NODE_1_length_25698_cov_36.651041	315	395	0	9	80	0.1125000
NODE_1_length_25698_cov_36.651041	315	395	4	71	80	0.8875000
NODE_1_length_25698_cov_36.651041	368	403	4	29	35	0.8285714
NODE_1_length_25698_cov_36.651041	368	403	6	2	35	0.0571429
NODE_1_length_25698_cov_36.651041	368	403	10	1	35	0.0285714
NODE_1_length_25698_cov_36.651041	368	403	12	2	35	0.0571429
NODE_1_length_25698_cov_36.651041	368	403	30	1	35	0.0285714
NODE_1_length_25698_cov_36.651041	24448	24494	0	46	46	1.0000000
NODE_2_length_24307_cov_15.119712	2613	2689	0	72	76	0.9473684
NODE_2_length_24307_cov_15.119712	2613	2689	2	4	76	0.0526316
NODE_2_length_24307_cov_15.119712	2662	2716	0	54	54	1.0000000
NODE_2_length_24307_cov_15.119712	11257	11320	0	63	63	1.0000000
NODE_2_length_24307_cov_15.119712	20621	20701	4	4	80	0.0500000
NODE_2_length_24307_cov_15.119712	20621	20701	6	7	80	0.0875000
NODE_2_length_24307_cov_15.119712	20621	20701	8	22	80	0.2750000
NODE_2_length_24307_cov_15.119712	20621	20701	10	47	80	0.5875000
NODE_2_length_24307_cov_15.119712	20674	20754	2	17	80	0.2125000
NODE_2_length_24307_cov_15.119712	20674	20754	4	23	80	0.2875000
NODE_2_length_24307_cov_15.119712	20674	20754	5	16	80	0.2000000
NODE_2_length_24307_cov_15.119712	20674	20754	6	2	80	0.0250000
NODE_2_length_24307_cov_15.119712	20674	20754	8	22	80	0.2750000
NODE_7_length_12349_cov_28.144571	12251	12310	12	4	59	0.0677966
NODE_7_length_12349_cov_28.144571	12251	12310	14	2	59	0.0338983
NODE_7_length_12349_cov_28.144571	12251	12310	18	4	59	0.0677966
NODE_7_length_12349_cov_28.144571	12251	12310	20	2	59	0.0338983
NODE_7_length_12349_cov_28.144571	12251	12310	22	4	59	0.0677966
NODE_7_length_12349_cov_28.144571	12251	12310	24	1	59	0.0169492
NODE_7_length_12349_cov_28.144571	12251	12310	26	1	59	0.0169492
NODE_7_length_12349_cov_28.144571	12251	12310	27	1	59	0.0169492
NODE_7_length_12349_cov_28.144571	12251	12310	30	2	59	0.0338983
NODE_7_length_12349_cov_28.144571	12251	12310	34	3	59	0.0508475
NODE_7_length_12349_cov_28.144571	12251	12310	36	1	59	0.0169492
NODE_7_length_12349_cov_28.144571	12251	12310	42	3	59	0.0508475
NODE_7_length_12349_cov_28.144571	12251	12310	44	5	59	0.0847458
NODE_7_length_12349_cov_28.144571	12251	12310	48	4	59	0.0677966
NODE_7_length_12349_cov_28.144571	12251	12310	50	1	59	0.0169492
NODE_7_length_12349_cov_28.144571	12251	12310	58	3	59	0.0508475
NODE_7_length_12349_cov_28.144571	12251	12310	60	2	59	0.0338983
NODE_7_length_12349_cov_28.144571	12251	12310	62	2	59	0.0338983
NODE_7_length_12349_cov_28.144571	12251	12310	66	1	59	0.0169492
NODE_7_length_12349_cov_28.144571	12251	12310	68	3	59	0.0508475
NODE_7_length_12349_cov_28.144571	12251	12310	70	2	59	0.0338983
NODE_7_length_12349_cov_28.144571	12251	12310	74	7	59	0.1186441
NODE_7_length_12349_cov_28.144571	12251	12310	80	1	59	0.0169492
NODE_7_length_12349_cov_28.144571	12284	12310	12	4	26	0.1538462
NODE_7_length_12349_cov_28.144571	12284	12310	14	2	26	0.0769231
NODE_7_length_12349_cov_28.144571	12284	12310	18	4	26	0.1538462
NODE_7_length_12349_cov_28.144571	12284	12310	20	2	26	0.0769231
NODE_7_length_12349_cov_28.144571	12284	12310	22	4	26	0.1538462
NODE_7_length_12349_cov_28.144571	12284	12310	24	1	26	0.0384615
NODE_7_length_12349_cov_28.144571	12284	12310	26	1	26	0.0384615
NODE_7_length_12349_cov_28.144571	12284	12310	27	1	26	0.0384615
NODE_7_length_12349_cov_28.144571	12284	12310	30	2	26	0.0769231
NODE_7_length_12349_cov_28.144571	12284	12310	34	3	26	0.1153846
NODE_7_length_12349_cov_28.144571	12284	12310	36	1	26	0.0384615
NODE_7_length_12349_cov_28.144571	12284	12310	42	1	26	0.0384615
NODE_10_length_11096_cov_14.154679	6455	6535	0	80	80	1.0000000
NODE_10_length_11096_cov_14.154679	6508	6588	0	80	80	1.0000000
NODE_10_length_11096_cov_14.154679	6584	6664	0	16	80	0.2000000
NODE_10_length_11096_cov_14.154679	6584	6664	2	4	80	0.0500000
NODE_10_length_11096_cov_14.154679	6584	6664	4	3	80	0.0375000
NODE_10_length_11096_cov_14.154679	6584	6664	10	35	80	0.4375000
NODE_10_length_11096_cov_14.154679	6584	6664	12	22	80	0.2750000
NODE_10_length_11096_cov_14.154679	6637	6717	4	7	80	0.0875000
NODE_10_length_11096_cov_14.154679	6637	6717	6	16	80	0.2000000
NODE_10_length_11096_cov_14.154679	6637	6717	8	1	80	0.0125000
NODE_10_length_11096_cov_14.154679	6637	6717	10	11	80	0.1375000
NODE_10_length_11096_cov_14.154679	6637	6717	12	45	80	0.5625000
NODE_10_length_11096_cov_14.154679	7182	7229	169	1	47	0.0212766
NODE_10_length_11096_cov_14.154679	7182	7229	171	3	47	0.0638298
NODE_10_length_11096_cov_14.154679	7182	7229	173	1	47	0.0212766
NODE_10_length_11096_cov_14.154679	7182	7229	175	2	47	0.0425532
NODE_10_length_11096_cov_14.154679	7182	7229	176	2	47	0.0425532
NODE_10_length_11096_cov_14.154679	7182	7229	177	1	47	0.0212766
NODE_10_length_11096_cov_14.154679	7182	7229	179	1	47	0.0212766
NODE_10_length_11096_cov_14.154679	7182	7229	181	1	47	0.0212766
NODE_10_length_11096_cov_14.154679	7182	7229	186	2	47	0.0425532
NODE_10_length_11096_cov_14.154679	7182	7229	189	1	47	0.0212766
NODE_10_length_11096_cov_14.154679	7182	7229	191	2	47	0.0425532
NODE_10_length_11096_cov_14.154679	7182	7229	192	1	47	0.0212766
NODE_10_length_11096_cov_14.154679	7182	7229	201	3	47	0.0638298
NODE_10_length_11096_cov_14.154679	7182	7229	205	1	47	0.0212766
NODE_10_length_11096_cov_14.154679	7182	7229	215	1	47	0.0212766
NODE_10_length_11096_cov_14.154679	7182	7229	219	1	47	0.0212766
NODE_10_length_11096_cov_14.154679	7182	7229	221	1	47	0.0212766
NODE_10_length_11096_cov_14.154679	7182	7229	225	1	47	0.0212766
NODE_10_length_11096_cov_14.154679	7182	7229	229	1	47	0.0212766
NODE_10_length_11096_cov_14.154679	7182	7229	231	1	47	0.0212766
NODE_10_length_11096_cov_14.154679	7182	7229	232	2	47	0.0425532
NODE_10_length_11096_cov_14.154679	7182	7229	233	1	47	0.0212766
NODE_10_length_11096_cov_14.154679	7182	7229	234	1	47	0.0212766
NODE_10_length_11096_cov_14.154679	7182	7229	235	1	47	0.0212766
NODE_10_length_11096_cov_14.154679	7182	7229	236	1	47	0.0212766
NODE_10_length_11096_cov_14.154679	7182	7229	240	1	47	0.0212766
NODE_10_length_11096_cov_14.154679	7182	7229	244	1	47	0.0212766
NODE_10_length_11096_cov_14.154679	7182	7229	245	1	47	0.0212766
NODE_10_length_11096_cov_14.154679	7182	7229	247	1	47	0.0212766
NODE_10_length_11096_cov_14.154679	7182	7229	248	1	47	0.0212766
NODE_10_length_11096_cov_14.154679	7182	7229	258	1	47	0.0212766
NODE_10_length_11096_cov_14.154679	7182	7229	260	1	47	0.0212766
NODE_10_length_11096_cov_14.154679	7182	7229	262	3	47	0.0638298
NODE_10_length_11096_cov_14.154679	7182	7229	263	1	47	0.0212766
NODE_10_length_11096_cov_14.154679	7182	7229	264	1	47	0.0212766
NODE_10_length_11096_cov_14.154679	7182	7229	265	1	47	0.0212766
NODE_10_length_11096_cov_14.154679	7218	7282	110	4	64	0.0625000
NODE_10_length_11096_cov_14.154679	7218	7282	111	2	64	0.0312500
NODE_10_length_11096_cov_14.154679	7218	7282	112	6	64	0.0937500
NODE_10_length_11096_cov_14.154679	7218	7282	114	4	64	0.0625000
NODE_10_length_11096_cov_14.154679	7218	7282	116	2	64	0.0312500
NODE_10_length_11096_cov_14.154679	7218	7282	118	1	64	0.0156250
NODE_10_length_11096_cov_14.154679	7218	7282	120	1	64	0.0156250
NODE_10_length_11096_cov_14.154679	7218	7282	122	1	64	0.0156250
NODE_10_length_11096_cov_14.154679	7218	7282	124	3	64	0.0468750
NODE_10_length_11096_cov_14.154679	7218	7282	126	2	64	0.0312500
NODE_10_length_11096_cov_14.154679	7218	7282	128	2	64	0.0312500
NODE_10_length_11096_cov_14.154679	7218	7282	130	1	64	0.0156250
NODE_10_length_11096_cov_14.154679	7218	7282	132	1	64	0.0156250
NODE_10_length_11096_cov_14.154679	7218	7282	136	2	64	0.0312500
NODE_10_length_11096_cov_14.154679	7218	7282	144	1	64	0.0156250
NODE_10_length_11096_cov_14.154679	7218	7282	150	1	64	0.0156250
NODE_10_length_11096_cov_14.154679	7218	7282	155	1	64	0.0156250
NODE_10_length_11096_cov_14.154679	7218	7282	159	2	64	0.0312500
NODE_10_length_11096_cov_14.154679	7218	7282	163	6	64	0.0937500
NODE_10_length_11096_cov_14.154679	7218	7282	165	2	64	0.0312500
NODE_10_length_11096_cov_14.154679	7218	7282	167	6	64	0.0937500
NODE_10_length_11096_cov_14.154679	7218	7282	169	3	64	0.0468750
NODE_10_length_11096_cov_14.154679	7218	7282	171	3	64	0.0468750
NODE_10_length_11096_cov_14.154679	7218	7282	173	1	64	0.0156250
NODE_10_length_11096_cov_14.154679	7218	7282	175	2	64	0.0312500
NODE_10_length_11096_cov_14.154679	7218	7282	176	2	64	0.0312500
NODE_10_length_11096_cov_14.154679	7218	7282	177	1	64	0.0156250
NODE_10_length_11096_cov_14.154679	7218	7282	179	1	64	0.0156250
NODE_13_length_10749_cov_34.330235	3589	3669	0	14	80	0.1750000
NODE_13_length_10749_cov_34.330235	3589	3669	2	1	80	0.0125000
NODE_13_length_10749_cov_34.330235	3589	3669	4	65	80	0.8125000
NODE_13_length_10749_cov_34.330235	3642	3722	0	67	80	0.8375000
NODE_13_length_10749_cov_34.330235	3642	3722	2	1	80	0.0125000
NODE_13_length_10749_cov_34.330235	3642	3722	4	12	80	0.1500000
NODE_13_length_10749_cov_34.330235	3718	3798	0	80	80	1.0000000
NODE_13_length_10749_cov_34.330235	3771	3851	0	73	80	0.9125000
NODE_13_length_10749_cov_34.330235	3771	3851	2	7	80	0.0875000
NODE_14_length_10557_cov_50.055938	423	503	0	80	80	1.0000000
NODE_14_length_10557_cov_50.055938	476	556	0	80	80	1.0000000
NODE_14_length_10557_cov_50.055938	1625	1696	8	3	71	0.0422535
NODE_14_length_10557_cov_50.055938	1625	1696	10	4	71	0.0563380
NODE_14_length_10557_cov_50.055938	1625	1696	11	10	71	0.1408451
NODE_14_length_10557_cov_50.055938	1625	1696	12	2	71	0.0281690
NODE_14_length_10557_cov_50.055938	1625	1696	13	52	71	0.7323943
NODE_14_length_10557_cov_50.055938	1678	1733	7	24	55	0.4363636
NODE_14_length_10557_cov_50.055938	1678	1733	9	9	55	0.1636364
NODE_14_length_10557_cov_50.055938	1678	1733	10	1	55	0.0181818
NODE_14_length_10557_cov_50.055938	1678	1733	11	2	55	0.0363636
NODE_14_length_10557_cov_50.055938	1678	1733	12	3	55	0.0545455
NODE_14_length_10557_cov_50.055938	1678	1733	13	16	55	0.2909091
NODE_14_length_10557_cov_50.055938	2428	2488	10	7	60	0.1166667
NODE_14_length_10557_cov_50.055938	2428	2488	12	13	60	0.2166667
NODE_14_length_10557_cov_50.055938	2428	2488	14	2	60	0.0333333
NODE_14_length_10557_cov_50.055938	2428	2488	16	30	60	0.5000000
NODE_14_length_10557_cov_50.055938	2428	2488	18	8	60	0.1333333
NODE_17_length_10101_cov_12.236253	923	966	4	4	43	0.0930233
NODE_17_length_10101_cov_12.236253	923	966	6	39	43	0.9069768
NODE_17_length_10101_cov_12.236253	943	1007	3	10	64	0.1562500
NODE_17_length_10101_cov_12.236253	943	1007	4	3	64	0.0468750
NODE_17_length_10101_cov_12.236253	943	1007	6	51	64	0.7968750
NODE_17_length_10101_cov_12.236253	1715	1795	0	80	80	1.0000000
NODE_17_length_10101_cov_12.236253	1768	1820	0	51	52	0.9807692
NODE_17_length_10101_cov_12.236253	1768	1820	4	1	52	0.0192308
NODE_20_length_9442_cov_109.961147	2108	2188	0	3	80	0.0375000
NODE_20_length_9442_cov_109.961147	2108	2188	2	32	80	0.4000000
NODE_20_length_9442_cov_109.961147	2108	2188	4	8	80	0.1000000
NODE_20_length_9442_cov_109.961147	2108	2188	6	37	80	0.4625000
NODE_20_length_9442_cov_109.961147	2161	2241	0	12	80	0.1500000
NODE_20_length_9442_cov_109.961147	2161	2241	2	15	80	0.1875000
NODE_20_length_9442_cov_109.961147	2161	2241	6	53	80	0.6625000
NODE_21_length_9414_cov_34.165217	2363	2443	34	4	80	0.0500000
NODE_21_length_9414_cov_34.165217	2363	2443	37	1	80	0.0125000
NODE_21_length_9414_cov_34.165217	2363	2443	39	1	80	0.0125000
NODE_21_length_9414_cov_34.165217	2363	2443	40	4	80	0.0500000
NODE_21_length_9414_cov_34.165217	2363	2443	41	1	80	0.0125000
NODE_21_length_9414_cov_34.165217	2363	2443	42	8	80	0.1000000
NODE_21_length_9414_cov_34.165217	2363	2443	44	4	80	0.0500000
NODE_21_length_9414_cov_34.165217	2363	2443	45	44	80	0.5500000
NODE_21_length_9414_cov_34.165217	2363	2443	46	13	80	0.1625000
NODE_21_length_9414_cov_34.165217	2416	2484	2	1	68	0.0147059
NODE_21_length_9414_cov_34.165217	2416	2484	4	6	68	0.0882353
NODE_21_length_9414_cov_34.165217	2416	2484	6	5	68	0.0735294
NODE_21_length_9414_cov_34.165217	2416	2484	9	7	68	0.1029412
NODE_21_length_9414_cov_34.165217	2416	2484	12	1	68	0.0147059
NODE_21_length_9414_cov_34.165217	2416	2484	13	9	68	0.1323529
NODE_21_length_9414_cov_34.165217	2416	2484	15	1	68	0.0147059
NODE_21_length_9414_cov_34.165217	2416	2484	17	2	68	0.0294118
NODE_21_length_9414_cov_34.165217	2416	2484	19	4	68	0.0588235
NODE_21_length_9414_cov_34.165217	2416	2484	22	1	68	0.0147059
NODE_21_length_9414_cov_34.165217	2416	2484	24	2	68	0.0294118
NODE_21_length_9414_cov_34.165217	2416	2484	28	1	68	0.0147059
NODE_21_length_9414_cov_34.165217	2416	2484	30	1	68	0.0147059
NODE_21_length_9414_cov_34.165217	2416	2484	34	1	68	0.0147059
NODE_21_length_9414_cov_34.165217	2416	2484	37	1	68	0.0147059
NODE_21_length_9414_cov_34.165217	2416	2484	39	1	68	0.0147059
NODE_21_length_9414_cov_34.165217	2416	2484	41	1	68	0.0147059
NODE_21_length_9414_cov_34.165217	2416	2484	44	1	68	0.0147059
NODE_21_length_9414_cov_34.165217	2416	2484	45	22	68	0.3235294
NODE_21_length_9414_cov_34.165217	5899	5975	47	4	76	0.0526316
NODE_21_length_9414_cov_34.165217	5899	5975	48	1	76	0.0131579
NODE_21_length_9414_cov_34.165217	5899	5975	49	3	76	0.0394737
NODE_21_length_9414_cov_34.165217	5899	5975	50	6	76	0.0789474
NODE_21_length_9414_cov_34.165217	5899	5975	51	2	76	0.0263158
NODE_21_length_9414_cov_34.165217	5899	5975	52	2	76	0.0263158
NODE_21_length_9414_cov_34.165217	5899	5975	54	5	76	0.0657895
NODE_21_length_9414_cov_34.165217	5899	5975	56	3	76	0.0394737
NODE_21_length_9414_cov_34.165217	5899	5975	58	1	76	0.0131579
NODE_21_length_9414_cov_34.165217	5899	5975	59	3	76	0.0394737
NODE_21_length_9414_cov_34.165217	5899	5975	60	3	76	0.0394737
NODE_21_length_9414_cov_34.165217	5899	5975	61	3	76	0.0394737
NODE_21_length_9414_cov_34.165217	5899	5975	62	9	76	0.1184211
NODE_21_length_9414_cov_34.165217	5899	5975	64	1	76	0.0131579
NODE_21_length_9414_cov_34.165217	5899	5975	65	2	76	0.0263158
NODE_21_length_9414_cov_34.165217	5899	5975	66	2	76	0.0263158
NODE_21_length_9414_cov_34.165217	5899	5975	68	10	76	0.1315790
NODE_21_length_9414_cov_34.165217	5899	5975	69	3	76	0.0394737
NODE_21_length_9414_cov_34.165217	5899	5975	70	8	76	0.1052632
NODE_21_length_9414_cov_34.165217	5899	5975	71	2	76	0.0263158
NODE_21_length_9414_cov_34.165217	5899	5975	72	3	76	0.0394737
NODE_24_length_9168_cov_47.407542	470	550	58	9	80	0.1125000
NODE_24_length_9168_cov_47.407542	470	550	60	6	80	0.0750000
NODE_24_length_9168_cov_47.407542	470	550	61	5	80	0.0625000
NODE_24_length_9168_cov_47.407542	470	550	62	2	80	0.0250000
NODE_24_length_9168_cov_47.407542	470	550	63	1	80	0.0125000
NODE_24_length_9168_cov_47.407542	470	550	64	2	80	0.0250000
NODE_24_length_9168_cov_47.407542	470	550	65	1	80	0.0125000
NODE_24_length_9168_cov_47.407542	470	550	66	4	80	0.0500000
NODE_24_length_9168_cov_47.407542	470	550	67	7	80	0.0875000
NODE_24_length_9168_cov_47.407542	470	550	68	12	80	0.1500000
NODE_24_length_9168_cov_47.407542	470	550	69	3	80	0.0375000
NODE_24_length_9168_cov_47.407542	470	550	70	2	80	0.0250000
NODE_24_length_9168_cov_47.407542	470	550	71	1	80	0.0125000
NODE_24_length_9168_cov_47.407542	470	550	73	2	80	0.0250000
NODE_24_length_9168_cov_47.407542	470	550	77	6	80	0.0750000
NODE_24_length_9168_cov_47.407542	470	550	79	11	80	0.1375000
NODE_24_length_9168_cov_47.407542	470	550	81	6	80	0.0750000
NODE_24_length_9168_cov_47.407542	523	603	27	14	80	0.1750000
NODE_24_length_9168_cov_47.407542	523	603	29	1	80	0.0125000
NODE_24_length_9168_cov_47.407542	523	603	30	4	80	0.0500000
NODE_24_length_9168_cov_47.407542	523	603	34	1	80	0.0125000
NODE_24_length_9168_cov_47.407542	523	603	36	3	80	0.0375000
NODE_24_length_9168_cov_47.407542	523	603	38	4	80	0.0500000
NODE_24_length_9168_cov_47.407542	523	603	40	2	80	0.0250000
NODE_24_length_9168_cov_47.407542	523	603	46	1	80	0.0125000
NODE_24_length_9168_cov_47.407542	523	603	48	9	80	0.1125000
NODE_24_length_9168_cov_47.407542	523	603	50	3	80	0.0375000
NODE_24_length_9168_cov_47.407542	523	603	52	5	80	0.0625000
NODE_24_length_9168_cov_47.407542	523	603	54	2	80	0.0250000
NODE_24_length_9168_cov_47.407542	523	603	56	2	80	0.0250000
NODE_24_length_9168_cov_47.407542	523	603	58	11	80	0.1375000
NODE_24_length_9168_cov_47.407542	523	603	60	6	80	0.0750000
NODE_24_length_9168_cov_47.407542	523	603	62	2	80	0.0250000
NODE_24_length_9168_cov_47.407542	523	603	64	2	80	0.0250000
NODE_24_length_9168_cov_47.407542	523	603	66	4	80	0.0500000
NODE_24_length_9168_cov_47.407542	523	603	68	2	80	0.0250000
NODE_24_length_9168_cov_47.407542	523	603	70	2	80	0.0250000
NODE_27_length_9108_cov_47.430347	4786	4866	121	1	80	0.0125000
NODE_27_length_9108_cov_47.430347	4786	4866	123	1	80	0.0125000
NODE_27_length_9108_cov_47.430347	4786	4866	125	7	80	0.0875000
NODE_27_length_9108_cov_47.430347	4786	4866	127	7	80	0.0875000
NODE_27_length_9108_cov_47.430347	4786	4866	129	5	80	0.0625000
NODE_27_length_9108_cov_47.430347	4786	4866	131	1	80	0.0125000
NODE_27_length_9108_cov_47.430347	4786	4866	132	1	80	0.0125000
NODE_27_length_9108_cov_47.430347	4786	4866	133	4	80	0.0500000
NODE_27_length_9108_cov_47.430347	4786	4866	134	5	80	0.0625000
NODE_27_length_9108_cov_47.430347	4786	4866	135	1	80	0.0125000
NODE_27_length_9108_cov_47.430347	4786	4866	136	2	80	0.0250000
NODE_27_length_9108_cov_47.430347	4786	4866	137	1	80	0.0125000
NODE_27_length_9108_cov_47.430347	4786	4866	138	3	80	0.0375000
NODE_27_length_9108_cov_47.430347	4786	4866	139	4	80	0.0500000
NODE_27_length_9108_cov_47.430347	4786	4866	140	2	80	0.0250000
NODE_27_length_9108_cov_47.430347	4786	4866	142	7	80	0.0875000
NODE_27_length_9108_cov_47.430347	4786	4866	144	3	80	0.0375000
NODE_27_length_9108_cov_47.430347	4786	4866	145	1	80	0.0125000
NODE_27_length_9108_cov_47.430347	4786	4866	146	3	80	0.0375000
NODE_27_length_9108_cov_47.430347	4786	4866	147	2	80	0.0250000
NODE_27_length_9108_cov_47.430347	4786	4866	148	1	80	0.0125000
NODE_27_length_9108_cov_47.430347	4786	4866	149	1	80	0.0125000
NODE_27_length_9108_cov_47.430347	4786	4866	150	1	80	0.0125000
NODE_27_length_9108_cov_47.430347	4786	4866	151	2	80	0.0250000
NODE_27_length_9108_cov_47.430347	4786	4866	152	1	80	0.0125000
NODE_27_length_9108_cov_47.430347	4786	4866	153	2	80	0.0250000
NODE_27_length_9108_cov_47.430347	4786	4866	154	6	80	0.0750000
NODE_27_length_9108_cov_47.430347	4786	4866	155	2	80	0.0250000
NODE_27_length_9108_cov_47.430347	4786	4866	156	1	80	0.0125000
NODE_27_length_9108_cov_47.430347	4786	4866	160	2	80	0.0250000
NODE_27_length_9108_cov_47.430347	4839	4902	138	2	63	0.0317460
NODE_27_length_9108_cov_47.430347	4839	4902	139	1	63	0.0158730
NODE_27_length_9108_cov_47.430347	4839	4902	140	1	63	0.0158730
NODE_27_length_9108_cov_47.430347	4839	4902	144	1	63	0.0158730
NODE_27_length_9108_cov_47.430347	4839	4902	145	1	63	0.0158730
NODE_27_length_9108_cov_47.430347	4839	4902	147	2	63	0.0317460
NODE_27_length_9108_cov_47.430347	4839	4902	148	1	63	0.0158730
NODE_27_length_9108_cov_47.430347	4839	4902	149	1	63	0.0158730
NODE_27_length_9108_cov_47.430347	4839	4902	150	1	63	0.0158730
NODE_27_length_9108_cov_47.430347	4839	4902	151	2	63	0.0317460
NODE_27_length_9108_cov_47.430347	4839	4902	152	1	63	0.0158730
NODE_27_length_9108_cov_47.430347	4839	4902	153	2	63	0.0317460
NODE_27_length_9108_cov_47.430347	4839	4902	154	6	63	0.0952381
NODE_27_length_9108_cov_47.430347	4839	4902	155	2	63	0.0317460
NODE_27_length_9108_cov_47.430347	4839	4902	156	1	63	0.0158730
NODE_27_length_9108_cov_47.430347	4839	4902	157	1	63	0.0158730
NODE_27_length_9108_cov_47.430347	4839	4902	160	2	63	0.0317460
NODE_27_length_9108_cov_47.430347	4839	4902	163	1	63	0.0158730
NODE_27_length_9108_cov_47.430347	4839	4902	165	3	63	0.0476190
NODE_27_length_9108_cov_47.430347	4839	4902	169	1	63	0.0158730
NODE_27_length_9108_cov_47.430347	4839	4902	171	2	63	0.0317460
NODE_27_length_9108_cov_47.430347	4839	4902	179	1	63	0.0158730
NODE_27_length_9108_cov_47.430347	4839	4902	187	1	63	0.0158730
NODE_27_length_9108_cov_47.430347	4839	4902	193	2	63	0.0317460
NODE_27_length_9108_cov_47.430347	4839	4902	203	1	63	0.0158730
NODE_27_length_9108_cov_47.430347	4839	4902	212	1	63	0.0158730
NODE_27_length_9108_cov_47.430347	4839	4902	213	1	63	0.0158730
NODE_27_length_9108_cov_47.430347	4839	4902	216	3	63	0.0476190
NODE_27_length_9108_cov_47.430347	4839	4902	217	3	63	0.0476190
NODE_27_length_9108_cov_47.430347	4839	4902	219	4	63	0.0634921
NODE_27_length_9108_cov_47.430347	4839	4902	220	1	63	0.0158730
NODE_27_length_9108_cov_47.430347	4839	4902	221	2	63	0.0317460
NODE_27_length_9108_cov_47.430347	4839	4902	223	3	63	0.0476190
NODE_27_length_9108_cov_47.430347	4839	4902	225	3	63	0.0476190
NODE_27_length_9108_cov_47.430347	4839	4902	228	1	63	0.0158730
NODE_27_length_9108_cov_47.430347	4839	4902	229	1	63	0.0158730
NODE_27_length_9108_cov_47.430347	4895	4963	182	1	68	0.0147059
NODE_27_length_9108_cov_47.430347	4895	4963	191	1	68	0.0147059
NODE_27_length_9108_cov_47.430347	4895	4963	192	1	68	0.0147059
NODE_27_length_9108_cov_47.430347	4895	4963	195	2	68	0.0294118
NODE_27_length_9108_cov_47.430347	4895	4963	201	1	68	0.0147059
NODE_27_length_9108_cov_47.430347	4895	4963	203	1	68	0.0147059
NODE_27_length_9108_cov_47.430347	4895	4963	207	1	68	0.0147059
NODE_27_length_9108_cov_47.430347	4895	4963	211	3	68	0.0441176
NODE_27_length_9108_cov_47.430347	4895	4963	215	1	68	0.0147059
NODE_27_length_9108_cov_47.430347	4895	4963	217	12	68	0.1764706
NODE_27_length_9108_cov_47.430347	4895	4963	219	8	68	0.1176471
NODE_27_length_9108_cov_47.430347	4895	4963	220	3	68	0.0441176
NODE_27_length_9108_cov_47.430347	4895	4963	221	5	68	0.0735294
NODE_27_length_9108_cov_47.430347	4895	4963	222	4	68	0.0588235
NODE_27_length_9108_cov_47.430347	4895	4963	223	1	68	0.0147059
NODE_27_length_9108_cov_47.430347	4895	4963	224	3	68	0.0441176
NODE_27_length_9108_cov_47.430347	4895	4963	225	3	68	0.0441176
NODE_27_length_9108_cov_47.430347	4895	4963	226	1	68	0.0147059
NODE_27_length_9108_cov_47.430347	4895	4963	228	5	68	0.0735294
NODE_27_length_9108_cov_47.430347	4895	4963	229	3	68	0.0441176
NODE_27_length_9108_cov_47.430347	4895	4963	230	1	68	0.0147059
NODE_27_length_9108_cov_47.430347	4895	4963	231	1	68	0.0147059
NODE_27_length_9108_cov_47.430347	4895	4963	232	2	68	0.0294118
NODE_27_length_9108_cov_47.430347	4895	4963	234	1	68	0.0147059
NODE_27_length_9108_cov_47.430347	4895	4963	235	1	68	0.0147059
NODE_27_length_9108_cov_47.430347	4895	4963	237	2	68	0.0294118
NODE_27_length_9108_cov_47.430347	4936	5016	22	1	80	0.0125000
NODE_27_length_9108_cov_47.430347	4936	5016	24	1	80	0.0125000
NODE_27_length_9108_cov_47.430347	4936	5016	33	1	80	0.0125000
NODE_27_length_9108_cov_47.430347	4936	5016	35	1	80	0.0125000
NODE_27_length_9108_cov_47.430347	4936	5016	36	1	80	0.0125000
NODE_27_length_9108_cov_47.430347	4936	5016	42	1	80	0.0125000
NODE_27_length_9108_cov_47.430347	4936	5016	48	1	80	0.0125000
NODE_27_length_9108_cov_47.430347	4936	5016	52	2	80	0.0250000
NODE_27_length_9108_cov_47.430347	4936	5016	57	1	80	0.0125000
NODE_27_length_9108_cov_47.430347	4936	5016	59	1	80	0.0125000
NODE_27_length_9108_cov_47.430347	4936	5016	72	1	80	0.0125000
NODE_27_length_9108_cov_47.430347	4936	5016	84	2	80	0.0250000
NODE_27_length_9108_cov_47.430347	4936	5016	86	1	80	0.0125000
NODE_27_length_9108_cov_47.430347	4936	5016	88	1	80	0.0125000
NODE_27_length_9108_cov_47.430347	4936	5016	92	1	80	0.0125000
NODE_27_length_9108_cov_47.430347	4936	5016	93	1	80	0.0125000
NODE_27_length_9108_cov_47.430347	4936	5016	99	1	80	0.0125000
NODE_27_length_9108_cov_47.430347	4936	5016	102	3	80	0.0375000
NODE_27_length_9108_cov_47.430347	4936	5016	104	1	80	0.0125000
NODE_27_length_9108_cov_47.430347	4936	5016	108	1	80	0.0125000
NODE_27_length_9108_cov_47.430347	4936	5016	112	2	80	0.0250000
NODE_27_length_9108_cov_47.430347	4936	5016	116	2	80	0.0250000
NODE_27_length_9108_cov_47.430347	4936	5016	122	2	80	0.0250000
NODE_27_length_9108_cov_47.430347	4936	5016	123	1	80	0.0125000
NODE_27_length_9108_cov_47.430347	4936	5016	127	2	80	0.0250000
NODE_27_length_9108_cov_47.430347	4936	5016	130	2	80	0.0250000
NODE_27_length_9108_cov_47.430347	4936	5016	142	1	80	0.0125000
NODE_27_length_9108_cov_47.430347	4936	5016	148	1	80	0.0125000
NODE_27_length_9108_cov_47.430347	4936	5016	149	1	80	0.0125000
NODE_27_length_9108_cov_47.430347	4936	5016	153	1	80	0.0125000
NODE_27_length_9108_cov_47.430347	4936	5016	157	1	80	0.0125000
NODE_27_length_9108_cov_47.430347	4936	5016	159	2	80	0.0250000
NODE_27_length_9108_cov_47.430347	4936	5016	160	1	80	0.0125000
NODE_27_length_9108_cov_47.430347	4936	5016	164	3	80	0.0375000
NODE_27_length_9108_cov_47.430347	4936	5016	170	1	80	0.0125000
NODE_27_length_9108_cov_47.430347	4936	5016	178	1	80	0.0125000
NODE_27_length_9108_cov_47.430347	4936	5016	180	3	80	0.0375000
NODE_27_length_9108_cov_47.430347	4936	5016	182	3	80	0.0375000
NODE_27_length_9108_cov_47.430347	4936	5016	191	1	80	0.0125000
NODE_27_length_9108_cov_47.430347	4936	5016	192	1	80	0.0125000
NODE_27_length_9108_cov_47.430347	4936	5016	195	2	80	0.0250000
NODE_27_length_9108_cov_47.430347	4936	5016	201	1	80	0.0125000
NODE_27_length_9108_cov_47.430347	4936	5016	203	1	80	0.0125000
NODE_27_length_9108_cov_47.430347	4936	5016	207	1	80	0.0125000
NODE_27_length_9108_cov_47.430347	4936	5016	211	3	80	0.0375000
NODE_27_length_9108_cov_47.430347	4936	5016	215	1	80	0.0125000
NODE_27_length_9108_cov_47.430347	4936	5016	217	12	80	0.1500000
NODE_27_length_9108_cov_47.430347	4936	5016	219	3	80	0.0375000
NODE_28_length_9108_cov_26.469974	44	120	2	13	76	0.1710526
NODE_28_length_9108_cov_26.469974	44	120	4	63	76	0.8289474
NODE_28_length_9108_cov_26.469974	7711	7791	2	1	80	0.0125000
NODE_28_length_9108_cov_26.469974	7711	7791	6	17	80	0.2125000
NODE_28_length_9108_cov_26.469974	7711	7791	8	13	80	0.1625000
NODE_28_length_9108_cov_26.469974	7711	7791	10	1	80	0.0125000
NODE_28_length_9108_cov_26.469974	7711	7791	14	12	80	0.1500000
NODE_28_length_9108_cov_26.469974	7711	7791	15	12	80	0.1500000
NODE_28_length_9108_cov_26.469974	7711	7791	17	1	80	0.0125000
NODE_28_length_9108_cov_26.469974	7711	7791	18	2	80	0.0250000
NODE_28_length_9108_cov_26.469974	7711	7791	20	3	80	0.0375000
NODE_28_length_9108_cov_26.469974	7711	7791	22	2	80	0.0250000
NODE_28_length_9108_cov_26.469974	7711	7791	24	1	80	0.0125000
NODE_28_length_9108_cov_26.469974	7711	7791	25	3	80	0.0375000
NODE_28_length_9108_cov_26.469974	7711	7791	27	12	80	0.1500000
NODE_28_length_9108_cov_26.469974	8144	8224	2	1	80	0.0125000
NODE_28_length_9108_cov_26.469974	8144	8224	4	3	80	0.0375000
NODE_28_length_9108_cov_26.469974	8144	8224	10	11	80	0.1375000
NODE_28_length_9108_cov_26.469974	8144	8224	12	2	80	0.0250000
NODE_28_length_9108_cov_26.469974	8144	8224	16	28	80	0.3500000
NODE_28_length_9108_cov_26.469974	8144	8224	18	2	80	0.0250000
NODE_28_length_9108_cov_26.469974	8144	8224	20	7	80	0.0875000
NODE_28_length_9108_cov_26.469974	8144	8224	22	10	80	0.1250000
NODE_28_length_9108_cov_26.469974	8144	8224	24	12	80	0.1500000
NODE_28_length_9108_cov_26.469974	8144	8224	26	3	80	0.0375000
NODE_28_length_9108_cov_26.469974	8144	8224	27	1	80	0.0125000
NODE_28_length_9108_cov_26.469974	8568	8648	0	21	80	0.2625000
NODE_28_length_9108_cov_26.469974	8568	8648	2	59	80	0.7375000
NODE_28_length_9108_cov_26.469974	8621	8701	0	38	80	0.4750000
NODE_28_length_9108_cov_26.469974	8621	8701	2	42	80	0.5250000
NODE_30_length_8743_cov_14.172721	7849	7929	24	2	80	0.0250000
NODE_30_length_8743_cov_14.172721	7849	7929	30	2	80	0.0250000
NODE_30_length_8743_cov_14.172721	7849	7929	32	3	80	0.0375000
NODE_30_length_8743_cov_14.172721	7849	7929	38	2	80	0.0250000
NODE_30_length_8743_cov_14.172721	7849	7929	40	6	80	0.0750000
NODE_30_length_8743_cov_14.172721	7849	7929	42	5	80	0.0625000
NODE_30_length_8743_cov_14.172721	7849	7929	44	7	80	0.0875000
NODE_30_length_8743_cov_14.172721	7849	7929	46	1	80	0.0125000
NODE_30_length_8743_cov_14.172721	7849	7929	47	1	80	0.0125000
NODE_30_length_8743_cov_14.172721	7849	7929	50	10	80	0.1250000
NODE_30_length_8743_cov_14.172721	7849	7929	51	11	80	0.1375000
NODE_30_length_8743_cov_14.172721	7849	7929	52	20	80	0.2500000
NODE_30_length_8743_cov_14.172721	7849	7929	54	10	80	0.1250000
NODE_30_length_8743_cov_14.172721	7902	7964	6	10	62	0.1612903
NODE_30_length_8743_cov_14.172721	7902	7964	8	2	62	0.0322581
NODE_30_length_8743_cov_14.172721	7902	7964	10	2	62	0.0322581
NODE_30_length_8743_cov_14.172721	7902	7964	14	2	62	0.0322581
NODE_30_length_8743_cov_14.172721	7902	7964	16	9	62	0.1451613
NODE_30_length_8743_cov_14.172721	7902	7964	20	3	62	0.0483871
NODE_30_length_8743_cov_14.172721	7902	7964	24	9	62	0.1451613
NODE_30_length_8743_cov_14.172721	7902	7964	30	2	62	0.0322581
NODE_30_length_8743_cov_14.172721	7902	7964	32	3	62	0.0483871
NODE_30_length_8743_cov_14.172721	7902	7964	40	6	62	0.0967742
NODE_30_length_8743_cov_14.172721	7902	7964	42	5	62	0.0806452
NODE_30_length_8743_cov_14.172721	7902	7964	44	7	62	0.1129032
NODE_30_length_8743_cov_14.172721	7902	7964	50	2	62	0.0322581
NODE_32_length_8707_cov_6.353044	8541	8621	14	8	80	0.1000000
NODE_32_length_8707_cov_6.353044	8541	8621	16	3	80	0.0375000
NODE_32_length_8707_cov_6.353044	8541	8621	18	2	80	0.0250000
NODE_32_length_8707_cov_6.353044	8541	8621	19	3	80	0.0375000
NODE_32_length_8707_cov_6.353044	8541	8621	21	5	80	0.0625000
NODE_32_length_8707_cov_6.353044	8541	8621	22	21	80	0.2625000
NODE_32_length_8707_cov_6.353044	8541	8621	24	36	80	0.4500000
NODE_32_length_8707_cov_6.353044	8541	8621	26	2	80	0.0250000
NODE_32_length_8707_cov_6.353044	8541	8621	14	8	80	0.1000000
NODE_32_length_8707_cov_6.353044	8541	8621	16	3	80	0.0375000
NODE_32_length_8707_cov_6.353044	8541	8621	18	2	80	0.0250000
NODE_32_length_8707_cov_6.353044	8541	8621	19	3	80	0.0375000
NODE_32_length_8707_cov_6.353044	8541	8621	21	5	80	0.0625000
NODE_32_length_8707_cov_6.353044	8541	8621	22	21	80	0.2625000
NODE_32_length_8707_cov_6.353044	8541	8621	24	36	80	0.4500000
NODE_32_length_8707_cov_6.353044	8541	8621	26	2	80	0.0250000
NODE_32_length_8707_cov_6.353044	8541	8621	14	8	80	0.1000000
NODE_32_length_8707_cov_6.353044	8541	8621	16	3	80	0.0375000
NODE_32_length_8707_cov_6.353044	8541	8621	18	2	80	0.0250000
NODE_32_length_8707_cov_6.353044	8541	8621	19	3	80	0.0375000
NODE_32_length_8707_cov_6.353044	8541	8621	21	5	80	0.0625000
NODE_32_length_8707_cov_6.353044	8541	8621	22	21	80	0.2625000
NODE_32_length_8707_cov_6.353044	8541	8621	24	36	80	0.4500000
NODE_32_length_8707_cov_6.353044	8541	8621	26	2	80	0.0250000
NODE_32_length_8707_cov_6.353044	8594	8674	8	10	80	0.1250000
NODE_32_length_8707_cov_6.353044	8594	8674	10	12	80	0.1500000
NODE_32_length_8707_cov_6.353044	8594	8674	12	15	80	0.1875000
NODE_32_length_8707_cov_6.353044	8594	8674	14	11	80	0.1375000
NODE_32_length_8707_cov_6.353044	8594	8674	22	3	80	0.0375000
NODE_32_length_8707_cov_6.353044	8594	8674	24	29	80	0.3625000
NODE_32_length_8707_cov_6.353044	8594	8674	8	10	80	0.1250000
NODE_32_length_8707_cov_6.353044	8594	8674	10	12	80	0.1500000
NODE_32_length_8707_cov_6.353044	8594	8674	12	15	80	0.1875000
NODE_32_length_8707_cov_6.353044	8594	8674	14	11	80	0.1375000
NODE_32_length_8707_cov_6.353044	8594	8674	22	3	80	0.0375000
NODE_32_length_8707_cov_6.353044	8594	8674	24	29	80	0.3625000
NODE_32_length_8707_cov_6.353044	8594	8673	8	9	79	0.1139240
NODE_32_length_8707_cov_6.353044	8594	8673	10	12	79	0.1518987
NODE_32_length_8707_cov_6.353044	8594	8673	12	15	79	0.1898734
NODE_32_length_8707_cov_6.353044	8594	8673	14	11	79	0.1392405
NODE_32_length_8707_cov_6.353044	8594	8673	22	3	79	0.0379747
NODE_32_length_8707_cov_6.353044	8594	8673	24	29	79	0.3670886
NODE_32_length_8707_cov_6.353044	8599	8674	8	10	75	0.1333333
NODE_32_length_8707_cov_6.353044	8599	8674	10	12	75	0.1600000
NODE_32_length_8707_cov_6.353044	8599	8674	12	15	75	0.2000000
NODE_32_length_8707_cov_6.353044	8599	8674	14	11	75	0.1466667
NODE_32_length_8707_cov_6.353044	8599	8674	22	3	75	0.0400000
NODE_32_length_8707_cov_6.353044	8599	8674	24	24	75	0.3200000
NODE_38_length_8281_cov_13.025177	7108	7188	0	6	80	0.0750000
NODE_38_length_8281_cov_13.025177	7108	7188	2	55	80	0.6875000
NODE_38_length_8281_cov_13.025177	7108	7188	4	19	80	0.2375000
NODE_38_length_8281_cov_13.025177	7161	7199	2	8	38	0.2105263
NODE_38_length_8281_cov_13.025177	7161	7199	4	30	38	0.7894737
NODE_38_length_8281_cov_13.025177	7175	7255	0	2	80	0.0250000
NODE_38_length_8281_cov_13.025177	7175	7255	2	54	80	0.6750000
NODE_38_length_8281_cov_13.025177	7175	7255	4	24	80	0.3000000
NODE_38_length_8281_cov_13.025177	7228	7308	0	55	80	0.6875000
NODE_38_length_8281_cov_13.025177	7228	7308	2	25	80	0.3125000
NODE_38_length_8281_cov_13.025177	7749	7829	0	22	80	0.2750000
NODE_38_length_8281_cov_13.025177	7749	7829	4	28	80	0.3500000
NODE_38_length_8281_cov_13.025177	7749	7829	6	7	80	0.0875000
NODE_38_length_8281_cov_13.025177	7749	7829	10	23	80	0.2875000
NODE_38_length_8281_cov_13.025177	7802	7882	6	20	80	0.2500000
NODE_38_length_8281_cov_13.025177	7802	7882	10	60	80	0.7500000
NODE_38_length_8281_cov_13.025177	7878	7958	2	24	80	0.3000000
NODE_38_length_8281_cov_13.025177	7878	7958	6	51	80	0.6375000
NODE_38_length_8281_cov_13.025177	7878	7958	8	5	80	0.0625000
NODE_38_length_8281_cov_13.025177	7931	8011	0	21	80	0.2625000
NODE_38_length_8281_cov_13.025177	7931	8011	2	56	80	0.7000000
NODE_38_length_8281_cov_13.025177	7931	8011	6	3	80	0.0375000
NODE_39_length_8259_cov_60.011152	1424	1504	5	1	80	0.0125000
NODE_39_length_8259_cov_60.011152	1424	1504	7	6	80	0.0750000
NODE_39_length_8259_cov_60.011152	1424	1504	10	73	80	0.9125000
NODE_39_length_8259_cov_60.011152	1477	1549	7	12	72	0.1666667
NODE_39_length_8259_cov_60.011152	1477	1549	10	60	72	0.8333333
NODE_40_length_8228_cov_17.079592	314	394	4	12	80	0.1500000
NODE_40_length_8228_cov_17.079592	314	394	6	54	80	0.6750000
NODE_40_length_8228_cov_17.079592	314	394	8	14	80	0.1750000
NODE_40_length_8228_cov_17.079592	367	447	2	10	80	0.1250000
NODE_40_length_8228_cov_17.079592	367	447	3	36	80	0.4500000
NODE_40_length_8228_cov_17.079592	367	447	6	34	80	0.4250000
NODE_40_length_8228_cov_17.079592	443	523	0	20	80	0.2500000
NODE_40_length_8228_cov_17.079592	443	523	2	17	80	0.2125000
NODE_40_length_8228_cov_17.079592	443	523	4	19	80	0.2375000
NODE_40_length_8228_cov_17.079592	443	523	8	21	80	0.2625000
NODE_40_length_8228_cov_17.079592	443	523	10	3	80	0.0375000
NODE_40_length_8228_cov_17.079592	496	576	4	3	80	0.0375000
NODE_40_length_8228_cov_17.079592	496	576	6	1	80	0.0125000
NODE_40_length_8228_cov_17.079592	496	576	8	33	80	0.4125000
NODE_40_length_8228_cov_17.079592	496	576	10	43	80	0.5375000
NODE_40_length_8228_cov_17.079592	3154	3217	12	1	63	0.0158730
NODE_40_length_8228_cov_17.079592	3154	3217	42	3	63	0.0476190
NODE_40_length_8228_cov_17.079592	3154	3217	44	5	63	0.0793651
NODE_40_length_8228_cov_17.079592	3154	3217	46	8	63	0.1269841
NODE_40_length_8228_cov_17.079592	3154	3217	54	1	63	0.0158730
NODE_40_length_8228_cov_17.079592	3154	3217	59	1	63	0.0158730
NODE_40_length_8228_cov_17.079592	3154	3217	64	1	63	0.0158730
NODE_40_length_8228_cov_17.079592	3154	3217	66	4	63	0.0634921
NODE_40_length_8228_cov_17.079592	3154	3217	72	1	63	0.0158730
NODE_40_length_8228_cov_17.079592	3154	3217	78	1	63	0.0158730
NODE_40_length_8228_cov_17.079592	3154	3217	79	1	63	0.0158730
NODE_40_length_8228_cov_17.079592	3154	3217	83	1	63	0.0158730
NODE_40_length_8228_cov_17.079592	3154	3217	85	2	63	0.0317460
NODE_40_length_8228_cov_17.079592	3154	3217	97	1	63	0.0158730
NODE_40_length_8228_cov_17.079592	3154	3217	103	1	63	0.0158730
NODE_40_length_8228_cov_17.079592	3154	3217	105	1	63	0.0158730
NODE_40_length_8228_cov_17.079592	3154	3217	109	1	63	0.0158730
NODE_40_length_8228_cov_17.079592	3154	3217	113	1	63	0.0158730
NODE_40_length_8228_cov_17.079592	3154	3217	123	1	63	0.0158730
NODE_40_length_8228_cov_17.079592	3154	3217	125	1	63	0.0158730
NODE_40_length_8228_cov_17.079592	3154	3217	129	1	63	0.0158730
NODE_40_length_8228_cov_17.079592	3154	3217	136	1	63	0.0158730
NODE_40_length_8228_cov_17.079592	3154	3217	137	2	63	0.0317460
NODE_40_length_8228_cov_17.079592	3154	3217	139	12	63	0.1904762
NODE_40_length_8228_cov_17.079592	3154	3217	143	2	63	0.0317460
NODE_40_length_8228_cov_17.079592	3154	3217	145	5	63	0.0793651
NODE_40_length_8228_cov_17.079592	3154	3217	147	3	63	0.0476190
NODE_43_length_8100_cov_32.115236	501	581	24	3	80	0.0375000
NODE_43_length_8100_cov_32.115236	501	581	26	13	80	0.1625000
NODE_43_length_8100_cov_32.115236	501	581	28	11	80	0.1375000
NODE_43_length_8100_cov_32.115236	501	581	30	13	80	0.1625000
NODE_43_length_8100_cov_32.115236	501	581	31	3	80	0.0375000
NODE_43_length_8100_cov_32.115236	501	581	32	8	80	0.1000000
NODE_43_length_8100_cov_32.115236	501	581	33	1	80	0.0125000
NODE_43_length_8100_cov_32.115236	501	581	34	19	80	0.2375000
NODE_43_length_8100_cov_32.115236	501	581	35	3	80	0.0375000
NODE_43_length_8100_cov_32.115236	501	581	37	5	80	0.0625000
NODE_43_length_8100_cov_32.115236	501	581	39	1	80	0.0125000
NODE_43_length_8100_cov_32.115236	554	634	2	8	80	0.1000000
NODE_43_length_8100_cov_32.115236	554	634	4	4	80	0.0500000
NODE_43_length_8100_cov_32.115236	554	634	5	1	80	0.0125000
NODE_43_length_8100_cov_32.115236	554	634	7	3	80	0.0375000
NODE_43_length_8100_cov_32.115236	554	634	9	7	80	0.0875000
NODE_43_length_8100_cov_32.115236	554	634	11	2	80	0.0250000
NODE_43_length_8100_cov_32.115236	554	634	15	10	80	0.1250000
NODE_43_length_8100_cov_32.115236	554	634	17	6	80	0.0750000
NODE_43_length_8100_cov_32.115236	554	634	19	2	80	0.0250000
NODE_43_length_8100_cov_32.115236	554	634	22	2	80	0.0250000
NODE_43_length_8100_cov_32.115236	554	634	24	11	80	0.1375000
NODE_43_length_8100_cov_32.115236	554	634	26	13	80	0.1625000
NODE_43_length_8100_cov_32.115236	554	634	28	11	80	0.1375000
NODE_43_length_8100_cov_32.115236	1383	1463	0	80	80	1.0000000
NODE_43_length_8100_cov_32.115236	1436	1516	0	35	80	0.4375000
NODE_43_length_8100_cov_32.115236	1436	1516	2	45	80	0.5625000
NODE_43_length_8100_cov_32.115236	3391	3462	174	1	71	0.0140845
NODE_43_length_8100_cov_32.115236	3391	3462	189	1	71	0.0140845
NODE_43_length_8100_cov_32.115236	3391	3462	191	1	71	0.0140845
NODE_43_length_8100_cov_32.115236	3391	3462	192	1	71	0.0140845
NODE_43_length_8100_cov_32.115236	3391	3462	195	1	71	0.0140845
NODE_43_length_8100_cov_32.115236	3391	3462	198	1	71	0.0140845
NODE_43_length_8100_cov_32.115236	3391	3462	203	1	71	0.0140845
NODE_43_length_8100_cov_32.115236	3391	3462	206	1	71	0.0140845
NODE_43_length_8100_cov_32.115236	3391	3462	208	1	71	0.0140845
NODE_43_length_8100_cov_32.115236	3391	3462	210	1	71	0.0140845
NODE_43_length_8100_cov_32.115236	3391	3462	213	1	71	0.0140845
NODE_43_length_8100_cov_32.115236	3391	3462	214	3	71	0.0422535
NODE_43_length_8100_cov_32.115236	3391	3462	215	1	71	0.0140845
NODE_43_length_8100_cov_32.115236	3391	3462	216	1	71	0.0140845
NODE_43_length_8100_cov_32.115236	3391	3462	222	1	71	0.0140845
NODE_43_length_8100_cov_32.115236	3391	3462	224	1	71	0.0140845
NODE_43_length_8100_cov_32.115236	3391	3462	225	1	71	0.0140845
NODE_43_length_8100_cov_32.115236	3391	3462	233	1	71	0.0140845
NODE_43_length_8100_cov_32.115236	3391	3462	240	1	71	0.0140845
NODE_43_length_8100_cov_32.115236	3391	3462	244	1	71	0.0140845
NODE_43_length_8100_cov_32.115236	3391	3462	250	2	71	0.0281690
NODE_43_length_8100_cov_32.115236	3391	3462	252	6	71	0.0845070
NODE_43_length_8100_cov_32.115236	3391	3462	253	1	71	0.0140845
NODE_43_length_8100_cov_32.115236	3391	3462	254	3	71	0.0422535
NODE_43_length_8100_cov_32.115236	3391	3462	255	5	71	0.0704225
NODE_43_length_8100_cov_32.115236	3391	3462	256	1	71	0.0140845
NODE_43_length_8100_cov_32.115236	3391	3462	257	2	71	0.0281690
NODE_43_length_8100_cov_32.115236	3391	3462	259	5	71	0.0704225
NODE_43_length_8100_cov_32.115236	3391	3462	261	4	71	0.0563380
NODE_43_length_8100_cov_32.115236	3391	3462	262	1	71	0.0140845
NODE_43_length_8100_cov_32.115236	3391	3462	263	1	71	0.0140845
NODE_43_length_8100_cov_32.115236	3391	3462	264	6	71	0.0845070
NODE_43_length_8100_cov_32.115236	3391	3462	266	1	71	0.0140845
NODE_43_length_8100_cov_32.115236	3391	3462	268	2	71	0.0281690
NODE_43_length_8100_cov_32.115236	3391	3462	269	8	71	0.1126761
NODE_43_length_8100_cov_32.115236	3391	3462	271	1	71	0.0140845
NODE_43_length_8100_cov_32.115236	3435	3483	104	1	48	0.0208333
NODE_43_length_8100_cov_32.115236	3435	3483	106	1	48	0.0208333
NODE_43_length_8100_cov_32.115236	3435	3483	107	1	48	0.0208333
NODE_43_length_8100_cov_32.115236	3435	3483	109	2	48	0.0416667
NODE_43_length_8100_cov_32.115236	3435	3483	115	1	48	0.0208333
NODE_43_length_8100_cov_32.115236	3435	3483	119	1	48	0.0208333
NODE_43_length_8100_cov_32.115236	3435	3483	121	1	48	0.0208333
NODE_43_length_8100_cov_32.115236	3435	3483	122	1	48	0.0208333
NODE_43_length_8100_cov_32.115236	3435	3483	123	1	48	0.0208333
NODE_43_length_8100_cov_32.115236	3435	3483	125	1	48	0.0208333
NODE_43_length_8100_cov_32.115236	3435	3483	127	1	48	0.0208333
NODE_43_length_8100_cov_32.115236	3435	3483	135	1	48	0.0208333
NODE_43_length_8100_cov_32.115236	3435	3483	137	1	48	0.0208333
NODE_43_length_8100_cov_32.115236	3435	3483	141	2	48	0.0416667
NODE_43_length_8100_cov_32.115236	3435	3483	151	1	48	0.0208333
NODE_43_length_8100_cov_32.115236	3435	3483	155	1	48	0.0208333
NODE_43_length_8100_cov_32.115236	3435	3483	161	1	48	0.0208333
NODE_43_length_8100_cov_32.115236	3435	3483	173	1	48	0.0208333
NODE_43_length_8100_cov_32.115236	3435	3483	174	2	48	0.0416667
NODE_43_length_8100_cov_32.115236	3435	3483	189	1	48	0.0208333
NODE_43_length_8100_cov_32.115236	3435	3483	191	1	48	0.0208333
NODE_43_length_8100_cov_32.115236	3435	3483	192	1	48	0.0208333
NODE_43_length_8100_cov_32.115236	3435	3483	195	1	48	0.0208333
NODE_43_length_8100_cov_32.115236	3435	3483	198	1	48	0.0208333
NODE_43_length_8100_cov_32.115236	3435	3483	203	1	48	0.0208333
NODE_43_length_8100_cov_32.115236	3435	3483	206	1	48	0.0208333
NODE_43_length_8100_cov_32.115236	3435	3483	208	1	48	0.0208333
NODE_43_length_8100_cov_32.115236	3435	3483	210	1	48	0.0208333
NODE_43_length_8100_cov_32.115236	3435	3483	213	1	48	0.0208333
NODE_43_length_8100_cov_32.115236	3435	3483	214	3	48	0.0625000
NODE_43_length_8100_cov_32.115236	3435	3483	215	1	48	0.0208333
NODE_43_length_8100_cov_32.115236	3435	3483	216	1	48	0.0208333
NODE_43_length_8100_cov_32.115236	3435	3483	222	1	48	0.0208333
NODE_43_length_8100_cov_32.115236	3435	3483	224	1	48	0.0208333
NODE_43_length_8100_cov_32.115236	3435	3483	225	1	48	0.0208333
NODE_43_length_8100_cov_32.115236	3435	3483	233	1	48	0.0208333
NODE_43_length_8100_cov_32.115236	3435	3483	240	1	48	0.0208333
NODE_43_length_8100_cov_32.115236	3435	3483	244	1	48	0.0208333
NODE_43_length_8100_cov_32.115236	3435	3483	250	2	48	0.0416667
NODE_43_length_8100_cov_32.115236	3435	3483	252	1	48	0.0208333
NODE_43_length_8100_cov_32.115236	3435	3483	254	1	48	0.0208333
NODE_43_length_8100_cov_32.115236	3435	3483	255	1	48	0.0208333
NODE_46_length_7962_cov_31.622790	6281	6363	108	2	82	0.0243902
NODE_46_length_7962_cov_31.622790	6281	6363	109	1	82	0.0121951
NODE_46_length_7962_cov_31.622790	6281	6363	110	3	82	0.0365854
NODE_46_length_7962_cov_31.622790	6281	6363	111	5	82	0.0609756
NODE_46_length_7962_cov_31.622790	6281	6363	113	1	82	0.0121951
NODE_46_length_7962_cov_31.622790	6281	6363	114	2	82	0.0243902
NODE_46_length_7962_cov_31.622790	6281	6363	115	2	82	0.0243902
NODE_46_length_7962_cov_31.622790	6281	6363	116	1	82	0.0121951
NODE_46_length_7962_cov_31.622790	6281	6363	117	3	82	0.0365854
NODE_46_length_7962_cov_31.622790	6281	6363	119	3	82	0.0365854
NODE_46_length_7962_cov_31.622790	6281	6363	121	3	82	0.0365854
NODE_46_length_7962_cov_31.622790	6281	6363	122	5	82	0.0609756
NODE_46_length_7962_cov_31.622790	6281	6363	123	2	82	0.0243902
NODE_46_length_7962_cov_31.622790	6281	6363	124	1	82	0.0121951
NODE_46_length_7962_cov_31.622790	6281	6363	125	7	82	0.0853659
NODE_46_length_7962_cov_31.622790	6281	6363	126	7	82	0.0853659
NODE_46_length_7962_cov_31.622790	6281	6363	127	3	82	0.0365854
NODE_46_length_7962_cov_31.622790	6281	6363	128	10	82	0.1219512
NODE_46_length_7962_cov_31.622790	6281	6363	129	1	82	0.0121951
NODE_46_length_7962_cov_31.622790	6281	6363	130	1	82	0.0121951
NODE_46_length_7962_cov_31.622790	6281	6363	131	1	82	0.0121951
NODE_46_length_7962_cov_31.622790	6281	6363	136	3	82	0.0365854
NODE_46_length_7962_cov_31.622790	6281	6363	139	1	82	0.0121951
NODE_46_length_7962_cov_31.622790	6281	6363	140	1	82	0.0121951
NODE_46_length_7962_cov_31.622790	6281	6363	144	6	82	0.0731707
NODE_46_length_7962_cov_31.622790	6281	6363	145	4	82	0.0487805
NODE_46_length_7962_cov_31.622790	6281	6363	146	1	82	0.0121951
NODE_46_length_7962_cov_31.622790	6281	6363	147	2	82	0.0243902
NODE_47_length_7944_cov_12.238496	348	419	2	33	71	0.4647887
NODE_47_length_7944_cov_12.238496	348	419	4	2	71	0.0281690
NODE_47_length_7944_cov_12.238496	348	419	10	8	71	0.1126761
NODE_47_length_7944_cov_12.238496	348	419	14	9	71	0.1267606
NODE_47_length_7944_cov_12.238496	348	419	19	9	71	0.1267606
NODE_47_length_7944_cov_12.238496	348	419	21	6	71	0.0845070
NODE_47_length_7944_cov_12.238496	348	419	27	3	71	0.0422535
NODE_47_length_7944_cov_12.238496	348	419	28	1	71	0.0140845
NODE_48_length_7919_cov_14.554859	2380	2460	16	8	80	0.1000000
NODE_48_length_7919_cov_14.554859	2380	2460	18	19	80	0.2375000
NODE_48_length_7919_cov_14.554859	2380	2460	22	2	80	0.0250000
NODE_48_length_7919_cov_14.554859	2380	2460	24	8	80	0.1000000
NODE_48_length_7919_cov_14.554859	2380	2460	26	6	80	0.0750000
NODE_48_length_7919_cov_14.554859	2380	2460	28	10	80	0.1250000
NODE_48_length_7919_cov_14.554859	2380	2460	30	7	80	0.0875000
NODE_48_length_7919_cov_14.554859	2380	2460	32	4	80	0.0500000
NODE_48_length_7919_cov_14.554859	2380	2460	34	11	80	0.1375000
NODE_48_length_7919_cov_14.554859	2380	2460	36	5	80	0.0625000
NODE_50_length_7830_cov_4.211098	0	52	0	52	52	1.0000000
NODE_50_length_7830_cov_4.211098	30	105	0	75	75	1.0000000
NODE_52_length_7779_cov_20.230859	7691	7771	0	43	80	0.5375000
NODE_52_length_7779_cov_20.230859	7691	7771	2	37	80	0.4625000
NODE_52_length_7779_cov_20.230859	7691	7771	0	43	80	0.5375000
NODE_52_length_7779_cov_20.230859	7691	7771	2	37	80	0.4625000
NODE_52_length_7779_cov_20.230859	7691	7761	0	33	70	0.4714286
NODE_52_length_7779_cov_20.230859	7691	7761	2	37	70	0.5285714
NODE_52_length_7779_cov_20.230859	7744	7779	0	35	35	1.0000000
NODE_53_length_7765_cov_18.871119	254	322	12	2	68	0.0294118
NODE_53_length_7765_cov_18.871119	254	322	14	2	68	0.0294118
NODE_53_length_7765_cov_18.871119	254	322	16	5	68	0.0735294
NODE_53_length_7765_cov_18.871119	254	322	18	3	68	0.0441176
NODE_53_length_7765_cov_18.871119	254	322	20	3	68	0.0441176
NODE_53_length_7765_cov_18.871119	254	322	21	1	68	0.0147059
NODE_53_length_7765_cov_18.871119	254	322	22	1	68	0.0147059
NODE_53_length_7765_cov_18.871119	254	322	23	2	68	0.0294118
NODE_53_length_7765_cov_18.871119	254	322	24	12	68	0.1764706
NODE_53_length_7765_cov_18.871119	254	322	26	3	68	0.0441176
NODE_53_length_7765_cov_18.871119	254	322	27	3	68	0.0441176
NODE_53_length_7765_cov_18.871119	254	322	28	5	68	0.0735294
NODE_53_length_7765_cov_18.871119	254	322	30	3	68	0.0441176
NODE_53_length_7765_cov_18.871119	254	322	32	1	68	0.0147059
NODE_53_length_7765_cov_18.871119	254	322	34	3	68	0.0441176
NODE_53_length_7765_cov_18.871119	254	322	36	2	68	0.0294118
NODE_53_length_7765_cov_18.871119	254	322	40	1	68	0.0147059
NODE_53_length_7765_cov_18.871119	254	322	41	2	68	0.0294118
NODE_53_length_7765_cov_18.871119	254	322	42	11	68	0.1617647
NODE_53_length_7765_cov_18.871119	254	322	43	2	68	0.0294118
NODE_53_length_7765_cov_18.871119	254	322	47	1	68	0.0147059
NODE_53_length_7765_cov_18.871119	353	433	76	1	80	0.0125000
NODE_53_length_7765_cov_18.871119	353	433	78	1	80	0.0125000
NODE_53_length_7765_cov_18.871119	353	433	80	4	80	0.0500000
NODE_53_length_7765_cov_18.871119	353	433	82	3	80	0.0375000
NODE_53_length_7765_cov_18.871119	353	433	84	6	80	0.0750000
NODE_53_length_7765_cov_18.871119	353	433	86	1	80	0.0125000
NODE_53_length_7765_cov_18.871119	353	433	90	1	80	0.0125000
NODE_53_length_7765_cov_18.871119	353	433	92	5	80	0.0625000
NODE_53_length_7765_cov_18.871119	353	433	94	1	80	0.0125000
NODE_53_length_7765_cov_18.871119	353	433	96	1	80	0.0125000
NODE_53_length_7765_cov_18.871119	353	433	97	1	80	0.0125000
NODE_53_length_7765_cov_18.871119	353	433	98	2	80	0.0250000
NODE_53_length_7765_cov_18.871119	353	433	103	1	80	0.0125000
NODE_53_length_7765_cov_18.871119	353	433	105	3	80	0.0375000
NODE_53_length_7765_cov_18.871119	353	433	106	3	80	0.0375000
NODE_53_length_7765_cov_18.871119	353	433	108	1	80	0.0125000
NODE_53_length_7765_cov_18.871119	353	433	109	1	80	0.0125000
NODE_53_length_7765_cov_18.871119	353	433	110	5	80	0.0625000
NODE_53_length_7765_cov_18.871119	353	433	111	3	80	0.0375000
NODE_53_length_7765_cov_18.871119	353	433	113	2	80	0.0250000
NODE_53_length_7765_cov_18.871119	353	433	114	8	80	0.1000000
NODE_53_length_7765_cov_18.871119	353	433	115	1	80	0.0125000
NODE_53_length_7765_cov_18.871119	353	433	117	3	80	0.0375000
NODE_53_length_7765_cov_18.871119	353	433	118	3	80	0.0375000
NODE_53_length_7765_cov_18.871119	353	433	119	5	80	0.0625000
NODE_53_length_7765_cov_18.871119	353	433	121	10	80	0.1250000
NODE_53_length_7765_cov_18.871119	353	433	122	1	80	0.0125000
NODE_53_length_7765_cov_18.871119	353	433	123	3	80	0.0375000
NODE_61_length_7411_cov_74.967314	2283	2347	0	64	64	1.0000000
NODE_61_length_7411_cov_74.967314	4725	4789	0	64	64	1.0000000
NODE_64_length_7305_cov_3.696087	971	1019	2	7	48	0.1458333
NODE_64_length_7305_cov_3.696087	971	1019	4	28	48	0.5833333
NODE_64_length_7305_cov_3.696087	971	1019	6	2	48	0.0416667
NODE_64_length_7305_cov_3.696087	971	1019	8	4	48	0.0833333
NODE_64_length_7305_cov_3.696087	971	1019	10	7	48	0.1458333
NODE_64_length_7305_cov_3.696087	7142	7190	0	48	48	1.0000000
NODE_66_length_7261_cov_12.433398	2313	2395	90	2	82	0.0243902
NODE_66_length_7261_cov_12.433398	2313	2395	91	1	82	0.0121951
NODE_66_length_7261_cov_12.433398	2313	2395	92	8	82	0.0975610
NODE_66_length_7261_cov_12.433398	2313	2395	93	3	82	0.0365854
NODE_66_length_7261_cov_12.433398	2313	2395	94	2	82	0.0243902
NODE_66_length_7261_cov_12.433398	2313	2395	95	3	82	0.0365854
NODE_66_length_7261_cov_12.433398	2313	2395	96	6	82	0.0731707
NODE_66_length_7261_cov_12.433398	2313	2395	97	1	82	0.0121951
NODE_66_length_7261_cov_12.433398	2313	2395	98	5	82	0.0609756
NODE_66_length_7261_cov_12.433398	2313	2395	100	6	82	0.0731707
NODE_66_length_7261_cov_12.433398	2313	2395	102	3	82	0.0365854
NODE_66_length_7261_cov_12.433398	2313	2395	104	3	82	0.0365854
NODE_66_length_7261_cov_12.433398	2313	2395	108	5	82	0.0609756
NODE_66_length_7261_cov_12.433398	2313	2395	109	2	82	0.0243902
NODE_66_length_7261_cov_12.433398	2313	2395	113	1	82	0.0121951
NODE_66_length_7261_cov_12.433398	2313	2395	117	1	82	0.0121951
NODE_66_length_7261_cov_12.433398	2313	2395	119	1	82	0.0121951
NODE_66_length_7261_cov_12.433398	2313	2395	121	1	82	0.0121951
NODE_66_length_7261_cov_12.433398	2313	2395	127	1	82	0.0121951
NODE_66_length_7261_cov_12.433398	2313	2395	132	2	82	0.0243902
NODE_66_length_7261_cov_12.433398	2313	2395	136	1	82	0.0121951
NODE_66_length_7261_cov_12.433398	2313	2395	138	1	82	0.0121951
NODE_66_length_7261_cov_12.433398	2313	2395	140	1	82	0.0121951
NODE_66_length_7261_cov_12.433398	2313	2395	142	1	82	0.0121951
NODE_66_length_7261_cov_12.433398	2313	2395	150	2	82	0.0243902
NODE_66_length_7261_cov_12.433398	2313	2395	155	1	82	0.0121951
NODE_66_length_7261_cov_12.433398	2313	2395	157	1	82	0.0121951
NODE_66_length_7261_cov_12.433398	2313	2395	159	1	82	0.0121951
NODE_66_length_7261_cov_12.433398	2313	2395	165	1	82	0.0121951
NODE_66_length_7261_cov_12.433398	2313	2395	172	1	82	0.0121951
NODE_66_length_7261_cov_12.433398	2313	2395	174	6	82	0.0731707
NODE_66_length_7261_cov_12.433398	2313	2395	177	1	82	0.0121951
NODE_66_length_7261_cov_12.433398	2313	2395	179	1	82	0.0121951
NODE_66_length_7261_cov_12.433398	2313	2395	184	1	82	0.0121951
NODE_66_length_7261_cov_12.433398	2313	2395	189	3	82	0.0365854
NODE_66_length_7261_cov_12.433398	2313	2395	190	1	82	0.0121951
NODE_66_length_7261_cov_12.433398	2313	2395	211	1	82	0.0121951
NODE_73_length_7036_cov_65.961943	4375	4455	0	11	80	0.1375000
NODE_73_length_7036_cov_65.961943	4375	4455	1	5	80	0.0625000
NODE_73_length_7036_cov_65.961943	4375	4455	5	13	80	0.1625000
NODE_73_length_7036_cov_65.961943	4375	4455	6	2	80	0.0250000
NODE_73_length_7036_cov_65.961943	4375	4455	7	1	80	0.0125000
NODE_73_length_7036_cov_65.961943	4375	4455	9	7	80	0.0875000
NODE_73_length_7036_cov_65.961943	4375	4455	11	41	80	0.5125000
NODE_73_length_7036_cov_65.961943	5538	5618	226	1	80	0.0125000
NODE_73_length_7036_cov_65.961943	5538	5618	232	1	80	0.0125000
NODE_73_length_7036_cov_65.961943	5538	5618	237	1	80	0.0125000
NODE_73_length_7036_cov_65.961943	5538	5618	239	1	80	0.0125000
NODE_73_length_7036_cov_65.961943	5538	5618	247	1	80	0.0125000
NODE_73_length_7036_cov_65.961943	5538	5618	249	1	80	0.0125000
NODE_73_length_7036_cov_65.961943	5538	5618	254	1	80	0.0125000
NODE_73_length_7036_cov_65.961943	5538	5618	258	1	80	0.0125000
NODE_73_length_7036_cov_65.961943	5538	5618	268	1	80	0.0125000
NODE_73_length_7036_cov_65.961943	5538	5618	287	1	80	0.0125000
NODE_73_length_7036_cov_65.961943	5538	5618	298	1	80	0.0125000
NODE_73_length_7036_cov_65.961943	5538	5618	302	1	80	0.0125000
NODE_73_length_7036_cov_65.961943	5538	5618	313	1	80	0.0125000
NODE_73_length_7036_cov_65.961943	5538	5618	321	1	80	0.0125000
NODE_73_length_7036_cov_65.961943	5538	5618	329	1	80	0.0125000
NODE_73_length_7036_cov_65.961943	5538	5618	343	1	80	0.0125000
NODE_73_length_7036_cov_65.961943	5538	5618	357	1	80	0.0125000
NODE_73_length_7036_cov_65.961943	5538	5618	360	1	80	0.0125000
NODE_73_length_7036_cov_65.961943	5538	5618	369	1	80	0.0125000
NODE_73_length_7036_cov_65.961943	5538	5618	381	1	80	0.0125000
NODE_73_length_7036_cov_65.961943	5538	5618	383	1	80	0.0125000
NODE_73_length_7036_cov_65.961943	5538	5618	386	2	80	0.0250000
NODE_73_length_7036_cov_65.961943	5538	5618	388	1	80	0.0125000
NODE_73_length_7036_cov_65.961943	5538	5618	390	1	80	0.0125000
NODE_73_length_7036_cov_65.961943	5538	5618	413	1	80	0.0125000
NODE_73_length_7036_cov_65.961943	5538	5618	417	1	80	0.0125000
NODE_73_length_7036_cov_65.961943	5538	5618	422	1	80	0.0125000
NODE_73_length_7036_cov_65.961943	5538	5618	439	1	80	0.0125000
NODE_73_length_7036_cov_65.961943	5538	5618	444	1	80	0.0125000
NODE_73_length_7036_cov_65.961943	5538	5618	451	1	80	0.0125000
NODE_73_length_7036_cov_65.961943	5538	5618	452	1	80	0.0125000
NODE_73_length_7036_cov_65.961943	5538	5618	466	1	80	0.0125000
NODE_73_length_7036_cov_65.961943	5538	5618	479	1	80	0.0125000
NODE_73_length_7036_cov_65.961943	5538	5618	491	1	80	0.0125000
NODE_73_length_7036_cov_65.961943	5538	5618	506	1	80	0.0125000
NODE_73_length_7036_cov_65.961943	5538	5618	511	1	80	0.0125000
NODE_73_length_7036_cov_65.961943	5538	5618	516	1	80	0.0125000
NODE_73_length_7036_cov_65.961943	5538	5618	522	1	80	0.0125000
NODE_73_length_7036_cov_65.961943	5538	5618	538	1	80	0.0125000
NODE_73_length_7036_cov_65.961943	5538	5618	549	1	80	0.0125000
NODE_73_length_7036_cov_65.961943	5538	5618	555	1	80	0.0125000
NODE_73_length_7036_cov_65.961943	5538	5618	565	1	80	0.0125000
NODE_73_length_7036_cov_65.961943	5538	5618	568	1	80	0.0125000
NODE_73_length_7036_cov_65.961943	5538	5618	577	1	80	0.0125000
NODE_73_length_7036_cov_65.961943	5538	5618	589	1	80	0.0125000
NODE_73_length_7036_cov_65.961943	5538	5618	593	1	80	0.0125000
NODE_73_length_7036_cov_65.961943	5538	5618	600	1	80	0.0125000
NODE_73_length_7036_cov_65.961943	5538	5618	604	1	80	0.0125000
NODE_73_length_7036_cov_65.961943	5538	5618	608	1	80	0.0125000
NODE_73_length_7036_cov_65.961943	5538	5618	613	1	80	0.0125000
NODE_73_length_7036_cov_65.961943	5538	5618	615	1	80	0.0125000
NODE_73_length_7036_cov_65.961943	5538	5618	616	1	80	0.0125000
NODE_73_length_7036_cov_65.961943	5538	5618	628	2	80	0.0250000
NODE_73_length_7036_cov_65.961943	5538	5618	652	1	80	0.0125000
NODE_73_length_7036_cov_65.961943	5538	5618	655	1	80	0.0125000
NODE_73_length_7036_cov_65.961943	5538	5618	663	1	80	0.0125000
NODE_73_length_7036_cov_65.961943	5538	5618	674	1	80	0.0125000
NODE_73_length_7036_cov_65.961943	5538	5618	686	2	80	0.0250000
NODE_73_length_7036_cov_65.961943	5538	5618	690	1	80	0.0125000
NODE_73_length_7036_cov_65.961943	5538	5618	705	1	80	0.0125000
NODE_73_length_7036_cov_65.961943	5538	5618	715	1	80	0.0125000
NODE_73_length_7036_cov_65.961943	5538	5618	723	1	80	0.0125000
NODE_73_length_7036_cov_65.961943	5538	5618	739	1	80	0.0125000
NODE_73_length_7036_cov_65.961943	5538	5618	744	1	80	0.0125000
NODE_73_length_7036_cov_65.961943	5538	5618	748	1	80	0.0125000
NODE_73_length_7036_cov_65.961943	5538	5618	755	1	80	0.0125000
NODE_73_length_7036_cov_65.961943	5538	5618	767	1	80	0.0125000
NODE_73_length_7036_cov_65.961943	5538	5618	779	1	80	0.0125000
NODE_73_length_7036_cov_65.961943	5538	5618	796	1	80	0.0125000
NODE_73_length_7036_cov_65.961943	5538	5618	797	1	80	0.0125000
NODE_73_length_7036_cov_65.961943	5538	5618	798	2	80	0.0250000
NODE_73_length_7036_cov_65.961943	5538	5618	799	1	80	0.0125000
NODE_73_length_7036_cov_65.961943	5538	5618	804	1	80	0.0125000
NODE_73_length_7036_cov_65.961943	5538	5618	808	3	80	0.0375000
NODE_73_length_7036_cov_65.961943	5591	5666	628	2	75	0.0266667
NODE_73_length_7036_cov_65.961943	5591	5666	652	1	75	0.0133333
NODE_73_length_7036_cov_65.961943	5591	5666	655	1	75	0.0133333
NODE_73_length_7036_cov_65.961943	5591	5666	663	1	75	0.0133333
NODE_73_length_7036_cov_65.961943	5591	5666	674	1	75	0.0133333
NODE_73_length_7036_cov_65.961943	5591	5666	686	2	75	0.0266667
NODE_73_length_7036_cov_65.961943	5591	5666	690	1	75	0.0133333
NODE_73_length_7036_cov_65.961943	5591	5666	705	1	75	0.0133333
NODE_73_length_7036_cov_65.961943	5591	5666	715	1	75	0.0133333
NODE_73_length_7036_cov_65.961943	5591	5666	723	1	75	0.0133333
NODE_73_length_7036_cov_65.961943	5591	5666	739	1	75	0.0133333
NODE_73_length_7036_cov_65.961943	5591	5666	744	1	75	0.0133333
NODE_73_length_7036_cov_65.961943	5591	5666	748	1	75	0.0133333
NODE_73_length_7036_cov_65.961943	5591	5666	755	1	75	0.0133333
NODE_73_length_7036_cov_65.961943	5591	5666	767	1	75	0.0133333
NODE_73_length_7036_cov_65.961943	5591	5666	779	1	75	0.0133333
NODE_73_length_7036_cov_65.961943	5591	5666	796	1	75	0.0133333
NODE_73_length_7036_cov_65.961943	5591	5666	797	1	75	0.0133333
NODE_73_length_7036_cov_65.961943	5591	5666	798	2	75	0.0266667
NODE_73_length_7036_cov_65.961943	5591	5666	799	1	75	0.0133333
NODE_73_length_7036_cov_65.961943	5591	5666	804	1	75	0.0133333
NODE_73_length_7036_cov_65.961943	5591	5666	808	3	75	0.0400000
NODE_73_length_7036_cov_65.961943	5591	5666	820	1	75	0.0133333
NODE_73_length_7036_cov_65.961943	5591	5666	838	1	75	0.0133333
NODE_73_length_7036_cov_65.961943	5591	5666	839	1	75	0.0133333
NODE_73_length_7036_cov_65.961943	5591	5666	845	2	75	0.0266667
NODE_73_length_7036_cov_65.961943	5591	5666	857	1	75	0.0133333
NODE_73_length_7036_cov_65.961943	5591	5666	859	1	75	0.0133333
NODE_73_length_7036_cov_65.961943	5591	5666	861	1	75	0.0133333
NODE_73_length_7036_cov_65.961943	5591	5666	878	1	75	0.0133333
NODE_73_length_7036_cov_65.961943	5591	5666	879	1	75	0.0133333
NODE_73_length_7036_cov_65.961943	5591	5666	885	1	75	0.0133333
NODE_73_length_7036_cov_65.961943	5591	5666	891	1	75	0.0133333
NODE_73_length_7036_cov_65.961943	5591	5666	893	1	75	0.0133333
NODE_73_length_7036_cov_65.961943	5591	5666	900	2	75	0.0266667
NODE_73_length_7036_cov_65.961943	5591	5666	902	1	75	0.0133333
NODE_73_length_7036_cov_65.961943	5591	5666	906	1	75	0.0133333
NODE_73_length_7036_cov_65.961943	5591	5666	909	1	75	0.0133333
NODE_73_length_7036_cov_65.961943	5591	5666	910	1	75	0.0133333
NODE_73_length_7036_cov_65.961943	5591	5666	921	1	75	0.0133333
NODE_73_length_7036_cov_65.961943	5591	5666	922	1	75	0.0133333
NODE_73_length_7036_cov_65.961943	5591	5666	924	1	75	0.0133333
NODE_73_length_7036_cov_65.961943	5591	5666	928	2	75	0.0266667
NODE_73_length_7036_cov_65.961943	5591	5666	929	1	75	0.0133333
NODE_73_length_7036_cov_65.961943	5591	5666	935	1	75	0.0133333
NODE_73_length_7036_cov_65.961943	5591	5666	940	1	75	0.0133333
NODE_73_length_7036_cov_65.961943	5591	5666	952	1	75	0.0133333
NODE_73_length_7036_cov_65.961943	5591	5666	960	1	75	0.0133333
NODE_73_length_7036_cov_65.961943	5591	5666	969	1	75	0.0133333
NODE_73_length_7036_cov_65.961943	5591	5666	980	1	75	0.0133333
NODE_73_length_7036_cov_65.961943	5591	5666	1003	1	75	0.0133333
NODE_73_length_7036_cov_65.961943	5591	5666	1028	1	75	0.0133333
NODE_73_length_7036_cov_65.961943	5591	5666	1040	1	75	0.0133333
NODE_73_length_7036_cov_65.961943	5591	5666	1076	1	75	0.0133333
NODE_73_length_7036_cov_65.961943	5591	5666	1077	1	75	0.0133333
NODE_73_length_7036_cov_65.961943	5591	5666	1085	1	75	0.0133333
NODE_73_length_7036_cov_65.961943	5591	5666	1087	1	75	0.0133333
NODE_73_length_7036_cov_65.961943	5591	5666	1091	1	75	0.0133333
NODE_73_length_7036_cov_65.961943	5591	5666	1104	1	75	0.0133333
NODE_73_length_7036_cov_65.961943	5591	5666	1106	1	75	0.0133333
NODE_73_length_7036_cov_65.961943	5591	5666	1125	1	75	0.0133333
NODE_73_length_7036_cov_65.961943	5591	5666	1134	1	75	0.0133333
NODE_73_length_7036_cov_65.961943	5591	5666	1137	1	75	0.0133333
NODE_73_length_7036_cov_65.961943	5591	5666	1150	1	75	0.0133333
NODE_73_length_7036_cov_65.961943	5591	5666	1153	1	75	0.0133333
NODE_73_length_7036_cov_65.961943	5591	5666	1158	1	75	0.0133333
NODE_73_length_7036_cov_65.961943	5591	5666	1167	1	75	0.0133333
NODE_73_length_7036_cov_65.961943	5690	5746	1286	1	56	0.0178571
NODE_73_length_7036_cov_65.961943	5690	5746	1291	1	56	0.0178571
NODE_73_length_7036_cov_65.961943	5690	5746	1292	1	56	0.0178571
NODE_73_length_7036_cov_65.961943	5690	5746	1294	1	56	0.0178571
NODE_73_length_7036_cov_65.961943	5690	5746	1296	1	56	0.0178571
NODE_73_length_7036_cov_65.961943	5690	5746	1297	3	56	0.0535714
NODE_73_length_7036_cov_65.961943	5690	5746	1299	1	56	0.0178571
NODE_73_length_7036_cov_65.961943	5690	5746	1301	2	56	0.0357143
NODE_73_length_7036_cov_65.961943	5690	5746	1302	3	56	0.0535714
NODE_73_length_7036_cov_65.961943	5690	5746	1303	1	56	0.0178571
NODE_73_length_7036_cov_65.961943	5690	5746	1305	1	56	0.0178571
NODE_73_length_7036_cov_65.961943	5690	5746	1307	1	56	0.0178571
NODE_73_length_7036_cov_65.961943	5690	5746	1309	2	56	0.0357143
NODE_73_length_7036_cov_65.961943	5690	5746	1310	1	56	0.0178571
NODE_73_length_7036_cov_65.961943	5690	5746	1311	1	56	0.0178571
NODE_73_length_7036_cov_65.961943	5690	5746	1312	1	56	0.0178571
NODE_73_length_7036_cov_65.961943	5690	5746	1313	4	56	0.0714286
NODE_73_length_7036_cov_65.961943	5690	5746	1315	3	56	0.0535714
NODE_73_length_7036_cov_65.961943	5690	5746	1316	4	56	0.0714286
NODE_73_length_7036_cov_65.961943	5690	5746	1318	3	56	0.0535714
NODE_73_length_7036_cov_65.961943	5690	5746	1320	1	56	0.0178571
NODE_73_length_7036_cov_65.961943	5690	5746	1321	2	56	0.0357143
NODE_73_length_7036_cov_65.961943	5690	5746	1322	1	56	0.0178571
NODE_73_length_7036_cov_65.961943	5690	5746	1325	1	56	0.0178571
NODE_73_length_7036_cov_65.961943	5690	5746	1326	2	56	0.0357143
NODE_73_length_7036_cov_65.961943	5690	5746	1328	3	56	0.0535714
NODE_73_length_7036_cov_65.961943	5690	5746	1330	1	56	0.0178571
NODE_73_length_7036_cov_65.961943	5690	5746	1333	2	56	0.0357143
NODE_73_length_7036_cov_65.961943	5690	5746	1334	2	56	0.0357143
NODE_73_length_7036_cov_65.961943	5690	5746	1335	1	56	0.0178571
NODE_73_length_7036_cov_65.961943	5690	5746	1336	1	56	0.0178571
NODE_73_length_7036_cov_65.961943	5690	5746	1339	1	56	0.0178571
NODE_73_length_7036_cov_65.961943	5690	5746	1344	1	56	0.0178571
NODE_73_length_7036_cov_65.961943	5690	5746	1345	1	56	0.0178571
NODE_73_length_7036_cov_65.961943	6373	6453	0	80	80	1.0000000
NODE_73_length_7036_cov_65.961943	6426	6506	0	80	80	1.0000000
NODE_74_length_6974_cov_16.058327	976	1056	2	31	80	0.3875000
NODE_74_length_6974_cov_16.058327	976	1056	4	26	80	0.3250000
NODE_74_length_6974_cov_16.058327	976	1056	6	23	80	0.2875000
NODE_74_length_6974_cov_16.058327	1029	1109	4	6	80	0.0750000
NODE_74_length_6974_cov_16.058327	1029	1109	6	74	80	0.9250000
NODE_80_length_6826_cov_10.483574	4462	4542	0	10	80	0.1250000
NODE_80_length_6826_cov_10.483574	4462	4542	11	3	80	0.0375000
NODE_80_length_6826_cov_10.483574	4462	4542	12	6	80	0.0750000
NODE_80_length_6826_cov_10.483574	4462	4542	13	9	80	0.1125000
NODE_80_length_6826_cov_10.483574	4462	4542	17	5	80	0.0625000
NODE_80_length_6826_cov_10.483574	4462	4542	21	5	80	0.0625000
NODE_80_length_6826_cov_10.483574	4462	4542	22	1	80	0.0125000
NODE_80_length_6826_cov_10.483574	4462	4542	24	6	80	0.0750000
NODE_80_length_6826_cov_10.483574	4462	4542	25	14	80	0.1750000
NODE_80_length_6826_cov_10.483574	4462	4542	27	8	80	0.1000000
NODE_80_length_6826_cov_10.483574	4462	4542	33	8	80	0.1000000
NODE_80_length_6826_cov_10.483574	4462	4542	37	2	80	0.0250000
NODE_80_length_6826_cov_10.483574	4462	4542	41	3	80	0.0375000
NODE_80_length_6826_cov_10.483574	4515	4595	25	6	80	0.0750000
NODE_80_length_6826_cov_10.483574	4515	4595	27	8	80	0.1000000
NODE_80_length_6826_cov_10.483574	4515	4595	33	8	80	0.1000000
NODE_80_length_6826_cov_10.483574	4515	4595	37	2	80	0.0250000
NODE_80_length_6826_cov_10.483574	4515	4595	41	3	80	0.0375000
NODE_80_length_6826_cov_10.483574	4515	4595	43	6	80	0.0750000
NODE_80_length_6826_cov_10.483574	4515	4595	45	3	80	0.0375000
NODE_80_length_6826_cov_10.483574	4515	4595	47	2	80	0.0250000
NODE_80_length_6826_cov_10.483574	4515	4595	49	5	80	0.0625000
NODE_80_length_6826_cov_10.483574	4515	4595	53	13	80	0.1625000
NODE_80_length_6826_cov_10.483574	4515	4595	55	8	80	0.1000000
NODE_80_length_6826_cov_10.483574	4515	4595	57	14	80	0.1750000
NODE_80_length_6826_cov_10.483574	4515	4595	59	2	80	0.0250000
NODE_81_length_6816_cov_2.820753	6726	6801	0	75	75	1.0000000
NODE_81_length_6816_cov_2.820753	6774	6816	0	42	42	1.0000000
NODE_84_length_6744_cov_6.222272	5	85	0	80	80	1.0000000
NODE_84_length_6744_cov_6.222272	58	138	0	80	80	1.0000000
NODE_84_length_6744_cov_6.222272	6650	6730	4	20	80	0.2500000
NODE_84_length_6744_cov_6.222272	6650	6730	6	34	80	0.4250000
NODE_84_length_6744_cov_6.222272	6650	6730	8	15	80	0.1875000
NODE_84_length_6744_cov_6.222272	6650	6730	10	11	80	0.1375000
NODE_84_length_6744_cov_6.222272	6703	6744	0	3	41	0.0731707
NODE_84_length_6744_cov_6.222272	6703	6744	2	8	41	0.1951219
NODE_84_length_6744_cov_6.222272	6703	6744	4	23	41	0.5609756
NODE_84_length_6744_cov_6.222272	6703	6744	6	7	41	0.1707317
NODE_86_length_6733_cov_88.965029	3141	3221	0	3	80	0.0375000
NODE_86_length_6733_cov_88.965029	3141	3221	3	11	80	0.1375000
NODE_86_length_6733_cov_88.965029	3141	3221	4	1	80	0.0125000
NODE_86_length_6733_cov_88.965029	3141	3221	6	31	80	0.3875000
NODE_86_length_6733_cov_88.965029	3141	3221	8	32	80	0.4000000
NODE_86_length_6733_cov_88.965029	3141	3221	12	2	80	0.0250000
NODE_86_length_6733_cov_88.965029	3194	3274	8	25	80	0.3125000
NODE_86_length_6733_cov_88.965029	3194	3274	10	1	80	0.0125000
NODE_86_length_6733_cov_88.965029	3194	3274	12	41	80	0.5125000
NODE_86_length_6733_cov_88.965029	3194	3274	20	1	80	0.0125000
NODE_86_length_6733_cov_88.965029	3194	3274	22	12	80	0.1500000
NODE_86_length_6733_cov_88.965029	3270	3350	11	25	80	0.3125000
NODE_86_length_6733_cov_88.965029	3270	3350	15	28	80	0.3500000
NODE_86_length_6733_cov_88.965029	3270	3350	16	9	80	0.1125000
NODE_86_length_6733_cov_88.965029	3270	3350	20	3	80	0.0375000
NODE_86_length_6733_cov_88.965029	3270	3350	22	15	80	0.1875000
NODE_86_length_6733_cov_88.965029	3323	3403	11	78	80	0.9750000
NODE_86_length_6733_cov_88.965029	3323	3403	15	2	80	0.0250000
NODE_90_length_6627_cov_9.440564	350	430	0	80	80	1.0000000
NODE_90_length_6627_cov_9.440564	403	483	0	80	80	1.0000000
NODE_95_length_6507_cov_95.786049	171	247	0	72	76	0.9473684
NODE_95_length_6507_cov_95.786049	171	247	4	1	76	0.0131579
NODE_95_length_6507_cov_95.786049	171	247	14	1	76	0.0131579
NODE_95_length_6507_cov_95.786049	171	247	26	1	76	0.0131579
NODE_95_length_6507_cov_95.786049	171	247	79	1	76	0.0131579
NODE_96_length_6497_cov_2.677399	366	436	0	39	70	0.5571429
NODE_96_length_6497_cov_2.677399	366	436	2	31	70	0.4428571
NODE_96_length_6497_cov_2.677399	409	444	0	35	35	1.0000000
NODE_97_length_6450_cov_26.108172	5024	5104	8	7	80	0.0875000
NODE_97_length_6450_cov_26.108172	5024	5104	10	6	80	0.0750000
NODE_97_length_6450_cov_26.108172	5024	5104	12	4	80	0.0500000
NODE_97_length_6450_cov_26.108172	5024	5104	16	7	80	0.0875000
NODE_97_length_6450_cov_26.108172	5024	5104	18	4	80	0.0500000
NODE_97_length_6450_cov_26.108172	5024	5104	20	8	80	0.1000000
NODE_97_length_6450_cov_26.108172	5024	5104	22	8	80	0.1000000
NODE_97_length_6450_cov_26.108172	5024	5104	26	2	80	0.0250000
NODE_97_length_6450_cov_26.108172	5024	5104	28	1	80	0.0125000
NODE_97_length_6450_cov_26.108172	5024	5104	32	1	80	0.0125000
NODE_97_length_6450_cov_26.108172	5024	5104	36	18	80	0.2250000
NODE_97_length_6450_cov_26.108172	5024	5104	38	14	80	0.1750000
NODE_109_length_6171_cov_36.061100	3743	3813	10	2	70	0.0285714
NODE_109_length_6171_cov_36.061100	3743	3813	14	1	70	0.0142857
NODE_109_length_6171_cov_36.061100	3743	3813	16	1	70	0.0142857
NODE_109_length_6171_cov_36.061100	3743	3813	18	2	70	0.0285714
NODE_109_length_6171_cov_36.061100	3743	3813	20	2	70	0.0285714
NODE_109_length_6171_cov_36.061100	3743	3813	24	2	70	0.0285714
NODE_109_length_6171_cov_36.061100	3743	3813	28	1	70	0.0142857
NODE_109_length_6171_cov_36.061100	3743	3813	30	2	70	0.0285714
NODE_109_length_6171_cov_36.061100	3743	3813	32	18	70	0.2571429
NODE_109_length_6171_cov_36.061100	3743	3813	33	15	70	0.2142857
NODE_109_length_6171_cov_36.061100	3743	3813	37	4	70	0.0571429
NODE_109_length_6171_cov_36.061100	3743	3813	38	6	70	0.0857143
NODE_109_length_6171_cov_36.061100	3743	3813	39	5	70	0.0714286
NODE_109_length_6171_cov_36.061100	3743	3813	41	9	70	0.1285714
NODE_109_length_6171_cov_36.061100	3798	3851	33	3	53	0.0566038
NODE_109_length_6171_cov_36.061100	3798	3851	34	3	53	0.0566038
NODE_109_length_6171_cov_36.061100	3798	3851	35	3	53	0.0566038
NODE_109_length_6171_cov_36.061100	3798	3851	37	2	53	0.0377358
NODE_109_length_6171_cov_36.061100	3798	3851	38	1	53	0.0188679
NODE_109_length_6171_cov_36.061100	3798	3851	39	5	53	0.0943396
NODE_109_length_6171_cov_36.061100	3798	3851	41	9	53	0.1698113
NODE_109_length_6171_cov_36.061100	3798	3851	47	1	53	0.0188679
NODE_109_length_6171_cov_36.061100	3798	3851	48	1	53	0.0188679
NODE_109_length_6171_cov_36.061100	3798	3851	50	1	53	0.0188679
NODE_109_length_6171_cov_36.061100	3798	3851	52	1	53	0.0188679
NODE_109_length_6171_cov_36.061100	3798	3851	54	2	53	0.0377358
NODE_109_length_6171_cov_36.061100	3798	3851	55	5	53	0.0943396
NODE_109_length_6171_cov_36.061100	3798	3851	57	5	53	0.0943396
NODE_109_length_6171_cov_36.061100	3798	3851	59	11	53	0.2075472
NODE_109_length_6171_cov_36.061100	4552	4596	257	1	44	0.0227273
NODE_109_length_6171_cov_36.061100	4552	4596	259	3	44	0.0681818
NODE_109_length_6171_cov_36.061100	4552	4596	260	1	44	0.0227273
NODE_109_length_6171_cov_36.061100	4552	4596	261	2	44	0.0454545
NODE_109_length_6171_cov_36.061100	4552	4596	262	2	44	0.0454545
NODE_109_length_6171_cov_36.061100	4552	4596	264	6	44	0.1363636
NODE_109_length_6171_cov_36.061100	4552	4596	265	1	44	0.0227273
NODE_109_length_6171_cov_36.061100	4552	4596	267	3	44	0.0681818
NODE_109_length_6171_cov_36.061100	4552	4596	269	3	44	0.0681818
NODE_109_length_6171_cov_36.061100	4552	4596	271	3	44	0.0681818
NODE_109_length_6171_cov_36.061100	4552	4596	272	1	44	0.0227273
NODE_109_length_6171_cov_36.061100	4552	4596	273	2	44	0.0454545
NODE_109_length_6171_cov_36.061100	4552	4596	276	1	44	0.0227273
NODE_109_length_6171_cov_36.061100	4552	4596	277	1	44	0.0227273
NODE_109_length_6171_cov_36.061100	4552	4596	278	1	44	0.0227273
NODE_109_length_6171_cov_36.061100	4552	4596	279	1	44	0.0227273
NODE_109_length_6171_cov_36.061100	4552	4596	281	1	44	0.0227273
NODE_109_length_6171_cov_36.061100	4552	4596	282	1	44	0.0227273
NODE_109_length_6171_cov_36.061100	4552	4596	288	2	44	0.0454545
NODE_109_length_6171_cov_36.061100	4552	4596	290	1	44	0.0227273
NODE_109_length_6171_cov_36.061100	4552	4596	292	2	44	0.0454545
NODE_109_length_6171_cov_36.061100	4552	4596	296	1	44	0.0227273
NODE_109_length_6171_cov_36.061100	4552	4596	297	1	44	0.0227273
NODE_109_length_6171_cov_36.061100	4552	4596	298	3	44	0.0681818
NODE_109_length_6171_cov_36.061100	4569	4649	257	1	80	0.0125000
NODE_109_length_6171_cov_36.061100	4569	4649	259	3	80	0.0375000
NODE_109_length_6171_cov_36.061100	4569	4649	260	1	80	0.0125000
NODE_109_length_6171_cov_36.061100	4569	4649	261	2	80	0.0250000
NODE_109_length_6171_cov_36.061100	4569	4649	267	2	80	0.0250000
NODE_109_length_6171_cov_36.061100	4569	4649	269	2	80	0.0250000
NODE_109_length_6171_cov_36.061100	4569	4649	271	2	80	0.0250000
NODE_109_length_6171_cov_36.061100	4569	4649	273	2	80	0.0250000
NODE_109_length_6171_cov_36.061100	4569	4649	276	1	80	0.0125000
NODE_109_length_6171_cov_36.061100	4569	4649	277	1	80	0.0125000
NODE_109_length_6171_cov_36.061100	4569	4649	278	1	80	0.0125000
NODE_109_length_6171_cov_36.061100	4569	4649	281	1	80	0.0125000
NODE_109_length_6171_cov_36.061100	4569	4649	282	1	80	0.0125000
NODE_109_length_6171_cov_36.061100	4569	4649	288	1	80	0.0125000
NODE_109_length_6171_cov_36.061100	4569	4649	290	1	80	0.0125000
NODE_109_length_6171_cov_36.061100	4569	4649	292	2	80	0.0250000
NODE_109_length_6171_cov_36.061100	4569	4649	297	1	80	0.0125000
NODE_109_length_6171_cov_36.061100	4569	4649	298	2	80	0.0250000
NODE_109_length_6171_cov_36.061100	4569	4649	303	2	80	0.0250000
NODE_109_length_6171_cov_36.061100	4569	4649	304	1	80	0.0125000
NODE_109_length_6171_cov_36.061100	4569	4649	305	1	80	0.0125000
NODE_109_length_6171_cov_36.061100	4569	4649	307	1	80	0.0125000
NODE_109_length_6171_cov_36.061100	4569	4649	309	1	80	0.0125000
NODE_109_length_6171_cov_36.061100	4569	4649	311	1	80	0.0125000
NODE_109_length_6171_cov_36.061100	4569	4649	319	1	80	0.0125000
NODE_109_length_6171_cov_36.061100	4569	4649	322	1	80	0.0125000
NODE_109_length_6171_cov_36.061100	4569	4649	324	1	80	0.0125000
NODE_109_length_6171_cov_36.061100	4569	4649	326	2	80	0.0250000
NODE_109_length_6171_cov_36.061100	4569	4649	331	1	80	0.0125000
NODE_109_length_6171_cov_36.061100	4569	4649	332	1	80	0.0125000
NODE_109_length_6171_cov_36.061100	4569	4649	333	1	80	0.0125000
NODE_109_length_6171_cov_36.061100	4569	4649	337	1	80	0.0125000
NODE_109_length_6171_cov_36.061100	4569	4649	339	3	80	0.0375000
NODE_109_length_6171_cov_36.061100	4569	4649	341	1	80	0.0125000
NODE_109_length_6171_cov_36.061100	4569	4649	343	2	80	0.0250000
NODE_109_length_6171_cov_36.061100	4569	4649	344	1	80	0.0125000
NODE_109_length_6171_cov_36.061100	4569	4649	345	1	80	0.0125000
NODE_109_length_6171_cov_36.061100	4569	4649	351	1	80	0.0125000
NODE_109_length_6171_cov_36.061100	4569	4649	354	1	80	0.0125000
NODE_109_length_6171_cov_36.061100	4569	4649	355	1	80	0.0125000
NODE_109_length_6171_cov_36.061100	4569	4649	356	2	80	0.0250000
NODE_109_length_6171_cov_36.061100	4569	4649	357	1	80	0.0125000
NODE_109_length_6171_cov_36.061100	4569	4649	359	1	80	0.0125000
NODE_109_length_6171_cov_36.061100	4569	4649	369	1	80	0.0125000
NODE_109_length_6171_cov_36.061100	4569	4649	372	1	80	0.0125000
NODE_109_length_6171_cov_36.061100	4569	4649	373	1	80	0.0125000
NODE_109_length_6171_cov_36.061100	4569	4649	385	2	80	0.0250000
NODE_109_length_6171_cov_36.061100	4569	4649	393	2	80	0.0250000
NODE_109_length_6171_cov_36.061100	4569	4649	400	1	80	0.0125000
NODE_109_length_6171_cov_36.061100	4569	4649	412	1	80	0.0125000
NODE_109_length_6171_cov_36.061100	4569	4649	413	1	80	0.0125000
NODE_109_length_6171_cov_36.061100	4569	4649	419	1	80	0.0125000
NODE_109_length_6171_cov_36.061100	4569	4649	420	1	80	0.0125000
NODE_109_length_6171_cov_36.061100	4569	4649	421	1	80	0.0125000
NODE_109_length_6171_cov_36.061100	4569	4649	422	1	80	0.0125000
NODE_109_length_6171_cov_36.061100	4569	4649	434	1	80	0.0125000
NODE_109_length_6171_cov_36.061100	4569	4649	436	1	80	0.0125000
NODE_109_length_6171_cov_36.061100	4569	4649	442	1	80	0.0125000
NODE_109_length_6171_cov_36.061100	4569	4649	449	1	80	0.0125000
NODE_109_length_6171_cov_36.061100	4569	4649	452	1	80	0.0125000
NODE_109_length_6171_cov_36.061100	4569	4649	456	1	80	0.0125000
NODE_109_length_6171_cov_36.061100	4569	4649	457	1	80	0.0125000
NODE_109_length_6171_cov_36.061100	4569	4649	459	1	80	0.0125000
NODE_109_length_6171_cov_36.061100	5742	5788	0	46	46	1.0000000
NODE_109_length_6171_cov_36.061100	5761	5841	0	80	80	1.0000000
NODE_110_length_6148_cov_58.915358	5602	5682	0	80	80	1.0000000
NODE_110_length_6148_cov_58.915358	5655	5735	0	80	80	1.0000000
NODE_112_length_6026_cov_17.775772	4124	4204	0	18	80	0.2250000
NODE_112_length_6026_cov_17.775772	4124	4204	2	43	80	0.5375000
NODE_112_length_6026_cov_17.775772	4124	4204	4	19	80	0.2375000
NODE_112_length_6026_cov_17.775772	4177	4257	0	47	80	0.5875000
NODE_112_length_6026_cov_17.775772	4177	4257	2	9	80	0.1125000
NODE_112_length_6026_cov_17.775772	4177	4257	4	21	80	0.2625000
NODE_112_length_6026_cov_17.775772	4177	4257	6	3	80	0.0375000
NODE_112_length_6026_cov_17.775772	4253	4333	4	1	80	0.0125000
NODE_112_length_6026_cov_17.775772	4253	4333	6	20	80	0.2500000
NODE_112_length_6026_cov_17.775772	4253	4333	8	10	80	0.1250000
NODE_112_length_6026_cov_17.775772	4253	4333	10	27	80	0.3375000
NODE_112_length_6026_cov_17.775772	4253	4333	14	14	80	0.1750000
NODE_112_length_6026_cov_17.775772	4253	4333	16	2	80	0.0250000
NODE_112_length_6026_cov_17.775772	4253	4333	18	6	80	0.0750000
NODE_112_length_6026_cov_17.775772	4306	4386	10	5	80	0.0625000
NODE_112_length_6026_cov_17.775772	4306	4386	12	3	80	0.0375000
NODE_112_length_6026_cov_17.775772	4306	4386	14	19	80	0.2375000
NODE_112_length_6026_cov_17.775772	4306	4386	16	2	80	0.0250000
NODE_112_length_6026_cov_17.775772	4306	4386	18	17	80	0.2125000
NODE_112_length_6026_cov_17.775772	4306	4386	20	34	80	0.4250000
NODE_124_length_5810_cov_24.750657	2064	2144	2	2	80	0.0250000
NODE_124_length_5810_cov_24.750657	2064	2144	3	6	80	0.0750000
NODE_124_length_5810_cov_24.750657	2064	2144	4	24	80	0.3000000
NODE_124_length_5810_cov_24.750657	2064	2144	5	5	80	0.0625000
NODE_124_length_5810_cov_24.750657	2064	2144	6	8	80	0.1000000
NODE_124_length_5810_cov_24.750657	2064	2144	8	4	80	0.0500000
NODE_124_length_5810_cov_24.750657	2064	2144	10	3	80	0.0375000
NODE_124_length_5810_cov_24.750657	2064	2144	14	2	80	0.0250000
NODE_124_length_5810_cov_24.750657	2064	2144	16	2	80	0.0250000
NODE_124_length_5810_cov_24.750657	2064	2144	20	1	80	0.0125000
NODE_124_length_5810_cov_24.750657	2064	2144	22	1	80	0.0125000
NODE_124_length_5810_cov_24.750657	2064	2144	24	1	80	0.0125000
NODE_124_length_5810_cov_24.750657	2064	2144	26	3	80	0.0375000
NODE_124_length_5810_cov_24.750657	2064	2144	28	1	80	0.0125000
NODE_124_length_5810_cov_24.750657	2064	2144	30	4	80	0.0500000
NODE_124_length_5810_cov_24.750657	2064	2144	34	2	80	0.0250000
NODE_124_length_5810_cov_24.750657	2064	2144	38	8	80	0.1000000
NODE_124_length_5810_cov_24.750657	2064	2144	40	1	80	0.0125000
NODE_124_length_5810_cov_24.750657	2064	2144	42	2	80	0.0250000
NODE_124_length_5810_cov_24.750657	2117	2194	2	2	77	0.0259740
NODE_124_length_5810_cov_24.750657	2117	2194	4	16	77	0.2077922
NODE_124_length_5810_cov_24.750657	2117	2194	5	1	77	0.0129870
NODE_124_length_5810_cov_24.750657	2117	2194	6	58	77	0.7532467
NODE_127_length_5771_cov_10.854549	2814	2883	2	18	69	0.2608696
NODE_127_length_5771_cov_10.854549	2814	2883	4	32	69	0.4637681
NODE_127_length_5771_cov_10.854549	2814	2883	5	19	69	0.2753623
NODE_128_length_5769_cov_6.878483	5701	5731	0	30	30	1.0000000
NODE_133_length_5728_cov_16.351039	63	134	5	44	71	0.6197183
NODE_133_length_5728_cov_16.351039	63	134	6	27	71	0.3802817
NODE_133_length_5728_cov_16.351039	2960	3040	1	7	80	0.0875000
NODE_133_length_5728_cov_16.351039	2960	3040	2	10	80	0.1250000
NODE_133_length_5728_cov_16.351039	2960	3040	3	1	80	0.0125000
NODE_133_length_5728_cov_16.351039	2960	3040	5	16	80	0.2000000
NODE_133_length_5728_cov_16.351039	2960	3040	7	46	80	0.5750000
NODE_133_length_5728_cov_16.351039	5106	5172	44	2	66	0.0303030
NODE_133_length_5728_cov_16.351039	5106	5172	46	7	66	0.1060606
NODE_133_length_5728_cov_16.351039	5106	5172	47	1	66	0.0151515
NODE_133_length_5728_cov_16.351039	5106	5172	50	5	66	0.0757576
NODE_133_length_5728_cov_16.351039	5106	5172	51	6	66	0.0909091
NODE_133_length_5728_cov_16.351039	5106	5172	52	1	66	0.0151515
NODE_133_length_5728_cov_16.351039	5106	5172	53	8	66	0.1212121
NODE_133_length_5728_cov_16.351039	5106	5172	54	2	66	0.0303030
NODE_133_length_5728_cov_16.351039	5106	5172	55	4	66	0.0606061
NODE_133_length_5728_cov_16.351039	5106	5172	56	3	66	0.0454545
NODE_133_length_5728_cov_16.351039	5106	5172	58	1	66	0.0151515
NODE_133_length_5728_cov_16.351039	5106	5172	60	4	66	0.0606061
NODE_133_length_5728_cov_16.351039	5106	5172	62	3	66	0.0454545
NODE_133_length_5728_cov_16.351039	5106	5172	66	1	66	0.0151515
NODE_133_length_5728_cov_16.351039	5106	5172	69	1	66	0.0151515
NODE_133_length_5728_cov_16.351039	5106	5172	72	2	66	0.0303030
NODE_133_length_5728_cov_16.351039	5106	5172	74	3	66	0.0454545
NODE_133_length_5728_cov_16.351039	5106	5172	75	1	66	0.0151515
NODE_133_length_5728_cov_16.351039	5106	5172	80	4	66	0.0606061
NODE_133_length_5728_cov_16.351039	5106	5172	84	1	66	0.0151515
NODE_133_length_5728_cov_16.351039	5106	5172	86	6	66	0.0909091
NODE_133_length_5728_cov_16.351039	5145	5225	58	1	80	0.0125000
NODE_133_length_5728_cov_16.351039	5145	5225	60	4	80	0.0500000
NODE_133_length_5728_cov_16.351039	5145	5225	62	3	80	0.0375000
NODE_133_length_5728_cov_16.351039	5145	5225	66	1	80	0.0125000
NODE_133_length_5728_cov_16.351039	5145	5225	69	1	80	0.0125000
NODE_133_length_5728_cov_16.351039	5145	5225	72	2	80	0.0250000
NODE_133_length_5728_cov_16.351039	5145	5225	74	3	80	0.0375000
NODE_133_length_5728_cov_16.351039	5145	5225	75	1	80	0.0125000
NODE_133_length_5728_cov_16.351039	5145	5225	80	4	80	0.0500000
NODE_133_length_5728_cov_16.351039	5145	5225	84	1	80	0.0125000
NODE_133_length_5728_cov_16.351039	5145	5225	86	6	80	0.0750000
NODE_133_length_5728_cov_16.351039	5145	5225	88	1	80	0.0125000
NODE_133_length_5728_cov_16.351039	5145	5225	90	1	80	0.0125000
NODE_133_length_5728_cov_16.351039	5145	5225	92	5	80	0.0625000
NODE_133_length_5728_cov_16.351039	5145	5225	94	2	80	0.0250000
NODE_133_length_5728_cov_16.351039	5145	5225	96	1	80	0.0125000
NODE_133_length_5728_cov_16.351039	5145	5225	102	3	80	0.0375000
NODE_133_length_5728_cov_16.351039	5145	5225	104	1	80	0.0125000
NODE_133_length_5728_cov_16.351039	5145	5225	108	1	80	0.0125000
NODE_133_length_5728_cov_16.351039	5145	5225	114	2	80	0.0250000
NODE_133_length_5728_cov_16.351039	5145	5225	116	2	80	0.0250000
NODE_133_length_5728_cov_16.351039	5145	5225	118	1	80	0.0125000
NODE_133_length_5728_cov_16.351039	5145	5225	120	1	80	0.0125000
NODE_133_length_5728_cov_16.351039	5145	5225	124	1	80	0.0125000
NODE_133_length_5728_cov_16.351039	5145	5225	130	2	80	0.0250000
NODE_133_length_5728_cov_16.351039	5145	5225	131	3	80	0.0375000
NODE_133_length_5728_cov_16.351039	5145	5225	133	4	80	0.0500000
NODE_133_length_5728_cov_16.351039	5145	5225	135	5	80	0.0625000
NODE_133_length_5728_cov_16.351039	5145	5225	137	7	80	0.0875000
NODE_133_length_5728_cov_16.351039	5145	5225	138	3	80	0.0375000
NODE_133_length_5728_cov_16.351039	5145	5225	139	6	80	0.0750000
NODE_133_length_5728_cov_16.351039	5145	5225	141	1	80	0.0125000
NODE_137_length_5696_cov_20.656244	179	258	0	42	79	0.5316456
NODE_137_length_5696_cov_20.656244	179	258	2	37	79	0.4683544
NODE_137_length_5696_cov_20.656244	231	311	0	9	80	0.1125000
NODE_137_length_5696_cov_20.656244	231	311	2	71	80	0.8875000
NODE_137_length_5696_cov_20.656244	307	387	2	73	80	0.9125000
NODE_137_length_5696_cov_20.656244	307	387	4	7	80	0.0875000
NODE_137_length_5696_cov_20.656244	360	440	0	5	80	0.0625000
NODE_137_length_5696_cov_20.656244	360	440	2	75	80	0.9375000
NODE_137_length_5696_cov_20.656244	5100	5180	0	48	80	0.6000000
NODE_137_length_5696_cov_20.656244	5100	5180	2	32	80	0.4000000
NODE_137_length_5696_cov_20.656244	5153	5233	0	7	80	0.0875000
NODE_137_length_5696_cov_20.656244	5153	5233	2	73	80	0.9125000
NODE_137_length_5696_cov_20.656244	5280	5360	0	69	80	0.8625000
NODE_137_length_5696_cov_20.656244	5280	5360	2	11	80	0.1375000
NODE_137_length_5696_cov_20.656244	5333	5413	0	16	80	0.2000000
NODE_137_length_5696_cov_20.656244	5333	5413	2	64	80	0.8000000
NODE_139_length_5681_cov_68.065030	253	333	8	16	80	0.2000000
NODE_139_length_5681_cov_68.065030	253	333	20	1	80	0.0125000
NODE_139_length_5681_cov_68.065030	253	333	22	18	80	0.2250000
NODE_139_length_5681_cov_68.065030	253	333	23	25	80	0.3125000
NODE_139_length_5681_cov_68.065030	253	333	24	20	80	0.2500000
NODE_139_length_5681_cov_68.065030	306	386	4	1	80	0.0125000
NODE_139_length_5681_cov_68.065030	306	386	9	2	80	0.0250000
NODE_139_length_5681_cov_68.065030	306	386	10	5	80	0.0625000
NODE_139_length_5681_cov_68.065030	306	386	12	23	80	0.2875000
NODE_139_length_5681_cov_68.065030	306	386	13	7	80	0.0875000
NODE_139_length_5681_cov_68.065030	306	386	14	3	80	0.0375000
NODE_139_length_5681_cov_68.065030	306	386	16	3	80	0.0375000
NODE_139_length_5681_cov_68.065030	306	386	22	9	80	0.1125000
NODE_139_length_5681_cov_68.065030	306	386	23	25	80	0.3125000
NODE_139_length_5681_cov_68.065030	306	386	24	2	80	0.0250000
NODE_139_length_5681_cov_68.065030	4762	4842	79	4	80	0.0500000
NODE_139_length_5681_cov_68.065030	4762	4842	81	1	80	0.0125000
NODE_139_length_5681_cov_68.065030	4762	4842	83	1	80	0.0125000
NODE_139_length_5681_cov_68.065030	4762	4842	93	1	80	0.0125000
NODE_139_length_5681_cov_68.065030	4762	4842	94	3	80	0.0375000
NODE_139_length_5681_cov_68.065030	4762	4842	95	5	80	0.0625000
NODE_139_length_5681_cov_68.065030	4762	4842	103	2	80	0.0250000
NODE_139_length_5681_cov_68.065030	4762	4842	104	2	80	0.0250000
NODE_139_length_5681_cov_68.065030	4762	4842	105	1	80	0.0125000
NODE_139_length_5681_cov_68.065030	4762	4842	106	2	80	0.0250000
NODE_139_length_5681_cov_68.065030	4762	4842	108	3	80	0.0375000
NODE_139_length_5681_cov_68.065030	4762	4842	110	2	80	0.0250000
NODE_139_length_5681_cov_68.065030	4762	4842	111	1	80	0.0125000
NODE_139_length_5681_cov_68.065030	4762	4842	112	2	80	0.0250000
NODE_139_length_5681_cov_68.065030	4762	4842	115	3	80	0.0375000
NODE_139_length_5681_cov_68.065030	4762	4842	116	3	80	0.0375000
NODE_139_length_5681_cov_68.065030	4762	4842	118	1	80	0.0125000
NODE_139_length_5681_cov_68.065030	4762	4842	119	3	80	0.0375000
NODE_139_length_5681_cov_68.065030	4762	4842	120	2	80	0.0250000
NODE_139_length_5681_cov_68.065030	4762	4842	121	1	80	0.0125000
NODE_139_length_5681_cov_68.065030	4762	4842	123	2	80	0.0250000
NODE_139_length_5681_cov_68.065030	4762	4842	124	11	80	0.1375000
NODE_139_length_5681_cov_68.065030	4762	4842	125	11	80	0.1375000
NODE_139_length_5681_cov_68.065030	4762	4842	126	4	80	0.0500000
NODE_139_length_5681_cov_68.065030	4762	4842	127	2	80	0.0250000
NODE_139_length_5681_cov_68.065030	4762	4842	128	7	80	0.0875000
NODE_139_length_5681_cov_68.065030	4762	4842	79	4	80	0.0500000
NODE_139_length_5681_cov_68.065030	4762	4842	81	1	80	0.0125000
NODE_139_length_5681_cov_68.065030	4762	4842	83	1	80	0.0125000
NODE_139_length_5681_cov_68.065030	4762	4842	93	1	80	0.0125000
NODE_139_length_5681_cov_68.065030	4762	4842	94	3	80	0.0375000
NODE_139_length_5681_cov_68.065030	4762	4842	95	5	80	0.0625000
NODE_139_length_5681_cov_68.065030	4762	4842	103	2	80	0.0250000
NODE_139_length_5681_cov_68.065030	4762	4842	104	2	80	0.0250000
NODE_139_length_5681_cov_68.065030	4762	4842	105	1	80	0.0125000
NODE_139_length_5681_cov_68.065030	4762	4842	106	2	80	0.0250000
NODE_139_length_5681_cov_68.065030	4762	4842	108	3	80	0.0375000
NODE_139_length_5681_cov_68.065030	4762	4842	110	2	80	0.0250000
NODE_139_length_5681_cov_68.065030	4762	4842	111	1	80	0.0125000
NODE_139_length_5681_cov_68.065030	4762	4842	112	2	80	0.0250000
NODE_139_length_5681_cov_68.065030	4762	4842	115	3	80	0.0375000
NODE_139_length_5681_cov_68.065030	4762	4842	116	3	80	0.0375000
NODE_139_length_5681_cov_68.065030	4762	4842	118	1	80	0.0125000
NODE_139_length_5681_cov_68.065030	4762	4842	119	3	80	0.0375000
NODE_139_length_5681_cov_68.065030	4762	4842	120	2	80	0.0250000
NODE_139_length_5681_cov_68.065030	4762	4842	121	1	80	0.0125000
NODE_139_length_5681_cov_68.065030	4762	4842	123	2	80	0.0250000
NODE_139_length_5681_cov_68.065030	4762	4842	124	11	80	0.1375000
NODE_139_length_5681_cov_68.065030	4762	4842	125	11	80	0.1375000
NODE_139_length_5681_cov_68.065030	4762	4842	126	4	80	0.0500000
NODE_139_length_5681_cov_68.065030	4762	4842	127	2	80	0.0250000
NODE_139_length_5681_cov_68.065030	4762	4842	128	7	80	0.0875000
NODE_139_length_5681_cov_68.065030	4762	4842	79	4	80	0.0500000
NODE_139_length_5681_cov_68.065030	4762	4842	81	1	80	0.0125000
NODE_139_length_5681_cov_68.065030	4762	4842	83	1	80	0.0125000
NODE_139_length_5681_cov_68.065030	4762	4842	93	1	80	0.0125000
NODE_139_length_5681_cov_68.065030	4762	4842	94	3	80	0.0375000
NODE_139_length_5681_cov_68.065030	4762	4842	95	5	80	0.0625000
NODE_139_length_5681_cov_68.065030	4762	4842	103	2	80	0.0250000
NODE_139_length_5681_cov_68.065030	4762	4842	104	2	80	0.0250000
NODE_139_length_5681_cov_68.065030	4762	4842	105	1	80	0.0125000
NODE_139_length_5681_cov_68.065030	4762	4842	106	2	80	0.0250000
NODE_139_length_5681_cov_68.065030	4762	4842	108	3	80	0.0375000
NODE_139_length_5681_cov_68.065030	4762	4842	110	2	80	0.0250000
NODE_139_length_5681_cov_68.065030	4762	4842	111	1	80	0.0125000
NODE_139_length_5681_cov_68.065030	4762	4842	112	2	80	0.0250000
NODE_139_length_5681_cov_68.065030	4762	4842	115	3	80	0.0375000
NODE_139_length_5681_cov_68.065030	4762	4842	116	3	80	0.0375000
NODE_139_length_5681_cov_68.065030	4762	4842	118	1	80	0.0125000
NODE_139_length_5681_cov_68.065030	4762	4842	119	3	80	0.0375000
NODE_139_length_5681_cov_68.065030	4762	4842	120	2	80	0.0250000
NODE_139_length_5681_cov_68.065030	4762	4842	121	1	80	0.0125000
NODE_139_length_5681_cov_68.065030	4762	4842	123	2	80	0.0250000
NODE_139_length_5681_cov_68.065030	4762	4842	124	11	80	0.1375000
NODE_139_length_5681_cov_68.065030	4762	4842	125	11	80	0.1375000
NODE_139_length_5681_cov_68.065030	4762	4842	126	4	80	0.0500000
NODE_139_length_5681_cov_68.065030	4762	4842	127	2	80	0.0250000
NODE_139_length_5681_cov_68.065030	4762	4842	128	7	80	0.0875000
NODE_139_length_5681_cov_68.065030	4762	4842	79	4	80	0.0500000
NODE_139_length_5681_cov_68.065030	4762	4842	81	1	80	0.0125000
NODE_139_length_5681_cov_68.065030	4762	4842	83	1	80	0.0125000
NODE_139_length_5681_cov_68.065030	4762	4842	93	1	80	0.0125000
NODE_139_length_5681_cov_68.065030	4762	4842	94	3	80	0.0375000
NODE_139_length_5681_cov_68.065030	4762	4842	95	5	80	0.0625000
NODE_139_length_5681_cov_68.065030	4762	4842	103	2	80	0.0250000
NODE_139_length_5681_cov_68.065030	4762	4842	104	2	80	0.0250000
NODE_139_length_5681_cov_68.065030	4762	4842	105	1	80	0.0125000
NODE_139_length_5681_cov_68.065030	4762	4842	106	2	80	0.0250000
NODE_139_length_5681_cov_68.065030	4762	4842	108	3	80	0.0375000
NODE_139_length_5681_cov_68.065030	4762	4842	110	2	80	0.0250000
NODE_139_length_5681_cov_68.065030	4762	4842	111	1	80	0.0125000
NODE_139_length_5681_cov_68.065030	4762	4842	112	2	80	0.0250000
NODE_139_length_5681_cov_68.065030	4762	4842	115	3	80	0.0375000
NODE_139_length_5681_cov_68.065030	4762	4842	116	3	80	0.0375000
NODE_139_length_5681_cov_68.065030	4762	4842	118	1	80	0.0125000
NODE_139_length_5681_cov_68.065030	4762	4842	119	3	80	0.0375000
NODE_139_length_5681_cov_68.065030	4762	4842	120	2	80	0.0250000
NODE_139_length_5681_cov_68.065030	4762	4842	121	1	80	0.0125000
NODE_139_length_5681_cov_68.065030	4762	4842	123	2	80	0.0250000
NODE_139_length_5681_cov_68.065030	4762	4842	124	11	80	0.1375000
NODE_139_length_5681_cov_68.065030	4762	4842	125	11	80	0.1375000
NODE_139_length_5681_cov_68.065030	4762	4842	126	4	80	0.0500000
NODE_139_length_5681_cov_68.065030	4762	4842	127	2	80	0.0250000
NODE_139_length_5681_cov_68.065030	4762	4842	128	7	80	0.0875000
NODE_139_length_5681_cov_68.065030	4762	4842	79	4	80	0.0500000
NODE_139_length_5681_cov_68.065030	4762	4842	81	1	80	0.0125000
NODE_139_length_5681_cov_68.065030	4762	4842	83	1	80	0.0125000
NODE_139_length_5681_cov_68.065030	4762	4842	93	1	80	0.0125000
NODE_139_length_5681_cov_68.065030	4762	4842	94	3	80	0.0375000
NODE_139_length_5681_cov_68.065030	4762	4842	95	5	80	0.0625000
NODE_139_length_5681_cov_68.065030	4762	4842	103	2	80	0.0250000
NODE_139_length_5681_cov_68.065030	4762	4842	104	2	80	0.0250000
NODE_139_length_5681_cov_68.065030	4762	4842	105	1	80	0.0125000
NODE_139_length_5681_cov_68.065030	4762	4842	106	2	80	0.0250000
NODE_139_length_5681_cov_68.065030	4762	4842	108	3	80	0.0375000
NODE_139_length_5681_cov_68.065030	4762	4842	110	2	80	0.0250000
NODE_139_length_5681_cov_68.065030	4762	4842	111	1	80	0.0125000
NODE_139_length_5681_cov_68.065030	4762	4842	112	2	80	0.0250000
NODE_139_length_5681_cov_68.065030	4762	4842	115	3	80	0.0375000
NODE_139_length_5681_cov_68.065030	4762	4842	116	3	80	0.0375000
NODE_139_length_5681_cov_68.065030	4762	4842	118	1	80	0.0125000
NODE_139_length_5681_cov_68.065030	4762	4842	119	3	80	0.0375000
NODE_139_length_5681_cov_68.065030	4762	4842	120	2	80	0.0250000
NODE_139_length_5681_cov_68.065030	4762	4842	121	1	80	0.0125000
NODE_139_length_5681_cov_68.065030	4762	4842	123	2	80	0.0250000
NODE_139_length_5681_cov_68.065030	4762	4842	124	11	80	0.1375000
NODE_139_length_5681_cov_68.065030	4762	4842	125	11	80	0.1375000
NODE_139_length_5681_cov_68.065030	4762	4842	126	4	80	0.0500000
NODE_139_length_5681_cov_68.065030	4762	4842	127	2	80	0.0250000
NODE_139_length_5681_cov_68.065030	4762	4842	128	7	80	0.0875000
NODE_139_length_5681_cov_68.065030	4762	4842	79	4	80	0.0500000
NODE_139_length_5681_cov_68.065030	4762	4842	81	1	80	0.0125000
NODE_139_length_5681_cov_68.065030	4762	4842	83	1	80	0.0125000
NODE_139_length_5681_cov_68.065030	4762	4842	93	1	80	0.0125000
NODE_139_length_5681_cov_68.065030	4762	4842	94	3	80	0.0375000
NODE_139_length_5681_cov_68.065030	4762	4842	95	5	80	0.0625000
NODE_139_length_5681_cov_68.065030	4762	4842	103	2	80	0.0250000
NODE_139_length_5681_cov_68.065030	4762	4842	104	2	80	0.0250000
NODE_139_length_5681_cov_68.065030	4762	4842	105	1	80	0.0125000
NODE_139_length_5681_cov_68.065030	4762	4842	106	2	80	0.0250000
NODE_139_length_5681_cov_68.065030	4762	4842	108	3	80	0.0375000
NODE_139_length_5681_cov_68.065030	4762	4842	110	2	80	0.0250000
NODE_139_length_5681_cov_68.065030	4762	4842	111	1	80	0.0125000
NODE_139_length_5681_cov_68.065030	4762	4842	112	2	80	0.0250000
NODE_139_length_5681_cov_68.065030	4762	4842	115	3	80	0.0375000
NODE_139_length_5681_cov_68.065030	4762	4842	116	3	80	0.0375000
NODE_139_length_5681_cov_68.065030	4762	4842	118	1	80	0.0125000
NODE_139_length_5681_cov_68.065030	4762	4842	119	3	80	0.0375000
NODE_139_length_5681_cov_68.065030	4762	4842	120	2	80	0.0250000
NODE_139_length_5681_cov_68.065030	4762	4842	121	1	80	0.0125000
NODE_139_length_5681_cov_68.065030	4762	4842	123	2	80	0.0250000
NODE_139_length_5681_cov_68.065030	4762	4842	124	11	80	0.1375000
NODE_139_length_5681_cov_68.065030	4762	4842	125	11	80	0.1375000
NODE_139_length_5681_cov_68.065030	4762	4842	126	4	80	0.0500000
NODE_139_length_5681_cov_68.065030	4762	4842	127	2	80	0.0250000
NODE_139_length_5681_cov_68.065030	4762	4842	128	7	80	0.0875000
NODE_139_length_5681_cov_68.065030	4769	4839	79	1	70	0.0142857
NODE_139_length_5681_cov_68.065030	4769	4839	81	1	70	0.0142857
NODE_139_length_5681_cov_68.065030	4769	4839	83	1	70	0.0142857
NODE_139_length_5681_cov_68.065030	4769	4839	93	1	70	0.0142857
NODE_139_length_5681_cov_68.065030	4769	4839	94	3	70	0.0428571
NODE_139_length_5681_cov_68.065030	4769	4839	95	5	70	0.0714286
NODE_139_length_5681_cov_68.065030	4769	4839	103	2	70	0.0285714
NODE_139_length_5681_cov_68.065030	4769	4839	104	2	70	0.0285714
NODE_139_length_5681_cov_68.065030	4769	4839	106	2	70	0.0285714
NODE_139_length_5681_cov_68.065030	4769	4839	108	3	70	0.0428571
NODE_139_length_5681_cov_68.065030	4769	4839	110	2	70	0.0285714
NODE_139_length_5681_cov_68.065030	4769	4839	111	1	70	0.0142857
NODE_139_length_5681_cov_68.065030	4769	4839	112	2	70	0.0285714
NODE_139_length_5681_cov_68.065030	4769	4839	115	3	70	0.0428571
NODE_139_length_5681_cov_68.065030	4769	4839	116	3	70	0.0428571
NODE_139_length_5681_cov_68.065030	4769	4839	118	1	70	0.0142857
NODE_139_length_5681_cov_68.065030	4769	4839	120	2	70	0.0285714
NODE_139_length_5681_cov_68.065030	4769	4839	121	1	70	0.0142857
NODE_139_length_5681_cov_68.065030	4769	4839	123	2	70	0.0285714
NODE_139_length_5681_cov_68.065030	4769	4839	124	11	70	0.1571429
NODE_139_length_5681_cov_68.065030	4769	4839	125	8	70	0.1142857
NODE_139_length_5681_cov_68.065030	4769	4839	126	4	70	0.0571429
NODE_139_length_5681_cov_68.065030	4769	4839	127	2	70	0.0285714
NODE_139_length_5681_cov_68.065030	4769	4839	128	7	70	0.1000000
NODE_139_length_5681_cov_68.065030	4771	4842	79	4	71	0.0563380
NODE_139_length_5681_cov_68.065030	4771	4842	81	1	71	0.0140845
NODE_139_length_5681_cov_68.065030	4771	4842	83	1	71	0.0140845
NODE_139_length_5681_cov_68.065030	4771	4842	93	1	71	0.0140845
NODE_139_length_5681_cov_68.065030	4771	4842	94	3	71	0.0422535
NODE_139_length_5681_cov_68.065030	4771	4842	95	5	71	0.0704225
NODE_139_length_5681_cov_68.065030	4771	4842	103	2	71	0.0281690
NODE_139_length_5681_cov_68.065030	4771	4842	104	2	71	0.0281690
NODE_139_length_5681_cov_68.065030	4771	4842	106	2	71	0.0281690
NODE_139_length_5681_cov_68.065030	4771	4842	108	3	71	0.0422535
NODE_139_length_5681_cov_68.065030	4771	4842	110	2	71	0.0281690
NODE_139_length_5681_cov_68.065030	4771	4842	111	1	71	0.0140845
NODE_139_length_5681_cov_68.065030	4771	4842	112	2	71	0.0281690
NODE_139_length_5681_cov_68.065030	4771	4842	115	3	71	0.0422535
NODE_139_length_5681_cov_68.065030	4771	4842	116	3	71	0.0422535
NODE_139_length_5681_cov_68.065030	4771	4842	118	1	71	0.0140845
NODE_139_length_5681_cov_68.065030	4771	4842	120	2	71	0.0281690
NODE_139_length_5681_cov_68.065030	4771	4842	121	1	71	0.0140845
NODE_139_length_5681_cov_68.065030	4771	4842	123	2	71	0.0281690
NODE_139_length_5681_cov_68.065030	4771	4842	124	11	71	0.1549296
NODE_139_length_5681_cov_68.065030	4771	4842	125	7	71	0.0985916
NODE_139_length_5681_cov_68.065030	4771	4842	126	3	71	0.0422535
NODE_139_length_5681_cov_68.065030	4771	4842	127	2	71	0.0281690
NODE_139_length_5681_cov_68.065030	4771	4842	128	7	71	0.0985916
NODE_139_length_5681_cov_68.065030	4815	4895	44	21	80	0.2625000
NODE_139_length_5681_cov_68.065030	4815	4895	46	1	80	0.0125000
NODE_139_length_5681_cov_68.065030	4815	4895	49	8	80	0.1000000
NODE_139_length_5681_cov_68.065030	4815	4895	50	1	80	0.0125000
NODE_139_length_5681_cov_68.065030	4815	4895	51	3	80	0.0375000
NODE_139_length_5681_cov_68.065030	4815	4895	53	1	80	0.0125000
NODE_139_length_5681_cov_68.065030	4815	4895	63	1	80	0.0125000
NODE_139_length_5681_cov_68.065030	4815	4895	64	1	80	0.0125000
NODE_139_length_5681_cov_68.065030	4815	4895	68	2	80	0.0250000
NODE_139_length_5681_cov_68.065030	4815	4895	70	3	80	0.0375000
NODE_139_length_5681_cov_68.065030	4815	4895	76	3	80	0.0375000
NODE_139_length_5681_cov_68.065030	4815	4895	77	6	80	0.0750000
NODE_139_length_5681_cov_68.065030	4815	4895	79	6	80	0.0750000
NODE_139_length_5681_cov_68.065030	4815	4895	81	1	80	0.0125000
NODE_139_length_5681_cov_68.065030	4815	4895	83	1	80	0.0125000
NODE_139_length_5681_cov_68.065030	4815	4895	93	1	80	0.0125000
NODE_139_length_5681_cov_68.065030	4815	4895	94	3	80	0.0375000
NODE_139_length_5681_cov_68.065030	4815	4895	95	5	80	0.0625000
NODE_139_length_5681_cov_68.065030	4815	4895	103	2	80	0.0250000
NODE_139_length_5681_cov_68.065030	4815	4895	104	2	80	0.0250000
NODE_139_length_5681_cov_68.065030	4815	4895	106	2	80	0.0250000
NODE_139_length_5681_cov_68.065030	4815	4895	108	3	80	0.0375000
NODE_139_length_5681_cov_68.065030	4815	4895	110	2	80	0.0250000
NODE_139_length_5681_cov_68.065030	4815	4895	111	1	80	0.0125000
NODE_139_length_5681_cov_68.065030	4815	4895	44	21	80	0.2625000
NODE_139_length_5681_cov_68.065030	4815	4895	46	1	80	0.0125000
NODE_139_length_5681_cov_68.065030	4815	4895	49	8	80	0.1000000
NODE_139_length_5681_cov_68.065030	4815	4895	50	1	80	0.0125000
NODE_139_length_5681_cov_68.065030	4815	4895	51	3	80	0.0375000
NODE_139_length_5681_cov_68.065030	4815	4895	53	1	80	0.0125000
NODE_139_length_5681_cov_68.065030	4815	4895	63	1	80	0.0125000
NODE_139_length_5681_cov_68.065030	4815	4895	64	1	80	0.0125000
NODE_139_length_5681_cov_68.065030	4815	4895	68	2	80	0.0250000
NODE_139_length_5681_cov_68.065030	4815	4895	70	3	80	0.0375000
NODE_139_length_5681_cov_68.065030	4815	4895	76	3	80	0.0375000
NODE_139_length_5681_cov_68.065030	4815	4895	77	6	80	0.0750000
NODE_139_length_5681_cov_68.065030	4815	4895	79	6	80	0.0750000
NODE_139_length_5681_cov_68.065030	4815	4895	81	1	80	0.0125000
NODE_139_length_5681_cov_68.065030	4815	4895	83	1	80	0.0125000
NODE_139_length_5681_cov_68.065030	4815	4895	93	1	80	0.0125000
NODE_139_length_5681_cov_68.065030	4815	4895	94	3	80	0.0375000
NODE_139_length_5681_cov_68.065030	4815	4895	95	5	80	0.0625000
NODE_139_length_5681_cov_68.065030	4815	4895	103	2	80	0.0250000
NODE_139_length_5681_cov_68.065030	4815	4895	104	2	80	0.0250000
NODE_139_length_5681_cov_68.065030	4815	4895	106	2	80	0.0250000
NODE_139_length_5681_cov_68.065030	4815	4895	108	3	80	0.0375000
NODE_139_length_5681_cov_68.065030	4815	4895	110	2	80	0.0250000
NODE_139_length_5681_cov_68.065030	4815	4895	111	1	80	0.0125000
NODE_139_length_5681_cov_68.065030	4815	4895	44	21	80	0.2625000
NODE_139_length_5681_cov_68.065030	4815	4895	46	1	80	0.0125000
NODE_139_length_5681_cov_68.065030	4815	4895	49	8	80	0.1000000
NODE_139_length_5681_cov_68.065030	4815	4895	50	1	80	0.0125000
NODE_139_length_5681_cov_68.065030	4815	4895	51	3	80	0.0375000
NODE_139_length_5681_cov_68.065030	4815	4895	53	1	80	0.0125000
NODE_139_length_5681_cov_68.065030	4815	4895	63	1	80	0.0125000
NODE_139_length_5681_cov_68.065030	4815	4895	64	1	80	0.0125000
NODE_139_length_5681_cov_68.065030	4815	4895	68	2	80	0.0250000
NODE_139_length_5681_cov_68.065030	4815	4895	70	3	80	0.0375000
NODE_139_length_5681_cov_68.065030	4815	4895	76	3	80	0.0375000
NODE_139_length_5681_cov_68.065030	4815	4895	77	6	80	0.0750000
NODE_139_length_5681_cov_68.065030	4815	4895	79	6	80	0.0750000
NODE_139_length_5681_cov_68.065030	4815	4895	81	1	80	0.0125000
NODE_139_length_5681_cov_68.065030	4815	4895	83	1	80	0.0125000
NODE_139_length_5681_cov_68.065030	4815	4895	93	1	80	0.0125000
NODE_139_length_5681_cov_68.065030	4815	4895	94	3	80	0.0375000
NODE_139_length_5681_cov_68.065030	4815	4895	95	5	80	0.0625000
NODE_139_length_5681_cov_68.065030	4815	4895	103	2	80	0.0250000
NODE_139_length_5681_cov_68.065030	4815	4895	104	2	80	0.0250000
NODE_139_length_5681_cov_68.065030	4815	4895	106	2	80	0.0250000
NODE_139_length_5681_cov_68.065030	4815	4895	108	3	80	0.0375000
NODE_139_length_5681_cov_68.065030	4815	4895	110	2	80	0.0250000
NODE_139_length_5681_cov_68.065030	4815	4895	111	1	80	0.0125000
NODE_139_length_5681_cov_68.065030	4815	4895	44	21	80	0.2625000
NODE_139_length_5681_cov_68.065030	4815	4895	46	1	80	0.0125000
NODE_139_length_5681_cov_68.065030	4815	4895	49	8	80	0.1000000
NODE_139_length_5681_cov_68.065030	4815	4895	50	1	80	0.0125000
NODE_139_length_5681_cov_68.065030	4815	4895	51	3	80	0.0375000
NODE_139_length_5681_cov_68.065030	4815	4895	53	1	80	0.0125000
NODE_139_length_5681_cov_68.065030	4815	4895	63	1	80	0.0125000
NODE_139_length_5681_cov_68.065030	4815	4895	64	1	80	0.0125000
NODE_139_length_5681_cov_68.065030	4815	4895	68	2	80	0.0250000
NODE_139_length_5681_cov_68.065030	4815	4895	70	3	80	0.0375000
NODE_139_length_5681_cov_68.065030	4815	4895	76	3	80	0.0375000
NODE_139_length_5681_cov_68.065030	4815	4895	77	6	80	0.0750000
NODE_139_length_5681_cov_68.065030	4815	4895	79	6	80	0.0750000
NODE_139_length_5681_cov_68.065030	4815	4895	81	1	80	0.0125000
NODE_139_length_5681_cov_68.065030	4815	4895	83	1	80	0.0125000
NODE_139_length_5681_cov_68.065030	4815	4895	93	1	80	0.0125000
NODE_139_length_5681_cov_68.065030	4815	4895	94	3	80	0.0375000
NODE_139_length_5681_cov_68.065030	4815	4895	95	5	80	0.0625000
NODE_139_length_5681_cov_68.065030	4815	4895	103	2	80	0.0250000
NODE_139_length_5681_cov_68.065030	4815	4895	104	2	80	0.0250000
NODE_139_length_5681_cov_68.065030	4815	4895	106	2	80	0.0250000
NODE_139_length_5681_cov_68.065030	4815	4895	108	3	80	0.0375000
NODE_139_length_5681_cov_68.065030	4815	4895	110	2	80	0.0250000
NODE_139_length_5681_cov_68.065030	4815	4895	111	1	80	0.0125000
NODE_139_length_5681_cov_68.065030	4815	4895	44	21	80	0.2625000
NODE_139_length_5681_cov_68.065030	4815	4895	46	1	80	0.0125000
NODE_139_length_5681_cov_68.065030	4815	4895	49	8	80	0.1000000
NODE_139_length_5681_cov_68.065030	4815	4895	50	1	80	0.0125000
NODE_139_length_5681_cov_68.065030	4815	4895	51	3	80	0.0375000
NODE_139_length_5681_cov_68.065030	4815	4895	53	1	80	0.0125000
NODE_139_length_5681_cov_68.065030	4815	4895	63	1	80	0.0125000
NODE_139_length_5681_cov_68.065030	4815	4895	64	1	80	0.0125000
NODE_139_length_5681_cov_68.065030	4815	4895	68	2	80	0.0250000
NODE_139_length_5681_cov_68.065030	4815	4895	70	3	80	0.0375000
NODE_139_length_5681_cov_68.065030	4815	4895	76	3	80	0.0375000
NODE_139_length_5681_cov_68.065030	4815	4895	77	6	80	0.0750000
NODE_139_length_5681_cov_68.065030	4815	4895	79	6	80	0.0750000
NODE_139_length_5681_cov_68.065030	4815	4895	81	1	80	0.0125000
NODE_139_length_5681_cov_68.065030	4815	4895	83	1	80	0.0125000
NODE_139_length_5681_cov_68.065030	4815	4895	93	1	80	0.0125000
NODE_139_length_5681_cov_68.065030	4815	4895	94	3	80	0.0375000
NODE_139_length_5681_cov_68.065030	4815	4895	95	5	80	0.0625000
NODE_139_length_5681_cov_68.065030	4815	4895	103	2	80	0.0250000
NODE_139_length_5681_cov_68.065030	4815	4895	104	2	80	0.0250000
NODE_139_length_5681_cov_68.065030	4815	4895	106	2	80	0.0250000
NODE_139_length_5681_cov_68.065030	4815	4895	108	3	80	0.0375000
NODE_139_length_5681_cov_68.065030	4815	4895	110	2	80	0.0250000
NODE_139_length_5681_cov_68.065030	4815	4895	111	1	80	0.0125000
NODE_139_length_5681_cov_68.065030	4815	4895	44	21	80	0.2625000
NODE_139_length_5681_cov_68.065030	4815	4895	46	1	80	0.0125000
NODE_139_length_5681_cov_68.065030	4815	4895	49	8	80	0.1000000
NODE_139_length_5681_cov_68.065030	4815	4895	50	1	80	0.0125000
NODE_139_length_5681_cov_68.065030	4815	4895	51	3	80	0.0375000
NODE_139_length_5681_cov_68.065030	4815	4895	53	1	80	0.0125000
NODE_139_length_5681_cov_68.065030	4815	4895	63	1	80	0.0125000
NODE_139_length_5681_cov_68.065030	4815	4895	64	1	80	0.0125000
NODE_139_length_5681_cov_68.065030	4815	4895	68	2	80	0.0250000
NODE_139_length_5681_cov_68.065030	4815	4895	70	3	80	0.0375000
NODE_139_length_5681_cov_68.065030	4815	4895	76	3	80	0.0375000
NODE_139_length_5681_cov_68.065030	4815	4895	77	6	80	0.0750000
NODE_139_length_5681_cov_68.065030	4815	4895	79	6	80	0.0750000
NODE_139_length_5681_cov_68.065030	4815	4895	81	1	80	0.0125000
NODE_139_length_5681_cov_68.065030	4815	4895	83	1	80	0.0125000
NODE_139_length_5681_cov_68.065030	4815	4895	93	1	80	0.0125000
NODE_139_length_5681_cov_68.065030	4815	4895	94	3	80	0.0375000
NODE_139_length_5681_cov_68.065030	4815	4895	95	5	80	0.0625000
NODE_139_length_5681_cov_68.065030	4815	4895	103	2	80	0.0250000
NODE_139_length_5681_cov_68.065030	4815	4895	104	2	80	0.0250000
NODE_139_length_5681_cov_68.065030	4815	4895	106	2	80	0.0250000
NODE_139_length_5681_cov_68.065030	4815	4895	108	3	80	0.0375000
NODE_139_length_5681_cov_68.065030	4815	4895	110	2	80	0.0250000
NODE_139_length_5681_cov_68.065030	4815	4895	111	1	80	0.0125000
NODE_139_length_5681_cov_68.065030	4891	4971	4	1	80	0.0125000
NODE_139_length_5681_cov_68.065030	4891	4971	8	40	80	0.5000000
NODE_139_length_5681_cov_68.065030	4891	4971	10	8	80	0.1000000
NODE_139_length_5681_cov_68.065030	4891	4971	11	1	80	0.0125000
NODE_139_length_5681_cov_68.065030	4891	4971	13	1	80	0.0125000
NODE_139_length_5681_cov_68.065030	4891	4971	14	3	80	0.0375000
NODE_139_length_5681_cov_68.065030	4891	4971	16	4	80	0.0500000
NODE_139_length_5681_cov_68.065030	4891	4971	18	3	80	0.0375000
NODE_139_length_5681_cov_68.065030	4891	4971	30	1	80	0.0125000
NODE_139_length_5681_cov_68.065030	4891	4971	32	2	80	0.0250000
NODE_139_length_5681_cov_68.065030	4891	4971	34	4	80	0.0500000
NODE_139_length_5681_cov_68.065030	4891	4971	38	6	80	0.0750000
NODE_139_length_5681_cov_68.065030	4891	4971	44	6	80	0.0750000
NODE_139_length_5681_cov_68.065030	4944	5007	4	37	63	0.5873016
NODE_139_length_5681_cov_68.065030	4944	5007	8	26	63	0.4126984
NODE_139_length_5681_cov_68.065030	4944	5024	4	54	80	0.6750000
NODE_139_length_5681_cov_68.065030	4944	5024	8	26	80	0.3250000
NODE_140_length_5677_cov_21.613482	1792	1863	52	1	71	0.0140845
NODE_140_length_5677_cov_21.613482	1792	1863	54	2	71	0.0281690
NODE_140_length_5677_cov_21.613482	1792	1863	56	4	71	0.0563380
NODE_140_length_5677_cov_21.613482	1792	1863	57	1	71	0.0140845
NODE_140_length_5677_cov_21.613482	1792	1863	58	2	71	0.0281690
NODE_140_length_5677_cov_21.613482	1792	1863	61	1	71	0.0140845
NODE_140_length_5677_cov_21.613482	1792	1863	62	2	71	0.0281690
NODE_140_length_5677_cov_21.613482	1792	1863	63	2	71	0.0281690
NODE_140_length_5677_cov_21.613482	1792	1863	64	3	71	0.0422535
NODE_140_length_5677_cov_21.613482	1792	1863	65	7	71	0.0985916
NODE_140_length_5677_cov_21.613482	1792	1863	66	6	71	0.0845070
NODE_140_length_5677_cov_21.613482	1792	1863	67	1	71	0.0140845
NODE_140_length_5677_cov_21.613482	1792	1863	68	5	71	0.0704225
NODE_140_length_5677_cov_21.613482	1792	1863	70	1	71	0.0140845
NODE_140_length_5677_cov_21.613482	1792	1863	74	2	71	0.0281690
NODE_140_length_5677_cov_21.613482	1792	1863	77	1	71	0.0140845
NODE_140_length_5677_cov_21.613482	1792	1863	79	9	71	0.1267606
NODE_140_length_5677_cov_21.613482	1792	1863	80	10	71	0.1408451
NODE_140_length_5677_cov_21.613482	1792	1863	81	2	71	0.0281690
NODE_140_length_5677_cov_21.613482	1792	1863	82	7	71	0.0985916
NODE_140_length_5677_cov_21.613482	1792	1863	83	2	71	0.0281690
NODE_140_length_5677_cov_21.613482	1845	1916	50	5	71	0.0704225
NODE_140_length_5677_cov_21.613482	1845	1916	52	3	71	0.0422535
NODE_140_length_5677_cov_21.613482	1845	1916	54	4	71	0.0563380
NODE_140_length_5677_cov_21.613482	1845	1916	58	2	71	0.0281690
NODE_140_length_5677_cov_21.613482	1845	1916	66	1	71	0.0140845
NODE_140_length_5677_cov_21.613482	1845	1916	68	2	71	0.0281690
NODE_140_length_5677_cov_21.613482	1845	1916	70	7	71	0.0985916
NODE_140_length_5677_cov_21.613482	1845	1916	74	1	71	0.0140845
NODE_140_length_5677_cov_21.613482	1845	1916	76	2	71	0.0281690
NODE_140_length_5677_cov_21.613482	1845	1916	78	1	71	0.0140845
NODE_140_length_5677_cov_21.613482	1845	1916	79	1	71	0.0140845
NODE_140_length_5677_cov_21.613482	1845	1916	80	25	71	0.3521127
NODE_140_length_5677_cov_21.613482	1845	1916	82	15	71	0.2112676
NODE_140_length_5677_cov_21.613482	1845	1916	84	2	71	0.0281690
NODE_142_length_5631_cov_25.927332	96	176	8	12	80	0.1500000
NODE_142_length_5631_cov_25.927332	96	176	10	55	80	0.6875000
NODE_142_length_5631_cov_25.927332	96	176	12	13	80	0.1625000
NODE_142_length_5631_cov_25.927332	149	229	6	19	80	0.2375000
NODE_142_length_5631_cov_25.927332	149	229	8	5	80	0.0625000
NODE_142_length_5631_cov_25.927332	149	229	10	56	80	0.7000000
NODE_146_length_5588_cov_40.961377	2793	2873	2	34	80	0.4250000
NODE_146_length_5588_cov_40.961377	2793	2873	4	46	80	0.5750000
NODE_146_length_5588_cov_40.961377	2846	2926	2	34	80	0.4250000
NODE_146_length_5588_cov_40.961377	2846	2926	3	22	80	0.2750000
NODE_146_length_5588_cov_40.961377	2846	2926	4	18	80	0.2250000
NODE_146_length_5588_cov_40.961377	2846	2926	7	6	80	0.0750000
NODE_146_length_5588_cov_40.961377	2922	3002	5	1	80	0.0125000
NODE_146_length_5588_cov_40.961377	2922	3002	7	33	80	0.4125000
NODE_146_length_5588_cov_40.961377	2922	3002	11	5	80	0.0625000
NODE_146_length_5588_cov_40.961377	2922	3002	13	13	80	0.1625000
NODE_146_length_5588_cov_40.961377	2922	3002	14	28	80	0.3500000
NODE_146_length_5588_cov_40.961377	2975	3055	9	2	80	0.0250000
NODE_146_length_5588_cov_40.961377	2975	3055	11	3	80	0.0375000
NODE_146_length_5588_cov_40.961377	2975	3055	12	1	80	0.0125000
NODE_146_length_5588_cov_40.961377	2975	3055	13	1	80	0.0125000
NODE_146_length_5588_cov_40.961377	2975	3055	14	73	80	0.9125000
NODE_149_length_5578_cov_5.173389	331	411	0	80	80	1.0000000
NODE_149_length_5578_cov_5.173389	388	464	0	33	76	0.4342105
NODE_149_length_5578_cov_5.173389	388	464	2	43	76	0.5657895
NODE_150_length_5572_cov_79.124246	1555	1627	10	4	72	0.0555556
NODE_150_length_5572_cov_79.124246	1555	1627	11	1	72	0.0138889
NODE_150_length_5572_cov_79.124246	1555	1627	12	14	72	0.1944444
NODE_150_length_5572_cov_79.124246	1555	1627	13	8	72	0.1111111
NODE_150_length_5572_cov_79.124246	1555	1627	14	7	72	0.0972222
NODE_150_length_5572_cov_79.124246	1555	1627	15	2	72	0.0277778
NODE_150_length_5572_cov_79.124246	1555	1627	16	1	72	0.0138889
NODE_150_length_5572_cov_79.124246	1555	1627	18	1	72	0.0138889
NODE_150_length_5572_cov_79.124246	1555	1627	23	1	72	0.0138889
NODE_150_length_5572_cov_79.124246	1555	1627	34	2	72	0.0277778
NODE_150_length_5572_cov_79.124246	1555	1627	35	1	72	0.0138889
NODE_150_length_5572_cov_79.124246	1555	1627	38	1	72	0.0138889
NODE_150_length_5572_cov_79.124246	1555	1627	46	1	72	0.0138889
NODE_150_length_5572_cov_79.124246	1555	1627	48	1	72	0.0138889
NODE_150_length_5572_cov_79.124246	1555	1627	53	1	72	0.0138889
NODE_150_length_5572_cov_79.124246	1555	1627	55	1	72	0.0138889
NODE_150_length_5572_cov_79.124246	1555	1627	57	1	72	0.0138889
NODE_150_length_5572_cov_79.124246	1555	1627	61	1	72	0.0138889
NODE_150_length_5572_cov_79.124246	1555	1627	65	2	72	0.0277778
NODE_150_length_5572_cov_79.124246	1555	1627	67	1	72	0.0138889
NODE_150_length_5572_cov_79.124246	1555	1627	74	4	72	0.0555556
NODE_150_length_5572_cov_79.124246	1555	1627	81	1	72	0.0138889
NODE_150_length_5572_cov_79.124246	1555	1627	93	1	72	0.0138889
NODE_150_length_5572_cov_79.124246	1555	1627	94	2	72	0.0277778
NODE_150_length_5572_cov_79.124246	1555	1627	100	2	72	0.0277778
NODE_150_length_5572_cov_79.124246	1555	1627	102	1	72	0.0138889
NODE_150_length_5572_cov_79.124246	1555	1627	107	1	72	0.0138889
NODE_150_length_5572_cov_79.124246	1555	1627	108	1	72	0.0138889
NODE_150_length_5572_cov_79.124246	1555	1627	113	1	72	0.0138889
NODE_150_length_5572_cov_79.124246	1555	1627	117	1	72	0.0138889
NODE_150_length_5572_cov_79.124246	1555	1627	118	1	72	0.0138889
NODE_150_length_5572_cov_79.124246	1555	1627	123	1	72	0.0138889
NODE_150_length_5572_cov_79.124246	1555	1627	135	1	72	0.0138889
NODE_150_length_5572_cov_79.124246	1555	1627	137	1	72	0.0138889
NODE_150_length_5572_cov_79.124246	1555	1627	145	1	72	0.0138889
NODE_150_length_5572_cov_79.124246	1603	1680	61	1	77	0.0129870
NODE_150_length_5572_cov_79.124246	1603	1680	65	2	77	0.0259740
NODE_150_length_5572_cov_79.124246	1603	1680	67	1	77	0.0129870
NODE_150_length_5572_cov_79.124246	1603	1680	74	4	77	0.0519481
NODE_150_length_5572_cov_79.124246	1603	1680	81	1	77	0.0129870
NODE_150_length_5572_cov_79.124246	1603	1680	93	1	77	0.0129870
NODE_150_length_5572_cov_79.124246	1603	1680	94	2	77	0.0259740
NODE_150_length_5572_cov_79.124246	1603	1680	100	2	77	0.0259740
NODE_150_length_5572_cov_79.124246	1603	1680	102	1	77	0.0129870
NODE_150_length_5572_cov_79.124246	1603	1680	107	1	77	0.0129870
NODE_150_length_5572_cov_79.124246	1603	1680	108	1	77	0.0129870
NODE_150_length_5572_cov_79.124246	1603	1680	113	1	77	0.0129870
NODE_150_length_5572_cov_79.124246	1603	1680	117	1	77	0.0129870
NODE_150_length_5572_cov_79.124246	1603	1680	118	1	77	0.0129870
NODE_150_length_5572_cov_79.124246	1603	1680	123	1	77	0.0129870
NODE_150_length_5572_cov_79.124246	1603	1680	135	1	77	0.0129870
NODE_150_length_5572_cov_79.124246	1603	1680	137	1	77	0.0129870
NODE_150_length_5572_cov_79.124246	1603	1680	145	1	77	0.0129870
NODE_150_length_5572_cov_79.124246	1603	1680	147	1	77	0.0129870
NODE_150_length_5572_cov_79.124246	1603	1680	149	1	77	0.0129870
NODE_150_length_5572_cov_79.124246	1603	1680	150	1	77	0.0129870
NODE_150_length_5572_cov_79.124246	1603	1680	160	1	77	0.0129870
NODE_150_length_5572_cov_79.124246	1603	1680	161	1	77	0.0129870
NODE_150_length_5572_cov_79.124246	1603	1680	169	1	77	0.0129870
NODE_150_length_5572_cov_79.124246	1603	1680	178	1	77	0.0129870
NODE_150_length_5572_cov_79.124246	1603	1680	188	1	77	0.0129870
NODE_150_length_5572_cov_79.124246	1603	1680	198	1	77	0.0129870
NODE_150_length_5572_cov_79.124246	1603	1680	203	1	77	0.0129870
NODE_150_length_5572_cov_79.124246	1603	1680	218	1	77	0.0129870
NODE_150_length_5572_cov_79.124246	1603	1680	221	1	77	0.0129870
NODE_150_length_5572_cov_79.124246	1603	1680	230	1	77	0.0129870
NODE_150_length_5572_cov_79.124246	1603	1680	235	1	77	0.0129870
NODE_150_length_5572_cov_79.124246	1603	1680	245	1	77	0.0129870
NODE_150_length_5572_cov_79.124246	1603	1680	256	1	77	0.0129870
NODE_150_length_5572_cov_79.124246	1603	1680	275	1	77	0.0129870
NODE_150_length_5572_cov_79.124246	1603	1680	280	1	77	0.0129870
NODE_150_length_5572_cov_79.124246	1603	1680	310	1	77	0.0129870
NODE_150_length_5572_cov_79.124246	1603	1680	323	1	77	0.0129870
NODE_150_length_5572_cov_79.124246	1603	1680	336	1	77	0.0129870
NODE_150_length_5572_cov_79.124246	1603	1680	340	1	77	0.0129870
NODE_150_length_5572_cov_79.124246	1603	1680	350	1	77	0.0129870
NODE_150_length_5572_cov_79.124246	1603	1680	355	1	77	0.0129870
NODE_150_length_5572_cov_79.124246	1603	1680	368	1	77	0.0129870
NODE_150_length_5572_cov_79.124246	1603	1680	381	1	77	0.0129870
NODE_150_length_5572_cov_79.124246	1603	1680	387	1	77	0.0129870
NODE_150_length_5572_cov_79.124246	1603	1680	399	1	77	0.0129870
NODE_150_length_5572_cov_79.124246	1603	1680	418	1	77	0.0129870
NODE_150_length_5572_cov_79.124246	1603	1680	427	1	77	0.0129870
NODE_150_length_5572_cov_79.124246	1603	1680	435	1	77	0.0129870
NODE_150_length_5572_cov_79.124246	1603	1680	442	1	77	0.0129870
NODE_150_length_5572_cov_79.124246	1603	1680	450	1	77	0.0129870
NODE_150_length_5572_cov_79.124246	1603	1680	460	1	77	0.0129870
NODE_150_length_5572_cov_79.124246	1603	1680	464	1	77	0.0129870
NODE_150_length_5572_cov_79.124246	1603	1680	479	1	77	0.0129870
NODE_150_length_5572_cov_79.124246	1603	1680	483	1	77	0.0129870
NODE_150_length_5572_cov_79.124246	1603	1680	488	1	77	0.0129870
NODE_150_length_5572_cov_79.124246	1603	1680	493	1	77	0.0129870
NODE_150_length_5572_cov_79.124246	1603	1680	498	1	77	0.0129870
NODE_150_length_5572_cov_79.124246	1603	1680	507	1	77	0.0129870
NODE_150_length_5572_cov_79.124246	1603	1680	520	1	77	0.0129870
NODE_150_length_5572_cov_79.124246	1603	1680	526	1	77	0.0129870
NODE_150_length_5572_cov_79.124246	1603	1680	530	1	77	0.0129870
NODE_150_length_5572_cov_79.124246	1603	1680	533	1	77	0.0129870
NODE_150_length_5572_cov_79.124246	1603	1680	546	1	77	0.0129870
NODE_150_length_5572_cov_79.124246	1603	1680	557	1	77	0.0129870
NODE_150_length_5572_cov_79.124246	1603	1680	580	1	77	0.0129870
NODE_150_length_5572_cov_79.124246	1603	1680	601	1	77	0.0129870
NODE_150_length_5572_cov_79.124246	1603	1680	626	1	77	0.0129870
NODE_150_length_5572_cov_79.124246	1603	1680	658	1	77	0.0129870
NODE_150_length_5572_cov_79.124246	1603	1680	679	1	77	0.0129870
NODE_150_length_5572_cov_79.124246	1603	1680	687	1	77	0.0129870
NODE_150_length_5572_cov_79.124246	1637	1717	218	1	80	0.0125000
NODE_150_length_5572_cov_79.124246	1637	1717	221	1	80	0.0125000
NODE_150_length_5572_cov_79.124246	1637	1717	230	1	80	0.0125000
NODE_150_length_5572_cov_79.124246	1637	1717	235	1	80	0.0125000
NODE_150_length_5572_cov_79.124246	1637	1717	245	1	80	0.0125000
NODE_150_length_5572_cov_79.124246	1637	1717	256	1	80	0.0125000
NODE_150_length_5572_cov_79.124246	1637	1717	275	1	80	0.0125000
NODE_150_length_5572_cov_79.124246	1637	1717	280	1	80	0.0125000
NODE_150_length_5572_cov_79.124246	1637	1717	310	1	80	0.0125000
NODE_150_length_5572_cov_79.124246	1637	1717	323	1	80	0.0125000
NODE_150_length_5572_cov_79.124246	1637	1717	336	1	80	0.0125000
NODE_150_length_5572_cov_79.124246	1637	1717	340	1	80	0.0125000
NODE_150_length_5572_cov_79.124246	1637	1717	350	1	80	0.0125000
NODE_150_length_5572_cov_79.124246	1637	1717	355	1	80	0.0125000
NODE_150_length_5572_cov_79.124246	1637	1717	368	1	80	0.0125000
NODE_150_length_5572_cov_79.124246	1637	1717	381	1	80	0.0125000
NODE_150_length_5572_cov_79.124246	1637	1717	387	1	80	0.0125000
NODE_150_length_5572_cov_79.124246	1637	1717	399	1	80	0.0125000
NODE_150_length_5572_cov_79.124246	1637	1717	418	1	80	0.0125000
NODE_150_length_5572_cov_79.124246	1637	1717	427	1	80	0.0125000
NODE_150_length_5572_cov_79.124246	1637	1717	435	1	80	0.0125000
NODE_150_length_5572_cov_79.124246	1637	1717	442	1	80	0.0125000
NODE_150_length_5572_cov_79.124246	1637	1717	450	1	80	0.0125000
NODE_150_length_5572_cov_79.124246	1637	1717	460	1	80	0.0125000
NODE_150_length_5572_cov_79.124246	1637	1717	464	1	80	0.0125000
NODE_150_length_5572_cov_79.124246	1637	1717	479	1	80	0.0125000
NODE_150_length_5572_cov_79.124246	1637	1717	483	1	80	0.0125000
NODE_150_length_5572_cov_79.124246	1637	1717	488	1	80	0.0125000
NODE_150_length_5572_cov_79.124246	1637	1717	493	1	80	0.0125000
NODE_150_length_5572_cov_79.124246	1637	1717	498	1	80	0.0125000
NODE_150_length_5572_cov_79.124246	1637	1717	507	1	80	0.0125000
NODE_150_length_5572_cov_79.124246	1637	1717	520	1	80	0.0125000
NODE_150_length_5572_cov_79.124246	1637	1717	526	1	80	0.0125000
NODE_150_length_5572_cov_79.124246	1637	1717	530	1	80	0.0125000
NODE_150_length_5572_cov_79.124246	1637	1717	533	1	80	0.0125000
NODE_150_length_5572_cov_79.124246	1637	1717	546	1	80	0.0125000
NODE_150_length_5572_cov_79.124246	1637	1717	557	1	80	0.0125000
NODE_150_length_5572_cov_79.124246	1637	1717	580	1	80	0.0125000
NODE_150_length_5572_cov_79.124246	1637	1717	601	1	80	0.0125000
NODE_150_length_5572_cov_79.124246	1637	1717	626	1	80	0.0125000
NODE_150_length_5572_cov_79.124246	1637	1717	658	1	80	0.0125000
NODE_150_length_5572_cov_79.124246	1637	1717	679	1	80	0.0125000
NODE_150_length_5572_cov_79.124246	1637	1717	687	1	80	0.0125000
NODE_150_length_5572_cov_79.124246	1637	1717	695	1	80	0.0125000
NODE_150_length_5572_cov_79.124246	1637	1717	701	1	80	0.0125000
NODE_150_length_5572_cov_79.124246	1637	1717	708	1	80	0.0125000
NODE_150_length_5572_cov_79.124246	1637	1717	738	1	80	0.0125000
NODE_150_length_5572_cov_79.124246	1637	1717	739	1	80	0.0125000
NODE_150_length_5572_cov_79.124246	1637	1717	743	1	80	0.0125000
NODE_150_length_5572_cov_79.124246	1637	1717	749	1	80	0.0125000
NODE_150_length_5572_cov_79.124246	1637	1717	767	1	80	0.0125000
NODE_150_length_5572_cov_79.124246	1637	1717	786	1	80	0.0125000
NODE_150_length_5572_cov_79.124246	1637	1717	803	1	80	0.0125000
NODE_150_length_5572_cov_79.124246	1637	1717	807	1	80	0.0125000
NODE_150_length_5572_cov_79.124246	1637	1717	817	1	80	0.0125000
NODE_150_length_5572_cov_79.124246	1637	1717	834	1	80	0.0125000
NODE_150_length_5572_cov_79.124246	1637	1717	845	1	80	0.0125000
NODE_150_length_5572_cov_79.124246	1637	1717	853	1	80	0.0125000
NODE_150_length_5572_cov_79.124246	1637	1717	879	1	80	0.0125000
NODE_150_length_5572_cov_79.124246	1637	1717	885	1	80	0.0125000
NODE_150_length_5572_cov_79.124246	1637	1717	894	1	80	0.0125000
NODE_150_length_5572_cov_79.124246	1637	1717	913	1	80	0.0125000
NODE_150_length_5572_cov_79.124246	1637	1717	922	1	80	0.0125000
NODE_150_length_5572_cov_79.124246	1637	1717	930	1	80	0.0125000
NODE_150_length_5572_cov_79.124246	1637	1717	934	1	80	0.0125000
NODE_150_length_5572_cov_79.124246	1637	1717	938	1	80	0.0125000
NODE_150_length_5572_cov_79.124246	1637	1717	939	1	80	0.0125000
NODE_150_length_5572_cov_79.124246	1637	1717	941	1	80	0.0125000
NODE_150_length_5572_cov_79.124246	1637	1717	942	1	80	0.0125000
NODE_150_length_5572_cov_79.124246	1637	1717	943	1	80	0.0125000
NODE_150_length_5572_cov_79.124246	1637	1717	950	2	80	0.0250000
NODE_150_length_5572_cov_79.124246	1637	1717	960	1	80	0.0125000
NODE_150_length_5572_cov_79.124246	1637	1717	962	2	80	0.0250000
NODE_150_length_5572_cov_79.124246	1637	1717	969	1	80	0.0125000
NODE_150_length_5572_cov_79.124246	1637	1717	971	1	80	0.0125000
NODE_150_length_5572_cov_79.124246	1637	1717	972	2	80	0.0250000
NODE_150_length_5572_cov_79.124246	1637	1717	974	1	80	0.0125000
NODE_150_length_5572_cov_79.124246	1690	1770	631	1	80	0.0125000
NODE_150_length_5572_cov_79.124246	1690	1770	643	1	80	0.0125000
NODE_150_length_5572_cov_79.124246	1690	1770	679	1	80	0.0125000
NODE_150_length_5572_cov_79.124246	1690	1770	701	1	80	0.0125000
NODE_150_length_5572_cov_79.124246	1690	1770	737	1	80	0.0125000
NODE_150_length_5572_cov_79.124246	1690	1770	749	1	80	0.0125000
NODE_150_length_5572_cov_79.124246	1690	1770	764	1	80	0.0125000
NODE_150_length_5572_cov_79.124246	1690	1770	771	1	80	0.0125000
NODE_150_length_5572_cov_79.124246	1690	1770	782	1	80	0.0125000
NODE_150_length_5572_cov_79.124246	1690	1770	788	1	80	0.0125000
NODE_150_length_5572_cov_79.124246	1690	1770	794	1	80	0.0125000
NODE_150_length_5572_cov_79.124246	1690	1770	802	1	80	0.0125000
NODE_150_length_5572_cov_79.124246	1690	1770	807	1	80	0.0125000
NODE_150_length_5572_cov_79.124246	1690	1770	810	1	80	0.0125000
NODE_150_length_5572_cov_79.124246	1690	1770	817	1	80	0.0125000
NODE_150_length_5572_cov_79.124246	1690	1770	825	1	80	0.0125000
NODE_150_length_5572_cov_79.124246	1690	1770	827	1	80	0.0125000
NODE_150_length_5572_cov_79.124246	1690	1770	834	1	80	0.0125000
NODE_150_length_5572_cov_79.124246	1690	1770	837	1	80	0.0125000
NODE_150_length_5572_cov_79.124246	1690	1770	843	1	80	0.0125000
NODE_150_length_5572_cov_79.124246	1690	1770	845	1	80	0.0125000
NODE_150_length_5572_cov_79.124246	1690	1770	848	1	80	0.0125000
NODE_150_length_5572_cov_79.124246	1690	1770	853	1	80	0.0125000
NODE_150_length_5572_cov_79.124246	1690	1770	859	1	80	0.0125000
NODE_150_length_5572_cov_79.124246	1690	1770	861	1	80	0.0125000
NODE_150_length_5572_cov_79.124246	1690	1770	863	1	80	0.0125000
NODE_150_length_5572_cov_79.124246	1690	1770	877	1	80	0.0125000
NODE_150_length_5572_cov_79.124246	1690	1770	879	1	80	0.0125000
NODE_150_length_5572_cov_79.124246	1690	1770	885	1	80	0.0125000
NODE_150_length_5572_cov_79.124246	1690	1770	889	1	80	0.0125000
NODE_150_length_5572_cov_79.124246	1690	1770	894	1	80	0.0125000
NODE_150_length_5572_cov_79.124246	1690	1770	897	1	80	0.0125000
NODE_150_length_5572_cov_79.124246	1690	1770	904	1	80	0.0125000
NODE_150_length_5572_cov_79.124246	1690	1770	910	1	80	0.0125000
NODE_150_length_5572_cov_79.124246	1690	1770	913	1	80	0.0125000
NODE_150_length_5572_cov_79.124246	1690	1770	922	1	80	0.0125000
NODE_150_length_5572_cov_79.124246	1690	1770	927	1	80	0.0125000
NODE_150_length_5572_cov_79.124246	1690	1770	930	1	80	0.0125000
NODE_150_length_5572_cov_79.124246	1690	1770	934	1	80	0.0125000
NODE_150_length_5572_cov_79.124246	1690	1770	936	1	80	0.0125000
NODE_150_length_5572_cov_79.124246	1690	1770	938	2	80	0.0250000
NODE_150_length_5572_cov_79.124246	1690	1770	939	1	80	0.0125000
NODE_150_length_5572_cov_79.124246	1690	1770	941	1	80	0.0125000
NODE_150_length_5572_cov_79.124246	1690	1770	942	1	80	0.0125000
NODE_150_length_5572_cov_79.124246	1690	1770	943	1	80	0.0125000
NODE_150_length_5572_cov_79.124246	1690	1770	946	2	80	0.0250000
NODE_150_length_5572_cov_79.124246	1690	1770	947	1	80	0.0125000
NODE_150_length_5572_cov_79.124246	1690	1770	950	2	80	0.0250000
NODE_150_length_5572_cov_79.124246	1690	1770	958	1	80	0.0125000
NODE_150_length_5572_cov_79.124246	1690	1770	960	2	80	0.0250000
NODE_150_length_5572_cov_79.124246	1690	1770	961	1	80	0.0125000
NODE_150_length_5572_cov_79.124246	1690	1770	962	2	80	0.0250000
NODE_150_length_5572_cov_79.124246	1690	1770	967	1	80	0.0125000
NODE_150_length_5572_cov_79.124246	1690	1770	968	1	80	0.0125000
NODE_150_length_5572_cov_79.124246	1690	1770	969	1	80	0.0125000
NODE_150_length_5572_cov_79.124246	1690	1770	971	1	80	0.0125000
NODE_150_length_5572_cov_79.124246	1690	1770	972	3	80	0.0375000
NODE_150_length_5572_cov_79.124246	1690	1770	974	2	80	0.0250000
NODE_150_length_5572_cov_79.124246	1690	1770	976	1	80	0.0125000
NODE_150_length_5572_cov_79.124246	1690	1770	977	2	80	0.0250000
NODE_150_length_5572_cov_79.124246	1690	1770	979	2	80	0.0250000
NODE_150_length_5572_cov_79.124246	1690	1770	981	1	80	0.0125000
NODE_150_length_5572_cov_79.124246	1690	1770	982	1	80	0.0125000
NODE_150_length_5572_cov_79.124246	1690	1770	983	3	80	0.0375000
NODE_150_length_5572_cov_79.124246	1690	1770	984	3	80	0.0375000
NODE_150_length_5572_cov_79.124246	1690	1770	985	1	80	0.0125000
NODE_150_length_5572_cov_79.124246	5130	5210	0	80	80	1.0000000
NODE_150_length_5572_cov_79.124246	5183	5263	0	29	80	0.3625000
NODE_150_length_5572_cov_79.124246	5183	5263	2	51	80	0.6375000
NODE_151_length_5557_cov_26.198241	341	414	0	22	73	0.3013699
NODE_151_length_5557_cov_26.198241	341	414	2	30	73	0.4109589
NODE_151_length_5557_cov_26.198241	341	414	4	21	73	0.2876712
NODE_151_length_5557_cov_26.198241	394	460	0	66	66	1.0000000
NODE_156_length_5500_cov_35.832438	81	161	2	4	80	0.0500000
NODE_156_length_5500_cov_35.832438	81	161	4	1	80	0.0125000
NODE_156_length_5500_cov_35.832438	81	161	6	11	80	0.1375000
NODE_156_length_5500_cov_35.832438	81	161	8	64	80	0.8000000
NODE_156_length_5500_cov_35.832438	134	214	4	5	80	0.0625000
NODE_156_length_5500_cov_35.832438	134	214	6	6	80	0.0750000
NODE_156_length_5500_cov_35.832438	134	214	8	69	80	0.8625000
NODE_159_length_5470_cov_5.987526	5180	5249	0	69	69	1.0000000
NODE_160_length_5434_cov_14.997751	541	621	0	76	80	0.9500000
NODE_160_length_5434_cov_14.997751	541	621	2	4	80	0.0500000
NODE_160_length_5434_cov_14.997751	594	674	0	23	80	0.2875000
NODE_160_length_5434_cov_14.997751	594	674	2	57	80	0.7125000
NODE_160_length_5434_cov_14.997751	2664	2744	2	80	80	1.0000000
NODE_160_length_5434_cov_14.997751	2717	2797	1	6	80	0.0750000
NODE_160_length_5434_cov_14.997751	2717	2797	2	74	80	0.9250000
NODE_160_length_5434_cov_14.997751	3041	3093	2	52	52	1.0000000
NODE_160_length_5434_cov_14.997751	3419	3467	8	23	48	0.4791667
NODE_160_length_5434_cov_14.997751	3419	3467	10	13	48	0.2708333
NODE_160_length_5434_cov_14.997751	3419	3467	12	12	48	0.2500000
NODE_161_length_5425_cov_15.812242	141	218	5	9	77	0.1168831
NODE_161_length_5425_cov_15.812242	141	218	7	2	77	0.0259740
NODE_161_length_5425_cov_15.812242	141	218	8	3	77	0.0389610
NODE_161_length_5425_cov_15.812242	141	218	10	2	77	0.0259740
NODE_161_length_5425_cov_15.812242	141	218	11	14	77	0.1818182
NODE_161_length_5425_cov_15.812242	141	218	12	11	77	0.1428571
NODE_161_length_5425_cov_15.812242	141	218	14	6	77	0.0779221
NODE_161_length_5425_cov_15.812242	141	218	18	3	77	0.0389610
NODE_161_length_5425_cov_15.812242	141	218	20	4	77	0.0519481
NODE_161_length_5425_cov_15.812242	141	218	22	3	77	0.0389610
NODE_161_length_5425_cov_15.812242	141	218	24	5	77	0.0649351
NODE_161_length_5425_cov_15.812242	141	218	26	9	77	0.1168831
NODE_161_length_5425_cov_15.812242	141	218	28	5	77	0.0649351
NODE_161_length_5425_cov_15.812242	141	218	31	1	77	0.0129870
NODE_161_length_5425_cov_15.812242	841	921	0	8	80	0.1000000
NODE_161_length_5425_cov_15.812242	841	921	2	3	80	0.0375000
NODE_161_length_5425_cov_15.812242	841	921	4	21	80	0.2625000
NODE_161_length_5425_cov_15.812242	841	921	6	48	80	0.6000000
NODE_161_length_5425_cov_15.812242	894	974	0	61	80	0.7625000
NODE_161_length_5425_cov_15.812242	894	974	2	3	80	0.0375000
NODE_161_length_5425_cov_15.812242	894	974	4	16	80	0.2000000
NODE_163_length_5402_cov_5.397322	191	263	4	18	72	0.2500000
NODE_163_length_5402_cov_5.397322	191	263	6	54	72	0.7500000
NODE_163_length_5402_cov_5.397322	2305	2385	22	6	80	0.0750000
NODE_163_length_5402_cov_5.397322	2305	2385	24	6	80	0.0750000
NODE_163_length_5402_cov_5.397322	2305	2385	30	2	80	0.0250000
NODE_163_length_5402_cov_5.397322	2305	2385	33	7	80	0.0875000
NODE_163_length_5402_cov_5.397322	2305	2385	35	13	80	0.1625000
NODE_163_length_5402_cov_5.397322	2305	2385	36	2	80	0.0250000
NODE_163_length_5402_cov_5.397322	2305	2385	37	1	80	0.0125000
NODE_163_length_5402_cov_5.397322	2305	2385	38	8	80	0.1000000
NODE_163_length_5402_cov_5.397322	2305	2385	39	2	80	0.0250000
NODE_163_length_5402_cov_5.397322	2305	2385	40	18	80	0.2250000
NODE_163_length_5402_cov_5.397322	2305	2385	42	14	80	0.1750000
NODE_163_length_5402_cov_5.397322	2305	2385	44	1	80	0.0125000
NODE_163_length_5402_cov_5.397322	2358	2438	28	1	80	0.0125000
NODE_163_length_5402_cov_5.397322	2358	2438	30	1	80	0.0125000
NODE_163_length_5402_cov_5.397322	2358	2438	32	8	80	0.1000000
NODE_163_length_5402_cov_5.397322	2358	2438	35	9	80	0.1125000
NODE_163_length_5402_cov_5.397322	2358	2438	36	2	80	0.0250000
NODE_163_length_5402_cov_5.397322	2358	2438	37	3	80	0.0375000
NODE_163_length_5402_cov_5.397322	2358	2438	38	7	80	0.0875000
NODE_163_length_5402_cov_5.397322	2358	2438	39	6	80	0.0750000
NODE_163_length_5402_cov_5.397322	2358	2438	40	7	80	0.0875000
NODE_163_length_5402_cov_5.397322	2358	2438	41	17	80	0.2125000
NODE_163_length_5402_cov_5.397322	2358	2438	42	3	80	0.0375000
NODE_163_length_5402_cov_5.397322	2358	2438	43	4	80	0.0500000
NODE_163_length_5402_cov_5.397322	2358	2438	45	12	80	0.1500000
NODE_164_length_5383_cov_15.680545	205	285	2	32	80	0.4000000
NODE_164_length_5383_cov_15.680545	205	285	4	29	80	0.3625000
NODE_164_length_5383_cov_15.680545	205	285	8	19	80	0.2375000
NODE_164_length_5383_cov_15.680545	258	317	4	8	59	0.1355932
NODE_164_length_5383_cov_15.680545	258	317	6	17	59	0.2881356
NODE_164_length_5383_cov_15.680545	258	317	8	34	59	0.5762712
NODE_164_length_5383_cov_15.680545	2042	2122	12	5	80	0.0625000
NODE_164_length_5383_cov_15.680545	2042	2122	14	1	80	0.0125000
NODE_164_length_5383_cov_15.680545	2042	2122	16	74	80	0.9250000
NODE_164_length_5383_cov_15.680545	2095	2175	2	10	80	0.1250000
NODE_164_length_5383_cov_15.680545	2095	2175	4	7	80	0.0875000
NODE_164_length_5383_cov_15.680545	2095	2175	7	15	80	0.1875000
NODE_164_length_5383_cov_15.680545	2095	2175	12	2	80	0.0250000
NODE_164_length_5383_cov_15.680545	2095	2175	14	17	80	0.2125000
NODE_164_length_5383_cov_15.680545	2095	2175	16	29	80	0.3625000
NODE_165_length_5382_cov_16.894378	1301	1347	11	7	46	0.1521739
NODE_165_length_5382_cov_16.894378	1301	1347	12	11	46	0.2391304
NODE_165_length_5382_cov_16.894378	1301	1347	13	10	46	0.2173913
NODE_165_length_5382_cov_16.894378	1301	1347	14	4	46	0.0869565
NODE_165_length_5382_cov_16.894378	1301	1347	16	1	46	0.0217391
NODE_165_length_5382_cov_16.894378	1301	1347	18	4	46	0.0869565
NODE_165_length_5382_cov_16.894378	1301	1347	21	3	46	0.0652174
NODE_165_length_5382_cov_16.894378	1301	1347	23	6	46	0.1304348
NODE_165_length_5382_cov_16.894378	5056	5082	56	1	26	0.0384615
NODE_165_length_5382_cov_16.894378	5056	5082	57	1	26	0.0384615
NODE_165_length_5382_cov_16.894378	5056	5082	59	1	26	0.0384615
NODE_165_length_5382_cov_16.894378	5056	5082	66	1	26	0.0384615
NODE_165_length_5382_cov_16.894378	5056	5082	72	1	26	0.0384615
NODE_165_length_5382_cov_16.894378	5056	5082	75	3	26	0.1153846
NODE_165_length_5382_cov_16.894378	5056	5082	76	4	26	0.1538462
NODE_165_length_5382_cov_16.894378	5056	5082	85	1	26	0.0384615
NODE_165_length_5382_cov_16.894378	5056	5082	87	2	26	0.0769231
NODE_165_length_5382_cov_16.894378	5056	5082	91	1	26	0.0384615
NODE_165_length_5382_cov_16.894378	5056	5082	105	1	26	0.0384615
NODE_165_length_5382_cov_16.894378	5056	5082	111	1	26	0.0384615
NODE_165_length_5382_cov_16.894378	5056	5082	117	2	26	0.0769231
NODE_165_length_5382_cov_16.894378	5056	5082	119	1	26	0.0384615
NODE_165_length_5382_cov_16.894378	5056	5082	125	1	26	0.0384615
NODE_165_length_5382_cov_16.894378	5056	5082	130	1	26	0.0384615
NODE_165_length_5382_cov_16.894378	5056	5082	133	1	26	0.0384615
NODE_165_length_5382_cov_16.894378	5056	5082	137	1	26	0.0384615
NODE_165_length_5382_cov_16.894378	5056	5082	145	1	26	0.0384615
NODE_165_length_5382_cov_16.894378	5056	5115	56	1	59	0.0169492
NODE_165_length_5382_cov_16.894378	5056	5115	57	1	59	0.0169492
NODE_165_length_5382_cov_16.894378	5056	5115	59	1	59	0.0169492
NODE_165_length_5382_cov_16.894378	5056	5115	66	1	59	0.0169492
NODE_165_length_5382_cov_16.894378	5056	5115	72	1	59	0.0169492
NODE_165_length_5382_cov_16.894378	5056	5115	75	3	59	0.0508475
NODE_165_length_5382_cov_16.894378	5056	5115	76	4	59	0.0677966
NODE_165_length_5382_cov_16.894378	5056	5115	85	1	59	0.0169492
NODE_165_length_5382_cov_16.894378	5056	5115	87	2	59	0.0338983
NODE_165_length_5382_cov_16.894378	5056	5115	91	1	59	0.0169492
NODE_165_length_5382_cov_16.894378	5056	5115	105	1	59	0.0169492
NODE_165_length_5382_cov_16.894378	5056	5115	111	1	59	0.0169492
NODE_165_length_5382_cov_16.894378	5056	5115	117	2	59	0.0338983
NODE_165_length_5382_cov_16.894378	5056	5115	119	1	59	0.0169492
NODE_165_length_5382_cov_16.894378	5056	5115	125	1	59	0.0169492
NODE_165_length_5382_cov_16.894378	5056	5115	130	1	59	0.0169492
NODE_165_length_5382_cov_16.894378	5056	5115	133	1	59	0.0169492
NODE_165_length_5382_cov_16.894378	5056	5115	137	1	59	0.0169492
NODE_165_length_5382_cov_16.894378	5056	5115	145	1	59	0.0169492
NODE_165_length_5382_cov_16.894378	5056	5115	147	2	59	0.0338983
NODE_165_length_5382_cov_16.894378	5056	5115	155	3	59	0.0508475
NODE_165_length_5382_cov_16.894378	5056	5115	157	2	59	0.0338983
NODE_165_length_5382_cov_16.894378	5056	5115	159	3	59	0.0508475
NODE_165_length_5382_cov_16.894378	5056	5115	161	1	59	0.0169492
NODE_165_length_5382_cov_16.894378	5056	5115	165	1	59	0.0169492
NODE_165_length_5382_cov_16.894378	5056	5115	166	1	59	0.0169492
NODE_165_length_5382_cov_16.894378	5056	5115	168	2	59	0.0338983
NODE_165_length_5382_cov_16.894378	5056	5115	170	2	59	0.0338983
NODE_165_length_5382_cov_16.894378	5056	5115	173	1	59	0.0169492
NODE_165_length_5382_cov_16.894378	5056	5115	175	1	59	0.0169492
NODE_165_length_5382_cov_16.894378	5056	5115	190	2	59	0.0338983
NODE_165_length_5382_cov_16.894378	5056	5115	192	1	59	0.0169492
NODE_165_length_5382_cov_16.894378	5056	5115	194	1	59	0.0169492
NODE_165_length_5382_cov_16.894378	5056	5115	196	1	59	0.0169492
NODE_165_length_5382_cov_16.894378	5056	5115	198	1	59	0.0169492
NODE_165_length_5382_cov_16.894378	5056	5115	208	1	59	0.0169492
NODE_165_length_5382_cov_16.894378	5056	5115	211	1	59	0.0169492
NODE_165_length_5382_cov_16.894378	5056	5115	222	1	59	0.0169492
NODE_165_length_5382_cov_16.894378	5056	5115	224	3	59	0.0508475
NODE_165_length_5382_cov_16.894378	5056	5115	228	2	59	0.0338983
NODE_167_length_5339_cov_28.708969	3375	3455	2	6	80	0.0750000
NODE_167_length_5339_cov_28.708969	3375	3455	4	18	80	0.2250000
NODE_167_length_5339_cov_28.708969	3375	3455	5	14	80	0.1750000
NODE_167_length_5339_cov_28.708969	3375	3455	6	1	80	0.0125000
NODE_167_length_5339_cov_28.708969	3375	3455	8	6	80	0.0750000
NODE_167_length_5339_cov_28.708969	3375	3455	10	28	80	0.3500000
NODE_167_length_5339_cov_28.708969	3375	3455	12	4	80	0.0500000
NODE_167_length_5339_cov_28.708969	3375	3455	14	3	80	0.0375000
NODE_167_length_5339_cov_28.708969	3428	3508	8	6	80	0.0750000
NODE_167_length_5339_cov_28.708969	3428	3508	10	14	80	0.1750000
NODE_167_length_5339_cov_28.708969	3428	3508	12	4	80	0.0500000
NODE_167_length_5339_cov_28.708969	3428	3508	14	25	80	0.3125000
NODE_167_length_5339_cov_28.708969	3428	3508	16	31	80	0.3875000
NODE_168_length_5336_cov_33.036471	3109	3189	18	8	80	0.1000000
NODE_168_length_5336_cov_33.036471	3109	3189	21	1	80	0.0125000
NODE_168_length_5336_cov_33.036471	3109	3189	22	7	80	0.0875000
NODE_168_length_5336_cov_33.036471	3109	3189	24	1	80	0.0125000
NODE_168_length_5336_cov_33.036471	3109	3189	30	5	80	0.0625000
NODE_168_length_5336_cov_33.036471	3109	3189	32	3	80	0.0375000
NODE_168_length_5336_cov_33.036471	3109	3189	34	21	80	0.2625000
NODE_168_length_5336_cov_33.036471	3109	3189	36	32	80	0.4000000
NODE_168_length_5336_cov_33.036471	3109	3189	38	2	80	0.0250000
NODE_168_length_5336_cov_33.036471	3162	3242	0	7	80	0.0875000
NODE_168_length_5336_cov_33.036471	3162	3242	2	4	80	0.0500000
NODE_168_length_5336_cov_33.036471	3162	3242	10	1	80	0.0125000
NODE_168_length_5336_cov_33.036471	3162	3242	12	2	80	0.0250000
NODE_168_length_5336_cov_33.036471	3162	3242	14	11	80	0.1375000
NODE_168_length_5336_cov_33.036471	3162	3242	18	7	80	0.0875000
NODE_168_length_5336_cov_33.036471	3162	3242	24	9	80	0.1125000
NODE_168_length_5336_cov_33.036471	3162	3242	26	3	80	0.0375000
NODE_168_length_5336_cov_33.036471	3162	3242	28	2	80	0.0250000
NODE_168_length_5336_cov_33.036471	3162	3242	30	7	80	0.0875000
NODE_168_length_5336_cov_33.036471	3162	3242	32	1	80	0.0125000
NODE_168_length_5336_cov_33.036471	3162	3242	34	14	80	0.1750000
NODE_168_length_5336_cov_33.036471	3162	3242	36	12	80	0.1500000
NODE_179_length_5269_cov_23.392650	1905	1985	4	9	80	0.1125000
NODE_179_length_5269_cov_23.392650	1905	1985	9	21	80	0.2625000
NODE_179_length_5269_cov_23.392650	1905	1985	10	28	80	0.3500000
NODE_179_length_5269_cov_23.392650	1905	1985	11	21	80	0.2625000
NODE_179_length_5269_cov_23.392650	1905	1985	12	1	80	0.0125000
NODE_179_length_5269_cov_23.392650	1958	2038	8	21	80	0.2625000
NODE_179_length_5269_cov_23.392650	1958	2038	10	53	80	0.6625000
NODE_179_length_5269_cov_23.392650	1958	2038	11	5	80	0.0625000
NODE_179_length_5269_cov_23.392650	1958	2038	12	1	80	0.0125000
NODE_181_length_5207_cov_31.352780	4588	4668	0	6	80	0.0750000
NODE_181_length_5207_cov_31.352780	4588	4668	2	74	80	0.9250000
NODE_181_length_5207_cov_31.352780	4641	4721	0	43	80	0.5375000
NODE_181_length_5207_cov_31.352780	4641	4721	2	37	80	0.4625000
NODE_183_length_5193_cov_14.930506	4659	4739	2	14	80	0.1750000
NODE_183_length_5193_cov_14.930506	4659	4739	4	10	80	0.1250000
NODE_183_length_5193_cov_14.930506	4659	4739	6	42	80	0.5250000
NODE_183_length_5193_cov_14.930506	4659	4739	8	8	80	0.1000000
NODE_183_length_5193_cov_14.930506	4659	4739	10	6	80	0.0750000
NODE_183_length_5193_cov_14.930506	4712	4792	6	31	80	0.3875000
NODE_183_length_5193_cov_14.930506	4712	4792	8	25	80	0.3125000
NODE_183_length_5193_cov_14.930506	4712	4792	10	22	80	0.2750000
NODE_183_length_5193_cov_14.930506	4712	4792	16	2	80	0.0250000
NODE_183_length_5193_cov_14.930506	4788	4868	8	2	80	0.0250000
NODE_183_length_5193_cov_14.930506	4788	4868	10	18	80	0.2250000
NODE_183_length_5193_cov_14.930506	4788	4868	12	35	80	0.4375000
NODE_183_length_5193_cov_14.930506	4788	4868	14	5	80	0.0625000
NODE_183_length_5193_cov_14.930506	4788	4868	16	20	80	0.2500000
NODE_183_length_5193_cov_14.930506	4841	4921	0	4	80	0.0500000
NODE_183_length_5193_cov_14.930506	4841	4921	8	41	80	0.5125000
NODE_183_length_5193_cov_14.930506	4841	4921	10	26	80	0.3250000
NODE_183_length_5193_cov_14.930506	4841	4921	12	9	80	0.1125000
NODE_186_length_5159_cov_261.593676	158	227	106	4	69	0.0579710
NODE_186_length_5159_cov_261.593676	158	227	108	3	69	0.0434783
NODE_186_length_5159_cov_261.593676	158	227	110	1	69	0.0144928
NODE_186_length_5159_cov_261.593676	158	227	112	3	69	0.0434783
NODE_186_length_5159_cov_261.593676	158	227	113	9	69	0.1304348
NODE_186_length_5159_cov_261.593676	158	227	115	3	69	0.0434783
NODE_186_length_5159_cov_261.593676	158	227	116	1	69	0.0144928
NODE_186_length_5159_cov_261.593676	158	227	117	2	69	0.0289855
NODE_186_length_5159_cov_261.593676	158	227	118	7	69	0.1014493
NODE_186_length_5159_cov_261.593676	158	227	119	4	69	0.0579710
NODE_186_length_5159_cov_261.593676	158	227	121	1	69	0.0144928
NODE_186_length_5159_cov_261.593676	158	227	122	5	69	0.0724638
NODE_186_length_5159_cov_261.593676	158	227	123	3	69	0.0434783
NODE_186_length_5159_cov_261.593676	158	227	124	4	69	0.0579710
NODE_186_length_5159_cov_261.593676	158	227	125	3	69	0.0434783
NODE_186_length_5159_cov_261.593676	158	227	126	9	69	0.1304348
NODE_186_length_5159_cov_261.593676	158	227	128	6	69	0.0869565
NODE_186_length_5159_cov_261.593676	158	227	130	1	69	0.0144928
NODE_189_length_5138_cov_31.467355	3004	3075	2	5	71	0.0704225
NODE_189_length_5138_cov_31.467355	3004	3075	4	18	71	0.2535211
NODE_189_length_5138_cov_31.467355	3004	3075	7	1	71	0.0140845
NODE_189_length_5138_cov_31.467355	3004	3075	9	1	71	0.0140845
NODE_189_length_5138_cov_31.467355	3004	3075	10	3	71	0.0422535
NODE_189_length_5138_cov_31.467355	3004	3075	12	3	71	0.0422535
NODE_189_length_5138_cov_31.467355	3004	3075	18	1	71	0.0140845
NODE_189_length_5138_cov_31.467355	3004	3075	20	2	71	0.0281690
NODE_189_length_5138_cov_31.467355	3004	3075	22	1	71	0.0140845
NODE_189_length_5138_cov_31.467355	3004	3075	24	1	71	0.0140845
NODE_189_length_5138_cov_31.467355	3004	3075	26	2	71	0.0281690
NODE_189_length_5138_cov_31.467355	3004	3075	28	1	71	0.0140845
NODE_189_length_5138_cov_31.467355	3004	3075	30	2	71	0.0281690
NODE_189_length_5138_cov_31.467355	3004	3075	32	7	71	0.0985916
NODE_189_length_5138_cov_31.467355	3004	3075	35	4	71	0.0563380
NODE_189_length_5138_cov_31.467355	3004	3075	39	15	71	0.2112676
NODE_189_length_5138_cov_31.467355	3004	3075	43	4	71	0.0563380
NODE_191_length_5126_cov_5.900935	731	811	6	3	80	0.0375000
NODE_191_length_5126_cov_5.900935	731	811	8	21	80	0.2625000
NODE_191_length_5126_cov_5.900935	731	811	10	36	80	0.4500000
NODE_191_length_5126_cov_5.900935	731	811	12	20	80	0.2500000
NODE_191_length_5126_cov_5.900935	784	864	0	12	80	0.1500000
NODE_191_length_5126_cov_5.900935	784	864	2	7	80	0.0875000
NODE_191_length_5126_cov_5.900935	784	864	8	26	80	0.3250000
NODE_191_length_5126_cov_5.900935	784	864	10	17	80	0.2125000
NODE_191_length_5126_cov_5.900935	784	864	12	18	80	0.2250000
NODE_194_length_5102_cov_12.729962	367	447	0	80	80	1.0000000
NODE_194_length_5102_cov_12.729962	420	500	0	80	80	1.0000000
NODE_194_length_5102_cov_12.729962	496	576	0	80	80	1.0000000
NODE_194_length_5102_cov_12.729962	549	629	0	80	80	1.0000000
NODE_196_length_5079_cov_5.580522	875	940	29	13	65	0.2000000
NODE_196_length_5079_cov_5.580522	875	940	30	8	65	0.1230769
NODE_196_length_5079_cov_5.580522	875	940	31	18	65	0.2769231
NODE_196_length_5079_cov_5.580522	875	940	32	3	65	0.0461538
NODE_196_length_5079_cov_5.580522	875	940	33	14	65	0.2153846
NODE_196_length_5079_cov_5.580522	875	940	34	9	65	0.1384615
NODE_197_length_5057_cov_16.348729	2929	3000	141	1	71	0.0140845
NODE_197_length_5057_cov_16.348729	2929	3000	157	1	71	0.0140845
NODE_197_length_5057_cov_16.348729	2929	3000	163	1	71	0.0140845
NODE_197_length_5057_cov_16.348729	2929	3000	167	1	71	0.0140845
NODE_197_length_5057_cov_16.348729	2929	3000	169	1	71	0.0140845
NODE_197_length_5057_cov_16.348729	2929	3000	171	1	71	0.0140845
NODE_197_length_5057_cov_16.348729	2929	3000	173	1	71	0.0140845
NODE_197_length_5057_cov_16.348729	2929	3000	174	1	71	0.0140845
NODE_197_length_5057_cov_16.348729	2929	3000	176	2	71	0.0281690
NODE_197_length_5057_cov_16.348729	2929	3000	180	1	71	0.0140845
NODE_197_length_5057_cov_16.348729	2929	3000	181	1	71	0.0140845
NODE_197_length_5057_cov_16.348729	2929	3000	185	1	71	0.0140845
NODE_197_length_5057_cov_16.348729	2929	3000	195	1	71	0.0140845
NODE_197_length_5057_cov_16.348729	2929	3000	200	1	71	0.0140845
NODE_197_length_5057_cov_16.348729	2929	3000	208	1	71	0.0140845
NODE_197_length_5057_cov_16.348729	2929	3000	212	1	71	0.0140845
NODE_197_length_5057_cov_16.348729	2929	3000	217	1	71	0.0140845
NODE_197_length_5057_cov_16.348729	2929	3000	227	1	71	0.0140845
NODE_197_length_5057_cov_16.348729	2929	3000	229	1	71	0.0140845
NODE_197_length_5057_cov_16.348729	2929	3000	237	1	71	0.0140845
NODE_197_length_5057_cov_16.348729	2929	3000	248	2	71	0.0281690
NODE_197_length_5057_cov_16.348729	2929	3000	252	1	71	0.0140845
NODE_197_length_5057_cov_16.348729	2929	3000	253	1	71	0.0140845
NODE_197_length_5057_cov_16.348729	2929	3000	259	1	71	0.0140845
NODE_197_length_5057_cov_16.348729	2929	3000	263	1	71	0.0140845
NODE_197_length_5057_cov_16.348729	2929	3000	264	1	71	0.0140845
NODE_197_length_5057_cov_16.348729	2929	3000	270	3	71	0.0422535
NODE_197_length_5057_cov_16.348729	2929	3000	278	1	71	0.0140845
NODE_197_length_5057_cov_16.348729	2929	3000	280	1	71	0.0140845
NODE_197_length_5057_cov_16.348729	2929	3000	290	1	71	0.0140845
NODE_197_length_5057_cov_16.348729	2929	3000	296	1	71	0.0140845
NODE_197_length_5057_cov_16.348729	2929	3000	302	3	71	0.0422535
NODE_197_length_5057_cov_16.348729	2929	3000	306	1	71	0.0140845
NODE_197_length_5057_cov_16.348729	2929	3000	310	1	71	0.0140845
NODE_197_length_5057_cov_16.348729	2929	3000	314	1	71	0.0140845
NODE_197_length_5057_cov_16.348729	2929	3000	316	1	71	0.0140845
NODE_197_length_5057_cov_16.348729	2929	3000	318	1	71	0.0140845
NODE_197_length_5057_cov_16.348729	2929	3000	329	1	71	0.0140845
NODE_197_length_5057_cov_16.348729	2929	3000	335	4	71	0.0563380
NODE_197_length_5057_cov_16.348729	2929	3000	337	3	71	0.0422535
NODE_197_length_5057_cov_16.348729	2929	3000	340	2	71	0.0281690
NODE_197_length_5057_cov_16.348729	2929	3000	344	1	71	0.0140845
NODE_197_length_5057_cov_16.348729	2929	3000	346	1	71	0.0140845
NODE_197_length_5057_cov_16.348729	2929	3000	352	1	71	0.0140845
NODE_197_length_5057_cov_16.348729	2929	3000	356	2	71	0.0281690
NODE_197_length_5057_cov_16.348729	2929	3000	359	1	71	0.0140845
NODE_197_length_5057_cov_16.348729	2929	3000	366	1	71	0.0140845
NODE_197_length_5057_cov_16.348729	2929	3000	368	1	71	0.0140845
NODE_197_length_5057_cov_16.348729	2929	3000	384	1	71	0.0140845
NODE_197_length_5057_cov_16.348729	2929	3000	386	1	71	0.0140845
NODE_197_length_5057_cov_16.348729	2929	3000	396	1	71	0.0140845
NODE_197_length_5057_cov_16.348729	2929	3000	397	4	71	0.0563380
NODE_197_length_5057_cov_16.348729	2929	3000	399	1	71	0.0140845
NODE_197_length_5057_cov_16.348729	2929	3000	403	2	71	0.0281690
NODE_197_length_5057_cov_16.348729	2973	3012	335	4	39	0.1025641
NODE_197_length_5057_cov_16.348729	2973	3012	337	3	39	0.0769231
NODE_197_length_5057_cov_16.348729	2973	3012	340	2	39	0.0512821
NODE_197_length_5057_cov_16.348729	2973	3012	344	1	39	0.0256410
NODE_197_length_5057_cov_16.348729	2973	3012	346	1	39	0.0256410
NODE_197_length_5057_cov_16.348729	2973	3012	352	1	39	0.0256410
NODE_197_length_5057_cov_16.348729	2973	3012	356	2	39	0.0512821
NODE_197_length_5057_cov_16.348729	2973	3012	359	1	39	0.0256410
NODE_197_length_5057_cov_16.348729	2973	3012	366	1	39	0.0256410
NODE_197_length_5057_cov_16.348729	2973	3012	368	1	39	0.0256410
NODE_197_length_5057_cov_16.348729	2973	3012	384	1	39	0.0256410
NODE_197_length_5057_cov_16.348729	2973	3012	386	1	39	0.0256410
NODE_197_length_5057_cov_16.348729	2973	3012	396	1	39	0.0256410
NODE_197_length_5057_cov_16.348729	2973	3012	397	4	39	0.1025641
NODE_197_length_5057_cov_16.348729	2973	3012	399	1	39	0.0256410
NODE_197_length_5057_cov_16.348729	2973	3012	403	3	39	0.0769231
NODE_197_length_5057_cov_16.348729	2973	3012	407	2	39	0.0512821
NODE_197_length_5057_cov_16.348729	2973	3012	409	1	39	0.0256410
NODE_197_length_5057_cov_16.348729	2973	3012	411	1	39	0.0256410
NODE_197_length_5057_cov_16.348729	2973	3012	412	2	39	0.0512821
NODE_197_length_5057_cov_16.348729	2973	3012	413	2	39	0.0512821
NODE_197_length_5057_cov_16.348729	2973	3012	414	1	39	0.0256410
NODE_197_length_5057_cov_16.348729	2973	3012	415	2	39	0.0512821
NODE_198_length_5053_cov_11.281994	791	834	2	37	43	0.8604651
NODE_198_length_5053_cov_11.281994	791	834	3	6	43	0.1395349
NODE_198_length_5053_cov_11.281994	807	887	1	41	80	0.5125000
NODE_198_length_5053_cov_11.281994	807	887	2	21	80	0.2625000
NODE_198_length_5053_cov_11.281994	807	887	3	18	80	0.2250000
NODE_198_length_5053_cov_11.281994	883	963	1	19	80	0.2375000
NODE_198_length_5053_cov_11.281994	883	963	2	61	80	0.7625000
NODE_198_length_5053_cov_11.281994	936	999	1	21	63	0.3333333
NODE_198_length_5053_cov_11.281994	936	999	2	42	63	0.6666667
NODE_204_length_4906_cov_37.988350	3170	3251	19	2	81	0.0246914
NODE_204_length_4906_cov_37.988350	3170	3251	22	2	81	0.0246914
NODE_204_length_4906_cov_37.988350	3170	3251	23	4	81	0.0493827
NODE_204_length_4906_cov_37.988350	3170	3251	25	1	81	0.0123457
NODE_204_length_4906_cov_37.988350	3170	3251	26	1	81	0.0123457
NODE_204_length_4906_cov_37.988350	3170	3251	28	3	81	0.0370370
NODE_204_length_4906_cov_37.988350	3170	3251	30	3	81	0.0370370
NODE_204_length_4906_cov_37.988350	3170	3251	31	3	81	0.0370370
NODE_204_length_4906_cov_37.988350	3170	3251	33	4	81	0.0493827
NODE_204_length_4906_cov_37.988350	3170	3251	35	2	81	0.0246914
NODE_204_length_4906_cov_37.988350	3170	3251	37	6	81	0.0740741
NODE_204_length_4906_cov_37.988350	3170	3251	42	1	81	0.0123457
NODE_204_length_4906_cov_37.988350	3170	3251	46	2	81	0.0246914
NODE_204_length_4906_cov_37.988350	3170	3251	47	1	81	0.0123457
NODE_204_length_4906_cov_37.988350	3170	3251	49	1	81	0.0123457
NODE_204_length_4906_cov_37.988350	3170	3251	50	4	81	0.0493827
NODE_204_length_4906_cov_37.988350	3170	3251	52	1	81	0.0123457
NODE_204_length_4906_cov_37.988350	3170	3251	57	3	81	0.0370370
NODE_204_length_4906_cov_37.988350	3170	3251	64	2	81	0.0246914
NODE_204_length_4906_cov_37.988350	3170	3251	68	1	81	0.0123457
NODE_204_length_4906_cov_37.988350	3170	3251	69	3	81	0.0370370
NODE_204_length_4906_cov_37.988350	3170	3251	75	1	81	0.0123457
NODE_204_length_4906_cov_37.988350	3170	3251	82	2	81	0.0246914
NODE_204_length_4906_cov_37.988350	3170	3251	88	2	81	0.0246914
NODE_204_length_4906_cov_37.988350	3170	3251	89	1	81	0.0123457
NODE_204_length_4906_cov_37.988350	3170	3251	95	1	81	0.0123457
NODE_204_length_4906_cov_37.988350	3170	3251	106	1	81	0.0123457
NODE_204_length_4906_cov_37.988350	3170	3251	107	4	81	0.0493827
NODE_204_length_4906_cov_37.988350	3170	3251	115	1	81	0.0123457
NODE_204_length_4906_cov_37.988350	3170	3251	117	1	81	0.0123457
NODE_204_length_4906_cov_37.988350	3170	3251	125	1	81	0.0123457
NODE_204_length_4906_cov_37.988350	3170	3251	129	1	81	0.0123457
NODE_204_length_4906_cov_37.988350	3170	3251	134	1	81	0.0123457
NODE_204_length_4906_cov_37.988350	3170	3251	135	1	81	0.0123457
NODE_204_length_4906_cov_37.988350	3170	3251	144	1	81	0.0123457
NODE_204_length_4906_cov_37.988350	3170	3251	148	3	81	0.0370370
NODE_204_length_4906_cov_37.988350	3170	3251	150	1	81	0.0123457
NODE_204_length_4906_cov_37.988350	3170	3251	155	2	81	0.0246914
NODE_204_length_4906_cov_37.988350	3170	3251	163	2	81	0.0246914
NODE_204_length_4906_cov_37.988350	3170	3251	164	2	81	0.0246914
NODE_204_length_4906_cov_37.988350	3170	3251	167	1	81	0.0123457
NODE_204_length_4906_cov_37.988350	3170	3251	176	1	81	0.0123457
NODE_205_length_4888_cov_60.162247	4029	4068	0	13	39	0.3333333
NODE_205_length_4888_cov_60.162247	4029	4068	2	23	39	0.5897436
NODE_205_length_4888_cov_60.162247	4029	4068	9	3	39	0.0769231
NODE_205_length_4888_cov_60.162247	4041	4121	0	4	80	0.0500000
NODE_205_length_4888_cov_60.162247	4041	4121	2	76	80	0.9500000
NODE_207_length_4875_cov_63.035176	2905	2985	0	24	80	0.3000000
NODE_207_length_4875_cov_63.035176	2905	2985	2	10	80	0.1250000
NODE_207_length_4875_cov_63.035176	2905	2985	4	46	80	0.5750000
NODE_207_length_4875_cov_63.035176	2958	3038	4	43	80	0.5375000
NODE_207_length_4875_cov_63.035176	2958	3038	8	1	80	0.0125000
NODE_207_length_4875_cov_63.035176	2958	3038	10	3	80	0.0375000
NODE_207_length_4875_cov_63.035176	2958	3038	12	13	80	0.1625000
NODE_207_length_4875_cov_63.035176	2958	3038	14	1	80	0.0125000
NODE_207_length_4875_cov_63.035176	2958	3038	16	18	80	0.2250000
NODE_207_length_4875_cov_63.035176	2958	3038	18	1	80	0.0125000
NODE_208_length_4875_cov_8.996859	4683	4760	2	29	77	0.3766234
NODE_208_length_4875_cov_8.996859	4683	4760	4	48	77	0.6233766
NODE_208_length_4875_cov_8.996859	4736	4813	0	11	77	0.1428571
NODE_208_length_4875_cov_8.996859	4736	4813	2	47	77	0.6103896
NODE_208_length_4875_cov_8.996859	4736	4813	4	19	77	0.2467532
NODE_211_length_4827_cov_15.364636	1803	1865	28	8	62	0.1290323
NODE_211_length_4827_cov_15.364636	1803	1865	30	2	62	0.0322581
NODE_211_length_4827_cov_15.364636	1803	1865	32	5	62	0.0806452
NODE_211_length_4827_cov_15.364636	1803	1865	36	2	62	0.0322581
NODE_211_length_4827_cov_15.364636	1803	1865	38	1	62	0.0161290
NODE_211_length_4827_cov_15.364636	1803	1865	40	2	62	0.0322581
NODE_211_length_4827_cov_15.364636	1803	1865	42	2	62	0.0322581
NODE_211_length_4827_cov_15.364636	1803	1865	44	3	62	0.0483871
NODE_211_length_4827_cov_15.364636	1803	1865	46	1	62	0.0161290
NODE_211_length_4827_cov_15.364636	1803	1865	48	6	62	0.0967742
NODE_211_length_4827_cov_15.364636	1803	1865	52	2	62	0.0322581
NODE_211_length_4827_cov_15.364636	1803	1865	53	3	62	0.0483871
NODE_211_length_4827_cov_15.364636	1803	1865	54	2	62	0.0322581
NODE_211_length_4827_cov_15.364636	1803	1865	55	2	62	0.0322581
NODE_211_length_4827_cov_15.364636	1803	1865	56	2	62	0.0322581
NODE_211_length_4827_cov_15.364636	1803	1865	61	1	62	0.0161290
NODE_211_length_4827_cov_15.364636	1803	1865	62	1	62	0.0161290
NODE_211_length_4827_cov_15.364636	1803	1865	65	2	62	0.0322581
NODE_211_length_4827_cov_15.364636	1803	1865	69	1	62	0.0161290
NODE_211_length_4827_cov_15.364636	1803	1865	70	1	62	0.0161290
NODE_211_length_4827_cov_15.364636	1803	1865	71	1	62	0.0161290
NODE_211_length_4827_cov_15.364636	1803	1865	78	4	62	0.0645161
NODE_211_length_4827_cov_15.364636	1803	1865	80	2	62	0.0322581
NODE_211_length_4827_cov_15.364636	1803	1865	81	1	62	0.0161290
NODE_211_length_4827_cov_15.364636	1803	1865	83	1	62	0.0161290
NODE_211_length_4827_cov_15.364636	1803	1865	85	2	62	0.0322581
NODE_211_length_4827_cov_15.364636	1803	1865	87	1	62	0.0161290
NODE_211_length_4827_cov_15.364636	1803	1865	89	1	62	0.0161290
NODE_211_length_4827_cov_15.364636	1899	1979	32	2	80	0.0250000
NODE_211_length_4827_cov_15.364636	1899	1979	36	2	80	0.0250000
NODE_211_length_4827_cov_15.364636	1899	1979	39	1	80	0.0125000
NODE_211_length_4827_cov_15.364636	1899	1979	40	3	80	0.0375000
NODE_211_length_4827_cov_15.364636	1899	1979	42	1	80	0.0125000
NODE_211_length_4827_cov_15.364636	1899	1979	44	3	80	0.0375000
NODE_211_length_4827_cov_15.364636	1899	1979	45	8	80	0.1000000
NODE_211_length_4827_cov_15.364636	1899	1979	46	30	80	0.3750000
NODE_211_length_4827_cov_15.364636	1899	1979	48	9	80	0.1125000
NODE_211_length_4827_cov_15.364636	1899	1979	50	1	80	0.0125000
NODE_211_length_4827_cov_15.364636	1899	1979	51	5	80	0.0625000
NODE_211_length_4827_cov_15.364636	1899	1979	52	8	80	0.1000000
NODE_211_length_4827_cov_15.364636	1899	1979	54	2	80	0.0250000
NODE_211_length_4827_cov_15.364636	1899	1979	56	5	80	0.0625000
NODE_211_length_4827_cov_15.364636	1952	1996	31	3	44	0.0681818
NODE_211_length_4827_cov_15.364636	1952	1996	35	2	44	0.0454545
NODE_211_length_4827_cov_15.364636	1952	1996	37	4	44	0.0909091
NODE_211_length_4827_cov_15.364636	1952	1996	39	9	44	0.2045455
NODE_211_length_4827_cov_15.364636	1952	1996	40	3	44	0.0681818
NODE_211_length_4827_cov_15.364636	1952	1996	44	2	44	0.0454545
NODE_211_length_4827_cov_15.364636	1952	1996	45	8	44	0.1818182
NODE_211_length_4827_cov_15.364636	1952	1996	46	13	44	0.2954545
NODE_212_length_4821_cov_10.856840	999	1061	4	8	62	0.1290323
NODE_212_length_4821_cov_10.856840	999	1061	8	42	62	0.6774194
NODE_212_length_4821_cov_10.856840	999	1061	10	7	62	0.1129032
NODE_212_length_4821_cov_10.856840	999	1061	12	1	62	0.0161290
NODE_212_length_4821_cov_10.856840	999	1061	14	4	62	0.0645161
NODE_213_length_4819_cov_16.363347	2392	2461	23	9	69	0.1304348
NODE_213_length_4819_cov_16.363347	2392	2461	25	9	69	0.1304348
NODE_213_length_4819_cov_16.363347	2392	2461	27	1	69	0.0144928
NODE_213_length_4819_cov_16.363347	2392	2461	29	5	69	0.0724638
NODE_213_length_4819_cov_16.363347	2392	2461	31	8	69	0.1159420
NODE_213_length_4819_cov_16.363347	2392	2461	33	10	69	0.1449275
NODE_213_length_4819_cov_16.363347	2392	2461	35	7	69	0.1014493
NODE_213_length_4819_cov_16.363347	2392	2461	37	8	69	0.1159420
NODE_213_length_4819_cov_16.363347	2392	2461	39	12	69	0.1739130
NODE_217_length_4794_cov_14.912886	657	737	37	7	80	0.0875000
NODE_217_length_4794_cov_14.912886	657	737	38	7	80	0.0875000
NODE_217_length_4794_cov_14.912886	657	737	43	2	80	0.0250000
NODE_217_length_4794_cov_14.912886	657	737	47	1	80	0.0125000
NODE_217_length_4794_cov_14.912886	657	737	48	3	80	0.0375000
NODE_217_length_4794_cov_14.912886	657	737	50	6	80	0.0750000
NODE_217_length_4794_cov_14.912886	657	737	54	1	80	0.0125000
NODE_217_length_4794_cov_14.912886	657	737	56	5	80	0.0625000
NODE_217_length_4794_cov_14.912886	657	737	58	1	80	0.0125000
NODE_217_length_4794_cov_14.912886	657	737	59	6	80	0.0750000
NODE_217_length_4794_cov_14.912886	657	737	60	2	80	0.0250000
NODE_217_length_4794_cov_14.912886	657	737	62	6	80	0.0750000
NODE_217_length_4794_cov_14.912886	657	737	63	6	80	0.0750000
NODE_217_length_4794_cov_14.912886	657	737	65	4	80	0.0500000
NODE_217_length_4794_cov_14.912886	657	737	67	2	80	0.0250000
NODE_217_length_4794_cov_14.912886	657	737	68	7	80	0.0875000
NODE_217_length_4794_cov_14.912886	657	737	70	14	80	0.1750000
NODE_217_length_4794_cov_14.912886	4240	4312	2	4	72	0.0555556
NODE_217_length_4794_cov_14.912886	4240	4312	3	8	72	0.1111111
NODE_217_length_4794_cov_14.912886	4240	4312	4	8	72	0.1111111
NODE_217_length_4794_cov_14.912886	4240	4312	5	37	72	0.5138889
NODE_217_length_4794_cov_14.912886	4240	4312	6	15	72	0.2083333
NODE_217_length_4794_cov_14.912886	4293	4312	2	4	19	0.2105263
NODE_217_length_4794_cov_14.912886	4293	4312	4	4	19	0.2105263
NODE_217_length_4794_cov_14.912886	4293	4312	5	11	19	0.5789474
NODE_217_length_4794_cov_14.912886	4345	4408	10	10	63	0.1587302
NODE_217_length_4794_cov_14.912886	4345	4408	11	1	63	0.0158730
NODE_217_length_4794_cov_14.912886	4345	4408	12	30	63	0.4761905
NODE_217_length_4794_cov_14.912886	4345	4408	14	11	63	0.1746032
NODE_217_length_4794_cov_14.912886	4345	4408	16	11	63	0.1746032
NODE_218_length_4791_cov_16.126172	2438	2518	0	80	80	1.0000000
NODE_218_length_4791_cov_16.126172	2491	2571	0	74	80	0.9250000
NODE_218_length_4791_cov_16.126172	2491	2571	2	6	80	0.0750000
NODE_218_length_4791_cov_16.126172	2567	2647	2	80	80	1.0000000
NODE_218_length_4791_cov_16.126172	2620	2700	0	44	80	0.5500000
NODE_218_length_4791_cov_16.126172	2620	2700	2	36	80	0.4500000
NODE_218_length_4791_cov_16.126172	4607	4687	0	52	80	0.6500000
NODE_218_length_4791_cov_16.126172	4607	4687	2	28	80	0.3500000
NODE_219_length_4790_cov_9.713494	2159	2239	47	4	80	0.0500000
NODE_219_length_4790_cov_9.713494	2159	2239	49	11	80	0.1375000
NODE_219_length_4790_cov_9.713494	2159	2239	51	2	80	0.0250000
NODE_219_length_4790_cov_9.713494	2159	2239	53	3	80	0.0375000
NODE_219_length_4790_cov_9.713494	2159	2239	54	2	80	0.0250000
NODE_219_length_4790_cov_9.713494	2159	2239	55	6	80	0.0750000
NODE_219_length_4790_cov_9.713494	2159	2239	57	1	80	0.0125000
NODE_219_length_4790_cov_9.713494	2159	2239	58	5	80	0.0625000
NODE_219_length_4790_cov_9.713494	2159	2239	59	14	80	0.1750000
NODE_219_length_4790_cov_9.713494	2159	2239	61	8	80	0.1000000
NODE_219_length_4790_cov_9.713494	2159	2239	63	11	80	0.1375000
NODE_219_length_4790_cov_9.713494	2159	2239	65	6	80	0.0750000
NODE_219_length_4790_cov_9.713494	2159	2239	67	2	80	0.0250000
NODE_219_length_4790_cov_9.713494	2159	2239	69	2	80	0.0250000
NODE_219_length_4790_cov_9.713494	2159	2239	70	3	80	0.0375000
NODE_219_length_4790_cov_9.713494	4273	4353	8	20	80	0.2500000
NODE_219_length_4790_cov_9.713494	4273	4353	10	10	80	0.1250000
NODE_219_length_4790_cov_9.713494	4273	4353	12	10	80	0.1250000
NODE_219_length_4790_cov_9.713494	4273	4353	14	12	80	0.1500000
NODE_219_length_4790_cov_9.713494	4273	4353	16	17	80	0.2125000
NODE_219_length_4790_cov_9.713494	4273	4353	18	11	80	0.1375000
NODE_219_length_4790_cov_9.713494	4273	4335	8	2	62	0.0322581
NODE_219_length_4790_cov_9.713494	4273	4335	10	10	62	0.1612903
NODE_219_length_4790_cov_9.713494	4273	4335	12	10	62	0.1612903
NODE_219_length_4790_cov_9.713494	4273	4335	14	12	62	0.1935484
NODE_219_length_4790_cov_9.713494	4273	4335	16	17	62	0.2741936
NODE_219_length_4790_cov_9.713494	4273	4335	18	11	62	0.1774193
NODE_219_length_4790_cov_9.713494	4326	4406	0	6	80	0.0750000
NODE_219_length_4790_cov_9.713494	4326	4406	2	19	80	0.2375000
NODE_219_length_4790_cov_9.713494	4326	4406	4	13	80	0.1625000
NODE_219_length_4790_cov_9.713494	4326	4406	6	12	80	0.1500000
NODE_219_length_4790_cov_9.713494	4326	4406	8	23	80	0.2875000
NODE_219_length_4790_cov_9.713494	4326	4406	10	7	80	0.0875000
NODE_221_length_4772_cov_10.560454	4281	4367	0	86	86	1.0000000
NODE_222_length_4770_cov_106.953543	2778	2858	12	1	80	0.0125000
NODE_222_length_4770_cov_106.953543	2778	2858	13	9	80	0.1125000
NODE_222_length_4770_cov_106.953543	2778	2858	14	6	80	0.0750000
NODE_222_length_4770_cov_106.953543	2778	2858	15	2	80	0.0250000
NODE_222_length_4770_cov_106.953543	2778	2858	16	52	80	0.6500000
NODE_222_length_4770_cov_106.953543	2778	2858	17	6	80	0.0750000
NODE_222_length_4770_cov_106.953543	2778	2858	18	4	80	0.0500000
NODE_222_length_4770_cov_106.953543	2831	2911	10	1	80	0.0125000
NODE_222_length_4770_cov_106.953543	2831	2911	12	3	80	0.0375000
NODE_222_length_4770_cov_106.953543	2831	2911	13	9	80	0.1125000
NODE_222_length_4770_cov_106.953543	2831	2911	14	8	80	0.1000000
NODE_222_length_4770_cov_106.953543	2831	2911	15	2	80	0.0250000
NODE_222_length_4770_cov_106.953543	2831	2911	16	36	80	0.4500000
NODE_222_length_4770_cov_106.953543	2831	2911	22	2	80	0.0250000
NODE_222_length_4770_cov_106.953543	2831	2911	24	1	80	0.0125000
NODE_222_length_4770_cov_106.953543	2831	2911	25	8	80	0.1000000
NODE_222_length_4770_cov_106.953543	2831	2911	27	7	80	0.0875000
NODE_222_length_4770_cov_106.953543	2831	2911	29	2	80	0.0250000
NODE_222_length_4770_cov_106.953543	2831	2911	35	1	80	0.0125000
NODE_222_length_4770_cov_106.953543	2907	2987	27	1	80	0.0125000
NODE_222_length_4770_cov_106.953543	2907	2987	29	2	80	0.0250000
NODE_222_length_4770_cov_106.953543	2907	2987	35	1	80	0.0125000
NODE_222_length_4770_cov_106.953543	2907	2987	39	3	80	0.0375000
NODE_222_length_4770_cov_106.953543	2907	2987	43	1	80	0.0125000
NODE_222_length_4770_cov_106.953543	2907	2987	45	1	80	0.0125000
NODE_222_length_4770_cov_106.953543	2907	2987	53	3	80	0.0375000
NODE_222_length_4770_cov_106.953543	2907	2987	55	1	80	0.0125000
NODE_222_length_4770_cov_106.953543	2907	2987	59	1	80	0.0125000
NODE_222_length_4770_cov_106.953543	2907	2987	62	1	80	0.0125000
NODE_222_length_4770_cov_106.953543	2907	2987	64	3	80	0.0375000
NODE_222_length_4770_cov_106.953543	2907	2987	66	3	80	0.0375000
NODE_222_length_4770_cov_106.953543	2907	2987	70	5	80	0.0625000
NODE_222_length_4770_cov_106.953543	2907	2987	71	1	80	0.0125000
NODE_222_length_4770_cov_106.953543	2907	2987	73	3	80	0.0375000
NODE_222_length_4770_cov_106.953543	2907	2987	75	2	80	0.0250000
NODE_222_length_4770_cov_106.953543	2907	2987	79	3	80	0.0375000
NODE_222_length_4770_cov_106.953543	2907	2987	83	5	80	0.0625000
NODE_222_length_4770_cov_106.953543	2907	2987	84	1	80	0.0125000
NODE_222_length_4770_cov_106.953543	2907	2987	85	5	80	0.0625000
NODE_222_length_4770_cov_106.953543	2907	2987	86	7	80	0.0875000
NODE_222_length_4770_cov_106.953543	2907	2987	87	4	80	0.0500000
NODE_222_length_4770_cov_106.953543	2907	2987	88	2	80	0.0250000
NODE_222_length_4770_cov_106.953543	2907	2987	89	1	80	0.0125000
NODE_222_length_4770_cov_106.953543	2907	2987	90	3	80	0.0375000
NODE_222_length_4770_cov_106.953543	2907	2987	91	3	80	0.0375000
NODE_222_length_4770_cov_106.953543	2907	2987	92	1	80	0.0125000
NODE_222_length_4770_cov_106.953543	2907	2987	93	2	80	0.0250000
NODE_222_length_4770_cov_106.953543	2907	2987	97	1	80	0.0125000
NODE_222_length_4770_cov_106.953543	2907	2987	101	5	80	0.0625000
NODE_222_length_4770_cov_106.953543	2907	2987	103	2	80	0.0250000
NODE_222_length_4770_cov_106.953543	2907	2987	104	2	80	0.0250000
NODE_222_length_4770_cov_106.953543	2907	2987	105	1	80	0.0125000
NODE_222_length_4770_cov_106.953543	2960	3040	87	4	80	0.0500000
NODE_222_length_4770_cov_106.953543	2960	3040	88	2	80	0.0250000
NODE_222_length_4770_cov_106.953543	2960	3040	89	1	80	0.0125000
NODE_222_length_4770_cov_106.953543	2960	3040	90	3	80	0.0375000
NODE_222_length_4770_cov_106.953543	2960	3040	91	3	80	0.0375000
NODE_222_length_4770_cov_106.953543	2960	3040	92	1	80	0.0125000
NODE_222_length_4770_cov_106.953543	2960	3040	93	2	80	0.0250000
NODE_222_length_4770_cov_106.953543	2960	3040	97	1	80	0.0125000
NODE_222_length_4770_cov_106.953543	2960	3040	98	2	80	0.0250000
NODE_222_length_4770_cov_106.953543	2960	3040	100	3	80	0.0375000
NODE_222_length_4770_cov_106.953543	2960	3040	101	6	80	0.0750000
NODE_222_length_4770_cov_106.953543	2960	3040	102	8	80	0.1000000
NODE_222_length_4770_cov_106.953543	2960	3040	103	5	80	0.0625000
NODE_222_length_4770_cov_106.953543	2960	3040	104	11	80	0.1375000
NODE_222_length_4770_cov_106.953543	2960	3040	105	7	80	0.0875000
NODE_222_length_4770_cov_106.953543	2960	3040	106	4	80	0.0500000
NODE_222_length_4770_cov_106.953543	2960	3040	107	3	80	0.0375000
NODE_222_length_4770_cov_106.953543	2960	3040	108	1	80	0.0125000
NODE_222_length_4770_cov_106.953543	2960	3040	109	5	80	0.0625000
NODE_222_length_4770_cov_106.953543	2960	3040	111	7	80	0.0875000
NODE_222_length_4770_cov_106.953543	2960	3040	112	1	80	0.0125000
NODE_223_length_4768_cov_15.447205	1237	1317	9	2	80	0.0250000
NODE_223_length_4768_cov_15.447205	1237	1317	13	16	80	0.2000000
NODE_223_length_4768_cov_15.447205	1237	1317	22	8	80	0.1000000
NODE_223_length_4768_cov_15.447205	1237	1317	23	34	80	0.4250000
NODE_223_length_4768_cov_15.447205	1237	1317	24	18	80	0.2250000
NODE_223_length_4768_cov_15.447205	1237	1317	25	2	80	0.0250000
NODE_228_length_4730_cov_30.142734	256	336	0	17	80	0.2125000
NODE_228_length_4730_cov_30.142734	256	336	2	1	80	0.0125000
NODE_228_length_4730_cov_30.142734	256	336	6	23	80	0.2875000
NODE_228_length_4730_cov_30.142734	256	336	8	29	80	0.3625000
NODE_228_length_4730_cov_30.142734	256	336	11	9	80	0.1125000
NODE_228_length_4730_cov_30.142734	256	336	13	1	80	0.0125000
NODE_228_length_4730_cov_30.142734	309	389	8	23	80	0.2875000
NODE_228_length_4730_cov_30.142734	309	389	11	9	80	0.1125000
NODE_228_length_4730_cov_30.142734	309	389	12	39	80	0.4875000
NODE_228_length_4730_cov_30.142734	309	389	13	9	80	0.1125000
NODE_228_length_4730_cov_30.142734	4052	4132	10	26	80	0.3250000
NODE_228_length_4730_cov_30.142734	4052	4132	12	54	80	0.6750000
NODE_228_length_4730_cov_30.142734	4105	4185	4	29	80	0.3625000
NODE_228_length_4730_cov_30.142734	4105	4185	9	1	80	0.0125000
NODE_228_length_4730_cov_30.142734	4105	4185	10	16	80	0.2000000
NODE_228_length_4730_cov_30.142734	4105	4185	12	18	80	0.2250000
NODE_228_length_4730_cov_30.142734	4105	4185	14	16	80	0.2000000
NODE_231_length_4706_cov_25.522683	2181	2261	8	4	80	0.0500000
NODE_231_length_4706_cov_25.522683	2181	2261	10	13	80	0.1625000
NODE_231_length_4706_cov_25.522683	2181	2261	12	10	80	0.1250000
NODE_231_length_4706_cov_25.522683	2181	2261	14	8	80	0.1000000
NODE_231_length_4706_cov_25.522683	2181	2261	16	2	80	0.0250000
NODE_231_length_4706_cov_25.522683	2181	2261	18	7	80	0.0875000
NODE_231_length_4706_cov_25.522683	2181	2261	20	3	80	0.0375000
NODE_231_length_4706_cov_25.522683	2181	2261	24	4	80	0.0500000
NODE_231_length_4706_cov_25.522683	2181	2261	26	3	80	0.0375000
NODE_231_length_4706_cov_25.522683	2181	2261	28	1	80	0.0125000
NODE_231_length_4706_cov_25.522683	2181	2261	30	6	80	0.0750000
NODE_231_length_4706_cov_25.522683	2181	2261	34	2	80	0.0250000
NODE_231_length_4706_cov_25.522683	2181	2261	35	6	80	0.0750000
NODE_231_length_4706_cov_25.522683	2181	2261	39	4	80	0.0500000
NODE_231_length_4706_cov_25.522683	2181	2261	41	2	80	0.0250000
NODE_231_length_4706_cov_25.522683	2181	2261	42	5	80	0.0625000
NODE_231_length_4706_cov_25.522683	2234	2288	0	14	54	0.2592593
NODE_231_length_4706_cov_25.522683	2234	2288	2	5	54	0.0925926
NODE_231_length_4706_cov_25.522683	2234	2288	4	3	54	0.0555556
NODE_231_length_4706_cov_25.522683	2234	2288	8	9	54	0.1666667
NODE_231_length_4706_cov_25.522683	2234	2288	10	13	54	0.2407407
NODE_231_length_4706_cov_25.522683	2234	2288	12	10	54	0.1851852
NODE_231_length_4706_cov_25.522683	3943	4026	33	2	83	0.0240964
NODE_231_length_4706_cov_25.522683	3943	4026	35	2	83	0.0240964
NODE_231_length_4706_cov_25.522683	3943	4026	37	3	83	0.0361446
NODE_231_length_4706_cov_25.522683	3943	4026	38	3	83	0.0361446
NODE_231_length_4706_cov_25.522683	3943	4026	39	2	83	0.0240964
NODE_231_length_4706_cov_25.522683	3943	4026	40	11	83	0.1325301
NODE_231_length_4706_cov_25.522683	3943	4026	41	2	83	0.0240964
NODE_231_length_4706_cov_25.522683	3943	4026	43	1	83	0.0120482
NODE_231_length_4706_cov_25.522683	3943	4026	44	1	83	0.0120482
NODE_231_length_4706_cov_25.522683	3943	4026	45	3	83	0.0361446
NODE_231_length_4706_cov_25.522683	3943	4026	46	4	83	0.0481928
NODE_231_length_4706_cov_25.522683	3943	4026	47	8	83	0.0963855
NODE_231_length_4706_cov_25.522683	3943	4026	48	1	83	0.0120482
NODE_231_length_4706_cov_25.522683	3943	4026	49	5	83	0.0602410
NODE_231_length_4706_cov_25.522683	3943	4026	50	10	83	0.1204819
NODE_231_length_4706_cov_25.522683	3943	4026	51	1	83	0.0120482
NODE_231_length_4706_cov_25.522683	3943	4026	52	2	83	0.0240964
NODE_231_length_4706_cov_25.522683	3943	4026	53	1	83	0.0120482
NODE_231_length_4706_cov_25.522683	3943	4026	55	1	83	0.0120482
NODE_231_length_4706_cov_25.522683	3943	4026	57	1	83	0.0120482
NODE_231_length_4706_cov_25.522683	3943	4026	61	6	83	0.0722892
NODE_231_length_4706_cov_25.522683	3943	4026	63	5	83	0.0602410
NODE_231_length_4706_cov_25.522683	3943	4026	65	7	83	0.0843373
NODE_231_length_4706_cov_25.522683	3943	4026	67	1	83	0.0120482
NODE_235_length_4693_cov_16.973008	374	454	6	7	80	0.0875000
NODE_235_length_4693_cov_16.973008	374	454	8	4	80	0.0500000
NODE_235_length_4693_cov_16.973008	374	454	10	1	80	0.0125000
NODE_235_length_4693_cov_16.973008	374	454	12	9	80	0.1125000
NODE_235_length_4693_cov_16.973008	374	454	14	9	80	0.1125000
NODE_235_length_4693_cov_16.973008	374	454	16	7	80	0.0875000
NODE_235_length_4693_cov_16.973008	374	454	18	2	80	0.0250000
NODE_235_length_4693_cov_16.973008	374	454	22	8	80	0.1000000
NODE_235_length_4693_cov_16.973008	374	454	24	1	80	0.0125000
NODE_235_length_4693_cov_16.973008	374	454	26	5	80	0.0625000
NODE_235_length_4693_cov_16.973008	374	454	28	22	80	0.2750000
NODE_235_length_4693_cov_16.973008	374	454	30	2	80	0.0250000
NODE_235_length_4693_cov_16.973008	374	454	32	3	80	0.0375000
NODE_235_length_4693_cov_16.973008	427	507	28	22	80	0.2750000
NODE_235_length_4693_cov_16.973008	427	507	30	12	80	0.1500000
NODE_235_length_4693_cov_16.973008	427	507	32	46	80	0.5750000
NODE_240_length_4672_cov_39.029084	1391	1470	77	1	79	0.0126582
NODE_240_length_4672_cov_39.029084	1391	1470	97	1	79	0.0126582
NODE_240_length_4672_cov_39.029084	1391	1470	115	1	79	0.0126582
NODE_240_length_4672_cov_39.029084	1391	1470	133	1	79	0.0126582
NODE_240_length_4672_cov_39.029084	1391	1470	135	5	79	0.0632911
NODE_240_length_4672_cov_39.029084	1391	1470	137	1	79	0.0126582
NODE_240_length_4672_cov_39.029084	1391	1470	141	1	79	0.0126582
NODE_240_length_4672_cov_39.029084	1391	1470	153	1	79	0.0126582
NODE_240_length_4672_cov_39.029084	1391	1470	161	1	79	0.0126582
NODE_240_length_4672_cov_39.029084	1391	1470	173	1	79	0.0126582
NODE_240_length_4672_cov_39.029084	1391	1470	175	1	79	0.0126582
NODE_240_length_4672_cov_39.029084	1391	1470	179	1	79	0.0126582
NODE_240_length_4672_cov_39.029084	1391	1470	181	4	79	0.0506329
NODE_240_length_4672_cov_39.029084	1391	1470	183	2	79	0.0253165
NODE_240_length_4672_cov_39.029084	1391	1470	185	1	79	0.0126582
NODE_240_length_4672_cov_39.029084	1391	1470	195	2	79	0.0253165
NODE_240_length_4672_cov_39.029084	1391	1470	196	3	79	0.0379747
NODE_240_length_4672_cov_39.029084	1391	1470	198	1	79	0.0126582
NODE_240_length_4672_cov_39.029084	1391	1470	200	1	79	0.0126582
NODE_240_length_4672_cov_39.029084	1391	1470	206	1	79	0.0126582
NODE_240_length_4672_cov_39.029084	1391	1470	210	1	79	0.0126582
NODE_240_length_4672_cov_39.029084	1391	1470	212	1	79	0.0126582
NODE_240_length_4672_cov_39.029084	1391	1470	226	1	79	0.0126582
NODE_240_length_4672_cov_39.029084	1391	1470	228	1	79	0.0126582
NODE_240_length_4672_cov_39.029084	1391	1470	230	1	79	0.0126582
NODE_240_length_4672_cov_39.029084	1391	1470	232	1	79	0.0126582
NODE_240_length_4672_cov_39.029084	1391	1470	234	1	79	0.0126582
NODE_240_length_4672_cov_39.029084	1391	1470	240	2	79	0.0253165
NODE_240_length_4672_cov_39.029084	1391	1470	242	1	79	0.0126582
NODE_240_length_4672_cov_39.029084	1391	1470	254	2	79	0.0253165
NODE_240_length_4672_cov_39.029084	1391	1470	258	1	79	0.0126582
NODE_240_length_4672_cov_39.029084	1391	1470	260	1	79	0.0126582
NODE_240_length_4672_cov_39.029084	1391	1470	262	1	79	0.0126582
NODE_240_length_4672_cov_39.029084	1391	1470	264	2	79	0.0253165
NODE_240_length_4672_cov_39.029084	1391	1470	274	3	79	0.0379747
NODE_240_length_4672_cov_39.029084	1391	1470	277	2	79	0.0253165
NODE_240_length_4672_cov_39.029084	1391	1470	279	2	79	0.0253165
NODE_240_length_4672_cov_39.029084	1391	1470	280	1	79	0.0126582
NODE_240_length_4672_cov_39.029084	1391	1470	282	1	79	0.0126582
NODE_240_length_4672_cov_39.029084	1391	1470	283	1	79	0.0126582
NODE_240_length_4672_cov_39.029084	1391	1470	284	1	79	0.0126582
NODE_240_length_4672_cov_39.029084	1391	1470	286	1	79	0.0126582
NODE_240_length_4672_cov_39.029084	1391	1470	293	2	79	0.0253165
NODE_240_length_4672_cov_39.029084	1391	1470	294	2	79	0.0253165
NODE_240_length_4672_cov_39.029084	1391	1470	296	2	79	0.0253165
NODE_240_length_4672_cov_39.029084	1391	1470	297	2	79	0.0253165
NODE_240_length_4672_cov_39.029084	1391	1470	298	5	79	0.0632911
NODE_240_length_4672_cov_39.029084	1391	1470	300	6	79	0.0759494
NODE_240_length_4672_cov_39.029084	1444	1523	113	2	79	0.0253165
NODE_240_length_4672_cov_39.029084	1444	1523	127	1	79	0.0126582
NODE_240_length_4672_cov_39.029084	1444	1523	129	1	79	0.0126582
NODE_240_length_4672_cov_39.029084	1444	1523	131	1	79	0.0126582
NODE_240_length_4672_cov_39.029084	1444	1523	133	1	79	0.0126582
NODE_240_length_4672_cov_39.029084	1444	1523	137	1	79	0.0126582
NODE_240_length_4672_cov_39.029084	1444	1523	150	1	79	0.0126582
NODE_240_length_4672_cov_39.029084	1444	1523	158	1	79	0.0126582
NODE_240_length_4672_cov_39.029084	1444	1523	159	3	79	0.0379747
NODE_240_length_4672_cov_39.029084	1444	1523	165	1	79	0.0126582
NODE_240_length_4672_cov_39.029084	1444	1523	167	1	79	0.0126582
NODE_240_length_4672_cov_39.029084	1444	1523	169	1	79	0.0126582
NODE_240_length_4672_cov_39.029084	1444	1523	186	2	79	0.0253165
NODE_240_length_4672_cov_39.029084	1444	1523	191	1	79	0.0126582
NODE_240_length_4672_cov_39.029084	1444	1523	206	5	79	0.0632911
NODE_240_length_4672_cov_39.029084	1444	1523	210	1	79	0.0126582
NODE_240_length_4672_cov_39.029084	1444	1523	214	1	79	0.0126582
NODE_240_length_4672_cov_39.029084	1444	1523	226	1	79	0.0126582
NODE_240_length_4672_cov_39.029084	1444	1523	228	1	79	0.0126582
NODE_240_length_4672_cov_39.029084	1444	1523	232	1	79	0.0126582
NODE_240_length_4672_cov_39.029084	1444	1523	234	1	79	0.0126582
NODE_240_length_4672_cov_39.029084	1444	1523	236	1	79	0.0126582
NODE_240_length_4672_cov_39.029084	1444	1523	241	1	79	0.0126582
NODE_240_length_4672_cov_39.029084	1444	1523	249	1	79	0.0126582
NODE_240_length_4672_cov_39.029084	1444	1523	251	1	79	0.0126582
NODE_240_length_4672_cov_39.029084	1444	1523	253	2	79	0.0253165
NODE_240_length_4672_cov_39.029084	1444	1523	255	1	79	0.0126582
NODE_240_length_4672_cov_39.029084	1444	1523	257	2	79	0.0253165
NODE_240_length_4672_cov_39.029084	1444	1523	261	1	79	0.0126582
NODE_240_length_4672_cov_39.029084	1444	1523	263	2	79	0.0253165
NODE_240_length_4672_cov_39.029084	1444	1523	267	3	79	0.0379747
NODE_240_length_4672_cov_39.029084	1444	1523	271	1	79	0.0126582
NODE_240_length_4672_cov_39.029084	1444	1523	272	5	79	0.0632911
NODE_240_length_4672_cov_39.029084	1444	1523	276	1	79	0.0126582
NODE_240_length_4672_cov_39.029084	1444	1523	278	1	79	0.0126582
NODE_240_length_4672_cov_39.029084	1444	1523	279	2	79	0.0253165
NODE_240_length_4672_cov_39.029084	1444	1523	280	2	79	0.0253165
NODE_240_length_4672_cov_39.029084	1444	1523	282	1	79	0.0126582
NODE_240_length_4672_cov_39.029084	1444	1523	283	1	79	0.0126582
NODE_240_length_4672_cov_39.029084	1444	1523	284	1	79	0.0126582
NODE_240_length_4672_cov_39.029084	1444	1523	286	1	79	0.0126582
NODE_240_length_4672_cov_39.029084	1444	1523	293	2	79	0.0253165
NODE_240_length_4672_cov_39.029084	1444	1523	294	2	79	0.0253165
NODE_240_length_4672_cov_39.029084	1444	1523	296	2	79	0.0253165
NODE_240_length_4672_cov_39.029084	1444	1523	297	2	79	0.0253165
NODE_240_length_4672_cov_39.029084	1444	1523	298	5	79	0.0632911
NODE_240_length_4672_cov_39.029084	1444	1523	300	6	79	0.0759494
NODE_246_length_4602_cov_17.281368	3106	3186	0	3	80	0.0375000
NODE_246_length_4602_cov_17.281368	3106	3186	2	8	80	0.1000000
NODE_246_length_4602_cov_17.281368	3106	3186	7	16	80	0.2000000
NODE_246_length_4602_cov_17.281368	3106	3186	8	21	80	0.2625000
NODE_246_length_4602_cov_17.281368	3106	3186	11	1	80	0.0125000
NODE_246_length_4602_cov_17.281368	3106	3186	15	31	80	0.3875000
NODE_246_length_4602_cov_17.281368	3159	3239	8	9	80	0.1125000
NODE_246_length_4602_cov_17.281368	3159	3239	14	1	80	0.0125000
NODE_246_length_4602_cov_17.281368	3159	3239	15	70	80	0.8750000
NODE_248_length_4587_cov_14.431150	1294	1370	82	2	76	0.0263158
NODE_248_length_4587_cov_14.431150	1294	1370	84	4	76	0.0526316
NODE_248_length_4587_cov_14.431150	1294	1370	85	1	76	0.0131579
NODE_248_length_4587_cov_14.431150	1294	1370	86	3	76	0.0394737
NODE_248_length_4587_cov_14.431150	1294	1370	87	1	76	0.0131579
NODE_248_length_4587_cov_14.431150	1294	1370	88	3	76	0.0394737
NODE_248_length_4587_cov_14.431150	1294	1370	90	2	76	0.0263158
NODE_248_length_4587_cov_14.431150	1294	1370	91	3	76	0.0394737
NODE_248_length_4587_cov_14.431150	1294	1370	94	1	76	0.0131579
NODE_248_length_4587_cov_14.431150	1294	1370	95	3	76	0.0394737
NODE_248_length_4587_cov_14.431150	1294	1370	96	8	76	0.1052632
NODE_248_length_4587_cov_14.431150	1294	1370	98	10	76	0.1315790
NODE_248_length_4587_cov_14.431150	1294	1370	99	4	76	0.0526316
NODE_248_length_4587_cov_14.431150	1294	1370	100	6	76	0.0789474
NODE_248_length_4587_cov_14.431150	1294	1370	101	5	76	0.0657895
NODE_248_length_4587_cov_14.431150	1294	1370	102	8	76	0.1052632
NODE_248_length_4587_cov_14.431150	1294	1370	104	4	76	0.0526316
NODE_248_length_4587_cov_14.431150	1294	1370	107	1	76	0.0131579
NODE_248_length_4587_cov_14.431150	1294	1370	109	2	76	0.0263158
NODE_248_length_4587_cov_14.431150	1294	1370	111	1	76	0.0131579
NODE_248_length_4587_cov_14.431150	1294	1370	113	1	76	0.0131579
NODE_248_length_4587_cov_14.431150	1294	1370	114	1	76	0.0131579
NODE_248_length_4587_cov_14.431150	1294	1370	118	2	76	0.0263158
NODE_248_length_4587_cov_14.431150	1347	1427	98	1	80	0.0125000
NODE_248_length_4587_cov_14.431150	1347	1427	99	2	80	0.0250000
NODE_248_length_4587_cov_14.431150	1347	1427	101	5	80	0.0625000
NODE_248_length_4587_cov_14.431150	1347	1427	102	3	80	0.0375000
NODE_248_length_4587_cov_14.431150	1347	1427	104	4	80	0.0500000
NODE_248_length_4587_cov_14.431150	1347	1427	107	1	80	0.0125000
NODE_248_length_4587_cov_14.431150	1347	1427	109	2	80	0.0250000
NODE_248_length_4587_cov_14.431150	1347	1427	111	1	80	0.0125000
NODE_248_length_4587_cov_14.431150	1347	1427	113	1	80	0.0125000
NODE_248_length_4587_cov_14.431150	1347	1427	114	1	80	0.0125000
NODE_248_length_4587_cov_14.431150	1347	1427	116	3	80	0.0375000
NODE_248_length_4587_cov_14.431150	1347	1427	118	3	80	0.0375000
NODE_248_length_4587_cov_14.431150	1347	1427	120	1	80	0.0125000
NODE_248_length_4587_cov_14.431150	1347	1427	121	3	80	0.0375000
NODE_248_length_4587_cov_14.431150	1347	1427	123	2	80	0.0250000
NODE_248_length_4587_cov_14.431150	1347	1427	125	2	80	0.0250000
NODE_248_length_4587_cov_14.431150	1347	1427	129	1	80	0.0125000
NODE_248_length_4587_cov_14.431150	1347	1427	130	3	80	0.0375000
NODE_248_length_4587_cov_14.431150	1347	1427	132	5	80	0.0625000
NODE_248_length_4587_cov_14.431150	1347	1427	133	1	80	0.0125000
NODE_248_length_4587_cov_14.431150	1347	1427	134	5	80	0.0625000
NODE_248_length_4587_cov_14.431150	1347	1427	135	3	80	0.0375000
NODE_248_length_4587_cov_14.431150	1347	1427	136	6	80	0.0750000
NODE_248_length_4587_cov_14.431150	1347	1427	138	1	80	0.0125000
NODE_248_length_4587_cov_14.431150	1347	1427	140	4	80	0.0500000
NODE_248_length_4587_cov_14.431150	1347	1427	142	2	80	0.0250000
NODE_248_length_4587_cov_14.431150	1347	1427	143	1	80	0.0125000
NODE_248_length_4587_cov_14.431150	1347	1427	144	2	80	0.0250000
NODE_248_length_4587_cov_14.431150	1347	1427	146	2	80	0.0250000
NODE_248_length_4587_cov_14.431150	1347	1427	148	1	80	0.0125000
NODE_248_length_4587_cov_14.431150	1347	1427	149	4	80	0.0500000
NODE_248_length_4587_cov_14.431150	1347	1427	150	1	80	0.0125000
NODE_248_length_4587_cov_14.431150	1347	1427	151	1	80	0.0125000
NODE_248_length_4587_cov_14.431150	1347	1427	153	2	80	0.0250000
NODE_248_length_4587_cov_14.431150	1466	1533	95	2	67	0.0298507
NODE_248_length_4587_cov_14.431150	1466	1533	101	1	67	0.0149254
NODE_248_length_4587_cov_14.431150	1466	1533	103	1	67	0.0149254
NODE_248_length_4587_cov_14.431150	1466	1533	105	3	67	0.0447761
NODE_248_length_4587_cov_14.431150	1466	1533	106	1	67	0.0149254
NODE_248_length_4587_cov_14.431150	1466	1533	107	1	67	0.0149254
NODE_248_length_4587_cov_14.431150	1466	1533	108	3	67	0.0447761
NODE_248_length_4587_cov_14.431150	1466	1533	109	1	67	0.0149254
NODE_248_length_4587_cov_14.431150	1466	1533	111	1	67	0.0149254
NODE_248_length_4587_cov_14.431150	1466	1533	115	3	67	0.0447761
NODE_248_length_4587_cov_14.431150	1466	1533	116	7	67	0.1044776
NODE_248_length_4587_cov_14.431150	1466	1533	117	2	67	0.0298507
NODE_248_length_4587_cov_14.431150	1466	1533	118	9	67	0.1343284
NODE_248_length_4587_cov_14.431150	1466	1533	119	3	67	0.0447761
NODE_248_length_4587_cov_14.431150	1466	1533	120	12	67	0.1791045
NODE_248_length_4587_cov_14.431150	1466	1533	121	3	67	0.0447761
NODE_248_length_4587_cov_14.431150	1466	1533	122	12	67	0.1791045
NODE_248_length_4587_cov_14.431150	1466	1533	123	1	67	0.0149254
NODE_248_length_4587_cov_14.431150	1466	1533	124	1	67	0.0149254
NODE_248_length_4587_cov_14.431150	4316	4382	165	1	66	0.0151515
NODE_248_length_4587_cov_14.431150	4316	4382	174	1	66	0.0151515
NODE_248_length_4587_cov_14.431150	4316	4382	176	1	66	0.0151515
NODE_248_length_4587_cov_14.431150	4316	4382	194	1	66	0.0151515
NODE_248_length_4587_cov_14.431150	4316	4382	197	1	66	0.0151515
NODE_248_length_4587_cov_14.431150	4316	4382	201	1	66	0.0151515
NODE_248_length_4587_cov_14.431150	4316	4382	216	2	66	0.0303030
NODE_248_length_4587_cov_14.431150	4316	4382	234	1	66	0.0151515
NODE_248_length_4587_cov_14.431150	4316	4382	235	1	66	0.0151515
NODE_248_length_4587_cov_14.431150	4316	4382	237	1	66	0.0151515
NODE_248_length_4587_cov_14.431150	4316	4382	240	1	66	0.0151515
NODE_248_length_4587_cov_14.431150	4316	4382	251	1	66	0.0151515
NODE_248_length_4587_cov_14.431150	4316	4382	264	1	66	0.0151515
NODE_248_length_4587_cov_14.431150	4316	4382	266	1	66	0.0151515
NODE_248_length_4587_cov_14.431150	4316	4382	267	1	66	0.0151515
NODE_248_length_4587_cov_14.431150	4316	4382	270	1	66	0.0151515
NODE_248_length_4587_cov_14.431150	4316	4382	276	1	66	0.0151515
NODE_248_length_4587_cov_14.431150	4316	4382	279	1	66	0.0151515
NODE_248_length_4587_cov_14.431150	4316	4382	280	1	66	0.0151515
NODE_248_length_4587_cov_14.431150	4316	4382	282	1	66	0.0151515
NODE_248_length_4587_cov_14.431150	4316	4382	287	1	66	0.0151515
NODE_248_length_4587_cov_14.431150	4316	4382	291	2	66	0.0303030
NODE_248_length_4587_cov_14.431150	4316	4382	292	1	66	0.0151515
NODE_248_length_4587_cov_14.431150	4316	4382	294	1	66	0.0151515
NODE_248_length_4587_cov_14.431150	4316	4382	300	1	66	0.0151515
NODE_248_length_4587_cov_14.431150	4316	4382	301	1	66	0.0151515
NODE_248_length_4587_cov_14.431150	4316	4382	307	1	66	0.0151515
NODE_248_length_4587_cov_14.431150	4316	4382	311	1	66	0.0151515
NODE_248_length_4587_cov_14.431150	4316	4382	315	1	66	0.0151515
NODE_248_length_4587_cov_14.431150	4316	4382	318	2	66	0.0303030
NODE_248_length_4587_cov_14.431150	4316	4382	325	1	66	0.0151515
NODE_248_length_4587_cov_14.431150	4316	4382	328	2	66	0.0303030
NODE_248_length_4587_cov_14.431150	4316	4382	339	1	66	0.0151515
NODE_248_length_4587_cov_14.431150	4316	4382	347	1	66	0.0151515
NODE_248_length_4587_cov_14.431150	4316	4382	350	1	66	0.0151515
NODE_248_length_4587_cov_14.431150	4316	4382	361	1	66	0.0151515
NODE_248_length_4587_cov_14.431150	4316	4382	376	2	66	0.0303030
NODE_248_length_4587_cov_14.431150	4316	4382	378	4	66	0.0606061
NODE_248_length_4587_cov_14.431150	4316	4382	380	1	66	0.0151515
NODE_248_length_4587_cov_14.431150	4316	4382	384	1	66	0.0151515
NODE_248_length_4587_cov_14.431150	4316	4382	386	1	66	0.0151515
NODE_248_length_4587_cov_14.431150	4316	4382	389	2	66	0.0303030
NODE_248_length_4587_cov_14.431150	4316	4382	390	1	66	0.0151515
NODE_248_length_4587_cov_14.431150	4316	4382	391	1	66	0.0151515
NODE_248_length_4587_cov_14.431150	4316	4382	392	2	66	0.0303030
NODE_248_length_4587_cov_14.431150	4316	4382	393	1	66	0.0151515
NODE_248_length_4587_cov_14.431150	4316	4382	394	1	66	0.0151515
NODE_248_length_4587_cov_14.431150	4316	4382	396	3	66	0.0454545
NODE_248_length_4587_cov_14.431150	4316	4382	398	2	66	0.0303030
NODE_248_length_4587_cov_14.431150	4316	4382	399	1	66	0.0151515
NODE_248_length_4587_cov_14.431150	4316	4382	401	1	66	0.0151515
NODE_248_length_4587_cov_14.431150	4316	4382	403	2	66	0.0303030
NODE_248_length_4587_cov_14.431150	4355	4435	360	1	80	0.0125000
NODE_248_length_4587_cov_14.431150	4355	4435	361	1	80	0.0125000
NODE_248_length_4587_cov_14.431150	4355	4435	365	1	80	0.0125000
NODE_248_length_4587_cov_14.431150	4355	4435	369	1	80	0.0125000
NODE_248_length_4587_cov_14.431150	4355	4435	373	1	80	0.0125000
NODE_248_length_4587_cov_14.431150	4355	4435	376	2	80	0.0250000
NODE_248_length_4587_cov_14.431150	4355	4435	377	1	80	0.0125000
NODE_248_length_4587_cov_14.431150	4355	4435	378	4	80	0.0500000
NODE_248_length_4587_cov_14.431150	4355	4435	380	1	80	0.0125000
NODE_248_length_4587_cov_14.431150	4355	4435	383	1	80	0.0125000
NODE_248_length_4587_cov_14.431150	4355	4435	384	1	80	0.0125000
NODE_248_length_4587_cov_14.431150	4355	4435	386	1	80	0.0125000
NODE_248_length_4587_cov_14.431150	4355	4435	389	2	80	0.0250000
NODE_248_length_4587_cov_14.431150	4355	4435	390	1	80	0.0125000
NODE_248_length_4587_cov_14.431150	4355	4435	391	1	80	0.0125000
NODE_248_length_4587_cov_14.431150	4355	4435	392	2	80	0.0250000
NODE_248_length_4587_cov_14.431150	4355	4435	393	3	80	0.0375000
NODE_248_length_4587_cov_14.431150	4355	4435	394	1	80	0.0125000
NODE_248_length_4587_cov_14.431150	4355	4435	396	3	80	0.0375000
NODE_248_length_4587_cov_14.431150	4355	4435	398	2	80	0.0250000
NODE_248_length_4587_cov_14.431150	4355	4435	399	1	80	0.0125000
NODE_248_length_4587_cov_14.431150	4355	4435	400	1	80	0.0125000
NODE_248_length_4587_cov_14.431150	4355	4435	401	1	80	0.0125000
NODE_248_length_4587_cov_14.431150	4355	4435	402	3	80	0.0375000
NODE_248_length_4587_cov_14.431150	4355	4435	403	3	80	0.0375000
NODE_248_length_4587_cov_14.431150	4355	4435	404	1	80	0.0125000
NODE_248_length_4587_cov_14.431150	4355	4435	406	2	80	0.0250000
NODE_248_length_4587_cov_14.431150	4355	4435	407	2	80	0.0250000
NODE_248_length_4587_cov_14.431150	4355	4435	412	2	80	0.0250000
NODE_248_length_4587_cov_14.431150	4355	4435	414	4	80	0.0500000
NODE_248_length_4587_cov_14.431150	4355	4435	418	3	80	0.0375000
NODE_248_length_4587_cov_14.431150	4355	4435	420	1	80	0.0125000
NODE_248_length_4587_cov_14.431150	4355	4435	423	3	80	0.0375000
NODE_248_length_4587_cov_14.431150	4355	4435	424	1	80	0.0125000
NODE_248_length_4587_cov_14.431150	4355	4435	434	2	80	0.0250000
NODE_248_length_4587_cov_14.431150	4355	4435	438	2	80	0.0250000
NODE_248_length_4587_cov_14.431150	4355	4435	440	1	80	0.0125000
NODE_248_length_4587_cov_14.431150	4355	4435	448	4	80	0.0500000
NODE_248_length_4587_cov_14.431150	4355	4435	449	1	80	0.0125000
NODE_248_length_4587_cov_14.431150	4355	4435	450	2	80	0.0250000
NODE_248_length_4587_cov_14.431150	4355	4435	452	4	80	0.0500000
NODE_248_length_4587_cov_14.431150	4355	4435	454	3	80	0.0375000
NODE_248_length_4587_cov_14.431150	4355	4435	456	2	80	0.0250000
NODE_249_length_4572_cov_50.244579	2406	2483	4	15	77	0.1948052
NODE_249_length_4572_cov_50.244579	2406	2483	6	38	77	0.4935065
NODE_249_length_4572_cov_50.244579	2406	2483	8	24	77	0.3116883
NODE_249_length_4572_cov_50.244579	2406	2483	4	15	77	0.1948052
NODE_249_length_4572_cov_50.244579	2406	2483	6	38	77	0.4935065
NODE_249_length_4572_cov_50.244579	2406	2483	8	24	77	0.3116883
NODE_251_length_4556_cov_14.556652	4229	4288	53	2	59	0.0338983
NODE_251_length_4556_cov_14.556652	4229	4288	55	4	59	0.0677966
NODE_251_length_4556_cov_14.556652	4229	4288	56	2	59	0.0338983
NODE_251_length_4556_cov_14.556652	4229	4288	58	3	59	0.0508475
NODE_251_length_4556_cov_14.556652	4229	4288	59	5	59	0.0847458
NODE_251_length_4556_cov_14.556652	4229	4288	64	1	59	0.0169492
NODE_251_length_4556_cov_14.556652	4229	4288	68	5	59	0.0847458
NODE_251_length_4556_cov_14.556652	4229	4288	70	2	59	0.0338983
NODE_251_length_4556_cov_14.556652	4229	4288	72	1	59	0.0169492
NODE_251_length_4556_cov_14.556652	4229	4288	76	3	59	0.0508475
NODE_251_length_4556_cov_14.556652	4229	4288	80	5	59	0.0847458
NODE_251_length_4556_cov_14.556652	4229	4288	84	1	59	0.0169492
NODE_251_length_4556_cov_14.556652	4229	4288	86	1	59	0.0169492
NODE_251_length_4556_cov_14.556652	4229	4288	87	2	59	0.0338983
NODE_251_length_4556_cov_14.556652	4229	4288	88	1	59	0.0169492
NODE_251_length_4556_cov_14.556652	4229	4288	89	1	59	0.0169492
NODE_251_length_4556_cov_14.556652	4229	4288	91	1	59	0.0169492
NODE_251_length_4556_cov_14.556652	4229	4288	95	3	59	0.0508475
NODE_251_length_4556_cov_14.556652	4229	4288	96	2	59	0.0338983
NODE_251_length_4556_cov_14.556652	4229	4288	98	5	59	0.0847458
NODE_251_length_4556_cov_14.556652	4229	4288	99	5	59	0.0847458
NODE_251_length_4556_cov_14.556652	4229	4288	103	4	59	0.0677966
NODE_252_length_4550_cov_5.664120	3548	3628	0	80	80	1.0000000
NODE_252_length_4550_cov_5.664120	3601	3681	0	80	80	1.0000000
NODE_253_length_4544_cov_10.690439	353	433	0	80	80	1.0000000
NODE_253_length_4544_cov_10.690439	406	486	0	80	80	1.0000000
NODE_253_length_4544_cov_10.690439	4487	4544	0	55	57	0.9649123
NODE_253_length_4544_cov_10.690439	4487	4544	15	2	57	0.0350877
NODE_255_length_4535_cov_24.849188	675	755	2	80	80	1.0000000
NODE_255_length_4535_cov_24.849188	728	809	2	81	81	1.0000000
NODE_255_length_4535_cov_24.849188	1319	1399	0	80	80	1.0000000
NODE_255_length_4535_cov_24.849188	1372	1452	0	34	80	0.4250000
NODE_255_length_4535_cov_24.849188	1372	1452	1	1	80	0.0125000
NODE_255_length_4535_cov_24.849188	1372	1452	3	10	80	0.1250000
NODE_255_length_4535_cov_24.849188	1372	1452	5	1	80	0.0125000
NODE_255_length_4535_cov_24.849188	1372	1452	8	2	80	0.0250000
NODE_255_length_4535_cov_24.849188	1372	1452	13	1	80	0.0125000
NODE_255_length_4535_cov_24.849188	1372	1452	14	1	80	0.0125000
NODE_255_length_4535_cov_24.849188	1372	1452	19	1	80	0.0125000
NODE_255_length_4535_cov_24.849188	1372	1452	21	1	80	0.0125000
NODE_255_length_4535_cov_24.849188	1372	1452	23	1	80	0.0125000
NODE_255_length_4535_cov_24.849188	1372	1452	25	1	80	0.0125000
NODE_255_length_4535_cov_24.849188	1372	1452	29	3	80	0.0375000
NODE_255_length_4535_cov_24.849188	1372	1452	33	1	80	0.0125000
NODE_255_length_4535_cov_24.849188	1372	1452	37	1	80	0.0125000
NODE_255_length_4535_cov_24.849188	1372	1452	39	2	80	0.0250000
NODE_255_length_4535_cov_24.849188	1372	1452	41	2	80	0.0250000
NODE_255_length_4535_cov_24.849188	1372	1452	48	1	80	0.0125000
NODE_255_length_4535_cov_24.849188	1372	1452	56	1	80	0.0125000
NODE_255_length_4535_cov_24.849188	1372	1452	58	1	80	0.0125000
NODE_255_length_4535_cov_24.849188	1372	1452	61	1	80	0.0125000
NODE_255_length_4535_cov_24.849188	1372	1452	68	1	80	0.0125000
NODE_255_length_4535_cov_24.849188	1372	1452	70	1	80	0.0125000
NODE_255_length_4535_cov_24.849188	1372	1452	72	1	80	0.0125000
NODE_255_length_4535_cov_24.849188	1372	1452	75	5	80	0.0625000
NODE_255_length_4535_cov_24.849188	1372	1452	79	1	80	0.0125000
NODE_255_length_4535_cov_24.849188	1372	1452	83	2	80	0.0250000
NODE_255_length_4535_cov_24.849188	1372	1452	86	1	80	0.0125000
NODE_255_length_4535_cov_24.849188	1372	1452	88	1	80	0.0125000
NODE_258_length_4528_cov_19.736509	4295	4366	0	27	71	0.3802817
NODE_258_length_4528_cov_19.736509	4295	4366	2	40	71	0.5633803
NODE_258_length_4528_cov_19.736509	4295	4366	4	1	71	0.0140845
NODE_258_length_4528_cov_19.736509	4295	4366	11	1	71	0.0140845
NODE_258_length_4528_cov_19.736509	4295	4366	18	1	71	0.0140845
NODE_258_length_4528_cov_19.736509	4295	4366	29	1	71	0.0140845
NODE_259_length_4505_cov_10.409215	3166	3202	12	3	36	0.0833333
NODE_259_length_4505_cov_10.409215	3166	3202	14	13	36	0.3611111
NODE_259_length_4505_cov_10.409215	3166	3202	16	8	36	0.2222222
NODE_259_length_4505_cov_10.409215	3166	3202	19	1	36	0.0277778
NODE_259_length_4505_cov_10.409215	3166	3202	21	4	36	0.1111111
NODE_259_length_4505_cov_10.409215	3166	3202	23	7	36	0.1944444
NODE_259_length_4505_cov_10.409215	3175	3255	14	7	80	0.0875000
NODE_259_length_4505_cov_10.409215	3175	3255	16	8	80	0.1000000
NODE_259_length_4505_cov_10.409215	3175	3255	19	1	80	0.0125000
NODE_259_length_4505_cov_10.409215	3175	3255	21	4	80	0.0500000
NODE_259_length_4505_cov_10.409215	3175	3255	23	8	80	0.1000000
NODE_259_length_4505_cov_10.409215	3175	3255	25	3	80	0.0375000
NODE_259_length_4505_cov_10.409215	3175	3255	27	1	80	0.0125000
NODE_259_length_4505_cov_10.409215	3175	3255	28	7	80	0.0875000
NODE_259_length_4505_cov_10.409215	3175	3255	29	1	80	0.0125000
NODE_259_length_4505_cov_10.409215	3175	3255	30	12	80	0.1500000
NODE_259_length_4505_cov_10.409215	3175	3255	31	4	80	0.0500000
NODE_259_length_4505_cov_10.409215	3175	3255	32	4	80	0.0500000
NODE_259_length_4505_cov_10.409215	3175	3255	33	3	80	0.0375000
NODE_259_length_4505_cov_10.409215	3175	3255	34	13	80	0.1625000
NODE_259_length_4505_cov_10.409215	3175	3255	36	4	80	0.0500000
NODE_260_length_4498_cov_8.216185	3161	3219	0	56	58	0.9655172
NODE_260_length_4498_cov_8.216185	3161	3219	2	2	58	0.0344828
NODE_260_length_4498_cov_8.216185	4257	4314	6	15	57	0.2631579
NODE_260_length_4498_cov_8.216185	4257	4314	7	42	57	0.7368421
NODE_263_length_4476_cov_29.825451	141	215	0	51	74	0.6891892
NODE_263_length_4476_cov_29.825451	141	215	2	23	74	0.3108108
NODE_263_length_4476_cov_29.825451	1890	1970	34	4	80	0.0500000
NODE_263_length_4476_cov_29.825451	1890	1970	36	8	80	0.1000000
NODE_263_length_4476_cov_29.825451	1890	1970	42	1	80	0.0125000
NODE_263_length_4476_cov_29.825451	1890	1970	44	9	80	0.1125000
NODE_263_length_4476_cov_29.825451	1890	1970	46	12	80	0.1500000
NODE_263_length_4476_cov_29.825451	1890	1970	47	1	80	0.0125000
NODE_263_length_4476_cov_29.825451	1890	1970	48	9	80	0.1125000
NODE_263_length_4476_cov_29.825451	1890	1970	49	8	80	0.1000000
NODE_263_length_4476_cov_29.825451	1890	1970	50	6	80	0.0750000
NODE_263_length_4476_cov_29.825451	1890	1970	51	8	80	0.1000000
NODE_263_length_4476_cov_29.825451	1890	1970	53	5	80	0.0625000
NODE_263_length_4476_cov_29.825451	1890	1970	55	1	80	0.0125000
NODE_263_length_4476_cov_29.825451	1890	1970	57	8	80	0.1000000
NODE_263_length_4476_cov_29.825451	1943	2023	24	4	80	0.0500000
NODE_263_length_4476_cov_29.825451	1943	2023	26	1	80	0.0125000
NODE_263_length_4476_cov_29.825451	1943	2023	28	1	80	0.0125000
NODE_263_length_4476_cov_29.825451	1943	2023	30	1	80	0.0125000
NODE_263_length_4476_cov_29.825451	1943	2023	32	12	80	0.1500000
NODE_263_length_4476_cov_29.825451	1943	2023	36	3	80	0.0375000
NODE_263_length_4476_cov_29.825451	1943	2023	38	6	80	0.0750000
NODE_263_length_4476_cov_29.825451	1943	2023	40	5	80	0.0625000
NODE_263_length_4476_cov_29.825451	1943	2023	42	7	80	0.0875000
NODE_263_length_4476_cov_29.825451	1943	2023	44	4	80	0.0500000
NODE_263_length_4476_cov_29.825451	1943	2023	46	6	80	0.0750000
NODE_263_length_4476_cov_29.825451	1943	2023	47	1	80	0.0125000
NODE_263_length_4476_cov_29.825451	1943	2023	48	9	80	0.1125000
NODE_263_length_4476_cov_29.825451	1943	2023	49	8	80	0.1000000
NODE_263_length_4476_cov_29.825451	1943	2023	50	5	80	0.0625000
NODE_263_length_4476_cov_29.825451	1943	2023	51	4	80	0.0500000
NODE_263_length_4476_cov_29.825451	1943	2023	53	3	80	0.0375000
NODE_264_length_4474_cov_17.051886	23	99	0	76	76	1.0000000
NODE_264_length_4474_cov_17.051886	23	98	0	75	75	1.0000000
NODE_264_length_4474_cov_17.051886	23	99	0	76	76	1.0000000
NODE_264_length_4474_cov_17.051886	32	99	0	67	67	1.0000000
NODE_264_length_4474_cov_17.051886	76	140	0	64	64	1.0000000
NODE_264_length_4474_cov_17.051886	1528	1569	61	5	41	0.1219512
NODE_264_length_4474_cov_17.051886	1528	1569	63	1	41	0.0243902
NODE_264_length_4474_cov_17.051886	1528	1569	65	2	41	0.0487805
NODE_264_length_4474_cov_17.051886	1528	1569	66	2	41	0.0487805
NODE_264_length_4474_cov_17.051886	1528	1569	68	2	41	0.0487805
NODE_264_length_4474_cov_17.051886	1528	1569	70	1	41	0.0243902
NODE_264_length_4474_cov_17.051886	1528	1569	74	2	41	0.0487805
NODE_264_length_4474_cov_17.051886	1528	1569	76	1	41	0.0243902
NODE_264_length_4474_cov_17.051886	1528	1569	94	1	41	0.0243902
NODE_264_length_4474_cov_17.051886	1528	1569	99	2	41	0.0487805
NODE_264_length_4474_cov_17.051886	1528	1569	101	1	41	0.0243902
NODE_264_length_4474_cov_17.051886	1528	1569	105	1	41	0.0243902
NODE_264_length_4474_cov_17.051886	1528	1569	113	2	41	0.0487805
NODE_264_length_4474_cov_17.051886	1528	1569	116	1	41	0.0243902
NODE_264_length_4474_cov_17.051886	1528	1569	120	1	41	0.0243902
NODE_264_length_4474_cov_17.051886	1528	1569	122	1	41	0.0243902
NODE_264_length_4474_cov_17.051886	1528	1569	126	1	41	0.0243902
NODE_264_length_4474_cov_17.051886	1528	1569	128	3	41	0.0731707
NODE_264_length_4474_cov_17.051886	1528	1569	130	1	41	0.0243902
NODE_264_length_4474_cov_17.051886	1528	1569	131	2	41	0.0487805
NODE_264_length_4474_cov_17.051886	1528	1569	137	3	41	0.0731707
NODE_264_length_4474_cov_17.051886	1528	1569	141	1	41	0.0243902
NODE_264_length_4474_cov_17.051886	1528	1569	144	1	41	0.0243902
NODE_264_length_4474_cov_17.051886	1528	1569	148	2	41	0.0487805
NODE_264_length_4474_cov_17.051886	1528	1569	163	1	41	0.0243902
NODE_264_length_4474_cov_17.051886	1536	1609	22	13	73	0.1780822
NODE_264_length_4474_cov_17.051886	1536	1609	24	1	73	0.0136986
NODE_264_length_4474_cov_17.051886	1536	1609	28	1	73	0.0136986
NODE_264_length_4474_cov_17.051886	1536	1609	34	2	73	0.0273973
NODE_264_length_4474_cov_17.051886	1536	1609	36	1	73	0.0136986
NODE_264_length_4474_cov_17.051886	1536	1609	37	7	73	0.0958904
NODE_264_length_4474_cov_17.051886	1536	1609	40	2	73	0.0273973
NODE_264_length_4474_cov_17.051886	1536	1609	47	3	73	0.0410959
NODE_264_length_4474_cov_17.051886	1536	1609	49	3	73	0.0410959
NODE_264_length_4474_cov_17.051886	1536	1609	52	1	73	0.0136986
NODE_264_length_4474_cov_17.051886	1536	1609	56	4	73	0.0547945
NODE_264_length_4474_cov_17.051886	1536	1609	59	1	73	0.0136986
NODE_264_length_4474_cov_17.051886	1536	1609	61	6	73	0.0821918
NODE_264_length_4474_cov_17.051886	1536	1609	63	1	73	0.0136986
NODE_264_length_4474_cov_17.051886	1536	1609	65	2	73	0.0273973
NODE_264_length_4474_cov_17.051886	1536	1609	66	2	73	0.0273973
NODE_264_length_4474_cov_17.051886	1536	1609	68	2	73	0.0273973
NODE_264_length_4474_cov_17.051886	1536	1609	70	1	73	0.0136986
NODE_264_length_4474_cov_17.051886	1536	1609	74	2	73	0.0273973
NODE_264_length_4474_cov_17.051886	1536	1609	76	1	73	0.0136986
NODE_264_length_4474_cov_17.051886	1536	1609	94	1	73	0.0136986
NODE_264_length_4474_cov_17.051886	1536	1609	99	2	73	0.0273973
NODE_264_length_4474_cov_17.051886	1536	1609	101	1	73	0.0136986
NODE_264_length_4474_cov_17.051886	1536	1609	105	1	73	0.0136986
NODE_264_length_4474_cov_17.051886	1536	1609	113	2	73	0.0273973
NODE_264_length_4474_cov_17.051886	1536	1609	116	1	73	0.0136986
NODE_264_length_4474_cov_17.051886	1536	1609	120	1	73	0.0136986
NODE_264_length_4474_cov_17.051886	1536	1609	122	1	73	0.0136986
NODE_264_length_4474_cov_17.051886	1536	1609	126	1	73	0.0136986
NODE_264_length_4474_cov_17.051886	1536	1609	128	3	73	0.0410959
NODE_264_length_4474_cov_17.051886	1536	1609	130	1	73	0.0136986
NODE_264_length_4474_cov_17.051886	1536	1609	131	2	73	0.0273973
NODE_264_length_4474_cov_17.051886	1618	1643	0	19	25	0.7600000
NODE_264_length_4474_cov_17.051886	1618	1643	2	2	25	0.0800000
NODE_264_length_4474_cov_17.051886	1618	1643	10	2	25	0.0800000
NODE_264_length_4474_cov_17.051886	1618	1643	12	2	25	0.0800000
NODE_264_length_4474_cov_17.051886	1618	1696	0	72	78	0.9230769
NODE_264_length_4474_cov_17.051886	1618	1696	2	2	78	0.0256410
NODE_264_length_4474_cov_17.051886	1618	1696	10	2	78	0.0256410
NODE_264_length_4474_cov_17.051886	1618	1696	12	2	78	0.0256410
NODE_265_length_4474_cov_14.441829	282	362	0	31	80	0.3875000
NODE_265_length_4474_cov_14.441829	282	362	1	49	80	0.6125000
NODE_265_length_4474_cov_14.441829	335	415	0	76	80	0.9500000
NODE_265_length_4474_cov_14.441829	335	415	5	1	80	0.0125000
NODE_265_length_4474_cov_14.441829	335	415	16	1	80	0.0125000
NODE_265_length_4474_cov_14.441829	335	415	49	1	80	0.0125000
NODE_265_length_4474_cov_14.441829	335	415	65	1	80	0.0125000
NODE_265_length_4474_cov_14.441829	1522	1575	4	31	53	0.5849057
NODE_265_length_4474_cov_14.441829	1522	1575	6	18	53	0.3396226
NODE_265_length_4474_cov_14.441829	1522	1575	22	1	53	0.0188679
NODE_265_length_4474_cov_14.441829	1522	1575	26	1	53	0.0188679
NODE_265_length_4474_cov_14.441829	1522	1575	28	2	53	0.0377358
NODE_265_length_4474_cov_14.441829	1548	1623	4	9	75	0.1200000
NODE_265_length_4474_cov_14.441829	1548	1623	6	18	75	0.2400000
NODE_265_length_4474_cov_14.441829	1548	1623	8	8	75	0.1066667
NODE_265_length_4474_cov_14.441829	1548	1623	10	1	75	0.0133333
NODE_265_length_4474_cov_14.441829	1548	1623	12	6	75	0.0800000
NODE_265_length_4474_cov_14.441829	1548	1623	14	1	75	0.0133333
NODE_265_length_4474_cov_14.441829	1548	1623	15	1	75	0.0133333
NODE_265_length_4474_cov_14.441829	1548	1623	16	17	75	0.2266667
NODE_265_length_4474_cov_14.441829	1548	1623	18	14	75	0.1866667
NODE_265_length_4474_cov_14.441829	3068	3121	2	35	53	0.6603774
NODE_265_length_4474_cov_14.441829	3068	3121	4	16	53	0.3018868
NODE_265_length_4474_cov_14.441829	3068	3121	18	1	53	0.0188679
NODE_265_length_4474_cov_14.441829	3068	3121	22	1	53	0.0188679
NODE_268_length_4463_cov_7.023144	119	168	0	44	49	0.8979592
NODE_268_length_4463_cov_7.023144	119	168	7	1	49	0.0204082
NODE_268_length_4463_cov_7.023144	119	168	8	4	49	0.0816327
NODE_270_length_4453_cov_16.820395	3383	3463	40	1	80	0.0125000
NODE_270_length_4453_cov_16.820395	3383	3463	42	13	80	0.1625000
NODE_270_length_4453_cov_16.820395	3383	3463	44	5	80	0.0625000
NODE_270_length_4453_cov_16.820395	3383	3463	46	9	80	0.1125000
NODE_270_length_4453_cov_16.820395	3383	3463	48	7	80	0.0875000
NODE_270_length_4453_cov_16.820395	3383	3463	49	2	80	0.0250000
NODE_270_length_4453_cov_16.820395	3383	3463	50	4	80	0.0500000
NODE_270_length_4453_cov_16.820395	3383	3463	51	3	80	0.0375000
NODE_270_length_4453_cov_16.820395	3383	3463	52	4	80	0.0500000
NODE_270_length_4453_cov_16.820395	3383	3463	53	15	80	0.1875000
NODE_270_length_4453_cov_16.820395	3383	3463	54	1	80	0.0125000
NODE_270_length_4453_cov_16.820395	3383	3463	55	9	80	0.1125000
NODE_270_length_4453_cov_16.820395	3383	3463	56	7	80	0.0875000
NODE_270_length_4453_cov_16.820395	3436	3496	18	1	60	0.0166667
NODE_270_length_4453_cov_16.820395	3436	3496	22	8	60	0.1333333
NODE_270_length_4453_cov_16.820395	3436	3496	24	7	60	0.1166667
NODE_270_length_4453_cov_16.820395	3436	3496	26	2	60	0.0333333
NODE_270_length_4453_cov_16.820395	3436	3496	28	3	60	0.0500000
NODE_270_length_4453_cov_16.820395	3436	3496	34	2	60	0.0333333
NODE_270_length_4453_cov_16.820395	3436	3496	36	3	60	0.0500000
NODE_270_length_4453_cov_16.820395	3436	3496	40	8	60	0.1333333
NODE_270_length_4453_cov_16.820395	3436	3496	42	5	60	0.0833333
NODE_270_length_4453_cov_16.820395	3436	3496	44	4	60	0.0666667
NODE_270_length_4453_cov_16.820395	3436	3496	46	1	60	0.0166667
NODE_270_length_4453_cov_16.820395	3436	3496	49	2	60	0.0333333
NODE_270_length_4453_cov_16.820395	3436	3496	51	3	60	0.0500000
NODE_270_length_4453_cov_16.820395	3436	3496	53	11	60	0.1833333
NODE_272_length_4436_cov_31.114595	2807	2871	2	9	64	0.1406250
NODE_272_length_4436_cov_31.114595	2807	2871	4	7	64	0.1093750
NODE_272_length_4436_cov_31.114595	2807	2871	6	3	64	0.0468750
NODE_272_length_4436_cov_31.114595	2807	2871	14	13	64	0.2031250
NODE_272_length_4436_cov_31.114595	2807	2871	23	3	64	0.0468750
NODE_272_length_4436_cov_31.114595	2807	2871	27	9	64	0.1406250
NODE_272_length_4436_cov_31.114595	2807	2871	29	20	64	0.3125000
NODE_272_length_4436_cov_31.114595	2846	2906	0	29	60	0.4833333
NODE_272_length_4436_cov_31.114595	2846	2906	2	15	60	0.2500000
NODE_272_length_4436_cov_31.114595	2846	2906	4	7	60	0.1166667
NODE_272_length_4436_cov_31.114595	2846	2906	6	3	60	0.0500000
NODE_272_length_4436_cov_31.114595	2846	2906	14	6	60	0.1000000
NODE_272_length_4436_cov_31.114595	2846	2898	0	21	52	0.4038461
NODE_272_length_4436_cov_31.114595	2846	2898	2	15	52	0.2884615
NODE_272_length_4436_cov_31.114595	2846	2898	4	7	52	0.1346154
NODE_272_length_4436_cov_31.114595	2846	2898	6	3	52	0.0576923
NODE_272_length_4436_cov_31.114595	2846	2898	14	6	52	0.1153846
NODE_278_length_4391_cov_7.711323	66	141	0	28	75	0.3733333
NODE_278_length_4391_cov_7.711323	66	141	2	47	75	0.6266667
NODE_278_length_4391_cov_7.711323	119	155	0	31	36	0.8611111
NODE_278_length_4391_cov_7.711323	119	155	4	3	36	0.0833333
NODE_278_length_4391_cov_7.711323	119	155	6	2	36	0.0555556
NODE_279_length_4385_cov_6.067662	1556	1606	4	4	50	0.0800000
NODE_279_length_4385_cov_6.067662	1556	1606	8	2	50	0.0400000
NODE_279_length_4385_cov_6.067662	1556	1606	10	12	50	0.2400000
NODE_279_length_4385_cov_6.067662	1556	1606	12	14	50	0.2800000
NODE_279_length_4385_cov_6.067662	1556	1606	14	2	50	0.0400000
NODE_279_length_4385_cov_6.067662	1556	1606	16	6	50	0.1200000
NODE_279_length_4385_cov_6.067662	1556	1606	18	2	50	0.0400000
NODE_279_length_4385_cov_6.067662	1556	1606	20	1	50	0.0200000
NODE_279_length_4385_cov_6.067662	1556	1606	22	3	50	0.0600000
NODE_279_length_4385_cov_6.067662	1556	1606	24	4	50	0.0800000
NODE_286_length_4331_cov_37.938800	1898	1978	12	4	80	0.0500000
NODE_286_length_4331_cov_37.938800	1898	1978	16	5	80	0.0625000
NODE_286_length_4331_cov_37.938800	1898	1978	18	1	80	0.0125000
NODE_286_length_4331_cov_37.938800	1898	1978	20	13	80	0.1625000
NODE_286_length_4331_cov_37.938800	1898	1978	22	7	80	0.0875000
NODE_286_length_4331_cov_37.938800	1898	1978	23	4	80	0.0500000
NODE_286_length_4331_cov_37.938800	1898	1978	24	6	80	0.0750000
NODE_286_length_4331_cov_37.938800	1898	1978	25	10	80	0.1250000
NODE_286_length_4331_cov_37.938800	1898	1978	26	14	80	0.1750000
NODE_286_length_4331_cov_37.938800	1898	1978	27	3	80	0.0375000
NODE_286_length_4331_cov_37.938800	1898	1978	29	13	80	0.1625000
NODE_286_length_4331_cov_37.938800	1951	2031	23	1	80	0.0125000
NODE_286_length_4331_cov_37.938800	1951	2031	25	10	80	0.1250000
NODE_286_length_4331_cov_37.938800	1951	2031	27	4	80	0.0500000
NODE_286_length_4331_cov_37.938800	1951	2031	29	17	80	0.2125000
NODE_286_length_4331_cov_37.938800	1951	2031	30	1	80	0.0125000
NODE_286_length_4331_cov_37.938800	1951	2031	31	3	80	0.0375000
NODE_286_length_4331_cov_37.938800	1951	2031	33	6	80	0.0750000
NODE_286_length_4331_cov_37.938800	1951	2031	34	1	80	0.0125000
NODE_286_length_4331_cov_37.938800	1951	2031	36	8	80	0.1000000
NODE_286_length_4331_cov_37.938800	1951	2031	40	4	80	0.0500000
NODE_286_length_4331_cov_37.938800	1951	2031	42	6	80	0.0750000
NODE_286_length_4331_cov_37.938800	1951	2031	46	4	80	0.0500000
NODE_286_length_4331_cov_37.938800	1951	2031	47	1	80	0.0125000
NODE_286_length_4331_cov_37.938800	1951	2031	49	2	80	0.0250000
NODE_286_length_4331_cov_37.938800	1951	2031	51	1	80	0.0125000
NODE_286_length_4331_cov_37.938800	1951	2031	53	3	80	0.0375000
NODE_286_length_4331_cov_37.938800	1951	2031	57	1	80	0.0125000
NODE_286_length_4331_cov_37.938800	1951	2031	59	1	80	0.0125000
NODE_286_length_4331_cov_37.938800	1951	2031	63	2	80	0.0250000
NODE_286_length_4331_cov_37.938800	1951	2031	65	2	80	0.0250000
NODE_286_length_4331_cov_37.938800	1951	2031	76	2	80	0.0250000
NODE_286_length_4331_cov_37.938800	2027	2107	65	2	80	0.0250000
NODE_286_length_4331_cov_37.938800	2027	2107	76	3	80	0.0375000
NODE_286_length_4331_cov_37.938800	2027	2107	84	8	80	0.1000000
NODE_286_length_4331_cov_37.938800	2027	2107	86	1	80	0.0125000
NODE_286_length_4331_cov_37.938800	2027	2107	89	1	80	0.0125000
NODE_286_length_4331_cov_37.938800	2027	2107	90	2	80	0.0250000
NODE_286_length_4331_cov_37.938800	2027	2107	91	1	80	0.0125000
NODE_286_length_4331_cov_37.938800	2027	2107	97	2	80	0.0250000
NODE_286_length_4331_cov_37.938800	2027	2107	101	2	80	0.0250000
NODE_286_length_4331_cov_37.938800	2027	2107	104	1	80	0.0125000
NODE_286_length_4331_cov_37.938800	2027	2107	105	2	80	0.0250000
NODE_286_length_4331_cov_37.938800	2027	2107	110	2	80	0.0250000
NODE_286_length_4331_cov_37.938800	2027	2107	111	1	80	0.0125000
NODE_286_length_4331_cov_37.938800	2027	2107	115	1	80	0.0125000
NODE_286_length_4331_cov_37.938800	2027	2107	120	1	80	0.0125000
NODE_286_length_4331_cov_37.938800	2027	2107	121	2	80	0.0250000
NODE_286_length_4331_cov_37.938800	2027	2107	127	1	80	0.0125000
NODE_286_length_4331_cov_37.938800	2027	2107	129	4	80	0.0500000
NODE_286_length_4331_cov_37.938800	2027	2107	131	1	80	0.0125000
NODE_286_length_4331_cov_37.938800	2027	2107	137	2	80	0.0250000
NODE_286_length_4331_cov_37.938800	2027	2107	139	1	80	0.0125000
NODE_286_length_4331_cov_37.938800	2027	2107	144	3	80	0.0375000
NODE_286_length_4331_cov_37.938800	2027	2107	152	2	80	0.0250000
NODE_286_length_4331_cov_37.938800	2027	2107	154	4	80	0.0500000
NODE_286_length_4331_cov_37.938800	2027	2107	156	2	80	0.0250000
NODE_286_length_4331_cov_37.938800	2027	2107	158	7	80	0.0875000
NODE_286_length_4331_cov_37.938800	2027	2107	160	1	80	0.0125000
NODE_286_length_4331_cov_37.938800	2027	2107	161	1	80	0.0125000
NODE_286_length_4331_cov_37.938800	2027	2107	162	3	80	0.0375000
NODE_286_length_4331_cov_37.938800	2027	2107	163	3	80	0.0375000
NODE_286_length_4331_cov_37.938800	2027	2107	164	3	80	0.0375000
NODE_286_length_4331_cov_37.938800	2027	2107	165	2	80	0.0250000
NODE_286_length_4331_cov_37.938800	2027	2107	166	1	80	0.0125000
NODE_286_length_4331_cov_37.938800	2027	2107	168	3	80	0.0375000
NODE_286_length_4331_cov_37.938800	2027	2107	173	1	80	0.0125000
NODE_286_length_4331_cov_37.938800	2027	2107	179	1	80	0.0125000
NODE_286_length_4331_cov_37.938800	2027	2107	180	2	80	0.0250000
NODE_286_length_4331_cov_37.938800	2080	2160	115	1	80	0.0125000
NODE_286_length_4331_cov_37.938800	2080	2160	119	3	80	0.0375000
NODE_286_length_4331_cov_37.938800	2080	2160	120	4	80	0.0500000
NODE_286_length_4331_cov_37.938800	2080	2160	121	1	80	0.0125000
NODE_286_length_4331_cov_37.938800	2080	2160	129	4	80	0.0500000
NODE_286_length_4331_cov_37.938800	2080	2160	131	2	80	0.0250000
NODE_286_length_4331_cov_37.938800	2080	2160	133	2	80	0.0250000
NODE_286_length_4331_cov_37.938800	2080	2160	135	1	80	0.0125000
NODE_286_length_4331_cov_37.938800	2080	2160	147	1	80	0.0125000
NODE_286_length_4331_cov_37.938800	2080	2160	148	2	80	0.0250000
NODE_286_length_4331_cov_37.938800	2080	2160	149	2	80	0.0250000
NODE_286_length_4331_cov_37.938800	2080	2160	153	1	80	0.0125000
NODE_286_length_4331_cov_37.938800	2080	2160	155	2	80	0.0250000
NODE_286_length_4331_cov_37.938800	2080	2160	157	4	80	0.0500000
NODE_286_length_4331_cov_37.938800	2080	2160	158	6	80	0.0750000
NODE_286_length_4331_cov_37.938800	2080	2160	160	1	80	0.0125000
NODE_286_length_4331_cov_37.938800	2080	2160	161	1	80	0.0125000
NODE_286_length_4331_cov_37.938800	2080	2160	162	3	80	0.0375000
NODE_286_length_4331_cov_37.938800	2080	2160	163	4	80	0.0500000
NODE_286_length_4331_cov_37.938800	2080	2160	164	3	80	0.0375000
NODE_286_length_4331_cov_37.938800	2080	2160	165	3	80	0.0375000
NODE_286_length_4331_cov_37.938800	2080	2160	166	1	80	0.0125000
NODE_286_length_4331_cov_37.938800	2080	2160	167	2	80	0.0250000
NODE_286_length_4331_cov_37.938800	2080	2160	168	3	80	0.0375000
NODE_286_length_4331_cov_37.938800	2080	2160	169	1	80	0.0125000
NODE_286_length_4331_cov_37.938800	2080	2160	171	3	80	0.0375000
NODE_286_length_4331_cov_37.938800	2080	2160	172	1	80	0.0125000
NODE_286_length_4331_cov_37.938800	2080	2160	173	1	80	0.0125000
NODE_286_length_4331_cov_37.938800	2080	2160	176	1	80	0.0125000
NODE_286_length_4331_cov_37.938800	2080	2160	179	1	80	0.0125000
NODE_286_length_4331_cov_37.938800	2080	2160	180	5	80	0.0625000
NODE_286_length_4331_cov_37.938800	2080	2160	182	10	80	0.1250000
NODE_289_length_4320_cov_7.680881	442	522	0	80	80	1.0000000
NODE_289_length_4320_cov_7.680881	495	575	0	80	80	1.0000000
NODE_289_length_4320_cov_7.680881	571	651	0	80	80	1.0000000
NODE_289_length_4320_cov_7.680881	624	704	0	80	80	1.0000000
NODE_290_length_4314_cov_5.311507	1436	1516	0	19	80	0.2375000
NODE_290_length_4314_cov_5.311507	1436	1516	4	61	80	0.7625000
NODE_290_length_4314_cov_5.311507	1489	1569	0	19	80	0.2375000
NODE_290_length_4314_cov_5.311507	1489	1569	2	19	80	0.2375000
NODE_290_length_4314_cov_5.311507	1489	1569	4	42	80	0.5250000
NODE_290_length_4314_cov_5.311507	3331	3400	0	8	69	0.1159420
NODE_290_length_4314_cov_5.311507	3331	3400	2	9	69	0.1304348
NODE_290_length_4314_cov_5.311507	3331	3400	4	52	69	0.7536232
NODE_290_length_4314_cov_5.311507	3420	3482	6	14	62	0.2258064
NODE_290_length_4314_cov_5.311507	3420	3482	8	8	62	0.1290323
NODE_290_length_4314_cov_5.311507	3420	3482	12	11	62	0.1774193
NODE_290_length_4314_cov_5.311507	3420	3482	14	29	62	0.4677419
NODE_292_length_4311_cov_8.733381	92	171	8	12	79	0.1518987
NODE_292_length_4311_cov_8.733381	92	171	10	1	79	0.0126582
NODE_292_length_4311_cov_8.733381	92	171	12	66	79	0.8354430
NODE_292_length_4311_cov_8.733381	1925	2005	0	80	80	1.0000000
NODE_292_length_4311_cov_8.733381	1978	2058	0	80	80	1.0000000
NODE_294_length_4293_cov_3.809251	244	326	2	82	82	1.0000000
NODE_294_length_4293_cov_3.809251	301	394	0	62	93	0.6666667
NODE_294_length_4293_cov_3.809251	301	394	2	31	93	0.3333333
NODE_295_length_4284_cov_15.940263	3726	3806	0	80	80	1.0000000
NODE_295_length_4284_cov_15.940263	3779	3858	0	79	79	1.0000000
NODE_299_length_4277_cov_5.451173	3818	3898	0	7	80	0.0875000
NODE_299_length_4277_cov_5.451173	3818	3898	2	73	80	0.9125000
NODE_299_length_4277_cov_5.451173	3927	3995	0	68	68	1.0000000
NODE_299_length_4277_cov_5.451173	3968	4048	0	80	80	1.0000000
NODE_300_length_4274_cov_18.943234	591	671	4	16	80	0.2000000
NODE_300_length_4274_cov_18.943234	591	671	8	3	80	0.0375000
NODE_300_length_4274_cov_18.943234	591	671	10	20	80	0.2500000
NODE_300_length_4274_cov_18.943234	591	671	12	41	80	0.5125000
NODE_300_length_4274_cov_18.943234	644	724	0	7	80	0.0875000
NODE_300_length_4274_cov_18.943234	644	724	2	10	80	0.1250000
NODE_300_length_4274_cov_18.943234	644	724	8	39	80	0.4875000
NODE_300_length_4274_cov_18.943234	644	724	12	24	80	0.3000000
NODE_301_length_4274_cov_16.160958	416	496	0	41	80	0.5125000
NODE_301_length_4274_cov_16.160958	416	496	4	4	80	0.0500000
NODE_301_length_4274_cov_16.160958	416	496	8	5	80	0.0625000
NODE_301_length_4274_cov_16.160958	416	496	10	30	80	0.3750000
NODE_301_length_4274_cov_16.160958	1034	1114	0	7	80	0.0875000
NODE_301_length_4274_cov_16.160958	1034	1114	2	73	80	0.9125000
NODE_301_length_4274_cov_16.160958	1087	1167	2	28	80	0.3500000
NODE_301_length_4274_cov_16.160958	1087	1167	4	15	80	0.1875000
NODE_301_length_4274_cov_16.160958	1087	1167	5	22	80	0.2750000
NODE_301_length_4274_cov_16.160958	1087	1167	6	15	80	0.1875000
NODE_301_length_4274_cov_16.160958	1163	1243	4	37	80	0.4625000
NODE_301_length_4274_cov_16.160958	1163	1243	6	43	80	0.5375000
NODE_301_length_4274_cov_16.160958	1216	1296	0	5	80	0.0625000
NODE_301_length_4274_cov_16.160958	1216	1296	2	42	80	0.5250000
NODE_301_length_4274_cov_16.160958	1216	1296	6	33	80	0.4125000
NODE_301_length_4274_cov_16.160958	3411	3491	0	69	80	0.8625000
NODE_301_length_4274_cov_16.160958	3411	3491	2	1	80	0.0125000
NODE_301_length_4274_cov_16.160958	3411	3491	6	1	80	0.0125000
NODE_301_length_4274_cov_16.160958	3411	3491	8	4	80	0.0500000
NODE_301_length_4274_cov_16.160958	3411	3491	10	5	80	0.0625000
NODE_302_length_4270_cov_14.045792	3835	3915	132	4	80	0.0500000
NODE_302_length_4270_cov_14.045792	3835	3915	134	1	80	0.0125000
NODE_302_length_4270_cov_14.045792	3835	3915	136	1	80	0.0125000
NODE_302_length_4270_cov_14.045792	3835	3915	139	2	80	0.0250000
NODE_302_length_4270_cov_14.045792	3835	3915	145	1	80	0.0125000
NODE_302_length_4270_cov_14.045792	3835	3915	147	1	80	0.0125000
NODE_302_length_4270_cov_14.045792	3835	3915	151	1	80	0.0125000
NODE_302_length_4270_cov_14.045792	3835	3915	156	1	80	0.0125000
NODE_302_length_4270_cov_14.045792	3835	3915	159	2	80	0.0250000
NODE_302_length_4270_cov_14.045792	3835	3915	161	1	80	0.0125000
NODE_302_length_4270_cov_14.045792	3835	3915	162	1	80	0.0125000
NODE_302_length_4270_cov_14.045792	3835	3915	163	2	80	0.0250000
NODE_302_length_4270_cov_14.045792	3835	3915	165	1	80	0.0125000
NODE_302_length_4270_cov_14.045792	3835	3915	166	2	80	0.0250000
NODE_302_length_4270_cov_14.045792	3835	3915	167	2	80	0.0250000
NODE_302_length_4270_cov_14.045792	3835	3915	169	7	80	0.0875000
NODE_302_length_4270_cov_14.045792	3835	3915	171	6	80	0.0750000
NODE_302_length_4270_cov_14.045792	3835	3915	172	8	80	0.1000000
NODE_302_length_4270_cov_14.045792	3835	3915	173	7	80	0.0875000
NODE_302_length_4270_cov_14.045792	3835	3915	174	2	80	0.0250000
NODE_302_length_4270_cov_14.045792	3835	3915	175	2	80	0.0250000
NODE_302_length_4270_cov_14.045792	3835	3915	177	3	80	0.0375000
NODE_302_length_4270_cov_14.045792	3835	3915	178	4	80	0.0500000
NODE_302_length_4270_cov_14.045792	3835	3915	179	1	80	0.0125000
NODE_302_length_4270_cov_14.045792	3835	3915	180	2	80	0.0250000
NODE_302_length_4270_cov_14.045792	3835	3915	181	5	80	0.0625000
NODE_302_length_4270_cov_14.045792	3835	3915	183	5	80	0.0625000
NODE_302_length_4270_cov_14.045792	3835	3915	184	5	80	0.0625000
NODE_302_length_4270_cov_14.045792	3888	3968	121	2	80	0.0250000
NODE_302_length_4270_cov_14.045792	3888	3968	122	4	80	0.0500000
NODE_302_length_4270_cov_14.045792	3888	3968	124	2	80	0.0250000
NODE_302_length_4270_cov_14.045792	3888	3968	125	2	80	0.0250000
NODE_302_length_4270_cov_14.045792	3888	3968	126	4	80	0.0500000
NODE_302_length_4270_cov_14.045792	3888	3968	128	5	80	0.0625000
NODE_302_length_4270_cov_14.045792	3888	3968	130	2	80	0.0250000
NODE_302_length_4270_cov_14.045792	3888	3968	132	1	80	0.0125000
NODE_302_length_4270_cov_14.045792	3888	3968	134	2	80	0.0250000
NODE_302_length_4270_cov_14.045792	3888	3968	135	2	80	0.0250000
NODE_302_length_4270_cov_14.045792	3888	3968	136	1	80	0.0125000
NODE_302_length_4270_cov_14.045792	3888	3968	137	1	80	0.0125000
NODE_302_length_4270_cov_14.045792	3888	3968	138	1	80	0.0125000
NODE_302_length_4270_cov_14.045792	3888	3968	145	1	80	0.0125000
NODE_302_length_4270_cov_14.045792	3888	3968	147	6	80	0.0750000
NODE_302_length_4270_cov_14.045792	3888	3968	149	2	80	0.0250000
NODE_302_length_4270_cov_14.045792	3888	3968	158	2	80	0.0250000
NODE_302_length_4270_cov_14.045792	3888	3968	159	2	80	0.0250000
NODE_302_length_4270_cov_14.045792	3888	3968	160	2	80	0.0250000
NODE_302_length_4270_cov_14.045792	3888	3968	161	1	80	0.0125000
NODE_302_length_4270_cov_14.045792	3888	3968	164	3	80	0.0375000
NODE_302_length_4270_cov_14.045792	3888	3968	166	2	80	0.0250000
NODE_302_length_4270_cov_14.045792	3888	3968	167	4	80	0.0500000
NODE_302_length_4270_cov_14.045792	3888	3968	168	1	80	0.0125000
NODE_302_length_4270_cov_14.045792	3888	3968	169	8	80	0.1000000
NODE_302_length_4270_cov_14.045792	3888	3968	171	6	80	0.0750000
NODE_302_length_4270_cov_14.045792	3888	3968	172	6	80	0.0750000
NODE_302_length_4270_cov_14.045792	3888	3968	173	5	80	0.0625000
NODE_303_length_4260_cov_24.780822	244	311	6	6	67	0.0895522
NODE_303_length_4260_cov_24.780822	244	311	8	4	67	0.0597015
NODE_303_length_4260_cov_24.780822	244	311	10	24	67	0.3582090
NODE_303_length_4260_cov_24.780822	244	311	12	33	67	0.4925373
NODE_303_length_4260_cov_24.780822	244	311	6	6	67	0.0895522
NODE_303_length_4260_cov_24.780822	244	311	8	4	67	0.0597015
NODE_303_length_4260_cov_24.780822	244	311	10	24	67	0.3582090
NODE_303_length_4260_cov_24.780822	244	311	12	33	67	0.4925373
NODE_303_length_4260_cov_24.780822	263	311	6	6	48	0.1250000
NODE_303_length_4260_cov_24.780822	263	311	8	4	48	0.0833333
NODE_303_length_4260_cov_24.780822	263	311	10	12	48	0.2500000
NODE_303_length_4260_cov_24.780822	263	311	12	26	48	0.5416667
NODE_303_length_4260_cov_24.780822	1605	1633	2	15	28	0.5357143
NODE_303_length_4260_cov_24.780822	1605	1633	4	2	28	0.0714286
NODE_303_length_4260_cov_24.780822	1605	1633	6	2	28	0.0714286
NODE_303_length_4260_cov_24.780822	1605	1633	8	8	28	0.2857143
NODE_303_length_4260_cov_24.780822	1605	1633	18	1	28	0.0357143
NODE_303_length_4260_cov_24.780822	1660	1699	42	1	39	0.0256410
NODE_303_length_4260_cov_24.780822	1660	1699	44	1	39	0.0256410
NODE_303_length_4260_cov_24.780822	1660	1699	47	1	39	0.0256410
NODE_303_length_4260_cov_24.780822	1660	1699	53	1	39	0.0256410
NODE_303_length_4260_cov_24.780822	1660	1699	55	1	39	0.0256410
NODE_303_length_4260_cov_24.780822	1660	1699	59	6	39	0.1538462
NODE_303_length_4260_cov_24.780822	1660	1699	61	1	39	0.0256410
NODE_303_length_4260_cov_24.780822	1660	1699	63	1	39	0.0256410
NODE_303_length_4260_cov_24.780822	1660	1699	67	1	39	0.0256410
NODE_303_length_4260_cov_24.780822	1660	1699	69	1	39	0.0256410
NODE_303_length_4260_cov_24.780822	1660	1699	71	1	39	0.0256410
NODE_303_length_4260_cov_24.780822	1660	1699	73	1	39	0.0256410
NODE_303_length_4260_cov_24.780822	1660	1699	75	1	39	0.0256410
NODE_303_length_4260_cov_24.780822	1660	1699	77	1	39	0.0256410
NODE_303_length_4260_cov_24.780822	1660	1699	81	1	39	0.0256410
NODE_303_length_4260_cov_24.780822	1660	1699	85	3	39	0.0769231
NODE_303_length_4260_cov_24.780822	1660	1699	87	1	39	0.0256410
NODE_303_length_4260_cov_24.780822	1660	1699	89	1	39	0.0256410
NODE_303_length_4260_cov_24.780822	1660	1699	95	5	39	0.1282051
NODE_303_length_4260_cov_24.780822	1660	1699	97	2	39	0.0512821
NODE_303_length_4260_cov_24.780822	1660	1699	99	5	39	0.1282051
NODE_303_length_4260_cov_24.780822	1660	1699	105	1	39	0.0256410
NODE_303_length_4260_cov_24.780822	1660	1699	108	1	39	0.0256410
NODE_310_length_4207_cov_6.923564	3664	3722	2	31	58	0.5344828
NODE_310_length_4207_cov_6.923564	3664	3722	4	3	58	0.0517241
NODE_310_length_4207_cov_6.923564	3664	3722	5	13	58	0.2241379
NODE_310_length_4207_cov_6.923564	3664	3722	6	2	58	0.0344828
NODE_310_length_4207_cov_6.923564	3664	3722	8	6	58	0.1034483
NODE_310_length_4207_cov_6.923564	3664	3722	12	3	58	0.0517241
NODE_310_length_4207_cov_6.923564	3695	3775	2	65	80	0.8125000
NODE_310_length_4207_cov_6.923564	3695	3775	4	15	80	0.1875000
NODE_311_length_4205_cov_6.121042	592	632	6	14	40	0.3500000
NODE_311_length_4205_cov_6.121042	592	632	10	4	40	0.1000000
NODE_311_length_4205_cov_6.121042	592	632	12	22	40	0.5500000
NODE_311_length_4205_cov_6.121042	605	685	6	3	80	0.0375000
NODE_311_length_4205_cov_6.121042	605	685	8	15	80	0.1875000
NODE_311_length_4205_cov_6.121042	605	685	10	30	80	0.3750000
NODE_311_length_4205_cov_6.121042	605	685	12	32	80	0.4000000
NODE_311_length_4205_cov_6.121042	681	745	0	33	64	0.5156250
NODE_311_length_4205_cov_6.121042	681	745	2	27	64	0.4218750
NODE_311_length_4205_cov_6.121042	681	745	6	2	64	0.0312500
NODE_311_length_4205_cov_6.121042	681	745	8	2	64	0.0312500
NODE_312_length_4196_cov_4.170857	340	420	2	80	80	1.0000000
NODE_312_length_4196_cov_4.170857	393	473	1	7	80	0.0875000
NODE_312_length_4196_cov_4.170857	393	473	2	73	80	0.9125000
NODE_316_length_4179_cov_6.655882	1	65	6	6	64	0.0937500
NODE_316_length_4179_cov_6.655882	1	65	8	2	64	0.0312500
NODE_316_length_4179_cov_6.655882	1	65	12	2	64	0.0312500
NODE_316_length_4179_cov_6.655882	1	65	16	2	64	0.0312500
NODE_316_length_4179_cov_6.655882	1	65	18	8	64	0.1250000
NODE_316_length_4179_cov_6.655882	1	65	22	5	64	0.0781250
NODE_316_length_4179_cov_6.655882	1	65	23	1	64	0.0156250
NODE_316_length_4179_cov_6.655882	1	65	24	1	64	0.0156250
NODE_316_length_4179_cov_6.655882	1	65	26	8	64	0.1250000
NODE_316_length_4179_cov_6.655882	1	65	28	1	64	0.0156250
NODE_316_length_4179_cov_6.655882	1	65	30	1	64	0.0156250
NODE_316_length_4179_cov_6.655882	1	65	32	27	64	0.4218750
NODE_316_length_4179_cov_6.655882	1087	1140	4	6	53	0.1132075
NODE_316_length_4179_cov_6.655882	1087	1140	6	17	53	0.3207547
NODE_316_length_4179_cov_6.655882	1087	1140	8	19	53	0.3584906
NODE_316_length_4179_cov_6.655882	1087	1140	10	11	53	0.2075472
NODE_316_length_4179_cov_6.655882	1818	1898	2	68	80	0.8500000
NODE_316_length_4179_cov_6.655882	1818	1898	4	12	80	0.1500000
NODE_319_length_4150_cov_10.600099	2827	2849	98	1	22	0.0454545
NODE_319_length_4150_cov_10.600099	2827	2849	101	5	22	0.2272727
NODE_319_length_4150_cov_10.600099	2827	2849	102	1	22	0.0454545
NODE_319_length_4150_cov_10.600099	2827	2849	105	1	22	0.0454545
NODE_319_length_4150_cov_10.600099	2827	2849	107	12	22	0.5454546
NODE_319_length_4150_cov_10.600099	2827	2849	109	2	22	0.0909091
NODE_319_length_4150_cov_10.600099	2973	3053	8	6	80	0.0750000
NODE_319_length_4150_cov_10.600099	2973	3053	10	7	80	0.0875000
NODE_319_length_4150_cov_10.600099	2973	3053	15	1	80	0.0125000
NODE_319_length_4150_cov_10.600099	2973	3053	16	8	80	0.1000000
NODE_319_length_4150_cov_10.600099	2973	3053	18	2	80	0.0250000
NODE_319_length_4150_cov_10.600099	2973	3053	22	1	80	0.0125000
NODE_319_length_4150_cov_10.600099	2973	3053	24	1	80	0.0125000
NODE_319_length_4150_cov_10.600099	2973	3053	26	7	80	0.0875000
NODE_319_length_4150_cov_10.600099	2973	3053	30	9	80	0.1125000
NODE_319_length_4150_cov_10.600099	2973	3053	32	7	80	0.0875000
NODE_319_length_4150_cov_10.600099	2973	3053	34	7	80	0.0875000
NODE_319_length_4150_cov_10.600099	2973	3053	36	1	80	0.0125000
NODE_319_length_4150_cov_10.600099	2973	3053	38	3	80	0.0375000
NODE_319_length_4150_cov_10.600099	2973	3053	40	8	80	0.1000000
NODE_319_length_4150_cov_10.600099	2973	3053	42	8	80	0.1000000
NODE_319_length_4150_cov_10.600099	2973	3053	44	4	80	0.0500000
NODE_319_length_4150_cov_10.600099	3026	3106	34	3	80	0.0375000
NODE_319_length_4150_cov_10.600099	3026	3106	36	1	80	0.0125000
NODE_319_length_4150_cov_10.600099	3026	3106	38	3	80	0.0375000
NODE_319_length_4150_cov_10.600099	3026	3106	40	8	80	0.1000000
NODE_319_length_4150_cov_10.600099	3026	3106	42	8	80	0.1000000
NODE_319_length_4150_cov_10.600099	3026	3106	43	3	80	0.0375000
NODE_319_length_4150_cov_10.600099	3026	3106	44	9	80	0.1125000
NODE_319_length_4150_cov_10.600099	3026	3106	49	5	80	0.0625000
NODE_319_length_4150_cov_10.600099	3026	3106	51	13	80	0.1625000
NODE_319_length_4150_cov_10.600099	3026	3106	53	6	80	0.0750000
NODE_319_length_4150_cov_10.600099	3026	3106	55	4	80	0.0500000
NODE_319_length_4150_cov_10.600099	3026	3106	57	7	80	0.0875000
NODE_319_length_4150_cov_10.600099	3026	3106	59	10	80	0.1250000
NODE_324_length_4119_cov_27.984328	2818	2898	67	1	80	0.0125000
NODE_324_length_4119_cov_27.984328	2818	2898	69	1	80	0.0125000
NODE_324_length_4119_cov_27.984328	2818	2898	71	4	80	0.0500000
NODE_324_length_4119_cov_27.984328	2818	2898	73	4	80	0.0500000
NODE_324_length_4119_cov_27.984328	2818	2898	74	1	80	0.0125000
NODE_324_length_4119_cov_27.984328	2818	2898	79	1	80	0.0125000
NODE_324_length_4119_cov_27.984328	2818	2898	80	3	80	0.0375000
NODE_324_length_4119_cov_27.984328	2818	2898	81	2	80	0.0250000
NODE_324_length_4119_cov_27.984328	2818	2898	84	1	80	0.0125000
NODE_324_length_4119_cov_27.984328	2818	2898	88	2	80	0.0250000
NODE_324_length_4119_cov_27.984328	2818	2898	94	4	80	0.0500000
NODE_324_length_4119_cov_27.984328	2818	2898	96	1	80	0.0125000
NODE_324_length_4119_cov_27.984328	2818	2898	97	1	80	0.0125000
NODE_324_length_4119_cov_27.984328	2818	2898	99	2	80	0.0250000
NODE_324_length_4119_cov_27.984328	2818	2898	103	6	80	0.0750000
NODE_324_length_4119_cov_27.984328	2818	2898	105	2	80	0.0250000
NODE_324_length_4119_cov_27.984328	2818	2898	107	2	80	0.0250000
NODE_324_length_4119_cov_27.984328	2818	2898	109	1	80	0.0125000
NODE_324_length_4119_cov_27.984328	2818	2898	111	4	80	0.0500000
NODE_324_length_4119_cov_27.984328	2818	2898	112	2	80	0.0250000
NODE_324_length_4119_cov_27.984328	2818	2898	113	4	80	0.0500000
NODE_324_length_4119_cov_27.984328	2818	2898	114	1	80	0.0125000
NODE_324_length_4119_cov_27.984328	2818	2898	115	7	80	0.0875000
NODE_324_length_4119_cov_27.984328	2818	2898	116	1	80	0.0125000
NODE_324_length_4119_cov_27.984328	2818	2898	117	5	80	0.0625000
NODE_324_length_4119_cov_27.984328	2818	2898	118	3	80	0.0375000
NODE_324_length_4119_cov_27.984328	2818	2898	119	5	80	0.0625000
NODE_324_length_4119_cov_27.984328	2818	2898	120	5	80	0.0625000
NODE_324_length_4119_cov_27.984328	2818	2898	121	3	80	0.0375000
NODE_324_length_4119_cov_27.984328	2818	2898	123	1	80	0.0125000
NODE_325_length_4108_cov_14.755550	378	422	0	5	44	0.1136364
NODE_325_length_4108_cov_14.755550	378	422	2	3	44	0.0681818
NODE_325_length_4108_cov_14.755550	378	422	4	36	44	0.8181818
NODE_325_length_4108_cov_14.755550	3537	3617	0	31	80	0.3875000
NODE_325_length_4108_cov_14.755550	3537	3617	2	49	80	0.6125000
NODE_325_length_4108_cov_14.755550	3590	3670	2	35	80	0.4375000
NODE_325_length_4108_cov_14.755550	3590	3670	4	17	80	0.2125000
NODE_325_length_4108_cov_14.755550	3590	3670	6	28	80	0.3500000
NODE_326_length_4107_cov_1.855539	207	287	0	80	80	1.0000000
NODE_328_length_4096_cov_31.197648	379	459	4	41	80	0.5125000
NODE_328_length_4096_cov_31.197648	379	459	6	39	80	0.4875000
NODE_328_length_4096_cov_31.197648	432	512	0	45	80	0.5625000
NODE_328_length_4096_cov_31.197648	432	512	4	35	80	0.4375000
NODE_328_length_4096_cov_31.197648	3305	3385	0	80	80	1.0000000
NODE_328_length_4096_cov_31.197648	3358	3438	0	80	80	1.0000000
NODE_329_length_4081_cov_20.248870	3673	3753	4	4	80	0.0500000
NODE_329_length_4081_cov_20.248870	3673	3753	5	13	80	0.1625000
NODE_329_length_4081_cov_20.248870	3673	3753	6	49	80	0.6125000
NODE_329_length_4081_cov_20.248870	3673	3753	7	14	80	0.1750000
NODE_329_length_4081_cov_20.248870	3726	3806	4	39	80	0.4875000
NODE_329_length_4081_cov_20.248870	3726	3806	6	40	80	0.5000000
NODE_329_length_4081_cov_20.248870	3726	3806	8	1	80	0.0125000
NODE_330_length_4076_cov_15.138044	1062	1142	0	41	80	0.5125000
NODE_330_length_4076_cov_15.138044	1062	1142	4	30	80	0.3750000
NODE_330_length_4076_cov_15.138044	1062	1142	5	3	80	0.0375000
NODE_330_length_4076_cov_15.138044	1062	1142	8	6	80	0.0750000
NODE_330_length_4076_cov_15.138044	1115	1195	4	18	80	0.2250000
NODE_330_length_4076_cov_15.138044	1115	1195	5	3	80	0.0375000
NODE_330_length_4076_cov_15.138044	1115	1195	8	59	80	0.7375000
NODE_331_length_4069_cov_14.261209	3871	3936	0	49	65	0.7538462
NODE_331_length_4069_cov_14.261209	3871	3936	2	16	65	0.2461538
NODE_333_length_4050_cov_31.044039	1703	1783	34	1	80	0.0125000
NODE_333_length_4050_cov_31.044039	1703	1783	35	1	80	0.0125000
NODE_333_length_4050_cov_31.044039	1703	1783	36	4	80	0.0500000
NODE_333_length_4050_cov_31.044039	1703	1783	37	5	80	0.0625000
NODE_333_length_4050_cov_31.044039	1703	1783	38	5	80	0.0625000
NODE_333_length_4050_cov_31.044039	1703	1783	39	1	80	0.0125000
NODE_333_length_4050_cov_31.044039	1703	1783	40	2	80	0.0250000
NODE_333_length_4050_cov_31.044039	1703	1783	41	8	80	0.1000000
NODE_333_length_4050_cov_31.044039	1703	1783	42	12	80	0.1500000
NODE_333_length_4050_cov_31.044039	1703	1783	43	10	80	0.1250000
NODE_333_length_4050_cov_31.044039	1703	1783	44	4	80	0.0500000
NODE_333_length_4050_cov_31.044039	1703	1783	45	9	80	0.1125000
NODE_333_length_4050_cov_31.044039	1703	1783	46	5	80	0.0625000
NODE_333_length_4050_cov_31.044039	1703	1783	47	4	80	0.0500000
NODE_333_length_4050_cov_31.044039	1703	1783	48	5	80	0.0625000
NODE_333_length_4050_cov_31.044039	1703	1783	49	3	80	0.0375000
NODE_333_length_4050_cov_31.044039	1703	1783	51	1	80	0.0125000
NODE_335_length_4021_cov_34.619072	379	459	0	80	80	1.0000000
NODE_335_length_4021_cov_34.619072	432	512	0	80	80	1.0000000
NODE_336_length_4020_cov_5.130834	3455	3535	0	6	80	0.0750000
NODE_336_length_4020_cov_5.130834	3455	3535	2	74	80	0.9250000
NODE_336_length_4020_cov_5.130834	3508	3588	0	26	80	0.3250000
NODE_336_length_4020_cov_5.130834	3508	3588	2	54	80	0.6750000
NODE_339_length_4004_cov_9.718054	387	467	0	80	80	1.0000000
NODE_339_length_4004_cov_9.718054	440	520	0	40	80	0.5000000
NODE_339_length_4004_cov_9.718054	440	520	2	40	80	0.5000000
NODE_339_length_4004_cov_9.718054	516	596	2	71	80	0.8875000
NODE_339_length_4004_cov_9.718054	516	596	4	9	80	0.1125000
NODE_339_length_4004_cov_9.718054	569	649	2	79	80	0.9875000
NODE_339_length_4004_cov_9.718054	569	649	4	1	80	0.0125000
NODE_341_length_3991_cov_18.617934	867	947	0	26	80	0.3250000
NODE_341_length_3991_cov_18.617934	867	947	1	3	80	0.0375000
NODE_341_length_3991_cov_18.617934	867	947	2	51	80	0.6375000
NODE_341_length_3991_cov_18.617934	920	1000	2	75	80	0.9375000
NODE_341_length_3991_cov_18.617934	920	1000	4	5	80	0.0625000
NODE_341_length_3991_cov_18.617934	996	1076	2	80	80	1.0000000
NODE_341_length_3991_cov_18.617934	1049	1124	0	26	75	0.3466667
NODE_341_length_3991_cov_18.617934	1049	1124	2	49	75	0.6533333
NODE_348_length_3973_cov_6.906298	17	65	0	48	48	1.0000000
NODE_348_length_3973_cov_6.906298	1945	1995	2	14	50	0.2800000
NODE_348_length_3973_cov_6.906298	1945	1995	4	2	50	0.0400000
NODE_348_length_3973_cov_6.906298	1945	1995	6	11	50	0.2200000
NODE_348_length_3973_cov_6.906298	1945	1995	8	4	50	0.0800000
NODE_348_length_3973_cov_6.906298	1945	1995	10	7	50	0.1400000
NODE_348_length_3973_cov_6.906298	1945	1995	12	8	50	0.1600000
NODE_348_length_3973_cov_6.906298	1945	1995	14	4	50	0.0800000
NODE_350_length_3960_cov_6.246827	2673	2761	0	88	88	1.0000000
NODE_350_length_3960_cov_6.246827	3520	3600	2	46	80	0.5750000
NODE_350_length_3960_cov_6.246827	3520	3600	4	34	80	0.4250000
NODE_350_length_3960_cov_6.246827	3573	3653	0	4	80	0.0500000
NODE_350_length_3960_cov_6.246827	3573	3653	2	4	80	0.0500000
NODE_350_length_3960_cov_6.246827	3573	3653	4	72	80	0.9000000
NODE_353_length_3952_cov_8.805346	826	906	2	71	80	0.8875000
NODE_353_length_3952_cov_8.805346	826	906	4	9	80	0.1125000
NODE_353_length_3952_cov_8.805346	879	959	2	26	80	0.3250000
NODE_353_length_3952_cov_8.805346	879	959	4	54	80	0.6750000
NODE_354_length_3928_cov_5.936798	2440	2521	2	7	81	0.0864198
NODE_354_length_3928_cov_5.936798	2440	2521	4	22	81	0.2716049
NODE_354_length_3928_cov_5.936798	2440	2521	8	22	81	0.2716049
NODE_354_length_3928_cov_5.936798	2440	2521	10	30	81	0.3703704
NODE_354_length_3928_cov_5.936798	2493	2574	4	29	81	0.3580247
NODE_354_length_3928_cov_5.936798	2493	2574	5	6	81	0.0740741
NODE_354_length_3928_cov_5.936798	2493	2574	6	16	81	0.1975309
NODE_354_length_3928_cov_5.936798	2493	2574	10	30	81	0.3703704
NODE_356_length_3923_cov_14.807793	3759	3800	2	41	41	1.0000000
NODE_358_length_3922_cov_7.609731	1493	1573	71	1	80	0.0125000
NODE_358_length_3922_cov_7.609731	1493	1573	72	4	80	0.0500000
NODE_358_length_3922_cov_7.609731	1493	1573	74	11	80	0.1375000
NODE_358_length_3922_cov_7.609731	1493	1573	75	2	80	0.0250000
NODE_358_length_3922_cov_7.609731	1493	1573	76	6	80	0.0750000
NODE_358_length_3922_cov_7.609731	1493	1573	77	11	80	0.1375000
NODE_358_length_3922_cov_7.609731	1493	1573	78	8	80	0.1000000
NODE_358_length_3922_cov_7.609731	1493	1573	79	5	80	0.0625000
NODE_358_length_3922_cov_7.609731	1493	1573	81	7	80	0.0875000
NODE_358_length_3922_cov_7.609731	1493	1573	82	5	80	0.0625000
NODE_358_length_3922_cov_7.609731	1493	1573	83	17	80	0.2125000
NODE_358_length_3922_cov_7.609731	1493	1573	84	1	80	0.0125000
NODE_358_length_3922_cov_7.609731	1493	1573	87	2	80	0.0250000
NODE_358_length_3922_cov_7.609731	1546	1600	71	2	54	0.0370370
NODE_358_length_3922_cov_7.609731	1546	1600	72	4	54	0.0740741
NODE_358_length_3922_cov_7.609731	1546	1600	74	4	54	0.0740741
NODE_358_length_3922_cov_7.609731	1546	1600	75	2	54	0.0370370
NODE_358_length_3922_cov_7.609731	1546	1600	76	6	54	0.1111111
NODE_358_length_3922_cov_7.609731	1546	1600	77	11	54	0.2037037
NODE_358_length_3922_cov_7.609731	1546	1600	78	11	54	0.2037037
NODE_358_length_3922_cov_7.609731	1546	1600	79	5	54	0.0925926
NODE_358_length_3922_cov_7.609731	1546	1600	80	1	54	0.0185185
NODE_358_length_3922_cov_7.609731	1546	1600	82	2	54	0.0370370
NODE_358_length_3922_cov_7.609731	1546	1600	84	1	54	0.0185185
NODE_358_length_3922_cov_7.609731	1546	1600	86	4	54	0.0740741
NODE_358_length_3922_cov_7.609731	1546	1600	88	1	54	0.0185185
NODE_359_length_3921_cov_9.943223	2936	3016	237	1	80	0.0125000
NODE_359_length_3921_cov_9.943223	2936	3016	239	1	80	0.0125000
NODE_359_length_3921_cov_9.943223	2936	3016	243	4	80	0.0500000
NODE_359_length_3921_cov_9.943223	2936	3016	251	1	80	0.0125000
NODE_359_length_3921_cov_9.943223	2936	3016	257	1	80	0.0125000
NODE_359_length_3921_cov_9.943223	2936	3016	259	1	80	0.0125000
NODE_359_length_3921_cov_9.943223	2936	3016	260	1	80	0.0125000
NODE_359_length_3921_cov_9.943223	2936	3016	261	2	80	0.0250000
NODE_359_length_3921_cov_9.943223	2936	3016	265	2	80	0.0250000
NODE_359_length_3921_cov_9.943223	2936	3016	267	1	80	0.0125000
NODE_359_length_3921_cov_9.943223	2936	3016	268	4	80	0.0500000
NODE_359_length_3921_cov_9.943223	2936	3016	271	2	80	0.0250000
NODE_359_length_3921_cov_9.943223	2936	3016	273	1	80	0.0125000
NODE_359_length_3921_cov_9.943223	2936	3016	275	1	80	0.0125000
NODE_359_length_3921_cov_9.943223	2936	3016	281	1	80	0.0125000
NODE_359_length_3921_cov_9.943223	2936	3016	282	1	80	0.0125000
NODE_359_length_3921_cov_9.943223	2936	3016	284	2	80	0.0250000
NODE_359_length_3921_cov_9.943223	2936	3016	285	1	80	0.0125000
NODE_359_length_3921_cov_9.943223	2936	3016	286	2	80	0.0250000
NODE_359_length_3921_cov_9.943223	2936	3016	289	1	80	0.0125000
NODE_359_length_3921_cov_9.943223	2936	3016	290	1	80	0.0125000
NODE_359_length_3921_cov_9.943223	2936	3016	291	1	80	0.0125000
NODE_359_length_3921_cov_9.943223	2936	3016	299	1	80	0.0125000
NODE_359_length_3921_cov_9.943223	2936	3016	307	1	80	0.0125000
NODE_359_length_3921_cov_9.943223	2936	3016	311	1	80	0.0125000
NODE_359_length_3921_cov_9.943223	2936	3016	322	1	80	0.0125000
NODE_359_length_3921_cov_9.943223	2936	3016	324	2	80	0.0250000
NODE_359_length_3921_cov_9.943223	2936	3016	332	1	80	0.0125000
NODE_359_length_3921_cov_9.943223	2936	3016	336	2	80	0.0250000
NODE_359_length_3921_cov_9.943223	2936	3016	337	1	80	0.0125000
NODE_359_length_3921_cov_9.943223	2936	3016	342	1	80	0.0125000
NODE_359_length_3921_cov_9.943223	2936	3016	348	3	80	0.0375000
NODE_359_length_3921_cov_9.943223	2936	3016	354	1	80	0.0125000
NODE_359_length_3921_cov_9.943223	2936	3016	357	2	80	0.0250000
NODE_359_length_3921_cov_9.943223	2936	3016	359	2	80	0.0250000
NODE_359_length_3921_cov_9.943223	2936	3016	361	1	80	0.0125000
NODE_359_length_3921_cov_9.943223	2936	3016	364	1	80	0.0125000
NODE_359_length_3921_cov_9.943223	2936	3016	365	3	80	0.0375000
NODE_359_length_3921_cov_9.943223	2936	3016	366	1	80	0.0125000
NODE_359_length_3921_cov_9.943223	2936	3016	367	1	80	0.0125000
NODE_359_length_3921_cov_9.943223	2936	3016	368	1	80	0.0125000
NODE_359_length_3921_cov_9.943223	2936	3016	369	3	80	0.0375000
NODE_359_length_3921_cov_9.943223	2936	3016	370	4	80	0.0500000
NODE_359_length_3921_cov_9.943223	2936	3016	371	2	80	0.0250000
NODE_359_length_3921_cov_9.943223	2936	3016	372	1	80	0.0125000
NODE_359_length_3921_cov_9.943223	2936	3016	373	1	80	0.0125000
NODE_359_length_3921_cov_9.943223	2936	3016	375	1	80	0.0125000
NODE_359_length_3921_cov_9.943223	2936	3016	376	1	80	0.0125000
NODE_359_length_3921_cov_9.943223	2936	3016	379	3	80	0.0375000
NODE_359_length_3921_cov_9.943223	2936	3016	383	2	80	0.0250000
NODE_359_length_3921_cov_9.943223	2936	3016	386	2	80	0.0250000
NODE_359_length_3921_cov_9.943223	2989	3057	243	2	68	0.0294118
NODE_359_length_3921_cov_9.943223	2989	3057	249	1	68	0.0147059
NODE_359_length_3921_cov_9.943223	2989	3057	256	3	68	0.0441176
NODE_359_length_3921_cov_9.943223	2989	3057	258	1	68	0.0147059
NODE_359_length_3921_cov_9.943223	2989	3057	260	1	68	0.0147059
NODE_359_length_3921_cov_9.943223	2989	3057	268	1	68	0.0147059
NODE_359_length_3921_cov_9.943223	2989	3057	276	1	68	0.0147059
NODE_359_length_3921_cov_9.943223	2989	3057	291	2	68	0.0294118
NODE_359_length_3921_cov_9.943223	2989	3057	293	1	68	0.0147059
NODE_359_length_3921_cov_9.943223	2989	3057	295	1	68	0.0147059
NODE_359_length_3921_cov_9.943223	2989	3057	311	1	68	0.0147059
NODE_359_length_3921_cov_9.943223	2989	3057	328	1	68	0.0147059
NODE_359_length_3921_cov_9.943223	2989	3057	330	2	68	0.0294118
NODE_359_length_3921_cov_9.943223	2989	3057	331	2	68	0.0294118
NODE_359_length_3921_cov_9.943223	2989	3057	346	1	68	0.0147059
NODE_359_length_3921_cov_9.943223	2989	3057	347	1	68	0.0147059
NODE_359_length_3921_cov_9.943223	2989	3057	348	2	68	0.0294118
NODE_359_length_3921_cov_9.943223	2989	3057	351	1	68	0.0147059
NODE_359_length_3921_cov_9.943223	2989	3057	352	1	68	0.0147059
NODE_359_length_3921_cov_9.943223	2989	3057	353	4	68	0.0588235
NODE_359_length_3921_cov_9.943223	2989	3057	354	1	68	0.0147059
NODE_359_length_3921_cov_9.943223	2989	3057	357	2	68	0.0294118
NODE_359_length_3921_cov_9.943223	2989	3057	358	3	68	0.0441176
NODE_359_length_3921_cov_9.943223	2989	3057	359	3	68	0.0441176
NODE_359_length_3921_cov_9.943223	2989	3057	360	1	68	0.0147059
NODE_359_length_3921_cov_9.943223	2989	3057	361	1	68	0.0147059
NODE_359_length_3921_cov_9.943223	2989	3057	362	1	68	0.0147059
NODE_359_length_3921_cov_9.943223	2989	3057	364	1	68	0.0147059
NODE_359_length_3921_cov_9.943223	2989	3057	365	3	68	0.0441176
NODE_359_length_3921_cov_9.943223	2989	3057	366	1	68	0.0147059
NODE_359_length_3921_cov_9.943223	2989	3057	368	1	68	0.0147059
NODE_359_length_3921_cov_9.943223	2989	3057	369	3	68	0.0441176
NODE_359_length_3921_cov_9.943223	2989	3057	370	4	68	0.0588235
NODE_359_length_3921_cov_9.943223	2989	3057	371	2	68	0.0294118
NODE_359_length_3921_cov_9.943223	2989	3057	372	1	68	0.0147059
NODE_359_length_3921_cov_9.943223	2989	3057	373	1	68	0.0147059
NODE_359_length_3921_cov_9.943223	2989	3057	375	1	68	0.0147059
NODE_359_length_3921_cov_9.943223	2989	3057	376	1	68	0.0147059
NODE_359_length_3921_cov_9.943223	2989	3057	379	3	68	0.0441176
NODE_359_length_3921_cov_9.943223	2989	3057	383	2	68	0.0294118
NODE_359_length_3921_cov_9.943223	2989	3057	386	2	68	0.0294118
NODE_359_length_3921_cov_9.943223	3047	3066	194	1	19	0.0526316
NODE_359_length_3921_cov_9.943223	3047	3066	206	1	19	0.0526316
NODE_359_length_3921_cov_9.943223	3047	3066	208	1	19	0.0526316
NODE_359_length_3921_cov_9.943223	3047	3066	214	1	19	0.0526316
NODE_359_length_3921_cov_9.943223	3047	3066	227	1	19	0.0526316
NODE_359_length_3921_cov_9.943223	3047	3066	228	1	19	0.0526316
NODE_359_length_3921_cov_9.943223	3047	3066	229	1	19	0.0526316
NODE_359_length_3921_cov_9.943223	3047	3066	241	1	19	0.0526316
NODE_359_length_3921_cov_9.943223	3047	3066	243	3	19	0.1578947
NODE_359_length_3921_cov_9.943223	3047	3066	249	1	19	0.0526316
NODE_359_length_3921_cov_9.943223	3047	3066	256	3	19	0.1578947
NODE_359_length_3921_cov_9.943223	3047	3066	258	1	19	0.0526316
NODE_359_length_3921_cov_9.943223	3047	3066	260	1	19	0.0526316
NODE_359_length_3921_cov_9.943223	3047	3066	268	1	19	0.0526316
NODE_359_length_3921_cov_9.943223	3047	3066	276	1	19	0.0526316
NODE_363_length_3898_cov_40.033167	3296	3370	26	2	74	0.0270270
NODE_363_length_3898_cov_40.033167	3296	3370	28	2	74	0.0270270
NODE_363_length_3898_cov_40.033167	3296	3370	32	1	74	0.0135135
NODE_363_length_3898_cov_40.033167	3296	3370	34	1	74	0.0135135
NODE_363_length_3898_cov_40.033167	3296	3370	36	3	74	0.0405405
NODE_363_length_3898_cov_40.033167	3296	3370	38	3	74	0.0405405
NODE_363_length_3898_cov_40.033167	3296	3370	40	1	74	0.0135135
NODE_363_length_3898_cov_40.033167	3296	3370	42	3	74	0.0405405
NODE_363_length_3898_cov_40.033167	3296	3370	44	7	74	0.0945946
NODE_363_length_3898_cov_40.033167	3296	3370	46	14	74	0.1891892
NODE_363_length_3898_cov_40.033167	3296	3370	48	11	74	0.1486486
NODE_363_length_3898_cov_40.033167	3296	3370	50	26	74	0.3513514
NODE_363_length_3898_cov_40.033167	3539	3619	12	1	80	0.0125000
NODE_363_length_3898_cov_40.033167	3539	3619	14	33	80	0.4125000
NODE_363_length_3898_cov_40.033167	3539	3619	16	34	80	0.4250000
NODE_363_length_3898_cov_40.033167	3539	3619	18	1	80	0.0125000
NODE_363_length_3898_cov_40.033167	3539	3619	20	6	80	0.0750000
NODE_363_length_3898_cov_40.033167	3539	3619	22	5	80	0.0625000
NODE_364_length_3898_cov_7.550145	668	748	4	60	80	0.7500000
NODE_364_length_3898_cov_7.550145	668	748	5	5	80	0.0625000
NODE_364_length_3898_cov_7.550145	668	748	6	6	80	0.0750000
NODE_364_length_3898_cov_7.550145	668	748	8	9	80	0.1125000
NODE_364_length_3898_cov_7.550145	721	801	4	7	80	0.0875000
NODE_364_length_3898_cov_7.550145	721	801	5	5	80	0.0625000
NODE_364_length_3898_cov_7.550145	721	801	6	18	80	0.2250000
NODE_364_length_3898_cov_7.550145	721	801	7	1	80	0.0125000
NODE_364_length_3898_cov_7.550145	721	801	8	37	80	0.4625000
NODE_364_length_3898_cov_7.550145	721	801	10	7	80	0.0875000
NODE_364_length_3898_cov_7.550145	721	801	31	1	80	0.0125000
NODE_364_length_3898_cov_7.550145	721	801	36	2	80	0.0250000
NODE_364_length_3898_cov_7.550145	721	801	40	2	80	0.0250000
NODE_367_length_3882_cov_4.166006	3244	3324	0	80	80	1.0000000
NODE_367_length_3882_cov_4.166006	3282	3324	0	42	42	1.0000000
NODE_367_length_3882_cov_4.166006	3297	3377	0	80	80	1.0000000
NODE_367_length_3882_cov_4.166006	3297	3377	0	80	80	1.0000000
NODE_367_length_3882_cov_4.166006	3373	3450	0	77	77	1.0000000
NODE_374_length_3853_cov_18.816196	524	579	12	2	55	0.0363636
NODE_374_length_3853_cov_18.816196	524	579	14	4	55	0.0727273
NODE_374_length_3853_cov_18.816196	524	579	16	19	55	0.3454545
NODE_374_length_3853_cov_18.816196	524	579	17	1	55	0.0181818
NODE_374_length_3853_cov_18.816196	524	579	18	29	55	0.5272727
NODE_374_length_3853_cov_18.816196	559	639	0	15	80	0.1875000
NODE_374_length_3853_cov_18.816196	559	639	2	7	80	0.0875000
NODE_374_length_3853_cov_18.816196	559	639	4	13	80	0.1625000
NODE_374_length_3853_cov_18.816196	559	639	6	7	80	0.0875000
NODE_374_length_3853_cov_18.816196	559	639	10	18	80	0.2250000
NODE_374_length_3853_cov_18.816196	559	639	12	2	80	0.0250000
NODE_374_length_3853_cov_18.816196	559	639	14	4	80	0.0500000
NODE_374_length_3853_cov_18.816196	559	639	16	14	80	0.1750000
NODE_379_length_3829_cov_12.697319	515	595	0	80	80	1.0000000
NODE_379_length_3829_cov_12.697319	568	648	0	37	80	0.4625000
NODE_379_length_3829_cov_12.697319	568	648	2	43	80	0.5375000
NODE_379_length_3829_cov_12.697319	644	724	0	60	80	0.7500000
NODE_379_length_3829_cov_12.697319	644	724	2	20	80	0.2500000
NODE_379_length_3829_cov_12.697319	697	777	0	80	80	1.0000000
NODE_381_length_3815_cov_17.218784	399	479	4	21	80	0.2625000
NODE_381_length_3815_cov_17.218784	399	479	6	59	80	0.7375000
NODE_381_length_3815_cov_17.218784	452	532	2	38	80	0.4750000
NODE_381_length_3815_cov_17.218784	452	532	6	42	80	0.5250000
NODE_383_length_3812_cov_65.007272	840	903	8	1	63	0.0158730
NODE_383_length_3812_cov_65.007272	840	903	11	2	63	0.0317460
NODE_383_length_3812_cov_65.007272	840	903	13	2	63	0.0317460
NODE_383_length_3812_cov_65.007272	840	903	15	1	63	0.0158730
NODE_383_length_3812_cov_65.007272	840	903	20	1	63	0.0158730
NODE_383_length_3812_cov_65.007272	840	903	22	1	63	0.0158730
NODE_383_length_3812_cov_65.007272	840	903	24	1	63	0.0158730
NODE_383_length_3812_cov_65.007272	840	903	29	2	63	0.0317460
NODE_383_length_3812_cov_65.007272	840	903	33	1	63	0.0158730
NODE_383_length_3812_cov_65.007272	840	903	34	1	63	0.0158730
NODE_383_length_3812_cov_65.007272	840	903	37	1	63	0.0158730
NODE_383_length_3812_cov_65.007272	840	903	40	1	63	0.0158730
NODE_383_length_3812_cov_65.007272	840	903	42	2	63	0.0317460
NODE_383_length_3812_cov_65.007272	840	903	49	2	63	0.0317460
NODE_383_length_3812_cov_65.007272	840	903	50	1	63	0.0158730
NODE_383_length_3812_cov_65.007272	840	903	54	1	63	0.0158730
NODE_383_length_3812_cov_65.007272	840	903	58	1	63	0.0158730
NODE_383_length_3812_cov_65.007272	840	903	60	1	63	0.0158730
NODE_383_length_3812_cov_65.007272	840	903	63	1	63	0.0158730
NODE_383_length_3812_cov_65.007272	840	903	69	1	63	0.0158730
NODE_383_length_3812_cov_65.007272	840	903	73	1	63	0.0158730
NODE_383_length_3812_cov_65.007272	840	903	78	1	63	0.0158730
NODE_383_length_3812_cov_65.007272	840	903	80	1	63	0.0158730
NODE_383_length_3812_cov_65.007272	840	903	83	1	63	0.0158730
NODE_383_length_3812_cov_65.007272	840	903	88	1	63	0.0158730
NODE_383_length_3812_cov_65.007272	840	903	92	1	63	0.0158730
NODE_383_length_3812_cov_65.007272	840	903	94	1	63	0.0158730
NODE_383_length_3812_cov_65.007272	840	903	96	1	63	0.0158730
NODE_383_length_3812_cov_65.007272	840	903	97	2	63	0.0317460
NODE_383_length_3812_cov_65.007272	840	903	99	1	63	0.0158730
NODE_383_length_3812_cov_65.007272	840	903	104	1	63	0.0158730
NODE_383_length_3812_cov_65.007272	840	903	105	1	63	0.0158730
NODE_383_length_3812_cov_65.007272	840	903	109	1	63	0.0158730
NODE_383_length_3812_cov_65.007272	840	903	116	2	63	0.0317460
NODE_383_length_3812_cov_65.007272	840	903	118	3	63	0.0476190
NODE_383_length_3812_cov_65.007272	840	903	120	2	63	0.0317460
NODE_383_length_3812_cov_65.007272	840	903	122	2	63	0.0317460
NODE_383_length_3812_cov_65.007272	840	903	124	1	63	0.0158730
NODE_383_length_3812_cov_65.007272	840	903	130	1	63	0.0158730
NODE_383_length_3812_cov_65.007272	840	903	132	1	63	0.0158730
NODE_383_length_3812_cov_65.007272	840	903	134	2	63	0.0317460
NODE_383_length_3812_cov_65.007272	840	903	136	1	63	0.0158730
NODE_383_length_3812_cov_65.007272	840	903	138	1	63	0.0158730
NODE_383_length_3812_cov_65.007272	840	903	146	1	63	0.0158730
NODE_383_length_3812_cov_65.007272	840	903	154	2	63	0.0317460
NODE_383_length_3812_cov_65.007272	840	903	159	1	63	0.0158730
NODE_383_length_3812_cov_65.007272	840	903	161	1	63	0.0158730
NODE_383_length_3812_cov_65.007272	840	903	170	1	63	0.0158730
NODE_383_length_3812_cov_65.007272	840	903	171	1	63	0.0158730
NODE_383_length_3812_cov_65.007272	840	903	173	1	63	0.0158730
NODE_384_length_3805_cov_9.533189	145	236	0	14	91	0.1538462
NODE_384_length_3805_cov_9.533189	145	236	2	77	91	0.8461539
NODE_384_length_3805_cov_9.533189	209	279	0	14	70	0.2000000
NODE_384_length_3805_cov_9.533189	209	279	2	56	70	0.8000000
NODE_386_length_3799_cov_10.046486	2944	3024	0	22	80	0.2750000
NODE_386_length_3799_cov_10.046486	2944	3024	2	2	80	0.0250000
NODE_386_length_3799_cov_10.046486	2944	3024	4	17	80	0.2125000
NODE_386_length_3799_cov_10.046486	2944	3024	6	35	80	0.4375000
NODE_386_length_3799_cov_10.046486	2944	3024	16	2	80	0.0250000
NODE_386_length_3799_cov_10.046486	2944	3024	18	2	80	0.0250000
NODE_386_length_3799_cov_10.046486	2997	3077	0	75	80	0.9375000
NODE_386_length_3799_cov_10.046486	2997	3077	2	2	80	0.0250000
NODE_386_length_3799_cov_10.046486	2997	3077	4	3	80	0.0375000
NODE_388_length_3795_cov_13.724297	3350	3430	2	29	80	0.3625000
NODE_388_length_3795_cov_13.724297	3350	3430	4	51	80	0.6375000
NODE_388_length_3795_cov_13.724297	3403	3483	0	37	80	0.4625000
NODE_388_length_3795_cov_13.724297	3403	3483	2	43	80	0.5375000
NODE_388_length_3795_cov_13.724297	3479	3562	0	11	83	0.1325301
NODE_388_length_3795_cov_13.724297	3479	3562	2	13	83	0.1566265
NODE_388_length_3795_cov_13.724297	3479	3562	4	6	83	0.0722892
NODE_388_length_3795_cov_13.724297	3479	3562	6	1	83	0.0120482
NODE_388_length_3795_cov_13.724297	3479	3562	8	47	83	0.5662650
NODE_388_length_3795_cov_13.724297	3479	3562	10	5	83	0.0602410
NODE_388_length_3795_cov_13.724297	3479	3562	0	11	83	0.1325301
NODE_388_length_3795_cov_13.724297	3479	3562	2	13	83	0.1566265
NODE_388_length_3795_cov_13.724297	3479	3562	4	6	83	0.0722892
NODE_388_length_3795_cov_13.724297	3479	3562	6	1	83	0.0120482
NODE_388_length_3795_cov_13.724297	3479	3562	8	47	83	0.5662650
NODE_388_length_3795_cov_13.724297	3479	3562	10	5	83	0.0602410
NODE_388_length_3795_cov_13.724297	3479	3552	0	11	73	0.1506849
NODE_388_length_3795_cov_13.724297	3479	3552	2	13	73	0.1780822
NODE_388_length_3795_cov_13.724297	3479	3552	4	6	73	0.0821918
NODE_388_length_3795_cov_13.724297	3479	3552	6	1	73	0.0136986
NODE_388_length_3795_cov_13.724297	3479	3552	8	42	73	0.5753425
NODE_388_length_3795_cov_13.724297	3535	3586	8	27	51	0.5294118
NODE_388_length_3795_cov_13.724297	3535	3586	10	24	51	0.4705882
NODE_388_length_3795_cov_13.724297	3535	3584	8	25	49	0.5102041
NODE_388_length_3795_cov_13.724297	3535	3584	10	24	49	0.4897959
NODE_388_length_3795_cov_13.724297	3698	3721	42	7	23	0.3043478
NODE_388_length_3795_cov_13.724297	3698	3721	44	4	23	0.1739130
NODE_388_length_3795_cov_13.724297	3698	3721	46	12	23	0.5217391
NODE_394_length_3774_cov_7.720544	538	595	4	11	57	0.1929825
NODE_394_length_3774_cov_7.720544	538	595	6	13	57	0.2280702
NODE_394_length_3774_cov_7.720544	538	595	8	6	57	0.1052632
NODE_394_length_3774_cov_7.720544	538	595	10	4	57	0.0701754
NODE_394_length_3774_cov_7.720544	538	595	14	10	57	0.1754386
NODE_394_length_3774_cov_7.720544	538	595	18	13	57	0.2280702
NODE_404_length_3747_cov_3.328947	2230	2292	0	62	62	1.0000000
NODE_406_length_3743_cov_38.767014	1354	1434	10	8	80	0.1000000
NODE_406_length_3743_cov_38.767014	1354	1434	12	20	80	0.2500000
NODE_406_length_3743_cov_38.767014	1354	1434	14	1	80	0.0125000
NODE_406_length_3743_cov_38.767014	1354	1434	16	1	80	0.0125000
NODE_406_length_3743_cov_38.767014	1354	1434	20	6	80	0.0750000
NODE_406_length_3743_cov_38.767014	1354	1434	21	4	80	0.0500000
NODE_406_length_3743_cov_38.767014	1354	1434	22	13	80	0.1625000
NODE_406_length_3743_cov_38.767014	1354	1434	23	4	80	0.0500000
NODE_406_length_3743_cov_38.767014	1354	1434	24	23	80	0.2875000
NODE_406_length_3743_cov_38.767014	1407	1487	6	3	80	0.0375000
NODE_406_length_3743_cov_38.767014	1407	1487	8	11	80	0.1375000
NODE_406_length_3743_cov_38.767014	1407	1487	10	4	80	0.0500000
NODE_406_length_3743_cov_38.767014	1407	1487	12	3	80	0.0375000
NODE_406_length_3743_cov_38.767014	1407	1487	14	11	80	0.1375000
NODE_406_length_3743_cov_38.767014	1407	1487	18	9	80	0.1125000
NODE_406_length_3743_cov_38.767014	1407	1487	20	1	80	0.0125000
NODE_406_length_3743_cov_38.767014	1407	1487	21	15	80	0.1875000
NODE_406_length_3743_cov_38.767014	1407	1487	22	10	80	0.1250000
NODE_406_length_3743_cov_38.767014	1407	1487	23	4	80	0.0500000
NODE_406_length_3743_cov_38.767014	1407	1487	24	9	80	0.1125000
NODE_408_length_3733_cov_16.204458	186	249	0	46	63	0.7301587
NODE_408_length_3733_cov_16.204458	186	249	2	1	63	0.0158730
NODE_408_length_3733_cov_16.204458	186	249	3	1	63	0.0158730
NODE_408_length_3733_cov_16.204458	186	249	4	1	63	0.0158730
NODE_408_length_3733_cov_16.204458	186	249	5	4	63	0.0634921
NODE_408_length_3733_cov_16.204458	186	249	11	4	63	0.0634921
NODE_408_length_3733_cov_16.204458	186	249	20	1	63	0.0158730
NODE_408_length_3733_cov_16.204458	186	249	44	3	63	0.0476190
NODE_408_length_3733_cov_16.204458	186	249	46	2	63	0.0317460
NODE_413_length_3707_cov_56.575665	2387	2467	2	16	80	0.2000000
NODE_413_length_3707_cov_56.575665	2387	2467	4	64	80	0.8000000
NODE_413_length_3707_cov_56.575665	2440	2520	2	23	80	0.2875000
NODE_413_length_3707_cov_56.575665	2440	2520	4	24	80	0.3000000
NODE_413_length_3707_cov_56.575665	2440	2520	8	20	80	0.2500000
NODE_413_length_3707_cov_56.575665	2440	2520	10	13	80	0.1625000
NODE_413_length_3707_cov_56.575665	2516	2596	8	1	80	0.0125000
NODE_413_length_3707_cov_56.575665	2516	2596	10	10	80	0.1250000
NODE_413_length_3707_cov_56.575665	2516	2596	12	1	80	0.0125000
NODE_413_length_3707_cov_56.575665	2516	2596	16	1	80	0.0125000
NODE_413_length_3707_cov_56.575665	2516	2596	18	2	80	0.0250000
NODE_413_length_3707_cov_56.575665	2516	2596	20	2	80	0.0250000
NODE_413_length_3707_cov_56.575665	2516	2596	24	8	80	0.1000000
NODE_413_length_3707_cov_56.575665	2516	2596	26	1	80	0.0125000
NODE_413_length_3707_cov_56.575665	2516	2596	28	6	80	0.0750000
NODE_413_length_3707_cov_56.575665	2516	2596	30	37	80	0.4625000
NODE_413_length_3707_cov_56.575665	2516	2596	32	1	80	0.0125000
NODE_413_length_3707_cov_56.575665	2516	2596	34	10	80	0.1250000
NODE_413_length_3707_cov_56.575665	2569	2649	8	1	80	0.0125000
NODE_413_length_3707_cov_56.575665	2569	2649	10	7	80	0.0875000
NODE_413_length_3707_cov_56.575665	2569	2649	14	8	80	0.1000000
NODE_413_length_3707_cov_56.575665	2569	2649	17	1	80	0.0125000
NODE_413_length_3707_cov_56.575665	2569	2649	18	1	80	0.0125000
NODE_413_length_3707_cov_56.575665	2569	2649	20	10	80	0.1250000
NODE_413_length_3707_cov_56.575665	2569	2649	22	4	80	0.0500000
NODE_413_length_3707_cov_56.575665	2569	2649	24	2	80	0.0250000
NODE_413_length_3707_cov_56.575665	2569	2649	26	5	80	0.0625000
NODE_413_length_3707_cov_56.575665	2569	2649	28	2	80	0.0250000
NODE_413_length_3707_cov_56.575665	2569	2649	30	23	80	0.2875000
NODE_413_length_3707_cov_56.575665	2569	2649	32	6	80	0.0750000
NODE_413_length_3707_cov_56.575665	2569	2649	34	10	80	0.1250000
NODE_416_length_3690_cov_7.476190	723	792	0	60	69	0.8695652
NODE_416_length_3690_cov_7.476190	723	792	2	9	69	0.1304348
NODE_416_length_3690_cov_7.476190	776	855	0	79	79	1.0000000
NODE_419_length_3685_cov_7.011154	1966	2046	100	1	80	0.0125000
NODE_419_length_3685_cov_7.011154	1966	2046	103	1	80	0.0125000
NODE_419_length_3685_cov_7.011154	1966	2046	105	2	80	0.0250000
NODE_419_length_3685_cov_7.011154	1966	2046	107	1	80	0.0125000
NODE_419_length_3685_cov_7.011154	1966	2046	109	1	80	0.0125000
NODE_419_length_3685_cov_7.011154	1966	2046	111	2	80	0.0250000
NODE_419_length_3685_cov_7.011154	1966	2046	113	1	80	0.0125000
NODE_419_length_3685_cov_7.011154	1966	2046	115	1	80	0.0125000
NODE_419_length_3685_cov_7.011154	1966	2046	116	1	80	0.0125000
NODE_419_length_3685_cov_7.011154	1966	2046	119	2	80	0.0250000
NODE_419_length_3685_cov_7.011154	1966	2046	123	1	80	0.0125000
NODE_419_length_3685_cov_7.011154	1966	2046	124	1	80	0.0125000
NODE_419_length_3685_cov_7.011154	1966	2046	125	4	80	0.0500000
NODE_419_length_3685_cov_7.011154	1966	2046	126	1	80	0.0125000
NODE_419_length_3685_cov_7.011154	1966	2046	130	3	80	0.0375000
NODE_419_length_3685_cov_7.011154	1966	2046	131	1	80	0.0125000
NODE_419_length_3685_cov_7.011154	1966	2046	132	2	80	0.0250000
NODE_419_length_3685_cov_7.011154	1966	2046	136	2	80	0.0250000
NODE_419_length_3685_cov_7.011154	1966	2046	139	1	80	0.0125000
NODE_419_length_3685_cov_7.011154	1966	2046	144	2	80	0.0250000
NODE_419_length_3685_cov_7.011154	1966	2046	150	1	80	0.0125000
NODE_419_length_3685_cov_7.011154	1966	2046	156	2	80	0.0250000
NODE_419_length_3685_cov_7.011154	1966	2046	157	1	80	0.0125000
NODE_419_length_3685_cov_7.011154	1966	2046	158	2	80	0.0250000
NODE_419_length_3685_cov_7.011154	1966	2046	159	2	80	0.0250000
NODE_419_length_3685_cov_7.011154	1966	2046	160	6	80	0.0750000
NODE_419_length_3685_cov_7.011154	1966	2046	161	6	80	0.0750000
NODE_419_length_3685_cov_7.011154	1966	2046	162	1	80	0.0125000
NODE_419_length_3685_cov_7.011154	1966	2046	163	1	80	0.0125000
NODE_419_length_3685_cov_7.011154	1966	2046	164	3	80	0.0375000
NODE_419_length_3685_cov_7.011154	1966	2046	165	1	80	0.0125000
NODE_419_length_3685_cov_7.011154	1966	2046	167	2	80	0.0250000
NODE_419_length_3685_cov_7.011154	1966	2046	168	8	80	0.1000000
NODE_419_length_3685_cov_7.011154	1966	2046	169	6	80	0.0750000
NODE_419_length_3685_cov_7.011154	1966	2046	170	2	80	0.0250000
NODE_419_length_3685_cov_7.011154	1966	2046	171	1	80	0.0125000
NODE_419_length_3685_cov_7.011154	1966	2046	172	2	80	0.0250000
NODE_419_length_3685_cov_7.011154	1966	2046	174	2	80	0.0250000
NODE_419_length_3685_cov_7.011154	2019	2086	107	1	67	0.0149254
NODE_419_length_3685_cov_7.011154	2019	2086	109	1	67	0.0149254
NODE_419_length_3685_cov_7.011154	2019	2086	113	2	67	0.0298507
NODE_419_length_3685_cov_7.011154	2019	2086	115	3	67	0.0447761
NODE_419_length_3685_cov_7.011154	2019	2086	119	1	67	0.0149254
NODE_419_length_3685_cov_7.011154	2019	2086	121	1	67	0.0149254
NODE_419_length_3685_cov_7.011154	2019	2086	123	1	67	0.0149254
NODE_419_length_3685_cov_7.011154	2019	2086	127	2	67	0.0298507
NODE_419_length_3685_cov_7.011154	2019	2086	135	1	67	0.0149254
NODE_419_length_3685_cov_7.011154	2019	2086	139	1	67	0.0149254
NODE_419_length_3685_cov_7.011154	2019	2086	141	4	67	0.0597015
NODE_419_length_3685_cov_7.011154	2019	2086	143	1	67	0.0149254
NODE_419_length_3685_cov_7.011154	2019	2086	144	3	67	0.0447761
NODE_419_length_3685_cov_7.011154	2019	2086	148	1	67	0.0149254
NODE_419_length_3685_cov_7.011154	2019	2086	151	1	67	0.0149254
NODE_419_length_3685_cov_7.011154	2019	2086	153	9	67	0.1343284
NODE_419_length_3685_cov_7.011154	2019	2086	155	1	67	0.0149254
NODE_419_length_3685_cov_7.011154	2019	2086	156	1	67	0.0149254
NODE_419_length_3685_cov_7.011154	2019	2086	157	2	67	0.0298507
NODE_419_length_3685_cov_7.011154	2019	2086	158	2	67	0.0298507
NODE_419_length_3685_cov_7.011154	2019	2086	162	2	67	0.0298507
NODE_419_length_3685_cov_7.011154	2019	2086	164	3	67	0.0447761
NODE_419_length_3685_cov_7.011154	2019	2086	167	2	67	0.0298507
NODE_419_length_3685_cov_7.011154	2019	2086	168	8	67	0.1194030
NODE_419_length_3685_cov_7.011154	2019	2086	169	6	67	0.0895522
NODE_419_length_3685_cov_7.011154	2019	2086	170	2	67	0.0298507
NODE_419_length_3685_cov_7.011154	2019	2086	171	1	67	0.0149254
NODE_419_length_3685_cov_7.011154	2019	2086	172	2	67	0.0298507
NODE_419_length_3685_cov_7.011154	2019	2086	174	2	67	0.0298507
NODE_426_length_3667_cov_1089.047365	1634	1705	5	2	71	0.0281690
NODE_426_length_3667_cov_1089.047365	1634	1705	7	20	71	0.2816902
NODE_426_length_3667_cov_1089.047365	1634	1705	9	4	71	0.0563380
NODE_426_length_3667_cov_1089.047365	1634	1705	10	7	71	0.0985916
NODE_426_length_3667_cov_1089.047365	1634	1705	12	38	71	0.5352113
NODE_426_length_3667_cov_1089.047365	1678	1758	4	8	80	0.1000000
NODE_426_length_3667_cov_1089.047365	1678	1758	6	13	80	0.1625000
NODE_426_length_3667_cov_1089.047365	1678	1758	8	10	80	0.1250000
NODE_426_length_3667_cov_1089.047365	1678	1758	10	10	80	0.1250000
NODE_426_length_3667_cov_1089.047365	1678	1758	12	39	80	0.4875000
NODE_428_length_3660_cov_79.447627	1806	1870	81	3	64	0.0468750
NODE_428_length_3660_cov_79.447627	1806	1870	83	1	64	0.0156250
NODE_428_length_3660_cov_79.447627	1806	1870	85	1	64	0.0156250
NODE_428_length_3660_cov_79.447627	1806	1870	87	1	64	0.0156250
NODE_428_length_3660_cov_79.447627	1806	1870	91	3	64	0.0468750
NODE_428_length_3660_cov_79.447627	1806	1870	95	1	64	0.0156250
NODE_428_length_3660_cov_79.447627	1806	1870	101	2	64	0.0312500
NODE_428_length_3660_cov_79.447627	1806	1870	103	1	64	0.0156250
NODE_428_length_3660_cov_79.447627	1806	1870	105	2	64	0.0312500
NODE_428_length_3660_cov_79.447627	1806	1870	107	2	64	0.0312500
NODE_428_length_3660_cov_79.447627	1806	1870	111	1	64	0.0156250
NODE_428_length_3660_cov_79.447627	1806	1870	113	2	64	0.0312500
NODE_428_length_3660_cov_79.447627	1806	1870	115	1	64	0.0156250
NODE_428_length_3660_cov_79.447627	1806	1870	119	1	64	0.0156250
NODE_428_length_3660_cov_79.447627	1806	1870	123	2	64	0.0312500
NODE_428_length_3660_cov_79.447627	1806	1870	125	2	64	0.0312500
NODE_428_length_3660_cov_79.447627	1806	1870	129	1	64	0.0156250
NODE_428_length_3660_cov_79.447627	1806	1870	130	1	64	0.0156250
NODE_428_length_3660_cov_79.447627	1806	1870	132	2	64	0.0312500
NODE_428_length_3660_cov_79.447627	1806	1870	135	1	64	0.0156250
NODE_428_length_3660_cov_79.447627	1806	1870	141	2	64	0.0312500
NODE_428_length_3660_cov_79.447627	1806	1870	143	2	64	0.0312500
NODE_428_length_3660_cov_79.447627	1806	1870	145	1	64	0.0156250
NODE_428_length_3660_cov_79.447627	1806	1870	148	1	64	0.0156250
NODE_428_length_3660_cov_79.447627	1806	1870	149	1	64	0.0156250
NODE_428_length_3660_cov_79.447627	1806	1870	150	2	64	0.0312500
NODE_428_length_3660_cov_79.447627	1806	1870	151	3	64	0.0468750
NODE_428_length_3660_cov_79.447627	1806	1870	152	5	64	0.0781250
NODE_428_length_3660_cov_79.447627	1806	1870	153	1	64	0.0156250
NODE_428_length_3660_cov_79.447627	1806	1870	154	2	64	0.0312500
NODE_428_length_3660_cov_79.447627	1806	1870	156	2	64	0.0312500
NODE_428_length_3660_cov_79.447627	1806	1870	159	2	64	0.0312500
NODE_428_length_3660_cov_79.447627	1806	1870	160	3	64	0.0468750
NODE_428_length_3660_cov_79.447627	1806	1870	161	1	64	0.0156250
NODE_428_length_3660_cov_79.447627	1806	1870	163	3	64	0.0468750
NODE_428_length_3660_cov_79.447627	1806	1870	165	1	64	0.0156250
NODE_428_length_3660_cov_79.447627	1806	1870	167	1	64	0.0156250
NODE_428_length_3660_cov_79.447627	1859	1906	159	2	47	0.0425532
NODE_428_length_3660_cov_79.447627	1859	1906	160	3	47	0.0638298
NODE_428_length_3660_cov_79.447627	1859	1906	161	1	47	0.0212766
NODE_428_length_3660_cov_79.447627	1859	1906	163	3	47	0.0638298
NODE_428_length_3660_cov_79.447627	1859	1906	165	2	47	0.0425532
NODE_428_length_3660_cov_79.447627	1859	1906	167	2	47	0.0425532
NODE_428_length_3660_cov_79.447627	1859	1906	170	1	47	0.0212766
NODE_428_length_3660_cov_79.447627	1859	1906	172	4	47	0.0851064
NODE_428_length_3660_cov_79.447627	1859	1906	174	2	47	0.0425532
NODE_428_length_3660_cov_79.447627	1859	1906	176	1	47	0.0212766
NODE_428_length_3660_cov_79.447627	1859	1906	180	1	47	0.0212766
NODE_428_length_3660_cov_79.447627	1859	1906	181	1	47	0.0212766
NODE_428_length_3660_cov_79.447627	1859	1906	189	1	47	0.0212766
NODE_428_length_3660_cov_79.447627	1859	1906	190	4	47	0.0851064
NODE_428_length_3660_cov_79.447627	1859	1906	191	3	47	0.0638298
NODE_428_length_3660_cov_79.447627	1859	1906	192	1	47	0.0212766
NODE_428_length_3660_cov_79.447627	1859	1906	193	1	47	0.0212766
NODE_428_length_3660_cov_79.447627	1859	1906	197	2	47	0.0425532
NODE_428_length_3660_cov_79.447627	1859	1906	199	2	47	0.0425532
NODE_428_length_3660_cov_79.447627	1859	1906	201	4	47	0.0851064
NODE_428_length_3660_cov_79.447627	1859	1906	202	5	47	0.1063830
NODE_428_length_3660_cov_79.447627	1859	1906	204	1	47	0.0212766
NODE_428_length_3660_cov_79.447627	2358	2438	0	80	80	1.0000000
NODE_428_length_3660_cov_79.447627	2411	2491	0	80	80	1.0000000
NODE_428_length_3660_cov_79.447627	2487	2567	0	80	80	1.0000000
NODE_428_length_3660_cov_79.447627	2540	2620	0	80	80	1.0000000
NODE_430_length_3634_cov_34.913154	1499	1544	82	2	45	0.0444444
NODE_430_length_3634_cov_34.913154	1499	1544	84	1	45	0.0222222
NODE_430_length_3634_cov_34.913154	1499	1544	86	4	45	0.0888889
NODE_430_length_3634_cov_34.913154	1499	1544	88	1	45	0.0222222
NODE_430_length_3634_cov_34.913154	1499	1544	96	5	45	0.1111111
NODE_430_length_3634_cov_34.913154	1499	1544	99	1	45	0.0222222
NODE_430_length_3634_cov_34.913154	1499	1544	106	1	45	0.0222222
NODE_430_length_3634_cov_34.913154	1499	1544	108	1	45	0.0222222
NODE_430_length_3634_cov_34.913154	1499	1544	112	2	45	0.0444444
NODE_430_length_3634_cov_34.913154	1499	1544	120	1	45	0.0222222
NODE_430_length_3634_cov_34.913154	1499	1544	130	1	45	0.0222222
NODE_430_length_3634_cov_34.913154	1499	1544	142	1	45	0.0222222
NODE_430_length_3634_cov_34.913154	1499	1544	148	1	45	0.0222222
NODE_430_length_3634_cov_34.913154	1499	1544	152	1	45	0.0222222
NODE_430_length_3634_cov_34.913154	1499	1544	156	1	45	0.0222222
NODE_430_length_3634_cov_34.913154	1499	1544	160	1	45	0.0222222
NODE_430_length_3634_cov_34.913154	1499	1544	172	1	45	0.0222222
NODE_430_length_3634_cov_34.913154	1499	1544	180	1	45	0.0222222
NODE_430_length_3634_cov_34.913154	1499	1544	199	1	45	0.0222222
NODE_430_length_3634_cov_34.913154	1499	1544	204	1	45	0.0222222
NODE_430_length_3634_cov_34.913154	1499	1544	205	1	45	0.0222222
NODE_430_length_3634_cov_34.913154	1499	1544	206	1	45	0.0222222
NODE_430_length_3634_cov_34.913154	1499	1544	212	1	45	0.0222222
NODE_430_length_3634_cov_34.913154	1499	1544	214	1	45	0.0222222
NODE_430_length_3634_cov_34.913154	1499	1544	221	1	45	0.0222222
NODE_430_length_3634_cov_34.913154	1499	1544	223	1	45	0.0222222
NODE_430_length_3634_cov_34.913154	1499	1544	226	1	45	0.0222222
NODE_430_length_3634_cov_34.913154	1499	1544	227	1	45	0.0222222
NODE_430_length_3634_cov_34.913154	1499	1544	236	1	45	0.0222222
NODE_430_length_3634_cov_34.913154	1499	1544	238	1	45	0.0222222
NODE_430_length_3634_cov_34.913154	1499	1544	241	1	45	0.0222222
NODE_430_length_3634_cov_34.913154	1499	1544	247	1	45	0.0222222
NODE_430_length_3634_cov_34.913154	1499	1544	261	1	45	0.0222222
NODE_430_length_3634_cov_34.913154	1499	1544	266	1	45	0.0222222
NODE_430_length_3634_cov_34.913154	1499	1544	268	1	45	0.0222222
NODE_430_length_3634_cov_34.913154	1499	1544	272	1	45	0.0222222
NODE_430_length_3634_cov_34.913154	1517	1597	120	1	80	0.0125000
NODE_430_length_3634_cov_34.913154	1517	1597	130	1	80	0.0125000
NODE_430_length_3634_cov_34.913154	1517	1597	142	1	80	0.0125000
NODE_430_length_3634_cov_34.913154	1517	1597	148	1	80	0.0125000
NODE_430_length_3634_cov_34.913154	1517	1597	152	1	80	0.0125000
NODE_430_length_3634_cov_34.913154	1517	1597	156	1	80	0.0125000
NODE_430_length_3634_cov_34.913154	1517	1597	160	1	80	0.0125000
NODE_430_length_3634_cov_34.913154	1517	1597	172	1	80	0.0125000
NODE_430_length_3634_cov_34.913154	1517	1597	180	1	80	0.0125000
NODE_430_length_3634_cov_34.913154	1517	1597	199	1	80	0.0125000
NODE_430_length_3634_cov_34.913154	1517	1597	204	1	80	0.0125000
NODE_430_length_3634_cov_34.913154	1517	1597	205	1	80	0.0125000
NODE_430_length_3634_cov_34.913154	1517	1597	206	1	80	0.0125000
NODE_430_length_3634_cov_34.913154	1517	1597	212	1	80	0.0125000
NODE_430_length_3634_cov_34.913154	1517	1597	214	1	80	0.0125000
NODE_430_length_3634_cov_34.913154	1517	1597	221	1	80	0.0125000
NODE_430_length_3634_cov_34.913154	1517	1597	223	1	80	0.0125000
NODE_430_length_3634_cov_34.913154	1517	1597	226	1	80	0.0125000
NODE_430_length_3634_cov_34.913154	1517	1597	227	1	80	0.0125000
NODE_430_length_3634_cov_34.913154	1517	1597	236	1	80	0.0125000
NODE_430_length_3634_cov_34.913154	1517	1597	238	1	80	0.0125000
NODE_430_length_3634_cov_34.913154	1517	1597	241	1	80	0.0125000
NODE_430_length_3634_cov_34.913154	1517	1597	247	1	80	0.0125000
NODE_430_length_3634_cov_34.913154	1517	1597	261	1	80	0.0125000
NODE_430_length_3634_cov_34.913154	1517	1597	266	1	80	0.0125000
NODE_430_length_3634_cov_34.913154	1517	1597	268	1	80	0.0125000
NODE_430_length_3634_cov_34.913154	1517	1597	272	1	80	0.0125000
NODE_430_length_3634_cov_34.913154	1517	1597	276	1	80	0.0125000
NODE_430_length_3634_cov_34.913154	1517	1597	278	2	80	0.0250000
NODE_430_length_3634_cov_34.913154	1517	1597	283	1	80	0.0125000
NODE_430_length_3634_cov_34.913154	1517	1597	292	1	80	0.0125000
NODE_430_length_3634_cov_34.913154	1517	1597	293	4	80	0.0500000
NODE_430_length_3634_cov_34.913154	1517	1597	304	1	80	0.0125000
NODE_430_length_3634_cov_34.913154	1517	1597	307	2	80	0.0250000
NODE_430_length_3634_cov_34.913154	1517	1597	308	1	80	0.0125000
NODE_430_length_3634_cov_34.913154	1517	1597	323	1	80	0.0125000
NODE_430_length_3634_cov_34.913154	1517	1597	326	1	80	0.0125000
NODE_430_length_3634_cov_34.913154	1517	1597	330	2	80	0.0250000
NODE_430_length_3634_cov_34.913154	1517	1597	332	1	80	0.0125000
NODE_430_length_3634_cov_34.913154	1517	1597	335	3	80	0.0375000
NODE_430_length_3634_cov_34.913154	1517	1597	337	2	80	0.0250000
NODE_430_length_3634_cov_34.913154	1517	1597	340	2	80	0.0250000
NODE_430_length_3634_cov_34.913154	1517	1597	344	1	80	0.0125000
NODE_430_length_3634_cov_34.913154	1517	1597	347	1	80	0.0125000
NODE_430_length_3634_cov_34.913154	1517	1597	353	1	80	0.0125000
NODE_430_length_3634_cov_34.913154	1517	1597	363	1	80	0.0125000
NODE_430_length_3634_cov_34.913154	1517	1597	378	1	80	0.0125000
NODE_430_length_3634_cov_34.913154	1517	1597	381	1	80	0.0125000
NODE_430_length_3634_cov_34.913154	1517	1597	389	1	80	0.0125000
NODE_430_length_3634_cov_34.913154	1517	1597	395	1	80	0.0125000
NODE_430_length_3634_cov_34.913154	1517	1597	407	1	80	0.0125000
NODE_430_length_3634_cov_34.913154	1517	1597	418	1	80	0.0125000
NODE_430_length_3634_cov_34.913154	1517	1597	431	1	80	0.0125000
NODE_430_length_3634_cov_34.913154	1517	1597	434	1	80	0.0125000
NODE_430_length_3634_cov_34.913154	1517	1597	436	1	80	0.0125000
NODE_430_length_3634_cov_34.913154	1517	1597	437	3	80	0.0375000
NODE_430_length_3634_cov_34.913154	1517	1597	438	1	80	0.0125000
NODE_430_length_3634_cov_34.913154	1517	1597	442	2	80	0.0250000
NODE_430_length_3634_cov_34.913154	1517	1597	445	3	80	0.0375000
NODE_430_length_3634_cov_34.913154	1517	1597	446	1	80	0.0125000
NODE_430_length_3634_cov_34.913154	1517	1597	447	5	80	0.0625000
NODE_430_length_3634_cov_34.913154	1978	2058	98	1	80	0.0125000
NODE_430_length_3634_cov_34.913154	1978	2058	101	1	80	0.0125000
NODE_430_length_3634_cov_34.913154	1978	2058	106	1	80	0.0125000
NODE_430_length_3634_cov_34.913154	1978	2058	109	1	80	0.0125000
NODE_430_length_3634_cov_34.913154	1978	2058	121	1	80	0.0125000
NODE_430_length_3634_cov_34.913154	1978	2058	129	1	80	0.0125000
NODE_430_length_3634_cov_34.913154	1978	2058	131	1	80	0.0125000
NODE_430_length_3634_cov_34.913154	1978	2058	132	2	80	0.0250000
NODE_430_length_3634_cov_34.913154	1978	2058	136	1	80	0.0125000
NODE_430_length_3634_cov_34.913154	1978	2058	140	1	80	0.0125000
NODE_430_length_3634_cov_34.913154	1978	2058	148	1	80	0.0125000
NODE_430_length_3634_cov_34.913154	1978	2058	163	1	80	0.0125000
NODE_430_length_3634_cov_34.913154	1978	2058	175	1	80	0.0125000
NODE_430_length_3634_cov_34.913154	1978	2058	186	1	80	0.0125000
NODE_430_length_3634_cov_34.913154	1978	2058	200	1	80	0.0125000
NODE_430_length_3634_cov_34.913154	1978	2058	204	1	80	0.0125000
NODE_430_length_3634_cov_34.913154	1978	2058	206	1	80	0.0125000
NODE_430_length_3634_cov_34.913154	1978	2058	219	1	80	0.0125000
NODE_430_length_3634_cov_34.913154	1978	2058	223	2	80	0.0250000
NODE_430_length_3634_cov_34.913154	1978	2058	227	1	80	0.0125000
NODE_430_length_3634_cov_34.913154	1978	2058	231	1	80	0.0125000
NODE_430_length_3634_cov_34.913154	1978	2058	237	1	80	0.0125000
NODE_430_length_3634_cov_34.913154	1978	2058	247	1	80	0.0125000
NODE_430_length_3634_cov_34.913154	1978	2058	253	1	80	0.0125000
NODE_430_length_3634_cov_34.913154	1978	2058	257	1	80	0.0125000
NODE_430_length_3634_cov_34.913154	1978	2058	258	2	80	0.0250000
NODE_430_length_3634_cov_34.913154	1978	2058	259	1	80	0.0125000
NODE_430_length_3634_cov_34.913154	1978	2058	264	1	80	0.0125000
NODE_430_length_3634_cov_34.913154	1978	2058	265	1	80	0.0125000
NODE_430_length_3634_cov_34.913154	1978	2058	267	1	80	0.0125000
NODE_430_length_3634_cov_34.913154	1978	2058	269	2	80	0.0250000
NODE_430_length_3634_cov_34.913154	1978	2058	273	1	80	0.0125000
NODE_430_length_3634_cov_34.913154	1978	2058	276	2	80	0.0250000
NODE_430_length_3634_cov_34.913154	1978	2058	292	1	80	0.0125000
NODE_430_length_3634_cov_34.913154	1978	2058	296	1	80	0.0125000
NODE_430_length_3634_cov_34.913154	1978	2058	298	1	80	0.0125000
NODE_430_length_3634_cov_34.913154	1978	2058	301	1	80	0.0125000
NODE_430_length_3634_cov_34.913154	1978	2058	303	1	80	0.0125000
NODE_430_length_3634_cov_34.913154	1978	2058	305	1	80	0.0125000
NODE_430_length_3634_cov_34.913154	1978	2058	311	1	80	0.0125000
NODE_430_length_3634_cov_34.913154	1978	2058	313	2	80	0.0250000
NODE_430_length_3634_cov_34.913154	1978	2058	315	1	80	0.0125000
NODE_430_length_3634_cov_34.913154	1978	2058	317	1	80	0.0125000
NODE_430_length_3634_cov_34.913154	1978	2058	319	1	80	0.0125000
NODE_430_length_3634_cov_34.913154	1978	2058	320	2	80	0.0250000
NODE_430_length_3634_cov_34.913154	1978	2058	322	1	80	0.0125000
NODE_430_length_3634_cov_34.913154	1978	2058	329	2	80	0.0250000
NODE_430_length_3634_cov_34.913154	1978	2058	331	1	80	0.0125000
NODE_430_length_3634_cov_34.913154	1978	2058	342	1	80	0.0125000
NODE_430_length_3634_cov_34.913154	1978	2058	356	1	80	0.0125000
NODE_430_length_3634_cov_34.913154	1978	2058	358	1	80	0.0125000
NODE_430_length_3634_cov_34.913154	1978	2058	366	1	80	0.0125000
NODE_430_length_3634_cov_34.913154	1978	2058	387	1	80	0.0125000
NODE_430_length_3634_cov_34.913154	1978	2058	389	1	80	0.0125000
NODE_430_length_3634_cov_34.913154	1978	2058	396	1	80	0.0125000
NODE_430_length_3634_cov_34.913154	1978	2058	416	1	80	0.0125000
NODE_430_length_3634_cov_34.913154	1978	2058	422	1	80	0.0125000
NODE_430_length_3634_cov_34.913154	1978	2058	430	1	80	0.0125000
NODE_430_length_3634_cov_34.913154	1978	2058	432	1	80	0.0125000
NODE_430_length_3634_cov_34.913154	1978	2058	436	1	80	0.0125000
NODE_430_length_3634_cov_34.913154	1978	2058	438	1	80	0.0125000
NODE_430_length_3634_cov_34.913154	1978	2058	445	1	80	0.0125000
NODE_430_length_3634_cov_34.913154	1978	2058	452	1	80	0.0125000
NODE_430_length_3634_cov_34.913154	1978	2058	466	1	80	0.0125000
NODE_430_length_3634_cov_34.913154	1978	2058	479	1	80	0.0125000
NODE_430_length_3634_cov_34.913154	1978	2058	485	1	80	0.0125000
NODE_430_length_3634_cov_34.913154	1978	2058	491	1	80	0.0125000
NODE_430_length_3634_cov_34.913154	1978	2058	501	1	80	0.0125000
NODE_430_length_3634_cov_34.913154	1978	2058	525	1	80	0.0125000
NODE_430_length_3634_cov_34.913154	1978	2058	529	1	80	0.0125000
NODE_430_length_3634_cov_34.913154	1978	2058	533	1	80	0.0125000
NODE_430_length_3634_cov_34.913154	1978	2058	534	1	80	0.0125000
NODE_430_length_3634_cov_34.913154	2031	2077	26	1	46	0.0217391
NODE_430_length_3634_cov_34.913154	2031	2077	31	1	46	0.0217391
NODE_430_length_3634_cov_34.913154	2031	2077	37	1	46	0.0217391
NODE_430_length_3634_cov_34.913154	2031	2077	47	2	46	0.0434783
NODE_430_length_3634_cov_34.913154	2031	2077	49	1	46	0.0217391
NODE_430_length_3634_cov_34.913154	2031	2077	55	1	46	0.0217391
NODE_430_length_3634_cov_34.913154	2031	2077	58	1	46	0.0217391
NODE_430_length_3634_cov_34.913154	2031	2077	60	1	46	0.0217391
NODE_430_length_3634_cov_34.913154	2031	2077	61	1	46	0.0217391
NODE_430_length_3634_cov_34.913154	2031	2077	67	1	46	0.0217391
NODE_430_length_3634_cov_34.913154	2031	2077	69	1	46	0.0217391
NODE_430_length_3634_cov_34.913154	2031	2077	73	1	46	0.0217391
NODE_430_length_3634_cov_34.913154	2031	2077	75	1	46	0.0217391
NODE_430_length_3634_cov_34.913154	2031	2077	79	2	46	0.0434783
NODE_430_length_3634_cov_34.913154	2031	2077	83	1	46	0.0217391
NODE_430_length_3634_cov_34.913154	2031	2077	92	1	46	0.0217391
NODE_430_length_3634_cov_34.913154	2031	2077	98	2	46	0.0434783
NODE_430_length_3634_cov_34.913154	2031	2077	101	1	46	0.0217391
NODE_430_length_3634_cov_34.913154	2031	2077	106	1	46	0.0217391
NODE_430_length_3634_cov_34.913154	2031	2077	109	1	46	0.0217391
NODE_430_length_3634_cov_34.913154	2031	2077	121	1	46	0.0217391
NODE_430_length_3634_cov_34.913154	2031	2077	129	1	46	0.0217391
NODE_430_length_3634_cov_34.913154	2031	2077	131	1	46	0.0217391
NODE_430_length_3634_cov_34.913154	2031	2077	132	2	46	0.0434783
NODE_430_length_3634_cov_34.913154	2031	2077	136	1	46	0.0217391
NODE_430_length_3634_cov_34.913154	2031	2077	140	1	46	0.0217391
NODE_430_length_3634_cov_34.913154	2031	2077	148	1	46	0.0217391
NODE_430_length_3634_cov_34.913154	2031	2077	163	1	46	0.0217391
NODE_430_length_3634_cov_34.913154	2031	2077	175	1	46	0.0217391
NODE_430_length_3634_cov_34.913154	2031	2077	186	1	46	0.0217391
NODE_430_length_3634_cov_34.913154	2031	2077	200	1	46	0.0217391
NODE_430_length_3634_cov_34.913154	2031	2077	204	1	46	0.0217391
NODE_430_length_3634_cov_34.913154	2031	2077	206	1	46	0.0217391
NODE_430_length_3634_cov_34.913154	2031	2077	219	1	46	0.0217391
NODE_430_length_3634_cov_34.913154	2031	2077	223	2	46	0.0434783
NODE_430_length_3634_cov_34.913154	2031	2077	227	1	46	0.0217391
NODE_430_length_3634_cov_34.913154	2031	2077	231	1	46	0.0217391
NODE_430_length_3634_cov_34.913154	2031	2077	237	1	46	0.0217391
NODE_430_length_3634_cov_34.913154	2031	2077	247	1	46	0.0217391
NODE_430_length_3634_cov_34.913154	2031	2077	253	1	46	0.0217391
NODE_430_length_3634_cov_34.913154	2031	2077	258	1	46	0.0217391
NODE_435_length_3622_cov_29.112120	201	281	0	34	80	0.4250000
NODE_435_length_3622_cov_29.112120	201	281	2	46	80	0.5750000
NODE_435_length_3622_cov_29.112120	254	334	2	63	80	0.7875000
NODE_435_length_3622_cov_29.112120	254	334	4	17	80	0.2125000
NODE_435_length_3622_cov_29.112120	2310	2390	146	1	80	0.0125000
NODE_435_length_3622_cov_29.112120	2310	2390	148	1	80	0.0125000
NODE_435_length_3622_cov_29.112120	2310	2390	149	1	80	0.0125000
NODE_435_length_3622_cov_29.112120	2310	2390	155	1	80	0.0125000
NODE_435_length_3622_cov_29.112120	2310	2390	157	3	80	0.0375000
NODE_435_length_3622_cov_29.112120	2310	2390	167	2	80	0.0250000
NODE_435_length_3622_cov_29.112120	2310	2390	168	2	80	0.0250000
NODE_435_length_3622_cov_29.112120	2310	2390	172	2	80	0.0250000
NODE_435_length_3622_cov_29.112120	2310	2390	178	1	80	0.0125000
NODE_435_length_3622_cov_29.112120	2310	2390	188	1	80	0.0125000
NODE_435_length_3622_cov_29.112120	2310	2390	194	2	80	0.0250000
NODE_435_length_3622_cov_29.112120	2310	2390	196	1	80	0.0125000
NODE_435_length_3622_cov_29.112120	2310	2390	204	1	80	0.0125000
NODE_435_length_3622_cov_29.112120	2310	2390	209	1	80	0.0125000
NODE_435_length_3622_cov_29.112120	2310	2390	211	2	80	0.0250000
NODE_435_length_3622_cov_29.112120	2310	2390	225	2	80	0.0250000
NODE_435_length_3622_cov_29.112120	2310	2390	231	1	80	0.0125000
NODE_435_length_3622_cov_29.112120	2310	2390	239	1	80	0.0125000
NODE_435_length_3622_cov_29.112120	2310	2390	240	3	80	0.0375000
NODE_435_length_3622_cov_29.112120	2310	2390	246	1	80	0.0125000
NODE_435_length_3622_cov_29.112120	2310	2390	255	1	80	0.0125000
NODE_435_length_3622_cov_29.112120	2310	2390	257	1	80	0.0125000
NODE_435_length_3622_cov_29.112120	2310	2390	258	1	80	0.0125000
NODE_435_length_3622_cov_29.112120	2310	2390	264	1	80	0.0125000
NODE_435_length_3622_cov_29.112120	2310	2390	270	1	80	0.0125000
NODE_435_length_3622_cov_29.112120	2310	2390	277	1	80	0.0125000
NODE_435_length_3622_cov_29.112120	2310	2390	281	1	80	0.0125000
NODE_435_length_3622_cov_29.112120	2310	2390	287	1	80	0.0125000
NODE_435_length_3622_cov_29.112120	2310	2390	290	1	80	0.0125000
NODE_435_length_3622_cov_29.112120	2310	2390	296	1	80	0.0125000
NODE_435_length_3622_cov_29.112120	2310	2390	304	1	80	0.0125000
NODE_435_length_3622_cov_29.112120	2310	2390	306	1	80	0.0125000
NODE_435_length_3622_cov_29.112120	2310	2390	310	1	80	0.0125000
NODE_435_length_3622_cov_29.112120	2310	2390	314	1	80	0.0125000
NODE_435_length_3622_cov_29.112120	2310	2390	316	1	80	0.0125000
NODE_435_length_3622_cov_29.112120	2310	2390	318	1	80	0.0125000
NODE_435_length_3622_cov_29.112120	2310	2390	322	1	80	0.0125000
NODE_435_length_3622_cov_29.112120	2310	2390	326	1	80	0.0125000
NODE_435_length_3622_cov_29.112120	2310	2390	328	2	80	0.0250000
NODE_435_length_3622_cov_29.112120	2310	2390	329	1	80	0.0125000
NODE_435_length_3622_cov_29.112120	2310	2390	332	8	80	0.1000000
NODE_435_length_3622_cov_29.112120	2310	2390	334	3	80	0.0375000
NODE_435_length_3622_cov_29.112120	2310	2390	335	1	80	0.0125000
NODE_435_length_3622_cov_29.112120	2310	2390	336	3	80	0.0375000
NODE_435_length_3622_cov_29.112120	2310	2390	339	2	80	0.0250000
NODE_435_length_3622_cov_29.112120	2310	2390	344	2	80	0.0250000
NODE_435_length_3622_cov_29.112120	2310	2390	348	3	80	0.0375000
NODE_435_length_3622_cov_29.112120	2310	2390	349	5	80	0.0625000
NODE_435_length_3622_cov_29.112120	2310	2390	351	2	80	0.0250000
NODE_435_length_3622_cov_29.112120	2363	2441	12	2	78	0.0256410
NODE_435_length_3622_cov_29.112120	2363	2441	14	2	78	0.0256410
NODE_435_length_3622_cov_29.112120	2363	2441	16	1	78	0.0128205
NODE_435_length_3622_cov_29.112120	2363	2441	20	1	78	0.0128205
NODE_435_length_3622_cov_29.112120	2363	2441	21	1	78	0.0128205
NODE_435_length_3622_cov_29.112120	2363	2441	24	2	78	0.0256410
NODE_435_length_3622_cov_29.112120	2363	2441	27	2	78	0.0256410
NODE_435_length_3622_cov_29.112120	2363	2441	29	1	78	0.0128205
NODE_435_length_3622_cov_29.112120	2363	2441	33	5	78	0.0641026
NODE_435_length_3622_cov_29.112120	2363	2441	39	2	78	0.0256410
NODE_435_length_3622_cov_29.112120	2363	2441	40	3	78	0.0384615
NODE_435_length_3622_cov_29.112120	2363	2441	41	1	78	0.0128205
NODE_435_length_3622_cov_29.112120	2363	2441	43	1	78	0.0128205
NODE_435_length_3622_cov_29.112120	2363	2441	47	4	78	0.0512821
NODE_435_length_3622_cov_29.112120	2363	2441	50	2	78	0.0256410
NODE_435_length_3622_cov_29.112120	2363	2441	54	1	78	0.0128205
NODE_435_length_3622_cov_29.112120	2363	2441	55	1	78	0.0128205
NODE_435_length_3622_cov_29.112120	2363	2441	63	3	78	0.0384615
NODE_435_length_3622_cov_29.112120	2363	2441	73	1	78	0.0128205
NODE_435_length_3622_cov_29.112120	2363	2441	74	1	78	0.0128205
NODE_435_length_3622_cov_29.112120	2363	2441	75	1	78	0.0128205
NODE_435_length_3622_cov_29.112120	2363	2441	85	1	78	0.0128205
NODE_435_length_3622_cov_29.112120	2363	2441	89	1	78	0.0128205
NODE_435_length_3622_cov_29.112120	2363	2441	96	1	78	0.0128205
NODE_435_length_3622_cov_29.112120	2363	2441	102	1	78	0.0128205
NODE_435_length_3622_cov_29.112120	2363	2441	106	1	78	0.0128205
NODE_435_length_3622_cov_29.112120	2363	2441	110	1	78	0.0128205
NODE_435_length_3622_cov_29.112120	2363	2441	112	1	78	0.0128205
NODE_435_length_3622_cov_29.112120	2363	2441	125	1	78	0.0128205
NODE_435_length_3622_cov_29.112120	2363	2441	127	1	78	0.0128205
NODE_435_length_3622_cov_29.112120	2363	2441	129	1	78	0.0128205
NODE_435_length_3622_cov_29.112120	2363	2441	135	1	78	0.0128205
NODE_435_length_3622_cov_29.112120	2363	2441	139	1	78	0.0128205
NODE_435_length_3622_cov_29.112120	2363	2441	146	2	78	0.0256410
NODE_435_length_3622_cov_29.112120	2363	2441	148	1	78	0.0128205
NODE_435_length_3622_cov_29.112120	2363	2441	149	1	78	0.0128205
NODE_435_length_3622_cov_29.112120	2363	2441	155	1	78	0.0128205
NODE_435_length_3622_cov_29.112120	2363	2441	157	3	78	0.0384615
NODE_435_length_3622_cov_29.112120	2363	2441	167	2	78	0.0256410
NODE_435_length_3622_cov_29.112120	2363	2441	168	2	78	0.0256410
NODE_435_length_3622_cov_29.112120	2363	2441	172	2	78	0.0256410
NODE_435_length_3622_cov_29.112120	2363	2441	178	1	78	0.0128205
NODE_435_length_3622_cov_29.112120	2363	2441	188	1	78	0.0128205
NODE_435_length_3622_cov_29.112120	2363	2441	194	2	78	0.0256410
NODE_435_length_3622_cov_29.112120	2363	2441	196	1	78	0.0128205
NODE_435_length_3622_cov_29.112120	2363	2441	204	1	78	0.0128205
NODE_435_length_3622_cov_29.112120	2363	2441	209	1	78	0.0128205
NODE_435_length_3622_cov_29.112120	2363	2441	211	2	78	0.0256410
NODE_435_length_3622_cov_29.112120	2363	2441	225	2	78	0.0256410
NODE_435_length_3622_cov_29.112120	2363	2441	231	1	78	0.0128205
NODE_435_length_3622_cov_29.112120	2363	2441	239	1	78	0.0128205
NODE_435_length_3622_cov_29.112120	2363	2441	240	1	78	0.0128205
NODE_437_length_3610_cov_8.785816	294	340	0	24	46	0.5217391
NODE_437_length_3610_cov_8.785816	294	340	2	22	46	0.4782609
NODE_437_length_3610_cov_8.785816	313	393	0	5	80	0.0625000
NODE_437_length_3610_cov_8.785816	313	393	2	75	80	0.9375000
NODE_444_length_3588_cov_16.296360	2421	2501	1	73	80	0.9125000
NODE_444_length_3588_cov_16.296360	2421	2501	3	7	80	0.0875000
NODE_444_length_3588_cov_16.296360	2474	2539	1	20	65	0.3076923
NODE_444_length_3588_cov_16.296360	2474	2539	3	21	65	0.3230769
NODE_444_length_3588_cov_16.296360	2474	2539	5	24	65	0.3692308
NODE_447_length_3585_cov_2.283419	605	668	0	63	63	1.0000000
NODE_451_length_3567_cov_16.283160	410	429	6	8	19	0.4210526
NODE_451_length_3567_cov_16.283160	410	429	8	11	19	0.5789474
NODE_451_length_3567_cov_16.283160	2259	2339	170	1	80	0.0125000
NODE_451_length_3567_cov_16.283160	2259	2339	174	2	80	0.0250000
NODE_451_length_3567_cov_16.283160	2259	2339	180	2	80	0.0250000
NODE_451_length_3567_cov_16.283160	2259	2339	182	2	80	0.0250000
NODE_451_length_3567_cov_16.283160	2259	2339	184	2	80	0.0250000
NODE_451_length_3567_cov_16.283160	2259	2339	188	1	80	0.0125000
NODE_451_length_3567_cov_16.283160	2259	2339	189	1	80	0.0125000
NODE_451_length_3567_cov_16.283160	2259	2339	192	1	80	0.0125000
NODE_451_length_3567_cov_16.283160	2259	2339	197	1	80	0.0125000
NODE_451_length_3567_cov_16.283160	2259	2339	198	2	80	0.0250000
NODE_451_length_3567_cov_16.283160	2259	2339	199	3	80	0.0375000
NODE_451_length_3567_cov_16.283160	2259	2339	201	3	80	0.0375000
NODE_451_length_3567_cov_16.283160	2259	2339	203	4	80	0.0500000
NODE_451_length_3567_cov_16.283160	2259	2339	204	3	80	0.0375000
NODE_451_length_3567_cov_16.283160	2259	2339	205	3	80	0.0375000
NODE_451_length_3567_cov_16.283160	2259	2339	206	7	80	0.0875000
NODE_451_length_3567_cov_16.283160	2259	2339	207	2	80	0.0250000
NODE_451_length_3567_cov_16.283160	2259	2339	208	1	80	0.0125000
NODE_451_length_3567_cov_16.283160	2259	2339	210	5	80	0.0625000
NODE_451_length_3567_cov_16.283160	2259	2339	211	4	80	0.0500000
NODE_451_length_3567_cov_16.283160	2259	2339	212	3	80	0.0375000
NODE_451_length_3567_cov_16.283160	2259	2339	213	5	80	0.0625000
NODE_451_length_3567_cov_16.283160	2259	2339	215	10	80	0.1250000
NODE_451_length_3567_cov_16.283160	2259	2339	216	1	80	0.0125000
NODE_451_length_3567_cov_16.283160	2259	2339	217	6	80	0.0750000
NODE_451_length_3567_cov_16.283160	2259	2339	218	5	80	0.0625000
NODE_451_length_3567_cov_16.283160	2312	2379	4	1	67	0.0149254
NODE_451_length_3567_cov_16.283160	2312	2379	8	1	67	0.0149254
NODE_451_length_3567_cov_16.283160	2312	2379	10	2	67	0.0298507
NODE_451_length_3567_cov_16.283160	2312	2379	11	1	67	0.0149254
NODE_451_length_3567_cov_16.283160	2312	2379	36	1	67	0.0149254
NODE_451_length_3567_cov_16.283160	2312	2379	38	1	67	0.0149254
NODE_451_length_3567_cov_16.283160	2312	2379	40	1	67	0.0149254
NODE_451_length_3567_cov_16.283160	2312	2379	44	2	67	0.0298507
NODE_451_length_3567_cov_16.283160	2312	2379	56	1	67	0.0149254
NODE_451_length_3567_cov_16.283160	2312	2379	59	1	67	0.0149254
NODE_451_length_3567_cov_16.283160	2312	2379	63	1	67	0.0149254
NODE_451_length_3567_cov_16.283160	2312	2379	71	1	67	0.0149254
NODE_451_length_3567_cov_16.283160	2312	2379	72	1	67	0.0149254
NODE_451_length_3567_cov_16.283160	2312	2379	80	2	67	0.0298507
NODE_451_length_3567_cov_16.283160	2312	2379	84	1	67	0.0149254
NODE_451_length_3567_cov_16.283160	2312	2379	91	1	67	0.0149254
NODE_451_length_3567_cov_16.283160	2312	2379	97	1	67	0.0149254
NODE_451_length_3567_cov_16.283160	2312	2379	99	1	67	0.0149254
NODE_451_length_3567_cov_16.283160	2312	2379	116	1	67	0.0149254
NODE_451_length_3567_cov_16.283160	2312	2379	119	1	67	0.0149254
NODE_451_length_3567_cov_16.283160	2312	2379	127	2	67	0.0298507
NODE_451_length_3567_cov_16.283160	2312	2379	135	1	67	0.0149254
NODE_451_length_3567_cov_16.283160	2312	2379	140	1	67	0.0149254
NODE_451_length_3567_cov_16.283160	2312	2379	143	2	67	0.0298507
NODE_451_length_3567_cov_16.283160	2312	2379	145	1	67	0.0149254
NODE_451_length_3567_cov_16.283160	2312	2379	151	1	67	0.0149254
NODE_451_length_3567_cov_16.283160	2312	2379	155	1	67	0.0149254
NODE_451_length_3567_cov_16.283160	2312	2379	160	1	67	0.0149254
NODE_451_length_3567_cov_16.283160	2312	2379	162	1	67	0.0149254
NODE_451_length_3567_cov_16.283160	2312	2379	165	1	67	0.0149254
NODE_451_length_3567_cov_16.283160	2312	2379	166	1	67	0.0149254
NODE_451_length_3567_cov_16.283160	2312	2379	171	1	67	0.0149254
NODE_451_length_3567_cov_16.283160	2312	2379	175	1	67	0.0149254
NODE_451_length_3567_cov_16.283160	2312	2379	177	1	67	0.0149254
NODE_451_length_3567_cov_16.283160	2312	2379	178	1	67	0.0149254
NODE_451_length_3567_cov_16.283160	2312	2379	184	1	67	0.0149254
NODE_451_length_3567_cov_16.283160	2312	2379	188	1	67	0.0149254
NODE_451_length_3567_cov_16.283160	2312	2379	189	1	67	0.0149254
NODE_451_length_3567_cov_16.283160	2312	2379	192	1	67	0.0149254
NODE_451_length_3567_cov_16.283160	2312	2379	197	1	67	0.0149254
NODE_451_length_3567_cov_16.283160	2312	2379	199	3	67	0.0447761
NODE_451_length_3567_cov_16.283160	2312	2379	201	3	67	0.0447761
NODE_451_length_3567_cov_16.283160	2312	2379	203	4	67	0.0597015
NODE_451_length_3567_cov_16.283160	2312	2379	204	2	67	0.0298507
NODE_451_length_3567_cov_16.283160	2312	2379	205	2	67	0.0298507
NODE_451_length_3567_cov_16.283160	2312	2379	206	2	67	0.0298507
NODE_451_length_3567_cov_16.283160	2312	2379	207	1	67	0.0149254
NODE_451_length_3567_cov_16.283160	2312	2379	208	1	67	0.0149254
NODE_451_length_3567_cov_16.283160	2312	2379	210	4	67	0.0597015
NODE_454_length_3557_cov_12.423077	640	718	0	78	78	1.0000000
NODE_454_length_3557_cov_12.423077	640	688	0	48	48	1.0000000
NODE_454_length_3557_cov_12.423077	640	688	0	48	48	1.0000000
NODE_454_length_3557_cov_12.423077	640	688	0	48	48	1.0000000
NODE_454_length_3557_cov_12.423077	640	688	0	48	48	1.0000000
NODE_454_length_3557_cov_12.423077	693	771	0	78	78	1.0000000
NODE_455_length_3548_cov_7.216295	554	634	2	22	80	0.2750000
NODE_455_length_3548_cov_7.216295	554	634	4	34	80	0.4250000
NODE_455_length_3548_cov_7.216295	554	634	6	24	80	0.3000000
NODE_455_length_3548_cov_7.216295	607	687	2	23	80	0.2875000
NODE_455_length_3548_cov_7.216295	607	687	4	14	80	0.1750000
NODE_455_length_3548_cov_7.216295	607	687	6	43	80	0.5375000
NODE_461_length_3518_cov_40.508336	1320	1400	0	29	80	0.3625000
NODE_461_length_3518_cov_40.508336	1320	1400	2	51	80	0.6375000
NODE_461_length_3518_cov_40.508336	1373	1453	2	74	80	0.9250000
NODE_461_length_3518_cov_40.508336	1373	1453	4	6	80	0.0750000
NODE_465_length_3497_cov_65.791348	3062	3142	439	1	80	0.0125000
NODE_465_length_3497_cov_65.791348	3062	3142	443	1	80	0.0125000
NODE_465_length_3497_cov_65.791348	3062	3142	444	1	80	0.0125000
NODE_465_length_3497_cov_65.791348	3062	3142	447	2	80	0.0250000
NODE_465_length_3497_cov_65.791348	3062	3142	448	1	80	0.0125000
NODE_465_length_3497_cov_65.791348	3062	3142	456	1	80	0.0125000
NODE_465_length_3497_cov_65.791348	3062	3142	477	1	80	0.0125000
NODE_465_length_3497_cov_65.791348	3062	3142	493	1	80	0.0125000
NODE_465_length_3497_cov_65.791348	3062	3142	498	1	80	0.0125000
NODE_465_length_3497_cov_65.791348	3062	3142	500	1	80	0.0125000
NODE_465_length_3497_cov_65.791348	3062	3142	501	1	80	0.0125000
NODE_465_length_3497_cov_65.791348	3062	3142	502	1	80	0.0125000
NODE_465_length_3497_cov_65.791348	3062	3142	510	1	80	0.0125000
NODE_465_length_3497_cov_65.791348	3062	3142	522	1	80	0.0125000
NODE_465_length_3497_cov_65.791348	3062	3142	523	1	80	0.0125000
NODE_465_length_3497_cov_65.791348	3062	3142	524	1	80	0.0125000
NODE_465_length_3497_cov_65.791348	3062	3142	525	1	80	0.0125000
NODE_465_length_3497_cov_65.791348	3062	3142	526	3	80	0.0375000
NODE_465_length_3497_cov_65.791348	3062	3142	528	1	80	0.0125000
NODE_465_length_3497_cov_65.791348	3062	3142	529	1	80	0.0125000
NODE_465_length_3497_cov_65.791348	3062	3142	532	2	80	0.0250000
NODE_465_length_3497_cov_65.791348	3062	3142	535	1	80	0.0125000
NODE_465_length_3497_cov_65.791348	3062	3142	537	2	80	0.0250000
NODE_465_length_3497_cov_65.791348	3062	3142	538	1	80	0.0125000
NODE_465_length_3497_cov_65.791348	3062	3142	539	1	80	0.0125000
NODE_465_length_3497_cov_65.791348	3062	3142	541	1	80	0.0125000
NODE_465_length_3497_cov_65.791348	3062	3142	545	1	80	0.0125000
NODE_465_length_3497_cov_65.791348	3062	3142	549	1	80	0.0125000
NODE_465_length_3497_cov_65.791348	3062	3142	551	1	80	0.0125000
NODE_465_length_3497_cov_65.791348	3062	3142	552	1	80	0.0125000
NODE_465_length_3497_cov_65.791348	3062	3142	553	1	80	0.0125000
NODE_465_length_3497_cov_65.791348	3062	3142	554	1	80	0.0125000
NODE_465_length_3497_cov_65.791348	3062	3142	558	3	80	0.0375000
NODE_465_length_3497_cov_65.791348	3062	3142	561	1	80	0.0125000
NODE_465_length_3497_cov_65.791348	3062	3142	563	3	80	0.0375000
NODE_465_length_3497_cov_65.791348	3062	3142	564	1	80	0.0125000
NODE_465_length_3497_cov_65.791348	3062	3142	566	2	80	0.0250000
NODE_465_length_3497_cov_65.791348	3062	3142	567	3	80	0.0375000
NODE_465_length_3497_cov_65.791348	3062	3142	569	1	80	0.0125000
NODE_465_length_3497_cov_65.791348	3062	3142	575	1	80	0.0125000
NODE_465_length_3497_cov_65.791348	3062	3142	587	2	80	0.0250000
NODE_465_length_3497_cov_65.791348	3062	3142	590	1	80	0.0125000
NODE_465_length_3497_cov_65.791348	3062	3142	591	1	80	0.0125000
NODE_465_length_3497_cov_65.791348	3062	3142	593	1	80	0.0125000
NODE_465_length_3497_cov_65.791348	3062	3142	594	2	80	0.0250000
NODE_465_length_3497_cov_65.791348	3062	3142	595	1	80	0.0125000
NODE_465_length_3497_cov_65.791348	3062	3142	597	2	80	0.0250000
NODE_465_length_3497_cov_65.791348	3062	3142	598	1	80	0.0125000
NODE_465_length_3497_cov_65.791348	3062	3142	599	2	80	0.0250000
NODE_465_length_3497_cov_65.791348	3062	3142	600	1	80	0.0125000
NODE_465_length_3497_cov_65.791348	3062	3142	601	1	80	0.0125000
NODE_465_length_3497_cov_65.791348	3062	3142	602	1	80	0.0125000
NODE_465_length_3497_cov_65.791348	3062	3142	605	1	80	0.0125000
NODE_465_length_3497_cov_65.791348	3062	3142	607	1	80	0.0125000
NODE_465_length_3497_cov_65.791348	3062	3142	608	2	80	0.0250000
NODE_465_length_3497_cov_65.791348	3062	3142	610	1	80	0.0125000
NODE_465_length_3497_cov_65.791348	3062	3142	611	1	80	0.0125000
NODE_465_length_3497_cov_65.791348	3062	3142	612	1	80	0.0125000
NODE_465_length_3497_cov_65.791348	3062	3142	614	2	80	0.0250000
NODE_465_length_3497_cov_65.791348	3062	3142	618	1	80	0.0125000
NODE_465_length_3497_cov_65.791348	3062	3142	619	1	80	0.0125000
NODE_465_length_3497_cov_65.791348	3062	3142	621	1	80	0.0125000
NODE_466_length_3488_cov_2.243730	506	529	2	9	23	0.3913043
NODE_466_length_3488_cov_2.243730	506	529	4	14	23	0.6086956
NODE_470_length_3483_cov_14.759456	360	440	0	51	80	0.6375000
NODE_470_length_3483_cov_14.759456	360	440	4	29	80	0.3625000
NODE_470_length_3483_cov_14.759456	413	493	4	80	80	1.0000000
NODE_474_length_3471_cov_37.887604	2795	2875	2	47	80	0.5875000
NODE_474_length_3471_cov_37.887604	2795	2875	4	33	80	0.4125000
NODE_474_length_3471_cov_37.887604	2848	2928	0	18	80	0.2250000
NODE_474_length_3471_cov_37.887604	2848	2928	2	62	80	0.7750000
NODE_474_length_3471_cov_37.887604	2924	2943	0	19	19	1.0000000
NODE_474_length_3471_cov_37.887604	2924	3004	0	80	80	1.0000000
NODE_474_length_3471_cov_37.887604	2977	3057	0	80	80	1.0000000
NODE_479_length_3451_cov_29.833234	2973	3053	4	62	80	0.7750000
NODE_479_length_3451_cov_29.833234	2973	3053	6	18	80	0.2250000
NODE_479_length_3451_cov_29.833234	3026	3106	4	34	80	0.4250000
NODE_479_length_3451_cov_29.833234	3026	3106	5	5	80	0.0625000
NODE_479_length_3451_cov_29.833234	3026	3106	6	41	80	0.5125000
NODE_481_length_3446_cov_32.421273	3181	3261	30	1	80	0.0125000
NODE_481_length_3446_cov_32.421273	3181	3261	32	1	80	0.0125000
NODE_481_length_3446_cov_32.421273	3181	3261	34	16	80	0.2000000
NODE_481_length_3446_cov_32.421273	3181	3261	36	2	80	0.0250000
NODE_481_length_3446_cov_32.421273	3181	3261	38	8	80	0.1000000
NODE_481_length_3446_cov_32.421273	3181	3261	40	5	80	0.0625000
NODE_481_length_3446_cov_32.421273	3181	3261	42	8	80	0.1000000
NODE_481_length_3446_cov_32.421273	3181	3261	44	31	80	0.3875000
NODE_481_length_3446_cov_32.421273	3181	3261	46	8	80	0.1000000
NODE_482_length_3444_cov_29.954858	792	872	16	10	80	0.1250000
NODE_482_length_3444_cov_29.954858	792	872	18	3	80	0.0375000
NODE_482_length_3444_cov_29.954858	792	872	20	30	80	0.3750000
NODE_482_length_3444_cov_29.954858	792	872	21	1	80	0.0125000
NODE_482_length_3444_cov_29.954858	792	872	22	14	80	0.1750000
NODE_482_length_3444_cov_29.954858	792	872	24	11	80	0.1375000
NODE_482_length_3444_cov_29.954858	792	872	26	11	80	0.1375000
NODE_482_length_3444_cov_29.954858	845	925	8	6	80	0.0750000
NODE_482_length_3444_cov_29.954858	845	925	10	4	80	0.0500000
NODE_482_length_3444_cov_29.954858	845	925	12	8	80	0.1000000
NODE_482_length_3444_cov_29.954858	845	925	14	11	80	0.1375000
NODE_482_length_3444_cov_29.954858	845	925	16	2	80	0.0250000
NODE_482_length_3444_cov_29.954858	845	925	18	2	80	0.0250000
NODE_482_length_3444_cov_29.954858	845	925	20	13	80	0.1625000
NODE_482_length_3444_cov_29.954858	845	925	22	9	80	0.1125000
NODE_482_length_3444_cov_29.954858	845	925	24	14	80	0.1750000
NODE_482_length_3444_cov_29.954858	845	925	26	11	80	0.1375000
NODE_483_length_3442_cov_17.799880	3155	3220	0	1	65	0.0153846
NODE_483_length_3442_cov_17.799880	3155	3220	2	5	65	0.0769231
NODE_483_length_3442_cov_17.799880	3155	3220	4	3	65	0.0461538
NODE_483_length_3442_cov_17.799880	3155	3220	6	6	65	0.0923077
NODE_483_length_3442_cov_17.799880	3155	3220	12	5	65	0.0769231
NODE_483_length_3442_cov_17.799880	3155	3220	14	2	65	0.0307692
NODE_483_length_3442_cov_17.799880	3155	3220	16	1	65	0.0153846
NODE_483_length_3442_cov_17.799880	3155	3220	18	2	65	0.0307692
NODE_483_length_3442_cov_17.799880	3155	3220	20	3	65	0.0461538
NODE_483_length_3442_cov_17.799880	3155	3220	22	2	65	0.0307692
NODE_483_length_3442_cov_17.799880	3155	3220	25	1	65	0.0153846
NODE_483_length_3442_cov_17.799880	3155	3220	27	2	65	0.0307692
NODE_483_length_3442_cov_17.799880	3155	3220	29	9	65	0.1384615
NODE_483_length_3442_cov_17.799880	3155	3220	30	1	65	0.0153846
NODE_483_length_3442_cov_17.799880	3155	3220	31	6	65	0.0923077
NODE_483_length_3442_cov_17.799880	3155	3220	33	4	65	0.0615385
NODE_483_length_3442_cov_17.799880	3155	3220	34	1	65	0.0153846
NODE_483_length_3442_cov_17.799880	3155	3220	37	7	65	0.1076923
NODE_483_length_3442_cov_17.799880	3155	3220	40	1	65	0.0153846
NODE_483_length_3442_cov_17.799880	3155	3220	44	1	65	0.0153846
NODE_483_length_3442_cov_17.799880	3155	3220	46	2	65	0.0307692
NODE_483_length_3442_cov_17.799880	3208	3273	34	1	65	0.0153846
NODE_483_length_3442_cov_17.799880	3208	3273	37	7	65	0.1076923
NODE_483_length_3442_cov_17.799880	3208	3273	40	1	65	0.0153846
NODE_483_length_3442_cov_17.799880	3208	3273	44	1	65	0.0153846
NODE_483_length_3442_cov_17.799880	3208	3273	46	7	65	0.1076923
NODE_483_length_3442_cov_17.799880	3208	3273	48	2	65	0.0307692
NODE_483_length_3442_cov_17.799880	3208	3273	50	1	65	0.0153846
NODE_483_length_3442_cov_17.799880	3208	3273	52	1	65	0.0153846
NODE_483_length_3442_cov_17.799880	3208	3273	54	2	65	0.0307692
NODE_483_length_3442_cov_17.799880	3208	3273	57	2	65	0.0307692
NODE_483_length_3442_cov_17.799880	3208	3273	59	1	65	0.0153846
NODE_483_length_3442_cov_17.799880	3208	3273	61	1	65	0.0153846
NODE_483_length_3442_cov_17.799880	3208	3273	63	1	65	0.0153846
NODE_483_length_3442_cov_17.799880	3208	3273	64	1	65	0.0153846
NODE_483_length_3442_cov_17.799880	3208	3273	66	1	65	0.0153846
NODE_483_length_3442_cov_17.799880	3208	3273	68	4	65	0.0615385
NODE_483_length_3442_cov_17.799880	3208	3273	69	4	65	0.0615385
NODE_483_length_3442_cov_17.799880	3208	3273	71	3	65	0.0461538
NODE_483_length_3442_cov_17.799880	3208	3273	76	1	65	0.0153846
NODE_483_length_3442_cov_17.799880	3208	3273	81	2	65	0.0307692
NODE_483_length_3442_cov_17.799880	3208	3273	83	3	65	0.0461538
NODE_483_length_3442_cov_17.799880	3208	3273	87	1	65	0.0153846
NODE_483_length_3442_cov_17.799880	3208	3273	94	1	65	0.0153846
NODE_483_length_3442_cov_17.799880	3208	3273	98	1	65	0.0153846
NODE_483_length_3442_cov_17.799880	3208	3273	100	3	65	0.0461538
NODE_483_length_3442_cov_17.799880	3208	3273	107	1	65	0.0153846
NODE_483_length_3442_cov_17.799880	3208	3273	109	1	65	0.0153846
NODE_483_length_3442_cov_17.799880	3208	3273	113	3	65	0.0461538
NODE_483_length_3442_cov_17.799880	3208	3273	117	1	65	0.0153846
NODE_483_length_3442_cov_17.799880	3208	3273	118	1	65	0.0153846
NODE_483_length_3442_cov_17.799880	3208	3273	120	1	65	0.0153846
NODE_483_length_3442_cov_17.799880	3208	3273	125	2	65	0.0307692
NODE_483_length_3442_cov_17.799880	3208	3273	129	1	65	0.0153846
NODE_483_length_3442_cov_17.799880	3208	3273	130	1	65	0.0153846
NODE_486_length_3429_cov_5.070270	125	148	44	5	23	0.2173913
NODE_486_length_3429_cov_5.070270	125	148	46	7	23	0.3043478
NODE_486_length_3429_cov_5.070270	125	148	47	7	23	0.3043478
NODE_486_length_3429_cov_5.070270	125	148	48	4	23	0.1739130
NODE_493_length_3408_cov_2.406769	0	45	0	45	45	1.0000000
NODE_495_length_3405_cov_44.930127	2683	2759	20	5	76	0.0657895
NODE_495_length_3405_cov_44.930127	2683	2759	24	9	76	0.1184211
NODE_495_length_3405_cov_44.930127	2683	2759	28	1	76	0.0131579
NODE_495_length_3405_cov_44.930127	2683	2759	31	19	76	0.2500000
NODE_495_length_3405_cov_44.930127	2683	2759	32	37	76	0.4868421
NODE_495_length_3405_cov_44.930127	2683	2759	33	5	76	0.0657895
NODE_495_length_3405_cov_44.930127	3116	3164	9	22	48	0.4583333
NODE_495_length_3405_cov_44.930127	3116	3164	11	26	48	0.5416667
NODE_496_length_3402_cov_28.961550	128	183	0	4	55	0.0727273
NODE_496_length_3402_cov_28.961550	128	183	2	10	55	0.1818182
NODE_496_length_3402_cov_28.961550	128	183	4	41	55	0.7454545
NODE_496_length_3402_cov_28.961550	3154	3234	30	1	80	0.0125000
NODE_496_length_3402_cov_28.961550	3154	3234	32	4	80	0.0500000
NODE_496_length_3402_cov_28.961550	3154	3234	34	2	80	0.0250000
NODE_496_length_3402_cov_28.961550	3154	3234	40	2	80	0.0250000
NODE_496_length_3402_cov_28.961550	3154	3234	42	1	80	0.0125000
NODE_496_length_3402_cov_28.961550	3154	3234	44	10	80	0.1250000
NODE_496_length_3402_cov_28.961550	3154	3234	46	10	80	0.1250000
NODE_496_length_3402_cov_28.961550	3154	3234	48	17	80	0.2125000
NODE_496_length_3402_cov_28.961550	3154	3234	50	22	80	0.2750000
NODE_496_length_3402_cov_28.961550	3154	3234	52	1	80	0.0125000
NODE_496_length_3402_cov_28.961550	3154	3234	54	9	80	0.1125000
NODE_496_length_3402_cov_28.961550	3154	3234	58	1	80	0.0125000
NODE_496_length_3402_cov_28.961550	3207	3287	0	1	80	0.0125000
NODE_496_length_3402_cov_28.961550	3207	3287	2	1	80	0.0125000
NODE_496_length_3402_cov_28.961550	3207	3287	6	11	80	0.1375000
NODE_496_length_3402_cov_28.961550	3207	3287	8	1	80	0.0125000
NODE_496_length_3402_cov_28.961550	3207	3287	9	5	80	0.0625000
NODE_496_length_3402_cov_28.961550	3207	3287	11	7	80	0.0875000
NODE_496_length_3402_cov_28.961550	3207	3287	15	1	80	0.0125000
NODE_496_length_3402_cov_28.961550	3207	3287	17	2	80	0.0250000
NODE_496_length_3402_cov_28.961550	3207	3287	19	4	80	0.0500000
NODE_496_length_3402_cov_28.961550	3207	3287	22	3	80	0.0375000
NODE_496_length_3402_cov_28.961550	3207	3287	24	9	80	0.1125000
NODE_496_length_3402_cov_28.961550	3207	3287	27	1	80	0.0125000
NODE_496_length_3402_cov_28.961550	3207	3287	28	5	80	0.0625000
NODE_496_length_3402_cov_28.961550	3207	3287	30	3	80	0.0375000
NODE_496_length_3402_cov_28.961550	3207	3287	32	4	80	0.0500000
NODE_496_length_3402_cov_28.961550	3207	3287	34	2	80	0.0250000
NODE_496_length_3402_cov_28.961550	3207	3287	40	2	80	0.0250000
NODE_496_length_3402_cov_28.961550	3207	3287	42	1	80	0.0125000
NODE_496_length_3402_cov_28.961550	3207	3287	44	10	80	0.1250000
NODE_496_length_3402_cov_28.961550	3207	3287	48	7	80	0.0875000
NODE_498_length_3393_cov_43.623558	1009	1075	8	1	66	0.0151515
NODE_498_length_3393_cov_43.623558	1009	1075	10	1	66	0.0151515
NODE_498_length_3393_cov_43.623558	1009	1075	12	1	66	0.0151515
NODE_498_length_3393_cov_43.623558	1009	1075	18	1	66	0.0151515
NODE_498_length_3393_cov_43.623558	1009	1075	20	1	66	0.0151515
NODE_498_length_3393_cov_43.623558	1009	1075	22	1	66	0.0151515
NODE_498_length_3393_cov_43.623558	1009	1075	24	2	66	0.0303030
NODE_498_length_3393_cov_43.623558	1009	1075	26	2	66	0.0303030
NODE_498_length_3393_cov_43.623558	1009	1075	28	1	66	0.0151515
NODE_498_length_3393_cov_43.623558	1009	1075	30	1	66	0.0151515
NODE_498_length_3393_cov_43.623558	1009	1075	32	1	66	0.0151515
NODE_498_length_3393_cov_43.623558	1009	1075	36	5	66	0.0757576
NODE_498_length_3393_cov_43.623558	1009	1075	38	1	66	0.0151515
NODE_498_length_3393_cov_43.623558	1009	1075	40	5	66	0.0757576
NODE_498_length_3393_cov_43.623558	1009	1075	48	1	66	0.0151515
NODE_498_length_3393_cov_43.623558	1009	1075	49	1	66	0.0151515
NODE_498_length_3393_cov_43.623558	1009	1075	51	1	66	0.0151515
NODE_498_length_3393_cov_43.623558	1009	1075	53	4	66	0.0606061
NODE_498_length_3393_cov_43.623558	1009	1075	57	1	66	0.0151515
NODE_498_length_3393_cov_43.623558	1009	1075	63	1	66	0.0151515
NODE_498_length_3393_cov_43.623558	1009	1075	71	4	66	0.0606061
NODE_498_length_3393_cov_43.623558	1009	1075	73	2	66	0.0303030
NODE_498_length_3393_cov_43.623558	1009	1075	77	3	66	0.0454545
NODE_498_length_3393_cov_43.623558	1009	1075	81	2	66	0.0303030
NODE_498_length_3393_cov_43.623558	1009	1075	83	5	66	0.0757576
NODE_498_length_3393_cov_43.623558	1009	1075	84	4	66	0.0606061
NODE_498_length_3393_cov_43.623558	1009	1075	86	5	66	0.0757576
NODE_498_length_3393_cov_43.623558	1009	1075	90	2	66	0.0303030
NODE_498_length_3393_cov_43.623558	1009	1075	92	6	66	0.0909091
NODE_498_length_3393_cov_43.623558	1048	1128	2	1	80	0.0125000
NODE_498_length_3393_cov_43.623558	1048	1128	3	11	80	0.1375000
NODE_498_length_3393_cov_43.623558	1048	1128	5	20	80	0.2500000
NODE_498_length_3393_cov_43.623558	1048	1128	6	18	80	0.2250000
NODE_498_length_3393_cov_43.623558	1048	1128	8	4	80	0.0500000
NODE_498_length_3393_cov_43.623558	1048	1128	10	1	80	0.0125000
NODE_498_length_3393_cov_43.623558	1048	1128	12	1	80	0.0125000
NODE_498_length_3393_cov_43.623558	1048	1128	18	1	80	0.0125000
NODE_498_length_3393_cov_43.623558	1048	1128	20	1	80	0.0125000
NODE_498_length_3393_cov_43.623558	1048	1128	22	1	80	0.0125000
NODE_498_length_3393_cov_43.623558	1048	1128	24	2	80	0.0250000
NODE_498_length_3393_cov_43.623558	1048	1128	26	2	80	0.0250000
NODE_498_length_3393_cov_43.623558	1048	1128	28	1	80	0.0125000
NODE_498_length_3393_cov_43.623558	1048	1128	30	1	80	0.0125000
NODE_498_length_3393_cov_43.623558	1048	1128	32	1	80	0.0125000
NODE_498_length_3393_cov_43.623558	1048	1128	36	5	80	0.0625000
NODE_498_length_3393_cov_43.623558	1048	1128	38	1	80	0.0125000
NODE_498_length_3393_cov_43.623558	1048	1128	40	5	80	0.0625000
NODE_498_length_3393_cov_43.623558	1048	1128	48	1	80	0.0125000
NODE_498_length_3393_cov_43.623558	1048	1128	49	1	80	0.0125000
NODE_498_length_3393_cov_43.623558	1048	1128	51	1	80	0.0125000
NODE_498_length_3393_cov_43.623558	3086	3128	16	1	42	0.0238095
NODE_498_length_3393_cov_43.623558	3086	3128	52	1	42	0.0238095
NODE_498_length_3393_cov_43.623558	3086	3128	55	1	42	0.0238095
NODE_498_length_3393_cov_43.623558	3086	3128	92	1	42	0.0238095
NODE_498_length_3393_cov_43.623558	3086	3128	108	1	42	0.0238095
NODE_498_length_3393_cov_43.623558	3086	3128	120	1	42	0.0238095
NODE_498_length_3393_cov_43.623558	3086	3128	126	1	42	0.0238095
NODE_498_length_3393_cov_43.623558	3086	3128	137	1	42	0.0238095
NODE_498_length_3393_cov_43.623558	3086	3128	149	1	42	0.0238095
NODE_498_length_3393_cov_43.623558	3086	3128	154	1	42	0.0238095
NODE_498_length_3393_cov_43.623558	3086	3128	156	1	42	0.0238095
NODE_498_length_3393_cov_43.623558	3086	3128	168	3	42	0.0714286
NODE_498_length_3393_cov_43.623558	3086	3128	170	1	42	0.0238095
NODE_498_length_3393_cov_43.623558	3086	3128	172	1	42	0.0238095
NODE_498_length_3393_cov_43.623558	3086	3128	178	3	42	0.0714286
NODE_498_length_3393_cov_43.623558	3086	3128	180	1	42	0.0238095
NODE_498_length_3393_cov_43.623558	3086	3128	189	1	42	0.0238095
NODE_498_length_3393_cov_43.623558	3086	3128	196	1	42	0.0238095
NODE_498_length_3393_cov_43.623558	3086	3128	199	1	42	0.0238095
NODE_498_length_3393_cov_43.623558	3086	3128	201	1	42	0.0238095
NODE_498_length_3393_cov_43.623558	3086	3128	213	1	42	0.0238095
NODE_498_length_3393_cov_43.623558	3086	3128	220	1	42	0.0238095
NODE_498_length_3393_cov_43.623558	3086	3128	226	1	42	0.0238095
NODE_498_length_3393_cov_43.623558	3086	3128	228	1	42	0.0238095
NODE_498_length_3393_cov_43.623558	3086	3128	230	1	42	0.0238095
NODE_498_length_3393_cov_43.623558	3086	3128	231	1	42	0.0238095
NODE_498_length_3393_cov_43.623558	3086	3128	235	1	42	0.0238095
NODE_498_length_3393_cov_43.623558	3086	3128	237	1	42	0.0238095
NODE_498_length_3393_cov_43.623558	3086	3128	241	1	42	0.0238095
NODE_498_length_3393_cov_43.623558	3086	3128	247	2	42	0.0476190
NODE_498_length_3393_cov_43.623558	3086	3128	249	1	42	0.0238095
NODE_498_length_3393_cov_43.623558	3086	3128	254	1	42	0.0238095
NODE_498_length_3393_cov_43.623558	3086	3128	263	1	42	0.0238095
NODE_498_length_3393_cov_43.623558	3086	3128	268	3	42	0.0714286
NODE_498_length_3393_cov_43.623558	3086	3128	274	1	42	0.0238095
NODE_498_length_3393_cov_43.623558	3293	3373	91	1	80	0.0125000
NODE_498_length_3393_cov_43.623558	3293	3373	93	1	80	0.0125000
NODE_498_length_3393_cov_43.623558	3293	3373	95	1	80	0.0125000
NODE_498_length_3393_cov_43.623558	3293	3373	97	1	80	0.0125000
NODE_498_length_3393_cov_43.623558	3293	3373	104	1	80	0.0125000
NODE_498_length_3393_cov_43.623558	3293	3373	108	3	80	0.0375000
NODE_498_length_3393_cov_43.623558	3293	3373	110	1	80	0.0125000
NODE_498_length_3393_cov_43.623558	3293	3373	114	1	80	0.0125000
NODE_498_length_3393_cov_43.623558	3293	3373	134	1	80	0.0125000
NODE_498_length_3393_cov_43.623558	3293	3373	136	1	80	0.0125000
NODE_498_length_3393_cov_43.623558	3293	3373	153	1	80	0.0125000
NODE_498_length_3393_cov_43.623558	3293	3373	157	1	80	0.0125000
NODE_498_length_3393_cov_43.623558	3293	3373	180	1	80	0.0125000
NODE_498_length_3393_cov_43.623558	3293	3373	187	1	80	0.0125000
NODE_498_length_3393_cov_43.623558	3293	3373	201	1	80	0.0125000
NODE_498_length_3393_cov_43.623558	3293	3373	218	1	80	0.0125000
NODE_498_length_3393_cov_43.623558	3293	3373	233	1	80	0.0125000
NODE_498_length_3393_cov_43.623558	3293	3373	235	1	80	0.0125000
NODE_498_length_3393_cov_43.623558	3293	3373	252	1	80	0.0125000
NODE_498_length_3393_cov_43.623558	3293	3373	278	1	80	0.0125000
NODE_498_length_3393_cov_43.623558	3293	3373	285	2	80	0.0250000
NODE_498_length_3393_cov_43.623558	3293	3373	293	1	80	0.0125000
NODE_498_length_3393_cov_43.623558	3293	3373	308	1	80	0.0125000
NODE_498_length_3393_cov_43.623558	3293	3373	311	1	80	0.0125000
NODE_498_length_3393_cov_43.623558	3293	3373	315	1	80	0.0125000
NODE_498_length_3393_cov_43.623558	3293	3373	318	1	80	0.0125000
NODE_498_length_3393_cov_43.623558	3293	3373	321	2	80	0.0250000
NODE_498_length_3393_cov_43.623558	3293	3373	323	1	80	0.0125000
NODE_498_length_3393_cov_43.623558	3293	3373	329	1	80	0.0125000
NODE_498_length_3393_cov_43.623558	3293	3373	332	1	80	0.0125000
NODE_498_length_3393_cov_43.623558	3293	3373	340	1	80	0.0125000
NODE_498_length_3393_cov_43.623558	3293	3373	355	1	80	0.0125000
NODE_498_length_3393_cov_43.623558	3293	3373	360	2	80	0.0250000
NODE_498_length_3393_cov_43.623558	3293	3373	366	2	80	0.0250000
NODE_498_length_3393_cov_43.623558	3293	3373	369	1	80	0.0125000
NODE_498_length_3393_cov_43.623558	3293	3373	373	1	80	0.0125000
NODE_498_length_3393_cov_43.623558	3293	3373	375	1	80	0.0125000
NODE_498_length_3393_cov_43.623558	3293	3373	377	3	80	0.0375000
NODE_498_length_3393_cov_43.623558	3293	3373	383	1	80	0.0125000
NODE_498_length_3393_cov_43.623558	3293	3373	385	1	80	0.0125000
NODE_498_length_3393_cov_43.623558	3293	3373	387	1	80	0.0125000
NODE_498_length_3393_cov_43.623558	3293	3373	389	2	80	0.0250000
NODE_498_length_3393_cov_43.623558	3293	3373	390	1	80	0.0125000
NODE_498_length_3393_cov_43.623558	3293	3373	397	1	80	0.0125000
NODE_498_length_3393_cov_43.623558	3293	3373	401	1	80	0.0125000
NODE_498_length_3393_cov_43.623558	3293	3373	404	1	80	0.0125000
NODE_498_length_3393_cov_43.623558	3293	3373	410	1	80	0.0125000
NODE_498_length_3393_cov_43.623558	3293	3373	419	1	80	0.0125000
NODE_498_length_3393_cov_43.623558	3293	3373	423	1	80	0.0125000
NODE_498_length_3393_cov_43.623558	3293	3373	436	1	80	0.0125000
NODE_498_length_3393_cov_43.623558	3293	3373	440	1	80	0.0125000
NODE_498_length_3393_cov_43.623558	3293	3373	446	1	80	0.0125000
NODE_498_length_3393_cov_43.623558	3293	3373	449	1	80	0.0125000
NODE_498_length_3393_cov_43.623558	3293	3373	459	1	80	0.0125000
NODE_498_length_3393_cov_43.623558	3293	3373	467	3	80	0.0375000
NODE_498_length_3393_cov_43.623558	3293	3373	471	2	80	0.0250000
NODE_498_length_3393_cov_43.623558	3293	3373	476	1	80	0.0125000
NODE_498_length_3393_cov_43.623558	3293	3373	487	2	80	0.0250000
NODE_498_length_3393_cov_43.623558	3293	3373	495	1	80	0.0125000
NODE_498_length_3393_cov_43.623558	3293	3373	501	1	80	0.0125000
NODE_498_length_3393_cov_43.623558	3293	3373	505	1	80	0.0125000
NODE_498_length_3393_cov_43.623558	3293	3373	510	1	80	0.0125000
NODE_498_length_3393_cov_43.623558	3293	3373	512	1	80	0.0125000
NODE_498_length_3393_cov_43.623558	3293	3373	514	1	80	0.0125000
NODE_498_length_3393_cov_43.623558	3293	3373	515	1	80	0.0125000
NODE_498_length_3393_cov_43.623558	3293	3373	528	1	80	0.0125000
NODE_498_length_3393_cov_43.623558	3293	3373	532	1	80	0.0125000
NODE_499_length_3392_cov_41.514728	255	335	0	32	80	0.4000000
NODE_499_length_3392_cov_41.514728	255	335	2	48	80	0.6000000
NODE_499_length_3392_cov_41.514728	308	388	0	80	80	1.0000000
NODE_499_length_3392_cov_41.514728	917	997	158	1	80	0.0125000
NODE_499_length_3392_cov_41.514728	917	997	161	1	80	0.0125000
NODE_499_length_3392_cov_41.514728	917	997	163	1	80	0.0125000
NODE_499_length_3392_cov_41.514728	917	997	164	1	80	0.0125000
NODE_499_length_3392_cov_41.514728	917	997	165	1	80	0.0125000
NODE_499_length_3392_cov_41.514728	917	997	174	1	80	0.0125000
NODE_499_length_3392_cov_41.514728	917	997	182	1	80	0.0125000
NODE_499_length_3392_cov_41.514728	917	997	188	2	80	0.0250000
NODE_499_length_3392_cov_41.514728	917	997	194	1	80	0.0125000
NODE_499_length_3392_cov_41.514728	917	997	196	1	80	0.0125000
NODE_499_length_3392_cov_41.514728	917	997	203	1	80	0.0125000
NODE_499_length_3392_cov_41.514728	917	997	216	1	80	0.0125000
NODE_499_length_3392_cov_41.514728	917	997	218	1	80	0.0125000
NODE_499_length_3392_cov_41.514728	917	997	220	1	80	0.0125000
NODE_499_length_3392_cov_41.514728	917	997	230	1	80	0.0125000
NODE_499_length_3392_cov_41.514728	917	997	239	1	80	0.0125000
NODE_499_length_3392_cov_41.514728	917	997	252	1	80	0.0125000
NODE_499_length_3392_cov_41.514728	917	997	268	1	80	0.0125000
NODE_499_length_3392_cov_41.514728	917	997	279	1	80	0.0125000
NODE_499_length_3392_cov_41.514728	917	997	297	1	80	0.0125000
NODE_499_length_3392_cov_41.514728	917	997	303	1	80	0.0125000
NODE_499_length_3392_cov_41.514728	917	997	304	2	80	0.0250000
NODE_499_length_3392_cov_41.514728	917	997	314	1	80	0.0125000
NODE_499_length_3392_cov_41.514728	917	997	320	1	80	0.0125000
NODE_499_length_3392_cov_41.514728	917	997	324	1	80	0.0125000
NODE_499_length_3392_cov_41.514728	917	997	328	1	80	0.0125000
NODE_499_length_3392_cov_41.514728	917	997	329	1	80	0.0125000
NODE_499_length_3392_cov_41.514728	917	997	334	1	80	0.0125000
NODE_499_length_3392_cov_41.514728	917	997	348	1	80	0.0125000
NODE_499_length_3392_cov_41.514728	917	997	350	1	80	0.0125000
NODE_499_length_3392_cov_41.514728	917	997	357	1	80	0.0125000
NODE_499_length_3392_cov_41.514728	917	997	366	1	80	0.0125000
NODE_499_length_3392_cov_41.514728	917	997	382	1	80	0.0125000
NODE_499_length_3392_cov_41.514728	917	997	396	1	80	0.0125000
NODE_499_length_3392_cov_41.514728	917	997	412	1	80	0.0125000
NODE_499_length_3392_cov_41.514728	917	997	413	2	80	0.0250000
NODE_499_length_3392_cov_41.514728	917	997	435	1	80	0.0125000
NODE_499_length_3392_cov_41.514728	917	997	444	1	80	0.0125000
NODE_499_length_3392_cov_41.514728	917	997	452	2	80	0.0250000
NODE_499_length_3392_cov_41.514728	917	997	454	1	80	0.0125000
NODE_499_length_3392_cov_41.514728	917	997	456	1	80	0.0125000
NODE_499_length_3392_cov_41.514728	917	997	472	1	80	0.0125000
NODE_499_length_3392_cov_41.514728	917	997	480	1	80	0.0125000
NODE_499_length_3392_cov_41.514728	917	997	483	1	80	0.0125000
NODE_499_length_3392_cov_41.514728	917	997	489	1	80	0.0125000
NODE_499_length_3392_cov_41.514728	917	997	504	1	80	0.0125000
NODE_499_length_3392_cov_41.514728	917	997	529	1	80	0.0125000
NODE_499_length_3392_cov_41.514728	917	997	544	1	80	0.0125000
NODE_499_length_3392_cov_41.514728	917	997	552	1	80	0.0125000
NODE_499_length_3392_cov_41.514728	917	997	553	1	80	0.0125000
NODE_499_length_3392_cov_41.514728	917	997	557	1	80	0.0125000
NODE_499_length_3392_cov_41.514728	917	997	575	1	80	0.0125000
NODE_499_length_3392_cov_41.514728	917	997	577	1	80	0.0125000
NODE_499_length_3392_cov_41.514728	917	997	587	1	80	0.0125000
NODE_499_length_3392_cov_41.514728	917	997	594	1	80	0.0125000
NODE_499_length_3392_cov_41.514728	917	997	604	1	80	0.0125000
NODE_499_length_3392_cov_41.514728	917	997	612	1	80	0.0125000
NODE_499_length_3392_cov_41.514728	917	997	625	1	80	0.0125000
NODE_499_length_3392_cov_41.514728	917	997	631	1	80	0.0125000
NODE_499_length_3392_cov_41.514728	917	997	654	1	80	0.0125000
NODE_499_length_3392_cov_41.514728	917	997	664	2	80	0.0250000
NODE_499_length_3392_cov_41.514728	917	997	680	1	80	0.0125000
NODE_499_length_3392_cov_41.514728	917	997	684	1	80	0.0125000
NODE_499_length_3392_cov_41.514728	917	997	699	1	80	0.0125000
NODE_499_length_3392_cov_41.514728	917	997	703	1	80	0.0125000
NODE_499_length_3392_cov_41.514728	917	997	709	1	80	0.0125000
NODE_499_length_3392_cov_41.514728	917	997	713	2	80	0.0250000
NODE_499_length_3392_cov_41.514728	917	997	715	1	80	0.0125000
NODE_499_length_3392_cov_41.514728	917	997	732	1	80	0.0125000
NODE_499_length_3392_cov_41.514728	917	997	736	1	80	0.0125000
NODE_499_length_3392_cov_41.514728	917	997	738	3	80	0.0375000
NODE_499_length_3392_cov_41.514728	917	997	740	1	80	0.0125000
NODE_499_length_3392_cov_41.514728	970	1053	91	1	83	0.0120482
NODE_499_length_3392_cov_41.514728	970	1053	93	3	83	0.0361446
NODE_499_length_3392_cov_41.514728	970	1053	95	1	83	0.0120482
NODE_499_length_3392_cov_41.514728	970	1053	97	2	83	0.0240964
NODE_499_length_3392_cov_41.514728	970	1053	98	1	83	0.0120482
NODE_499_length_3392_cov_41.514728	970	1053	99	2	83	0.0240964
NODE_499_length_3392_cov_41.514728	970	1053	100	2	83	0.0240964
NODE_499_length_3392_cov_41.514728	970	1053	101	5	83	0.0602410
NODE_499_length_3392_cov_41.514728	970	1053	102	2	83	0.0240964
NODE_499_length_3392_cov_41.514728	970	1053	103	8	83	0.0963855
NODE_499_length_3392_cov_41.514728	970	1053	104	1	83	0.0120482
NODE_499_length_3392_cov_41.514728	970	1053	105	3	83	0.0361446
NODE_499_length_3392_cov_41.514728	970	1053	106	2	83	0.0240964
NODE_499_length_3392_cov_41.514728	970	1053	107	1	83	0.0120482
NODE_499_length_3392_cov_41.514728	970	1053	110	1	83	0.0120482
NODE_499_length_3392_cov_41.514728	970	1053	113	2	83	0.0240964
NODE_499_length_3392_cov_41.514728	970	1053	116	1	83	0.0120482
NODE_499_length_3392_cov_41.514728	970	1053	120	1	83	0.0120482
NODE_499_length_3392_cov_41.514728	970	1053	124	1	83	0.0120482
NODE_499_length_3392_cov_41.514728	970	1053	127	1	83	0.0120482
NODE_499_length_3392_cov_41.514728	970	1053	129	2	83	0.0240964
NODE_499_length_3392_cov_41.514728	970	1053	134	1	83	0.0120482
NODE_499_length_3392_cov_41.514728	970	1053	138	3	83	0.0361446
NODE_499_length_3392_cov_41.514728	970	1053	139	1	83	0.0120482
NODE_499_length_3392_cov_41.514728	970	1053	142	2	83	0.0240964
NODE_499_length_3392_cov_41.514728	970	1053	146	3	83	0.0361446
NODE_499_length_3392_cov_41.514728	970	1053	150	1	83	0.0120482
NODE_499_length_3392_cov_41.514728	970	1053	152	1	83	0.0120482
NODE_499_length_3392_cov_41.514728	970	1053	156	1	83	0.0120482
NODE_499_length_3392_cov_41.514728	970	1053	158	1	83	0.0120482
NODE_499_length_3392_cov_41.514728	970	1053	161	1	83	0.0120482
NODE_499_length_3392_cov_41.514728	970	1053	163	1	83	0.0120482
NODE_499_length_3392_cov_41.514728	970	1053	164	1	83	0.0120482
NODE_499_length_3392_cov_41.514728	970	1053	165	1	83	0.0120482
NODE_499_length_3392_cov_41.514728	970	1053	174	1	83	0.0120482
NODE_499_length_3392_cov_41.514728	970	1053	182	1	83	0.0120482
NODE_499_length_3392_cov_41.514728	970	1053	188	2	83	0.0240964
NODE_499_length_3392_cov_41.514728	970	1053	194	1	83	0.0120482
NODE_499_length_3392_cov_41.514728	970	1053	196	1	83	0.0120482
NODE_499_length_3392_cov_41.514728	970	1053	203	1	83	0.0120482
NODE_499_length_3392_cov_41.514728	970	1053	216	1	83	0.0120482
NODE_499_length_3392_cov_41.514728	970	1053	218	1	83	0.0120482
NODE_499_length_3392_cov_41.514728	970	1053	220	1	83	0.0120482
NODE_499_length_3392_cov_41.514728	970	1053	230	1	83	0.0120482
NODE_499_length_3392_cov_41.514728	970	1053	239	1	83	0.0120482
NODE_499_length_3392_cov_41.514728	970	1053	252	1	83	0.0120482
NODE_499_length_3392_cov_41.514728	970	1053	268	1	83	0.0120482
NODE_499_length_3392_cov_41.514728	970	1053	279	1	83	0.0120482
NODE_499_length_3392_cov_41.514728	970	1053	297	1	83	0.0120482
NODE_499_length_3392_cov_41.514728	970	1053	303	1	83	0.0120482
NODE_499_length_3392_cov_41.514728	970	1053	304	2	83	0.0240964
NODE_499_length_3392_cov_41.514728	970	1053	314	1	83	0.0120482
NODE_499_length_3392_cov_41.514728	970	1053	320	1	83	0.0120482
NODE_499_length_3392_cov_41.514728	970	1053	324	1	83	0.0120482
NODE_501_length_3389_cov_8.244073	2159	2239	0	80	80	1.0000000
NODE_501_length_3389_cov_8.244073	2212	2292	0	80	80	1.0000000
NODE_506_length_3363_cov_4.412684	56	124	16	2	68	0.0294118
NODE_506_length_3363_cov_4.412684	56	124	18	1	68	0.0147059
NODE_506_length_3363_cov_4.412684	56	124	26	1	68	0.0147059
NODE_506_length_3363_cov_4.412684	56	124	32	2	68	0.0294118
NODE_506_length_3363_cov_4.412684	56	124	36	3	68	0.0441176
NODE_506_length_3363_cov_4.412684	56	124	42	1	68	0.0147059
NODE_506_length_3363_cov_4.412684	56	124	44	1	68	0.0147059
NODE_506_length_3363_cov_4.412684	56	124	47	1	68	0.0147059
NODE_506_length_3363_cov_4.412684	56	124	48	1	68	0.0147059
NODE_506_length_3363_cov_4.412684	56	124	52	1	68	0.0147059
NODE_506_length_3363_cov_4.412684	56	124	54	1	68	0.0147059
NODE_506_length_3363_cov_4.412684	56	124	62	6	68	0.0882353
NODE_506_length_3363_cov_4.412684	56	124	64	47	68	0.6911765
NODE_510_length_3353_cov_2.687462	0	61	0	40	61	0.6557377
NODE_510_length_3353_cov_2.687462	0	61	2	21	61	0.3442623
NODE_510_length_3353_cov_2.687462	0	61	0	40	61	0.6557377
NODE_510_length_3353_cov_2.687462	0	61	2	21	61	0.3442623
NODE_510_length_3353_cov_2.687462	34	99	0	6	65	0.0923077
NODE_510_length_3353_cov_2.687462	34	99	2	59	65	0.9076923
NODE_513_length_3348_cov_243.959372	2473	2553	428	1	80	0.0125000
NODE_513_length_3348_cov_243.959372	2473	2553	431	1	80	0.0125000
NODE_513_length_3348_cov_243.959372	2473	2553	432	1	80	0.0125000
NODE_513_length_3348_cov_243.959372	2473	2553	433	1	80	0.0125000
NODE_513_length_3348_cov_243.959372	2473	2553	434	2	80	0.0250000
NODE_513_length_3348_cov_243.959372	2473	2553	436	1	80	0.0125000
NODE_513_length_3348_cov_243.959372	2473	2553	437	2	80	0.0250000
NODE_513_length_3348_cov_243.959372	2473	2553	438	1	80	0.0125000
NODE_513_length_3348_cov_243.959372	2473	2553	445	1	80	0.0125000
NODE_513_length_3348_cov_243.959372	2473	2553	448	1	80	0.0125000
NODE_513_length_3348_cov_243.959372	2473	2553	449	2	80	0.0250000
NODE_513_length_3348_cov_243.959372	2473	2553	450	2	80	0.0250000
NODE_513_length_3348_cov_243.959372	2473	2553	451	1	80	0.0125000
NODE_513_length_3348_cov_243.959372	2473	2553	452	1	80	0.0125000
NODE_513_length_3348_cov_243.959372	2473	2553	455	1	80	0.0125000
NODE_513_length_3348_cov_243.959372	2473	2553	457	1	80	0.0125000
NODE_513_length_3348_cov_243.959372	2473	2553	458	1	80	0.0125000
NODE_513_length_3348_cov_243.959372	2473	2553	459	2	80	0.0250000
NODE_513_length_3348_cov_243.959372	2473	2553	460	2	80	0.0250000
NODE_513_length_3348_cov_243.959372	2473	2553	461	2	80	0.0250000
NODE_513_length_3348_cov_243.959372	2473	2553	462	1	80	0.0125000
NODE_513_length_3348_cov_243.959372	2473	2553	467	1	80	0.0125000
NODE_513_length_3348_cov_243.959372	2473	2553	470	1	80	0.0125000
NODE_513_length_3348_cov_243.959372	2473	2553	480	1	80	0.0125000
NODE_513_length_3348_cov_243.959372	2473	2553	508	1	80	0.0125000
NODE_513_length_3348_cov_243.959372	2473	2553	528	1	80	0.0125000
NODE_513_length_3348_cov_243.959372	2473	2553	534	1	80	0.0125000
NODE_513_length_3348_cov_243.959372	2473	2553	549	1	80	0.0125000
NODE_513_length_3348_cov_243.959372	2473	2553	558	1	80	0.0125000
NODE_513_length_3348_cov_243.959372	2473	2553	566	1	80	0.0125000
NODE_513_length_3348_cov_243.959372	2473	2553	567	1	80	0.0125000
NODE_513_length_3348_cov_243.959372	2473	2553	568	1	80	0.0125000
NODE_513_length_3348_cov_243.959372	2473	2553	572	1	80	0.0125000
NODE_513_length_3348_cov_243.959372	2473	2553	585	1	80	0.0125000
NODE_513_length_3348_cov_243.959372	2473	2553	593	1	80	0.0125000
NODE_513_length_3348_cov_243.959372	2473	2553	599	1	80	0.0125000
NODE_513_length_3348_cov_243.959372	2473	2553	600	2	80	0.0250000
NODE_513_length_3348_cov_243.959372	2473	2553	601	2	80	0.0250000
NODE_513_length_3348_cov_243.959372	2473	2553	603	1	80	0.0125000
NODE_513_length_3348_cov_243.959372	2473	2553	606	1	80	0.0125000
NODE_513_length_3348_cov_243.959372	2473	2553	612	1	80	0.0125000
NODE_513_length_3348_cov_243.959372	2473	2553	634	1	80	0.0125000
NODE_513_length_3348_cov_243.959372	2473	2553	652	1	80	0.0125000
NODE_513_length_3348_cov_243.959372	2473	2553	662	2	80	0.0250000
NODE_513_length_3348_cov_243.959372	2473	2553	663	1	80	0.0125000
NODE_513_length_3348_cov_243.959372	2473	2553	665	1	80	0.0125000
NODE_513_length_3348_cov_243.959372	2473	2553	684	1	80	0.0125000
NODE_513_length_3348_cov_243.959372	2473	2553	690	1	80	0.0125000
NODE_513_length_3348_cov_243.959372	2473	2553	691	1	80	0.0125000
NODE_513_length_3348_cov_243.959372	2473	2553	702	1	80	0.0125000
NODE_513_length_3348_cov_243.959372	2473	2553	732	1	80	0.0125000
NODE_513_length_3348_cov_243.959372	2473	2553	733	1	80	0.0125000
NODE_513_length_3348_cov_243.959372	2473	2553	735	2	80	0.0250000
NODE_513_length_3348_cov_243.959372	2473	2553	747	1	80	0.0125000
NODE_513_length_3348_cov_243.959372	2473	2553	749	1	80	0.0125000
NODE_513_length_3348_cov_243.959372	2473	2553	763	1	80	0.0125000
NODE_513_length_3348_cov_243.959372	2473	2553	785	1	80	0.0125000
NODE_513_length_3348_cov_243.959372	2473	2553	791	2	80	0.0250000
NODE_513_length_3348_cov_243.959372	2473	2553	793	1	80	0.0125000
NODE_513_length_3348_cov_243.959372	2473	2553	794	1	80	0.0125000
NODE_513_length_3348_cov_243.959372	2473	2553	811	1	80	0.0125000
NODE_513_length_3348_cov_243.959372	2473	2553	816	1	80	0.0125000
NODE_513_length_3348_cov_243.959372	2473	2553	852	1	80	0.0125000
NODE_513_length_3348_cov_243.959372	2473	2553	864	1	80	0.0125000
NODE_513_length_3348_cov_243.959372	2473	2553	870	1	80	0.0125000
NODE_513_length_3348_cov_243.959372	2473	2553	887	1	80	0.0125000
NODE_513_length_3348_cov_243.959372	2473	2553	905	1	80	0.0125000
NODE_513_length_3348_cov_243.959372	2473	2553	911	1	80	0.0125000
NODE_513_length_3348_cov_243.959372	2526	2606	428	1	80	0.0125000
NODE_513_length_3348_cov_243.959372	2526	2606	431	1	80	0.0125000
NODE_513_length_3348_cov_243.959372	2526	2606	432	1	80	0.0125000
NODE_513_length_3348_cov_243.959372	2526	2606	433	1	80	0.0125000
NODE_513_length_3348_cov_243.959372	2526	2606	434	2	80	0.0250000
NODE_513_length_3348_cov_243.959372	2526	2606	436	1	80	0.0125000
NODE_513_length_3348_cov_243.959372	2526	2606	437	2	80	0.0250000
NODE_513_length_3348_cov_243.959372	2526	2606	438	1	80	0.0125000
NODE_513_length_3348_cov_243.959372	2526	2606	445	1	80	0.0125000
NODE_513_length_3348_cov_243.959372	2526	2606	448	1	80	0.0125000
NODE_513_length_3348_cov_243.959372	2526	2606	449	2	80	0.0250000
NODE_513_length_3348_cov_243.959372	2526	2606	450	2	80	0.0250000
NODE_513_length_3348_cov_243.959372	2526	2606	451	1	80	0.0125000
NODE_513_length_3348_cov_243.959372	2526	2606	452	1	80	0.0125000
NODE_513_length_3348_cov_243.959372	2526	2606	453	1	80	0.0125000
NODE_513_length_3348_cov_243.959372	2526	2606	455	1	80	0.0125000
NODE_513_length_3348_cov_243.959372	2526	2606	457	1	80	0.0125000
NODE_513_length_3348_cov_243.959372	2526	2606	458	2	80	0.0250000
NODE_513_length_3348_cov_243.959372	2526	2606	459	2	80	0.0250000
NODE_513_length_3348_cov_243.959372	2526	2606	460	2	80	0.0250000
NODE_513_length_3348_cov_243.959372	2526	2606	461	2	80	0.0250000
NODE_513_length_3348_cov_243.959372	2526	2606	464	1	80	0.0125000
NODE_513_length_3348_cov_243.959372	2526	2606	469	1	80	0.0125000
NODE_513_length_3348_cov_243.959372	2526	2606	470	1	80	0.0125000
NODE_513_length_3348_cov_243.959372	2526	2606	471	1	80	0.0125000
NODE_513_length_3348_cov_243.959372	2526	2606	472	2	80	0.0250000
NODE_513_length_3348_cov_243.959372	2526	2606	476	1	80	0.0125000
NODE_513_length_3348_cov_243.959372	2526	2606	480	1	80	0.0125000
NODE_513_length_3348_cov_243.959372	2526	2606	486	1	80	0.0125000
NODE_513_length_3348_cov_243.959372	2526	2606	495	1	80	0.0125000
NODE_513_length_3348_cov_243.959372	2526	2606	505	2	80	0.0250000
NODE_513_length_3348_cov_243.959372	2526	2606	507	1	80	0.0125000
NODE_513_length_3348_cov_243.959372	2526	2606	508	1	80	0.0125000
NODE_513_length_3348_cov_243.959372	2526	2606	513	1	80	0.0125000
NODE_513_length_3348_cov_243.959372	2526	2606	514	2	80	0.0250000
NODE_513_length_3348_cov_243.959372	2526	2606	515	1	80	0.0125000
NODE_513_length_3348_cov_243.959372	2526	2606	516	1	80	0.0125000
NODE_513_length_3348_cov_243.959372	2526	2606	517	1	80	0.0125000
NODE_513_length_3348_cov_243.959372	2526	2606	521	2	80	0.0250000
NODE_513_length_3348_cov_243.959372	2526	2606	522	2	80	0.0250000
NODE_513_length_3348_cov_243.959372	2526	2606	524	3	80	0.0375000
NODE_513_length_3348_cov_243.959372	2526	2606	525	1	80	0.0125000
NODE_513_length_3348_cov_243.959372	2526	2606	526	3	80	0.0375000
NODE_513_length_3348_cov_243.959372	2526	2606	527	4	80	0.0500000
NODE_513_length_3348_cov_243.959372	2526	2606	528	2	80	0.0250000
NODE_513_length_3348_cov_243.959372	2526	2606	529	2	80	0.0250000
NODE_513_length_3348_cov_243.959372	2526	2606	530	2	80	0.0250000
NODE_513_length_3348_cov_243.959372	2526	2606	531	2	80	0.0250000
NODE_513_length_3348_cov_243.959372	2526	2606	532	1	80	0.0125000
NODE_513_length_3348_cov_243.959372	2526	2606	533	1	80	0.0125000
NODE_513_length_3348_cov_243.959372	2526	2606	536	3	80	0.0375000
NODE_513_length_3348_cov_243.959372	2526	2606	537	2	80	0.0250000
NODE_513_length_3348_cov_243.959372	2526	2606	539	1	80	0.0125000
NODE_514_length_3348_cov_31.953216	103	183	2	19	80	0.2375000
NODE_514_length_3348_cov_31.953216	103	183	6	11	80	0.1375000
NODE_514_length_3348_cov_31.953216	103	183	8	19	80	0.2375000
NODE_514_length_3348_cov_31.953216	103	183	10	31	80	0.3875000
NODE_514_length_3348_cov_31.953216	105	179	2	17	74	0.2297297
NODE_514_length_3348_cov_31.953216	105	179	6	11	74	0.1486486
NODE_514_length_3348_cov_31.953216	105	179	8	15	74	0.2027027
NODE_514_length_3348_cov_31.953216	105	179	10	31	74	0.4189189
NODE_514_length_3348_cov_31.953216	156	236	0	17	80	0.2125000
NODE_514_length_3348_cov_31.953216	156	236	4	11	80	0.1375000
NODE_514_length_3348_cov_31.953216	156	236	6	13	80	0.1625000
NODE_514_length_3348_cov_31.953216	156	236	8	29	80	0.3625000
NODE_514_length_3348_cov_31.953216	156	236	10	10	80	0.1250000
NODE_514_length_3348_cov_31.953216	156	236	0	17	80	0.2125000
NODE_514_length_3348_cov_31.953216	156	236	4	11	80	0.1375000
NODE_514_length_3348_cov_31.953216	156	236	6	13	80	0.1625000
NODE_514_length_3348_cov_31.953216	156	236	8	29	80	0.3625000
NODE_514_length_3348_cov_31.953216	156	236	10	10	80	0.1250000
NODE_514_length_3348_cov_31.953216	2405	2476	98	1	71	0.0140845
NODE_514_length_3348_cov_31.953216	2405	2476	99	1	71	0.0140845
NODE_514_length_3348_cov_31.953216	2405	2476	100	2	71	0.0281690
NODE_514_length_3348_cov_31.953216	2405	2476	104	5	71	0.0704225
NODE_514_length_3348_cov_31.953216	2405	2476	108	1	71	0.0140845
NODE_514_length_3348_cov_31.953216	2405	2476	110	1	71	0.0140845
NODE_514_length_3348_cov_31.953216	2405	2476	115	2	71	0.0281690
NODE_514_length_3348_cov_31.953216	2405	2476	116	1	71	0.0140845
NODE_514_length_3348_cov_31.953216	2405	2476	118	1	71	0.0140845
NODE_514_length_3348_cov_31.953216	2405	2476	119	3	71	0.0422535
NODE_514_length_3348_cov_31.953216	2405	2476	121	5	71	0.0704225
NODE_514_length_3348_cov_31.953216	2405	2476	123	3	71	0.0422535
NODE_514_length_3348_cov_31.953216	2405	2476	125	2	71	0.0281690
NODE_514_length_3348_cov_31.953216	2405	2476	126	2	71	0.0281690
NODE_514_length_3348_cov_31.953216	2405	2476	128	2	71	0.0281690
NODE_514_length_3348_cov_31.953216	2405	2476	132	1	71	0.0140845
NODE_514_length_3348_cov_31.953216	2405	2476	134	1	71	0.0140845
NODE_514_length_3348_cov_31.953216	2405	2476	138	2	71	0.0281690
NODE_514_length_3348_cov_31.953216	2405	2476	140	1	71	0.0140845
NODE_514_length_3348_cov_31.953216	2405	2476	144	1	71	0.0140845
NODE_514_length_3348_cov_31.953216	2405	2476	146	2	71	0.0281690
NODE_514_length_3348_cov_31.953216	2405	2476	148	4	71	0.0563380
NODE_514_length_3348_cov_31.953216	2405	2476	149	2	71	0.0281690
NODE_514_length_3348_cov_31.953216	2405	2476	150	1	71	0.0140845
NODE_514_length_3348_cov_31.953216	2405	2476	151	1	71	0.0140845
NODE_514_length_3348_cov_31.953216	2405	2476	153	3	71	0.0422535
NODE_514_length_3348_cov_31.953216	2405	2476	155	1	71	0.0140845
NODE_514_length_3348_cov_31.953216	2405	2476	156	1	71	0.0140845
NODE_514_length_3348_cov_31.953216	2405	2476	158	5	71	0.0704225
NODE_514_length_3348_cov_31.953216	2405	2476	159	1	71	0.0140845
NODE_514_length_3348_cov_31.953216	2405	2476	160	1	71	0.0140845
NODE_514_length_3348_cov_31.953216	2405	2476	162	2	71	0.0281690
NODE_514_length_3348_cov_31.953216	2405	2476	165	1	71	0.0140845
NODE_514_length_3348_cov_31.953216	2405	2476	171	1	71	0.0140845
NODE_514_length_3348_cov_31.953216	2405	2476	181	1	71	0.0140845
NODE_514_length_3348_cov_31.953216	2405	2476	185	2	71	0.0281690
NODE_514_length_3348_cov_31.953216	2405	2476	189	1	71	0.0140845
NODE_514_length_3348_cov_31.953216	2405	2476	193	1	71	0.0140845
NODE_514_length_3348_cov_31.953216	2405	2476	195	1	71	0.0140845
NODE_514_length_3348_cov_31.953216	2405	2476	196	1	71	0.0140845
NODE_514_length_3348_cov_31.953216	2458	2529	156	1	71	0.0140845
NODE_514_length_3348_cov_31.953216	2458	2529	158	5	71	0.0704225
NODE_514_length_3348_cov_31.953216	2458	2529	160	1	71	0.0140845
NODE_514_length_3348_cov_31.953216	2458	2529	162	2	71	0.0281690
NODE_514_length_3348_cov_31.953216	2458	2529	165	1	71	0.0140845
NODE_514_length_3348_cov_31.953216	2458	2529	171	1	71	0.0140845
NODE_514_length_3348_cov_31.953216	2458	2529	181	1	71	0.0140845
NODE_514_length_3348_cov_31.953216	2458	2529	185	2	71	0.0281690
NODE_514_length_3348_cov_31.953216	2458	2529	189	1	71	0.0140845
NODE_514_length_3348_cov_31.953216	2458	2529	193	1	71	0.0140845
NODE_514_length_3348_cov_31.953216	2458	2529	195	1	71	0.0140845
NODE_514_length_3348_cov_31.953216	2458	2529	196	1	71	0.0140845
NODE_514_length_3348_cov_31.953216	2458	2529	199	1	71	0.0140845
NODE_514_length_3348_cov_31.953216	2458	2529	200	3	71	0.0422535
NODE_514_length_3348_cov_31.953216	2458	2529	201	2	71	0.0281690
NODE_514_length_3348_cov_31.953216	2458	2529	202	1	71	0.0140845
NODE_514_length_3348_cov_31.953216	2458	2529	203	1	71	0.0140845
NODE_514_length_3348_cov_31.953216	2458	2529	210	2	71	0.0281690
NODE_514_length_3348_cov_31.953216	2458	2529	212	2	71	0.0281690
NODE_514_length_3348_cov_31.953216	2458	2529	214	3	71	0.0422535
NODE_514_length_3348_cov_31.953216	2458	2529	216	4	71	0.0563380
NODE_514_length_3348_cov_31.953216	2458	2529	217	2	71	0.0281690
NODE_514_length_3348_cov_31.953216	2458	2529	218	4	71	0.0563380
NODE_514_length_3348_cov_31.953216	2458	2529	220	6	71	0.0845070
NODE_514_length_3348_cov_31.953216	2458	2529	222	1	71	0.0140845
NODE_514_length_3348_cov_31.953216	2458	2529	223	1	71	0.0140845
NODE_514_length_3348_cov_31.953216	2458	2529	224	4	71	0.0563380
NODE_514_length_3348_cov_31.953216	2458	2529	225	1	71	0.0140845
NODE_514_length_3348_cov_31.953216	2458	2529	226	3	71	0.0422535
NODE_514_length_3348_cov_31.953216	2458	2529	227	1	71	0.0140845
NODE_514_length_3348_cov_31.953216	2458	2529	228	3	71	0.0422535
NODE_514_length_3348_cov_31.953216	2458	2529	229	2	71	0.0281690
NODE_514_length_3348_cov_31.953216	2458	2529	230	2	71	0.0281690
NODE_514_length_3348_cov_31.953216	2458	2529	231	1	71	0.0140845
NODE_514_length_3348_cov_31.953216	2458	2529	232	3	71	0.0422535
NODE_517_length_3335_cov_19.649567	2100	2180	2	9	80	0.1125000
NODE_517_length_3335_cov_19.649567	2100	2180	4	22	80	0.2750000
NODE_517_length_3335_cov_19.649567	2100	2180	6	33	80	0.4125000
NODE_517_length_3335_cov_19.649567	2100	2180	8	16	80	0.2000000
NODE_517_length_3335_cov_19.649567	2153	2233	2	4	80	0.0500000
NODE_517_length_3335_cov_19.649567	2153	2233	4	31	80	0.3875000
NODE_517_length_3335_cov_19.649567	2153	2233	6	11	80	0.1375000
NODE_517_length_3335_cov_19.649567	2153	2233	8	34	80	0.4250000
NODE_517_length_3335_cov_19.649567	2229	2309	0	20	80	0.2500000
NODE_517_length_3335_cov_19.649567	2229	2309	2	60	80	0.7500000
NODE_517_length_3335_cov_19.649567	2282	2362	0	18	80	0.2250000
NODE_517_length_3335_cov_19.649567	2282	2362	2	62	80	0.7750000
NODE_518_length_3333_cov_24.805504	734	814	0	33	80	0.4125000
NODE_518_length_3333_cov_24.805504	734	814	2	47	80	0.5875000
NODE_518_length_3333_cov_24.805504	787	867	0	80	80	1.0000000
NODE_523_length_3312_cov_6.996576	85	165	2	58	80	0.7250000
NODE_523_length_3312_cov_6.996576	85	165	3	22	80	0.2750000
NODE_523_length_3312_cov_6.996576	138	218	2	8	80	0.1000000
NODE_523_length_3312_cov_6.996576	138	218	3	72	80	0.9000000
NODE_525_length_3302_cov_3.859195	3184	3262	5	18	78	0.2307692
NODE_525_length_3302_cov_3.859195	3184	3262	6	5	78	0.0641026
NODE_525_length_3302_cov_3.859195	3184	3262	7	30	78	0.3846154
NODE_525_length_3302_cov_3.859195	3184	3262	8	5	78	0.0641026
NODE_525_length_3302_cov_3.859195	3184	3262	9	20	78	0.2564103
NODE_525_length_3302_cov_3.859195	3184	3253	5	9	69	0.1304348
NODE_525_length_3302_cov_3.859195	3184	3253	6	5	69	0.0724638
NODE_525_length_3302_cov_3.859195	3184	3253	7	30	69	0.4347826
NODE_525_length_3302_cov_3.859195	3184	3253	8	5	69	0.0724638
NODE_525_length_3302_cov_3.859195	3184	3253	9	20	69	0.2898551
NODE_526_length_3299_cov_6.014687	1632	1688	0	28	56	0.5000000
NODE_526_length_3299_cov_6.014687	1632	1688	2	26	56	0.4642857
NODE_526_length_3299_cov_6.014687	1632	1688	4	2	56	0.0357143
NODE_530_length_3290_cov_17.805390	773	853	6	4	80	0.0500000
NODE_530_length_3290_cov_17.805390	773	853	7	10	80	0.1250000
NODE_530_length_3290_cov_17.805390	773	853	13	1	80	0.0125000
NODE_530_length_3290_cov_17.805390	773	853	14	10	80	0.1250000
NODE_530_length_3290_cov_17.805390	773	853	18	2	80	0.0250000
NODE_530_length_3290_cov_17.805390	773	853	20	42	80	0.5250000
NODE_530_length_3290_cov_17.805390	773	853	22	11	80	0.1375000
NODE_530_length_3290_cov_17.805390	826	906	12	22	80	0.2750000
NODE_530_length_3290_cov_17.805390	826	906	16	3	80	0.0375000
NODE_530_length_3290_cov_17.805390	826	906	18	22	80	0.2750000
NODE_530_length_3290_cov_17.805390	826	906	20	33	80	0.4125000
NODE_531_length_3290_cov_12.352554	2749	2829	2	80	80	1.0000000
NODE_531_length_3290_cov_12.352554	2802	2882	0	49	80	0.6125000
NODE_531_length_3290_cov_12.352554	2802	2882	2	31	80	0.3875000
NODE_532_length_3286_cov_5.973015	0	50	0	2	50	0.0400000
NODE_532_length_3286_cov_5.973015	0	50	2	3	50	0.0600000
NODE_532_length_3286_cov_5.973015	0	50	4	11	50	0.2200000
NODE_532_length_3286_cov_5.973015	0	50	6	34	50	0.6800000
NODE_532_length_3286_cov_5.973015	0	50	0	2	50	0.0400000
NODE_532_length_3286_cov_5.973015	0	50	2	3	50	0.0600000
NODE_532_length_3286_cov_5.973015	0	50	4	11	50	0.2200000
NODE_532_length_3286_cov_5.973015	0	50	6	34	50	0.6800000
NODE_532_length_3286_cov_5.973015	0	50	0	2	50	0.0400000
NODE_532_length_3286_cov_5.973015	0	50	2	3	50	0.0600000
NODE_532_length_3286_cov_5.973015	0	50	4	11	50	0.2200000
NODE_532_length_3286_cov_5.973015	0	50	6	34	50	0.6800000
NODE_532_length_3286_cov_5.973015	23	89	6	66	66	1.0000000
NODE_532_length_3286_cov_5.973015	23	94	6	71	71	1.0000000
NODE_533_length_3284_cov_6.453689	313	392	3	8	79	0.1012658
NODE_533_length_3284_cov_6.453689	313	392	4	20	79	0.2531646
NODE_533_length_3284_cov_6.453689	313	392	6	51	79	0.6455696
NODE_533_length_3284_cov_6.453689	365	445	0	7	80	0.0875000
NODE_533_length_3284_cov_6.453689	365	445	2	41	80	0.5125000
NODE_533_length_3284_cov_6.453689	365	445	3	13	80	0.1625000
NODE_533_length_3284_cov_6.453689	365	445	4	9	80	0.1125000
NODE_533_length_3284_cov_6.453689	365	445	6	10	80	0.1250000
NODE_541_length_3267_cov_12.768624	11	91	0	20	80	0.2500000
NODE_541_length_3267_cov_12.768624	11	91	4	1	80	0.0125000
NODE_541_length_3267_cov_12.768624	11	91	8	11	80	0.1375000
NODE_541_length_3267_cov_12.768624	11	91	10	48	80	0.6000000
NODE_542_length_3266_cov_14.108304	2620	2684	8	5	64	0.0781250
NODE_542_length_3266_cov_14.108304	2620	2684	12	2	64	0.0312500
NODE_542_length_3266_cov_14.108304	2620	2684	14	20	64	0.3125000
NODE_542_length_3266_cov_14.108304	2620	2684	16	28	64	0.4375000
NODE_542_length_3266_cov_14.108304	2620	2684	18	9	64	0.1406250
NODE_542_length_3266_cov_14.108304	2620	2684	8	5	64	0.0781250
NODE_542_length_3266_cov_14.108304	2620	2684	12	2	64	0.0312500
NODE_542_length_3266_cov_14.108304	2620	2684	14	20	64	0.3125000
NODE_542_length_3266_cov_14.108304	2620	2684	16	28	64	0.4375000
NODE_542_length_3266_cov_14.108304	2620	2684	18	9	64	0.1406250
NODE_542_length_3266_cov_14.108304	2620	2684	8	5	64	0.0781250
NODE_542_length_3266_cov_14.108304	2620	2684	12	2	64	0.0312500
NODE_542_length_3266_cov_14.108304	2620	2684	14	20	64	0.3125000
NODE_542_length_3266_cov_14.108304	2620	2684	16	28	64	0.4375000
NODE_542_length_3266_cov_14.108304	2620	2684	18	9	64	0.1406250
NODE_547_length_3242_cov_12.407891	391	471	0	5	80	0.0625000
NODE_547_length_3242_cov_12.407891	391	471	2	16	80	0.2000000
NODE_547_length_3242_cov_12.407891	391	471	4	51	80	0.6375000
NODE_547_length_3242_cov_12.407891	391	471	6	8	80	0.1000000
NODE_547_length_3242_cov_12.407891	444	524	4	24	80	0.3000000
NODE_547_length_3242_cov_12.407891	444	524	6	21	80	0.2625000
NODE_547_length_3242_cov_12.407891	444	524	8	35	80	0.4375000
NODE_550_length_3233_cov_19.903957	411	491	0	80	80	1.0000000
NODE_550_length_3233_cov_19.903957	411	491	0	80	80	1.0000000
NODE_550_length_3233_cov_19.903957	464	544	0	80	80	1.0000000
NODE_552_length_3232_cov_11.378870	2586	2621	0	35	35	1.0000000
NODE_555_length_3214_cov_22.853291	2090	2170	36	3	80	0.0375000
NODE_555_length_3214_cov_22.853291	2090	2170	40	1	80	0.0125000
NODE_555_length_3214_cov_22.853291	2090	2170	44	1	80	0.0125000
NODE_555_length_3214_cov_22.853291	2090	2170	46	1	80	0.0125000
NODE_555_length_3214_cov_22.853291	2090	2170	48	7	80	0.0875000
NODE_555_length_3214_cov_22.853291	2090	2170	50	12	80	0.1500000
NODE_555_length_3214_cov_22.853291	2090	2170	51	6	80	0.0750000
NODE_555_length_3214_cov_22.853291	2090	2170	52	32	80	0.4000000
NODE_555_length_3214_cov_22.853291	2090	2170	53	10	80	0.1250000
NODE_555_length_3214_cov_22.853291	2090	2170	54	2	80	0.0250000
NODE_555_length_3214_cov_22.853291	2090	2170	55	5	80	0.0625000
NODE_555_length_3214_cov_22.853291	2143	2223	24	7	80	0.0875000
NODE_555_length_3214_cov_22.853291	2143	2223	26	1	80	0.0125000
NODE_555_length_3214_cov_22.853291	2143	2223	28	3	80	0.0375000
NODE_555_length_3214_cov_22.853291	2143	2223	30	2	80	0.0250000
NODE_555_length_3214_cov_22.853291	2143	2223	32	7	80	0.0875000
NODE_555_length_3214_cov_22.853291	2143	2223	34	1	80	0.0125000
NODE_555_length_3214_cov_22.853291	2143	2223	38	4	80	0.0500000
NODE_555_length_3214_cov_22.853291	2143	2223	40	6	80	0.0750000
NODE_555_length_3214_cov_22.853291	2143	2223	42	11	80	0.1375000
NODE_555_length_3214_cov_22.853291	2143	2223	44	5	80	0.0625000
NODE_555_length_3214_cov_22.853291	2143	2223	48	10	80	0.1250000
NODE_555_length_3214_cov_22.853291	2143	2223	50	6	80	0.0750000
NODE_555_length_3214_cov_22.853291	2143	2223	52	8	80	0.1000000
NODE_555_length_3214_cov_22.853291	2143	2223	53	4	80	0.0500000
NODE_555_length_3214_cov_22.853291	2143	2223	55	5	80	0.0625000
NODE_555_length_3214_cov_22.853291	3028	3086	10	26	58	0.4482759
NODE_555_length_3214_cov_22.853291	3028	3086	12	3	58	0.0517241
NODE_555_length_3214_cov_22.853291	3028	3086	14	3	58	0.0517241
NODE_555_length_3214_cov_22.853291	3028	3086	16	2	58	0.0344828
NODE_555_length_3214_cov_22.853291	3028	3086	17	8	58	0.1379310
NODE_555_length_3214_cov_22.853291	3028	3086	19	5	58	0.0862069
NODE_555_length_3214_cov_22.853291	3028	3086	22	1	58	0.0172414
NODE_555_length_3214_cov_22.853291	3028	3086	28	6	58	0.1034483
NODE_555_length_3214_cov_22.853291	3028	3086	30	3	58	0.0517241
NODE_555_length_3214_cov_22.853291	3028	3086	32	1	58	0.0172414
NODE_556_length_3211_cov_1.921915	95	175	4	1	80	0.0125000
NODE_556_length_3211_cov_1.921915	95	175	5	8	80	0.1000000
NODE_556_length_3211_cov_1.921915	95	175	7	6	80	0.0750000
NODE_556_length_3211_cov_1.921915	95	175	9	1	80	0.0125000
NODE_556_length_3211_cov_1.921915	95	175	11	1	80	0.0125000
NODE_556_length_3211_cov_1.921915	95	175	13	1	80	0.0125000
NODE_556_length_3211_cov_1.921915	95	175	14	2	80	0.0250000
NODE_556_length_3211_cov_1.921915	95	175	17	1	80	0.0125000
NODE_556_length_3211_cov_1.921915	95	175	23	2	80	0.0250000
NODE_556_length_3211_cov_1.921915	95	175	25	1	80	0.0125000
NODE_556_length_3211_cov_1.921915	95	175	26	4	80	0.0500000
NODE_556_length_3211_cov_1.921915	95	175	28	2	80	0.0250000
NODE_556_length_3211_cov_1.921915	95	175	30	1	80	0.0125000
NODE_556_length_3211_cov_1.921915	95	175	36	1	80	0.0125000
NODE_556_length_3211_cov_1.921915	95	175	38	7	80	0.0875000
NODE_556_length_3211_cov_1.921915	95	175	40	24	80	0.3000000
NODE_556_length_3211_cov_1.921915	95	175	42	1	80	0.0125000
NODE_556_length_3211_cov_1.921915	95	175	43	5	80	0.0625000
NODE_556_length_3211_cov_1.921915	95	175	44	11	80	0.1375000
NODE_556_length_3211_cov_1.921915	148	178	4	4	30	0.1333333
NODE_556_length_3211_cov_1.921915	148	178	5	8	30	0.2666667
NODE_556_length_3211_cov_1.921915	148	178	7	6	30	0.2000000
NODE_556_length_3211_cov_1.921915	148	178	9	1	30	0.0333333
NODE_556_length_3211_cov_1.921915	148	178	11	1	30	0.0333333
NODE_556_length_3211_cov_1.921915	148	178	13	1	30	0.0333333
NODE_556_length_3211_cov_1.921915	148	178	14	2	30	0.0666667
NODE_556_length_3211_cov_1.921915	148	178	17	1	30	0.0333333
NODE_556_length_3211_cov_1.921915	148	178	23	2	30	0.0666667
NODE_556_length_3211_cov_1.921915	148	178	25	1	30	0.0333333
NODE_556_length_3211_cov_1.921915	148	178	26	3	30	0.1000000
NODE_557_length_3210_cov_7.428480	2040	2111	4	4	71	0.0563380
NODE_557_length_3210_cov_7.428480	2040	2111	6	28	71	0.3943662
NODE_557_length_3210_cov_7.428480	2040	2111	8	39	71	0.5492958
NODE_557_length_3210_cov_7.428480	2084	2164	0	30	80	0.3750000
NODE_557_length_3210_cov_7.428480	2084	2164	2	6	80	0.0750000
NODE_557_length_3210_cov_7.428480	2084	2164	3	1	80	0.0125000
NODE_557_length_3210_cov_7.428480	2084	2164	4	8	80	0.1000000
NODE_557_length_3210_cov_7.428480	2084	2164	6	33	80	0.4125000
NODE_557_length_3210_cov_7.428480	2084	2164	8	2	80	0.0250000
NODE_557_length_3210_cov_7.428480	2715	2797	0	6	82	0.0731707
NODE_557_length_3210_cov_7.428480	2715	2797	2	76	82	0.9268293
NODE_557_length_3210_cov_7.428480	2770	2850	0	47	80	0.5875000
NODE_557_length_3210_cov_7.428480	2770	2850	2	33	80	0.4125000
NODE_562_length_3201_cov_3.591231	3120	3200	0	80	80	1.0000000
NODE_566_length_3189_cov_69.446602	137	188	0	51	51	1.0000000
NODE_567_length_3188_cov_7.233085	1663	1743	6	6	80	0.0750000
NODE_567_length_3188_cov_7.233085	1663	1743	7	11	80	0.1375000
NODE_567_length_3188_cov_7.233085	1663	1743	9	42	80	0.5250000
NODE_567_length_3188_cov_7.233085	1663	1743	11	21	80	0.2625000
NODE_567_length_3188_cov_7.233085	1716	1796	5	9	80	0.1125000
NODE_567_length_3188_cov_7.233085	1716	1796	6	9	80	0.1125000
NODE_567_length_3188_cov_7.233085	1716	1796	7	31	80	0.3875000
NODE_567_length_3188_cov_7.233085	1716	1796	9	31	80	0.3875000
NODE_570_length_3177_cov_2.789474	2021	2042	0	20	21	0.9523810
NODE_570_length_3177_cov_2.789474	2021	2042	2	1	21	0.0476190
NODE_575_length_3158_cov_19.018960	840	920	6	33	80	0.4125000
NODE_575_length_3158_cov_19.018960	840	920	8	16	80	0.2000000
NODE_575_length_3158_cov_19.018960	840	920	10	31	80	0.3875000
NODE_575_length_3158_cov_19.018960	893	973	4	17	80	0.2125000
NODE_575_length_3158_cov_19.018960	893	973	8	30	80	0.3750000
NODE_575_length_3158_cov_19.018960	893	973	10	33	80	0.4125000
NODE_575_length_3158_cov_19.018960	2833	2915	4	10	82	0.1219512
NODE_575_length_3158_cov_19.018960	2833	2915	6	72	82	0.8780488
NODE_575_length_3158_cov_19.018960	2888	2959	2	3	71	0.0422535
NODE_575_length_3158_cov_19.018960	2888	2959	4	41	71	0.5774648
NODE_575_length_3158_cov_19.018960	2888	2959	6	27	71	0.3802817
NODE_576_length_3150_cov_26.520813	770	850	12	20	80	0.2500000
NODE_576_length_3150_cov_26.520813	770	850	13	2	80	0.0250000
NODE_576_length_3150_cov_26.520813	770	850	14	58	80	0.7250000
NODE_576_length_3150_cov_26.520813	823	901	0	4	78	0.0512821
NODE_576_length_3150_cov_26.520813	823	901	3	6	78	0.0769231
NODE_576_length_3150_cov_26.520813	823	901	5	11	78	0.1410256
NODE_576_length_3150_cov_26.520813	823	901	6	8	78	0.1025641
NODE_576_length_3150_cov_26.520813	823	901	8	4	78	0.0512821
NODE_576_length_3150_cov_26.520813	823	901	10	9	78	0.1153846
NODE_576_length_3150_cov_26.520813	823	901	12	27	78	0.3461539
NODE_576_length_3150_cov_26.520813	823	901	13	2	78	0.0256410
NODE_576_length_3150_cov_26.520813	823	901	14	7	78	0.0897436
NODE_576_length_3150_cov_26.520813	2616	2696	0	1	80	0.0125000
NODE_576_length_3150_cov_26.520813	2616	2696	2	56	80	0.7000000
NODE_576_length_3150_cov_26.520813	2616	2696	4	6	80	0.0750000
NODE_576_length_3150_cov_26.520813	2616	2696	6	3	80	0.0375000
NODE_576_length_3150_cov_26.520813	2616	2696	8	14	80	0.1750000
NODE_576_length_3150_cov_26.520813	2669	2749	2	4	80	0.0500000
NODE_576_length_3150_cov_26.520813	2669	2749	4	6	80	0.0750000
NODE_576_length_3150_cov_26.520813	2669	2749	6	13	80	0.1625000
NODE_576_length_3150_cov_26.520813	2669	2749	8	57	80	0.7125000
NODE_577_length_3150_cov_5.923959	2313	2393	6	6	80	0.0750000
NODE_577_length_3150_cov_5.923959	2313	2393	10	10	80	0.1250000
NODE_577_length_3150_cov_5.923959	2313	2393	12	64	80	0.8000000
NODE_579_length_3148_cov_2.313873	3053	3105	0	52	52	1.0000000
NODE_581_length_3146_cov_18.277322	2418	2498	5	3	80	0.0375000
NODE_581_length_3146_cov_18.277322	2418	2498	6	28	80	0.3500000
NODE_581_length_3146_cov_18.277322	2418	2498	7	2	80	0.0250000
NODE_581_length_3146_cov_18.277322	2418	2498	8	47	80	0.5875000
NODE_581_length_3146_cov_18.277322	2471	2551	6	80	80	1.0000000
NODE_581_length_3146_cov_18.277322	2547	2627	2	29	80	0.3625000
NODE_581_length_3146_cov_18.277322	2547	2627	3	3	80	0.0375000
NODE_581_length_3146_cov_18.277322	2547	2627	4	6	80	0.0750000
NODE_581_length_3146_cov_18.277322	2547	2627	5	5	80	0.0625000
NODE_581_length_3146_cov_18.277322	2547	2627	6	37	80	0.4625000
NODE_581_length_3146_cov_18.277322	2600	2680	2	2	80	0.0250000
NODE_581_length_3146_cov_18.277322	2600	2680	3	9	80	0.1125000
NODE_581_length_3146_cov_18.277322	2600	2680	4	10	80	0.1250000
NODE_581_length_3146_cov_18.277322	2600	2680	5	2	80	0.0250000
NODE_581_length_3146_cov_18.277322	2600	2680	6	57	80	0.7125000
NODE_581_length_3146_cov_18.277322	2975	3055	3	12	80	0.1500000
NODE_581_length_3146_cov_18.277322	2975	3055	9	2	80	0.0250000
NODE_581_length_3146_cov_18.277322	2975	3055	10	66	80	0.8250000
NODE_585_length_3134_cov_8.717957	1290	1362	25	18	72	0.2500000
NODE_585_length_3134_cov_8.717957	1290	1362	26	2	72	0.0277778
NODE_585_length_3134_cov_8.717957	1290	1362	32	11	72	0.1527778
NODE_585_length_3134_cov_8.717957	1290	1362	34	5	72	0.0694444
NODE_585_length_3134_cov_8.717957	1290	1362	36	4	72	0.0555556
NODE_585_length_3134_cov_8.717957	1290	1362	40	5	72	0.0694444
NODE_585_length_3134_cov_8.717957	1290	1362	42	16	72	0.2222222
NODE_585_length_3134_cov_8.717957	1290	1362	44	11	72	0.1527778
NODE_585_length_3134_cov_8.717957	1335	1415	18	3	80	0.0375000
NODE_585_length_3134_cov_8.717957	1335	1415	20	7	80	0.0875000
NODE_585_length_3134_cov_8.717957	1335	1415	22	2	80	0.0250000
NODE_585_length_3134_cov_8.717957	1335	1415	24	1	80	0.0125000
NODE_585_length_3134_cov_8.717957	1335	1415	26	14	80	0.1750000
NODE_585_length_3134_cov_8.717957	1335	1415	28	3	80	0.0375000
NODE_585_length_3134_cov_8.717957	1335	1415	30	11	80	0.1375000
NODE_585_length_3134_cov_8.717957	1335	1415	32	3	80	0.0375000
NODE_585_length_3134_cov_8.717957	1335	1415	34	2	80	0.0250000
NODE_585_length_3134_cov_8.717957	1335	1415	36	2	80	0.0250000
NODE_585_length_3134_cov_8.717957	1335	1415	40	10	80	0.1250000
NODE_585_length_3134_cov_8.717957	1335	1415	42	11	80	0.1375000
NODE_585_length_3134_cov_8.717957	1335	1415	44	11	80	0.1375000
NODE_586_length_3131_cov_26.910620	232	312	0	80	80	1.0000000
NODE_586_length_3131_cov_26.910620	285	364	0	79	79	1.0000000
NODE_586_length_3131_cov_26.910620	2151	2231	0	80	80	1.0000000
NODE_586_length_3131_cov_26.910620	2155	2227	0	72	72	1.0000000
NODE_586_length_3131_cov_26.910620	2204	2284	0	80	80	1.0000000
NODE_586_length_3131_cov_26.910620	2208	2284	0	76	76	1.0000000
NODE_586_length_3131_cov_26.910620	2280	2360	0	80	80	1.0000000
NODE_586_length_3131_cov_26.910620	2333	2413	0	80	80	1.0000000
NODE_590_length_3118_cov_5.059622	367	445	0	18	78	0.2307692
NODE_590_length_3118_cov_5.059622	367	445	2	29	78	0.3717949
NODE_590_length_3118_cov_5.059622	367	445	6	31	78	0.3974359
NODE_590_length_3118_cov_5.059622	418	498	4	2	80	0.0250000
NODE_590_length_3118_cov_5.059622	418	498	6	78	80	0.9750000
NODE_591_length_3117_cov_5.938038	2525	2605	0	80	80	1.0000000
NODE_591_length_3117_cov_5.938038	2578	2658	0	80	80	1.0000000
NODE_595_length_3110_cov_31.733643	2864	2923	0	59	59	1.0000000
NODE_602_length_3093_cov_54.559786	571	651	2	27	80	0.3375000
NODE_602_length_3093_cov_54.559786	571	651	4	53	80	0.6625000
NODE_602_length_3093_cov_54.559786	624	704	2	58	80	0.7250000
NODE_602_length_3093_cov_54.559786	624	704	4	22	80	0.2750000
NODE_602_length_3093_cov_54.559786	2901	2981	28	3	80	0.0375000
NODE_602_length_3093_cov_54.559786	2901	2981	30	4	80	0.0500000
NODE_602_length_3093_cov_54.559786	2901	2981	32	18	80	0.2250000
NODE_602_length_3093_cov_54.559786	2901	2981	34	9	80	0.1125000
NODE_602_length_3093_cov_54.559786	2901	2981	36	17	80	0.2125000
NODE_602_length_3093_cov_54.559786	2901	2981	38	7	80	0.0875000
NODE_602_length_3093_cov_54.559786	2901	2981	40	22	80	0.2750000
NODE_602_length_3093_cov_54.559786	2954	3034	16	7	80	0.0875000
NODE_602_length_3093_cov_54.559786	2954	3034	18	1	80	0.0125000
NODE_602_length_3093_cov_54.559786	2954	3034	19	8	80	0.1000000
NODE_602_length_3093_cov_54.559786	2954	3034	21	13	80	0.1625000
NODE_602_length_3093_cov_54.559786	2954	3034	24	3	80	0.0375000
NODE_602_length_3093_cov_54.559786	2954	3034	26	7	80	0.0875000
NODE_602_length_3093_cov_54.559786	2954	3034	32	6	80	0.0750000
NODE_602_length_3093_cov_54.559786	2954	3034	34	1	80	0.0125000
NODE_602_length_3093_cov_54.559786	2954	3034	36	2	80	0.0250000
NODE_602_length_3093_cov_54.559786	2954	3034	38	5	80	0.0625000
NODE_602_length_3093_cov_54.559786	2954	3034	40	27	80	0.3375000
NODE_603_length_3091_cov_35.895722	1743	1804	2	6	61	0.0983607
NODE_603_length_3091_cov_35.895722	1743	1804	4	55	61	0.9016393
NODE_603_length_3091_cov_35.895722	1777	1857	0	17	80	0.2125000
NODE_603_length_3091_cov_35.895722	1777	1857	2	14	80	0.1750000
NODE_603_length_3091_cov_35.895722	1777	1857	4	49	80	0.6125000
NODE_603_length_3091_cov_35.895722	2472	2535	0	7	63	0.1111111
NODE_603_length_3091_cov_35.895722	2472	2535	2	56	63	0.8888889
NODE_603_length_3091_cov_35.895722	2508	2553	0	25	45	0.5555556
NODE_603_length_3091_cov_35.895722	2508	2553	2	20	45	0.4444444
NODE_603_length_3091_cov_35.895722	2534	2604	0	26	70	0.3714286
NODE_603_length_3091_cov_35.895722	2534	2604	2	44	70	0.6285715
NODE_603_length_3091_cov_35.895722	2578	2618	2	40	40	1.0000000
NODE_603_length_3091_cov_35.895722	2586	2623	2	37	37	1.0000000
NODE_603_length_3091_cov_35.895722	2626	2671	0	1	45	0.0222222
NODE_603_length_3091_cov_35.895722	2626	2671	2	44	45	0.9777778
NODE_603_length_3091_cov_35.895722	2682	2730	2	48	48	1.0000000
NODE_603_length_3091_cov_35.895722	2918	2969	0	51	51	1.0000000
NODE_603_length_3091_cov_35.895722	2942	2987	0	45	45	1.0000000
NODE_603_length_3091_cov_35.895722	2994	3039	0	45	45	1.0000000
NODE_607_length_3079_cov_7.081879	2340	2420	0	24	80	0.3000000
NODE_607_length_3079_cov_7.081879	2340	2420	2	4	80	0.0500000
NODE_607_length_3079_cov_7.081879	2340	2420	4	52	80	0.6500000
NODE_607_length_3079_cov_7.081879	2886	2938	9	5	52	0.0961538
NODE_607_length_3079_cov_7.081879	2886	2938	10	9	52	0.1730769
NODE_607_length_3079_cov_7.081879	2886	2938	14	2	52	0.0384615
NODE_607_length_3079_cov_7.081879	2886	2938	17	8	52	0.1538462
NODE_607_length_3079_cov_7.081879	2886	2938	19	3	52	0.0576923
NODE_607_length_3079_cov_7.081879	2886	2938	21	5	52	0.0961538
NODE_607_length_3079_cov_7.081879	2886	2938	22	3	52	0.0576923
NODE_607_length_3079_cov_7.081879	2886	2938	26	1	52	0.0192308
NODE_607_length_3079_cov_7.081879	2886	2938	27	1	52	0.0192308
NODE_607_length_3079_cov_7.081879	2886	2938	31	2	52	0.0384615
NODE_607_length_3079_cov_7.081879	2886	2938	32	1	52	0.0192308
NODE_607_length_3079_cov_7.081879	2886	2938	34	6	52	0.1153846
NODE_607_length_3079_cov_7.081879	2886	2938	36	3	52	0.0576923
NODE_607_length_3079_cov_7.081879	2886	2938	40	3	52	0.0576923
NODE_607_length_3079_cov_7.081879	2893	2959	10	7	66	0.1060606
NODE_607_length_3079_cov_7.081879	2893	2959	14	2	66	0.0303030
NODE_607_length_3079_cov_7.081879	2893	2959	17	8	66	0.1212121
NODE_607_length_3079_cov_7.081879	2893	2959	19	3	66	0.0454545
NODE_607_length_3079_cov_7.081879	2893	2959	21	5	66	0.0757576
NODE_607_length_3079_cov_7.081879	2893	2959	22	3	66	0.0454545
NODE_607_length_3079_cov_7.081879	2893	2959	26	1	66	0.0151515
NODE_607_length_3079_cov_7.081879	2893	2959	27	1	66	0.0151515
NODE_607_length_3079_cov_7.081879	2893	2959	31	2	66	0.0303030
NODE_607_length_3079_cov_7.081879	2893	2959	32	1	66	0.0151515
NODE_607_length_3079_cov_7.081879	2893	2959	34	6	66	0.0909091
NODE_607_length_3079_cov_7.081879	2893	2959	36	3	66	0.0454545
NODE_607_length_3079_cov_7.081879	2893	2959	40	3	66	0.0454545
NODE_607_length_3079_cov_7.081879	2893	2959	42	1	66	0.0151515
NODE_607_length_3079_cov_7.081879	2893	2959	44	1	66	0.0151515
NODE_607_length_3079_cov_7.081879	2893	2959	52	2	66	0.0303030
NODE_607_length_3079_cov_7.081879	2893	2959	56	1	66	0.0151515
NODE_607_length_3079_cov_7.081879	2893	2959	62	2	66	0.0303030
NODE_607_length_3079_cov_7.081879	2893	2959	66	3	66	0.0454545
NODE_607_length_3079_cov_7.081879	2893	2959	68	2	66	0.0303030
NODE_607_length_3079_cov_7.081879	2893	2959	70	2	66	0.0303030
NODE_607_length_3079_cov_7.081879	2893	2959	74	6	66	0.0909091
NODE_607_length_3079_cov_7.081879	2893	2959	76	1	66	0.0151515
NODE_607_length_3079_cov_7.081879	2932	2993	36	3	61	0.0491803
NODE_607_length_3079_cov_7.081879	2932	2993	40	3	61	0.0491803
NODE_607_length_3079_cov_7.081879	2932	2993	42	1	61	0.0163934
NODE_607_length_3079_cov_7.081879	2932	2993	44	1	61	0.0163934
NODE_607_length_3079_cov_7.081879	2932	2993	52	2	61	0.0327869
NODE_607_length_3079_cov_7.081879	2932	2993	56	1	61	0.0163934
NODE_607_length_3079_cov_7.081879	2932	2993	62	2	61	0.0327869
NODE_607_length_3079_cov_7.081879	2932	2993	66	3	61	0.0491803
NODE_607_length_3079_cov_7.081879	2932	2993	68	2	61	0.0327869
NODE_607_length_3079_cov_7.081879	2932	2993	70	2	61	0.0327869
NODE_607_length_3079_cov_7.081879	2932	2993	72	5	61	0.0819672
NODE_607_length_3079_cov_7.081879	2932	2993	74	6	61	0.0983607
NODE_607_length_3079_cov_7.081879	2932	2993	76	9	61	0.1475410
NODE_607_length_3079_cov_7.081879	2932	2993	78	21	61	0.3442623
NODE_607_length_3079_cov_7.081879	2932	2995	36	3	63	0.0476190
NODE_607_length_3079_cov_7.081879	2932	2995	40	3	63	0.0476190
NODE_607_length_3079_cov_7.081879	2932	2995	42	1	63	0.0158730
NODE_607_length_3079_cov_7.081879	2932	2995	44	1	63	0.0158730
NODE_607_length_3079_cov_7.081879	2932	2995	52	2	63	0.0317460
NODE_607_length_3079_cov_7.081879	2932	2995	56	1	63	0.0158730
NODE_607_length_3079_cov_7.081879	2932	2995	62	2	63	0.0317460
NODE_607_length_3079_cov_7.081879	2932	2995	66	3	63	0.0476190
NODE_607_length_3079_cov_7.081879	2932	2995	68	2	63	0.0317460
NODE_607_length_3079_cov_7.081879	2932	2995	70	2	63	0.0317460
NODE_607_length_3079_cov_7.081879	2932	2995	72	7	63	0.1111111
NODE_607_length_3079_cov_7.081879	2932	2995	74	6	63	0.0952381
NODE_607_length_3079_cov_7.081879	2932	2995	76	9	63	0.1428571
NODE_607_length_3079_cov_7.081879	2932	2995	78	21	63	0.3333333
NODE_607_length_3079_cov_7.081879	2932	2995	36	3	63	0.0476190
NODE_607_length_3079_cov_7.081879	2932	2995	40	3	63	0.0476190
NODE_607_length_3079_cov_7.081879	2932	2995	42	1	63	0.0158730
NODE_607_length_3079_cov_7.081879	2932	2995	44	1	63	0.0158730
NODE_607_length_3079_cov_7.081879	2932	2995	52	2	63	0.0317460
NODE_607_length_3079_cov_7.081879	2932	2995	56	1	63	0.0158730
NODE_607_length_3079_cov_7.081879	2932	2995	62	2	63	0.0317460
NODE_607_length_3079_cov_7.081879	2932	2995	66	3	63	0.0476190
NODE_607_length_3079_cov_7.081879	2932	2995	68	2	63	0.0317460
NODE_607_length_3079_cov_7.081879	2932	2995	70	2	63	0.0317460
NODE_607_length_3079_cov_7.081879	2932	2995	72	7	63	0.1111111
NODE_607_length_3079_cov_7.081879	2932	2995	74	6	63	0.0952381
NODE_607_length_3079_cov_7.081879	2932	2995	76	9	63	0.1428571
NODE_607_length_3079_cov_7.081879	2932	2995	78	21	63	0.3333333
NODE_608_length_3077_cov_23.535259	1244	1321	2	15	77	0.1948052
NODE_608_length_3077_cov_23.535259	1244	1321	4	1	77	0.0129870
NODE_608_length_3077_cov_23.535259	1244	1321	6	55	77	0.7142857
NODE_608_length_3077_cov_23.535259	1244	1321	8	6	77	0.0779221
NODE_608_length_3077_cov_23.535259	1911	1991	0	29	80	0.3625000
NODE_608_length_3077_cov_23.535259	1911	1991	2	40	80	0.5000000
NODE_608_length_3077_cov_23.535259	1911	1991	4	11	80	0.1375000
NODE_608_length_3077_cov_23.535259	1964	2016	2	16	52	0.3076923
NODE_608_length_3077_cov_23.535259	1964	2016	4	36	52	0.6923077
NODE_608_length_3077_cov_23.535259	2028	2114	2	1	86	0.0116279
NODE_608_length_3077_cov_23.535259	2028	2114	5	8	86	0.0930233
NODE_608_length_3077_cov_23.535259	2028	2114	6	53	86	0.6162791
NODE_608_length_3077_cov_23.535259	2028	2114	7	14	86	0.1627907
NODE_608_length_3077_cov_23.535259	2028	2114	8	10	86	0.1162791
NODE_609_length_3077_cov_8.693083	1157	1237	0	28	80	0.3500000
NODE_609_length_3077_cov_8.693083	1157	1237	2	5	80	0.0625000
NODE_609_length_3077_cov_8.693083	1157	1237	4	1	80	0.0125000
NODE_609_length_3077_cov_8.693083	1157	1237	6	12	80	0.1500000
NODE_609_length_3077_cov_8.693083	1157	1237	8	16	80	0.2000000
NODE_609_length_3077_cov_8.693083	1157	1237	10	1	80	0.0125000
NODE_609_length_3077_cov_8.693083	1157	1237	14	3	80	0.0375000
NODE_609_length_3077_cov_8.693083	1157	1237	16	3	80	0.0375000
NODE_609_length_3077_cov_8.693083	1157	1237	20	7	80	0.0875000
NODE_609_length_3077_cov_8.693083	1157	1237	22	3	80	0.0375000
NODE_609_length_3077_cov_8.693083	1157	1237	23	1	80	0.0125000
NODE_609_length_3077_cov_8.693083	1161	1184	0	23	23	1.0000000
NODE_609_length_3077_cov_8.693083	1233	1313	22	3	80	0.0375000
NODE_609_length_3077_cov_8.693083	1233	1313	23	11	80	0.1375000
NODE_609_length_3077_cov_8.693083	1233	1313	25	6	80	0.0750000
NODE_609_length_3077_cov_8.693083	1233	1313	31	6	80	0.0750000
NODE_609_length_3077_cov_8.693083	1233	1313	33	7	80	0.0875000
NODE_609_length_3077_cov_8.693083	1233	1313	34	6	80	0.0750000
NODE_609_length_3077_cov_8.693083	1233	1313	36	1	80	0.0125000
NODE_609_length_3077_cov_8.693083	1233	1313	38	9	80	0.1125000
NODE_609_length_3077_cov_8.693083	1233	1313	40	14	80	0.1750000
NODE_609_length_3077_cov_8.693083	1233	1313	42	17	80	0.2125000
NODE_609_length_3077_cov_8.693083	1286	1352	32	3	66	0.0454545
NODE_609_length_3077_cov_8.693083	1286	1352	34	4	66	0.0606061
NODE_609_length_3077_cov_8.693083	1286	1352	36	8	66	0.1212121
NODE_609_length_3077_cov_8.693083	1286	1352	38	11	66	0.1666667
NODE_609_length_3077_cov_8.693083	1286	1352	40	23	66	0.3484848
NODE_609_length_3077_cov_8.693083	1286	1352	42	17	66	0.2575758
NODE_609_length_3077_cov_8.693083	2672	2757	0	2	85	0.0235294
NODE_609_length_3077_cov_8.693083	2672	2757	4	4	85	0.0470588
NODE_609_length_3077_cov_8.693083	2672	2757	6	7	85	0.0823529
NODE_609_length_3077_cov_8.693083	2672	2757	8	31	85	0.3647059
NODE_609_length_3077_cov_8.693083	2672	2757	11	1	85	0.0117647
NODE_609_length_3077_cov_8.693083	2672	2757	12	16	85	0.1882353
NODE_609_length_3077_cov_8.693083	2672	2757	14	19	85	0.2235294
NODE_609_length_3077_cov_8.693083	2672	2757	16	2	85	0.0235294
NODE_609_length_3077_cov_8.693083	2672	2757	17	1	85	0.0117647
NODE_609_length_3077_cov_8.693083	2672	2757	18	2	85	0.0235294
NODE_611_length_3074_cov_2.996303	2561	2629	35	5	68	0.0735294
NODE_611_length_3074_cov_2.996303	2561	2629	37	2	68	0.0294118
NODE_611_length_3074_cov_2.996303	2561	2629	45	1	68	0.0147059
NODE_611_length_3074_cov_2.996303	2561	2629	47	1	68	0.0147059
NODE_611_length_3074_cov_2.996303	2561	2629	58	1	68	0.0147059
NODE_611_length_3074_cov_2.996303	2561	2629	62	1	68	0.0147059
NODE_611_length_3074_cov_2.996303	2561	2629	68	1	68	0.0147059
NODE_611_length_3074_cov_2.996303	2561	2629	71	1	68	0.0147059
NODE_611_length_3074_cov_2.996303	2561	2629	72	1	68	0.0147059
NODE_611_length_3074_cov_2.996303	2561	2629	73	1	68	0.0147059
NODE_611_length_3074_cov_2.996303	2561	2629	77	3	68	0.0441176
NODE_611_length_3074_cov_2.996303	2561	2629	83	2	68	0.0294118
NODE_611_length_3074_cov_2.996303	2561	2629	84	1	68	0.0147059
NODE_611_length_3074_cov_2.996303	2561	2629	85	1	68	0.0147059
NODE_611_length_3074_cov_2.996303	2561	2629	93	2	68	0.0294118
NODE_611_length_3074_cov_2.996303	2561	2629	97	1	68	0.0147059
NODE_611_length_3074_cov_2.996303	2561	2629	107	1	68	0.0147059
NODE_611_length_3074_cov_2.996303	2561	2629	111	1	68	0.0147059
NODE_611_length_3074_cov_2.996303	2561	2629	115	1	68	0.0147059
NODE_611_length_3074_cov_2.996303	2561	2629	116	1	68	0.0147059
NODE_611_length_3074_cov_2.996303	2561	2629	118	1	68	0.0147059
NODE_611_length_3074_cov_2.996303	2561	2629	125	3	68	0.0441176
NODE_611_length_3074_cov_2.996303	2561	2629	127	2	68	0.0294118
NODE_611_length_3074_cov_2.996303	2561	2629	129	1	68	0.0147059
NODE_611_length_3074_cov_2.996303	2561	2629	131	1	68	0.0147059
NODE_611_length_3074_cov_2.996303	2561	2629	135	1	68	0.0147059
NODE_611_length_3074_cov_2.996303	2561	2629	138	2	68	0.0294118
NODE_611_length_3074_cov_2.996303	2561	2629	144	1	68	0.0147059
NODE_611_length_3074_cov_2.996303	2561	2629	153	1	68	0.0147059
NODE_611_length_3074_cov_2.996303	2561	2629	161	1	68	0.0147059
NODE_611_length_3074_cov_2.996303	2561	2629	163	1	68	0.0147059
NODE_611_length_3074_cov_2.996303	2561	2629	171	5	68	0.0735294
NODE_611_length_3074_cov_2.996303	2561	2629	177	1	68	0.0147059
NODE_611_length_3074_cov_2.996303	2561	2629	183	1	68	0.0147059
NODE_611_length_3074_cov_2.996303	2561	2629	192	1	68	0.0147059
NODE_611_length_3074_cov_2.996303	2561	2629	202	1	68	0.0147059
NODE_611_length_3074_cov_2.996303	2561	2629	206	2	68	0.0294118
NODE_611_length_3074_cov_2.996303	2561	2629	212	1	68	0.0147059
NODE_611_length_3074_cov_2.996303	2561	2629	218	1	68	0.0147059
NODE_611_length_3074_cov_2.996303	2561	2629	234	1	68	0.0147059
NODE_611_length_3074_cov_2.996303	2561	2629	235	1	68	0.0147059
NODE_611_length_3074_cov_2.996303	2561	2629	253	1	68	0.0147059
NODE_611_length_3074_cov_2.996303	2561	2629	262	1	68	0.0147059
NODE_611_length_3074_cov_2.996303	2561	2629	266	1	68	0.0147059
NODE_611_length_3074_cov_2.996303	2561	2629	270	1	68	0.0147059
NODE_611_length_3074_cov_2.996303	2561	2629	296	1	68	0.0147059
NODE_611_length_3074_cov_2.996303	2561	2629	299	1	68	0.0147059
NODE_611_length_3074_cov_2.996303	2561	2629	323	1	68	0.0147059
NODE_611_length_3074_cov_2.996303	2561	2629	329	1	68	0.0147059
NODE_611_length_3074_cov_2.996303	2561	2629	333	1	68	0.0147059
NODE_615_length_3069_cov_2.448822	2948	2991	0	43	43	1.0000000
NODE_616_length_3059_cov_20.037500	346	426	17	1	80	0.0125000
NODE_616_length_3059_cov_20.037500	346	426	18	1	80	0.0125000
NODE_616_length_3059_cov_20.037500	346	426	19	6	80	0.0750000
NODE_616_length_3059_cov_20.037500	346	426	20	2	80	0.0250000
NODE_616_length_3059_cov_20.037500	346	426	21	1	80	0.0125000
NODE_616_length_3059_cov_20.037500	346	426	23	5	80	0.0625000
NODE_616_length_3059_cov_20.037500	346	426	28	1	80	0.0125000
NODE_616_length_3059_cov_20.037500	346	426	29	2	80	0.0250000
NODE_616_length_3059_cov_20.037500	346	426	31	2	80	0.0250000
NODE_616_length_3059_cov_20.037500	346	426	33	6	80	0.0750000
NODE_616_length_3059_cov_20.037500	346	426	37	4	80	0.0500000
NODE_616_length_3059_cov_20.037500	346	426	39	9	80	0.1125000
NODE_616_length_3059_cov_20.037500	346	426	41	3	80	0.0375000
NODE_616_length_3059_cov_20.037500	346	426	43	1	80	0.0125000
NODE_616_length_3059_cov_20.037500	346	426	45	1	80	0.0125000
NODE_616_length_3059_cov_20.037500	346	426	47	4	80	0.0500000
NODE_616_length_3059_cov_20.037500	346	426	48	1	80	0.0125000
NODE_616_length_3059_cov_20.037500	346	426	49	3	80	0.0375000
NODE_616_length_3059_cov_20.037500	346	426	50	13	80	0.1625000
NODE_616_length_3059_cov_20.037500	346	426	52	4	80	0.0500000
NODE_616_length_3059_cov_20.037500	346	426	54	2	80	0.0250000
NODE_616_length_3059_cov_20.037500	346	426	56	8	80	0.1000000
NODE_616_length_3059_cov_20.037500	399	479	34	5	80	0.0625000
NODE_616_length_3059_cov_20.037500	399	479	36	2	80	0.0250000
NODE_616_length_3059_cov_20.037500	399	479	40	1	80	0.0125000
NODE_616_length_3059_cov_20.037500	399	479	42	1	80	0.0125000
NODE_616_length_3059_cov_20.037500	399	479	46	5	80	0.0625000
NODE_616_length_3059_cov_20.037500	399	479	48	27	80	0.3375000
NODE_616_length_3059_cov_20.037500	399	479	50	18	80	0.2250000
NODE_616_length_3059_cov_20.037500	399	479	52	11	80	0.1375000
NODE_616_length_3059_cov_20.037500	399	479	54	2	80	0.0250000
NODE_616_length_3059_cov_20.037500	399	479	56	8	80	0.1000000
NODE_616_length_3059_cov_20.037500	1317	1397	4	16	80	0.2000000
NODE_616_length_3059_cov_20.037500	1317	1397	6	27	80	0.3375000
NODE_616_length_3059_cov_20.037500	1317	1397	8	37	80	0.4625000
NODE_616_length_3059_cov_20.037500	1370	1447	0	7	77	0.0909091
NODE_616_length_3059_cov_20.037500	1370	1447	2	1	77	0.0129870
NODE_616_length_3059_cov_20.037500	1370	1447	4	14	77	0.1818182
NODE_616_length_3059_cov_20.037500	1370	1447	6	55	77	0.7142857
NODE_616_length_3059_cov_20.037500	2514	2594	0	80	80	1.0000000
NODE_616_length_3059_cov_20.037500	2567	2647	0	80	80	1.0000000
NODE_617_length_3058_cov_21.767489	2802	2882	0	5	80	0.0625000
NODE_617_length_3058_cov_21.767489	2802	2882	2	23	80	0.2875000
NODE_617_length_3058_cov_21.767489	2802	2882	4	50	80	0.6250000
NODE_617_length_3058_cov_21.767489	2802	2882	8	2	80	0.0250000
NODE_617_length_3058_cov_21.767489	2855	2930	2	2	75	0.0266667
NODE_617_length_3058_cov_21.767489	2855	2930	4	28	75	0.3733333
NODE_617_length_3058_cov_21.767489	2855	2930	6	33	75	0.4400000
NODE_617_length_3058_cov_21.767489	2855	2930	8	12	75	0.1600000
NODE_621_length_3047_cov_47.232361	418	489	0	71	71	1.0000000
NODE_621_length_3047_cov_47.232361	758	801	8	7	43	0.1627907
NODE_621_length_3047_cov_47.232361	758	801	10	1	43	0.0232558
NODE_621_length_3047_cov_47.232361	758	801	12	2	43	0.0465116
NODE_621_length_3047_cov_47.232361	758	801	14	18	43	0.4186046
NODE_621_length_3047_cov_47.232361	758	801	16	1	43	0.0232558
NODE_621_length_3047_cov_47.232361	758	801	18	3	43	0.0697674
NODE_621_length_3047_cov_47.232361	758	801	20	1	43	0.0232558
NODE_621_length_3047_cov_47.232361	758	801	26	2	43	0.0465116
NODE_621_length_3047_cov_47.232361	758	801	29	1	43	0.0232558
NODE_621_length_3047_cov_47.232361	758	801	30	2	43	0.0465116
NODE_621_length_3047_cov_47.232361	758	801	31	5	43	0.1162791
NODE_623_length_3044_cov_38.951783	1702	1782	0	80	80	1.0000000
NODE_623_length_3044_cov_38.951783	1755	1835	0	80	80	1.0000000
NODE_623_length_3044_cov_38.951783	1831	1911	0	65	80	0.8125000
NODE_623_length_3044_cov_38.951783	1831	1911	2	8	80	0.1000000
NODE_623_length_3044_cov_38.951783	1831	1911	4	7	80	0.0875000
NODE_623_length_3044_cov_38.951783	1884	1964	0	12	80	0.1500000
NODE_623_length_3044_cov_38.951783	1884	1964	2	8	80	0.1000000
NODE_623_length_3044_cov_38.951783	1884	1964	4	60	80	0.7500000
NODE_623_length_3044_cov_38.951783	2556	2636	0	18	80	0.2250000
NODE_623_length_3044_cov_38.951783	2556	2636	2	39	80	0.4875000
NODE_623_length_3044_cov_38.951783	2556	2636	4	23	80	0.2875000
NODE_623_length_3044_cov_38.951783	2609	2689	0	4	80	0.0500000
NODE_623_length_3044_cov_38.951783	2609	2689	2	38	80	0.4750000
NODE_623_length_3044_cov_38.951783	2609	2689	4	38	80	0.4750000
NODE_625_length_3039_cov_3.258163	261	337	2	7	76	0.0921053
NODE_625_length_3039_cov_3.258163	261	337	4	21	76	0.2763158
NODE_625_length_3039_cov_3.258163	261	337	6	48	76	0.6315789
NODE_625_length_3039_cov_3.258163	261	336	2	7	75	0.0933333
NODE_625_length_3039_cov_3.258163	261	336	4	21	75	0.2800000
NODE_625_length_3039_cov_3.258163	261	336	6	47	75	0.6266667
NODE_625_length_3039_cov_3.258163	261	337	2	7	76	0.0921053
NODE_625_length_3039_cov_3.258163	261	337	4	21	76	0.2763158
NODE_625_length_3039_cov_3.258163	261	337	6	48	76	0.6315789
NODE_625_length_3039_cov_3.258163	270	337	4	19	67	0.2835821
NODE_625_length_3039_cov_3.258163	270	337	6	48	67	0.7164179
NODE_627_length_3036_cov_8.968676	2303	2367	0	43	64	0.6718750
NODE_627_length_3036_cov_8.968676	2303	2367	6	21	64	0.3281250
NODE_627_length_3036_cov_8.968676	2340	2420	0	6	80	0.0750000
NODE_627_length_3036_cov_8.968676	2340	2420	6	74	80	0.9250000
NODE_627_length_3036_cov_8.968676	2416	2496	0	14	80	0.1750000
NODE_627_length_3036_cov_8.968676	2416	2496	4	1	80	0.0125000
NODE_627_length_3036_cov_8.968676	2416	2496	6	65	80	0.8125000
NODE_627_length_3036_cov_8.968676	2469	2549	0	67	80	0.8375000
NODE_627_length_3036_cov_8.968676	2469	2549	4	1	80	0.0125000
NODE_627_length_3036_cov_8.968676	2469	2549	6	12	80	0.1500000
NODE_629_length_3032_cov_7.470849	1026	1068	12	6	42	0.1428571
NODE_629_length_3032_cov_7.470849	1026	1068	14	2	42	0.0476190
NODE_629_length_3032_cov_7.470849	1026	1068	15	1	42	0.0238095
NODE_629_length_3032_cov_7.470849	1026	1068	16	20	42	0.4761905
NODE_629_length_3032_cov_7.470849	1026	1068	18	9	42	0.2142857
NODE_629_length_3032_cov_7.470849	1026	1068	22	4	42	0.0952381
NODE_630_length_3025_cov_11.862611	2371	2451	0	80	80	1.0000000
NODE_630_length_3025_cov_11.862611	2424	2504	0	71	80	0.8875000
NODE_630_length_3025_cov_11.862611	2424	2504	2	1	80	0.0125000
NODE_630_length_3025_cov_11.862611	2424	2504	3	8	80	0.1000000
NODE_630_length_3025_cov_11.862611	2500	2580	3	45	80	0.5625000
NODE_630_length_3025_cov_11.862611	2500	2580	4	35	80	0.4375000
NODE_630_length_3025_cov_11.862611	2553	2633	2	36	80	0.4500000
NODE_630_length_3025_cov_11.862611	2553	2633	4	43	80	0.5375000
NODE_630_length_3025_cov_11.862611	2553	2633	6	1	80	0.0125000
NODE_635_length_3012_cov_33.100240	2379	2459	0	80	80	1.0000000
NODE_635_length_3012_cov_33.100240	2432	2512	0	80	80	1.0000000
NODE_637_length_3007_cov_11.843535	2641	2721	2	80	80	1.0000000
NODE_643_length_2992_cov_2.636709	2032	2112	0	39	80	0.4875000
NODE_643_length_2992_cov_2.636709	2032	2112	2	2	80	0.0250000
NODE_643_length_2992_cov_2.636709	2032	2112	4	13	80	0.1625000
NODE_643_length_2992_cov_2.636709	2032	2112	6	26	80	0.3250000
NODE_643_length_2992_cov_2.636709	2085	2165	4	1	80	0.0125000
NODE_643_length_2992_cov_2.636709	2085	2165	6	39	80	0.4875000
NODE_643_length_2992_cov_2.636709	2085	2165	8	12	80	0.1500000
NODE_643_length_2992_cov_2.636709	2085	2165	10	3	80	0.0375000
NODE_643_length_2992_cov_2.636709	2085	2165	12	18	80	0.2250000
NODE_643_length_2992_cov_2.636709	2085	2165	14	7	80	0.0875000
NODE_646_length_2978_cov_4.883293	382	452	6	70	70	1.0000000
NODE_646_length_2978_cov_4.883293	1858	1938	0	80	80	1.0000000
NODE_646_length_2978_cov_4.883293	1926	1991	0	29	65	0.4461538
NODE_646_length_2978_cov_4.883293	1926	1991	2	36	65	0.5538462
NODE_646_length_2978_cov_4.883293	1987	2066	0	24	79	0.3037975
NODE_646_length_2978_cov_4.883293	1987	2066	2	55	79	0.6962025
NODE_646_length_2978_cov_4.883293	2040	2079	0	37	39	0.9487180
NODE_646_length_2978_cov_4.883293	2040	2079	2	2	39	0.0512821
NODE_647_length_2976_cov_24.683003	1764	1844	0	80	80	1.0000000
NODE_647_length_2976_cov_24.683003	1817	1897	0	80	80	1.0000000
NODE_647_length_2976_cov_24.683003	1893	1973	0	80	80	1.0000000
NODE_647_length_2976_cov_24.683003	1946	2026	0	80	80	1.0000000
NODE_651_length_2967_cov_16.146095	238	318	0	8	80	0.1000000
NODE_651_length_2967_cov_16.146095	238	318	2	33	80	0.4125000
NODE_651_length_2967_cov_16.146095	238	318	6	28	80	0.3500000
NODE_651_length_2967_cov_16.146095	238	318	8	11	80	0.1375000
NODE_651_length_2967_cov_16.146095	291	371	0	1	80	0.0125000
NODE_651_length_2967_cov_16.146095	291	371	2	12	80	0.1500000
NODE_651_length_2967_cov_16.146095	291	371	4	4	80	0.0500000
NODE_651_length_2967_cov_16.146095	291	371	6	18	80	0.2250000
NODE_651_length_2967_cov_16.146095	291	371	8	45	80	0.5625000
NODE_651_length_2967_cov_16.146095	367	447	0	2	80	0.0250000
NODE_651_length_2967_cov_16.146095	367	447	1	9	80	0.1125000
NODE_651_length_2967_cov_16.146095	367	447	2	69	80	0.8625000
NODE_651_length_2967_cov_16.146095	420	500	0	55	80	0.6875000
NODE_651_length_2967_cov_16.146095	420	500	1	9	80	0.1125000
NODE_651_length_2967_cov_16.146095	420	500	2	16	80	0.2000000
NODE_653_length_2965_cov_19.913468	92	134	14	6	42	0.1428571
NODE_653_length_2965_cov_19.913468	92	134	16	1	42	0.0238095
NODE_653_length_2965_cov_19.913468	92	134	18	2	42	0.0476190
NODE_653_length_2965_cov_19.913468	92	134	20	3	42	0.0714286
NODE_653_length_2965_cov_19.913468	92	134	22	2	42	0.0476190
NODE_653_length_2965_cov_19.913468	92	134	24	2	42	0.0476190
NODE_653_length_2965_cov_19.913468	92	134	26	1	42	0.0238095
NODE_653_length_2965_cov_19.913468	92	134	36	1	42	0.0238095
NODE_653_length_2965_cov_19.913468	92	134	48	1	42	0.0238095
NODE_653_length_2965_cov_19.913468	92	134	54	2	42	0.0476190
NODE_653_length_2965_cov_19.913468	92	134	56	1	42	0.0238095
NODE_653_length_2965_cov_19.913468	92	134	58	3	42	0.0714286
NODE_653_length_2965_cov_19.913468	92	134	60	6	42	0.1428571
NODE_653_length_2965_cov_19.913468	92	134	62	1	42	0.0238095
NODE_653_length_2965_cov_19.913468	92	134	64	10	42	0.2380952
NODE_653_length_2965_cov_19.913468	109	178	0	8	69	0.1159420
NODE_653_length_2965_cov_19.913468	109	178	2	3	69	0.0434783
NODE_653_length_2965_cov_19.913468	109	178	4	4	69	0.0579710
NODE_653_length_2965_cov_19.913468	109	178	6	13	69	0.1884058
NODE_653_length_2965_cov_19.913468	109	178	10	2	69	0.0289855
NODE_653_length_2965_cov_19.913468	109	178	12	11	69	0.1594203
NODE_653_length_2965_cov_19.913468	109	178	14	9	69	0.1304348
NODE_653_length_2965_cov_19.913468	109	178	16	1	69	0.0144928
NODE_653_length_2965_cov_19.913468	109	178	18	2	69	0.0289855
NODE_653_length_2965_cov_19.913468	109	178	20	3	69	0.0434783
NODE_653_length_2965_cov_19.913468	109	178	22	2	69	0.0289855
NODE_653_length_2965_cov_19.913468	109	178	24	2	69	0.0289855
NODE_653_length_2965_cov_19.913468	109	178	26	1	69	0.0144928
NODE_653_length_2965_cov_19.913468	109	178	36	1	69	0.0144928
NODE_653_length_2965_cov_19.913468	109	178	48	1	69	0.0144928
NODE_653_length_2965_cov_19.913468	109	178	54	2	69	0.0289855
NODE_653_length_2965_cov_19.913468	109	178	56	1	69	0.0144928
NODE_653_length_2965_cov_19.913468	109	178	58	3	69	0.0434783
NODE_653_length_2965_cov_19.913468	109	178	0	8	69	0.1159420
NODE_653_length_2965_cov_19.913468	109	178	2	3	69	0.0434783
NODE_653_length_2965_cov_19.913468	109	178	4	4	69	0.0579710
NODE_653_length_2965_cov_19.913468	109	178	6	13	69	0.1884058
NODE_653_length_2965_cov_19.913468	109	178	10	2	69	0.0289855
NODE_653_length_2965_cov_19.913468	109	178	12	11	69	0.1594203
NODE_653_length_2965_cov_19.913468	109	178	14	9	69	0.1304348
NODE_653_length_2965_cov_19.913468	109	178	16	1	69	0.0144928
NODE_653_length_2965_cov_19.913468	109	178	18	2	69	0.0289855
NODE_653_length_2965_cov_19.913468	109	178	20	3	69	0.0434783
NODE_653_length_2965_cov_19.913468	109	178	22	2	69	0.0289855
NODE_653_length_2965_cov_19.913468	109	178	24	2	69	0.0289855
NODE_653_length_2965_cov_19.913468	109	178	26	1	69	0.0144928
NODE_653_length_2965_cov_19.913468	109	178	36	1	69	0.0144928
NODE_653_length_2965_cov_19.913468	109	178	48	1	69	0.0144928
NODE_653_length_2965_cov_19.913468	109	178	54	2	69	0.0289855
NODE_653_length_2965_cov_19.913468	109	178	56	1	69	0.0144928
NODE_653_length_2965_cov_19.913468	109	178	58	3	69	0.0434783
NODE_653_length_2965_cov_19.913468	2298	2378	0	80	80	1.0000000
NODE_653_length_2965_cov_19.913468	2351	2431	0	80	80	1.0000000
NODE_653_length_2965_cov_19.913468	2427	2507	0	54	80	0.6750000
NODE_653_length_2965_cov_19.913468	2427	2507	2	26	80	0.3250000
NODE_653_length_2965_cov_19.913468	2480	2560	0	1	80	0.0125000
NODE_653_length_2965_cov_19.913468	2480	2560	2	79	80	0.9875000
NODE_656_length_2960_cov_35.741699	459	539	0	80	80	1.0000000
NODE_656_length_2960_cov_35.741699	512	592	0	80	80	1.0000000
NODE_659_length_2951_cov_7.195652	1100	1141	176	1	41	0.0243902
NODE_659_length_2951_cov_7.195652	1100	1141	180	1	41	0.0243902
NODE_659_length_2951_cov_7.195652	1100	1141	188	1	41	0.0243902
NODE_659_length_2951_cov_7.195652	1100	1141	194	1	41	0.0243902
NODE_659_length_2951_cov_7.195652	1100	1141	202	1	41	0.0243902
NODE_659_length_2951_cov_7.195652	1100	1141	212	1	41	0.0243902
NODE_659_length_2951_cov_7.195652	1100	1141	216	1	41	0.0243902
NODE_659_length_2951_cov_7.195652	1100	1141	218	1	41	0.0243902
NODE_659_length_2951_cov_7.195652	1100	1141	219	1	41	0.0243902
NODE_659_length_2951_cov_7.195652	1100	1141	223	3	41	0.0731707
NODE_659_length_2951_cov_7.195652	1100	1141	225	1	41	0.0243902
NODE_659_length_2951_cov_7.195652	1100	1141	227	1	41	0.0243902
NODE_659_length_2951_cov_7.195652	1100	1141	234	1	41	0.0243902
NODE_659_length_2951_cov_7.195652	1100	1141	239	1	41	0.0243902
NODE_659_length_2951_cov_7.195652	1100	1141	241	4	41	0.0975610
NODE_659_length_2951_cov_7.195652	1100	1141	243	3	41	0.0731707
NODE_659_length_2951_cov_7.195652	1100	1141	247	1	41	0.0243902
NODE_659_length_2951_cov_7.195652	1100	1141	255	1	41	0.0243902
NODE_659_length_2951_cov_7.195652	1100	1141	257	1	41	0.0243902
NODE_659_length_2951_cov_7.195652	1100	1141	260	1	41	0.0243902
NODE_659_length_2951_cov_7.195652	1100	1141	261	1	41	0.0243902
NODE_659_length_2951_cov_7.195652	1100	1141	262	1	41	0.0243902
NODE_659_length_2951_cov_7.195652	1100	1141	268	1	41	0.0243902
NODE_659_length_2951_cov_7.195652	1100	1141	269	1	41	0.0243902
NODE_659_length_2951_cov_7.195652	1100	1141	270	1	41	0.0243902
NODE_659_length_2951_cov_7.195652	1100	1141	271	2	41	0.0487805
NODE_659_length_2951_cov_7.195652	1100	1141	273	1	41	0.0243902
NODE_659_length_2951_cov_7.195652	1100	1141	277	1	41	0.0243902
NODE_659_length_2951_cov_7.195652	1100	1141	285	1	41	0.0243902
NODE_659_length_2951_cov_7.195652	1100	1141	289	1	41	0.0243902
NODE_659_length_2951_cov_7.195652	1100	1141	292	1	41	0.0243902
NODE_659_length_2951_cov_7.195652	1100	1141	308	1	41	0.0243902
NODE_659_length_2951_cov_7.195652	1100	1141	310	1	41	0.0243902
NODE_665_length_2935_cov_37.693230	1492	1572	22	3	80	0.0375000
NODE_665_length_2935_cov_37.693230	1492	1572	24	5	80	0.0625000
NODE_665_length_2935_cov_37.693230	1492	1572	26	6	80	0.0750000
NODE_665_length_2935_cov_37.693230	1492	1572	28	15	80	0.1875000
NODE_665_length_2935_cov_37.693230	1492	1572	30	17	80	0.2125000
NODE_665_length_2935_cov_37.693230	1492	1572	32	15	80	0.1875000
NODE_665_length_2935_cov_37.693230	1492	1572	34	11	80	0.1375000
NODE_665_length_2935_cov_37.693230	1492	1572	36	8	80	0.1000000
NODE_665_length_2935_cov_37.693230	1534	1589	16	2	55	0.0363636
NODE_665_length_2935_cov_37.693230	1534	1589	18	6	55	0.1090909
NODE_665_length_2935_cov_37.693230	1534	1589	20	6	55	0.1090909
NODE_665_length_2935_cov_37.693230	1534	1589	22	2	55	0.0363636
NODE_665_length_2935_cov_37.693230	1534	1589	24	6	55	0.1090909
NODE_665_length_2935_cov_37.693230	1534	1589	26	3	55	0.0545455
NODE_665_length_2935_cov_37.693230	1534	1589	28	7	55	0.1272727
NODE_665_length_2935_cov_37.693230	1534	1589	30	16	55	0.2909091
NODE_665_length_2935_cov_37.693230	1534	1589	32	7	55	0.1272727
NODE_665_length_2935_cov_37.693230	1545	1619	0	2	74	0.0270270
NODE_665_length_2935_cov_37.693230	1545	1619	2	1	74	0.0135135
NODE_665_length_2935_cov_37.693230	1545	1619	6	12	74	0.1621622
NODE_665_length_2935_cov_37.693230	1545	1619	8	2	74	0.0270270
NODE_665_length_2935_cov_37.693230	1545	1619	12	10	74	0.1351351
NODE_665_length_2935_cov_37.693230	1545	1619	14	1	74	0.0135135
NODE_665_length_2935_cov_37.693230	1545	1619	16	4	74	0.0540541
NODE_665_length_2935_cov_37.693230	1545	1619	18	6	74	0.0810811
NODE_665_length_2935_cov_37.693230	1545	1619	20	6	74	0.0810811
NODE_665_length_2935_cov_37.693230	1545	1619	22	2	74	0.0270270
NODE_665_length_2935_cov_37.693230	1545	1619	24	6	74	0.0810811
NODE_665_length_2935_cov_37.693230	1545	1619	26	3	74	0.0405405
NODE_665_length_2935_cov_37.693230	1545	1619	28	7	74	0.0945946
NODE_665_length_2935_cov_37.693230	1545	1619	30	12	74	0.1621622
NODE_665_length_2935_cov_37.693230	1625	1701	0	76	76	1.0000000
NODE_665_length_2935_cov_37.693230	2863	2906	0	37	43	0.8604651
NODE_665_length_2935_cov_37.693230	2863	2906	2	6	43	0.1395349
NODE_675_length_2913_cov_4.376688	2664	2739	0	75	75	1.0000000
NODE_675_length_2913_cov_4.376688	2664	2723	0	59	59	1.0000000
NODE_675_length_2913_cov_4.376688	2664	2739	0	75	75	1.0000000
NODE_675_length_2913_cov_4.376688	2664	2739	0	75	75	1.0000000
NODE_675_length_2913_cov_4.376688	2673	2739	0	66	66	1.0000000
NODE_675_length_2913_cov_4.376688	2717	2780	0	63	63	1.0000000
NODE_675_length_2913_cov_4.376688	2745	2778	0	33	33	1.0000000
NODE_677_length_2909_cov_71.975089	2090	2174	14	1	84	0.0119048
NODE_677_length_2909_cov_71.975089	2090	2174	16	3	84	0.0357143
NODE_677_length_2909_cov_71.975089	2090	2174	18	3	84	0.0357143
NODE_677_length_2909_cov_71.975089	2090	2174	19	2	84	0.0238095
NODE_677_length_2909_cov_71.975089	2090	2174	22	1	84	0.0119048
NODE_677_length_2909_cov_71.975089	2090	2174	24	1	84	0.0119048
NODE_677_length_2909_cov_71.975089	2090	2174	25	12	84	0.1428571
NODE_677_length_2909_cov_71.975089	2090	2174	30	2	84	0.0238095
NODE_677_length_2909_cov_71.975089	2090	2174	31	1	84	0.0119048
NODE_677_length_2909_cov_71.975089	2090	2174	32	9	84	0.1071429
NODE_677_length_2909_cov_71.975089	2090	2174	33	2	84	0.0238095
NODE_677_length_2909_cov_71.975089	2090	2174	34	1	84	0.0119048
NODE_677_length_2909_cov_71.975089	2090	2174	35	1	84	0.0119048
NODE_677_length_2909_cov_71.975089	2090	2174	36	1	84	0.0119048
NODE_677_length_2909_cov_71.975089	2090	2174	41	1	84	0.0119048
NODE_677_length_2909_cov_71.975089	2090	2174	43	1	84	0.0119048
NODE_677_length_2909_cov_71.975089	2090	2174	44	1	84	0.0119048
NODE_677_length_2909_cov_71.975089	2090	2174	48	4	84	0.0476190
NODE_677_length_2909_cov_71.975089	2090	2174	51	2	84	0.0238095
NODE_677_length_2909_cov_71.975089	2090	2174	58	1	84	0.0119048
NODE_677_length_2909_cov_71.975089	2090	2174	64	1	84	0.0119048
NODE_677_length_2909_cov_71.975089	2090	2174	68	1	84	0.0119048
NODE_677_length_2909_cov_71.975089	2090	2174	81	1	84	0.0119048
NODE_677_length_2909_cov_71.975089	2090	2174	83	1	84	0.0119048
NODE_677_length_2909_cov_71.975089	2090	2174	85	2	84	0.0238095
NODE_677_length_2909_cov_71.975089	2090	2174	89	1	84	0.0119048
NODE_677_length_2909_cov_71.975089	2090	2174	91	2	84	0.0238095
NODE_677_length_2909_cov_71.975089	2090	2174	93	1	84	0.0119048
NODE_677_length_2909_cov_71.975089	2090	2174	99	1	84	0.0119048
NODE_677_length_2909_cov_71.975089	2090	2174	101	1	84	0.0119048
NODE_677_length_2909_cov_71.975089	2090	2174	104	1	84	0.0119048
NODE_677_length_2909_cov_71.975089	2090	2174	111	1	84	0.0119048
NODE_677_length_2909_cov_71.975089	2090	2174	115	5	84	0.0595238
NODE_677_length_2909_cov_71.975089	2090	2174	118	1	84	0.0119048
NODE_677_length_2909_cov_71.975089	2090	2174	129	1	84	0.0119048
NODE_677_length_2909_cov_71.975089	2090	2174	133	2	84	0.0238095
NODE_677_length_2909_cov_71.975089	2090	2174	134	2	84	0.0238095
NODE_677_length_2909_cov_71.975089	2090	2174	136	1	84	0.0119048
NODE_677_length_2909_cov_71.975089	2090	2174	142	1	84	0.0119048
NODE_677_length_2909_cov_71.975089	2090	2174	145	4	84	0.0476190
NODE_677_length_2909_cov_71.975089	2090	2174	146	2	84	0.0238095
NODE_677_length_2909_cov_71.975089	2090	2174	147	1	84	0.0119048
NODE_678_length_2908_cov_5.937344	2495	2575	4	9	80	0.1125000
NODE_678_length_2908_cov_5.937344	2495	2575	6	51	80	0.6375000
NODE_678_length_2908_cov_5.937344	2495	2575	8	20	80	0.2500000
NODE_678_length_2908_cov_5.937344	2548	2628	2	34	80	0.4250000
NODE_678_length_2908_cov_5.937344	2548	2628	4	6	80	0.0750000
NODE_678_length_2908_cov_5.937344	2548	2628	6	12	80	0.1500000
NODE_678_length_2908_cov_5.937344	2548	2628	8	28	80	0.3500000
NODE_678_length_2908_cov_5.937344	2624	2704	0	70	80	0.8750000
NODE_678_length_2908_cov_5.937344	2624	2704	2	10	80	0.1250000
NODE_678_length_2908_cov_5.937344	2677	2757	0	23	80	0.2875000
NODE_678_length_2908_cov_5.937344	2677	2757	2	19	80	0.2375000
NODE_678_length_2908_cov_5.937344	2677	2757	4	38	80	0.4750000
NODE_679_length_2905_cov_12.777619	2358	2419	0	57	61	0.9344262
NODE_679_length_2905_cov_12.777619	2358	2419	2	1	61	0.0163934
NODE_679_length_2905_cov_12.777619	2358	2419	4	1	61	0.0163934
NODE_679_length_2905_cov_12.777619	2358	2419	6	2	61	0.0327869
NODE_679_length_2905_cov_12.777619	2358	2419	0	57	61	0.9344262
NODE_679_length_2905_cov_12.777619	2358	2419	2	1	61	0.0163934
NODE_679_length_2905_cov_12.777619	2358	2419	4	1	61	0.0163934
NODE_679_length_2905_cov_12.777619	2358	2419	6	2	61	0.0327869
NODE_679_length_2905_cov_12.777619	2358	2419	0	57	61	0.9344262
NODE_679_length_2905_cov_12.777619	2358	2419	2	1	61	0.0163934
NODE_679_length_2905_cov_12.777619	2358	2419	4	1	61	0.0163934
NODE_679_length_2905_cov_12.777619	2358	2419	6	2	61	0.0327869
NODE_679_length_2905_cov_12.777619	2392	2472	0	80	80	1.0000000
NODE_680_length_2903_cov_5.474322	2423	2464	23	14	41	0.3414634
NODE_680_length_2903_cov_5.474322	2423	2464	25	25	41	0.6097561
NODE_680_length_2903_cov_5.474322	2423	2464	26	2	41	0.0487805
NODE_684_length_2898_cov_5.786352	0	74	0	40	74	0.5405405
NODE_684_length_2898_cov_5.786352	0	74	2	34	74	0.4594595
NODE_684_length_2898_cov_5.786352	47	124	0	6	77	0.0779221
NODE_684_length_2898_cov_5.786352	47	124	2	71	77	0.9220779
NODE_686_length_2895_cov_8.519313	869	949	0	23	80	0.2875000
NODE_686_length_2895_cov_8.519313	869	949	2	47	80	0.5875000
NODE_686_length_2895_cov_8.519313	869	949	4	10	80	0.1250000
NODE_686_length_2895_cov_8.519313	922	1002	2	17	80	0.2125000
NODE_686_length_2895_cov_8.519313	922	1002	4	22	80	0.2750000
NODE_686_length_2895_cov_8.519313	922	1002	6	33	80	0.4125000
NODE_686_length_2895_cov_8.519313	922	1002	8	8	80	0.1000000
NODE_688_length_2894_cov_2.036136	2677	2757	22	7	80	0.0875000
NODE_688_length_2894_cov_2.036136	2677	2757	26	22	80	0.2750000
NODE_688_length_2894_cov_2.036136	2677	2757	27	1	80	0.0125000
NODE_688_length_2894_cov_2.036136	2677	2757	28	21	80	0.2625000
NODE_688_length_2894_cov_2.036136	2677	2757	30	29	80	0.3625000
NODE_689_length_2891_cov_7.938037	193	275	0	19	82	0.2317073
NODE_689_length_2891_cov_7.938037	193	275	2	8	82	0.0975610
NODE_689_length_2891_cov_7.938037	193	275	4	1	82	0.0121951
NODE_689_length_2891_cov_7.938037	193	275	6	17	82	0.2073171
NODE_689_length_2891_cov_7.938037	193	275	8	5	82	0.0609756
NODE_689_length_2891_cov_7.938037	193	275	10	3	82	0.0365854
NODE_689_length_2891_cov_7.938037	193	275	16	9	82	0.1097561
NODE_689_length_2891_cov_7.938037	193	275	18	1	82	0.0121951
NODE_689_length_2891_cov_7.938037	193	275	20	3	82	0.0365854
NODE_689_length_2891_cov_7.938037	193	275	22	9	82	0.1097561
NODE_689_length_2891_cov_7.938037	193	275	24	6	82	0.0731707
NODE_689_length_2891_cov_7.938037	193	275	32	1	82	0.0121951
NODE_691_length_2889_cov_11.426882	407	487	2	2	80	0.0250000
NODE_691_length_2889_cov_11.426882	407	487	3	47	80	0.5875000
NODE_691_length_2889_cov_11.426882	407	487	4	31	80	0.3875000
NODE_691_length_2889_cov_11.426882	460	540	3	54	80	0.6750000
NODE_691_length_2889_cov_11.426882	460	540	4	26	80	0.3250000
NODE_691_length_2889_cov_11.426882	1006	1086	4	1	80	0.0125000
NODE_691_length_2889_cov_11.426882	1006	1086	10	9	80	0.1125000
NODE_691_length_2889_cov_11.426882	1006	1086	12	5	80	0.0625000
NODE_691_length_2889_cov_11.426882	1006	1086	14	2	80	0.0250000
NODE_691_length_2889_cov_11.426882	1006	1086	16	2	80	0.0250000
NODE_691_length_2889_cov_11.426882	1006	1086	18	5	80	0.0625000
NODE_691_length_2889_cov_11.426882	1006	1086	20	6	80	0.0750000
NODE_691_length_2889_cov_11.426882	1006	1086	22	2	80	0.0250000
NODE_691_length_2889_cov_11.426882	1006	1086	24	3	80	0.0375000
NODE_691_length_2889_cov_11.426882	1006	1086	26	36	80	0.4500000
NODE_691_length_2889_cov_11.426882	1006	1086	28	9	80	0.1125000
NODE_691_length_2889_cov_11.426882	1007	1086	4	1	79	0.0126582
NODE_691_length_2889_cov_11.426882	1007	1086	10	9	79	0.1139240
NODE_691_length_2889_cov_11.426882	1007	1086	12	5	79	0.0632911
NODE_691_length_2889_cov_11.426882	1007	1086	14	2	79	0.0253165
NODE_691_length_2889_cov_11.426882	1007	1086	16	2	79	0.0253165
NODE_691_length_2889_cov_11.426882	1007	1086	18	5	79	0.0632911
NODE_691_length_2889_cov_11.426882	1007	1086	20	6	79	0.0759494
NODE_691_length_2889_cov_11.426882	1007	1086	22	2	79	0.0253165
NODE_691_length_2889_cov_11.426882	1007	1086	24	3	79	0.0379747
NODE_691_length_2889_cov_11.426882	1007	1086	26	36	79	0.4556962
NODE_691_length_2889_cov_11.426882	1007	1086	28	8	79	0.1012658
NODE_691_length_2889_cov_11.426882	1059	1138	0	47	79	0.5949367
NODE_691_length_2889_cov_11.426882	1059	1138	4	6	79	0.0759494
NODE_691_length_2889_cov_11.426882	1059	1138	10	9	79	0.1139240
NODE_691_length_2889_cov_11.426882	1059	1138	12	5	79	0.0632911
NODE_691_length_2889_cov_11.426882	1059	1138	14	2	79	0.0253165
NODE_691_length_2889_cov_11.426882	1059	1138	16	2	79	0.0253165
NODE_691_length_2889_cov_11.426882	1059	1138	18	5	79	0.0632911
NODE_691_length_2889_cov_11.426882	1059	1138	20	3	79	0.0379747
NODE_691_length_2889_cov_11.426882	1059	1138	0	47	79	0.5949367
NODE_691_length_2889_cov_11.426882	1059	1138	4	6	79	0.0759494
NODE_691_length_2889_cov_11.426882	1059	1138	10	9	79	0.1139240
NODE_691_length_2889_cov_11.426882	1059	1138	12	5	79	0.0632911
NODE_691_length_2889_cov_11.426882	1059	1138	14	2	79	0.0253165
NODE_691_length_2889_cov_11.426882	1059	1138	16	2	79	0.0253165
NODE_691_length_2889_cov_11.426882	1059	1138	18	5	79	0.0632911
NODE_691_length_2889_cov_11.426882	1059	1138	20	3	79	0.0379747
NODE_693_length_2888_cov_3.789172	992	1072	0	80	80	1.0000000
NODE_693_length_2888_cov_3.789172	1045	1087	0	42	42	1.0000000
NODE_697_length_2878_cov_6.277798	2712	2781	0	33	69	0.4782609
NODE_697_length_2878_cov_6.277798	2712	2781	2	13	69	0.1884058
NODE_697_length_2878_cov_6.277798	2712	2781	4	6	69	0.0869565
NODE_697_length_2878_cov_6.277798	2712	2781	6	17	69	0.2463768
NODE_703_length_2862_cov_9.060803	2409	2489	2	34	80	0.4250000
NODE_703_length_2862_cov_9.060803	2409	2489	3	8	80	0.1000000
NODE_703_length_2862_cov_9.060803	2409	2489	4	26	80	0.3250000
NODE_703_length_2862_cov_9.060803	2409	2489	5	12	80	0.1500000
NODE_703_length_2862_cov_9.060803	2462	2542	2	7	80	0.0875000
NODE_703_length_2862_cov_9.060803	2462	2542	3	61	80	0.7625000
NODE_703_length_2862_cov_9.060803	2462	2542	5	12	80	0.1500000
NODE_712_length_2840_cov_2.079533	1660	1740	0	80	80	1.0000000
NODE_713_length_2839_cov_16.762044	327	402	0	75	75	1.0000000
NODE_713_length_2839_cov_16.762044	380	468	0	88	88	1.0000000
NODE_713_length_2839_cov_16.762044	1021	1101	0	49	80	0.6125000
NODE_713_length_2839_cov_16.762044	1021	1101	2	31	80	0.3875000
NODE_713_length_2839_cov_16.762044	1074	1154	0	8	80	0.1000000
NODE_713_length_2839_cov_16.762044	1074	1154	2	72	80	0.9000000
NODE_714_length_2835_cov_29.691520	1552	1581	82	3	29	0.1034483
NODE_714_length_2835_cov_29.691520	1552	1581	88	1	29	0.0344828
NODE_714_length_2835_cov_29.691520	1552	1581	94	3	29	0.1034483
NODE_714_length_2835_cov_29.691520	1552	1581	98	1	29	0.0344828
NODE_714_length_2835_cov_29.691520	1552	1581	100	6	29	0.2068966
NODE_714_length_2835_cov_29.691520	1552	1581	102	2	29	0.0689655
NODE_714_length_2835_cov_29.691520	1552	1581	104	1	29	0.0344828
NODE_714_length_2835_cov_29.691520	1552	1581	106	6	29	0.2068966
NODE_714_length_2835_cov_29.691520	1552	1581	108	1	29	0.0344828
NODE_714_length_2835_cov_29.691520	1552	1581	110	4	29	0.1379310
NODE_714_length_2835_cov_29.691520	1552	1581	112	1	29	0.0344828
NODE_714_length_2835_cov_29.691520	1554	1629	18	2	75	0.0266667
NODE_714_length_2835_cov_29.691520	1554	1629	19	1	75	0.0133333
NODE_714_length_2835_cov_29.691520	1554	1629	20	2	75	0.0266667
NODE_714_length_2835_cov_29.691520	1554	1629	22	2	75	0.0266667
NODE_714_length_2835_cov_29.691520	1554	1629	26	2	75	0.0266667
NODE_714_length_2835_cov_29.691520	1554	1629	28	1	75	0.0133333
NODE_714_length_2835_cov_29.691520	1554	1629	32	3	75	0.0400000
NODE_714_length_2835_cov_29.691520	1554	1629	38	4	75	0.0533333
NODE_714_length_2835_cov_29.691520	1554	1629	45	3	75	0.0400000
NODE_714_length_2835_cov_29.691520	1554	1629	51	2	75	0.0266667
NODE_714_length_2835_cov_29.691520	1554	1629	55	3	75	0.0400000
NODE_714_length_2835_cov_29.691520	1554	1629	56	2	75	0.0266667
NODE_714_length_2835_cov_29.691520	1554	1629	58	3	75	0.0400000
NODE_714_length_2835_cov_29.691520	1554	1629	62	1	75	0.0133333
NODE_714_length_2835_cov_29.691520	1554	1629	64	9	75	0.1200000
NODE_714_length_2835_cov_29.691520	1554	1629	70	1	75	0.0133333
NODE_714_length_2835_cov_29.691520	1554	1629	76	2	75	0.0266667
NODE_714_length_2835_cov_29.691520	1554	1629	78	2	75	0.0266667
NODE_714_length_2835_cov_29.691520	1554	1629	82	6	75	0.0800000
NODE_714_length_2835_cov_29.691520	1554	1629	88	1	75	0.0133333
NODE_714_length_2835_cov_29.691520	1554	1629	94	3	75	0.0400000
NODE_714_length_2835_cov_29.691520	1554	1629	98	1	75	0.0133333
NODE_714_length_2835_cov_29.691520	1554	1629	100	6	75	0.0800000
NODE_714_length_2835_cov_29.691520	1554	1629	102	2	75	0.0266667
NODE_714_length_2835_cov_29.691520	1554	1629	104	1	75	0.0133333
NODE_714_length_2835_cov_29.691520	1554	1629	106	6	75	0.0800000
NODE_714_length_2835_cov_29.691520	1554	1629	108	1	75	0.0133333
NODE_714_length_2835_cov_29.691520	1554	1629	110	3	75	0.0400000
NODE_720_length_2825_cov_9.731108	487	567	0	37	80	0.4625000
NODE_720_length_2825_cov_9.731108	487	567	2	7	80	0.0875000
NODE_720_length_2825_cov_9.731108	487	567	4	36	80	0.4500000
NODE_720_length_2825_cov_9.731108	540	620	0	80	80	1.0000000
NODE_726_length_2810_cov_2.844338	206	289	24	3	83	0.0361446
NODE_726_length_2810_cov_2.844338	206	289	26	2	83	0.0240964
NODE_726_length_2810_cov_2.844338	206	289	32	1	83	0.0120482
NODE_726_length_2810_cov_2.844338	206	289	42	1	83	0.0120482
NODE_726_length_2810_cov_2.844338	206	289	44	1	83	0.0120482
NODE_726_length_2810_cov_2.844338	206	289	46	1	83	0.0120482
NODE_726_length_2810_cov_2.844338	206	289	50	3	83	0.0361446
NODE_726_length_2810_cov_2.844338	206	289	52	3	83	0.0361446
NODE_726_length_2810_cov_2.844338	206	289	56	4	83	0.0481928
NODE_726_length_2810_cov_2.844338	206	289	58	9	83	0.1084337
NODE_726_length_2810_cov_2.844338	206	289	60	3	83	0.0361446
NODE_726_length_2810_cov_2.844338	206	289	62	13	83	0.1566265
NODE_726_length_2810_cov_2.844338	206	289	68	3	83	0.0361446
NODE_726_length_2810_cov_2.844338	206	289	76	2	83	0.0240964
NODE_726_length_2810_cov_2.844338	206	289	78	4	83	0.0481928
NODE_726_length_2810_cov_2.844338	206	289	80	6	83	0.0722892
NODE_726_length_2810_cov_2.844338	206	289	82	2	83	0.0240964
NODE_726_length_2810_cov_2.844338	206	289	84	1	83	0.0120482
NODE_726_length_2810_cov_2.844338	206	289	86	5	83	0.0602410
NODE_726_length_2810_cov_2.844338	206	289	88	1	83	0.0120482
NODE_726_length_2810_cov_2.844338	206	289	90	3	83	0.0361446
NODE_726_length_2810_cov_2.844338	206	289	98	1	83	0.0120482
NODE_726_length_2810_cov_2.844338	206	289	102	5	83	0.0602410
NODE_726_length_2810_cov_2.844338	206	289	118	5	83	0.0602410
NODE_726_length_2810_cov_2.844338	206	289	120	1	83	0.0120482
NODE_728_length_2808_cov_2.867110	140	163	15	2	23	0.0869565
NODE_728_length_2808_cov_2.867110	140	163	17	3	23	0.1304348
NODE_728_length_2808_cov_2.867110	140	163	19	18	23	0.7826087
NODE_729_length_2807_cov_8.423191	125	205	6	17	80	0.2125000
NODE_729_length_2807_cov_8.423191	125	205	8	17	80	0.2125000
NODE_729_length_2807_cov_8.423191	125	205	10	26	80	0.3250000
NODE_729_length_2807_cov_8.423191	125	205	12	20	80	0.2500000
NODE_729_length_2807_cov_8.423191	178	258	4	6	80	0.0750000
NODE_729_length_2807_cov_8.423191	178	258	6	23	80	0.2875000
NODE_729_length_2807_cov_8.423191	178	258	10	14	80	0.1750000
NODE_729_length_2807_cov_8.423191	178	258	11	4	80	0.0500000
NODE_729_length_2807_cov_8.423191	178	258	12	33	80	0.4125000
NODE_729_length_2807_cov_8.423191	2451	2515	0	10	64	0.1562500
NODE_729_length_2807_cov_8.423191	2451	2515	2	54	64	0.8437500
NODE_735_length_2801_cov_26.131384	461	521	10	29	60	0.4833333
NODE_735_length_2801_cov_26.131384	461	521	13	1	60	0.0166667
NODE_735_length_2801_cov_26.131384	461	521	14	30	60	0.5000000
NODE_735_length_2801_cov_26.131384	494	574	0	15	80	0.1875000
NODE_735_length_2801_cov_26.131384	494	574	2	21	80	0.2625000
NODE_735_length_2801_cov_26.131384	494	574	4	4	80	0.0500000
NODE_735_length_2801_cov_26.131384	494	574	8	1	80	0.0125000
NODE_735_length_2801_cov_26.131384	494	574	10	33	80	0.4125000
NODE_735_length_2801_cov_26.131384	494	574	13	1	80	0.0125000
NODE_735_length_2801_cov_26.131384	494	574	14	5	80	0.0625000
NODE_735_length_2801_cov_26.131384	1536	1596	25	3	60	0.0500000
NODE_735_length_2801_cov_26.131384	1536	1596	26	7	60	0.1166667
NODE_735_length_2801_cov_26.131384	1536	1596	30	2	60	0.0333333
NODE_735_length_2801_cov_26.131384	1536	1596	36	2	60	0.0333333
NODE_735_length_2801_cov_26.131384	1536	1596	46	2	60	0.0333333
NODE_735_length_2801_cov_26.131384	1536	1596	48	1	60	0.0166667
NODE_735_length_2801_cov_26.131384	1536	1596	50	3	60	0.0500000
NODE_735_length_2801_cov_26.131384	1536	1596	52	1	60	0.0166667
NODE_735_length_2801_cov_26.131384	1536	1596	56	1	60	0.0166667
NODE_735_length_2801_cov_26.131384	1536	1596	58	6	60	0.1000000
NODE_735_length_2801_cov_26.131384	1536	1596	64	1	60	0.0166667
NODE_735_length_2801_cov_26.131384	1536	1596	67	1	60	0.0166667
NODE_735_length_2801_cov_26.131384	1536	1596	68	2	60	0.0333333
NODE_735_length_2801_cov_26.131384	1536	1596	70	2	60	0.0333333
NODE_735_length_2801_cov_26.131384	1536	1596	72	6	60	0.1000000
NODE_735_length_2801_cov_26.131384	1536	1596	74	9	60	0.1500000
NODE_735_length_2801_cov_26.131384	1536	1596	76	6	60	0.1000000
NODE_735_length_2801_cov_26.131384	1536	1596	78	5	60	0.0833333
NODE_735_length_2801_cov_26.131384	1815	1881	0	66	66	1.0000000
NODE_735_length_2801_cov_26.131384	1854	1934	0	31	80	0.3875000
NODE_735_length_2801_cov_26.131384	1854	1934	2	49	80	0.6125000
NODE_736_length_2801_cov_3.594375	2589	2645	4	55	56	0.9821429
NODE_736_length_2801_cov_3.594375	2589	2645	5	1	56	0.0178571
NODE_738_length_2796_cov_94.511680	1090	1137	10	7	47	0.1489362
NODE_738_length_2796_cov_94.511680	1090	1137	14	1	47	0.0212766
NODE_738_length_2796_cov_94.511680	1090	1137	18	1	47	0.0212766
NODE_738_length_2796_cov_94.511680	1090	1137	20	2	47	0.0425532
NODE_738_length_2796_cov_94.511680	1090	1137	29	1	47	0.0212766
NODE_738_length_2796_cov_94.511680	1090	1137	30	9	47	0.1914894
NODE_738_length_2796_cov_94.511680	1090	1137	32	2	47	0.0425532
NODE_738_length_2796_cov_94.511680	1090	1137	34	1	47	0.0212766
NODE_738_length_2796_cov_94.511680	1090	1137	38	1	47	0.0212766
NODE_738_length_2796_cov_94.511680	1090	1137	41	1	47	0.0212766
NODE_738_length_2796_cov_94.511680	1090	1137	42	3	47	0.0638298
NODE_738_length_2796_cov_94.511680	1090	1137	44	2	47	0.0425532
NODE_738_length_2796_cov_94.511680	1090	1137	48	1	47	0.0212766
NODE_738_length_2796_cov_94.511680	1090	1137	50	5	47	0.1063830
NODE_738_length_2796_cov_94.511680	1090	1137	54	2	47	0.0425532
NODE_738_length_2796_cov_94.511680	1090	1137	62	1	47	0.0212766
NODE_738_length_2796_cov_94.511680	1090	1137	64	1	47	0.0212766
NODE_738_length_2796_cov_94.511680	1090	1137	66	1	47	0.0212766
NODE_738_length_2796_cov_94.511680	1090	1137	72	1	47	0.0212766
NODE_738_length_2796_cov_94.511680	1090	1137	78	1	47	0.0212766
NODE_738_length_2796_cov_94.511680	1090	1137	82	1	47	0.0212766
NODE_738_length_2796_cov_94.511680	1090	1137	86	1	47	0.0212766
NODE_738_length_2796_cov_94.511680	1090	1137	90	1	47	0.0212766
NODE_738_length_2796_cov_94.511680	2717	2796	0	79	79	1.0000000
NODE_744_length_2791_cov_9.997028	310	390	0	28	80	0.3500000
NODE_744_length_2791_cov_9.997028	310	390	2	15	80	0.1875000
NODE_744_length_2791_cov_9.997028	310	390	4	37	80	0.4625000
NODE_744_length_2791_cov_9.997028	363	443	2	36	80	0.4500000
NODE_744_length_2791_cov_9.997028	363	443	4	44	80	0.5500000
NODE_752_length_2778_cov_31.340799	2241	2321	2	14	80	0.1750000
NODE_752_length_2778_cov_31.340799	2241	2321	4	66	80	0.8250000
NODE_752_length_2778_cov_31.340799	2294	2374	0	29	80	0.3625000
NODE_752_length_2778_cov_31.340799	2294	2374	2	27	80	0.3375000
NODE_752_length_2778_cov_31.340799	2294	2374	4	24	80	0.3000000
NODE_752_length_2778_cov_31.340799	2370	2450	0	8	80	0.1000000
NODE_752_length_2778_cov_31.340799	2370	2450	2	3	80	0.0375000
NODE_752_length_2778_cov_31.340799	2370	2450	4	69	80	0.8625000
NODE_752_length_2778_cov_31.340799	2423	2503	0	34	80	0.4250000
NODE_752_length_2778_cov_31.340799	2423	2503	2	19	80	0.2375000
NODE_752_length_2778_cov_31.340799	2423	2503	4	27	80	0.3375000
NODE_752_length_2778_cov_31.340799	2564	2620	0	29	56	0.5178571
NODE_752_length_2778_cov_31.340799	2564	2620	2	27	56	0.4821429
NODE_758_length_2767_cov_12.450150	1941	2021	0	80	80	1.0000000
NODE_758_length_2767_cov_12.450150	1994	2074	0	80	80	1.0000000
NODE_767_length_2745_cov_5.322751	511	583	0	72	72	1.0000000
NODE_777_length_2720_cov_25.561618	2213	2293	0	80	80	1.0000000
NODE_777_length_2720_cov_25.561618	2266	2346	0	80	80	1.0000000
NODE_782_length_2716_cov_39.885747	715	795	4	3	80	0.0375000
NODE_782_length_2716_cov_39.885747	715	795	6	4	80	0.0500000
NODE_782_length_2716_cov_39.885747	715	795	10	2	80	0.0250000
NODE_782_length_2716_cov_39.885747	715	795	12	8	80	0.1000000
NODE_782_length_2716_cov_39.885747	715	795	14	25	80	0.3125000
NODE_782_length_2716_cov_39.885747	715	795	16	7	80	0.0875000
NODE_782_length_2716_cov_39.885747	715	795	18	31	80	0.3875000
NODE_782_length_2716_cov_39.885747	768	848	4	24	80	0.3000000
NODE_782_length_2716_cov_39.885747	768	848	6	28	80	0.3500000
NODE_782_length_2716_cov_39.885747	768	848	8	8	80	0.1000000
NODE_782_length_2716_cov_39.885747	768	848	10	2	80	0.0250000
NODE_782_length_2716_cov_39.885747	768	848	12	8	80	0.1000000
NODE_782_length_2716_cov_39.885747	768	848	14	10	80	0.1250000
NODE_782_length_2716_cov_39.885747	844	924	6	30	80	0.3750000
NODE_782_length_2716_cov_39.885747	844	924	8	50	80	0.6250000
NODE_782_length_2716_cov_39.885747	897	977	2	8	80	0.1000000
NODE_782_length_2716_cov_39.885747	897	977	4	39	80	0.4875000
NODE_782_length_2716_cov_39.885747	897	977	6	21	80	0.2625000
NODE_782_length_2716_cov_39.885747	897	977	8	12	80	0.1500000
NODE_785_length_2710_cov_10.896974	2410	2446	0	36	36	1.0000000
NODE_785_length_2710_cov_10.896974	2419	2499	0	30	80	0.3750000
NODE_785_length_2710_cov_10.896974	2419	2499	2	32	80	0.4000000
NODE_785_length_2710_cov_10.896974	2419	2499	6	18	80	0.2250000
NODE_788_length_2708_cov_25.097355	2289	2369	0	80	80	1.0000000
NODE_788_length_2708_cov_25.097355	2342	2422	0	80	80	1.0000000
NODE_789_length_2708_cov_14.569950	18	98	94	1	80	0.0125000
NODE_789_length_2708_cov_14.569950	18	98	99	1	80	0.0125000
NODE_789_length_2708_cov_14.569950	18	98	100	1	80	0.0125000
NODE_789_length_2708_cov_14.569950	18	98	102	1	80	0.0125000
NODE_789_length_2708_cov_14.569950	18	98	106	1	80	0.0125000
NODE_789_length_2708_cov_14.569950	18	98	108	5	80	0.0625000
NODE_789_length_2708_cov_14.569950	18	98	112	3	80	0.0375000
NODE_789_length_2708_cov_14.569950	18	98	114	1	80	0.0125000
NODE_789_length_2708_cov_14.569950	18	98	116	1	80	0.0125000
NODE_789_length_2708_cov_14.569950	18	98	118	65	80	0.8125000
NODE_789_length_2708_cov_14.569950	71	134	8	1	63	0.0158730
NODE_789_length_2708_cov_14.569950	71	134	20	1	63	0.0158730
NODE_789_length_2708_cov_14.569950	71	134	34	1	63	0.0158730
NODE_789_length_2708_cov_14.569950	71	134	44	1	63	0.0158730
NODE_789_length_2708_cov_14.569950	71	134	48	1	63	0.0158730
NODE_789_length_2708_cov_14.569950	71	134	54	1	63	0.0158730
NODE_789_length_2708_cov_14.569950	71	134	60	1	63	0.0158730
NODE_789_length_2708_cov_14.569950	71	134	66	1	63	0.0158730
NODE_789_length_2708_cov_14.569950	71	134	68	1	63	0.0158730
NODE_789_length_2708_cov_14.569950	71	134	72	1	63	0.0158730
NODE_789_length_2708_cov_14.569950	71	134	74	1	63	0.0158730
NODE_789_length_2708_cov_14.569950	71	134	84	1	63	0.0158730
NODE_789_length_2708_cov_14.569950	71	134	86	3	63	0.0476190
NODE_789_length_2708_cov_14.569950	71	134	92	1	63	0.0158730
NODE_789_length_2708_cov_14.569950	71	134	98	1	63	0.0158730
NODE_789_length_2708_cov_14.569950	71	134	100	3	63	0.0476190
NODE_789_length_2708_cov_14.569950	71	134	102	1	63	0.0158730
NODE_789_length_2708_cov_14.569950	71	134	104	2	63	0.0317460
NODE_789_length_2708_cov_14.569950	71	134	108	1	63	0.0158730
NODE_789_length_2708_cov_14.569950	71	134	110	1	63	0.0158730
NODE_789_length_2708_cov_14.569950	71	134	112	3	63	0.0476190
NODE_789_length_2708_cov_14.569950	71	134	114	3	63	0.0476190
NODE_789_length_2708_cov_14.569950	71	134	118	32	63	0.5079365
NODE_797_length_2691_cov_35.457948	401	481	0	80	80	1.0000000
NODE_797_length_2691_cov_35.457948	454	534	0	80	80	1.0000000
NODE_803_length_2684_cov_17.345068	146	194	0	31	48	0.6458333
NODE_803_length_2684_cov_17.345068	146	194	2	17	48	0.3541667
NODE_803_length_2684_cov_17.345068	146	194	0	31	48	0.6458333
NODE_803_length_2684_cov_17.345068	146	194	2	17	48	0.3541667
NODE_803_length_2684_cov_17.345068	146	194	0	31	48	0.6458333
NODE_803_length_2684_cov_17.345068	146	194	2	17	48	0.3541667
NODE_803_length_2684_cov_17.345068	146	194	0	31	48	0.6458333
NODE_803_length_2684_cov_17.345068	146	194	2	17	48	0.3541667
NODE_803_length_2684_cov_17.345068	146	194	0	31	48	0.6458333
NODE_803_length_2684_cov_17.345068	146	194	2	17	48	0.3541667
NODE_805_length_2682_cov_43.500581	913	992	267	1	79	0.0126582
NODE_805_length_2682_cov_43.500581	913	992	269	2	79	0.0253165
NODE_805_length_2682_cov_43.500581	913	992	271	3	79	0.0379747
NODE_805_length_2682_cov_43.500581	913	992	273	1	79	0.0126582
NODE_805_length_2682_cov_43.500581	913	992	275	1	79	0.0126582
NODE_805_length_2682_cov_43.500581	913	992	280	2	79	0.0253165
NODE_805_length_2682_cov_43.500581	913	992	283	1	79	0.0126582
NODE_805_length_2682_cov_43.500581	913	992	288	1	79	0.0126582
NODE_805_length_2682_cov_43.500581	913	992	290	1	79	0.0126582
NODE_805_length_2682_cov_43.500581	913	992	297	1	79	0.0126582
NODE_805_length_2682_cov_43.500581	913	992	304	1	79	0.0126582
NODE_805_length_2682_cov_43.500581	913	992	305	1	79	0.0126582
NODE_805_length_2682_cov_43.500581	913	992	315	2	79	0.0253165
NODE_805_length_2682_cov_43.500581	913	992	317	1	79	0.0126582
NODE_805_length_2682_cov_43.500581	913	992	321	1	79	0.0126582
NODE_805_length_2682_cov_43.500581	913	992	323	1	79	0.0126582
NODE_805_length_2682_cov_43.500581	913	992	331	1	79	0.0126582
NODE_805_length_2682_cov_43.500581	913	992	332	1	79	0.0126582
NODE_805_length_2682_cov_43.500581	913	992	333	2	79	0.0253165
NODE_805_length_2682_cov_43.500581	913	992	336	1	79	0.0126582
NODE_805_length_2682_cov_43.500581	913	992	354	1	79	0.0126582
NODE_805_length_2682_cov_43.500581	913	992	360	1	79	0.0126582
NODE_805_length_2682_cov_43.500581	913	992	368	1	79	0.0126582
NODE_805_length_2682_cov_43.500581	913	992	370	1	79	0.0126582
NODE_805_length_2682_cov_43.500581	913	992	375	1	79	0.0126582
NODE_805_length_2682_cov_43.500581	913	992	380	1	79	0.0126582
NODE_805_length_2682_cov_43.500581	913	992	384	1	79	0.0126582
NODE_805_length_2682_cov_43.500581	913	992	386	1	79	0.0126582
NODE_805_length_2682_cov_43.500581	913	992	392	2	79	0.0253165
NODE_805_length_2682_cov_43.500581	913	992	398	1	79	0.0126582
NODE_805_length_2682_cov_43.500581	913	992	400	2	79	0.0253165
NODE_805_length_2682_cov_43.500581	913	992	401	1	79	0.0126582
NODE_805_length_2682_cov_43.500581	913	992	404	1	79	0.0126582
NODE_805_length_2682_cov_43.500581	913	992	410	1	79	0.0126582
NODE_805_length_2682_cov_43.500581	913	992	412	1	79	0.0126582
NODE_805_length_2682_cov_43.500581	913	992	413	1	79	0.0126582
NODE_805_length_2682_cov_43.500581	913	992	414	1	79	0.0126582
NODE_805_length_2682_cov_43.500581	913	992	415	2	79	0.0253165
NODE_805_length_2682_cov_43.500581	913	992	417	2	79	0.0253165
NODE_805_length_2682_cov_43.500581	913	992	418	1	79	0.0126582
NODE_805_length_2682_cov_43.500581	913	992	419	1	79	0.0126582
NODE_805_length_2682_cov_43.500581	913	992	423	1	79	0.0126582
NODE_805_length_2682_cov_43.500581	913	992	425	1	79	0.0126582
NODE_805_length_2682_cov_43.500581	913	992	426	1	79	0.0126582
NODE_805_length_2682_cov_43.500581	913	992	427	2	79	0.0253165
NODE_805_length_2682_cov_43.500581	913	992	428	1	79	0.0126582
NODE_805_length_2682_cov_43.500581	913	992	429	3	79	0.0379747
NODE_805_length_2682_cov_43.500581	913	992	430	2	79	0.0253165
NODE_805_length_2682_cov_43.500581	913	992	431	3	79	0.0379747
NODE_805_length_2682_cov_43.500581	913	992	432	1	79	0.0126582
NODE_805_length_2682_cov_43.500581	913	992	446	2	79	0.0253165
NODE_805_length_2682_cov_43.500581	913	992	454	1	79	0.0126582
NODE_805_length_2682_cov_43.500581	913	992	462	1	79	0.0126582
NODE_805_length_2682_cov_43.500581	913	992	470	1	79	0.0126582
NODE_805_length_2682_cov_43.500581	913	992	476	2	79	0.0253165
NODE_805_length_2682_cov_43.500581	913	992	478	1	79	0.0126582
NODE_805_length_2682_cov_43.500581	913	992	481	1	79	0.0126582
NODE_805_length_2682_cov_43.500581	913	992	482	1	79	0.0126582
NODE_805_length_2682_cov_43.500581	913	992	488	1	79	0.0126582
NODE_805_length_2682_cov_43.500581	913	992	492	1	79	0.0126582
NODE_805_length_2682_cov_43.500581	913	992	495	1	79	0.0126582
NODE_805_length_2682_cov_43.500581	965	1002	231	1	37	0.0270270
NODE_805_length_2682_cov_43.500581	965	1002	235	1	37	0.0270270
NODE_805_length_2682_cov_43.500581	965	1002	238	1	37	0.0270270
NODE_805_length_2682_cov_43.500581	965	1002	248	5	37	0.1351351
NODE_805_length_2682_cov_43.500581	965	1002	251	1	37	0.0270270
NODE_805_length_2682_cov_43.500581	965	1002	260	1	37	0.0270270
NODE_805_length_2682_cov_43.500581	965	1002	267	1	37	0.0270270
NODE_805_length_2682_cov_43.500581	965	1002	269	2	37	0.0540541
NODE_805_length_2682_cov_43.500581	965	1002	271	3	37	0.0810811
NODE_805_length_2682_cov_43.500581	965	1002	273	1	37	0.0270270
NODE_805_length_2682_cov_43.500581	965	1002	275	1	37	0.0270270
NODE_805_length_2682_cov_43.500581	965	1002	280	2	37	0.0540541
NODE_805_length_2682_cov_43.500581	965	1002	283	1	37	0.0270270
NODE_805_length_2682_cov_43.500581	965	1002	288	1	37	0.0270270
NODE_805_length_2682_cov_43.500581	965	1002	290	1	37	0.0270270
NODE_805_length_2682_cov_43.500581	965	1002	297	1	37	0.0270270
NODE_805_length_2682_cov_43.500581	965	1002	304	1	37	0.0270270
NODE_805_length_2682_cov_43.500581	965	1002	305	1	37	0.0270270
NODE_805_length_2682_cov_43.500581	965	1002	315	2	37	0.0540541
NODE_805_length_2682_cov_43.500581	965	1002	317	1	37	0.0270270
NODE_805_length_2682_cov_43.500581	965	1002	321	1	37	0.0270270
NODE_805_length_2682_cov_43.500581	965	1002	323	1	37	0.0270270
NODE_805_length_2682_cov_43.500581	965	1002	331	1	37	0.0270270
NODE_805_length_2682_cov_43.500581	965	1002	332	1	37	0.0270270
NODE_805_length_2682_cov_43.500581	965	1002	333	2	37	0.0540541
NODE_805_length_2682_cov_43.500581	965	1002	336	1	37	0.0270270
NODE_805_length_2682_cov_43.500581	965	1002	354	1	37	0.0270270
NODE_808_length_2675_cov_10.369565	209	289	8	2	80	0.0250000
NODE_808_length_2675_cov_10.369565	209	289	10	17	80	0.2125000
NODE_808_length_2675_cov_10.369565	209	289	12	2	80	0.0250000
NODE_808_length_2675_cov_10.369565	209	289	16	5	80	0.0625000
NODE_808_length_2675_cov_10.369565	209	289	18	5	80	0.0625000
NODE_808_length_2675_cov_10.369565	209	289	20	12	80	0.1500000
NODE_808_length_2675_cov_10.369565	209	289	24	1	80	0.0125000
NODE_808_length_2675_cov_10.369565	209	289	26	8	80	0.1000000
NODE_808_length_2675_cov_10.369565	209	289	27	7	80	0.0875000
NODE_808_length_2675_cov_10.369565	209	289	29	12	80	0.1500000
NODE_808_length_2675_cov_10.369565	209	289	31	9	80	0.1125000
NODE_813_length_2670_cov_17.489304	1995	2075	0	80	80	1.0000000
NODE_813_length_2670_cov_17.489304	2048	2128	0	29	80	0.3625000
NODE_813_length_2670_cov_17.489304	2048	2128	2	51	80	0.6375000
NODE_813_length_2670_cov_17.489304	2124	2204	0	2	80	0.0250000
NODE_813_length_2670_cov_17.489304	2124	2204	1	9	80	0.1125000
NODE_813_length_2670_cov_17.489304	2124	2204	2	28	80	0.3500000
NODE_813_length_2670_cov_17.489304	2124	2204	3	13	80	0.1625000
NODE_813_length_2670_cov_17.489304	2124	2204	4	28	80	0.3500000
NODE_813_length_2670_cov_17.489304	2177	2257	4	80	80	1.0000000
NODE_815_length_2665_cov_19.145752	548	628	2	30	80	0.3750000
NODE_815_length_2665_cov_19.145752	548	628	4	32	80	0.4000000
NODE_815_length_2665_cov_19.145752	548	628	6	18	80	0.2250000
NODE_815_length_2665_cov_19.145752	601	681	0	21	80	0.2625000
NODE_815_length_2665_cov_19.145752	601	681	2	59	80	0.7375000
NODE_815_length_2665_cov_19.145752	2099	2176	0	18	77	0.2337662
NODE_815_length_2665_cov_19.145752	2099	2176	2	37	77	0.4805195
NODE_815_length_2665_cov_19.145752	2099	2176	4	22	77	0.2857143
NODE_815_length_2665_cov_19.145752	2172	2252	4	8	80	0.1000000
NODE_815_length_2665_cov_19.145752	2172	2252	6	72	80	0.9000000
NODE_815_length_2665_cov_19.145752	2172	2252	4	8	80	0.1000000
NODE_815_length_2665_cov_19.145752	2172	2252	6	72	80	0.9000000
NODE_815_length_2665_cov_19.145752	2225	2267	4	12	42	0.2857143
NODE_815_length_2665_cov_19.145752	2225	2267	6	30	42	0.7142857
NODE_816_length_2664_cov_4.175049	2005	2085	0	29	80	0.3625000
NODE_816_length_2664_cov_4.175049	2005	2085	2	51	80	0.6375000
NODE_816_length_2664_cov_4.175049	2058	2138	0	13	80	0.1625000
NODE_816_length_2664_cov_4.175049	2058	2138	2	67	80	0.8375000
NODE_822_length_2650_cov_19.800862	800	880	24	1	80	0.0125000
NODE_822_length_2650_cov_19.800862	800	880	28	5	80	0.0625000
NODE_822_length_2650_cov_19.800862	800	880	30	7	80	0.0875000
NODE_822_length_2650_cov_19.800862	800	880	32	5	80	0.0625000
NODE_822_length_2650_cov_19.800862	800	880	33	7	80	0.0875000
NODE_822_length_2650_cov_19.800862	800	880	34	5	80	0.0625000
NODE_822_length_2650_cov_19.800862	800	880	36	4	80	0.0500000
NODE_822_length_2650_cov_19.800862	800	880	37	1	80	0.0125000
NODE_822_length_2650_cov_19.800862	800	880	38	10	80	0.1250000
NODE_822_length_2650_cov_19.800862	800	880	39	5	80	0.0625000
NODE_822_length_2650_cov_19.800862	800	880	41	1	80	0.0125000
NODE_822_length_2650_cov_19.800862	800	880	42	2	80	0.0250000
NODE_822_length_2650_cov_19.800862	800	880	43	24	80	0.3000000
NODE_822_length_2650_cov_19.800862	800	880	44	3	80	0.0375000
NODE_824_length_2645_cov_8.618225	931	1011	0	80	80	1.0000000
NODE_824_length_2645_cov_8.618225	984	1064	0	65	80	0.8125000
NODE_824_length_2645_cov_8.618225	984	1064	2	15	80	0.1875000
NODE_827_length_2640_cov_16.462810	94	164	149	1	70	0.0142857
NODE_827_length_2640_cov_16.462810	94	164	150	1	70	0.0142857
NODE_827_length_2640_cov_16.462810	94	164	152	1	70	0.0142857
NODE_827_length_2640_cov_16.462810	94	164	158	1	70	0.0142857
NODE_827_length_2640_cov_16.462810	94	164	159	1	70	0.0142857
NODE_827_length_2640_cov_16.462810	94	164	160	2	70	0.0285714
NODE_827_length_2640_cov_16.462810	94	164	166	1	70	0.0142857
NODE_827_length_2640_cov_16.462810	94	164	168	1	70	0.0142857
NODE_827_length_2640_cov_16.462810	94	164	173	1	70	0.0142857
NODE_827_length_2640_cov_16.462810	94	164	175	1	70	0.0142857
NODE_827_length_2640_cov_16.462810	94	164	176	1	70	0.0142857
NODE_827_length_2640_cov_16.462810	94	164	182	1	70	0.0142857
NODE_827_length_2640_cov_16.462810	94	164	187	1	70	0.0142857
NODE_827_length_2640_cov_16.462810	94	164	189	2	70	0.0285714
NODE_827_length_2640_cov_16.462810	94	164	192	1	70	0.0142857
NODE_827_length_2640_cov_16.462810	94	164	193	2	70	0.0285714
NODE_827_length_2640_cov_16.462810	94	164	194	1	70	0.0142857
NODE_827_length_2640_cov_16.462810	94	164	201	1	70	0.0142857
NODE_827_length_2640_cov_16.462810	94	164	202	1	70	0.0142857
NODE_827_length_2640_cov_16.462810	94	164	207	1	70	0.0142857
NODE_827_length_2640_cov_16.462810	94	164	229	1	70	0.0142857
NODE_827_length_2640_cov_16.462810	94	164	231	2	70	0.0285714
NODE_827_length_2640_cov_16.462810	94	164	233	1	70	0.0142857
NODE_827_length_2640_cov_16.462810	94	164	246	1	70	0.0142857
NODE_827_length_2640_cov_16.462810	94	164	255	1	70	0.0142857
NODE_827_length_2640_cov_16.462810	94	164	274	3	70	0.0428571
NODE_827_length_2640_cov_16.462810	94	164	275	1	70	0.0142857
NODE_827_length_2640_cov_16.462810	94	164	277	1	70	0.0142857
NODE_827_length_2640_cov_16.462810	94	164	286	1	70	0.0142857
NODE_827_length_2640_cov_16.462810	94	164	289	1	70	0.0142857
NODE_827_length_2640_cov_16.462810	94	164	291	2	70	0.0285714
NODE_827_length_2640_cov_16.462810	94	164	295	2	70	0.0285714
NODE_827_length_2640_cov_16.462810	94	164	301	1	70	0.0142857
NODE_827_length_2640_cov_16.462810	94	164	310	1	70	0.0142857
NODE_827_length_2640_cov_16.462810	94	164	323	1	70	0.0142857
NODE_827_length_2640_cov_16.462810	94	164	335	1	70	0.0142857
NODE_827_length_2640_cov_16.462810	94	164	352	1	70	0.0142857
NODE_827_length_2640_cov_16.462810	94	164	353	1	70	0.0142857
NODE_827_length_2640_cov_16.462810	94	164	367	1	70	0.0142857
NODE_827_length_2640_cov_16.462810	94	164	369	1	70	0.0142857
NODE_827_length_2640_cov_16.462810	94	164	381	1	70	0.0142857
NODE_827_length_2640_cov_16.462810	94	164	383	2	70	0.0285714
NODE_827_length_2640_cov_16.462810	94	164	387	1	70	0.0142857
NODE_827_length_2640_cov_16.462810	94	164	389	2	70	0.0285714
NODE_827_length_2640_cov_16.462810	94	164	393	3	70	0.0428571
NODE_827_length_2640_cov_16.462810	94	164	395	7	70	0.1000000
NODE_827_length_2640_cov_16.462810	94	164	397	1	70	0.0142857
NODE_827_length_2640_cov_16.462810	94	164	399	5	70	0.0714286
NODE_827_length_2640_cov_16.462810	147	209	101	1	62	0.0161290
NODE_827_length_2640_cov_16.462810	147	209	106	1	62	0.0161290
NODE_827_length_2640_cov_16.462810	147	209	110	1	62	0.0161290
NODE_827_length_2640_cov_16.462810	147	209	112	3	62	0.0483871
NODE_827_length_2640_cov_16.462810	147	209	113	5	62	0.0806452
NODE_827_length_2640_cov_16.462810	147	209	114	3	62	0.0483871
NODE_827_length_2640_cov_16.462810	147	209	115	1	62	0.0161290
NODE_827_length_2640_cov_16.462810	147	209	116	2	62	0.0322581
NODE_827_length_2640_cov_16.462810	147	209	117	1	62	0.0161290
NODE_827_length_2640_cov_16.462810	147	209	118	2	62	0.0322581
NODE_827_length_2640_cov_16.462810	147	209	120	1	62	0.0161290
NODE_827_length_2640_cov_16.462810	147	209	124	2	62	0.0322581
NODE_827_length_2640_cov_16.462810	147	209	126	1	62	0.0161290
NODE_827_length_2640_cov_16.462810	147	209	129	1	62	0.0161290
NODE_827_length_2640_cov_16.462810	147	209	133	2	62	0.0322581
NODE_827_length_2640_cov_16.462810	147	209	134	4	62	0.0645161
NODE_827_length_2640_cov_16.462810	147	209	135	1	62	0.0161290
NODE_827_length_2640_cov_16.462810	147	209	136	2	62	0.0322581
NODE_827_length_2640_cov_16.462810	147	209	137	1	62	0.0161290
NODE_827_length_2640_cov_16.462810	147	209	138	5	62	0.0806452
NODE_827_length_2640_cov_16.462810	147	209	139	1	62	0.0161290
NODE_827_length_2640_cov_16.462810	147	209	142	1	62	0.0161290
NODE_827_length_2640_cov_16.462810	147	209	145	1	62	0.0161290
NODE_827_length_2640_cov_16.462810	147	209	147	1	62	0.0161290
NODE_827_length_2640_cov_16.462810	147	209	149	2	62	0.0322581
NODE_827_length_2640_cov_16.462810	147	209	150	1	62	0.0161290
NODE_827_length_2640_cov_16.462810	147	209	152	1	62	0.0161290
NODE_827_length_2640_cov_16.462810	147	209	158	1	62	0.0161290
NODE_827_length_2640_cov_16.462810	147	209	159	1	62	0.0161290
NODE_827_length_2640_cov_16.462810	147	209	160	2	62	0.0322581
NODE_827_length_2640_cov_16.462810	147	209	166	1	62	0.0161290
NODE_827_length_2640_cov_16.462810	147	209	168	1	62	0.0161290
NODE_827_length_2640_cov_16.462810	147	209	173	1	62	0.0161290
NODE_827_length_2640_cov_16.462810	147	209	175	1	62	0.0161290
NODE_827_length_2640_cov_16.462810	147	209	176	1	62	0.0161290
NODE_827_length_2640_cov_16.462810	147	209	182	1	62	0.0161290
NODE_827_length_2640_cov_16.462810	147	209	187	1	62	0.0161290
NODE_827_length_2640_cov_16.462810	147	209	189	2	62	0.0322581
NODE_827_length_2640_cov_16.462810	147	209	192	1	62	0.0161290
NODE_828_length_2636_cov_200.191171	561	641	149	1	80	0.0125000
NODE_828_length_2636_cov_200.191171	561	641	150	1	80	0.0125000
NODE_828_length_2636_cov_200.191171	561	641	154	1	80	0.0125000
NODE_828_length_2636_cov_200.191171	561	641	156	1	80	0.0125000
NODE_828_length_2636_cov_200.191171	561	641	164	1	80	0.0125000
NODE_828_length_2636_cov_200.191171	561	641	174	1	80	0.0125000
NODE_828_length_2636_cov_200.191171	561	641	180	2	80	0.0250000
NODE_828_length_2636_cov_200.191171	561	641	183	2	80	0.0250000
NODE_828_length_2636_cov_200.191171	561	641	186	1	80	0.0125000
NODE_828_length_2636_cov_200.191171	561	641	188	6	80	0.0750000
NODE_828_length_2636_cov_200.191171	561	641	189	2	80	0.0250000
NODE_828_length_2636_cov_200.191171	561	641	193	2	80	0.0250000
NODE_828_length_2636_cov_200.191171	561	641	195	2	80	0.0250000
NODE_828_length_2636_cov_200.191171	561	641	197	2	80	0.0250000
NODE_828_length_2636_cov_200.191171	561	641	198	2	80	0.0250000
NODE_828_length_2636_cov_200.191171	561	641	199	1	80	0.0125000
NODE_828_length_2636_cov_200.191171	561	641	200	4	80	0.0500000
NODE_828_length_2636_cov_200.191171	561	641	202	3	80	0.0375000
NODE_828_length_2636_cov_200.191171	561	641	208	4	80	0.0500000
NODE_828_length_2636_cov_200.191171	561	641	209	1	80	0.0125000
NODE_828_length_2636_cov_200.191171	561	641	211	3	80	0.0375000
NODE_828_length_2636_cov_200.191171	561	641	212	1	80	0.0125000
NODE_828_length_2636_cov_200.191171	561	641	213	5	80	0.0625000
NODE_828_length_2636_cov_200.191171	561	641	215	5	80	0.0625000
NODE_828_length_2636_cov_200.191171	561	641	217	2	80	0.0250000
NODE_828_length_2636_cov_200.191171	561	641	219	2	80	0.0250000
NODE_828_length_2636_cov_200.191171	561	641	220	2	80	0.0250000
NODE_828_length_2636_cov_200.191171	561	641	222	7	80	0.0875000
NODE_828_length_2636_cov_200.191171	561	641	226	2	80	0.0250000
NODE_828_length_2636_cov_200.191171	561	641	229	1	80	0.0125000
NODE_828_length_2636_cov_200.191171	561	641	230	1	80	0.0125000
NODE_828_length_2636_cov_200.191171	561	641	231	1	80	0.0125000
NODE_828_length_2636_cov_200.191171	561	641	233	2	80	0.0250000
NODE_828_length_2636_cov_200.191171	561	641	234	1	80	0.0125000
NODE_828_length_2636_cov_200.191171	561	641	235	1	80	0.0125000
NODE_828_length_2636_cov_200.191171	561	641	236	4	80	0.0500000
NODE_828_length_2636_cov_200.191171	614	695	61	1	81	0.0123457
NODE_828_length_2636_cov_200.191171	614	695	64	1	81	0.0123457
NODE_828_length_2636_cov_200.191171	614	695	68	1	81	0.0123457
NODE_828_length_2636_cov_200.191171	614	695	70	3	81	0.0370370
NODE_828_length_2636_cov_200.191171	614	695	72	2	81	0.0246914
NODE_828_length_2636_cov_200.191171	614	695	77	1	81	0.0123457
NODE_828_length_2636_cov_200.191171	614	695	79	1	81	0.0123457
NODE_828_length_2636_cov_200.191171	614	695	81	1	81	0.0123457
NODE_828_length_2636_cov_200.191171	614	695	86	3	81	0.0370370
NODE_828_length_2636_cov_200.191171	614	695	89	1	81	0.0123457
NODE_828_length_2636_cov_200.191171	614	695	91	1	81	0.0123457
NODE_828_length_2636_cov_200.191171	614	695	100	1	81	0.0123457
NODE_828_length_2636_cov_200.191171	614	695	108	1	81	0.0123457
NODE_828_length_2636_cov_200.191171	614	695	109	1	81	0.0123457
NODE_828_length_2636_cov_200.191171	614	695	110	1	81	0.0123457
NODE_828_length_2636_cov_200.191171	614	695	111	1	81	0.0123457
NODE_828_length_2636_cov_200.191171	614	695	112	1	81	0.0123457
NODE_828_length_2636_cov_200.191171	614	695	116	1	81	0.0123457
NODE_828_length_2636_cov_200.191171	614	695	121	1	81	0.0123457
NODE_828_length_2636_cov_200.191171	614	695	127	1	81	0.0123457
NODE_828_length_2636_cov_200.191171	614	695	130	1	81	0.0123457
NODE_828_length_2636_cov_200.191171	614	695	139	1	81	0.0123457
NODE_828_length_2636_cov_200.191171	614	695	144	1	81	0.0123457
NODE_828_length_2636_cov_200.191171	614	695	157	2	81	0.0246914
NODE_828_length_2636_cov_200.191171	614	695	163	1	81	0.0123457
NODE_828_length_2636_cov_200.191171	614	695	166	1	81	0.0123457
NODE_828_length_2636_cov_200.191171	614	695	168	1	81	0.0123457
NODE_828_length_2636_cov_200.191171	614	695	169	2	81	0.0246914
NODE_828_length_2636_cov_200.191171	614	695	170	1	81	0.0123457
NODE_828_length_2636_cov_200.191171	614	695	172	3	81	0.0370370
NODE_828_length_2636_cov_200.191171	614	695	174	1	81	0.0123457
NODE_828_length_2636_cov_200.191171	614	695	180	1	81	0.0123457
NODE_828_length_2636_cov_200.191171	614	695	184	1	81	0.0123457
NODE_828_length_2636_cov_200.191171	614	695	185	3	81	0.0370370
NODE_828_length_2636_cov_200.191171	614	695	186	3	81	0.0370370
NODE_828_length_2636_cov_200.191171	614	695	187	2	81	0.0246914
NODE_828_length_2636_cov_200.191171	614	695	188	11	81	0.1358025
NODE_828_length_2636_cov_200.191171	614	695	193	2	81	0.0246914
NODE_828_length_2636_cov_200.191171	614	695	195	2	81	0.0246914
NODE_828_length_2636_cov_200.191171	614	695	197	2	81	0.0246914
NODE_828_length_2636_cov_200.191171	614	695	198	2	81	0.0246914
NODE_828_length_2636_cov_200.191171	614	695	200	4	81	0.0493827
NODE_828_length_2636_cov_200.191171	614	695	202	3	81	0.0370370
NODE_828_length_2636_cov_200.191171	614	695	208	4	81	0.0493827
NODE_828_length_2636_cov_200.191171	614	695	211	1	81	0.0123457
NODE_830_length_2631_cov_10.831754	446	526	0	5	80	0.0625000
NODE_830_length_2631_cov_10.831754	446	526	2	5	80	0.0625000
NODE_830_length_2631_cov_10.831754	446	526	4	50	80	0.6250000
NODE_830_length_2631_cov_10.831754	446	526	6	20	80	0.2500000
NODE_830_length_2631_cov_10.831754	499	572	4	35	73	0.4794520
NODE_830_length_2631_cov_10.831754	499	572	6	38	73	0.5205479
NODE_833_length_2622_cov_63.057471	1877	1953	192	2	76	0.0263158
NODE_833_length_2622_cov_63.057471	1877	1953	194	4	76	0.0526316
NODE_833_length_2622_cov_63.057471	1877	1953	198	2	76	0.0263158
NODE_833_length_2622_cov_63.057471	1877	1953	202	1	76	0.0131579
NODE_833_length_2622_cov_63.057471	1877	1953	203	3	76	0.0394737
NODE_833_length_2622_cov_63.057471	1877	1953	205	1	76	0.0131579
NODE_833_length_2622_cov_63.057471	1877	1953	211	3	76	0.0394737
NODE_833_length_2622_cov_63.057471	1877	1953	213	1	76	0.0131579
NODE_833_length_2622_cov_63.057471	1877	1953	215	2	76	0.0263158
NODE_833_length_2622_cov_63.057471	1877	1953	217	4	76	0.0526316
NODE_833_length_2622_cov_63.057471	1877	1953	219	2	76	0.0263158
NODE_833_length_2622_cov_63.057471	1877	1953	220	1	76	0.0131579
NODE_833_length_2622_cov_63.057471	1877	1953	222	3	76	0.0394737
NODE_833_length_2622_cov_63.057471	1877	1953	224	2	76	0.0263158
NODE_833_length_2622_cov_63.057471	1877	1953	230	1	76	0.0131579
NODE_833_length_2622_cov_63.057471	1877	1953	236	2	76	0.0263158
NODE_833_length_2622_cov_63.057471	1877	1953	237	4	76	0.0526316
NODE_833_length_2622_cov_63.057471	1877	1953	238	1	76	0.0131579
NODE_833_length_2622_cov_63.057471	1877	1953	240	1	76	0.0131579
NODE_833_length_2622_cov_63.057471	1877	1953	241	2	76	0.0263158
NODE_833_length_2622_cov_63.057471	1877	1953	242	1	76	0.0131579
NODE_833_length_2622_cov_63.057471	1877	1953	243	1	76	0.0131579
NODE_833_length_2622_cov_63.057471	1877	1953	244	1	76	0.0131579
NODE_833_length_2622_cov_63.057471	1877	1953	245	3	76	0.0394737
NODE_833_length_2622_cov_63.057471	1877	1953	247	12	76	0.1578947
NODE_833_length_2622_cov_63.057471	1877	1953	248	1	76	0.0131579
NODE_833_length_2622_cov_63.057471	1877	1953	249	3	76	0.0394737
NODE_833_length_2622_cov_63.057471	1877	1953	250	3	76	0.0394737
NODE_833_length_2622_cov_63.057471	1877	1953	251	1	76	0.0131579
NODE_833_length_2622_cov_63.057471	1877	1953	252	1	76	0.0131579
NODE_833_length_2622_cov_63.057471	1877	1953	254	5	76	0.0657895
NODE_833_length_2622_cov_63.057471	1877	1953	256	1	76	0.0131579
NODE_833_length_2622_cov_63.057471	1877	1953	258	1	76	0.0131579
NODE_833_length_2622_cov_63.057471	2426	2506	73	4	80	0.0500000
NODE_833_length_2622_cov_63.057471	2426	2506	75	4	80	0.0500000
NODE_833_length_2622_cov_63.057471	2426	2506	77	2	80	0.0250000
NODE_833_length_2622_cov_63.057471	2426	2506	78	2	80	0.0250000
NODE_833_length_2622_cov_63.057471	2426	2506	79	1	80	0.0125000
NODE_833_length_2622_cov_63.057471	2426	2506	80	6	80	0.0750000
NODE_833_length_2622_cov_63.057471	2426	2506	81	7	80	0.0875000
NODE_833_length_2622_cov_63.057471	2426	2506	82	8	80	0.1000000
NODE_833_length_2622_cov_63.057471	2426	2506	83	10	80	0.1250000
NODE_833_length_2622_cov_63.057471	2426	2506	85	2	80	0.0250000
NODE_833_length_2622_cov_63.057471	2426	2506	86	2	80	0.0250000
NODE_833_length_2622_cov_63.057471	2426	2506	87	9	80	0.1125000
NODE_833_length_2622_cov_63.057471	2426	2506	90	3	80	0.0375000
NODE_833_length_2622_cov_63.057471	2426	2506	92	4	80	0.0500000
NODE_833_length_2622_cov_63.057471	2426	2506	94	5	80	0.0625000
NODE_833_length_2622_cov_63.057471	2426	2506	96	5	80	0.0625000
NODE_833_length_2622_cov_63.057471	2426	2506	98	5	80	0.0625000
NODE_833_length_2622_cov_63.057471	2426	2506	100	1	80	0.0125000
NODE_833_length_2622_cov_63.057471	2479	2559	72	1	80	0.0125000
NODE_833_length_2622_cov_63.057471	2479	2559	73	1	80	0.0125000
NODE_833_length_2622_cov_63.057471	2479	2559	74	1	80	0.0125000
NODE_833_length_2622_cov_63.057471	2479	2559	76	4	80	0.0500000
NODE_833_length_2622_cov_63.057471	2479	2559	78	1	80	0.0125000
NODE_833_length_2622_cov_63.057471	2479	2559	82	1	80	0.0125000
NODE_833_length_2622_cov_63.057471	2479	2559	84	2	80	0.0250000
NODE_833_length_2622_cov_63.057471	2479	2559	86	4	80	0.0500000
NODE_833_length_2622_cov_63.057471	2479	2559	87	3	80	0.0375000
NODE_833_length_2622_cov_63.057471	2479	2559	88	1	80	0.0125000
NODE_833_length_2622_cov_63.057471	2479	2559	90	5	80	0.0625000
NODE_833_length_2622_cov_63.057471	2479	2559	92	6	80	0.0750000
NODE_833_length_2622_cov_63.057471	2479	2559	94	11	80	0.1375000
NODE_833_length_2622_cov_63.057471	2479	2559	95	4	80	0.0500000
NODE_833_length_2622_cov_63.057471	2479	2559	96	5	80	0.0625000
NODE_833_length_2622_cov_63.057471	2479	2559	97	5	80	0.0625000
NODE_833_length_2622_cov_63.057471	2479	2559	98	6	80	0.0750000
NODE_833_length_2622_cov_63.057471	2479	2559	99	1	80	0.0125000
NODE_833_length_2622_cov_63.057471	2479	2559	100	1	80	0.0125000
NODE_833_length_2622_cov_63.057471	2479	2559	101	3	80	0.0375000
NODE_833_length_2622_cov_63.057471	2479	2559	102	7	80	0.0875000
NODE_833_length_2622_cov_63.057471	2479	2559	105	1	80	0.0125000
NODE_833_length_2622_cov_63.057471	2479	2559	107	6	80	0.0750000
NODE_836_length_2617_cov_16.817315	1404	1448	6	2	44	0.0454545
NODE_836_length_2617_cov_16.817315	1404	1448	8	42	44	0.9545454
NODE_836_length_2617_cov_16.817315	1467	1521	6	4	54	0.0740741
NODE_836_length_2617_cov_16.817315	1467	1521	8	48	54	0.8888889
NODE_836_length_2617_cov_16.817315	1467	1521	10	2	54	0.0370370
NODE_839_length_2610_cov_2.232577	2127	2163	0	32	36	0.8888889
NODE_839_length_2610_cov_2.232577	2127	2163	2	4	36	0.1111111
NODE_840_length_2609_cov_13.245418	2066	2146	4	11	80	0.1375000
NODE_840_length_2609_cov_13.245418	2066	2146	6	69	80	0.8625000
NODE_840_length_2609_cov_13.245418	2119	2199	0	23	80	0.2875000
NODE_840_length_2609_cov_13.245418	2119	2199	4	41	80	0.5125000
NODE_840_length_2609_cov_13.245418	2119	2199	6	16	80	0.2000000
NODE_840_length_2609_cov_13.245418	2195	2275	0	10	80	0.1250000
NODE_840_length_2609_cov_13.245418	2195	2275	2	49	80	0.6125000
NODE_840_length_2609_cov_13.245418	2195	2275	4	21	80	0.2625000
NODE_840_length_2609_cov_13.245418	2248	2328	0	4	80	0.0500000
NODE_840_length_2609_cov_13.245418	2248	2328	2	23	80	0.2875000
NODE_840_length_2609_cov_13.245418	2248	2328	4	53	80	0.6625000
NODE_845_length_2595_cov_5.638622	2157	2237	0	80	80	1.0000000
NODE_847_length_2594_cov_109.880160	386	450	37	1	64	0.0156250
NODE_847_length_2594_cov_109.880160	386	450	42	2	64	0.0312500
NODE_847_length_2594_cov_109.880160	386	450	44	1	64	0.0156250
NODE_847_length_2594_cov_109.880160	386	450	45	2	64	0.0312500
NODE_847_length_2594_cov_109.880160	386	450	50	2	64	0.0312500
NODE_847_length_2594_cov_109.880160	386	450	51	3	64	0.0468750
NODE_847_length_2594_cov_109.880160	386	450	53	1	64	0.0156250
NODE_847_length_2594_cov_109.880160	386	450	55	2	64	0.0312500
NODE_847_length_2594_cov_109.880160	386	450	60	1	64	0.0156250
NODE_847_length_2594_cov_109.880160	386	450	63	1	64	0.0156250
NODE_847_length_2594_cov_109.880160	386	450	71	1	64	0.0156250
NODE_847_length_2594_cov_109.880160	386	450	74	1	64	0.0156250
NODE_847_length_2594_cov_109.880160	386	450	82	1	64	0.0156250
NODE_847_length_2594_cov_109.880160	386	450	86	1	64	0.0156250
NODE_847_length_2594_cov_109.880160	386	450	106	2	64	0.0312500
NODE_847_length_2594_cov_109.880160	386	450	110	2	64	0.0312500
NODE_847_length_2594_cov_109.880160	386	450	112	1	64	0.0156250
NODE_847_length_2594_cov_109.880160	386	450	114	1	64	0.0156250
NODE_847_length_2594_cov_109.880160	386	450	122	3	64	0.0468750
NODE_847_length_2594_cov_109.880160	386	450	127	2	64	0.0312500
NODE_847_length_2594_cov_109.880160	386	450	129	1	64	0.0156250
NODE_847_length_2594_cov_109.880160	386	450	134	1	64	0.0156250
NODE_847_length_2594_cov_109.880160	386	450	140	1	64	0.0156250
NODE_847_length_2594_cov_109.880160	386	450	144	4	64	0.0625000
NODE_847_length_2594_cov_109.880160	386	450	145	1	64	0.0156250
NODE_847_length_2594_cov_109.880160	386	450	150	3	64	0.0468750
NODE_847_length_2594_cov_109.880160	386	450	154	8	64	0.1250000
NODE_847_length_2594_cov_109.880160	386	450	156	1	64	0.0156250
NODE_847_length_2594_cov_109.880160	386	450	158	1	64	0.0156250
NODE_847_length_2594_cov_109.880160	386	450	160	3	64	0.0468750
NODE_847_length_2594_cov_109.880160	386	450	162	3	64	0.0468750
NODE_847_length_2594_cov_109.880160	386	450	164	1	64	0.0156250
NODE_847_length_2594_cov_109.880160	386	450	166	2	64	0.0312500
NODE_847_length_2594_cov_109.880160	386	450	168	1	64	0.0156250
NODE_847_length_2594_cov_109.880160	386	450	172	1	64	0.0156250
NODE_847_length_2594_cov_109.880160	386	450	174	1	64	0.0156250
NODE_856_length_2575_cov_4.890549	1860	1912	2	22	52	0.4230769
NODE_856_length_2575_cov_4.890549	1860	1912	6	30	52	0.5769231
NODE_857_length_2572_cov_46.828548	302	382	2	3	80	0.0375000
NODE_857_length_2572_cov_46.828548	302	382	4	77	80	0.9625000
NODE_857_length_2572_cov_46.828548	355	435	0	6	80	0.0750000
NODE_857_length_2572_cov_46.828548	355	435	2	20	80	0.2500000
NODE_857_length_2572_cov_46.828548	355	435	4	54	80	0.6750000
NODE_868_length_2551_cov_40.721860	1104	1150	6	3	46	0.0652174
NODE_868_length_2551_cov_40.721860	1104	1150	7	8	46	0.1739130
NODE_868_length_2551_cov_40.721860	1104	1150	8	6	46	0.1304348
NODE_868_length_2551_cov_40.721860	1104	1150	10	1	46	0.0217391
NODE_868_length_2551_cov_40.721860	1104	1150	14	4	46	0.0869565
NODE_868_length_2551_cov_40.721860	1104	1150	16	10	46	0.2173913
NODE_868_length_2551_cov_40.721860	1104	1150	18	14	46	0.3043478
NODE_868_length_2551_cov_40.721860	1199	1259	0	21	60	0.3500000
NODE_868_length_2551_cov_40.721860	1199	1259	2	7	60	0.1166667
NODE_868_length_2551_cov_40.721860	1199	1259	4	32	60	0.5333334
NODE_870_length_2547_cov_218.062908	436	486	0	29	50	0.5800000
NODE_870_length_2547_cov_218.062908	436	486	2	3	50	0.0600000
NODE_870_length_2547_cov_218.062908	436	486	4	4	50	0.0800000
NODE_870_length_2547_cov_218.062908	436	486	6	1	50	0.0200000
NODE_870_length_2547_cov_218.062908	436	486	10	4	50	0.0800000
NODE_870_length_2547_cov_218.062908	436	486	14	2	50	0.0400000
NODE_870_length_2547_cov_218.062908	436	486	18	1	50	0.0200000
NODE_870_length_2547_cov_218.062908	436	486	22	1	50	0.0200000
NODE_870_length_2547_cov_218.062908	436	486	24	1	50	0.0200000
NODE_870_length_2547_cov_218.062908	436	486	26	4	50	0.0800000
NODE_879_length_2527_cov_27.275947	503	548	56	2	45	0.0444444
NODE_879_length_2527_cov_27.275947	503	548	57	14	45	0.3111111
NODE_879_length_2527_cov_27.275947	503	548	58	4	45	0.0888889
NODE_879_length_2527_cov_27.275947	503	548	59	11	45	0.2444444
NODE_879_length_2527_cov_27.275947	503	548	60	4	45	0.0888889
NODE_879_length_2527_cov_27.275947	503	548	61	2	45	0.0444444
NODE_879_length_2527_cov_27.275947	503	548	62	3	45	0.0666667
NODE_879_length_2527_cov_27.275947	503	548	63	2	45	0.0444444
NODE_879_length_2527_cov_27.275947	503	548	66	2	45	0.0444444
NODE_879_length_2527_cov_27.275947	503	548	68	1	45	0.0222222
NODE_884_length_2519_cov_15.991322	2122	2202	8	80	80	1.0000000
NODE_884_length_2519_cov_15.991322	2175	2255	0	39	80	0.4875000
NODE_884_length_2519_cov_15.991322	2175	2255	8	41	80	0.5125000
NODE_885_length_2518_cov_7.035965	62	142	36	3	80	0.0375000
NODE_885_length_2518_cov_7.035965	62	142	38	1	80	0.0125000
NODE_885_length_2518_cov_7.035965	62	142	40	3	80	0.0375000
NODE_885_length_2518_cov_7.035965	62	142	47	2	80	0.0250000
NODE_885_length_2518_cov_7.035965	62	142	48	5	80	0.0625000
NODE_885_length_2518_cov_7.035965	62	142	54	4	80	0.0500000
NODE_885_length_2518_cov_7.035965	62	142	56	17	80	0.2125000
NODE_885_length_2518_cov_7.035965	62	142	60	4	80	0.0500000
NODE_885_length_2518_cov_7.035965	62	142	62	8	80	0.1000000
NODE_885_length_2518_cov_7.035965	62	142	64	22	80	0.2750000
NODE_885_length_2518_cov_7.035965	62	142	66	11	80	0.1375000
NODE_885_length_2518_cov_7.035965	2005	2085	0	80	80	1.0000000
NODE_885_length_2518_cov_7.035965	2058	2138	0	80	80	1.0000000
NODE_887_length_2515_cov_37.984272	393	473	0	56	80	0.7000000
NODE_887_length_2515_cov_37.984272	393	473	2	24	80	0.3000000
NODE_887_length_2515_cov_37.984272	446	526	0	3	80	0.0375000
NODE_887_length_2515_cov_37.984272	446	526	2	77	80	0.9625000
NODE_887_length_2515_cov_37.984272	1896	1976	2	2	80	0.0250000
NODE_887_length_2515_cov_37.984272	1896	1976	4	57	80	0.7125000
NODE_887_length_2515_cov_37.984272	1896	1976	6	21	80	0.2625000
NODE_887_length_2515_cov_37.984272	1949	2029	2	24	80	0.3000000
NODE_887_length_2515_cov_37.984272	1949	2029	4	40	80	0.5000000
NODE_887_length_2515_cov_37.984272	1949	2029	6	16	80	0.2000000
NODE_887_length_2515_cov_37.984272	2025	2105	6	80	80	1.0000000
NODE_887_length_2515_cov_37.984272	2025	2104	6	79	79	1.0000000
NODE_887_length_2515_cov_37.984272	2078	2158	0	23	80	0.2875000
NODE_887_length_2515_cov_37.984272	2078	2158	2	5	80	0.0625000
NODE_887_length_2515_cov_37.984272	2078	2158	4	18	80	0.2250000
NODE_887_length_2515_cov_37.984272	2078	2158	6	34	80	0.4250000
NODE_888_length_2512_cov_48.259428	1299	1379	8	8	80	0.1000000
NODE_888_length_2512_cov_48.259428	1299	1379	10	8	80	0.1000000
NODE_888_length_2512_cov_48.259428	1299	1379	11	13	80	0.1625000
NODE_888_length_2512_cov_48.259428	1299	1379	13	20	80	0.2500000
NODE_888_length_2512_cov_48.259428	1299	1379	14	3	80	0.0375000
NODE_888_length_2512_cov_48.259428	1299	1379	16	25	80	0.3125000
NODE_888_length_2512_cov_48.259428	1299	1379	18	3	80	0.0375000
NODE_888_length_2512_cov_48.259428	1352	1432	8	20	80	0.2500000
NODE_888_length_2512_cov_48.259428	1352	1432	10	40	80	0.5000000
NODE_888_length_2512_cov_48.259428	1352	1432	11	16	80	0.2000000
NODE_888_length_2512_cov_48.259428	1352	1432	12	4	80	0.0500000
NODE_888_length_2512_cov_48.259428	1428	1512	8	19	84	0.2261905
NODE_888_length_2512_cov_48.259428	1428	1512	10	1	84	0.0119048
NODE_888_length_2512_cov_48.259428	1428	1512	12	5	84	0.0595238
NODE_888_length_2512_cov_48.259428	1428	1512	13	4	84	0.0476190
NODE_888_length_2512_cov_48.259428	1428	1512	14	8	84	0.0952381
NODE_888_length_2512_cov_48.259428	1428	1512	15	5	84	0.0595238
NODE_888_length_2512_cov_48.259428	1428	1512	17	2	84	0.0238095
NODE_888_length_2512_cov_48.259428	1428	1512	18	1	84	0.0119048
NODE_888_length_2512_cov_48.259428	1428	1512	19	3	84	0.0357143
NODE_888_length_2512_cov_48.259428	1428	1512	21	1	84	0.0119048
NODE_888_length_2512_cov_48.259428	1428	1512	27	6	84	0.0714286
NODE_888_length_2512_cov_48.259428	1428	1512	29	2	84	0.0238095
NODE_888_length_2512_cov_48.259428	1428	1512	31	3	84	0.0357143
NODE_888_length_2512_cov_48.259428	1428	1512	40	2	84	0.0238095
NODE_888_length_2512_cov_48.259428	1428	1512	42	1	84	0.0119048
NODE_888_length_2512_cov_48.259428	1428	1512	43	2	84	0.0238095
NODE_888_length_2512_cov_48.259428	1428	1512	47	1	84	0.0119048
NODE_888_length_2512_cov_48.259428	1428	1512	49	9	84	0.1071429
NODE_888_length_2512_cov_48.259428	1428	1512	50	1	84	0.0119048
NODE_888_length_2512_cov_48.259428	1428	1512	52	1	84	0.0119048
NODE_888_length_2512_cov_48.259428	1428	1512	54	1	84	0.0119048
NODE_888_length_2512_cov_48.259428	1428	1512	56	3	84	0.0357143
NODE_888_length_2512_cov_48.259428	1428	1512	57	3	84	0.0357143
NODE_888_length_2512_cov_48.259428	1485	1565	29	1	80	0.0125000
NODE_888_length_2512_cov_48.259428	1485	1565	31	2	80	0.0250000
NODE_888_length_2512_cov_48.259428	1485	1565	40	2	80	0.0250000
NODE_888_length_2512_cov_48.259428	1485	1565	42	1	80	0.0125000
NODE_888_length_2512_cov_48.259428	1485	1565	43	2	80	0.0250000
NODE_888_length_2512_cov_48.259428	1485	1565	47	1	80	0.0125000
NODE_888_length_2512_cov_48.259428	1485	1565	49	9	80	0.1125000
NODE_888_length_2512_cov_48.259428	1485	1565	50	1	80	0.0125000
NODE_888_length_2512_cov_48.259428	1485	1565	52	1	80	0.0125000
NODE_888_length_2512_cov_48.259428	1485	1565	54	1	80	0.0125000
NODE_888_length_2512_cov_48.259428	1485	1565	56	3	80	0.0375000
NODE_888_length_2512_cov_48.259428	1485	1565	57	10	80	0.1250000
NODE_888_length_2512_cov_48.259428	1485	1565	58	3	80	0.0375000
NODE_888_length_2512_cov_48.259428	1485	1565	60	1	80	0.0125000
NODE_888_length_2512_cov_48.259428	1485	1565	62	4	80	0.0500000
NODE_888_length_2512_cov_48.259428	1485	1565	64	2	80	0.0250000
NODE_888_length_2512_cov_48.259428	1485	1565	66	7	80	0.0875000
NODE_888_length_2512_cov_48.259428	1485	1565	68	7	80	0.0875000
NODE_888_length_2512_cov_48.259428	1485	1565	70	12	80	0.1500000
NODE_888_length_2512_cov_48.259428	1485	1565	72	1	80	0.0125000
NODE_888_length_2512_cov_48.259428	1485	1565	74	9	80	0.1125000
NODE_891_length_2505_cov_102.009975	390	470	0	13	80	0.1625000
NODE_891_length_2505_cov_102.009975	390	470	2	67	80	0.8375000
NODE_891_length_2505_cov_102.009975	443	510	0	17	67	0.2537313
NODE_891_length_2505_cov_102.009975	443	510	2	50	67	0.7462686
NODE_894_length_2499_cov_2.655417	2325	2375	2	2	50	0.0400000
NODE_894_length_2499_cov_2.655417	2325	2375	3	1	50	0.0200000
NODE_894_length_2499_cov_2.655417	2325	2375	5	2	50	0.0400000
NODE_894_length_2499_cov_2.655417	2325	2375	7	4	50	0.0800000
NODE_894_length_2499_cov_2.655417	2325	2375	9	3	50	0.0600000
NODE_894_length_2499_cov_2.655417	2325	2375	13	1	50	0.0200000
NODE_894_length_2499_cov_2.655417	2325	2375	18	1	50	0.0200000
NODE_894_length_2499_cov_2.655417	2325	2375	20	3	50	0.0600000
NODE_894_length_2499_cov_2.655417	2325	2375	22	2	50	0.0400000
NODE_894_length_2499_cov_2.655417	2325	2375	23	5	50	0.1000000
NODE_894_length_2499_cov_2.655417	2325	2375	24	1	50	0.0200000
NODE_894_length_2499_cov_2.655417	2325	2375	26	25	50	0.5000000
NODE_895_length_2498_cov_9.614840	239	281	2	42	42	1.0000000
NODE_895_length_2498_cov_9.614840	254	335	0	33	81	0.4074074
NODE_895_length_2498_cov_9.614840	254	335	2	48	81	0.5925926
NODE_895_length_2498_cov_9.614840	254	335	0	33	81	0.4074074
NODE_895_length_2498_cov_9.614840	254	335	2	48	81	0.5925926
NODE_895_length_2498_cov_9.614840	331	411	0	80	80	1.0000000
NODE_895_length_2498_cov_9.614840	384	464	0	80	80	1.0000000
NODE_898_length_2495_cov_5.151085	2395	2444	2	4	49	0.0816327
NODE_898_length_2495_cov_5.151085	2395	2444	4	45	49	0.9183673
NODE_898_length_2495_cov_5.151085	2395	2444	2	4	49	0.0816327
NODE_898_length_2495_cov_5.151085	2395	2444	4	45	49	0.9183673
NODE_898_length_2495_cov_5.151085	2396	2444	2	4	48	0.0833333
NODE_898_length_2495_cov_5.151085	2396	2444	4	44	48	0.9166667
NODE_898_length_2495_cov_5.151085	2396	2444	2	4	48	0.0833333
NODE_898_length_2495_cov_5.151085	2396	2444	4	44	48	0.9166667
NODE_898_length_2495_cov_5.151085	2396	2444	2	4	48	0.0833333
NODE_898_length_2495_cov_5.151085	2396	2444	4	44	48	0.9166667
NODE_900_length_2492_cov_43.645215	408	488	0	80	80	1.0000000
NODE_903_length_2489_cov_15.105021	204	234	2	7	30	0.2333333
NODE_903_length_2489_cov_15.105021	204	234	4	19	30	0.6333333
NODE_903_length_2489_cov_15.105021	204	234	6	3	30	0.1000000
NODE_903_length_2489_cov_15.105021	204	234	8	1	30	0.0333333
NODE_905_length_2488_cov_2.434910	2141	2200	16	17	59	0.2881356
NODE_905_length_2488_cov_2.434910	2141	2200	18	13	59	0.2203390
NODE_905_length_2488_cov_2.434910	2141	2200	20	3	59	0.0508475
NODE_905_length_2488_cov_2.434910	2141	2200	22	26	59	0.4406780
NODE_906_length_2484_cov_335.301887	224	279	581	1	55	0.0181818
NODE_906_length_2484_cov_335.301887	224	279	588	1	55	0.0181818
NODE_906_length_2484_cov_335.301887	224	279	591	3	55	0.0545455
NODE_906_length_2484_cov_335.301887	224	279	593	1	55	0.0181818
NODE_906_length_2484_cov_335.301887	224	279	607	1	55	0.0181818
NODE_906_length_2484_cov_335.301887	224	279	611	1	55	0.0181818
NODE_906_length_2484_cov_335.301887	224	279	618	1	55	0.0181818
NODE_906_length_2484_cov_335.301887	224	279	623	1	55	0.0181818
NODE_906_length_2484_cov_335.301887	224	279	624	1	55	0.0181818
NODE_906_length_2484_cov_335.301887	224	279	626	2	55	0.0363636
NODE_906_length_2484_cov_335.301887	224	279	627	1	55	0.0181818
NODE_906_length_2484_cov_335.301887	224	279	628	1	55	0.0181818
NODE_906_length_2484_cov_335.301887	224	279	631	2	55	0.0363636
NODE_906_length_2484_cov_335.301887	224	279	632	1	55	0.0181818
NODE_906_length_2484_cov_335.301887	224	279	634	2	55	0.0363636
NODE_906_length_2484_cov_335.301887	224	279	636	1	55	0.0181818
NODE_906_length_2484_cov_335.301887	224	279	638	1	55	0.0181818
NODE_906_length_2484_cov_335.301887	224	279	639	1	55	0.0181818
NODE_906_length_2484_cov_335.301887	224	279	642	1	55	0.0181818
NODE_906_length_2484_cov_335.301887	224	279	643	1	55	0.0181818
NODE_906_length_2484_cov_335.301887	224	279	645	2	55	0.0363636
NODE_906_length_2484_cov_335.301887	224	279	646	1	55	0.0181818
NODE_906_length_2484_cov_335.301887	224	279	647	4	55	0.0727273
NODE_906_length_2484_cov_335.301887	224	279	648	2	55	0.0363636
NODE_906_length_2484_cov_335.301887	224	279	649	1	55	0.0181818
NODE_906_length_2484_cov_335.301887	224	279	653	1	55	0.0181818
NODE_906_length_2484_cov_335.301887	224	279	654	1	55	0.0181818
NODE_906_length_2484_cov_335.301887	224	279	657	1	55	0.0181818
NODE_906_length_2484_cov_335.301887	224	279	662	1	55	0.0181818
NODE_906_length_2484_cov_335.301887	224	279	663	2	55	0.0363636
NODE_906_length_2484_cov_335.301887	224	279	666	1	55	0.0181818
NODE_906_length_2484_cov_335.301887	224	279	667	1	55	0.0181818
NODE_906_length_2484_cov_335.301887	224	279	670	1	55	0.0181818
NODE_906_length_2484_cov_335.301887	224	279	671	2	55	0.0363636
NODE_906_length_2484_cov_335.301887	224	279	672	1	55	0.0181818
NODE_906_length_2484_cov_335.301887	224	279	673	1	55	0.0181818
NODE_906_length_2484_cov_335.301887	224	279	674	1	55	0.0181818
NODE_906_length_2484_cov_335.301887	224	279	679	1	55	0.0181818
NODE_906_length_2484_cov_335.301887	224	279	680	1	55	0.0181818
NODE_906_length_2484_cov_335.301887	224	279	681	1	55	0.0181818
NODE_906_length_2484_cov_335.301887	224	279	684	1	55	0.0181818
NODE_906_length_2484_cov_335.301887	224	279	686	1	55	0.0181818
NODE_906_length_2484_cov_335.301887	224	279	690	1	55	0.0181818
NODE_906_length_2484_cov_335.301887	252	332	475	1	80	0.0125000
NODE_906_length_2484_cov_335.301887	252	332	480	1	80	0.0125000
NODE_906_length_2484_cov_335.301887	252	332	482	1	80	0.0125000
NODE_906_length_2484_cov_335.301887	252	332	492	1	80	0.0125000
NODE_906_length_2484_cov_335.301887	252	332	494	2	80	0.0250000
NODE_906_length_2484_cov_335.301887	252	332	500	1	80	0.0125000
NODE_906_length_2484_cov_335.301887	252	332	512	1	80	0.0125000
NODE_906_length_2484_cov_335.301887	252	332	516	1	80	0.0125000
NODE_906_length_2484_cov_335.301887	252	332	524	1	80	0.0125000
NODE_906_length_2484_cov_335.301887	252	332	531	1	80	0.0125000
NODE_906_length_2484_cov_335.301887	252	332	542	1	80	0.0125000
NODE_906_length_2484_cov_335.301887	252	332	551	1	80	0.0125000
NODE_906_length_2484_cov_335.301887	252	332	567	1	80	0.0125000
NODE_906_length_2484_cov_335.301887	252	332	589	1	80	0.0125000
NODE_906_length_2484_cov_335.301887	252	332	611	1	80	0.0125000
NODE_906_length_2484_cov_335.301887	252	332	617	1	80	0.0125000
NODE_906_length_2484_cov_335.301887	252	332	626	1	80	0.0125000
NODE_906_length_2484_cov_335.301887	252	332	631	1	80	0.0125000
NODE_906_length_2484_cov_335.301887	252	332	641	1	80	0.0125000
NODE_906_length_2484_cov_335.301887	252	332	647	6	80	0.0750000
NODE_906_length_2484_cov_335.301887	252	332	648	3	80	0.0375000
NODE_906_length_2484_cov_335.301887	252	332	649	1	80	0.0125000
NODE_906_length_2484_cov_335.301887	252	332	653	3	80	0.0375000
NODE_906_length_2484_cov_335.301887	252	332	654	1	80	0.0125000
NODE_906_length_2484_cov_335.301887	252	332	655	1	80	0.0125000
NODE_906_length_2484_cov_335.301887	252	332	656	1	80	0.0125000
NODE_906_length_2484_cov_335.301887	252	332	657	3	80	0.0375000
NODE_906_length_2484_cov_335.301887	252	332	658	5	80	0.0625000
NODE_906_length_2484_cov_335.301887	252	332	661	1	80	0.0125000
NODE_906_length_2484_cov_335.301887	252	332	662	2	80	0.0250000
NODE_906_length_2484_cov_335.301887	252	332	663	2	80	0.0250000
NODE_906_length_2484_cov_335.301887	252	332	664	1	80	0.0125000
NODE_906_length_2484_cov_335.301887	252	332	665	1	80	0.0125000
NODE_906_length_2484_cov_335.301887	252	332	666	2	80	0.0250000
NODE_906_length_2484_cov_335.301887	252	332	667	1	80	0.0125000
NODE_906_length_2484_cov_335.301887	252	332	669	1	80	0.0125000
NODE_906_length_2484_cov_335.301887	252	332	670	4	80	0.0500000
NODE_906_length_2484_cov_335.301887	252	332	671	3	80	0.0375000
NODE_906_length_2484_cov_335.301887	252	332	672	1	80	0.0125000
NODE_906_length_2484_cov_335.301887	252	332	673	2	80	0.0250000
NODE_906_length_2484_cov_335.301887	252	332	674	2	80	0.0250000
NODE_906_length_2484_cov_335.301887	252	332	675	1	80	0.0125000
NODE_906_length_2484_cov_335.301887	252	332	677	2	80	0.0250000
NODE_906_length_2484_cov_335.301887	252	332	679	4	80	0.0500000
NODE_906_length_2484_cov_335.301887	252	332	680	1	80	0.0125000
NODE_906_length_2484_cov_335.301887	252	332	681	1	80	0.0125000
NODE_906_length_2484_cov_335.301887	252	332	684	1	80	0.0125000
NODE_906_length_2484_cov_335.301887	252	332	685	1	80	0.0125000
NODE_906_length_2484_cov_335.301887	252	332	686	1	80	0.0125000
NODE_906_length_2484_cov_335.301887	252	332	690	1	80	0.0125000
NODE_912_length_2479_cov_90.381092	369	449	0	74	80	0.9250000
NODE_912_length_2479_cov_90.381092	369	449	2	6	80	0.0750000
NODE_912_length_2479_cov_90.381092	422	499	0	21	77	0.2727273
NODE_912_length_2479_cov_90.381092	422	499	2	11	77	0.1428571
NODE_912_length_2479_cov_90.381092	422	499	4	45	77	0.5844156
NODE_912_length_2479_cov_90.381092	1610	1685	42	1	75	0.0133333
NODE_912_length_2479_cov_90.381092	1610	1685	61	1	75	0.0133333
NODE_912_length_2479_cov_90.381092	1610	1685	65	1	75	0.0133333
NODE_912_length_2479_cov_90.381092	1610	1685	67	2	75	0.0266667
NODE_912_length_2479_cov_90.381092	1610	1685	71	1	75	0.0133333
NODE_912_length_2479_cov_90.381092	1610	1685	77	1	75	0.0133333
NODE_912_length_2479_cov_90.381092	1610	1685	78	3	75	0.0400000
NODE_912_length_2479_cov_90.381092	1610	1685	82	1	75	0.0133333
NODE_912_length_2479_cov_90.381092	1610	1685	84	1	75	0.0133333
NODE_912_length_2479_cov_90.381092	1610	1685	95	1	75	0.0133333
NODE_912_length_2479_cov_90.381092	1610	1685	97	1	75	0.0133333
NODE_912_length_2479_cov_90.381092	1610	1685	99	3	75	0.0400000
NODE_912_length_2479_cov_90.381092	1610	1685	103	1	75	0.0133333
NODE_912_length_2479_cov_90.381092	1610	1685	105	1	75	0.0133333
NODE_912_length_2479_cov_90.381092	1610	1685	109	1	75	0.0133333
NODE_912_length_2479_cov_90.381092	1610	1685	117	2	75	0.0266667
NODE_912_length_2479_cov_90.381092	1610	1685	121	1	75	0.0133333
NODE_912_length_2479_cov_90.381092	1610	1685	131	1	75	0.0133333
NODE_912_length_2479_cov_90.381092	1610	1685	135	1	75	0.0133333
NODE_912_length_2479_cov_90.381092	1610	1685	138	1	75	0.0133333
NODE_912_length_2479_cov_90.381092	1610	1685	144	2	75	0.0266667
NODE_912_length_2479_cov_90.381092	1610	1685	145	1	75	0.0133333
NODE_912_length_2479_cov_90.381092	1610	1685	149	1	75	0.0133333
NODE_912_length_2479_cov_90.381092	1610	1685	157	1	75	0.0133333
NODE_912_length_2479_cov_90.381092	1610	1685	159	1	75	0.0133333
NODE_912_length_2479_cov_90.381092	1610	1685	168	1	75	0.0133333
NODE_912_length_2479_cov_90.381092	1610	1685	170	1	75	0.0133333
NODE_912_length_2479_cov_90.381092	1610	1685	174	1	75	0.0133333
NODE_912_length_2479_cov_90.381092	1610	1685	176	1	75	0.0133333
NODE_912_length_2479_cov_90.381092	1610	1685	183	3	75	0.0400000
NODE_912_length_2479_cov_90.381092	1610	1685	198	1	75	0.0133333
NODE_912_length_2479_cov_90.381092	1610	1685	204	2	75	0.0266667
NODE_912_length_2479_cov_90.381092	1610	1685	211	2	75	0.0266667
NODE_912_length_2479_cov_90.381092	1610	1685	219	1	75	0.0133333
NODE_912_length_2479_cov_90.381092	1610	1685	221	2	75	0.0266667
NODE_912_length_2479_cov_90.381092	1610	1685	223	1	75	0.0133333
NODE_912_length_2479_cov_90.381092	1610	1685	225	1	75	0.0133333
NODE_912_length_2479_cov_90.381092	1610	1685	229	1	75	0.0133333
NODE_912_length_2479_cov_90.381092	1610	1685	231	1	75	0.0133333
NODE_912_length_2479_cov_90.381092	1610	1685	235	1	75	0.0133333
NODE_912_length_2479_cov_90.381092	1610	1685	241	1	75	0.0133333
NODE_912_length_2479_cov_90.381092	1610	1685	245	1	75	0.0133333
NODE_912_length_2479_cov_90.381092	1610	1685	255	1	75	0.0133333
NODE_912_length_2479_cov_90.381092	1610	1685	262	1	75	0.0133333
NODE_912_length_2479_cov_90.381092	1610	1685	268	1	75	0.0133333
NODE_912_length_2479_cov_90.381092	1610	1685	270	1	75	0.0133333
NODE_912_length_2479_cov_90.381092	1610	1685	272	1	75	0.0133333
NODE_912_length_2479_cov_90.381092	1610	1685	278	1	75	0.0133333
NODE_912_length_2479_cov_90.381092	1610	1685	280	4	75	0.0533333
NODE_912_length_2479_cov_90.381092	1610	1685	282	1	75	0.0133333
NODE_912_length_2479_cov_90.381092	1610	1685	283	1	75	0.0133333
NODE_912_length_2479_cov_90.381092	1610	1685	285	2	75	0.0266667
NODE_912_length_2479_cov_90.381092	1610	1685	287	1	75	0.0133333
NODE_912_length_2479_cov_90.381092	1610	1685	289	2	75	0.0266667
NODE_912_length_2479_cov_90.381092	1610	1685	290	1	75	0.0133333
NODE_912_length_2479_cov_90.381092	1610	1685	291	2	75	0.0266667
NODE_912_length_2479_cov_90.381092	1610	1685	293	1	75	0.0133333
NODE_912_length_2479_cov_90.381092	1658	1730	225	1	72	0.0138889
NODE_912_length_2479_cov_90.381092	1658	1730	229	1	72	0.0138889
NODE_912_length_2479_cov_90.381092	1658	1730	231	1	72	0.0138889
NODE_912_length_2479_cov_90.381092	1658	1730	235	1	72	0.0138889
NODE_912_length_2479_cov_90.381092	1658	1730	241	1	72	0.0138889
NODE_912_length_2479_cov_90.381092	1658	1730	245	1	72	0.0138889
NODE_912_length_2479_cov_90.381092	1658	1730	255	1	72	0.0138889
NODE_912_length_2479_cov_90.381092	1658	1730	262	1	72	0.0138889
NODE_912_length_2479_cov_90.381092	1658	1730	268	1	72	0.0138889
NODE_912_length_2479_cov_90.381092	1658	1730	270	1	72	0.0138889
NODE_912_length_2479_cov_90.381092	1658	1730	272	1	72	0.0138889
NODE_912_length_2479_cov_90.381092	1658	1730	278	1	72	0.0138889
NODE_912_length_2479_cov_90.381092	1658	1730	280	4	72	0.0555556
NODE_912_length_2479_cov_90.381092	1658	1730	282	1	72	0.0138889
NODE_912_length_2479_cov_90.381092	1658	1730	283	1	72	0.0138889
NODE_912_length_2479_cov_90.381092	1658	1730	285	2	72	0.0277778
NODE_912_length_2479_cov_90.381092	1658	1730	287	1	72	0.0138889
NODE_912_length_2479_cov_90.381092	1658	1730	289	2	72	0.0277778
NODE_912_length_2479_cov_90.381092	1658	1730	290	1	72	0.0138889
NODE_912_length_2479_cov_90.381092	1658	1730	291	2	72	0.0277778
NODE_912_length_2479_cov_90.381092	1658	1730	292	3	72	0.0416667
NODE_912_length_2479_cov_90.381092	1658	1730	293	2	72	0.0277778
NODE_912_length_2479_cov_90.381092	1658	1730	294	1	72	0.0138889
NODE_912_length_2479_cov_90.381092	1658	1730	295	2	72	0.0277778
NODE_912_length_2479_cov_90.381092	1658	1730	296	1	72	0.0138889
NODE_912_length_2479_cov_90.381092	1658	1730	297	1	72	0.0138889
NODE_912_length_2479_cov_90.381092	1658	1730	300	4	72	0.0555556
NODE_912_length_2479_cov_90.381092	1658	1730	303	2	72	0.0277778
NODE_912_length_2479_cov_90.381092	1658	1730	304	5	72	0.0694444
NODE_912_length_2479_cov_90.381092	1658	1730	306	2	72	0.0277778
NODE_912_length_2479_cov_90.381092	1658	1730	307	5	72	0.0694444
NODE_912_length_2479_cov_90.381092	1658	1730	308	1	72	0.0138889
NODE_912_length_2479_cov_90.381092	1658	1730	309	1	72	0.0138889
NODE_912_length_2479_cov_90.381092	1658	1730	310	1	72	0.0138889
NODE_912_length_2479_cov_90.381092	1658	1730	311	2	72	0.0277778
NODE_912_length_2479_cov_90.381092	1658	1730	312	2	72	0.0277778
NODE_912_length_2479_cov_90.381092	1658	1730	313	2	72	0.0277778
NODE_912_length_2479_cov_90.381092	1658	1730	314	4	72	0.0555556
NODE_912_length_2479_cov_90.381092	1658	1730	315	1	72	0.0138889
NODE_912_length_2479_cov_90.381092	1658	1730	316	4	72	0.0555556
NODE_913_length_2479_cov_3.433193	2379	2426	2	44	47	0.9361702
NODE_913_length_2479_cov_3.433193	2379	2426	4	1	47	0.0212766
NODE_913_length_2479_cov_3.433193	2379	2426	10	2	47	0.0425532
NODE_913_length_2479_cov_3.433193	2399	2479	0	6	80	0.0750000
NODE_913_length_2479_cov_3.433193	2399	2479	2	74	80	0.9250000
NODE_915_length_2474_cov_7.237895	399	479	3	15	80	0.1875000
NODE_915_length_2474_cov_7.237895	399	479	5	65	80	0.8125000
NODE_915_length_2474_cov_7.237895	452	532	0	31	80	0.3875000
NODE_915_length_2474_cov_7.237895	452	532	2	1	80	0.0125000
NODE_915_length_2474_cov_7.237895	452	532	3	11	80	0.1375000
NODE_915_length_2474_cov_7.237895	452	532	5	37	80	0.4625000
NODE_922_length_2465_cov_3.098056	2133	2213	0	25	80	0.3125000
NODE_922_length_2465_cov_3.098056	2133	2213	2	55	80	0.6875000
NODE_922_length_2465_cov_3.098056	2191	2253	2	62	62	1.0000000
NODE_923_length_2464_cov_24.562791	331	409	0	78	78	1.0000000
NODE_923_length_2464_cov_24.562791	382	462	0	80	80	1.0000000
NODE_924_length_2461_cov_2.696444	292	372	0	64	80	0.8000000
NODE_924_length_2461_cov_2.696444	292	372	2	2	80	0.0250000
NODE_924_length_2461_cov_2.696444	292	372	4	14	80	0.1750000
NODE_924_length_2461_cov_2.696444	345	425	0	13	80	0.1625000
NODE_924_length_2461_cov_2.696444	345	425	4	67	80	0.8375000
NODE_938_length_2447_cov_16.079216	2344	2424	14	3	80	0.0375000
NODE_938_length_2447_cov_16.079216	2344	2424	16	4	80	0.0500000
NODE_938_length_2447_cov_16.079216	2344	2424	18	13	80	0.1625000
NODE_938_length_2447_cov_16.079216	2344	2424	20	4	80	0.0500000
NODE_938_length_2447_cov_16.079216	2344	2424	22	1	80	0.0125000
NODE_938_length_2447_cov_16.079216	2344	2424	24	1	80	0.0125000
NODE_938_length_2447_cov_16.079216	2344	2424	28	4	80	0.0500000
NODE_938_length_2447_cov_16.079216	2344	2424	30	1	80	0.0125000
NODE_938_length_2447_cov_16.079216	2344	2424	34	5	80	0.0625000
NODE_938_length_2447_cov_16.079216	2344	2424	36	8	80	0.1000000
NODE_938_length_2447_cov_16.079216	2344	2424	38	6	80	0.0750000
NODE_938_length_2447_cov_16.079216	2344	2424	40	2	80	0.0250000
NODE_938_length_2447_cov_16.079216	2344	2424	42	2	80	0.0250000
NODE_938_length_2447_cov_16.079216	2344	2424	44	7	80	0.0875000
NODE_938_length_2447_cov_16.079216	2344	2424	46	2	80	0.0250000
NODE_938_length_2447_cov_16.079216	2344	2424	49	2	80	0.0250000
NODE_938_length_2447_cov_16.079216	2344	2424	50	4	80	0.0500000
NODE_938_length_2447_cov_16.079216	2344	2424	54	1	80	0.0125000
NODE_938_length_2447_cov_16.079216	2344	2424	55	1	80	0.0125000
NODE_938_length_2447_cov_16.079216	2344	2424	57	1	80	0.0125000
NODE_938_length_2447_cov_16.079216	2344	2424	62	6	80	0.0750000
NODE_938_length_2447_cov_16.079216	2344	2424	64	1	80	0.0125000
NODE_938_length_2447_cov_16.079216	2344	2424	68	1	80	0.0125000
NODE_938_length_2447_cov_16.079216	2397	2447	4	3	50	0.0600000
NODE_938_length_2447_cov_16.079216	2397	2447	6	8	50	0.1600000
NODE_938_length_2447_cov_16.079216	2397	2447	10	3	50	0.0600000
NODE_938_length_2447_cov_16.079216	2397	2447	12	2	50	0.0400000
NODE_938_length_2447_cov_16.079216	2397	2447	14	10	50	0.2000000
NODE_938_length_2447_cov_16.079216	2397	2447	16	4	50	0.0800000
NODE_938_length_2447_cov_16.079216	2397	2447	18	13	50	0.2600000
NODE_938_length_2447_cov_16.079216	2397	2447	20	4	50	0.0800000
NODE_938_length_2447_cov_16.079216	2397	2447	22	1	50	0.0200000
NODE_938_length_2447_cov_16.079216	2397	2447	24	1	50	0.0200000
NODE_938_length_2447_cov_16.079216	2397	2447	28	1	50	0.0200000
NODE_940_length_2446_cov_2.341287	1521	1578	0	6	57	0.1052632
NODE_940_length_2446_cov_2.341287	1521	1578	2	51	57	0.8947368
NODE_940_length_2446_cov_2.341287	1551	1593	2	34	42	0.8095238
NODE_940_length_2446_cov_2.341287	1551	1593	4	8	42	0.1904762
NODE_949_length_2437_cov_13.341745	418	498	0	71	80	0.8875000
NODE_949_length_2437_cov_13.341745	418	498	2	9	80	0.1125000
NODE_949_length_2437_cov_13.341745	471	551	0	62	80	0.7750000
NODE_949_length_2437_cov_13.341745	471	551	1	7	80	0.0875000
NODE_949_length_2437_cov_13.341745	471	551	3	6	80	0.0750000
NODE_949_length_2437_cov_13.341745	471	551	7	1	80	0.0125000
NODE_949_length_2437_cov_13.341745	471	551	15	1	80	0.0125000
NODE_949_length_2437_cov_13.341745	471	551	16	1	80	0.0125000
NODE_949_length_2437_cov_13.341745	471	551	18	2	80	0.0250000
NODE_951_length_2432_cov_70.360909	1875	1955	0	44	80	0.5500000
NODE_951_length_2432_cov_70.360909	1875	1955	4	36	80	0.4500000
NODE_951_length_2432_cov_70.360909	1928	2008	4	80	80	1.0000000
NODE_955_length_2430_cov_19.835264	0	68	18	1	68	0.0147059
NODE_955_length_2430_cov_19.835264	0	68	21	1	68	0.0147059
NODE_955_length_2430_cov_19.835264	0	68	28	1	68	0.0147059
NODE_955_length_2430_cov_19.835264	0	68	30	2	68	0.0294118
NODE_955_length_2430_cov_19.835264	0	68	33	1	68	0.0147059
NODE_955_length_2430_cov_19.835264	0	68	35	1	68	0.0147059
NODE_955_length_2430_cov_19.835264	0	68	36	3	68	0.0441176
NODE_955_length_2430_cov_19.835264	0	68	40	1	68	0.0147059
NODE_955_length_2430_cov_19.835264	0	68	41	2	68	0.0294118
NODE_955_length_2430_cov_19.835264	0	68	43	2	68	0.0294118
NODE_955_length_2430_cov_19.835264	0	68	45	1	68	0.0147059
NODE_955_length_2430_cov_19.835264	0	68	47	1	68	0.0147059
NODE_955_length_2430_cov_19.835264	0	68	49	1	68	0.0147059
NODE_955_length_2430_cov_19.835264	0	68	53	3	68	0.0441176
NODE_955_length_2430_cov_19.835264	0	68	56	2	68	0.0294118
NODE_955_length_2430_cov_19.835264	0	68	60	1	68	0.0147059
NODE_955_length_2430_cov_19.835264	0	68	62	2	68	0.0294118
NODE_955_length_2430_cov_19.835264	0	68	70	2	68	0.0294118
NODE_955_length_2430_cov_19.835264	0	68	72	4	68	0.0588235
NODE_955_length_2430_cov_19.835264	0	68	74	2	68	0.0294118
NODE_955_length_2430_cov_19.835264	0	68	76	2	68	0.0294118
NODE_955_length_2430_cov_19.835264	0	68	78	3	68	0.0441176
NODE_955_length_2430_cov_19.835264	0	68	80	1	68	0.0147059
NODE_955_length_2430_cov_19.835264	0	68	83	1	68	0.0147059
NODE_955_length_2430_cov_19.835264	0	68	87	4	68	0.0588235
NODE_955_length_2430_cov_19.835264	0	68	91	2	68	0.0294118
NODE_955_length_2430_cov_19.835264	0	68	93	3	68	0.0441176
NODE_955_length_2430_cov_19.835264	0	68	94	1	68	0.0147059
NODE_955_length_2430_cov_19.835264	0	68	95	1	68	0.0147059
NODE_955_length_2430_cov_19.835264	0	68	96	1	68	0.0147059
NODE_955_length_2430_cov_19.835264	0	68	100	2	68	0.0294118
NODE_955_length_2430_cov_19.835264	0	68	106	1	68	0.0147059
NODE_955_length_2430_cov_19.835264	0	68	109	1	68	0.0147059
NODE_955_length_2430_cov_19.835264	0	68	111	1	68	0.0147059
NODE_955_length_2430_cov_19.835264	0	68	126	1	68	0.0147059
NODE_955_length_2430_cov_19.835264	0	68	130	2	68	0.0294118
NODE_955_length_2430_cov_19.835264	0	68	139	1	68	0.0147059
NODE_955_length_2430_cov_19.835264	0	68	144	1	68	0.0147059
NODE_955_length_2430_cov_19.835264	0	68	148	2	68	0.0294118
NODE_955_length_2430_cov_19.835264	0	68	151	1	68	0.0147059
NODE_955_length_2430_cov_19.835264	0	68	152	2	68	0.0294118
NODE_955_length_2430_cov_19.835264	0	24	18	1	24	0.0416667
NODE_955_length_2430_cov_19.835264	0	24	21	1	24	0.0416667
NODE_955_length_2430_cov_19.835264	0	24	28	1	24	0.0416667
NODE_955_length_2430_cov_19.835264	0	24	30	2	24	0.0833333
NODE_955_length_2430_cov_19.835264	0	24	33	1	24	0.0416667
NODE_955_length_2430_cov_19.835264	0	24	35	1	24	0.0416667
NODE_955_length_2430_cov_19.835264	0	24	36	3	24	0.1250000
NODE_955_length_2430_cov_19.835264	0	24	40	1	24	0.0416667
NODE_955_length_2430_cov_19.835264	0	24	41	2	24	0.0833333
NODE_955_length_2430_cov_19.835264	0	24	43	2	24	0.0833333
NODE_955_length_2430_cov_19.835264	0	24	45	1	24	0.0416667
NODE_955_length_2430_cov_19.835264	0	24	47	1	24	0.0416667
NODE_955_length_2430_cov_19.835264	0	24	49	1	24	0.0416667
NODE_955_length_2430_cov_19.835264	0	24	53	3	24	0.1250000
NODE_955_length_2430_cov_19.835264	0	24	56	2	24	0.0833333
NODE_955_length_2430_cov_19.835264	0	24	60	1	24	0.0416667
NODE_956_length_2428_cov_179.842422	538	618	0	31	80	0.3875000
NODE_956_length_2428_cov_179.842422	538	618	2	49	80	0.6125000
NODE_956_length_2428_cov_179.842422	591	671	0	80	80	1.0000000
NODE_956_length_2428_cov_179.842422	667	747	0	20	80	0.2500000
NODE_956_length_2428_cov_179.842422	667	747	2	60	80	0.7500000
NODE_956_length_2428_cov_179.842422	720	800	0	47	80	0.5875000
NODE_956_length_2428_cov_179.842422	720	800	2	33	80	0.4125000
NODE_956_length_2428_cov_179.842422	1308	1388	0	80	80	1.0000000
NODE_956_length_2428_cov_179.842422	1361	1441	0	80	80	1.0000000
NODE_956_length_2428_cov_179.842422	1437	1517	0	80	80	1.0000000
NODE_956_length_2428_cov_179.842422	1490	1570	0	33	80	0.4125000
NODE_956_length_2428_cov_179.842422	1490	1570	2	47	80	0.5875000
NODE_956_length_2428_cov_179.842422	1986	2026	697	1	40	0.0250000
NODE_956_length_2428_cov_179.842422	1986	2026	702	1	40	0.0250000
NODE_956_length_2428_cov_179.842422	1986	2026	703	2	40	0.0500000
NODE_956_length_2428_cov_179.842422	1986	2026	705	2	40	0.0500000
NODE_956_length_2428_cov_179.842422	1986	2026	707	4	40	0.1000000
NODE_956_length_2428_cov_179.842422	1986	2026	708	2	40	0.0500000
NODE_956_length_2428_cov_179.842422	1986	2026	709	1	40	0.0250000
NODE_956_length_2428_cov_179.842422	1986	2026	711	1	40	0.0250000
NODE_956_length_2428_cov_179.842422	1986	2026	712	3	40	0.0750000
NODE_956_length_2428_cov_179.842422	1986	2026	713	2	40	0.0500000
NODE_956_length_2428_cov_179.842422	1986	2026	716	1	40	0.0250000
NODE_956_length_2428_cov_179.842422	1986	2026	717	1	40	0.0250000
NODE_956_length_2428_cov_179.842422	1986	2026	719	2	40	0.0500000
NODE_956_length_2428_cov_179.842422	1986	2026	721	1	40	0.0250000
NODE_956_length_2428_cov_179.842422	1986	2026	722	1	40	0.0250000
NODE_956_length_2428_cov_179.842422	1986	2026	725	1	40	0.0250000
NODE_956_length_2428_cov_179.842422	1986	2026	727	1	40	0.0250000
NODE_956_length_2428_cov_179.842422	1986	2026	729	1	40	0.0250000
NODE_956_length_2428_cov_179.842422	1986	2026	730	2	40	0.0500000
NODE_956_length_2428_cov_179.842422	1986	2026	733	1	40	0.0250000
NODE_956_length_2428_cov_179.842422	1986	2026	735	1	40	0.0250000
NODE_956_length_2428_cov_179.842422	1986	2026	739	1	40	0.0250000
NODE_956_length_2428_cov_179.842422	1986	2026	740	1	40	0.0250000
NODE_956_length_2428_cov_179.842422	1986	2026	751	1	40	0.0250000
NODE_956_length_2428_cov_179.842422	1986	2026	752	2	40	0.0500000
NODE_956_length_2428_cov_179.842422	1986	2026	755	1	40	0.0250000
NODE_956_length_2428_cov_179.842422	1986	2026	758	2	40	0.0500000
NODE_959_length_2422_cov_6.665088	197	255	0	25	58	0.4310345
NODE_959_length_2422_cov_6.665088	197	255	2	33	58	0.5689655
NODE_963_length_2414_cov_32.871706	411	491	2	80	80	1.0000000
NODE_963_length_2414_cov_32.871706	464	544	0	21	80	0.2625000
NODE_963_length_2414_cov_32.871706	464	544	2	59	80	0.7375000
NODE_964_length_2414_cov_2.105832	2349	2390	0	41	41	1.0000000
NODE_968_length_2410_cov_9.107313	1874	1954	0	33	80	0.4125000
NODE_968_length_2410_cov_9.107313	1874	1954	2	47	80	0.5875000
NODE_968_length_2410_cov_9.107313	1927	2007	0	8	80	0.1000000
NODE_968_length_2410_cov_9.107313	1927	2007	2	72	80	0.9000000
NODE_977_length_2390_cov_20.371454	1753	1833	2	26	80	0.3250000
NODE_977_length_2390_cov_20.371454	1753	1833	4	54	80	0.6750000
NODE_977_length_2390_cov_20.371454	1806	1886	0	35	80	0.4375000
NODE_977_length_2390_cov_20.371454	1806	1886	2	44	80	0.5500000
NODE_977_length_2390_cov_20.371454	1806	1886	4	1	80	0.0125000
NODE_979_length_2389_cov_17.904803	1601	1681	0	57	80	0.7125000
NODE_979_length_2389_cov_17.904803	1601	1681	2	23	80	0.2875000
NODE_979_length_2389_cov_17.904803	1654	1734	0	4	80	0.0500000
NODE_979_length_2389_cov_17.904803	1654	1734	2	76	80	0.9500000
NODE_979_length_2389_cov_17.904803	1730	1810	2	38	80	0.4750000
NODE_979_length_2389_cov_17.904803	1730	1810	4	27	80	0.3375000
NODE_979_length_2389_cov_17.904803	1730	1810	6	15	80	0.1875000
NODE_979_length_2389_cov_17.904803	1783	1863	2	8	80	0.1000000
NODE_979_length_2389_cov_17.904803	1783	1863	4	36	80	0.4500000
NODE_979_length_2389_cov_17.904803	1783	1863	6	36	80	0.4500000
NODE_988_length_2381_cov_32.280894	398	478	0	80	80	1.0000000
NODE_988_length_2381_cov_32.280894	451	531	0	80	80	1.0000000
NODE_988_length_2381_cov_32.280894	527	607	0	80	80	1.0000000
NODE_988_length_2381_cov_32.280894	580	660	0	66	80	0.8250000
NODE_988_length_2381_cov_32.280894	580	660	2	14	80	0.1750000
NODE_988_length_2381_cov_32.280894	2288	2368	0	3	80	0.0375000
NODE_988_length_2381_cov_32.280894	2288	2368	6	77	80	0.9625000
NODE_997_length_2369_cov_4.896916	241	321	0	29	80	0.3625000
NODE_997_length_2369_cov_4.896916	241	321	2	3	80	0.0375000
NODE_997_length_2369_cov_4.896916	241	321	4	48	80	0.6000000
NODE_997_length_2369_cov_4.896916	294	374	0	16	80	0.2000000
NODE_997_length_2369_cov_4.896916	294	374	2	31	80	0.3875000
NODE_997_length_2369_cov_4.896916	294	374	3	1	80	0.0125000
NODE_997_length_2369_cov_4.896916	294	374	4	32	80	0.4000000
NODE_1002_length_2364_cov_2.482561	0	79	0	79	79	1.0000000
NODE_1004_length_2360_cov_8.620080	587	651	10	1	64	0.0156250
NODE_1004_length_2360_cov_8.620080	587	651	11	8	64	0.1250000
NODE_1004_length_2360_cov_8.620080	587	651	13	12	64	0.1875000
NODE_1004_length_2360_cov_8.620080	587	651	14	32	64	0.5000000
NODE_1004_length_2360_cov_8.620080	587	651	15	11	64	0.1718750
NODE_1004_length_2360_cov_8.620080	587	651	10	1	64	0.0156250
NODE_1004_length_2360_cov_8.620080	587	651	11	8	64	0.1250000
NODE_1004_length_2360_cov_8.620080	587	651	13	12	64	0.1875000
NODE_1004_length_2360_cov_8.620080	587	651	14	32	64	0.5000000
NODE_1004_length_2360_cov_8.620080	587	651	15	11	64	0.1718750
NODE_1004_length_2360_cov_8.620080	624	684	9	6	60	0.1000000
NODE_1004_length_2360_cov_8.620080	624	684	10	16	60	0.2666667
NODE_1004_length_2360_cov_8.620080	624	684	11	13	60	0.2166667
NODE_1004_length_2360_cov_8.620080	624	684	13	18	60	0.3000000
NODE_1004_length_2360_cov_8.620080	624	684	15	7	60	0.1166667
NODE_1004_length_2360_cov_8.620080	1827	1907	0	16	80	0.2000000
NODE_1004_length_2360_cov_8.620080	1827	1907	2	6	80	0.0750000
NODE_1004_length_2360_cov_8.620080	1827	1907	5	3	80	0.0375000
NODE_1004_length_2360_cov_8.620080	1827	1907	7	16	80	0.2000000
NODE_1004_length_2360_cov_8.620080	1827	1907	8	39	80	0.4875000
NODE_1004_length_2360_cov_8.620080	1880	1960	8	80	80	1.0000000
NODE_1005_length_2359_cov_22.317257	958	1038	0	80	80	1.0000000
NODE_1005_length_2359_cov_22.317257	1011	1091	0	80	80	1.0000000
NODE_1008_length_2357_cov_25.711249	716	796	1	54	80	0.6750000
NODE_1008_length_2357_cov_25.711249	716	796	5	2	80	0.0250000
NODE_1008_length_2357_cov_25.711249	716	796	6	9	80	0.1125000
NODE_1008_length_2357_cov_25.711249	716	796	7	15	80	0.1875000
NODE_1008_length_2357_cov_25.711249	769	849	1	1	80	0.0125000
NODE_1008_length_2357_cov_25.711249	769	849	5	2	80	0.0250000
NODE_1008_length_2357_cov_25.711249	769	849	6	9	80	0.1125000
NODE_1008_length_2357_cov_25.711249	769	849	7	68	80	0.8500000
NODE_1015_length_2345_cov_5.386465	1845	1925	0	48	80	0.6000000
NODE_1015_length_2345_cov_5.386465	1845	1925	2	32	80	0.4000000
NODE_1015_length_2345_cov_5.386465	1898	1978	0	80	80	1.0000000
NODE_1016_length_2344_cov_6.236526	1208	1269	12	12	61	0.1967213
NODE_1016_length_2344_cov_6.236526	1208	1269	14	15	61	0.2459016
NODE_1016_length_2344_cov_6.236526	1208	1269	16	4	61	0.0655738
NODE_1016_length_2344_cov_6.236526	1208	1269	18	30	61	0.4918033
NODE_1016_length_2344_cov_6.236526	1208	1269	12	12	61	0.1967213
NODE_1016_length_2344_cov_6.236526	1208	1269	14	15	61	0.2459016
NODE_1016_length_2344_cov_6.236526	1208	1269	16	4	61	0.0655738
NODE_1016_length_2344_cov_6.236526	1208	1269	18	30	61	0.4918033
NODE_1016_length_2344_cov_6.236526	1208	1269	12	12	61	0.1967213
NODE_1016_length_2344_cov_6.236526	1208	1269	14	15	61	0.2459016
NODE_1016_length_2344_cov_6.236526	1208	1269	16	4	61	0.0655738
NODE_1016_length_2344_cov_6.236526	1208	1269	18	30	61	0.4918033
NODE_1016_length_2344_cov_6.236526	1208	1267	12	12	59	0.2033898
NODE_1016_length_2344_cov_6.236526	1208	1267	14	15	59	0.2542373
NODE_1016_length_2344_cov_6.236526	1208	1267	16	4	59	0.0677966
NODE_1016_length_2344_cov_6.236526	1208	1267	18	28	59	0.4745763
NODE_1023_length_2332_cov_4.725929	34	101	2	65	67	0.9701493
NODE_1023_length_2332_cov_4.725929	34	101	10	2	67	0.0298507
NODE_1027_length_2327_cov_18.210952	2213	2293	0	18	80	0.2250000
NODE_1027_length_2327_cov_18.210952	2213	2293	2	20	80	0.2500000
NODE_1027_length_2327_cov_18.210952	2213	2293	6	20	80	0.2500000
NODE_1027_length_2327_cov_18.210952	2213	2293	8	22	80	0.2750000
NODE_1027_length_2327_cov_18.210952	2266	2327	6	39	61	0.6393443
NODE_1027_length_2327_cov_18.210952	2266	2327	8	22	61	0.3606557
NODE_1028_length_2326_cov_15.583745	1709	1789	2	31	80	0.3875000
NODE_1028_length_2326_cov_15.583745	1709	1789	4	20	80	0.2500000
NODE_1028_length_2326_cov_15.583745	1709	1789	11	1	80	0.0125000
NODE_1028_length_2326_cov_15.583745	1709	1789	13	1	80	0.0125000
NODE_1028_length_2326_cov_15.583745	1709	1789	15	15	80	0.1875000
NODE_1028_length_2326_cov_15.583745	1709	1789	17	10	80	0.1250000
NODE_1028_length_2326_cov_15.583745	1709	1789	18	2	80	0.0250000
NODE_1028_length_2326_cov_15.583745	1762	1842	15	15	80	0.1875000
NODE_1028_length_2326_cov_15.583745	1762	1842	17	10	80	0.1250000
NODE_1028_length_2326_cov_15.583745	1762	1842	18	5	80	0.0625000
NODE_1028_length_2326_cov_15.583745	1762	1842	19	6	80	0.0750000
NODE_1028_length_2326_cov_15.583745	1762	1842	20	1	80	0.0125000
NODE_1028_length_2326_cov_15.583745	1762	1842	21	2	80	0.0250000
NODE_1028_length_2326_cov_15.583745	1762	1842	22	16	80	0.2000000
NODE_1028_length_2326_cov_15.583745	1762	1842	23	16	80	0.2000000
NODE_1028_length_2326_cov_15.583745	1762	1842	24	9	80	0.1125000
NODE_1030_length_2325_cov_14.998652	553	633	0	80	80	1.0000000
NODE_1030_length_2325_cov_14.998652	606	686	0	80	80	1.0000000
NODE_1034_length_2317_cov_11.956718	920	1000	1	13	80	0.1625000
NODE_1034_length_2317_cov_11.956718	920	1000	2	67	80	0.8375000
NODE_1034_length_2317_cov_11.956718	973	1053	1	46	80	0.5750000
NODE_1034_length_2317_cov_11.956718	973	1053	2	34	80	0.4250000
NODE_1034_length_2317_cov_11.956718	1049	1129	0	21	80	0.2625000
NODE_1034_length_2317_cov_11.956718	1049	1129	1	34	80	0.4250000
NODE_1034_length_2317_cov_11.956718	1049	1129	2	12	80	0.1500000
NODE_1034_length_2317_cov_11.956718	1049	1129	4	13	80	0.1625000
NODE_1034_length_2317_cov_11.956718	1102	1184	0	2	82	0.0243902
NODE_1034_length_2317_cov_11.956718	1102	1184	2	12	82	0.1463415
NODE_1034_length_2317_cov_11.956718	1102	1184	4	68	82	0.8292683
NODE_1037_length_2316_cov_8.556608	168	247	49	2	79	0.0253165
NODE_1037_length_2316_cov_8.556608	168	247	51	3	79	0.0379747
NODE_1037_length_2316_cov_8.556608	168	247	53	3	79	0.0379747
NODE_1037_length_2316_cov_8.556608	168	247	54	4	79	0.0506329
NODE_1037_length_2316_cov_8.556608	168	247	55	6	79	0.0759494
NODE_1037_length_2316_cov_8.556608	168	247	56	2	79	0.0253165
NODE_1037_length_2316_cov_8.556608	168	247	57	4	79	0.0506329
NODE_1037_length_2316_cov_8.556608	168	247	58	1	79	0.0126582
NODE_1037_length_2316_cov_8.556608	168	247	60	3	79	0.0379747
NODE_1037_length_2316_cov_8.556608	168	247	63	4	79	0.0506329
NODE_1037_length_2316_cov_8.556608	168	247	64	6	79	0.0759494
NODE_1037_length_2316_cov_8.556608	168	247	65	1	79	0.0126582
NODE_1037_length_2316_cov_8.556608	168	247	66	9	79	0.1139240
NODE_1037_length_2316_cov_8.556608	168	247	67	8	79	0.1012658
NODE_1037_length_2316_cov_8.556608	168	247	68	2	79	0.0253165
NODE_1037_length_2316_cov_8.556608	168	247	69	3	79	0.0379747
NODE_1037_length_2316_cov_8.556608	168	247	71	9	79	0.1139240
NODE_1037_length_2316_cov_8.556608	168	247	73	8	79	0.1012658
NODE_1037_length_2316_cov_8.556608	168	247	75	1	79	0.0126582
NODE_1037_length_2316_cov_8.556608	1117	1198	35	1	81	0.0123457
NODE_1037_length_2316_cov_8.556608	1117	1198	37	3	81	0.0370370
NODE_1037_length_2316_cov_8.556608	1117	1198	38	4	81	0.0493827
NODE_1037_length_2316_cov_8.556608	1117	1198	41	3	81	0.0370370
NODE_1037_length_2316_cov_8.556608	1117	1198	43	17	81	0.2098765
NODE_1037_length_2316_cov_8.556608	1117	1198	44	2	81	0.0246914
NODE_1037_length_2316_cov_8.556608	1117	1198	45	15	81	0.1851852
NODE_1037_length_2316_cov_8.556608	1117	1198	46	2	81	0.0246914
NODE_1037_length_2316_cov_8.556608	1117	1198	47	2	81	0.0246914
NODE_1037_length_2316_cov_8.556608	1117	1198	49	10	81	0.1234568
NODE_1037_length_2316_cov_8.556608	1117	1198	51	13	81	0.1604938
NODE_1037_length_2316_cov_8.556608	1117	1198	53	7	81	0.0864198
NODE_1037_length_2316_cov_8.556608	1117	1198	55	2	81	0.0246914
NODE_1037_length_2316_cov_8.556608	1369	1412	77	2	43	0.0465116
NODE_1037_length_2316_cov_8.556608	1369	1412	79	16	43	0.3720930
NODE_1037_length_2316_cov_8.556608	1369	1412	81	5	43	0.1162791
NODE_1037_length_2316_cov_8.556608	1369	1412	82	1	43	0.0232558
NODE_1037_length_2316_cov_8.556608	1369	1412	83	3	43	0.0697674
NODE_1037_length_2316_cov_8.556608	1369	1412	84	1	43	0.0232558
NODE_1037_length_2316_cov_8.556608	1369	1412	85	5	43	0.1162791
NODE_1037_length_2316_cov_8.556608	1369	1412	86	5	43	0.1162791
NODE_1037_length_2316_cov_8.556608	1369	1412	88	2	43	0.0465116
NODE_1037_length_2316_cov_8.556608	1369	1412	90	3	43	0.0697674
NODE_1040_length_2311_cov_2.821881	2121	2201	0	80	80	1.0000000
NODE_1040_length_2311_cov_2.821881	2174	2225	0	51	51	1.0000000
NODE_1044_length_2306_cov_17.347984	995	1075	0	12	80	0.1500000
NODE_1044_length_2306_cov_17.347984	995	1075	1	1	80	0.0125000
NODE_1044_length_2306_cov_17.347984	995	1075	2	48	80	0.6000000
NODE_1044_length_2306_cov_17.347984	995	1075	3	19	80	0.2375000
NODE_1044_length_2306_cov_17.347984	1048	1128	1	20	80	0.2500000
NODE_1044_length_2306_cov_17.347984	1048	1128	2	25	80	0.3125000
NODE_1044_length_2306_cov_17.347984	1048	1128	3	35	80	0.4375000
NODE_1052_length_2300_cov_9.803271	934	1014	0	41	80	0.5125000
NODE_1052_length_2300_cov_9.803271	934	1014	1	39	80	0.4875000
NODE_1052_length_2300_cov_9.803271	1892	1965	0	73	73	1.0000000
NODE_1059_length_2289_cov_17.807306	968	1026	76	5	58	0.0862069
NODE_1059_length_2289_cov_17.807306	968	1026	77	3	58	0.0517241
NODE_1059_length_2289_cov_17.807306	968	1026	78	9	58	0.1551724
NODE_1059_length_2289_cov_17.807306	968	1026	79	1	58	0.0172414
NODE_1059_length_2289_cov_17.807306	968	1026	80	6	58	0.1034483
NODE_1059_length_2289_cov_17.807306	968	1026	81	1	58	0.0172414
NODE_1059_length_2289_cov_17.807306	968	1026	82	1	58	0.0172414
NODE_1059_length_2289_cov_17.807306	968	1026	83	3	58	0.0517241
NODE_1059_length_2289_cov_17.807306	968	1026	84	4	58	0.0689655
NODE_1059_length_2289_cov_17.807306	968	1026	86	9	58	0.1551724
NODE_1059_length_2289_cov_17.807306	968	1026	89	3	58	0.0517241
NODE_1059_length_2289_cov_17.807306	968	1026	90	2	58	0.0344828
NODE_1059_length_2289_cov_17.807306	968	1026	91	1	58	0.0172414
NODE_1059_length_2289_cov_17.807306	968	1026	92	1	58	0.0172414
NODE_1059_length_2289_cov_17.807306	968	1026	94	3	58	0.0517241
NODE_1059_length_2289_cov_17.807306	968	1026	96	1	58	0.0172414
NODE_1059_length_2289_cov_17.807306	968	1026	97	1	58	0.0172414
NODE_1059_length_2289_cov_17.807306	968	1026	99	1	58	0.0172414
NODE_1059_length_2289_cov_17.807306	968	1026	100	1	58	0.0172414
NODE_1059_length_2289_cov_17.807306	968	1026	101	1	58	0.0172414
NODE_1059_length_2289_cov_17.807306	968	1026	102	1	58	0.0172414
NODE_1059_length_2289_cov_17.807306	1021	1079	51	6	58	0.1034483
NODE_1059_length_2289_cov_17.807306	1021	1079	53	4	58	0.0689655
NODE_1059_length_2289_cov_17.807306	1021	1079	54	2	58	0.0344828
NODE_1059_length_2289_cov_17.807306	1021	1079	55	3	58	0.0517241
NODE_1059_length_2289_cov_17.807306	1021	1079	57	1	58	0.0172414
NODE_1059_length_2289_cov_17.807306	1021	1079	58	2	58	0.0344828
NODE_1059_length_2289_cov_17.807306	1021	1079	60	1	58	0.0172414
NODE_1059_length_2289_cov_17.807306	1021	1079	63	1	58	0.0172414
NODE_1059_length_2289_cov_17.807306	1021	1079	64	3	58	0.0517241
NODE_1059_length_2289_cov_17.807306	1021	1079	66	1	58	0.0172414
NODE_1059_length_2289_cov_17.807306	1021	1079	67	2	58	0.0344828
NODE_1059_length_2289_cov_17.807306	1021	1079	68	2	58	0.0344828
NODE_1059_length_2289_cov_17.807306	1021	1079	69	1	58	0.0172414
NODE_1059_length_2289_cov_17.807306	1021	1079	73	1	58	0.0172414
NODE_1059_length_2289_cov_17.807306	1021	1079	77	4	58	0.0689655
NODE_1059_length_2289_cov_17.807306	1021	1079	78	4	58	0.0689655
NODE_1059_length_2289_cov_17.807306	1021	1079	79	7	58	0.1206897
NODE_1059_length_2289_cov_17.807306	1021	1079	81	6	58	0.1034483
NODE_1059_length_2289_cov_17.807306	1021	1079	83	6	58	0.1034483
NODE_1059_length_2289_cov_17.807306	1021	1079	85	1	58	0.0172414
NODE_1060_length_2289_cov_7.736986	2161	2218	72	1	57	0.0175439
NODE_1060_length_2289_cov_7.736986	2161	2218	86	1	57	0.0175439
NODE_1060_length_2289_cov_7.736986	2161	2218	92	1	57	0.0175439
NODE_1060_length_2289_cov_7.736986	2161	2218	96	1	57	0.0175439
NODE_1060_length_2289_cov_7.736986	2161	2218	98	1	57	0.0175439
NODE_1060_length_2289_cov_7.736986	2161	2218	108	1	57	0.0175439
NODE_1060_length_2289_cov_7.736986	2161	2218	114	1	57	0.0175439
NODE_1060_length_2289_cov_7.736986	2161	2218	116	2	57	0.0350877
NODE_1060_length_2289_cov_7.736986	2161	2218	122	1	57	0.0175439
NODE_1060_length_2289_cov_7.736986	2161	2218	124	2	57	0.0350877
NODE_1060_length_2289_cov_7.736986	2161	2218	130	1	57	0.0175439
NODE_1060_length_2289_cov_7.736986	2161	2218	136	1	57	0.0175439
NODE_1060_length_2289_cov_7.736986	2161	2218	138	1	57	0.0175439
NODE_1060_length_2289_cov_7.736986	2161	2218	140	3	57	0.0526316
NODE_1060_length_2289_cov_7.736986	2161	2218	144	1	57	0.0175439
NODE_1060_length_2289_cov_7.736986	2161	2218	150	1	57	0.0175439
NODE_1060_length_2289_cov_7.736986	2161	2218	154	2	57	0.0350877
NODE_1060_length_2289_cov_7.736986	2161	2218	160	3	57	0.0526316
NODE_1060_length_2289_cov_7.736986	2161	2218	164	10	57	0.1754386
NODE_1060_length_2289_cov_7.736986	2161	2218	166	22	57	0.3859649
NODE_1060_length_2289_cov_7.736986	2191	2271	76	1	80	0.0125000
NODE_1060_length_2289_cov_7.736986	2191	2271	82	1	80	0.0125000
NODE_1060_length_2289_cov_7.736986	2191	2271	84	1	80	0.0125000
NODE_1060_length_2289_cov_7.736986	2191	2271	90	1	80	0.0125000
NODE_1060_length_2289_cov_7.736986	2191	2271	100	1	80	0.0125000
NODE_1060_length_2289_cov_7.736986	2191	2271	129	1	80	0.0125000
NODE_1060_length_2289_cov_7.736986	2191	2271	134	1	80	0.0125000
NODE_1060_length_2289_cov_7.736986	2191	2271	138	1	80	0.0125000
NODE_1060_length_2289_cov_7.736986	2191	2271	140	1	80	0.0125000
NODE_1060_length_2289_cov_7.736986	2191	2271	146	1	80	0.0125000
NODE_1060_length_2289_cov_7.736986	2191	2271	150	1	80	0.0125000
NODE_1060_length_2289_cov_7.736986	2191	2271	154	1	80	0.0125000
NODE_1060_length_2289_cov_7.736986	2191	2271	156	3	80	0.0375000
NODE_1060_length_2289_cov_7.736986	2191	2271	160	24	80	0.3000000
NODE_1060_length_2289_cov_7.736986	2191	2271	164	24	80	0.3000000
NODE_1060_length_2289_cov_7.736986	2191	2271	166	17	80	0.2125000
NODE_1061_length_2288_cov_8.539973	340	420	2	14	80	0.1750000
NODE_1061_length_2288_cov_8.539973	340	420	4	6	80	0.0750000
NODE_1061_length_2288_cov_8.539973	340	420	6	39	80	0.4875000
NODE_1061_length_2288_cov_8.539973	340	420	8	5	80	0.0625000
NODE_1061_length_2288_cov_8.539973	340	420	10	10	80	0.1250000
NODE_1061_length_2288_cov_8.539973	340	420	12	6	80	0.0750000
NODE_1061_length_2288_cov_8.539973	393	473	2	6	80	0.0750000
NODE_1061_length_2288_cov_8.539973	393	473	4	4	80	0.0500000
NODE_1061_length_2288_cov_8.539973	393	473	6	70	80	0.8750000
NODE_1065_length_2278_cov_19.655805	450	530	0	4	80	0.0500000
NODE_1065_length_2278_cov_19.655805	450	530	2	33	80	0.4125000
NODE_1065_length_2278_cov_19.655805	450	530	4	43	80	0.5375000
NODE_1065_length_2278_cov_19.655805	503	583	0	2	80	0.0250000
NODE_1065_length_2278_cov_19.655805	503	583	2	36	80	0.4500000
NODE_1065_length_2278_cov_19.655805	503	583	4	42	80	0.5250000
NODE_1065_length_2278_cov_19.655805	579	659	0	24	80	0.3000000
NODE_1065_length_2278_cov_19.655805	579	659	2	56	80	0.7000000
NODE_1065_length_2278_cov_19.655805	632	712	2	80	80	1.0000000
NODE_1071_length_2272_cov_26.123792	226	306	4	80	80	1.0000000
NODE_1071_length_2272_cov_26.123792	279	359	0	33	80	0.4125000
NODE_1071_length_2272_cov_26.123792	279	359	2	9	80	0.1125000
NODE_1071_length_2272_cov_26.123792	279	359	4	38	80	0.4750000
NODE_1071_length_2272_cov_26.123792	1684	1731	25	1	47	0.0212766
NODE_1071_length_2272_cov_26.123792	1684	1731	27	1	47	0.0212766
NODE_1071_length_2272_cov_26.123792	1684	1731	42	1	47	0.0212766
NODE_1071_length_2272_cov_26.123792	1684	1731	58	1	47	0.0212766
NODE_1071_length_2272_cov_26.123792	1684	1731	66	1	47	0.0212766
NODE_1071_length_2272_cov_26.123792	1684	1731	68	2	47	0.0425532
NODE_1071_length_2272_cov_26.123792	1684	1731	74	1	47	0.0212766
NODE_1071_length_2272_cov_26.123792	1684	1731	76	1	47	0.0212766
NODE_1071_length_2272_cov_26.123792	1684	1731	80	2	47	0.0425532
NODE_1071_length_2272_cov_26.123792	1684	1731	82	6	47	0.1276596
NODE_1071_length_2272_cov_26.123792	1684	1731	86	1	47	0.0212766
NODE_1071_length_2272_cov_26.123792	1684	1731	90	2	47	0.0425532
NODE_1071_length_2272_cov_26.123792	1684	1731	92	2	47	0.0425532
NODE_1071_length_2272_cov_26.123792	1684	1731	96	1	47	0.0212766
NODE_1071_length_2272_cov_26.123792	1684	1731	98	1	47	0.0212766
NODE_1071_length_2272_cov_26.123792	1684	1731	99	1	47	0.0212766
NODE_1071_length_2272_cov_26.123792	1684	1731	101	1	47	0.0212766
NODE_1071_length_2272_cov_26.123792	1684	1731	105	1	47	0.0212766
NODE_1071_length_2272_cov_26.123792	1684	1731	107	1	47	0.0212766
NODE_1071_length_2272_cov_26.123792	1684	1731	113	1	47	0.0212766
NODE_1071_length_2272_cov_26.123792	1684	1731	115	1	47	0.0212766
NODE_1071_length_2272_cov_26.123792	1684	1731	119	1	47	0.0212766
NODE_1071_length_2272_cov_26.123792	1684	1731	120	1	47	0.0212766
NODE_1071_length_2272_cov_26.123792	1684	1731	126	1	47	0.0212766
NODE_1071_length_2272_cov_26.123792	1684	1731	129	1	47	0.0212766
NODE_1071_length_2272_cov_26.123792	1684	1731	132	1	47	0.0212766
NODE_1071_length_2272_cov_26.123792	1684	1731	137	1	47	0.0212766
NODE_1071_length_2272_cov_26.123792	1684	1731	142	1	47	0.0212766
NODE_1071_length_2272_cov_26.123792	1684	1731	153	1	47	0.0212766
NODE_1071_length_2272_cov_26.123792	1684	1731	154	1	47	0.0212766
NODE_1071_length_2272_cov_26.123792	1684	1731	162	1	47	0.0212766
NODE_1071_length_2272_cov_26.123792	1684	1731	165	1	47	0.0212766
NODE_1071_length_2272_cov_26.123792	1684	1731	172	1	47	0.0212766
NODE_1071_length_2272_cov_26.123792	1684	1731	174	1	47	0.0212766
NODE_1071_length_2272_cov_26.123792	1684	1731	175	2	47	0.0425532
NODE_1071_length_2272_cov_26.123792	1684	1731	182	1	47	0.0212766
NODE_1071_length_2272_cov_26.123792	1684	1731	186	1	47	0.0212766
NODE_1071_length_2272_cov_26.123792	1694	1725	68	1	31	0.0322581
NODE_1071_length_2272_cov_26.123792	1694	1725	74	1	31	0.0322581
NODE_1071_length_2272_cov_26.123792	1694	1725	76	1	31	0.0322581
NODE_1071_length_2272_cov_26.123792	1694	1725	80	2	31	0.0645161
NODE_1071_length_2272_cov_26.123792	1694	1725	82	6	31	0.1935484
NODE_1071_length_2272_cov_26.123792	1694	1725	86	1	31	0.0322581
NODE_1071_length_2272_cov_26.123792	1694	1725	90	2	31	0.0645161
NODE_1071_length_2272_cov_26.123792	1694	1725	92	2	31	0.0645161
NODE_1071_length_2272_cov_26.123792	1694	1725	96	1	31	0.0322581
NODE_1071_length_2272_cov_26.123792	1694	1725	98	1	31	0.0322581
NODE_1071_length_2272_cov_26.123792	1694	1725	99	1	31	0.0322581
NODE_1071_length_2272_cov_26.123792	1694	1725	101	1	31	0.0322581
NODE_1071_length_2272_cov_26.123792	1694	1725	105	1	31	0.0322581
NODE_1071_length_2272_cov_26.123792	1694	1725	107	1	31	0.0322581
NODE_1071_length_2272_cov_26.123792	1694	1725	113	1	31	0.0322581
NODE_1071_length_2272_cov_26.123792	1694	1725	115	1	31	0.0322581
NODE_1071_length_2272_cov_26.123792	1694	1725	119	1	31	0.0322581
NODE_1071_length_2272_cov_26.123792	1694	1725	120	1	31	0.0322581
NODE_1071_length_2272_cov_26.123792	1694	1725	126	1	31	0.0322581
NODE_1071_length_2272_cov_26.123792	1694	1725	129	1	31	0.0322581
NODE_1071_length_2272_cov_26.123792	1694	1725	132	1	31	0.0322581
NODE_1071_length_2272_cov_26.123792	1694	1725	137	1	31	0.0322581
NODE_1071_length_2272_cov_26.123792	1694	1725	142	1	31	0.0322581
NODE_1071_length_2272_cov_26.123792	1759	1833	6	10	74	0.1351351
NODE_1071_length_2272_cov_26.123792	1759	1833	8	21	74	0.2837838
NODE_1071_length_2272_cov_26.123792	1759	1833	10	38	74	0.5135135
NODE_1071_length_2272_cov_26.123792	1759	1833	12	5	74	0.0675676
NODE_1071_length_2272_cov_26.123792	1812	1892	2	12	80	0.1500000
NODE_1071_length_2272_cov_26.123792	1812	1892	4	15	80	0.1875000
NODE_1071_length_2272_cov_26.123792	1812	1892	6	10	80	0.1250000
NODE_1071_length_2272_cov_26.123792	1812	1892	8	16	80	0.2000000
NODE_1071_length_2272_cov_26.123792	1812	1892	10	22	80	0.2750000
NODE_1071_length_2272_cov_26.123792	1812	1892	12	5	80	0.0625000
NODE_1072_length_2272_cov_8.175334	213	293	65	4	80	0.0500000
NODE_1072_length_2272_cov_8.175334	213	293	71	4	80	0.0500000
NODE_1072_length_2272_cov_8.175334	213	293	72	5	80	0.0625000
NODE_1072_length_2272_cov_8.175334	213	293	76	1	80	0.0125000
NODE_1072_length_2272_cov_8.175334	213	293	78	6	80	0.0750000
NODE_1072_length_2272_cov_8.175334	213	293	80	1	80	0.0125000
NODE_1072_length_2272_cov_8.175334	213	293	82	3	80	0.0375000
NODE_1072_length_2272_cov_8.175334	213	293	84	2	80	0.0250000
NODE_1072_length_2272_cov_8.175334	213	293	86	2	80	0.0250000
NODE_1072_length_2272_cov_8.175334	213	293	88	6	80	0.0750000
NODE_1072_length_2272_cov_8.175334	213	293	90	7	80	0.0875000
NODE_1072_length_2272_cov_8.175334	213	293	91	1	80	0.0125000
NODE_1072_length_2272_cov_8.175334	213	293	92	3	80	0.0375000
NODE_1072_length_2272_cov_8.175334	213	293	95	1	80	0.0125000
NODE_1072_length_2272_cov_8.175334	213	293	96	10	80	0.1250000
NODE_1072_length_2272_cov_8.175334	213	293	98	8	80	0.1000000
NODE_1072_length_2272_cov_8.175334	213	293	100	14	80	0.1750000
NODE_1072_length_2272_cov_8.175334	213	293	102	2	80	0.0250000
NODE_1072_length_2272_cov_8.175334	266	346	0	1	80	0.0125000
NODE_1072_length_2272_cov_8.175334	266	346	2	1	80	0.0125000
NODE_1072_length_2272_cov_8.175334	266	346	19	3	80	0.0375000
NODE_1072_length_2272_cov_8.175334	266	346	21	2	80	0.0250000
NODE_1072_length_2272_cov_8.175334	266	346	23	1	80	0.0125000
NODE_1072_length_2272_cov_8.175334	266	346	24	1	80	0.0125000
NODE_1072_length_2272_cov_8.175334	266	346	26	1	80	0.0125000
NODE_1072_length_2272_cov_8.175334	266	346	30	2	80	0.0250000
NODE_1072_length_2272_cov_8.175334	266	346	32	1	80	0.0125000
NODE_1072_length_2272_cov_8.175334	266	346	34	1	80	0.0125000
NODE_1072_length_2272_cov_8.175334	266	346	35	1	80	0.0125000
NODE_1072_length_2272_cov_8.175334	266	346	37	11	80	0.1375000
NODE_1072_length_2272_cov_8.175334	266	346	39	1	80	0.0125000
NODE_1072_length_2272_cov_8.175334	266	346	41	6	80	0.0750000
NODE_1072_length_2272_cov_8.175334	266	346	45	3	80	0.0375000
NODE_1072_length_2272_cov_8.175334	266	346	49	2	80	0.0250000
NODE_1072_length_2272_cov_8.175334	266	346	55	6	80	0.0750000
NODE_1072_length_2272_cov_8.175334	266	346	57	2	80	0.0250000
NODE_1072_length_2272_cov_8.175334	266	346	59	6	80	0.0750000
NODE_1072_length_2272_cov_8.175334	266	346	63	1	80	0.0125000
NODE_1072_length_2272_cov_8.175334	266	346	65	4	80	0.0500000
NODE_1072_length_2272_cov_8.175334	266	346	71	4	80	0.0500000
NODE_1072_length_2272_cov_8.175334	266	346	72	5	80	0.0625000
NODE_1072_length_2272_cov_8.175334	266	346	76	1	80	0.0125000
NODE_1072_length_2272_cov_8.175334	266	346	80	1	80	0.0125000
NODE_1072_length_2272_cov_8.175334	266	346	82	3	80	0.0375000
NODE_1072_length_2272_cov_8.175334	266	346	88	4	80	0.0500000
NODE_1072_length_2272_cov_8.175334	266	346	95	1	80	0.0125000
NODE_1072_length_2272_cov_8.175334	266	346	96	4	80	0.0500000
NODE_1077_length_2266_cov_13.206276	359	439	10	2	80	0.0250000
NODE_1077_length_2266_cov_13.206276	359	439	12	28	80	0.3500000
NODE_1077_length_2266_cov_13.206276	359	439	14	6	80	0.0750000
NODE_1077_length_2266_cov_13.206276	359	439	16	1	80	0.0125000
NODE_1077_length_2266_cov_13.206276	359	439	18	16	80	0.2000000
NODE_1077_length_2266_cov_13.206276	359	439	20	27	80	0.3375000
NODE_1077_length_2266_cov_13.206276	412	492	2	27	80	0.3375000
NODE_1077_length_2266_cov_13.206276	412	492	4	1	80	0.0125000
NODE_1077_length_2266_cov_13.206276	412	492	6	8	80	0.1000000
NODE_1077_length_2266_cov_13.206276	412	492	8	6	80	0.0750000
NODE_1077_length_2266_cov_13.206276	412	492	10	7	80	0.0875000
NODE_1077_length_2266_cov_13.206276	412	492	12	21	80	0.2625000
NODE_1077_length_2266_cov_13.206276	412	492	20	10	80	0.1250000
NODE_1077_length_2266_cov_13.206276	488	568	2	15	80	0.1875000
NODE_1077_length_2266_cov_13.206276	488	568	4	65	80	0.8125000
NODE_1077_length_2266_cov_13.206276	541	627	0	9	86	0.1046512
NODE_1077_length_2266_cov_13.206276	541	627	2	30	86	0.3488372
NODE_1077_length_2266_cov_13.206276	541	627	4	47	86	0.5465117
NODE_1078_length_2262_cov_11.759131	413	493	0	80	80	1.0000000
NODE_1078_length_2262_cov_11.759131	466	546	0	80	80	1.0000000
NODE_1079_length_2260_cov_37.814901	219	299	0	80	80	1.0000000
NODE_1079_length_2260_cov_37.814901	742	822	0	80	80	1.0000000
NODE_1079_length_2260_cov_37.814901	795	875	0	80	80	1.0000000
NODE_1079_length_2260_cov_37.814901	1533	1613	18	9	80	0.1125000
NODE_1079_length_2260_cov_37.814901	1533	1613	20	19	80	0.2375000
NODE_1079_length_2260_cov_37.814901	1533	1613	22	3	80	0.0375000
NODE_1079_length_2260_cov_37.814901	1533	1613	24	35	80	0.4375000
NODE_1079_length_2260_cov_37.814901	1533	1613	26	14	80	0.1750000
NODE_1079_length_2260_cov_37.814901	1586	1666	2	21	80	0.2625000
NODE_1079_length_2260_cov_37.814901	1586	1666	8	3	80	0.0375000
NODE_1079_length_2260_cov_37.814901	1586	1666	10	8	80	0.1000000
NODE_1079_length_2260_cov_37.814901	1586	1666	12	5	80	0.0625000
NODE_1079_length_2260_cov_37.814901	1586	1666	14	12	80	0.1500000
NODE_1079_length_2260_cov_37.814901	1586	1666	16	4	80	0.0500000
NODE_1079_length_2260_cov_37.814901	1586	1666	18	8	80	0.1000000
NODE_1079_length_2260_cov_37.814901	1586	1666	20	6	80	0.0750000
NODE_1079_length_2260_cov_37.814901	1586	1666	24	13	80	0.1625000
NODE_1079_length_2260_cov_37.814901	1662	1742	0	15	80	0.1875000
NODE_1079_length_2260_cov_37.814901	1662	1742	2	65	80	0.8125000
NODE_1079_length_2260_cov_37.814901	1715	1795	0	25	80	0.3125000
NODE_1079_length_2260_cov_37.814901	1715	1795	2	55	80	0.6875000
NODE_1082_length_2253_cov_8.904828	472	552	15	3	80	0.0375000
NODE_1082_length_2253_cov_8.904828	472	552	17	3	80	0.0375000
NODE_1082_length_2253_cov_8.904828	472	552	21	5	80	0.0625000
NODE_1082_length_2253_cov_8.904828	472	552	22	12	80	0.1500000
NODE_1082_length_2253_cov_8.904828	472	552	23	11	80	0.1375000
NODE_1082_length_2253_cov_8.904828	472	552	24	3	80	0.0375000
NODE_1082_length_2253_cov_8.904828	472	552	26	14	80	0.1750000
NODE_1082_length_2253_cov_8.904828	472	552	28	4	80	0.0500000
NODE_1082_length_2253_cov_8.904828	472	552	29	3	80	0.0375000
NODE_1082_length_2253_cov_8.904828	472	552	30	1	80	0.0125000
NODE_1082_length_2253_cov_8.904828	472	552	31	1	80	0.0125000
NODE_1082_length_2253_cov_8.904828	472	552	33	6	80	0.0750000
NODE_1082_length_2253_cov_8.904828	472	552	37	1	80	0.0125000
NODE_1082_length_2253_cov_8.904828	472	552	41	3	80	0.0375000
NODE_1082_length_2253_cov_8.904828	472	552	43	1	80	0.0125000
NODE_1082_length_2253_cov_8.904828	472	552	45	1	80	0.0125000
NODE_1082_length_2253_cov_8.904828	472	552	47	4	80	0.0500000
NODE_1082_length_2253_cov_8.904828	472	552	49	1	80	0.0125000
NODE_1082_length_2253_cov_8.904828	472	552	51	1	80	0.0125000
NODE_1082_length_2253_cov_8.904828	472	552	53	2	80	0.0250000
NODE_1085_length_2252_cov_2.801208	1128	1170	2	11	42	0.2619048
NODE_1085_length_2252_cov_2.801208	1128	1170	4	31	42	0.7380952
NODE_1085_length_2252_cov_2.801208	1137	1172	2	13	35	0.3714286
NODE_1085_length_2252_cov_2.801208	1137	1172	4	22	35	0.6285715
NODE_1086_length_2252_cov_2.078031	13	62	0	48	49	0.9795918
NODE_1086_length_2252_cov_2.078031	13	62	2	1	49	0.0204082
NODE_1086_length_2252_cov_2.078031	13	61	0	48	48	1.0000000
NODE_1086_length_2252_cov_2.078031	13	62	0	48	49	0.9795918
NODE_1086_length_2252_cov_2.078031	13	62	2	1	49	0.0204082
NODE_1086_length_2252_cov_2.078031	13	62	0	48	49	0.9795918
NODE_1086_length_2252_cov_2.078031	13	62	2	1	49	0.0204082
NODE_1086_length_2252_cov_2.078031	13	61	0	48	48	1.0000000
NODE_1087_length_2251_cov_15.458178	1443	1506	0	50	63	0.7936508
NODE_1087_length_2251_cov_15.458178	1443	1506	1	10	63	0.1587302
NODE_1087_length_2251_cov_15.458178	1443	1506	2	2	63	0.0317460
NODE_1087_length_2251_cov_15.458178	1443	1506	18	1	63	0.0158730
NODE_1087_length_2251_cov_15.458178	1496	1550	1	17	54	0.3148148
NODE_1087_length_2251_cov_15.458178	1496	1550	3	15	54	0.2777778
NODE_1087_length_2251_cov_15.458178	1496	1550	8	1	54	0.0185185
NODE_1087_length_2251_cov_15.458178	1496	1550	9	8	54	0.1481481
NODE_1087_length_2251_cov_15.458178	1496	1550	13	3	54	0.0555556
NODE_1087_length_2251_cov_15.458178	1496	1550	17	4	54	0.0740741
NODE_1087_length_2251_cov_15.458178	1496	1550	21	1	54	0.0185185
NODE_1087_length_2251_cov_15.458178	1496	1550	23	2	54	0.0370370
NODE_1087_length_2251_cov_15.458178	1496	1550	25	2	54	0.0370370
NODE_1087_length_2251_cov_15.458178	1496	1550	27	1	54	0.0185185
NODE_1089_length_2250_cov_18.370990	1658	1738	0	80	80	1.0000000
NODE_1089_length_2250_cov_18.370990	1711	1791	0	80	80	1.0000000
NODE_1090_length_2250_cov_5.331474	1844	1924	0	80	80	1.0000000
NODE_1093_length_2247_cov_7.906890	364	436	0	72	72	1.0000000
NODE_1095_length_2246_cov_7.612948	1992	2055	2	6	63	0.0952381
NODE_1095_length_2246_cov_7.612948	1992	2055	4	15	63	0.2380952
NODE_1095_length_2246_cov_7.612948	1992	2055	6	42	63	0.6666667
NODE_1095_length_2246_cov_7.612948	2045	2108	4	4	63	0.0634921
NODE_1095_length_2246_cov_7.612948	2045	2108	6	29	63	0.4603175
NODE_1095_length_2246_cov_7.612948	2045	2108	8	30	63	0.4761905
NODE_1104_length_2233_cov_35.127460	1517	1597	0	80	80	1.0000000
NODE_1104_length_2233_cov_35.127460	1570	1650	0	80	80	1.0000000
NODE_1105_length_2231_cov_45.701689	315	396	18	11	81	0.1358025
NODE_1105_length_2231_cov_45.701689	315	396	20	1	81	0.0123457
NODE_1105_length_2231_cov_45.701689	315	396	22	4	81	0.0493827
NODE_1105_length_2231_cov_45.701689	315	396	24	2	81	0.0246914
NODE_1105_length_2231_cov_45.701689	315	396	26	1	81	0.0123457
NODE_1105_length_2231_cov_45.701689	315	396	28	2	81	0.0246914
NODE_1105_length_2231_cov_45.701689	315	396	30	27	81	0.3333333
NODE_1105_length_2231_cov_45.701689	315	396	32	33	81	0.4074074
NODE_1105_length_2231_cov_45.701689	369	449	0	7	80	0.0875000
NODE_1105_length_2231_cov_45.701689	369	449	4	6	80	0.0750000
NODE_1105_length_2231_cov_45.701689	369	449	8	4	80	0.0500000
NODE_1105_length_2231_cov_45.701689	369	449	11	7	80	0.0875000
NODE_1105_length_2231_cov_45.701689	369	449	14	9	80	0.1125000
NODE_1105_length_2231_cov_45.701689	369	449	16	3	80	0.0375000
NODE_1105_length_2231_cov_45.701689	369	449	18	28	80	0.3500000
NODE_1105_length_2231_cov_45.701689	369	449	20	1	80	0.0125000
NODE_1105_length_2231_cov_45.701689	369	449	22	4	80	0.0500000
NODE_1105_length_2231_cov_45.701689	369	449	24	2	80	0.0250000
NODE_1105_length_2231_cov_45.701689	369	449	26	1	80	0.0125000
NODE_1105_length_2231_cov_45.701689	369	449	28	2	80	0.0250000
NODE_1105_length_2231_cov_45.701689	369	449	30	6	80	0.0750000
NODE_1105_length_2231_cov_45.701689	496	576	0	80	80	1.0000000
NODE_1105_length_2231_cov_45.701689	582	662	0	80	80	1.0000000
NODE_1105_length_2231_cov_45.701689	625	705	0	50	80	0.6250000
NODE_1105_length_2231_cov_45.701689	625	705	1	7	80	0.0875000
NODE_1105_length_2231_cov_45.701689	625	705	2	23	80	0.2875000
NODE_1105_length_2231_cov_45.701689	711	791	4	42	80	0.5250000
NODE_1105_length_2231_cov_45.701689	711	791	8	38	80	0.4750000
NODE_1105_length_2231_cov_45.701689	1141	1186	23	1	45	0.0222222
NODE_1105_length_2231_cov_45.701689	1141	1186	31	2	45	0.0444444
NODE_1105_length_2231_cov_45.701689	1141	1186	33	4	45	0.0888889
NODE_1105_length_2231_cov_45.701689	1141	1186	44	1	45	0.0222222
NODE_1105_length_2231_cov_45.701689	1141	1186	46	2	45	0.0444444
NODE_1105_length_2231_cov_45.701689	1141	1186	49	1	45	0.0222222
NODE_1105_length_2231_cov_45.701689	1141	1186	59	3	45	0.0666667
NODE_1105_length_2231_cov_45.701689	1141	1186	61	5	45	0.1111111
NODE_1105_length_2231_cov_45.701689	1141	1186	65	3	45	0.0666667
NODE_1105_length_2231_cov_45.701689	1141	1186	67	1	45	0.0222222
NODE_1105_length_2231_cov_45.701689	1141	1186	68	1	45	0.0222222
NODE_1105_length_2231_cov_45.701689	1141	1186	69	1	45	0.0222222
NODE_1105_length_2231_cov_45.701689	1141	1186	70	3	45	0.0666667
NODE_1105_length_2231_cov_45.701689	1141	1186	72	3	45	0.0666667
NODE_1105_length_2231_cov_45.701689	1141	1186	76	14	45	0.3111111
NODE_1105_length_2231_cov_45.701689	1787	1867	0	4	80	0.0500000
NODE_1105_length_2231_cov_45.701689	1787	1867	2	76	80	0.9500000
NODE_1105_length_2231_cov_45.701689	1840	1920	0	23	80	0.2875000
NODE_1105_length_2231_cov_45.701689	1840	1920	2	57	80	0.7125000
NODE_1106_length_2230_cov_12.608634	1520	1600	0	80	80	1.0000000
NODE_1106_length_2230_cov_12.608634	1573	1653	0	80	80	1.0000000
NODE_1112_length_2218_cov_5.292591	1427	1497	0	70	70	1.0000000
NODE_1112_length_2218_cov_5.292591	1470	1536	0	66	66	1.0000000
NODE_1115_length_2215_cov_51.865784	108	188	0	80	80	1.0000000
NODE_1115_length_2215_cov_51.865784	161	241	0	80	80	1.0000000
NODE_1115_length_2215_cov_51.865784	237	317	0	80	80	1.0000000
NODE_1115_length_2215_cov_51.865784	290	370	0	80	80	1.0000000
NODE_1115_length_2215_cov_51.865784	1030	1102	4	1	72	0.0138889
NODE_1115_length_2215_cov_51.865784	1030	1102	6	32	72	0.4444444
NODE_1115_length_2215_cov_51.865784	1030	1102	8	10	72	0.1388889
NODE_1115_length_2215_cov_51.865784	1030	1102	9	2	72	0.0277778
NODE_1115_length_2215_cov_51.865784	1030	1102	11	2	72	0.0277778
NODE_1115_length_2215_cov_51.865784	1030	1102	12	8	72	0.1111111
NODE_1115_length_2215_cov_51.865784	1030	1102	14	2	72	0.0277778
NODE_1115_length_2215_cov_51.865784	1030	1102	16	4	72	0.0555556
NODE_1115_length_2215_cov_51.865784	1030	1102	20	3	72	0.0416667
NODE_1115_length_2215_cov_51.865784	1030	1102	22	3	72	0.0416667
NODE_1115_length_2215_cov_51.865784	1030	1102	24	3	72	0.0416667
NODE_1115_length_2215_cov_51.865784	1030	1102	26	2	72	0.0277778
NODE_1115_length_2215_cov_51.865784	1571	1651	2	74	80	0.9250000
NODE_1115_length_2215_cov_51.865784	1571	1651	4	6	80	0.0750000
NODE_1115_length_2215_cov_51.865784	1624	1704	2	29	80	0.3625000
NODE_1115_length_2215_cov_51.865784	1624	1704	4	51	80	0.6375000
NODE_1117_length_2212_cov_63.988168	459	539	0	7	80	0.0875000
NODE_1117_length_2212_cov_63.988168	459	539	4	13	80	0.1625000
NODE_1117_length_2212_cov_63.988168	459	539	6	60	80	0.7500000
NODE_1117_length_2212_cov_63.988168	512	592	0	42	80	0.5250000
NODE_1117_length_2212_cov_63.988168	512	592	4	31	80	0.3875000
NODE_1117_length_2212_cov_63.988168	512	592	6	7	80	0.0875000
NODE_1117_length_2212_cov_63.988168	588	668	4	55	80	0.6875000
NODE_1117_length_2212_cov_63.988168	588	668	6	25	80	0.3125000
NODE_1117_length_2212_cov_63.988168	641	721	2	35	80	0.4375000
NODE_1117_length_2212_cov_63.988168	641	721	4	2	80	0.0250000
NODE_1117_length_2212_cov_63.988168	641	721	6	43	80	0.5375000
NODE_1119_length_2212_cov_4.632750	1479	1559	0	80	80	1.0000000
NODE_1119_length_2212_cov_4.632750	1532	1612	0	80	80	1.0000000
NODE_1122_length_2211_cov_16.247159	1808	1888	16	3	80	0.0375000
NODE_1122_length_2211_cov_16.247159	1808	1888	17	1	80	0.0125000
NODE_1122_length_2211_cov_16.247159	1808	1888	18	9	80	0.1125000
NODE_1122_length_2211_cov_16.247159	1808	1888	20	13	80	0.1625000
NODE_1122_length_2211_cov_16.247159	1808	1888	22	13	80	0.1625000
NODE_1122_length_2211_cov_16.247159	1808	1888	24	11	80	0.1375000
NODE_1122_length_2211_cov_16.247159	1808	1888	26	18	80	0.2250000
NODE_1122_length_2211_cov_16.247159	1808	1888	28	12	80	0.1500000
NODE_1124_length_2207_cov_46.766129	1273	1348	151	1	75	0.0133333
NODE_1124_length_2207_cov_46.766129	1273	1348	153	2	75	0.0266667
NODE_1124_length_2207_cov_46.766129	1273	1348	155	1	75	0.0133333
NODE_1124_length_2207_cov_46.766129	1273	1348	157	2	75	0.0266667
NODE_1124_length_2207_cov_46.766129	1273	1348	163	1	75	0.0133333
NODE_1124_length_2207_cov_46.766129	1273	1348	167	1	75	0.0133333
NODE_1124_length_2207_cov_46.766129	1273	1348	171	1	75	0.0133333
NODE_1124_length_2207_cov_46.766129	1273	1348	179	1	75	0.0133333
NODE_1124_length_2207_cov_46.766129	1273	1348	181	2	75	0.0266667
NODE_1124_length_2207_cov_46.766129	1273	1348	187	1	75	0.0133333
NODE_1124_length_2207_cov_46.766129	1273	1348	191	1	75	0.0133333
NODE_1124_length_2207_cov_46.766129	1273	1348	193	3	75	0.0400000
NODE_1124_length_2207_cov_46.766129	1273	1348	195	1	75	0.0133333
NODE_1124_length_2207_cov_46.766129	1273	1348	196	1	75	0.0133333
NODE_1124_length_2207_cov_46.766129	1273	1348	200	1	75	0.0133333
NODE_1124_length_2207_cov_46.766129	1273	1348	201	1	75	0.0133333
NODE_1124_length_2207_cov_46.766129	1273	1348	205	1	75	0.0133333
NODE_1124_length_2207_cov_46.766129	1273	1348	209	1	75	0.0133333
NODE_1124_length_2207_cov_46.766129	1273	1348	217	1	75	0.0133333
NODE_1124_length_2207_cov_46.766129	1273	1348	219	1	75	0.0133333
NODE_1124_length_2207_cov_46.766129	1273	1348	222	1	75	0.0133333
NODE_1124_length_2207_cov_46.766129	1273	1348	227	1	75	0.0133333
NODE_1124_length_2207_cov_46.766129	1273	1348	240	1	75	0.0133333
NODE_1124_length_2207_cov_46.766129	1273	1348	244	4	75	0.0533333
NODE_1124_length_2207_cov_46.766129	1273	1348	246	1	75	0.0133333
NODE_1124_length_2207_cov_46.766129	1273	1348	248	2	75	0.0266667
NODE_1124_length_2207_cov_46.766129	1273	1348	250	1	75	0.0133333
NODE_1124_length_2207_cov_46.766129	1273	1348	252	1	75	0.0133333
NODE_1124_length_2207_cov_46.766129	1273	1348	254	1	75	0.0133333
NODE_1124_length_2207_cov_46.766129	1273	1348	256	1	75	0.0133333
NODE_1124_length_2207_cov_46.766129	1273	1348	260	1	75	0.0133333
NODE_1124_length_2207_cov_46.766129	1273	1348	261	2	75	0.0266667
NODE_1124_length_2207_cov_46.766129	1273	1348	265	2	75	0.0266667
NODE_1124_length_2207_cov_46.766129	1273	1348	267	1	75	0.0133333
NODE_1124_length_2207_cov_46.766129	1273	1348	268	1	75	0.0133333
NODE_1124_length_2207_cov_46.766129	1273	1348	270	2	75	0.0266667
NODE_1124_length_2207_cov_46.766129	1273	1348	271	3	75	0.0400000
NODE_1124_length_2207_cov_46.766129	1273	1348	274	6	75	0.0800000
NODE_1124_length_2207_cov_46.766129	1273	1348	275	5	75	0.0666667
NODE_1124_length_2207_cov_46.766129	1273	1348	277	6	75	0.0800000
NODE_1124_length_2207_cov_46.766129	1273	1348	278	3	75	0.0400000
NODE_1124_length_2207_cov_46.766129	1273	1348	279	3	75	0.0400000
NODE_1124_length_2207_cov_46.766129	1273	1348	281	1	75	0.0133333
NODE_1124_length_2207_cov_46.766129	1324	1401	39	4	77	0.0519481
NODE_1124_length_2207_cov_46.766129	1324	1401	41	3	77	0.0389610
NODE_1124_length_2207_cov_46.766129	1324	1401	43	6	77	0.0779221
NODE_1124_length_2207_cov_46.766129	1324	1401	44	4	77	0.0519481
NODE_1124_length_2207_cov_46.766129	1324	1401	45	2	77	0.0259740
NODE_1124_length_2207_cov_46.766129	1324	1401	47	2	77	0.0259740
NODE_1124_length_2207_cov_46.766129	1324	1401	49	1	77	0.0129870
NODE_1124_length_2207_cov_46.766129	1324	1401	50	1	77	0.0129870
NODE_1124_length_2207_cov_46.766129	1324	1401	54	1	77	0.0129870
NODE_1124_length_2207_cov_46.766129	1324	1401	56	2	77	0.0259740
NODE_1124_length_2207_cov_46.766129	1324	1401	59	2	77	0.0259740
NODE_1124_length_2207_cov_46.766129	1324	1401	65	1	77	0.0129870
NODE_1124_length_2207_cov_46.766129	1324	1401	68	1	77	0.0129870
NODE_1124_length_2207_cov_46.766129	1324	1401	70	2	77	0.0259740
NODE_1124_length_2207_cov_46.766129	1324	1401	75	1	77	0.0129870
NODE_1124_length_2207_cov_46.766129	1324	1401	80	1	77	0.0129870
NODE_1124_length_2207_cov_46.766129	1324	1401	85	1	77	0.0129870
NODE_1124_length_2207_cov_46.766129	1324	1401	93	1	77	0.0129870
NODE_1124_length_2207_cov_46.766129	1324	1401	97	1	77	0.0129870
NODE_1124_length_2207_cov_46.766129	1324	1401	102	3	77	0.0389610
NODE_1124_length_2207_cov_46.766129	1324	1401	116	1	77	0.0129870
NODE_1124_length_2207_cov_46.766129	1324	1401	118	1	77	0.0129870
NODE_1124_length_2207_cov_46.766129	1324	1401	128	1	77	0.0129870
NODE_1124_length_2207_cov_46.766129	1324	1401	134	1	77	0.0129870
NODE_1124_length_2207_cov_46.766129	1324	1401	139	1	77	0.0129870
NODE_1124_length_2207_cov_46.766129	1324	1401	143	1	77	0.0129870
NODE_1124_length_2207_cov_46.766129	1324	1401	144	1	77	0.0129870
NODE_1124_length_2207_cov_46.766129	1324	1401	145	2	77	0.0259740
NODE_1124_length_2207_cov_46.766129	1324	1401	147	4	77	0.0519481
NODE_1124_length_2207_cov_46.766129	1324	1401	151	1	77	0.0129870
NODE_1124_length_2207_cov_46.766129	1324	1401	153	2	77	0.0259740
NODE_1124_length_2207_cov_46.766129	1324	1401	155	1	77	0.0129870
NODE_1124_length_2207_cov_46.766129	1324	1401	157	2	77	0.0259740
NODE_1124_length_2207_cov_46.766129	1324	1401	163	1	77	0.0129870
NODE_1124_length_2207_cov_46.766129	1324	1401	167	1	77	0.0129870
NODE_1124_length_2207_cov_46.766129	1324	1401	171	1	77	0.0129870
NODE_1124_length_2207_cov_46.766129	1324	1401	179	1	77	0.0129870
NODE_1124_length_2207_cov_46.766129	1324	1401	181	2	77	0.0259740
NODE_1124_length_2207_cov_46.766129	1324	1401	187	1	77	0.0129870
NODE_1124_length_2207_cov_46.766129	1324	1401	191	1	77	0.0129870
NODE_1124_length_2207_cov_46.766129	1324	1401	193	3	77	0.0389610
NODE_1124_length_2207_cov_46.766129	1324	1401	195	1	77	0.0129870
NODE_1124_length_2207_cov_46.766129	1324	1401	196	1	77	0.0129870
NODE_1124_length_2207_cov_46.766129	1324	1401	200	1	77	0.0129870
NODE_1124_length_2207_cov_46.766129	1324	1401	201	1	77	0.0129870
NODE_1124_length_2207_cov_46.766129	1324	1401	205	1	77	0.0129870
NODE_1124_length_2207_cov_46.766129	1324	1401	209	1	77	0.0129870
NODE_1124_length_2207_cov_46.766129	1324	1401	217	1	77	0.0129870
NODE_1127_length_2205_cov_12.762108	1818	1898	2	45	80	0.5625000
NODE_1127_length_2205_cov_12.762108	1818	1898	4	35	80	0.4375000
NODE_1127_length_2205_cov_12.762108	1871	1951	2	62	80	0.7750000
NODE_1127_length_2205_cov_12.762108	1871	1951	4	18	80	0.2250000
NODE_1127_length_2205_cov_12.762108	1872	1951	2	62	79	0.7848101
NODE_1127_length_2205_cov_12.762108	1872	1951	4	17	79	0.2151899
NODE_1127_length_2205_cov_12.762108	1947	2020	0	40	73	0.5479452
NODE_1127_length_2205_cov_12.762108	1947	2020	2	33	73	0.4520548
NODE_1128_length_2202_cov_8.687114	1848	1912	0	64	64	1.0000000
NODE_1130_length_2200_cov_10.639695	1461	1541	2	21	80	0.2625000
NODE_1130_length_2200_cov_10.639695	1461	1541	4	5	80	0.0625000
NODE_1130_length_2200_cov_10.639695	1461	1541	5	28	80	0.3500000
NODE_1130_length_2200_cov_10.639695	1461	1541	7	5	80	0.0625000
NODE_1130_length_2200_cov_10.639695	1461	1541	8	21	80	0.2625000
NODE_1130_length_2200_cov_10.639695	1514	1594	5	1	80	0.0125000
NODE_1130_length_2200_cov_10.639695	1514	1594	6	1	80	0.0125000
NODE_1130_length_2200_cov_10.639695	1514	1594	7	25	80	0.3125000
NODE_1130_length_2200_cov_10.639695	1514	1594	8	53	80	0.6625000
NODE_1131_length_2199_cov_10.839524	1709	1789	0	22	80	0.2750000
NODE_1131_length_2199_cov_10.839524	1709	1789	2	58	80	0.7250000
NODE_1131_length_2199_cov_10.839524	1762	1842	0	75	80	0.9375000
NODE_1131_length_2199_cov_10.839524	1762	1842	2	5	80	0.0625000
NODE_1135_length_2196_cov_64.718646	885	965	6	6	80	0.0750000
NODE_1135_length_2196_cov_64.718646	885	965	8	8	80	0.1000000
NODE_1135_length_2196_cov_64.718646	885	965	10	44	80	0.5500000
NODE_1135_length_2196_cov_64.718646	885	965	12	18	80	0.2250000
NODE_1135_length_2196_cov_64.718646	885	965	14	4	80	0.0500000
NODE_1135_length_2196_cov_64.718646	938	1018	6	28	80	0.3500000
NODE_1135_length_2196_cov_64.718646	938	1018	8	7	80	0.0875000
NODE_1135_length_2196_cov_64.718646	938	1018	10	39	80	0.4875000
NODE_1135_length_2196_cov_64.718646	938	1018	12	2	80	0.0250000
NODE_1135_length_2196_cov_64.718646	938	1018	14	4	80	0.0500000
NODE_1138_length_2195_cov_8.443225	114	136	4	22	22	1.0000000
NODE_1139_length_2195_cov_6.113550	1245	1330	0	85	85	1.0000000
NODE_1139_length_2195_cov_6.113550	1306	1352	0	46	46	1.0000000
NODE_1141_length_2194_cov_1.366587	15	77	0	62	62	1.0000000
NODE_1142_length_2193_cov_8.320917	374	454	2	7	80	0.0875000
NODE_1142_length_2193_cov_8.320917	374	454	4	5	80	0.0625000
NODE_1142_length_2193_cov_8.320917	374	454	6	7	80	0.0875000
NODE_1142_length_2193_cov_8.320917	374	454	8	61	80	0.7625000
NODE_1142_length_2193_cov_8.320917	427	502	0	33	75	0.4400000
NODE_1142_length_2193_cov_8.320917	427	502	2	22	75	0.2933333
NODE_1142_length_2193_cov_8.320917	427	502	4	1	75	0.0133333
NODE_1142_length_2193_cov_8.320917	427	502	6	1	75	0.0133333
NODE_1142_length_2193_cov_8.320917	427	502	8	18	75	0.2400000
NODE_1146_length_2189_cov_36.884689	383	463	0	2	80	0.0250000
NODE_1146_length_2189_cov_36.884689	383	463	2	78	80	0.9750000
NODE_1146_length_2189_cov_36.884689	436	516	2	80	80	1.0000000
NODE_1146_length_2189_cov_36.884689	1257	1337	0	80	80	1.0000000
NODE_1146_length_2189_cov_36.884689	1310	1390	0	80	80	1.0000000
NODE_1146_length_2189_cov_36.884689	1427	1507	0	80	80	1.0000000
NODE_1146_length_2189_cov_36.884689	1480	1560	0	80	80	1.0000000
NODE_1152_length_2184_cov_9.464748	1536	1616	0	80	80	1.0000000
NODE_1152_length_2184_cov_9.464748	1589	1669	0	80	80	1.0000000
NODE_1154_length_2183_cov_45.471209	1632	1712	4	27	80	0.3375000
NODE_1154_length_2183_cov_45.471209	1632	1712	6	21	80	0.2625000
NODE_1154_length_2183_cov_45.471209	1632	1712	8	14	80	0.1750000
NODE_1154_length_2183_cov_45.471209	1632	1712	10	18	80	0.2250000
NODE_1154_length_2183_cov_45.471209	1685	1765	4	24	80	0.3000000
NODE_1154_length_2183_cov_45.471209	1685	1765	8	56	80	0.7000000
NODE_1159_length_2176_cov_47.338950	0	52	0	52	52	1.0000000
NODE_1162_length_2174_cov_40.560964	1638	1718	0	76	80	0.9500000
NODE_1162_length_2174_cov_40.560964	1638	1718	2	4	80	0.0500000
NODE_1162_length_2174_cov_40.560964	1691	1771	0	23	80	0.2875000
NODE_1162_length_2174_cov_40.560964	1691	1771	2	57	80	0.7125000
NODE_1163_length_2174_cov_35.399518	284	364	2	80	80	1.0000000
NODE_1163_length_2174_cov_35.399518	337	414	0	39	77	0.5064935
NODE_1163_length_2174_cov_35.399518	337	414	2	38	77	0.4935065
NODE_1163_length_2174_cov_35.399518	1542	1620	114	1	78	0.0128205
NODE_1163_length_2174_cov_35.399518	1542	1620	118	1	78	0.0128205
NODE_1163_length_2174_cov_35.399518	1542	1620	120	4	78	0.0512821
NODE_1163_length_2174_cov_35.399518	1542	1620	122	2	78	0.0256410
NODE_1163_length_2174_cov_35.399518	1542	1620	124	1	78	0.0128205
NODE_1163_length_2174_cov_35.399518	1542	1620	126	2	78	0.0256410
NODE_1163_length_2174_cov_35.399518	1542	1620	128	8	78	0.1025641
NODE_1163_length_2174_cov_35.399518	1542	1620	129	3	78	0.0384615
NODE_1163_length_2174_cov_35.399518	1542	1620	130	5	78	0.0641026
NODE_1163_length_2174_cov_35.399518	1542	1620	131	3	78	0.0384615
NODE_1163_length_2174_cov_35.399518	1542	1620	132	2	78	0.0256410
NODE_1163_length_2174_cov_35.399518	1542	1620	136	5	78	0.0641026
NODE_1163_length_2174_cov_35.399518	1542	1620	137	1	78	0.0128205
NODE_1163_length_2174_cov_35.399518	1542	1620	138	2	78	0.0256410
NODE_1163_length_2174_cov_35.399518	1542	1620	139	2	78	0.0256410
NODE_1163_length_2174_cov_35.399518	1542	1620	140	1	78	0.0128205
NODE_1163_length_2174_cov_35.399518	1542	1620	142	1	78	0.0128205
NODE_1163_length_2174_cov_35.399518	1542	1620	146	1	78	0.0128205
NODE_1163_length_2174_cov_35.399518	1542	1620	148	3	78	0.0384615
NODE_1163_length_2174_cov_35.399518	1542	1620	149	1	78	0.0128205
NODE_1163_length_2174_cov_35.399518	1542	1620	151	2	78	0.0256410
NODE_1163_length_2174_cov_35.399518	1542	1620	152	1	78	0.0128205
NODE_1163_length_2174_cov_35.399518	1542	1620	153	4	78	0.0512821
NODE_1163_length_2174_cov_35.399518	1542	1620	155	2	78	0.0256410
NODE_1163_length_2174_cov_35.399518	1542	1620	156	3	78	0.0384615
NODE_1163_length_2174_cov_35.399518	1542	1620	158	8	78	0.1025641
NODE_1163_length_2174_cov_35.399518	1542	1620	159	2	78	0.0256410
NODE_1163_length_2174_cov_35.399518	1542	1620	160	3	78	0.0384615
NODE_1163_length_2174_cov_35.399518	1542	1620	161	1	78	0.0128205
NODE_1163_length_2174_cov_35.399518	1542	1620	162	1	78	0.0128205
NODE_1163_length_2174_cov_35.399518	1542	1620	165	2	78	0.0256410
NODE_1163_length_2174_cov_35.399518	1593	1673	114	1	80	0.0125000
NODE_1163_length_2174_cov_35.399518	1593	1673	118	1	80	0.0125000
NODE_1163_length_2174_cov_35.399518	1593	1673	120	4	80	0.0500000
NODE_1163_length_2174_cov_35.399518	1593	1673	122	2	80	0.0250000
NODE_1163_length_2174_cov_35.399518	1593	1673	124	1	80	0.0125000
NODE_1163_length_2174_cov_35.399518	1593	1673	126	2	80	0.0250000
NODE_1163_length_2174_cov_35.399518	1593	1673	128	7	80	0.0875000
NODE_1163_length_2174_cov_35.399518	1593	1673	130	4	80	0.0500000
NODE_1163_length_2174_cov_35.399518	1593	1673	132	1	80	0.0125000
NODE_1163_length_2174_cov_35.399518	1593	1673	136	5	80	0.0625000
NODE_1163_length_2174_cov_35.399518	1593	1673	140	4	80	0.0500000
NODE_1163_length_2174_cov_35.399518	1593	1673	142	2	80	0.0250000
NODE_1163_length_2174_cov_35.399518	1593	1673	147	1	80	0.0125000
NODE_1163_length_2174_cov_35.399518	1593	1673	149	2	80	0.0250000
NODE_1163_length_2174_cov_35.399518	1593	1673	152	1	80	0.0125000
NODE_1163_length_2174_cov_35.399518	1593	1673	154	1	80	0.0125000
NODE_1163_length_2174_cov_35.399518	1593	1673	156	1	80	0.0125000
NODE_1163_length_2174_cov_35.399518	1593	1673	158	3	80	0.0375000
NODE_1163_length_2174_cov_35.399518	1593	1673	160	1	80	0.0125000
NODE_1163_length_2174_cov_35.399518	1593	1673	164	2	80	0.0250000
NODE_1163_length_2174_cov_35.399518	1593	1673	166	2	80	0.0250000
NODE_1163_length_2174_cov_35.399518	1593	1673	167	1	80	0.0125000
NODE_1163_length_2174_cov_35.399518	1593	1673	168	1	80	0.0125000
NODE_1163_length_2174_cov_35.399518	1593	1673	170	1	80	0.0125000
NODE_1163_length_2174_cov_35.399518	1593	1673	172	1	80	0.0125000
NODE_1163_length_2174_cov_35.399518	1593	1673	174	1	80	0.0125000
NODE_1163_length_2174_cov_35.399518	1593	1673	176	1	80	0.0125000
NODE_1163_length_2174_cov_35.399518	1593	1673	177	3	80	0.0375000
NODE_1163_length_2174_cov_35.399518	1593	1673	178	1	80	0.0125000
NODE_1163_length_2174_cov_35.399518	1593	1673	179	5	80	0.0625000
NODE_1163_length_2174_cov_35.399518	1593	1673	181	1	80	0.0125000
NODE_1163_length_2174_cov_35.399518	1593	1673	183	3	80	0.0375000
NODE_1163_length_2174_cov_35.399518	1593	1673	185	5	80	0.0625000
NODE_1163_length_2174_cov_35.399518	1593	1673	187	2	80	0.0250000
NODE_1163_length_2174_cov_35.399518	1593	1673	189	1	80	0.0125000
NODE_1163_length_2174_cov_35.399518	1593	1673	190	1	80	0.0125000
NODE_1163_length_2174_cov_35.399518	1593	1673	191	4	80	0.0500000
NODE_1163_length_2174_cov_35.399518	2075	2152	50	6	77	0.0779221
NODE_1163_length_2174_cov_35.399518	2075	2152	51	4	77	0.0519481
NODE_1163_length_2174_cov_35.399518	2075	2152	53	39	77	0.5064935
NODE_1163_length_2174_cov_35.399518	2075	2152	57	28	77	0.3636364
NODE_1163_length_2174_cov_35.399518	2075	2152	50	6	77	0.0779221
NODE_1163_length_2174_cov_35.399518	2075	2152	51	4	77	0.0519481
NODE_1163_length_2174_cov_35.399518	2075	2152	53	39	77	0.5064935
NODE_1163_length_2174_cov_35.399518	2075	2152	57	28	77	0.3636364
NODE_1163_length_2174_cov_35.399518	2075	2152	50	6	77	0.0779221
NODE_1163_length_2174_cov_35.399518	2075	2152	51	4	77	0.0519481
NODE_1163_length_2174_cov_35.399518	2075	2152	53	39	77	0.5064935
NODE_1163_length_2174_cov_35.399518	2075	2152	57	28	77	0.3636364
NODE_1163_length_2174_cov_35.399518	2125	2174	0	1	49	0.0204082
NODE_1163_length_2174_cov_35.399518	2125	2174	2	3	49	0.0612245
NODE_1163_length_2174_cov_35.399518	2125	2174	6	1	49	0.0204082
NODE_1163_length_2174_cov_35.399518	2125	2174	8	2	49	0.0408163
NODE_1163_length_2174_cov_35.399518	2125	2174	14	1	49	0.0204082
NODE_1163_length_2174_cov_35.399518	2125	2174	20	3	49	0.0612245
NODE_1163_length_2174_cov_35.399518	2125	2174	22	1	49	0.0204082
NODE_1163_length_2174_cov_35.399518	2125	2174	32	1	49	0.0204082
NODE_1163_length_2174_cov_35.399518	2125	2174	34	1	49	0.0204082
NODE_1163_length_2174_cov_35.399518	2125	2174	36	1	49	0.0204082
NODE_1163_length_2174_cov_35.399518	2125	2174	39	1	49	0.0204082
NODE_1163_length_2174_cov_35.399518	2125	2174	44	1	49	0.0204082
NODE_1163_length_2174_cov_35.399518	2125	2174	46	4	49	0.0816327
NODE_1163_length_2174_cov_35.399518	2125	2174	48	1	49	0.0204082
NODE_1163_length_2174_cov_35.399518	2125	2174	50	6	49	0.1224490
NODE_1163_length_2174_cov_35.399518	2125	2174	51	4	49	0.0816327
NODE_1163_length_2174_cov_35.399518	2125	2174	53	17	49	0.3469388
NODE_1163_length_2174_cov_35.399518	2128	2174	0	1	46	0.0217391
NODE_1163_length_2174_cov_35.399518	2128	2174	2	3	46	0.0652174
NODE_1163_length_2174_cov_35.399518	2128	2174	6	1	46	0.0217391
NODE_1163_length_2174_cov_35.399518	2128	2174	8	2	46	0.0434783
NODE_1163_length_2174_cov_35.399518	2128	2174	14	1	46	0.0217391
NODE_1163_length_2174_cov_35.399518	2128	2174	20	3	46	0.0652174
NODE_1163_length_2174_cov_35.399518	2128	2174	22	1	46	0.0217391
NODE_1163_length_2174_cov_35.399518	2128	2174	32	1	46	0.0217391
NODE_1163_length_2174_cov_35.399518	2128	2174	34	1	46	0.0217391
NODE_1163_length_2174_cov_35.399518	2128	2174	36	1	46	0.0217391
NODE_1163_length_2174_cov_35.399518	2128	2174	39	1	46	0.0217391
NODE_1163_length_2174_cov_35.399518	2128	2174	44	1	46	0.0217391
NODE_1163_length_2174_cov_35.399518	2128	2174	46	4	46	0.0869565
NODE_1163_length_2174_cov_35.399518	2128	2174	48	1	46	0.0217391
NODE_1163_length_2174_cov_35.399518	2128	2174	50	6	46	0.1304348
NODE_1163_length_2174_cov_35.399518	2128	2174	51	4	46	0.0869565
NODE_1163_length_2174_cov_35.399518	2128	2174	53	14	46	0.3043478
NODE_1163_length_2174_cov_35.399518	2130	2174	0	1	44	0.0227273
NODE_1163_length_2174_cov_35.399518	2130	2174	2	3	44	0.0681818
NODE_1163_length_2174_cov_35.399518	2130	2174	6	1	44	0.0227273
NODE_1163_length_2174_cov_35.399518	2130	2174	8	2	44	0.0454545
NODE_1163_length_2174_cov_35.399518	2130	2174	14	1	44	0.0227273
NODE_1163_length_2174_cov_35.399518	2130	2174	20	3	44	0.0681818
NODE_1163_length_2174_cov_35.399518	2130	2174	22	1	44	0.0227273
NODE_1163_length_2174_cov_35.399518	2130	2174	32	1	44	0.0227273
NODE_1163_length_2174_cov_35.399518	2130	2174	34	1	44	0.0227273
NODE_1163_length_2174_cov_35.399518	2130	2174	36	1	44	0.0227273
NODE_1163_length_2174_cov_35.399518	2130	2174	39	1	44	0.0227273
NODE_1163_length_2174_cov_35.399518	2130	2174	44	1	44	0.0227273
NODE_1163_length_2174_cov_35.399518	2130	2174	46	4	44	0.0909091
NODE_1163_length_2174_cov_35.399518	2130	2174	48	1	44	0.0227273
NODE_1163_length_2174_cov_35.399518	2130	2174	50	6	44	0.1363636
NODE_1163_length_2174_cov_35.399518	2130	2174	51	4	44	0.0909091
NODE_1163_length_2174_cov_35.399518	2130	2174	53	12	44	0.2727273
NODE_1164_length_2172_cov_44.861553	1110	1190	2	21	80	0.2625000
NODE_1164_length_2172_cov_44.861553	1110	1190	4	17	80	0.2125000
NODE_1164_length_2172_cov_44.861553	1110	1190	6	4	80	0.0500000
NODE_1164_length_2172_cov_44.861553	1110	1190	10	1	80	0.0125000
NODE_1164_length_2172_cov_44.861553	1110	1190	11	1	80	0.0125000
NODE_1164_length_2172_cov_44.861553	1110	1190	12	36	80	0.4500000
NODE_1164_length_2172_cov_44.861553	1163	1243	6	15	80	0.1875000
NODE_1164_length_2172_cov_44.861553	1163	1243	8	26	80	0.3250000
NODE_1164_length_2172_cov_44.861553	1163	1243	10	10	80	0.1250000
NODE_1164_length_2172_cov_44.861553	1163	1243	12	29	80	0.3625000
NODE_1164_length_2172_cov_44.861553	1239	1319	6	11	80	0.1375000
NODE_1164_length_2172_cov_44.861553	1239	1319	12	24	80	0.3000000
NODE_1164_length_2172_cov_44.861553	1239	1319	17	1	80	0.0125000
NODE_1164_length_2172_cov_44.861553	1239	1319	18	22	80	0.2750000
NODE_1164_length_2172_cov_44.861553	1239	1319	19	10	80	0.1250000
NODE_1164_length_2172_cov_44.861553	1239	1319	20	7	80	0.0875000
NODE_1164_length_2172_cov_44.861553	1239	1319	21	1	80	0.0125000
NODE_1164_length_2172_cov_44.861553	1239	1319	22	4	80	0.0500000
NODE_1164_length_2172_cov_44.861553	1292	1372	14	12	80	0.1500000
NODE_1164_length_2172_cov_44.861553	1292	1372	16	18	80	0.2250000
NODE_1164_length_2172_cov_44.861553	1292	1372	18	8	80	0.1000000
NODE_1164_length_2172_cov_44.861553	1292	1372	19	11	80	0.1375000
NODE_1164_length_2172_cov_44.861553	1292	1372	20	7	80	0.0875000
NODE_1164_length_2172_cov_44.861553	1292	1372	21	20	80	0.2500000
NODE_1164_length_2172_cov_44.861553	1292	1372	22	4	80	0.0500000
NODE_1166_length_2167_cov_33.133946	414	494	0	80	80	1.0000000
NODE_1166_length_2167_cov_33.133946	467	547	0	66	80	0.8250000
NODE_1166_length_2167_cov_33.133946	467	547	4	12	80	0.1500000
NODE_1166_length_2167_cov_33.133946	467	547	6	2	80	0.0250000
NODE_1166_length_2167_cov_33.133946	543	623	4	2	80	0.0250000
NODE_1166_length_2167_cov_33.133946	543	623	6	58	80	0.7250000
NODE_1166_length_2167_cov_33.133946	543	623	12	20	80	0.2500000
NODE_1166_length_2167_cov_33.133946	596	676	6	7	80	0.0875000
NODE_1166_length_2167_cov_33.133946	596	676	8	35	80	0.4375000
NODE_1166_length_2167_cov_33.133946	596	676	12	27	80	0.3375000
NODE_1166_length_2167_cov_33.133946	596	676	13	11	80	0.1375000
NODE_1169_length_2165_cov_21.460794	980	1060	0	30	80	0.3750000
NODE_1169_length_2165_cov_21.460794	980	1060	2	50	80	0.6250000
NODE_1169_length_2165_cov_21.460794	1033	1113	2	80	80	1.0000000
NODE_1176_length_2157_cov_22.284257	989	1069	0	26	80	0.3250000
NODE_1176_length_2157_cov_22.284257	989	1069	6	23	80	0.2875000
NODE_1176_length_2157_cov_22.284257	989	1069	8	31	80	0.3875000
NODE_1176_length_2157_cov_22.284257	1042	1122	0	2	80	0.0250000
NODE_1176_length_2157_cov_22.284257	1042	1122	6	11	80	0.1375000
NODE_1176_length_2157_cov_22.284257	1042	1122	8	67	80	0.8375000
NODE_1176_length_2157_cov_22.284257	1118	1198	0	50	80	0.6250000
NODE_1176_length_2157_cov_22.284257	1118	1198	2	6	80	0.0750000
NODE_1176_length_2157_cov_22.284257	1118	1198	3	22	80	0.2750000
NODE_1176_length_2157_cov_22.284257	1118	1198	6	2	80	0.0250000
NODE_1176_length_2157_cov_22.284257	1171	1251	2	5	80	0.0625000
NODE_1176_length_2157_cov_22.284257	1171	1251	3	37	80	0.4625000
NODE_1176_length_2157_cov_22.284257	1171	1251	5	38	80	0.4750000
NODE_1177_length_2157_cov_8.830418	867	947	0	15	80	0.1875000
NODE_1177_length_2157_cov_8.830418	867	947	2	52	80	0.6500000
NODE_1177_length_2157_cov_8.830418	867	947	4	13	80	0.1625000
NODE_1177_length_2157_cov_8.830418	920	1000	0	8	80	0.1000000
NODE_1177_length_2157_cov_8.830418	920	1000	2	58	80	0.7250000
NODE_1177_length_2157_cov_8.830418	920	1000	4	14	80	0.1750000
NODE_1177_length_2157_cov_8.830418	996	1076	0	59	80	0.7375000
NODE_1177_length_2157_cov_8.830418	996	1076	2	21	80	0.2625000
NODE_1177_length_2157_cov_8.830418	1049	1129	0	15	80	0.1875000
NODE_1177_length_2157_cov_8.830418	1049	1129	2	65	80	0.8125000
NODE_1178_length_2156_cov_25.065630	0	41	16	1	41	0.0243902
NODE_1178_length_2156_cov_25.065630	0	41	18	1	41	0.0243902
NODE_1178_length_2156_cov_25.065630	0	41	22	5	41	0.1219512
NODE_1178_length_2156_cov_25.065630	0	41	24	1	41	0.0243902
NODE_1178_length_2156_cov_25.065630	0	41	29	1	41	0.0243902
NODE_1178_length_2156_cov_25.065630	0	41	30	1	41	0.0243902
NODE_1178_length_2156_cov_25.065630	0	41	34	4	41	0.0975610
NODE_1178_length_2156_cov_25.065630	0	41	36	8	41	0.1951219
NODE_1178_length_2156_cov_25.065630	0	41	37	4	41	0.0975610
NODE_1178_length_2156_cov_25.065630	0	41	39	2	41	0.0487805
NODE_1178_length_2156_cov_25.065630	0	41	43	2	41	0.0487805
NODE_1178_length_2156_cov_25.065630	0	41	45	4	41	0.0975610
NODE_1178_length_2156_cov_25.065630	0	41	47	6	41	0.1463415
NODE_1178_length_2156_cov_25.065630	0	41	49	1	41	0.0243902
NODE_1178_length_2156_cov_25.065630	14	94	36	8	80	0.1000000
NODE_1178_length_2156_cov_25.065630	14	94	37	4	80	0.0500000
NODE_1178_length_2156_cov_25.065630	14	94	39	2	80	0.0250000
NODE_1178_length_2156_cov_25.065630	14	94	43	2	80	0.0250000
NODE_1178_length_2156_cov_25.065630	14	94	45	4	80	0.0500000
NODE_1178_length_2156_cov_25.065630	14	94	47	6	80	0.0750000
NODE_1178_length_2156_cov_25.065630	14	94	49	2	80	0.0250000
NODE_1178_length_2156_cov_25.065630	14	94	51	1	80	0.0125000
NODE_1178_length_2156_cov_25.065630	14	94	53	2	80	0.0250000
NODE_1178_length_2156_cov_25.065630	14	94	57	3	80	0.0375000
NODE_1178_length_2156_cov_25.065630	14	94	59	3	80	0.0375000
NODE_1178_length_2156_cov_25.065630	14	94	61	4	80	0.0500000
NODE_1178_length_2156_cov_25.065630	14	94	65	3	80	0.0375000
NODE_1178_length_2156_cov_25.065630	14	94	70	2	80	0.0250000
NODE_1178_length_2156_cov_25.065630	14	94	72	1	80	0.0125000
NODE_1178_length_2156_cov_25.065630	14	94	74	2	80	0.0250000
NODE_1178_length_2156_cov_25.065630	14	94	76	5	80	0.0625000
NODE_1178_length_2156_cov_25.065630	14	94	77	1	80	0.0125000
NODE_1178_length_2156_cov_25.065630	14	94	80	5	80	0.0625000
NODE_1178_length_2156_cov_25.065630	14	94	84	2	80	0.0250000
NODE_1178_length_2156_cov_25.065630	14	94	90	11	80	0.1375000
NODE_1178_length_2156_cov_25.065630	14	94	94	7	80	0.0875000
NODE_1181_length_2156_cov_3.216334	1890	1970	0	80	80	1.0000000
NODE_1181_length_2156_cov_3.216334	1943	2023	0	80	80	1.0000000
NODE_1184_length_2153_cov_11.610029	1968	2048	0	67	80	0.8375000
NODE_1184_length_2153_cov_11.610029	1968	2048	4	1	80	0.0125000
NODE_1184_length_2153_cov_11.610029	1968	2048	6	1	80	0.0125000
NODE_1184_length_2153_cov_11.610029	1968	2048	10	3	80	0.0375000
NODE_1184_length_2153_cov_11.610029	1968	2048	12	3	80	0.0375000
NODE_1184_length_2153_cov_11.610029	1968	2048	16	3	80	0.0375000
NODE_1184_length_2153_cov_11.610029	1968	2048	20	2	80	0.0250000
NODE_1184_length_2153_cov_11.610029	1977	2048	0	58	71	0.8169014
NODE_1184_length_2153_cov_11.610029	1977	2048	4	1	71	0.0140845
NODE_1184_length_2153_cov_11.610029	1977	2048	6	1	71	0.0140845
NODE_1184_length_2153_cov_11.610029	1977	2048	10	3	71	0.0422535
NODE_1184_length_2153_cov_11.610029	1977	2048	12	3	71	0.0422535
NODE_1184_length_2153_cov_11.610029	1977	2048	16	3	71	0.0422535
NODE_1184_length_2153_cov_11.610029	1977	2048	20	2	71	0.0281690
NODE_1190_length_2147_cov_25.116211	814	894	50	1	80	0.0125000
NODE_1190_length_2147_cov_25.116211	814	894	58	4	80	0.0500000
NODE_1190_length_2147_cov_25.116211	814	894	60	10	80	0.1250000
NODE_1190_length_2147_cov_25.116211	814	894	62	4	80	0.0500000
NODE_1190_length_2147_cov_25.116211	814	894	66	2	80	0.0250000
NODE_1190_length_2147_cov_25.116211	814	894	67	1	80	0.0125000
NODE_1190_length_2147_cov_25.116211	814	894	69	3	80	0.0375000
NODE_1190_length_2147_cov_25.116211	814	894	70	7	80	0.0875000
NODE_1190_length_2147_cov_25.116211	814	894	72	23	80	0.2875000
NODE_1190_length_2147_cov_25.116211	814	894	74	12	80	0.1500000
NODE_1190_length_2147_cov_25.116211	814	894	76	2	80	0.0250000
NODE_1190_length_2147_cov_25.116211	814	894	78	8	80	0.1000000
NODE_1190_length_2147_cov_25.116211	814	894	80	3	80	0.0375000
NODE_1190_length_2147_cov_25.116211	867	947	10	10	80	0.1250000
NODE_1190_length_2147_cov_25.116211	867	947	12	8	80	0.1000000
NODE_1190_length_2147_cov_25.116211	867	947	14	3	80	0.0375000
NODE_1190_length_2147_cov_25.116211	867	947	18	1	80	0.0125000
NODE_1190_length_2147_cov_25.116211	867	947	20	1	80	0.0125000
NODE_1190_length_2147_cov_25.116211	867	947	26	1	80	0.0125000
NODE_1190_length_2147_cov_25.116211	867	947	28	1	80	0.0125000
NODE_1190_length_2147_cov_25.116211	867	947	30	1	80	0.0125000
NODE_1190_length_2147_cov_25.116211	867	947	32	2	80	0.0250000
NODE_1190_length_2147_cov_25.116211	867	947	34	2	80	0.0250000
NODE_1190_length_2147_cov_25.116211	867	947	36	2	80	0.0250000
NODE_1190_length_2147_cov_25.116211	867	947	38	1	80	0.0125000
NODE_1190_length_2147_cov_25.116211	867	947	40	1	80	0.0125000
NODE_1190_length_2147_cov_25.116211	867	947	46	1	80	0.0125000
NODE_1190_length_2147_cov_25.116211	867	947	50	4	80	0.0500000
NODE_1190_length_2147_cov_25.116211	867	947	52	2	80	0.0250000
NODE_1190_length_2147_cov_25.116211	867	947	56	5	80	0.0625000
NODE_1190_length_2147_cov_25.116211	867	947	58	3	80	0.0375000
NODE_1190_length_2147_cov_25.116211	867	947	62	3	80	0.0375000
NODE_1190_length_2147_cov_25.116211	867	947	65	1	80	0.0125000
NODE_1190_length_2147_cov_25.116211	867	947	67	1	80	0.0125000
NODE_1190_length_2147_cov_25.116211	867	947	69	3	80	0.0375000
NODE_1190_length_2147_cov_25.116211	867	947	72	4	80	0.0500000
NODE_1190_length_2147_cov_25.116211	867	947	74	11	80	0.1375000
NODE_1190_length_2147_cov_25.116211	867	947	76	1	80	0.0125000
NODE_1190_length_2147_cov_25.116211	867	947	78	4	80	0.0500000
NODE_1190_length_2147_cov_25.116211	867	947	80	3	80	0.0375000
NODE_1197_length_2136_cov_16.947472	279	359	0	23	80	0.2875000
NODE_1197_length_2136_cov_16.947472	279	359	2	57	80	0.7125000
NODE_1197_length_2136_cov_16.947472	332	412	0	11	80	0.1375000
NODE_1197_length_2136_cov_16.947472	332	412	2	49	80	0.6125000
NODE_1197_length_2136_cov_16.947472	332	412	4	20	80	0.2500000
NODE_1197_length_2136_cov_16.947472	408	488	4	72	80	0.9000000
NODE_1197_length_2136_cov_16.947472	408	488	5	6	80	0.0750000
NODE_1197_length_2136_cov_16.947472	408	488	6	2	80	0.0250000
NODE_1197_length_2136_cov_16.947472	461	541	2	46	80	0.5750000
NODE_1197_length_2136_cov_16.947472	461	541	4	26	80	0.3250000
NODE_1197_length_2136_cov_16.947472	461	541	5	6	80	0.0750000
NODE_1197_length_2136_cov_16.947472	461	541	6	2	80	0.0250000
NODE_1199_length_2133_cov_15.038840	498	578	2	8	80	0.1000000
NODE_1199_length_2133_cov_15.038840	498	578	4	72	80	0.9000000
NODE_1199_length_2133_cov_15.038840	551	631	0	25	80	0.3125000
NODE_1199_length_2133_cov_15.038840	551	631	2	36	80	0.4500000
NODE_1199_length_2133_cov_15.038840	551	631	4	19	80	0.2375000
NODE_1199_length_2133_cov_15.038840	627	707	0	80	80	1.0000000
NODE_1199_length_2133_cov_15.038840	680	722	0	42	42	1.0000000
NODE_1204_length_2128_cov_11.799409	1698	1778	0	80	80	1.0000000
NODE_1204_length_2128_cov_11.799409	1751	1831	0	80	80	1.0000000
NODE_1206_length_2126_cov_6.854465	1614	1694	0	80	80	1.0000000
NODE_1206_length_2126_cov_6.854465	1667	1747	0	80	80	1.0000000
NODE_1209_length_2123_cov_12.668478	102	143	0	1	41	0.0243902
NODE_1209_length_2123_cov_12.668478	102	143	2	22	41	0.5365854
NODE_1209_length_2123_cov_12.668478	102	143	4	18	41	0.4390244
NODE_1209_length_2123_cov_12.668478	1474	1500	0	26	26	1.0000000
NODE_1209_length_2123_cov_12.668478	1552	1601	2	23	49	0.4693878
NODE_1209_length_2123_cov_12.668478	1552	1601	3	1	49	0.0204082
NODE_1209_length_2123_cov_12.668478	1552	1601	4	16	49	0.3265306
NODE_1209_length_2123_cov_12.668478	1552	1601	6	6	49	0.1224490
NODE_1209_length_2123_cov_12.668478	1552	1601	8	1	49	0.0204082
NODE_1209_length_2123_cov_12.668478	1552	1601	10	2	49	0.0408163
NODE_1209_length_2123_cov_12.668478	1574	1654	2	1	80	0.0125000
NODE_1209_length_2123_cov_12.668478	1574	1654	3	1	80	0.0125000
NODE_1209_length_2123_cov_12.668478	1574	1654	4	16	80	0.2000000
NODE_1209_length_2123_cov_12.668478	1574	1654	6	6	80	0.0750000
NODE_1209_length_2123_cov_12.668478	1574	1654	8	9	80	0.1125000
NODE_1209_length_2123_cov_12.668478	1574	1654	10	47	80	0.5875000
NODE_1211_length_2121_cov_10.101879	497	577	2	29	80	0.3625000
NODE_1211_length_2121_cov_10.101879	497	577	4	51	80	0.6375000
NODE_1211_length_2121_cov_10.101879	550	630	2	14	80	0.1750000
NODE_1211_length_2121_cov_10.101879	550	630	3	8	80	0.1000000
NODE_1211_length_2121_cov_10.101879	550	630	4	58	80	0.7250000
NODE_1211_length_2121_cov_10.101879	1935	2008	0	73	73	1.0000000
NODE_1212_length_2121_cov_9.964886	1523	1603	2	29	80	0.3625000
NODE_1212_length_2121_cov_9.964886	1523	1603	4	50	80	0.6250000
NODE_1212_length_2121_cov_9.964886	1523	1603	6	1	80	0.0125000
NODE_1212_length_2121_cov_9.964886	1576	1656	2	30	80	0.3750000
NODE_1212_length_2121_cov_9.964886	1576	1656	4	50	80	0.6250000
NODE_1213_length_2120_cov_24.609599	25	92	0	67	67	1.0000000
NODE_1215_length_2119_cov_18.446040	366	446	0	80	80	1.0000000
NODE_1215_length_2119_cov_18.446040	419	499	0	80	80	1.0000000
NODE_1215_length_2119_cov_18.446040	1239	1319	0	80	80	1.0000000
NODE_1215_length_2119_cov_18.446040	1292	1372	0	40	80	0.5000000
NODE_1215_length_2119_cov_18.446040	1292	1372	2	40	80	0.5000000
NODE_1225_length_2110_cov_8.668324	1755	1835	0	80	80	1.0000000
NODE_1225_length_2110_cov_8.668324	1808	1888	0	80	80	1.0000000
NODE_1227_length_2106_cov_14.643747	1579	1659	0	80	80	1.0000000
NODE_1227_length_2106_cov_14.643747	1632	1712	0	80	80	1.0000000
NODE_1227_length_2106_cov_14.643747	1708	1786	0	78	78	1.0000000
NODE_1227_length_2106_cov_14.643747	1759	1839	0	80	80	1.0000000
NODE_1228_length_2106_cov_3.173393	48	96	0	48	48	1.0000000
NODE_1228_length_2106_cov_3.173393	48	96	0	48	48	1.0000000
NODE_1228_length_2106_cov_3.173393	48	96	0	48	48	1.0000000
NODE_1228_length_2106_cov_3.173393	48	96	0	48	48	1.0000000
NODE_1228_length_2106_cov_3.173393	48	96	0	48	48	1.0000000
NODE_1229_length_2102_cov_23.872192	390	470	0	33	80	0.4125000
NODE_1229_length_2102_cov_23.872192	390	470	2	47	80	0.5875000
NODE_1229_length_2102_cov_23.872192	443	523	0	69	80	0.8625000
NODE_1229_length_2102_cov_23.872192	443	523	2	11	80	0.1375000
NODE_1229_length_2102_cov_23.872192	519	599	2	37	80	0.4625000
NODE_1229_length_2102_cov_23.872192	519	599	6	30	80	0.3750000
NODE_1229_length_2102_cov_23.872192	519	599	8	13	80	0.1625000
NODE_1229_length_2102_cov_23.872192	572	652	6	44	80	0.5500000
NODE_1229_length_2102_cov_23.872192	572	652	8	36	80	0.4500000
NODE_1229_length_2102_cov_23.872192	1049	1101	353	1	52	0.0192308
NODE_1229_length_2102_cov_23.872192	1049	1101	356	1	52	0.0192308
NODE_1229_length_2102_cov_23.872192	1049	1101	358	2	52	0.0384615
NODE_1229_length_2102_cov_23.872192	1049	1101	360	1	52	0.0192308
NODE_1229_length_2102_cov_23.872192	1049	1101	362	1	52	0.0192308
NODE_1229_length_2102_cov_23.872192	1049	1101	367	1	52	0.0192308
NODE_1229_length_2102_cov_23.872192	1049	1101	369	1	52	0.0192308
NODE_1229_length_2102_cov_23.872192	1049	1101	371	2	52	0.0384615
NODE_1229_length_2102_cov_23.872192	1049	1101	373	1	52	0.0192308
NODE_1229_length_2102_cov_23.872192	1049	1101	379	1	52	0.0192308
NODE_1229_length_2102_cov_23.872192	1049	1101	383	1	52	0.0192308
NODE_1229_length_2102_cov_23.872192	1049	1101	387	1	52	0.0192308
NODE_1229_length_2102_cov_23.872192	1049	1101	395	1	52	0.0192308
NODE_1229_length_2102_cov_23.872192	1049	1101	403	1	52	0.0192308
NODE_1229_length_2102_cov_23.872192	1049	1101	407	2	52	0.0384615
NODE_1229_length_2102_cov_23.872192	1049	1101	416	1	52	0.0192308
NODE_1229_length_2102_cov_23.872192	1049	1101	420	1	52	0.0192308
NODE_1229_length_2102_cov_23.872192	1049	1101	422	1	52	0.0192308
NODE_1229_length_2102_cov_23.872192	1049	1101	424	1	52	0.0192308
NODE_1229_length_2102_cov_23.872192	1049	1101	426	1	52	0.0192308
NODE_1229_length_2102_cov_23.872192	1049	1101	433	1	52	0.0192308
NODE_1229_length_2102_cov_23.872192	1049	1101	448	1	52	0.0192308
NODE_1229_length_2102_cov_23.872192	1049	1101	454	1	52	0.0192308
NODE_1229_length_2102_cov_23.872192	1049	1101	461	2	52	0.0384615
NODE_1229_length_2102_cov_23.872192	1049	1101	462	1	52	0.0192308
NODE_1229_length_2102_cov_23.872192	1049	1101	463	1	52	0.0192308
NODE_1229_length_2102_cov_23.872192	1049	1101	464	2	52	0.0384615
NODE_1229_length_2102_cov_23.872192	1049	1101	466	1	52	0.0192308
NODE_1229_length_2102_cov_23.872192	1049	1101	467	2	52	0.0384615
NODE_1229_length_2102_cov_23.872192	1049	1101	471	1	52	0.0192308
NODE_1229_length_2102_cov_23.872192	1049	1101	474	1	52	0.0192308
NODE_1229_length_2102_cov_23.872192	1049	1101	475	1	52	0.0192308
NODE_1229_length_2102_cov_23.872192	1049	1101	477	1	52	0.0192308
NODE_1229_length_2102_cov_23.872192	1049	1101	481	1	52	0.0192308
NODE_1229_length_2102_cov_23.872192	1049	1101	482	2	52	0.0384615
NODE_1229_length_2102_cov_23.872192	1049	1101	483	1	52	0.0192308
NODE_1229_length_2102_cov_23.872192	1049	1101	486	1	52	0.0192308
NODE_1229_length_2102_cov_23.872192	1049	1101	488	1	52	0.0192308
NODE_1229_length_2102_cov_23.872192	1049	1101	489	2	52	0.0384615
NODE_1229_length_2102_cov_23.872192	1049	1101	490	2	52	0.0384615
NODE_1229_length_2102_cov_23.872192	1049	1101	491	1	52	0.0192308
NODE_1229_length_2102_cov_23.872192	1049	1101	492	1	52	0.0192308
NODE_1229_length_2102_cov_23.872192	1049	1101	493	1	52	0.0192308
NODE_1231_length_2100_cov_21.504248	450	530	0	17	80	0.2125000
NODE_1231_length_2100_cov_21.504248	450	530	2	63	80	0.7875000
NODE_1231_length_2100_cov_21.504248	503	578	2	75	75	1.0000000
NODE_1231_length_2100_cov_21.504248	579	659	0	77	80	0.9625000
NODE_1231_length_2100_cov_21.504248	579	659	2	3	80	0.0375000
NODE_1231_length_2100_cov_21.504248	632	712	0	80	80	1.0000000
NODE_1231_length_2100_cov_21.504248	1420	1500	0	80	80	1.0000000
NODE_1231_length_2100_cov_21.504248	1473	1553	0	80	80	1.0000000
NODE_1232_length_2100_cov_6.399300	1510	1590	0	43	80	0.5375000
NODE_1232_length_2100_cov_6.399300	1510	1590	1	37	80	0.4625000
NODE_1232_length_2100_cov_6.399300	1559	1590	1	31	31	1.0000000
NODE_1232_length_2100_cov_6.399300	1563	1644	1	59	81	0.7283950
NODE_1232_length_2100_cov_6.399300	1563	1644	3	22	81	0.2716049
NODE_1232_length_2100_cov_6.399300	1563	1644	1	59	81	0.7283950
NODE_1232_length_2100_cov_6.399300	1563	1644	3	22	81	0.2716049
NODE_1234_length_2099_cov_40.603500	960	1040	0	80	80	1.0000000
NODE_1234_length_2099_cov_40.603500	1013	1093	0	65	80	0.8125000
NODE_1234_length_2099_cov_40.603500	1013	1093	1	15	80	0.1875000
NODE_1234_length_2099_cov_40.603500	1089	1169	1	33	80	0.4125000
NODE_1234_length_2099_cov_40.603500	1089	1169	5	10	80	0.1250000
NODE_1234_length_2099_cov_40.603500	1089	1169	7	13	80	0.1625000
NODE_1234_length_2099_cov_40.603500	1089	1169	8	24	80	0.3000000
NODE_1234_length_2099_cov_40.603500	1142	1222	6	8	80	0.1000000
NODE_1234_length_2099_cov_40.603500	1142	1222	7	3	80	0.0375000
NODE_1234_length_2099_cov_40.603500	1142	1222	8	69	80	0.8625000
NODE_1235_length_2098_cov_62.733867	1042	1122	18	5	80	0.0625000
NODE_1235_length_2098_cov_62.733867	1042	1122	19	1	80	0.0125000
NODE_1235_length_2098_cov_62.733867	1042	1122	20	20	80	0.2500000
NODE_1235_length_2098_cov_62.733867	1042	1122	21	7	80	0.0875000
NODE_1235_length_2098_cov_62.733867	1042	1122	22	14	80	0.1750000
NODE_1235_length_2098_cov_62.733867	1042	1122	23	1	80	0.0125000
NODE_1235_length_2098_cov_62.733867	1042	1122	24	24	80	0.3000000
NODE_1235_length_2098_cov_62.733867	1042	1122	26	8	80	0.1000000
NODE_1235_length_2098_cov_62.733867	1095	1175	7	9	80	0.1125000
NODE_1235_length_2098_cov_62.733867	1095	1175	9	17	80	0.2125000
NODE_1235_length_2098_cov_62.733867	1095	1175	10	9	80	0.1125000
NODE_1235_length_2098_cov_62.733867	1095	1175	12	2	80	0.0250000
NODE_1235_length_2098_cov_62.733867	1095	1175	15	1	80	0.0125000
NODE_1235_length_2098_cov_62.733867	1095	1175	16	7	80	0.0875000
NODE_1235_length_2098_cov_62.733867	1095	1175	18	13	80	0.1625000
NODE_1235_length_2098_cov_62.733867	1095	1175	19	1	80	0.0125000
NODE_1235_length_2098_cov_62.733867	1095	1175	20	14	80	0.1750000
NODE_1235_length_2098_cov_62.733867	1095	1175	21	7	80	0.0875000
NODE_1235_length_2098_cov_62.733867	1171	1251	4	4	80	0.0500000
NODE_1235_length_2098_cov_62.733867	1171	1251	5	2	80	0.0250000
NODE_1235_length_2098_cov_62.733867	1171	1251	6	4	80	0.0500000
NODE_1235_length_2098_cov_62.733867	1171	1251	7	12	80	0.1500000
NODE_1235_length_2098_cov_62.733867	1171	1251	8	50	80	0.6250000
NODE_1235_length_2098_cov_62.733867	1171	1251	12	8	80	0.1000000
NODE_1235_length_2098_cov_62.733867	1224	1304	6	1	80	0.0125000
NODE_1235_length_2098_cov_62.733867	1224	1304	8	42	80	0.5250000
NODE_1235_length_2098_cov_62.733867	1224	1304	10	29	80	0.3625000
NODE_1235_length_2098_cov_62.733867	1224	1304	12	8	80	0.1000000
NODE_1236_length_2098_cov_20.220110	550	630	0	80	80	1.0000000
NODE_1236_length_2098_cov_20.220110	603	683	0	80	80	1.0000000
NODE_1236_length_2098_cov_20.220110	1571	1651	2	16	80	0.2000000
NODE_1236_length_2098_cov_20.220110	1571	1651	4	57	80	0.7125000
NODE_1236_length_2098_cov_20.220110	1571	1651	6	7	80	0.0875000
NODE_1236_length_2098_cov_20.220110	1624	1704	0	44	80	0.5500000
NODE_1236_length_2098_cov_20.220110	1624	1704	2	18	80	0.2250000
NODE_1236_length_2098_cov_20.220110	1624	1704	4	18	80	0.2250000
NODE_1237_length_2098_cov_8.261631	324	404	2	31	80	0.3875000
NODE_1237_length_2098_cov_8.261631	324	404	3	49	80	0.6125000
NODE_1239_length_2095_cov_29.930862	1128	1209	163	1	81	0.0123457
NODE_1239_length_2095_cov_29.930862	1128	1209	169	1	81	0.0123457
NODE_1239_length_2095_cov_29.930862	1128	1209	186	1	81	0.0123457
NODE_1239_length_2095_cov_29.930862	1128	1209	196	1	81	0.0123457
NODE_1239_length_2095_cov_29.930862	1128	1209	208	1	81	0.0123457
NODE_1239_length_2095_cov_29.930862	1128	1209	212	1	81	0.0123457
NODE_1239_length_2095_cov_29.930862	1128	1209	226	1	81	0.0123457
NODE_1239_length_2095_cov_29.930862	1128	1209	240	1	81	0.0123457
NODE_1239_length_2095_cov_29.930862	1128	1209	246	1	81	0.0123457
NODE_1239_length_2095_cov_29.930862	1128	1209	249	1	81	0.0123457
NODE_1239_length_2095_cov_29.930862	1128	1209	263	1	81	0.0123457
NODE_1239_length_2095_cov_29.930862	1128	1209	272	1	81	0.0123457
NODE_1239_length_2095_cov_29.930862	1128	1209	279	1	81	0.0123457
NODE_1239_length_2095_cov_29.930862	1128	1209	284	1	81	0.0123457
NODE_1239_length_2095_cov_29.930862	1128	1209	294	1	81	0.0123457
NODE_1239_length_2095_cov_29.930862	1128	1209	305	1	81	0.0123457
NODE_1239_length_2095_cov_29.930862	1128	1209	307	2	81	0.0246914
NODE_1239_length_2095_cov_29.930862	1128	1209	313	1	81	0.0123457
NODE_1239_length_2095_cov_29.930862	1128	1209	326	2	81	0.0246914
NODE_1239_length_2095_cov_29.930862	1128	1209	336	1	81	0.0123457
NODE_1239_length_2095_cov_29.930862	1128	1209	344	1	81	0.0123457
NODE_1239_length_2095_cov_29.930862	1128	1209	353	1	81	0.0123457
NODE_1239_length_2095_cov_29.930862	1128	1209	359	1	81	0.0123457
NODE_1239_length_2095_cov_29.930862	1128	1209	370	1	81	0.0123457
NODE_1239_length_2095_cov_29.930862	1128	1209	381	1	81	0.0123457
NODE_1239_length_2095_cov_29.930862	1128	1209	393	1	81	0.0123457
NODE_1239_length_2095_cov_29.930862	1128	1209	405	1	81	0.0123457
NODE_1239_length_2095_cov_29.930862	1128	1209	411	1	81	0.0123457
NODE_1239_length_2095_cov_29.930862	1128	1209	414	1	81	0.0123457
NODE_1239_length_2095_cov_29.930862	1128	1209	419	1	81	0.0123457
NODE_1239_length_2095_cov_29.930862	1128	1209	421	1	81	0.0123457
NODE_1239_length_2095_cov_29.930862	1128	1209	436	1	81	0.0123457
NODE_1239_length_2095_cov_29.930862	1128	1209	438	1	81	0.0123457
NODE_1239_length_2095_cov_29.930862	1128	1209	440	1	81	0.0123457
NODE_1239_length_2095_cov_29.930862	1128	1209	457	1	81	0.0123457
NODE_1239_length_2095_cov_29.930862	1128	1209	461	1	81	0.0123457
NODE_1239_length_2095_cov_29.930862	1128	1209	465	1	81	0.0123457
NODE_1239_length_2095_cov_29.930862	1128	1209	466	1	81	0.0123457
NODE_1239_length_2095_cov_29.930862	1128	1209	468	1	81	0.0123457
NODE_1239_length_2095_cov_29.930862	1128	1209	476	1	81	0.0123457
NODE_1239_length_2095_cov_29.930862	1128	1209	502	1	81	0.0123457
NODE_1239_length_2095_cov_29.930862	1128	1209	508	1	81	0.0123457
NODE_1239_length_2095_cov_29.930862	1128	1209	510	1	81	0.0123457
NODE_1239_length_2095_cov_29.930862	1128	1209	518	1	81	0.0123457
NODE_1239_length_2095_cov_29.930862	1128	1209	527	1	81	0.0123457
NODE_1239_length_2095_cov_29.930862	1128	1209	540	1	81	0.0123457
NODE_1239_length_2095_cov_29.930862	1128	1209	542	1	81	0.0123457
NODE_1239_length_2095_cov_29.930862	1128	1209	544	2	81	0.0246914
NODE_1239_length_2095_cov_29.930862	1128	1209	556	1	81	0.0123457
NODE_1239_length_2095_cov_29.930862	1128	1209	559	3	81	0.0370370
NODE_1239_length_2095_cov_29.930862	1128	1209	562	1	81	0.0123457
NODE_1239_length_2095_cov_29.930862	1128	1209	564	1	81	0.0123457
NODE_1239_length_2095_cov_29.930862	1128	1209	581	1	81	0.0123457
NODE_1239_length_2095_cov_29.930862	1128	1209	587	1	81	0.0123457
NODE_1239_length_2095_cov_29.930862	1128	1209	598	1	81	0.0123457
NODE_1239_length_2095_cov_29.930862	1128	1209	603	1	81	0.0123457
NODE_1239_length_2095_cov_29.930862	1128	1209	612	1	81	0.0123457
NODE_1239_length_2095_cov_29.930862	1128	1209	617	1	81	0.0123457
NODE_1239_length_2095_cov_29.930862	1128	1209	618	1	81	0.0123457
NODE_1239_length_2095_cov_29.930862	1128	1209	622	1	81	0.0123457
NODE_1239_length_2095_cov_29.930862	1128	1209	630	1	81	0.0123457
NODE_1239_length_2095_cov_29.930862	1128	1209	638	1	81	0.0123457
NODE_1239_length_2095_cov_29.930862	1128	1209	644	1	81	0.0123457
NODE_1239_length_2095_cov_29.930862	1128	1209	651	1	81	0.0123457
NODE_1239_length_2095_cov_29.930862	1128	1209	653	1	81	0.0123457
NODE_1239_length_2095_cov_29.930862	1128	1209	657	1	81	0.0123457
NODE_1239_length_2095_cov_29.930862	1128	1209	661	1	81	0.0123457
NODE_1239_length_2095_cov_29.930862	1128	1209	666	1	81	0.0123457
NODE_1239_length_2095_cov_29.930862	1128	1209	670	1	81	0.0123457
NODE_1239_length_2095_cov_29.930862	1128	1209	672	2	81	0.0246914
NODE_1239_length_2095_cov_29.930862	1128	1209	676	1	81	0.0123457
NODE_1239_length_2095_cov_29.930862	1128	1209	677	1	81	0.0123457
NODE_1239_length_2095_cov_29.930862	1128	1209	681	1	81	0.0123457
NODE_1239_length_2095_cov_29.930862	1128	1209	695	1	81	0.0123457
NODE_1239_length_2095_cov_29.930862	1128	1209	697	1	81	0.0123457
NODE_1239_length_2095_cov_29.930862	1204	1258	668	1	54	0.0185185
NODE_1239_length_2095_cov_29.930862	1204	1258	676	1	54	0.0185185
NODE_1239_length_2095_cov_29.930862	1204	1258	677	3	54	0.0555556
NODE_1239_length_2095_cov_29.930862	1204	1258	679	1	54	0.0185185
NODE_1239_length_2095_cov_29.930862	1204	1258	681	1	54	0.0185185
NODE_1239_length_2095_cov_29.930862	1204	1258	688	2	54	0.0370370
NODE_1239_length_2095_cov_29.930862	1204	1258	693	1	54	0.0185185
NODE_1239_length_2095_cov_29.930862	1204	1258	695	1	54	0.0185185
NODE_1239_length_2095_cov_29.930862	1204	1258	696	1	54	0.0185185
NODE_1239_length_2095_cov_29.930862	1204	1258	697	2	54	0.0370370
NODE_1239_length_2095_cov_29.930862	1204	1258	710	1	54	0.0185185
NODE_1239_length_2095_cov_29.930862	1204	1258	721	1	54	0.0185185
NODE_1239_length_2095_cov_29.930862	1204	1258	723	1	54	0.0185185
NODE_1239_length_2095_cov_29.930862	1204	1258	726	1	54	0.0185185
NODE_1239_length_2095_cov_29.930862	1204	1258	730	4	54	0.0740741
NODE_1239_length_2095_cov_29.930862	1204	1258	731	1	54	0.0185185
NODE_1239_length_2095_cov_29.930862	1204	1258	732	2	54	0.0370370
NODE_1239_length_2095_cov_29.930862	1204	1258	738	1	54	0.0185185
NODE_1239_length_2095_cov_29.930862	1204	1258	739	1	54	0.0185185
NODE_1239_length_2095_cov_29.930862	1204	1258	740	1	54	0.0185185
NODE_1239_length_2095_cov_29.930862	1204	1258	742	2	54	0.0370370
NODE_1239_length_2095_cov_29.930862	1204	1258	743	1	54	0.0185185
NODE_1239_length_2095_cov_29.930862	1204	1258	744	1	54	0.0185185
NODE_1239_length_2095_cov_29.930862	1204	1258	745	4	54	0.0740741
NODE_1239_length_2095_cov_29.930862	1204	1258	746	4	54	0.0740741
NODE_1239_length_2095_cov_29.930862	1204	1258	747	4	54	0.0740741
NODE_1239_length_2095_cov_29.930862	1204	1258	748	1	54	0.0185185
NODE_1239_length_2095_cov_29.930862	1204	1258	749	3	54	0.0555556
NODE_1239_length_2095_cov_29.930862	1204	1258	750	2	54	0.0370370
NODE_1239_length_2095_cov_29.930862	1204	1258	752	1	54	0.0185185
NODE_1239_length_2095_cov_29.930862	1204	1258	753	1	54	0.0185185
NODE_1239_length_2095_cov_29.930862	1204	1258	754	1	54	0.0185185
NODE_1239_length_2095_cov_29.930862	1204	1258	755	1	54	0.0185185
NODE_1251_length_2084_cov_1.720403	959	1039	4	5	80	0.0625000
NODE_1251_length_2084_cov_1.720403	959	1039	6	5	80	0.0625000
NODE_1251_length_2084_cov_1.720403	959	1039	10	32	80	0.4000000
NODE_1251_length_2084_cov_1.720403	959	1039	12	38	80	0.4750000
NODE_1251_length_2084_cov_1.720403	1012	1092	4	31	80	0.3875000
NODE_1251_length_2084_cov_1.720403	1012	1092	6	16	80	0.2000000
NODE_1251_length_2084_cov_1.720403	1012	1092	8	1	80	0.0125000
NODE_1251_length_2084_cov_1.720403	1012	1092	10	5	80	0.0625000
NODE_1251_length_2084_cov_1.720403	1012	1092	12	27	80	0.3375000
NODE_1252_length_2083_cov_5.864415	419	499	0	30	80	0.3750000
NODE_1252_length_2083_cov_5.864415	419	499	2	50	80	0.6250000
NODE_1252_length_2083_cov_5.864415	472	552	0	80	80	1.0000000
NODE_1252_length_2083_cov_5.864415	548	628	0	80	80	1.0000000
NODE_1252_length_2083_cov_5.864415	601	681	0	80	80	1.0000000
NODE_1256_length_2078_cov_47.394644	311	391	0	1	80	0.0125000
NODE_1256_length_2078_cov_47.394644	311	391	6	13	80	0.1625000
NODE_1256_length_2078_cov_47.394644	311	391	8	66	80	0.8250000
NODE_1256_length_2078_cov_47.394644	364	444	0	15	80	0.1875000
NODE_1256_length_2078_cov_47.394644	364	444	2	4	80	0.0500000
NODE_1256_length_2078_cov_47.394644	364	444	8	61	80	0.7625000
NODE_1256_length_2078_cov_47.394644	440	520	0	17	80	0.2125000
NODE_1256_length_2078_cov_47.394644	440	520	4	3	80	0.0375000
NODE_1256_length_2078_cov_47.394644	440	520	6	8	80	0.1000000
NODE_1256_length_2078_cov_47.394644	440	520	7	1	80	0.0125000
NODE_1256_length_2078_cov_47.394644	440	520	8	4	80	0.0500000
NODE_1256_length_2078_cov_47.394644	440	520	10	38	80	0.4750000
NODE_1256_length_2078_cov_47.394644	440	520	12	9	80	0.1125000
NODE_1256_length_2078_cov_47.394644	493	573	6	24	80	0.3000000
NODE_1256_length_2078_cov_47.394644	493	573	8	3	80	0.0375000
NODE_1256_length_2078_cov_47.394644	493	573	10	18	80	0.2250000
NODE_1256_length_2078_cov_47.394644	493	573	12	35	80	0.4375000
NODE_1267_length_2067_cov_13.647866	1349	1429	0	26	80	0.3250000
NODE_1267_length_2067_cov_13.647866	1349	1429	3	2	80	0.0250000
NODE_1267_length_2067_cov_13.647866	1349	1429	4	12	80	0.1500000
NODE_1267_length_2067_cov_13.647866	1349	1429	6	40	80	0.5000000
NODE_1267_length_2067_cov_13.647866	1402	1482	6	53	80	0.6625000
NODE_1267_length_2067_cov_13.647866	1402	1482	8	7	80	0.0875000
NODE_1267_length_2067_cov_13.647866	1402	1482	10	20	80	0.2500000
NODE_1269_length_2066_cov_19.127605	1497	1577	4	5	80	0.0625000
NODE_1269_length_2066_cov_19.127605	1497	1577	6	3	80	0.0375000
NODE_1269_length_2066_cov_19.127605	1497	1577	9	2	80	0.0250000
NODE_1269_length_2066_cov_19.127605	1497	1577	10	4	80	0.0500000
NODE_1269_length_2066_cov_19.127605	1497	1577	12	15	80	0.1875000
NODE_1269_length_2066_cov_19.127605	1497	1577	16	12	80	0.1500000
NODE_1269_length_2066_cov_19.127605	1497	1577	18	15	80	0.1875000
NODE_1269_length_2066_cov_19.127605	1497	1577	20	8	80	0.1000000
NODE_1269_length_2066_cov_19.127605	1497	1577	22	16	80	0.2000000
NODE_1269_length_2066_cov_19.127605	1550	1630	10	11	80	0.1375000
NODE_1269_length_2066_cov_19.127605	1550	1630	12	6	80	0.0750000
NODE_1269_length_2066_cov_19.127605	1550	1630	14	13	80	0.1625000
NODE_1269_length_2066_cov_19.127605	1550	1630	16	11	80	0.1375000
NODE_1269_length_2066_cov_19.127605	1550	1630	18	3	80	0.0375000
NODE_1269_length_2066_cov_19.127605	1550	1630	20	19	80	0.2375000
NODE_1269_length_2066_cov_19.127605	1550	1630	22	17	80	0.2125000
NODE_1274_length_2061_cov_43.187054	364	444	0	80	80	1.0000000
NODE_1274_length_2061_cov_43.187054	417	497	0	80	80	1.0000000
NODE_1275_length_2061_cov_3.251784	981	1033	2	52	52	1.0000000
NODE_1275_length_2061_cov_3.251784	1006	1086	0	26	80	0.3250000
NODE_1275_length_2061_cov_3.251784	1006	1086	2	54	80	0.6750000
NODE_1277_length_2058_cov_4.531394	1844	1875	0	31	31	1.0000000
NODE_1277_length_2058_cov_4.531394	1848	1928	0	64	80	0.8000000
NODE_1277_length_2058_cov_4.531394	1848	1928	2	6	80	0.0750000
NODE_1277_length_2058_cov_4.531394	1848	1928	4	10	80	0.1250000
NODE_1279_length_2056_cov_20.525805	749	829	0	80	80	1.0000000
NODE_1279_length_2056_cov_20.525805	802	882	0	38	80	0.4750000
NODE_1279_length_2056_cov_20.525805	802	882	7	1	80	0.0125000
NODE_1279_length_2056_cov_20.525805	802	882	8	5	80	0.0625000
NODE_1279_length_2056_cov_20.525805	802	882	10	36	80	0.4500000
NODE_1279_length_2056_cov_20.525805	878	958	10	9	80	0.1125000
NODE_1279_length_2056_cov_20.525805	878	958	12	11	80	0.1375000
NODE_1279_length_2056_cov_20.525805	878	958	14	60	80	0.7500000
NODE_1279_length_2056_cov_20.525805	931	1011	0	38	80	0.4750000
NODE_1279_length_2056_cov_20.525805	931	1011	2	1	80	0.0125000
NODE_1279_length_2056_cov_20.525805	931	1011	4	8	80	0.1000000
NODE_1279_length_2056_cov_20.525805	931	1011	6	4	80	0.0500000
NODE_1279_length_2056_cov_20.525805	931	1011	14	29	80	0.3625000
NODE_1281_length_2055_cov_10.047546	1468	1548	0	80	80	1.0000000
NODE_1281_length_2055_cov_10.047546	1521	1601	0	80	80	1.0000000
NODE_1286_length_2049_cov_6.846154	270	350	0	80	80	1.0000000
NODE_1286_length_2049_cov_6.846154	323	403	0	80	80	1.0000000
NODE_1286_length_2049_cov_6.846154	1595	1674	0	79	79	1.0000000
NODE_1286_length_2049_cov_6.846154	1648	1712	0	64	64	1.0000000
NODE_1293_length_2045_cov_46.790339	876	956	27	4	80	0.0500000
NODE_1293_length_2045_cov_46.790339	876	956	29	9	80	0.1125000
NODE_1293_length_2045_cov_46.790339	876	956	31	8	80	0.1000000
NODE_1293_length_2045_cov_46.790339	876	956	32	19	80	0.2375000
NODE_1293_length_2045_cov_46.790339	876	956	34	9	80	0.1125000
NODE_1293_length_2045_cov_46.790339	876	956	36	13	80	0.1625000
NODE_1293_length_2045_cov_46.790339	876	956	38	9	80	0.1125000
NODE_1293_length_2045_cov_46.790339	876	956	40	3	80	0.0375000
NODE_1293_length_2045_cov_46.790339	876	956	42	6	80	0.0750000
NODE_1293_length_2045_cov_46.790339	929	1009	14	10	80	0.1250000
NODE_1293_length_2045_cov_46.790339	929	1009	16	6	80	0.0750000
NODE_1293_length_2045_cov_46.790339	929	1009	22	4	80	0.0500000
NODE_1293_length_2045_cov_46.790339	929	1009	24	9	80	0.1125000
NODE_1293_length_2045_cov_46.790339	929	1009	26	6	80	0.0750000
NODE_1293_length_2045_cov_46.790339	929	1009	28	10	80	0.1250000
NODE_1293_length_2045_cov_46.790339	929	1009	30	1	80	0.0125000
NODE_1293_length_2045_cov_46.790339	929	1009	32	5	80	0.0625000
NODE_1293_length_2045_cov_46.790339	929	1009	34	15	80	0.1875000
NODE_1293_length_2045_cov_46.790339	929	1009	36	13	80	0.1625000
NODE_1293_length_2045_cov_46.790339	929	1009	38	1	80	0.0125000
NODE_1293_length_2045_cov_46.790339	1005	1085	12	4	80	0.0500000
NODE_1293_length_2045_cov_46.790339	1005	1085	14	1	80	0.0125000
NODE_1293_length_2045_cov_46.790339	1005	1085	16	14	80	0.1750000
NODE_1293_length_2045_cov_46.790339	1005	1085	17	6	80	0.0750000
NODE_1293_length_2045_cov_46.790339	1005	1085	18	26	80	0.3250000
NODE_1293_length_2045_cov_46.790339	1005	1085	19	23	80	0.2875000
NODE_1293_length_2045_cov_46.790339	1005	1085	20	2	80	0.0250000
NODE_1293_length_2045_cov_46.790339	1005	1085	21	2	80	0.0250000
NODE_1293_length_2045_cov_46.790339	1005	1085	22	2	80	0.0250000
NODE_1293_length_2045_cov_46.790339	1058	1138	6	32	80	0.4000000
NODE_1293_length_2045_cov_46.790339	1058	1138	8	19	80	0.2375000
NODE_1293_length_2045_cov_46.790339	1058	1138	10	1	80	0.0125000
NODE_1293_length_2045_cov_46.790339	1058	1138	12	5	80	0.0625000
NODE_1293_length_2045_cov_46.790339	1058	1138	14	1	80	0.0125000
NODE_1293_length_2045_cov_46.790339	1058	1138	16	9	80	0.1125000
NODE_1293_length_2045_cov_46.790339	1058	1138	18	12	80	0.1500000
NODE_1293_length_2045_cov_46.790339	1058	1138	20	1	80	0.0125000
NODE_1298_length_2042_cov_4.447761	241	315	2	74	74	1.0000000
NODE_1301_length_2040_cov_30.109737	1760	1844	127	1	84	0.0119048
NODE_1301_length_2040_cov_30.109737	1760	1844	129	1	84	0.0119048
NODE_1301_length_2040_cov_30.109737	1760	1844	132	2	84	0.0238095
NODE_1301_length_2040_cov_30.109737	1760	1844	138	2	84	0.0238095
NODE_1301_length_2040_cov_30.109737	1760	1844	140	3	84	0.0357143
NODE_1301_length_2040_cov_30.109737	1760	1844	141	1	84	0.0119048
NODE_1301_length_2040_cov_30.109737	1760	1844	143	1	84	0.0119048
NODE_1301_length_2040_cov_30.109737	1760	1844	147	1	84	0.0119048
NODE_1301_length_2040_cov_30.109737	1760	1844	150	2	84	0.0238095
NODE_1301_length_2040_cov_30.109737	1760	1844	152	2	84	0.0238095
NODE_1301_length_2040_cov_30.109737	1760	1844	155	1	84	0.0119048
NODE_1301_length_2040_cov_30.109737	1760	1844	156	3	84	0.0357143
NODE_1301_length_2040_cov_30.109737	1760	1844	160	3	84	0.0357143
NODE_1301_length_2040_cov_30.109737	1760	1844	164	1	84	0.0119048
NODE_1301_length_2040_cov_30.109737	1760	1844	165	1	84	0.0119048
NODE_1301_length_2040_cov_30.109737	1760	1844	167	1	84	0.0119048
NODE_1301_length_2040_cov_30.109737	1760	1844	169	2	84	0.0238095
NODE_1301_length_2040_cov_30.109737	1760	1844	171	1	84	0.0119048
NODE_1301_length_2040_cov_30.109737	1760	1844	175	1	84	0.0119048
NODE_1301_length_2040_cov_30.109737	1760	1844	179	1	84	0.0119048
NODE_1301_length_2040_cov_30.109737	1760	1844	182	2	84	0.0238095
NODE_1301_length_2040_cov_30.109737	1760	1844	184	2	84	0.0238095
NODE_1301_length_2040_cov_30.109737	1760	1844	188	3	84	0.0357143
NODE_1301_length_2040_cov_30.109737	1760	1844	190	1	84	0.0119048
NODE_1301_length_2040_cov_30.109737	1760	1844	193	1	84	0.0119048
NODE_1301_length_2040_cov_30.109737	1760	1844	202	1	84	0.0119048
NODE_1301_length_2040_cov_30.109737	1760	1844	204	1	84	0.0119048
NODE_1301_length_2040_cov_30.109737	1760	1844	208	1	84	0.0119048
NODE_1301_length_2040_cov_30.109737	1760	1844	210	1	84	0.0119048
NODE_1301_length_2040_cov_30.109737	1760	1844	212	1	84	0.0119048
NODE_1301_length_2040_cov_30.109737	1760	1844	215	1	84	0.0119048
NODE_1301_length_2040_cov_30.109737	1760	1844	217	1	84	0.0119048
NODE_1301_length_2040_cov_30.109737	1760	1844	218	2	84	0.0238095
NODE_1301_length_2040_cov_30.109737	1760	1844	219	3	84	0.0357143
NODE_1301_length_2040_cov_30.109737	1760	1844	221	3	84	0.0357143
NODE_1301_length_2040_cov_30.109737	1760	1844	222	2	84	0.0238095
NODE_1301_length_2040_cov_30.109737	1760	1844	223	1	84	0.0119048
NODE_1301_length_2040_cov_30.109737	1760	1844	224	2	84	0.0238095
NODE_1301_length_2040_cov_30.109737	1760	1844	225	4	84	0.0476190
NODE_1301_length_2040_cov_30.109737	1760	1844	226	2	84	0.0238095
NODE_1301_length_2040_cov_30.109737	1760	1844	227	1	84	0.0119048
NODE_1301_length_2040_cov_30.109737	1760	1844	229	2	84	0.0238095
NODE_1301_length_2040_cov_30.109737	1760	1844	232	1	84	0.0119048
NODE_1301_length_2040_cov_30.109737	1760	1844	233	3	84	0.0357143
NODE_1301_length_2040_cov_30.109737	1760	1844	234	2	84	0.0238095
NODE_1301_length_2040_cov_30.109737	1760	1844	235	1	84	0.0119048
NODE_1301_length_2040_cov_30.109737	1760	1844	237	3	84	0.0357143
NODE_1301_length_2040_cov_30.109737	1760	1844	238	1	84	0.0119048
NODE_1301_length_2040_cov_30.109737	1760	1844	239	2	84	0.0238095
NODE_1301_length_2040_cov_30.109737	1760	1844	243	1	84	0.0119048
NODE_1301_length_2040_cov_30.109737	1760	1844	245	1	84	0.0119048
NODE_1306_length_2036_cov_11.672173	369	449	0	80	80	1.0000000
NODE_1306_length_2036_cov_11.672173	422	502	0	80	80	1.0000000
NODE_1312_length_2032_cov_11.188308	416	496	0	80	80	1.0000000
NODE_1312_length_2032_cov_11.188308	469	549	0	80	80	1.0000000
NODE_1318_length_2027_cov_43.702282	1129	1209	1	18	80	0.2250000
NODE_1318_length_2027_cov_43.702282	1129	1209	2	62	80	0.7750000
NODE_1318_length_2027_cov_43.702282	1182	1262	1	71	80	0.8875000
NODE_1318_length_2027_cov_43.702282	1182	1262	2	9	80	0.1125000
NODE_1318_length_2027_cov_43.702282	1258	1338	0	4	80	0.0500000
NODE_1318_length_2027_cov_43.702282	1258	1338	1	16	80	0.2000000
NODE_1318_length_2027_cov_43.702282	1258	1338	2	59	80	0.7375000
NODE_1318_length_2027_cov_43.702282	1258	1338	3	1	80	0.0125000
NODE_1318_length_2027_cov_43.702282	1311	1391	0	57	80	0.7125000
NODE_1318_length_2027_cov_43.702282	1311	1391	2	23	80	0.2875000
NODE_1319_length_2027_cov_6.558610	229	303	0	74	74	1.0000000
NODE_1319_length_2027_cov_6.558610	229	303	0	74	74	1.0000000
NODE_1319_length_2027_cov_6.558610	276	356	0	48	80	0.6000000
NODE_1319_length_2027_cov_6.558610	276	356	1	32	80	0.4000000
NODE_1320_length_2026_cov_18.457706	688	768	0	80	80	1.0000000
NODE_1320_length_2026_cov_18.457706	741	821	0	80	80	1.0000000
NODE_1324_length_2025_cov_10.711319	617	697	2	38	80	0.4750000
NODE_1324_length_2025_cov_10.711319	617	697	4	24	80	0.3000000
NODE_1324_length_2025_cov_10.711319	617	697	6	18	80	0.2250000
NODE_1324_length_2025_cov_10.711319	712	783	2	25	71	0.3521127
NODE_1324_length_2025_cov_10.711319	712	783	4	6	71	0.0845070
NODE_1324_length_2025_cov_10.711319	712	783	6	40	71	0.5633803
NODE_1324_length_2025_cov_10.711319	756	829	2	4	73	0.0547945
NODE_1324_length_2025_cov_10.711319	756	829	4	6	73	0.0821918
NODE_1324_length_2025_cov_10.711319	756	829	6	40	73	0.5479452
NODE_1324_length_2025_cov_10.711319	756	829	8	23	73	0.3150685
NODE_1325_length_2024_cov_33.891948	1045	1125	2	6	80	0.0750000
NODE_1325_length_2024_cov_33.891948	1045	1125	4	32	80	0.4000000
NODE_1325_length_2024_cov_33.891948	1045	1125	6	20	80	0.2500000
NODE_1325_length_2024_cov_33.891948	1045	1125	8	22	80	0.2750000
NODE_1325_length_2024_cov_33.891948	1098	1178	2	13	80	0.1625000
NODE_1325_length_2024_cov_33.891948	1098	1178	4	28	80	0.3500000
NODE_1325_length_2024_cov_33.891948	1098	1178	6	25	80	0.3125000
NODE_1325_length_2024_cov_33.891948	1098	1178	8	14	80	0.1750000
NODE_1331_length_2018_cov_33.742053	1215	1295	81	1	80	0.0125000
NODE_1331_length_2018_cov_33.742053	1215	1295	83	2	80	0.0250000
NODE_1331_length_2018_cov_33.742053	1215	1295	84	3	80	0.0375000
NODE_1331_length_2018_cov_33.742053	1215	1295	86	3	80	0.0375000
NODE_1331_length_2018_cov_33.742053	1215	1295	87	1	80	0.0125000
NODE_1331_length_2018_cov_33.742053	1215	1295	88	4	80	0.0500000
NODE_1331_length_2018_cov_33.742053	1215	1295	95	4	80	0.0500000
NODE_1331_length_2018_cov_33.742053	1215	1295	96	4	80	0.0500000
NODE_1331_length_2018_cov_33.742053	1215	1295	97	1	80	0.0125000
NODE_1331_length_2018_cov_33.742053	1215	1295	98	3	80	0.0375000
NODE_1331_length_2018_cov_33.742053	1215	1295	105	1	80	0.0125000
NODE_1331_length_2018_cov_33.742053	1215	1295	109	1	80	0.0125000
NODE_1331_length_2018_cov_33.742053	1215	1295	118	1	80	0.0125000
NODE_1331_length_2018_cov_33.742053	1215	1295	120	3	80	0.0375000
NODE_1331_length_2018_cov_33.742053	1215	1295	122	2	80	0.0250000
NODE_1331_length_2018_cov_33.742053	1215	1295	126	3	80	0.0375000
NODE_1331_length_2018_cov_33.742053	1215	1295	127	1	80	0.0125000
NODE_1331_length_2018_cov_33.742053	1215	1295	131	2	80	0.0250000
NODE_1331_length_2018_cov_33.742053	1215	1295	135	1	80	0.0125000
NODE_1331_length_2018_cov_33.742053	1215	1295	139	1	80	0.0125000
NODE_1331_length_2018_cov_33.742053	1215	1295	141	2	80	0.0250000
NODE_1331_length_2018_cov_33.742053	1215	1295	143	6	80	0.0750000
NODE_1331_length_2018_cov_33.742053	1215	1295	145	3	80	0.0375000
NODE_1331_length_2018_cov_33.742053	1215	1295	153	5	80	0.0625000
NODE_1331_length_2018_cov_33.742053	1215	1295	155	3	80	0.0375000
NODE_1331_length_2018_cov_33.742053	1215	1295	157	2	80	0.0250000
NODE_1331_length_2018_cov_33.742053	1215	1295	174	2	80	0.0250000
NODE_1331_length_2018_cov_33.742053	1215	1295	176	1	80	0.0125000
NODE_1331_length_2018_cov_33.742053	1215	1295	178	2	80	0.0250000
NODE_1331_length_2018_cov_33.742053	1215	1295	181	1	80	0.0125000
NODE_1331_length_2018_cov_33.742053	1215	1295	184	2	80	0.0250000
NODE_1331_length_2018_cov_33.742053	1215	1295	186	2	80	0.0250000
NODE_1331_length_2018_cov_33.742053	1215	1295	187	3	80	0.0375000
NODE_1331_length_2018_cov_33.742053	1215	1295	188	4	80	0.0500000
NODE_1331_length_2018_cov_33.742053	1268	1298	153	5	30	0.1666667
NODE_1331_length_2018_cov_33.742053	1268	1298	155	3	30	0.1000000
NODE_1331_length_2018_cov_33.742053	1268	1298	157	2	30	0.0666667
NODE_1331_length_2018_cov_33.742053	1268	1298	174	2	30	0.0666667
NODE_1331_length_2018_cov_33.742053	1268	1298	176	1	30	0.0333333
NODE_1331_length_2018_cov_33.742053	1268	1298	178	2	30	0.0666667
NODE_1331_length_2018_cov_33.742053	1268	1298	181	1	30	0.0333333
NODE_1331_length_2018_cov_33.742053	1268	1298	184	2	30	0.0666667
NODE_1331_length_2018_cov_33.742053	1268	1298	186	2	30	0.0666667
NODE_1331_length_2018_cov_33.742053	1268	1298	187	5	30	0.1666667
NODE_1331_length_2018_cov_33.742053	1268	1298	188	4	30	0.1333333
NODE_1331_length_2018_cov_33.742053	1268	1298	189	1	30	0.0333333
NODE_1331_length_2018_cov_33.742053	1876	1942	108	1	66	0.0151515
NODE_1331_length_2018_cov_33.742053	1876	1942	116	2	66	0.0303030
NODE_1331_length_2018_cov_33.742053	1876	1942	120	1	66	0.0151515
NODE_1331_length_2018_cov_33.742053	1876	1942	124	1	66	0.0151515
NODE_1331_length_2018_cov_33.742053	1876	1942	131	1	66	0.0151515
NODE_1331_length_2018_cov_33.742053	1876	1942	146	1	66	0.0151515
NODE_1331_length_2018_cov_33.742053	1876	1942	150	1	66	0.0151515
NODE_1331_length_2018_cov_33.742053	1876	1942	151	1	66	0.0151515
NODE_1331_length_2018_cov_33.742053	1876	1942	155	1	66	0.0151515
NODE_1331_length_2018_cov_33.742053	1876	1942	158	1	66	0.0151515
NODE_1331_length_2018_cov_33.742053	1876	1942	162	1	66	0.0151515
NODE_1331_length_2018_cov_33.742053	1876	1942	175	2	66	0.0303030
NODE_1331_length_2018_cov_33.742053	1876	1942	176	1	66	0.0151515
NODE_1331_length_2018_cov_33.742053	1876	1942	185	1	66	0.0151515
NODE_1331_length_2018_cov_33.742053	1876	1942	189	1	66	0.0151515
NODE_1331_length_2018_cov_33.742053	1876	1942	193	3	66	0.0454545
NODE_1331_length_2018_cov_33.742053	1876	1942	195	4	66	0.0606061
NODE_1331_length_2018_cov_33.742053	1876	1942	198	2	66	0.0303030
NODE_1331_length_2018_cov_33.742053	1876	1942	199	1	66	0.0151515
NODE_1331_length_2018_cov_33.742053	1876	1942	208	1	66	0.0151515
NODE_1331_length_2018_cov_33.742053	1876	1942	232	1	66	0.0151515
NODE_1331_length_2018_cov_33.742053	1876	1942	234	1	66	0.0151515
NODE_1331_length_2018_cov_33.742053	1876	1942	238	1	66	0.0151515
NODE_1331_length_2018_cov_33.742053	1876	1942	243	1	66	0.0151515
NODE_1331_length_2018_cov_33.742053	1876	1942	252	2	66	0.0303030
NODE_1331_length_2018_cov_33.742053	1876	1942	263	1	66	0.0151515
NODE_1331_length_2018_cov_33.742053	1876	1942	267	1	66	0.0151515
NODE_1331_length_2018_cov_33.742053	1876	1942	272	1	66	0.0151515
NODE_1331_length_2018_cov_33.742053	1876	1942	284	1	66	0.0151515
NODE_1331_length_2018_cov_33.742053	1876	1942	296	1	66	0.0151515
NODE_1331_length_2018_cov_33.742053	1876	1942	300	3	66	0.0454545
NODE_1331_length_2018_cov_33.742053	1876	1942	327	1	66	0.0151515
NODE_1331_length_2018_cov_33.742053	1876	1942	332	1	66	0.0151515
NODE_1331_length_2018_cov_33.742053	1876	1942	336	1	66	0.0151515
NODE_1331_length_2018_cov_33.742053	1876	1942	345	1	66	0.0151515
NODE_1331_length_2018_cov_33.742053	1876	1942	356	1	66	0.0151515
NODE_1331_length_2018_cov_33.742053	1876	1942	379	1	66	0.0151515
NODE_1331_length_2018_cov_33.742053	1876	1942	387	1	66	0.0151515
NODE_1331_length_2018_cov_33.742053	1876	1942	396	1	66	0.0151515
NODE_1331_length_2018_cov_33.742053	1876	1942	406	1	66	0.0151515
NODE_1331_length_2018_cov_33.742053	1876	1942	420	3	66	0.0454545
NODE_1331_length_2018_cov_33.742053	1876	1942	422	2	66	0.0303030
NODE_1331_length_2018_cov_33.742053	1876	1942	427	1	66	0.0151515
NODE_1331_length_2018_cov_33.742053	1876	1942	433	1	66	0.0151515
NODE_1331_length_2018_cov_33.742053	1876	1942	441	1	66	0.0151515
NODE_1331_length_2018_cov_33.742053	1876	1942	442	1	66	0.0151515
NODE_1331_length_2018_cov_33.742053	1876	1942	448	1	66	0.0151515
NODE_1331_length_2018_cov_33.742053	1876	1942	458	1	66	0.0151515
NODE_1331_length_2018_cov_33.742053	1876	1942	461	1	66	0.0151515
NODE_1331_length_2018_cov_33.742053	1876	1942	469	1	66	0.0151515
NODE_1331_length_2018_cov_33.742053	1876	1942	470	1	66	0.0151515
NODE_1331_length_2018_cov_33.742053	1876	1942	480	1	66	0.0151515
NODE_1331_length_2018_cov_33.742053	1915	1995	16	4	80	0.0500000
NODE_1331_length_2018_cov_33.742053	1915	1995	18	1	80	0.0125000
NODE_1331_length_2018_cov_33.742053	1915	1995	20	1	80	0.0125000
NODE_1331_length_2018_cov_33.742053	1915	1995	24	1	80	0.0125000
NODE_1331_length_2018_cov_33.742053	1915	1995	26	2	80	0.0250000
NODE_1331_length_2018_cov_33.742053	1915	1995	28	1	80	0.0125000
NODE_1331_length_2018_cov_33.742053	1915	1995	32	1	80	0.0125000
NODE_1331_length_2018_cov_33.742053	1915	1995	33	2	80	0.0250000
NODE_1331_length_2018_cov_33.742053	1915	1995	37	3	80	0.0375000
NODE_1331_length_2018_cov_33.742053	1915	1995	41	2	80	0.0250000
NODE_1331_length_2018_cov_33.742053	1915	1995	42	1	80	0.0125000
NODE_1331_length_2018_cov_33.742053	1915	1995	44	3	80	0.0375000
NODE_1331_length_2018_cov_33.742053	1915	1995	47	1	80	0.0125000
NODE_1331_length_2018_cov_33.742053	1915	1995	49	1	80	0.0125000
NODE_1331_length_2018_cov_33.742053	1915	1995	54	2	80	0.0250000
NODE_1331_length_2018_cov_33.742053	1915	1995	56	1	80	0.0125000
NODE_1331_length_2018_cov_33.742053	1915	1995	58	2	80	0.0250000
NODE_1331_length_2018_cov_33.742053	1915	1995	64	1	80	0.0125000
NODE_1331_length_2018_cov_33.742053	1915	1995	66	2	80	0.0250000
NODE_1331_length_2018_cov_33.742053	1915	1995	67	1	80	0.0125000
NODE_1331_length_2018_cov_33.742053	1915	1995	71	2	80	0.0250000
NODE_1331_length_2018_cov_33.742053	1915	1995	74	1	80	0.0125000
NODE_1331_length_2018_cov_33.742053	1915	1995	76	1	80	0.0125000
NODE_1331_length_2018_cov_33.742053	1915	1995	80	2	80	0.0250000
NODE_1331_length_2018_cov_33.742053	1915	1995	82	1	80	0.0125000
NODE_1331_length_2018_cov_33.742053	1915	1995	84	2	80	0.0250000
NODE_1331_length_2018_cov_33.742053	1915	1995	86	2	80	0.0250000
NODE_1331_length_2018_cov_33.742053	1915	1995	90	1	80	0.0125000
NODE_1331_length_2018_cov_33.742053	1915	1995	91	3	80	0.0375000
NODE_1331_length_2018_cov_33.742053	1915	1995	93	3	80	0.0375000
NODE_1331_length_2018_cov_33.742053	1915	1995	101	1	80	0.0125000
NODE_1331_length_2018_cov_33.742053	1915	1995	105	1	80	0.0125000
NODE_1331_length_2018_cov_33.742053	1915	1995	108	1	80	0.0125000
NODE_1331_length_2018_cov_33.742053	1915	1995	116	2	80	0.0250000
NODE_1331_length_2018_cov_33.742053	1915	1995	120	1	80	0.0125000
NODE_1331_length_2018_cov_33.742053	1915	1995	124	1	80	0.0125000
NODE_1331_length_2018_cov_33.742053	1915	1995	131	1	80	0.0125000
NODE_1331_length_2018_cov_33.742053	1915	1995	146	1	80	0.0125000
NODE_1331_length_2018_cov_33.742053	1915	1995	150	1	80	0.0125000
NODE_1331_length_2018_cov_33.742053	1915	1995	151	1	80	0.0125000
NODE_1331_length_2018_cov_33.742053	1915	1995	155	1	80	0.0125000
NODE_1331_length_2018_cov_33.742053	1915	1995	158	1	80	0.0125000
NODE_1331_length_2018_cov_33.742053	1915	1995	162	1	80	0.0125000
NODE_1331_length_2018_cov_33.742053	1915	1995	175	2	80	0.0250000
NODE_1331_length_2018_cov_33.742053	1915	1995	176	1	80	0.0125000
NODE_1331_length_2018_cov_33.742053	1915	1995	185	1	80	0.0125000
NODE_1331_length_2018_cov_33.742053	1915	1995	189	1	80	0.0125000
NODE_1331_length_2018_cov_33.742053	1915	1995	193	3	80	0.0375000
NODE_1331_length_2018_cov_33.742053	1915	1995	195	4	80	0.0500000
NODE_1331_length_2018_cov_33.742053	1915	1995	198	2	80	0.0250000
NODE_1331_length_2018_cov_33.742053	1915	1995	199	1	80	0.0125000
NODE_1337_length_2011_cov_22.430439	434	514	0	80	80	1.0000000
NODE_1337_length_2011_cov_22.430439	487	567	0	80	80	1.0000000
NODE_1337_length_2011_cov_22.430439	1124	1204	0	68	80	0.8500000
NODE_1337_length_2011_cov_22.430439	1124	1204	2	12	80	0.1500000
NODE_1337_length_2011_cov_22.430439	1177	1257	0	80	80	1.0000000
NODE_1343_length_2001_cov_10.416404	692	772	0	29	80	0.3625000
NODE_1343_length_2001_cov_10.416404	692	772	2	51	80	0.6375000
NODE_1343_length_2001_cov_10.416404	745	825	2	80	80	1.0000000
NODE_1350_length_1991_cov_112.926533	212	292	168	1	80	0.0125000
NODE_1350_length_1991_cov_112.926533	212	292	173	1	80	0.0125000
NODE_1350_length_1991_cov_112.926533	212	292	176	1	80	0.0125000
NODE_1350_length_1991_cov_112.926533	212	292	178	1	80	0.0125000
NODE_1350_length_1991_cov_112.926533	212	292	179	1	80	0.0125000
NODE_1350_length_1991_cov_112.926533	212	292	181	1	80	0.0125000
NODE_1350_length_1991_cov_112.926533	212	292	183	1	80	0.0125000
NODE_1350_length_1991_cov_112.926533	212	292	184	2	80	0.0250000
NODE_1350_length_1991_cov_112.926533	212	292	185	2	80	0.0250000
NODE_1350_length_1991_cov_112.926533	212	292	187	1	80	0.0125000
NODE_1350_length_1991_cov_112.926533	212	292	189	2	80	0.0250000
NODE_1350_length_1991_cov_112.926533	212	292	190	2	80	0.0250000
NODE_1350_length_1991_cov_112.926533	212	292	191	3	80	0.0375000
NODE_1350_length_1991_cov_112.926533	212	292	194	1	80	0.0125000
NODE_1350_length_1991_cov_112.926533	212	292	195	1	80	0.0125000
NODE_1350_length_1991_cov_112.926533	212	292	197	1	80	0.0125000
NODE_1350_length_1991_cov_112.926533	212	292	198	1	80	0.0125000
NODE_1350_length_1991_cov_112.926533	212	292	199	1	80	0.0125000
NODE_1350_length_1991_cov_112.926533	212	292	200	2	80	0.0250000
NODE_1350_length_1991_cov_112.926533	212	292	202	3	80	0.0375000
NODE_1350_length_1991_cov_112.926533	212	292	204	1	80	0.0125000
NODE_1350_length_1991_cov_112.926533	212	292	206	1	80	0.0125000
NODE_1350_length_1991_cov_112.926533	212	292	207	2	80	0.0250000
NODE_1350_length_1991_cov_112.926533	212	292	208	1	80	0.0125000
NODE_1350_length_1991_cov_112.926533	212	292	209	1	80	0.0125000
NODE_1350_length_1991_cov_112.926533	212	292	212	1	80	0.0125000
NODE_1350_length_1991_cov_112.926533	212	292	216	3	80	0.0375000
NODE_1350_length_1991_cov_112.926533	212	292	217	1	80	0.0125000
NODE_1350_length_1991_cov_112.926533	212	292	219	4	80	0.0500000
NODE_1350_length_1991_cov_112.926533	212	292	220	7	80	0.0875000
NODE_1350_length_1991_cov_112.926533	212	292	221	4	80	0.0500000
NODE_1350_length_1991_cov_112.926533	212	292	223	9	80	0.1125000
NODE_1350_length_1991_cov_112.926533	212	292	224	4	80	0.0500000
NODE_1350_length_1991_cov_112.926533	212	292	225	1	80	0.0125000
NODE_1350_length_1991_cov_112.926533	212	292	226	3	80	0.0375000
NODE_1350_length_1991_cov_112.926533	212	292	227	1	80	0.0125000
NODE_1350_length_1991_cov_112.926533	212	292	228	1	80	0.0125000
NODE_1350_length_1991_cov_112.926533	212	292	229	4	80	0.0500000
NODE_1350_length_1991_cov_112.926533	212	292	230	2	80	0.0250000
NODE_1352_length_1988_cov_13.736368	865	945	0	44	80	0.5500000
NODE_1352_length_1988_cov_13.736368	865	945	2	36	80	0.4500000
NODE_1352_length_1988_cov_13.736368	918	998	2	43	80	0.5375000
NODE_1352_length_1988_cov_13.736368	918	998	4	37	80	0.4625000
NODE_1353_length_1988_cov_9.980413	1616	1696	4	19	80	0.2375000
NODE_1353_length_1988_cov_9.980413	1616	1696	6	61	80	0.7625000
NODE_1353_length_1988_cov_9.980413	1669	1749	0	44	80	0.5500000
NODE_1353_length_1988_cov_9.980413	1669	1749	4	28	80	0.3500000
NODE_1353_length_1988_cov_9.980413	1669	1749	6	8	80	0.1000000
NODE_1356_length_1983_cov_17.332803	494	574	0	80	80	1.0000000
NODE_1356_length_1983_cov_17.332803	547	627	0	51	80	0.6375000
NODE_1356_length_1983_cov_17.332803	547	627	2	29	80	0.3625000
NODE_1356_length_1983_cov_17.332803	1600	1680	2	27	80	0.3375000
NODE_1356_length_1983_cov_17.332803	1600	1680	4	53	80	0.6625000
NODE_1356_length_1983_cov_17.332803	1653	1733	2	12	80	0.1500000
NODE_1356_length_1983_cov_17.332803	1653	1733	4	68	80	0.8500000
NODE_1359_length_1982_cov_17.164100	457	537	0	11	80	0.1375000
NODE_1359_length_1982_cov_17.164100	457	537	1	69	80	0.8625000
NODE_1359_length_1982_cov_17.164100	510	590	0	64	80	0.8000000
NODE_1359_length_1982_cov_17.164100	510	590	1	16	80	0.2000000
NODE_1359_length_1982_cov_17.164100	586	666	0	80	80	1.0000000
NODE_1359_length_1982_cov_17.164100	639	723	0	84	84	1.0000000
NODE_1360_length_1981_cov_46.444208	0	70	0	46	70	0.6571429
NODE_1360_length_1981_cov_46.444208	0	70	4	21	70	0.3000000
NODE_1360_length_1981_cov_46.444208	0	70	6	3	70	0.0428571
NODE_1362_length_1979_cov_1.630851	1554	1634	0	36	80	0.4500000
NODE_1362_length_1979_cov_1.630851	1554	1634	2	44	80	0.5500000
NODE_1364_length_1976_cov_1.959510	154	215	4	3	61	0.0491803
NODE_1364_length_1976_cov_1.959510	154	215	6	1	61	0.0163934
NODE_1364_length_1976_cov_1.959510	154	215	8	12	61	0.1967213
NODE_1364_length_1976_cov_1.959510	154	215	10	45	61	0.7377049
NODE_1364_length_1976_cov_1.959510	154	215	4	3	61	0.0491803
NODE_1364_length_1976_cov_1.959510	154	215	6	1	61	0.0163934
NODE_1364_length_1976_cov_1.959510	154	215	8	12	61	0.1967213
NODE_1364_length_1976_cov_1.959510	154	215	10	45	61	0.7377049
NODE_1364_length_1976_cov_1.959510	154	213	4	3	59	0.0508475
NODE_1364_length_1976_cov_1.959510	154	213	6	1	59	0.0169492
NODE_1364_length_1976_cov_1.959510	154	213	8	12	59	0.2033898
NODE_1364_length_1976_cov_1.959510	154	213	10	43	59	0.7288136
NODE_1365_length_1974_cov_8.058133	617	697	14	2	80	0.0250000
NODE_1365_length_1974_cov_8.058133	617	697	16	41	80	0.5125000
NODE_1365_length_1974_cov_8.058133	617	697	18	4	80	0.0500000
NODE_1365_length_1974_cov_8.058133	617	697	20	33	80	0.4125000
NODE_1365_length_1974_cov_8.058133	670	750	4	1	80	0.0125000
NODE_1365_length_1974_cov_8.058133	670	750	6	16	80	0.2000000
NODE_1365_length_1974_cov_8.058133	670	750	14	17	80	0.2125000
NODE_1365_length_1974_cov_8.058133	670	750	15	1	80	0.0125000
NODE_1365_length_1974_cov_8.058133	670	750	16	42	80	0.5250000
NODE_1365_length_1974_cov_8.058133	670	750	17	3	80	0.0375000
NODE_1366_length_1973_cov_14.885272	640	726	0	25	86	0.2906977
NODE_1366_length_1973_cov_14.885272	640	726	2	10	86	0.1162791
NODE_1366_length_1973_cov_14.885272	640	726	4	27	86	0.3139535
NODE_1366_length_1973_cov_14.885272	640	726	5	24	86	0.2790698
NODE_1366_length_1973_cov_14.885272	699	779	1	3	80	0.0375000
NODE_1366_length_1973_cov_14.885272	699	779	2	38	80	0.4750000
NODE_1366_length_1973_cov_14.885272	699	779	3	2	80	0.0250000
NODE_1366_length_1973_cov_14.885272	699	779	4	3	80	0.0375000
NODE_1366_length_1973_cov_14.885272	699	779	5	34	80	0.4250000
NODE_1366_length_1973_cov_14.885272	1389	1469	0	80	80	1.0000000
NODE_1366_length_1973_cov_14.885272	1442	1522	0	42	80	0.5250000
NODE_1366_length_1973_cov_14.885272	1442	1522	2	38	80	0.4750000
NODE_1372_length_1971_cov_3.126068	1662	1742	20	16	80	0.2000000
NODE_1372_length_1971_cov_3.126068	1662	1742	22	7	80	0.0875000
NODE_1372_length_1971_cov_3.126068	1662	1742	24	10	80	0.1250000
NODE_1372_length_1971_cov_3.126068	1662	1742	26	16	80	0.2000000
NODE_1372_length_1971_cov_3.126068	1662	1742	28	9	80	0.1125000
NODE_1372_length_1971_cov_3.126068	1662	1742	30	22	80	0.2750000
NODE_1372_length_1971_cov_3.126068	1715	1799	20	3	84	0.0357143
NODE_1372_length_1971_cov_3.126068	1715	1799	22	10	84	0.1190476
NODE_1372_length_1971_cov_3.126068	1715	1799	24	25	84	0.2976190
NODE_1372_length_1971_cov_3.126068	1715	1799	26	15	84	0.1785714
NODE_1372_length_1971_cov_3.126068	1715	1799	28	17	84	0.2023810
NODE_1372_length_1971_cov_3.126068	1715	1799	30	14	84	0.1666667
NODE_1386_length_1962_cov_23.774557	281	311	0	30	30	1.0000000
NODE_1386_length_1962_cov_23.774557	329	355	0	26	26	1.0000000
NODE_1386_length_1962_cov_23.774557	408	487	0	7	79	0.0886076
NODE_1386_length_1962_cov_23.774557	408	487	2	72	79	0.9113924
NODE_1386_length_1962_cov_23.774557	460	540	0	55	80	0.6875000
NODE_1386_length_1962_cov_23.774557	460	540	2	25	80	0.3125000
NODE_1386_length_1962_cov_23.774557	1417	1497	0	59	80	0.7375000
NODE_1386_length_1962_cov_23.774557	1417	1497	2	21	80	0.2625000
NODE_1386_length_1962_cov_23.774557	1470	1550	0	6	80	0.0750000
NODE_1386_length_1962_cov_23.774557	1470	1550	2	74	80	0.9250000
NODE_1386_length_1962_cov_23.774557	1607	1640	0	33	33	1.0000000
NODE_1395_length_1953_cov_26.183927	1	81	11	2	80	0.0250000
NODE_1395_length_1953_cov_26.183927	1	81	12	6	80	0.0750000
NODE_1395_length_1953_cov_26.183927	1	81	16	51	80	0.6375000
NODE_1395_length_1953_cov_26.183927	1	81	20	21	80	0.2625000
NODE_1395_length_1953_cov_26.183927	6	28	12	3	22	0.1363636
NODE_1395_length_1953_cov_26.183927	6	28	16	19	22	0.8636364
NODE_1395_length_1953_cov_26.183927	152	232	0	80	80	1.0000000
NODE_1395_length_1953_cov_26.183927	205	257	0	49	52	0.9423077
NODE_1395_length_1953_cov_26.183927	205	257	2	1	52	0.0192308
NODE_1395_length_1953_cov_26.183927	205	257	7	1	52	0.0192308
NODE_1395_length_1953_cov_26.183927	205	257	10	1	52	0.0192308
NODE_1405_length_1943_cov_11.218547	516	596	0	57	80	0.7125000
NODE_1405_length_1943_cov_11.218547	516	596	4	23	80	0.2875000
NODE_1405_length_1943_cov_11.218547	569	649	0	4	80	0.0500000
NODE_1405_length_1943_cov_11.218547	569	649	4	76	80	0.9500000
NODE_1408_length_1941_cov_14.407709	891	921	0	30	30	1.0000000
NODE_1408_length_1941_cov_14.407709	894	964	0	70	70	1.0000000
NODE_1408_length_1941_cov_14.407709	1878	1941	0	63	63	1.0000000
NODE_1409_length_1941_cov_9.632465	139	213	6	4	74	0.0540541
NODE_1409_length_1941_cov_9.632465	139	213	8	15	74	0.2027027
NODE_1409_length_1941_cov_9.632465	139	213	12	22	74	0.2972973
NODE_1409_length_1941_cov_9.632465	139	213	14	28	74	0.3783784
NODE_1409_length_1941_cov_9.632465	139	213	16	5	74	0.0675676
NODE_1409_length_1941_cov_9.632465	139	219	6	4	80	0.0500000
NODE_1409_length_1941_cov_9.632465	139	219	8	15	80	0.1875000
NODE_1409_length_1941_cov_9.632465	139	219	12	25	80	0.3125000
NODE_1409_length_1941_cov_9.632465	139	219	14	31	80	0.3875000
NODE_1409_length_1941_cov_9.632465	139	219	16	5	80	0.0625000
NODE_1409_length_1941_cov_9.632465	139	194	6	4	55	0.0727273
NODE_1409_length_1941_cov_9.632465	139	194	8	15	55	0.2727273
NODE_1409_length_1941_cov_9.632465	139	194	12	8	55	0.1454545
NODE_1409_length_1941_cov_9.632465	139	194	14	28	55	0.5090909
NODE_1409_length_1941_cov_9.632465	192	272	8	21	80	0.2625000
NODE_1409_length_1941_cov_9.632465	192	272	12	28	80	0.3500000
NODE_1409_length_1941_cov_9.632465	192	272	14	26	80	0.3250000
NODE_1409_length_1941_cov_9.632465	192	272	16	5	80	0.0625000
NODE_1414_length_1936_cov_13.338596	679	759	0	80	80	1.0000000
NODE_1414_length_1936_cov_13.338596	732	812	0	80	80	1.0000000
NODE_1414_length_1936_cov_13.338596	738	812	0	74	74	1.0000000
NODE_1414_length_1936_cov_13.338596	738	759	0	21	21	1.0000000
NODE_1415_length_1936_cov_12.592814	102	153	0	16	51	0.3137255
NODE_1415_length_1936_cov_12.592814	102	153	2	27	51	0.5294118
NODE_1415_length_1936_cov_12.592814	102	153	6	7	51	0.1372549
NODE_1415_length_1936_cov_12.592814	102	153	10	1	51	0.0196078
NODE_1415_length_1936_cov_12.592814	154	230	20	4	76	0.0526316
NODE_1415_length_1936_cov_12.592814	154	230	22	1	76	0.0131579
NODE_1415_length_1936_cov_12.592814	154	230	30	2	76	0.0263158
NODE_1415_length_1936_cov_12.592814	154	230	32	2	76	0.0263158
NODE_1415_length_1936_cov_12.592814	154	230	34	3	76	0.0394737
NODE_1415_length_1936_cov_12.592814	154	230	36	5	76	0.0657895
NODE_1415_length_1936_cov_12.592814	154	230	38	1	76	0.0131579
NODE_1415_length_1936_cov_12.592814	154	230	40	18	76	0.2368421
NODE_1415_length_1936_cov_12.592814	154	230	42	40	76	0.5263158
NODE_1415_length_1936_cov_12.592814	211	251	14	1	40	0.0250000
NODE_1415_length_1936_cov_12.592814	211	251	16	1	40	0.0250000
NODE_1415_length_1936_cov_12.592814	211	251	20	1	40	0.0250000
NODE_1415_length_1936_cov_12.592814	211	251	24	2	40	0.0500000
NODE_1415_length_1936_cov_12.592814	211	251	30	5	40	0.1250000
NODE_1415_length_1936_cov_12.592814	211	251	34	4	40	0.1000000
NODE_1415_length_1936_cov_12.592814	211	251	38	4	40	0.1000000
NODE_1415_length_1936_cov_12.592814	211	251	40	1	40	0.0250000
NODE_1415_length_1936_cov_12.592814	211	251	42	21	40	0.5250000
NODE_1416_length_1933_cov_86.724646	1044	1124	2	56	80	0.7000000
NODE_1416_length_1933_cov_86.724646	1044	1124	4	5	80	0.0625000
NODE_1416_length_1933_cov_86.724646	1044	1124	6	19	80	0.2375000
NODE_1416_length_1933_cov_86.724646	1097	1177	2	3	80	0.0375000
NODE_1416_length_1933_cov_86.724646	1097	1177	4	58	80	0.7250000
NODE_1416_length_1933_cov_86.724646	1097	1177	6	19	80	0.2375000
NODE_1416_length_1933_cov_86.724646	1173	1253	0	49	80	0.6125000
NODE_1416_length_1933_cov_86.724646	1173	1253	4	31	80	0.3875000
NODE_1416_length_1933_cov_86.724646	1226	1306	0	41	80	0.5125000
NODE_1416_length_1933_cov_86.724646	1226	1306	2	39	80	0.4875000
NODE_1419_length_1932_cov_5.905074	1534	1614	0	8	80	0.1000000
NODE_1419_length_1932_cov_5.905074	1534	1614	2	72	80	0.9000000
NODE_1422_length_1930_cov_3.005461	1700	1780	85	2	80	0.0250000
NODE_1422_length_1930_cov_3.005461	1700	1780	86	1	80	0.0125000
NODE_1422_length_1930_cov_3.005461	1700	1780	89	2	80	0.0250000
NODE_1422_length_1930_cov_3.005461	1700	1780	90	2	80	0.0250000
NODE_1422_length_1930_cov_3.005461	1700	1780	91	1	80	0.0125000
NODE_1422_length_1930_cov_3.005461	1700	1780	92	4	80	0.0500000
NODE_1422_length_1930_cov_3.005461	1700	1780	94	1	80	0.0125000
NODE_1422_length_1930_cov_3.005461	1700	1780	96	22	80	0.2750000
NODE_1422_length_1930_cov_3.005461	1700	1780	98	12	80	0.1500000
NODE_1422_length_1930_cov_3.005461	1700	1780	99	2	80	0.0250000
NODE_1422_length_1930_cov_3.005461	1700	1780	100	22	80	0.2750000
NODE_1422_length_1930_cov_3.005461	1700	1780	101	1	80	0.0125000
NODE_1422_length_1930_cov_3.005461	1700	1780	102	7	80	0.0875000
NODE_1422_length_1930_cov_3.005461	1700	1780	106	1	80	0.0125000
NODE_1427_length_1928_cov_2.580098	74	131	33	3	57	0.0526316
NODE_1427_length_1928_cov_2.580098	74	131	34	1	57	0.0175439
NODE_1427_length_1928_cov_2.580098	74	131	35	1	57	0.0175439
NODE_1427_length_1928_cov_2.580098	74	131	36	29	57	0.5087720
NODE_1427_length_1928_cov_2.580098	74	131	38	23	57	0.4035088
NODE_1427_length_1928_cov_2.580098	127	184	7	5	57	0.0877193
NODE_1427_length_1928_cov_2.580098	127	184	13	15	57	0.2631579
NODE_1427_length_1928_cov_2.580098	127	184	15	1	57	0.0175439
NODE_1427_length_1928_cov_2.580098	127	184	16	1	57	0.0175439
NODE_1427_length_1928_cov_2.580098	127	184	20	8	57	0.1403509
NODE_1427_length_1928_cov_2.580098	127	184	27	1	57	0.0175439
NODE_1427_length_1928_cov_2.580098	127	184	29	1	57	0.0175439
NODE_1427_length_1928_cov_2.580098	127	184	30	11	57	0.1929825
NODE_1427_length_1928_cov_2.580098	127	184	32	4	57	0.0701754
NODE_1427_length_1928_cov_2.580098	127	184	33	1	57	0.0175439
NODE_1427_length_1928_cov_2.580098	127	184	34	6	57	0.1052632
NODE_1427_length_1928_cov_2.580098	127	184	36	3	57	0.0526316
NODE_1434_length_1919_cov_17.901099	454	529	10	5	75	0.0666667
NODE_1434_length_1919_cov_17.901099	454	529	12	18	75	0.2400000
NODE_1434_length_1919_cov_17.901099	454	529	14	52	75	0.6933333
NODE_1434_length_1919_cov_17.901099	507	558	0	13	51	0.2549020
NODE_1434_length_1919_cov_17.901099	507	558	2	4	51	0.0784314
NODE_1434_length_1919_cov_17.901099	507	558	4	3	51	0.0588235
NODE_1434_length_1919_cov_17.901099	507	558	6	8	51	0.1568628
NODE_1434_length_1919_cov_17.901099	507	558	10	6	51	0.1176471
NODE_1434_length_1919_cov_17.901099	507	558	14	17	51	0.3333333
NODE_1436_length_1918_cov_14.876855	314	396	14	8	82	0.0975610
NODE_1436_length_1918_cov_14.876855	314	396	16	3	82	0.0365854
NODE_1436_length_1918_cov_14.876855	314	396	18	41	82	0.5000000
NODE_1436_length_1918_cov_14.876855	314	396	20	30	82	0.3658537
NODE_1438_length_1918_cov_3.493128	9	55	0	1	46	0.0217391
NODE_1438_length_1918_cov_3.493128	9	55	2	45	46	0.9782609
NODE_1438_length_1918_cov_3.493128	1480	1561	0	81	81	1.0000000
NODE_1440_length_1916_cov_4.426527	162	192	4	30	30	1.0000000
NODE_1442_length_1915_cov_35.787996	106	186	24	6	80	0.0750000
NODE_1442_length_1915_cov_35.787996	106	186	26	2	80	0.0250000
NODE_1442_length_1915_cov_35.787996	106	186	28	1	80	0.0125000
NODE_1442_length_1915_cov_35.787996	106	186	30	4	80	0.0500000
NODE_1442_length_1915_cov_35.787996	106	186	31	3	80	0.0375000
NODE_1442_length_1915_cov_35.787996	106	186	34	1	80	0.0125000
NODE_1442_length_1915_cov_35.787996	106	186	36	1	80	0.0125000
NODE_1442_length_1915_cov_35.787996	106	186	39	1	80	0.0125000
NODE_1442_length_1915_cov_35.787996	106	186	40	1	80	0.0125000
NODE_1442_length_1915_cov_35.787996	106	186	44	4	80	0.0500000
NODE_1442_length_1915_cov_35.787996	106	186	46	11	80	0.1375000
NODE_1442_length_1915_cov_35.787996	106	186	52	2	80	0.0250000
NODE_1442_length_1915_cov_35.787996	106	186	60	5	80	0.0625000
NODE_1442_length_1915_cov_35.787996	106	186	62	1	80	0.0125000
NODE_1442_length_1915_cov_35.787996	106	186	64	4	80	0.0500000
NODE_1442_length_1915_cov_35.787996	106	186	66	3	80	0.0375000
NODE_1442_length_1915_cov_35.787996	106	186	68	3	80	0.0375000
NODE_1442_length_1915_cov_35.787996	106	186	70	4	80	0.0500000
NODE_1442_length_1915_cov_35.787996	106	186	72	1	80	0.0125000
NODE_1442_length_1915_cov_35.787996	106	186	74	8	80	0.1000000
NODE_1442_length_1915_cov_35.787996	106	186	76	14	80	0.1750000
NODE_1451_length_1905_cov_18.464563	740	820	0	59	80	0.7375000
NODE_1451_length_1905_cov_18.464563	740	820	2	21	80	0.2625000
NODE_1451_length_1905_cov_18.464563	793	873	0	6	80	0.0750000
NODE_1451_length_1905_cov_18.464563	793	873	2	44	80	0.5500000
NODE_1451_length_1905_cov_18.464563	793	873	4	30	80	0.3750000
NODE_1451_length_1905_cov_18.464563	869	949	0	63	80	0.7875000
NODE_1451_length_1905_cov_18.464563	869	949	2	17	80	0.2125000
NODE_1451_length_1905_cov_18.464563	922	1010	0	88	88	1.0000000
NODE_1452_length_1905_cov_7.197121	596	676	0	80	80	1.0000000
NODE_1452_length_1905_cov_7.197121	649	682	0	33	33	1.0000000
NODE_1455_length_1902_cov_1.633943	1728	1792	22	2	64	0.0312500
NODE_1455_length_1902_cov_1.633943	1728	1792	24	1	64	0.0156250
NODE_1455_length_1902_cov_1.633943	1728	1792	26	1	64	0.0156250
NODE_1455_length_1902_cov_1.633943	1728	1792	28	5	64	0.0781250
NODE_1455_length_1902_cov_1.633943	1728	1792	32	2	64	0.0312500
NODE_1455_length_1902_cov_1.633943	1728	1792	34	5	64	0.0781250
NODE_1455_length_1902_cov_1.633943	1728	1792	37	2	64	0.0312500
NODE_1455_length_1902_cov_1.633943	1728	1792	41	2	64	0.0312500
NODE_1455_length_1902_cov_1.633943	1728	1792	43	2	64	0.0312500
NODE_1455_length_1902_cov_1.633943	1728	1792	47	7	64	0.1093750
NODE_1455_length_1902_cov_1.633943	1728	1792	51	12	64	0.1875000
NODE_1455_length_1902_cov_1.633943	1728	1792	53	7	64	0.1093750
NODE_1455_length_1902_cov_1.633943	1728	1792	55	3	64	0.0468750
NODE_1455_length_1902_cov_1.633943	1728	1792	57	2	64	0.0312500
NODE_1455_length_1902_cov_1.633943	1728	1792	61	2	64	0.0312500
NODE_1455_length_1902_cov_1.633943	1728	1792	63	2	64	0.0312500
NODE_1455_length_1902_cov_1.633943	1728	1792	65	1	64	0.0156250
NODE_1455_length_1902_cov_1.633943	1728	1792	67	6	64	0.0937500
NODE_1458_length_1900_cov_1.081066	1805	1851	0	46	46	1.0000000
NODE_1458_length_1900_cov_1.081066	1824	1900	0	76	76	1.0000000
NODE_1461_length_1895_cov_17.940980	1070	1150	2	47	80	0.5875000
NODE_1461_length_1895_cov_17.940980	1070	1150	4	9	80	0.1125000
NODE_1461_length_1895_cov_17.940980	1070	1150	6	24	80	0.3000000
NODE_1461_length_1895_cov_17.940980	1123	1203	2	5	80	0.0625000
NODE_1461_length_1895_cov_17.940980	1123	1203	4	48	80	0.6000000
NODE_1461_length_1895_cov_17.940980	1123	1203	6	27	80	0.3375000
NODE_1466_length_1893_cov_3.299331	918	998	2	46	80	0.5750000
NODE_1466_length_1893_cov_3.299331	918	998	4	29	80	0.3625000
NODE_1466_length_1893_cov_3.299331	918	998	6	5	80	0.0625000
NODE_1467_length_1892_cov_5.158394	317	397	2	7	80	0.0875000
NODE_1467_length_1892_cov_5.158394	317	397	4	73	80	0.9125000
NODE_1467_length_1892_cov_5.158394	370	445	0	32	75	0.4266667
NODE_1467_length_1892_cov_5.158394	370	445	2	15	75	0.2000000
NODE_1467_length_1892_cov_5.158394	370	445	4	28	75	0.3733333
NODE_1469_length_1889_cov_4.049162	1652	1686	2	14	34	0.4117647
NODE_1469_length_1889_cov_4.049162	1652	1686	4	19	34	0.5588235
NODE_1469_length_1889_cov_4.049162	1652	1686	8	1	34	0.0294118
NODE_1470_length_1889_cov_3.888268	960	1040	0	27	80	0.3375000
NODE_1470_length_1889_cov_3.888268	960	1040	2	53	80	0.6625000
NODE_1470_length_1889_cov_3.888268	1013	1093	0	80	80	1.0000000
NODE_1472_length_1888_cov_17.106764	15	96	26	2	81	0.0246914
NODE_1472_length_1888_cov_17.106764	15	96	30	4	81	0.0493827
NODE_1472_length_1888_cov_17.106764	15	96	34	2	81	0.0246914
NODE_1472_length_1888_cov_17.106764	15	96	38	1	81	0.0123457
NODE_1472_length_1888_cov_17.106764	15	96	40	1	81	0.0123457
NODE_1472_length_1888_cov_17.106764	15	96	42	2	81	0.0246914
NODE_1472_length_1888_cov_17.106764	15	96	44	1	81	0.0123457
NODE_1472_length_1888_cov_17.106764	15	96	46	15	81	0.1851852
NODE_1472_length_1888_cov_17.106764	15	96	48	7	81	0.0864198
NODE_1472_length_1888_cov_17.106764	15	96	50	3	81	0.0370370
NODE_1472_length_1888_cov_17.106764	15	96	52	28	81	0.3456790
NODE_1472_length_1888_cov_17.106764	15	96	56	15	81	0.1851852
NODE_1472_length_1888_cov_17.106764	68	143	13	7	75	0.0933333
NODE_1472_length_1888_cov_17.106764	68	143	16	5	75	0.0666667
NODE_1472_length_1888_cov_17.106764	68	143	18	1	75	0.0133333
NODE_1472_length_1888_cov_17.106764	68	143	22	1	75	0.0133333
NODE_1472_length_1888_cov_17.106764	68	143	24	1	75	0.0133333
NODE_1472_length_1888_cov_17.106764	68	143	28	3	75	0.0400000
NODE_1472_length_1888_cov_17.106764	68	143	30	2	75	0.0266667
NODE_1472_length_1888_cov_17.106764	68	143	32	3	75	0.0400000
NODE_1472_length_1888_cov_17.106764	68	143	34	1	75	0.0133333
NODE_1472_length_1888_cov_17.106764	68	143	36	5	75	0.0666667
NODE_1472_length_1888_cov_17.106764	68	143	40	1	75	0.0133333
NODE_1472_length_1888_cov_17.106764	68	143	42	3	75	0.0400000
NODE_1472_length_1888_cov_17.106764	68	143	48	2	75	0.0266667
NODE_1472_length_1888_cov_17.106764	68	143	52	14	75	0.1866667
NODE_1472_length_1888_cov_17.106764	68	143	54	3	75	0.0400000
NODE_1472_length_1888_cov_17.106764	68	143	56	23	75	0.3066667
NODE_1477_length_1885_cov_4.439530	441	521	0	37	80	0.4625000
NODE_1477_length_1885_cov_4.439530	441	521	8	43	80	0.5375000
NODE_1477_length_1885_cov_4.439530	494	574	0	80	80	1.0000000
NODE_1483_length_1882_cov_5.884464	1499	1579	2	80	80	1.0000000
NODE_1483_length_1882_cov_5.884464	1552	1632	2	79	80	0.9875000
NODE_1483_length_1882_cov_5.884464	1552	1632	4	1	80	0.0125000
NODE_1493_length_1875_cov_3.974662	1650	1730	4	13	80	0.1625000
NODE_1493_length_1875_cov_3.974662	1650	1730	5	20	80	0.2500000
NODE_1493_length_1875_cov_3.974662	1650	1730	6	25	80	0.3125000
NODE_1493_length_1875_cov_3.974662	1650	1730	8	17	80	0.2125000
NODE_1493_length_1875_cov_3.974662	1650	1730	10	5	80	0.0625000
NODE_1497_length_1872_cov_21.355330	153	201	0	48	48	1.0000000
NODE_1503_length_1868_cov_96.046919	1018	1098	6	4	80	0.0500000
NODE_1503_length_1868_cov_96.046919	1018	1098	8	2	80	0.0250000
NODE_1503_length_1868_cov_96.046919	1018	1098	12	8	80	0.1000000
NODE_1503_length_1868_cov_96.046919	1018	1098	14	5	80	0.0625000
NODE_1503_length_1868_cov_96.046919	1018	1098	16	9	80	0.1125000
NODE_1503_length_1868_cov_96.046919	1018	1098	18	5	80	0.0625000
NODE_1503_length_1868_cov_96.046919	1018	1098	20	1	80	0.0125000
NODE_1503_length_1868_cov_96.046919	1018	1098	22	1	80	0.0125000
NODE_1503_length_1868_cov_96.046919	1018	1098	24	1	80	0.0125000
NODE_1503_length_1868_cov_96.046919	1018	1098	26	1	80	0.0125000
NODE_1503_length_1868_cov_96.046919	1018	1098	28	5	80	0.0625000
NODE_1503_length_1868_cov_96.046919	1018	1098	30	2	80	0.0250000
NODE_1503_length_1868_cov_96.046919	1018	1098	38	6	80	0.0750000
NODE_1503_length_1868_cov_96.046919	1018	1098	42	1	80	0.0125000
NODE_1503_length_1868_cov_96.046919	1018	1098	44	3	80	0.0375000
NODE_1503_length_1868_cov_96.046919	1018	1098	48	8	80	0.1000000
NODE_1503_length_1868_cov_96.046919	1018	1098	50	6	80	0.0750000
NODE_1503_length_1868_cov_96.046919	1018	1098	52	11	80	0.1375000
NODE_1503_length_1868_cov_96.046919	1018	1098	54	1	80	0.0125000
NODE_1503_length_1868_cov_96.046919	1071	1151	42	2	80	0.0250000
NODE_1503_length_1868_cov_96.046919	1071	1151	44	8	80	0.1000000
NODE_1503_length_1868_cov_96.046919	1071	1151	45	9	80	0.1125000
NODE_1503_length_1868_cov_96.046919	1071	1151	46	13	80	0.1625000
NODE_1503_length_1868_cov_96.046919	1071	1151	48	27	80	0.3375000
NODE_1503_length_1868_cov_96.046919	1071	1151	49	1	80	0.0125000
NODE_1503_length_1868_cov_96.046919	1071	1151	50	8	80	0.1000000
NODE_1503_length_1868_cov_96.046919	1071	1151	52	11	80	0.1375000
NODE_1503_length_1868_cov_96.046919	1071	1151	54	1	80	0.0125000
NODE_1508_length_1866_cov_53.869270	1149	1229	10	60	80	0.7500000
NODE_1508_length_1866_cov_53.869270	1149	1229	12	20	80	0.2500000
NODE_1508_length_1866_cov_53.869270	1202	1282	2	23	80	0.2875000
NODE_1508_length_1866_cov_53.869270	1202	1282	6	3	80	0.0375000
NODE_1508_length_1866_cov_53.869270	1202	1282	10	22	80	0.2750000
NODE_1508_length_1866_cov_53.869270	1202	1282	12	32	80	0.4000000
NODE_1508_length_1866_cov_53.869270	1278	1358	0	56	80	0.7000000
NODE_1508_length_1866_cov_53.869270	1278	1358	2	24	80	0.3000000
NODE_1508_length_1866_cov_53.869270	1331	1411	0	80	80	1.0000000
NODE_1510_length_1866_cov_3.347482	888	966	0	78	78	1.0000000
NODE_1510_length_1866_cov_3.347482	939	1019	0	80	80	1.0000000
NODE_1513_length_1863_cov_11.265306	698	778	0	80	80	1.0000000
NODE_1513_length_1863_cov_11.265306	751	831	0	80	80	1.0000000
NODE_1518_length_1858_cov_19.019329	23	85	0	62	62	1.0000000
NODE_1518_length_1858_cov_19.019329	1125	1205	0	80	80	1.0000000
NODE_1518_length_1858_cov_19.019329	1178	1256	0	63	78	0.8076923
NODE_1518_length_1858_cov_19.019329	1178	1256	2	15	78	0.1923077
NODE_1518_length_1858_cov_19.019329	1387	1464	12	8	77	0.1038961
NODE_1518_length_1858_cov_19.019329	1387	1464	14	35	77	0.4545455
NODE_1518_length_1858_cov_19.019329	1387	1464	15	4	77	0.0519481
NODE_1518_length_1858_cov_19.019329	1387	1464	16	3	77	0.0389610
NODE_1518_length_1858_cov_19.019329	1387	1464	17	18	77	0.2337662
NODE_1518_length_1858_cov_19.019329	1387	1464	18	9	77	0.1168831
NODE_1518_length_1858_cov_19.019329	1440	1503	15	12	63	0.1904762
NODE_1518_length_1858_cov_19.019329	1440	1503	16	30	63	0.4761905
NODE_1518_length_1858_cov_19.019329	1440	1503	17	12	63	0.1904762
NODE_1518_length_1858_cov_19.019329	1440	1503	18	9	63	0.1428571
NODE_1519_length_1857_cov_18.402730	1282	1348	0	19	66	0.2878788
NODE_1519_length_1857_cov_18.402730	1282	1348	2	47	66	0.7121212
NODE_1519_length_1857_cov_18.402730	1321	1401	0	72	80	0.9000000
NODE_1519_length_1857_cov_18.402730	1321	1401	2	8	80	0.1000000
NODE_1519_length_1857_cov_18.402730	1397	1477	0	80	80	1.0000000
NODE_1519_length_1857_cov_18.402730	1450	1530	0	72	80	0.9000000
NODE_1519_length_1857_cov_18.402730	1450	1530	2	8	80	0.1000000
NODE_1531_length_1845_cov_12.653494	473	553	2	29	80	0.3625000
NODE_1531_length_1845_cov_12.653494	473	553	4	32	80	0.4000000
NODE_1531_length_1845_cov_12.653494	473	553	6	19	80	0.2375000
NODE_1531_length_1845_cov_12.653494	526	606	0	18	80	0.2250000
NODE_1531_length_1845_cov_12.653494	526	606	2	62	80	0.7750000
NODE_1546_length_1833_cov_31.337947	810	888	2	10	78	0.1282051
NODE_1546_length_1833_cov_31.337947	810	888	4	42	78	0.5384616
NODE_1546_length_1833_cov_31.337947	810	888	6	26	78	0.3333333
NODE_1546_length_1833_cov_31.337947	861	941	4	53	80	0.6625000
NODE_1546_length_1833_cov_31.337947	861	941	6	27	80	0.3375000
NODE_1546_length_1833_cov_31.337947	937	1017	0	29	80	0.3625000
NODE_1546_length_1833_cov_31.337947	937	1017	2	46	80	0.5750000
NODE_1546_length_1833_cov_31.337947	937	1017	3	1	80	0.0125000
NODE_1546_length_1833_cov_31.337947	937	1017	4	4	80	0.0500000
NODE_1546_length_1833_cov_31.337947	990	1070	2	29	80	0.3625000
NODE_1546_length_1833_cov_31.337947	990	1070	4	24	80	0.3000000
NODE_1546_length_1833_cov_31.337947	990	1070	5	4	80	0.0500000
NODE_1546_length_1833_cov_31.337947	990	1070	6	23	80	0.2875000
NODE_1550_length_1831_cov_3.065820	112	154	2	4	42	0.0952381
NODE_1550_length_1831_cov_3.065820	112	154	4	3	42	0.0714286
NODE_1550_length_1831_cov_3.065820	112	154	6	1	42	0.0238095
NODE_1550_length_1831_cov_3.065820	112	154	8	4	42	0.0952381
NODE_1550_length_1831_cov_3.065820	112	154	10	1	42	0.0238095
NODE_1550_length_1831_cov_3.065820	112	154	16	2	42	0.0476190
NODE_1550_length_1831_cov_3.065820	112	154	20	2	42	0.0476190
NODE_1550_length_1831_cov_3.065820	112	154	22	1	42	0.0238095
NODE_1550_length_1831_cov_3.065820	112	154	26	1	42	0.0238095
NODE_1550_length_1831_cov_3.065820	112	154	32	4	42	0.0952381
NODE_1550_length_1831_cov_3.065820	112	154	36	1	42	0.0238095
NODE_1550_length_1831_cov_3.065820	112	154	38	6	42	0.1428571
NODE_1550_length_1831_cov_3.065820	112	154	44	2	42	0.0476190
NODE_1550_length_1831_cov_3.065820	112	154	46	2	42	0.0476190
NODE_1550_length_1831_cov_3.065820	112	154	48	1	42	0.0238095
NODE_1550_length_1831_cov_3.065820	112	154	50	3	42	0.0714286
NODE_1550_length_1831_cov_3.065820	112	154	58	3	42	0.0714286
NODE_1550_length_1831_cov_3.065820	112	154	60	1	42	0.0238095
NODE_1553_length_1830_cov_2.512998	123	203	0	80	80	1.0000000
NODE_1553_length_1830_cov_2.512998	176	256	0	80	80	1.0000000
NODE_1553_length_1830_cov_2.512998	308	357	0	19	49	0.3877551
NODE_1553_length_1830_cov_2.512998	308	357	4	18	49	0.3673469
NODE_1553_length_1830_cov_2.512998	308	357	6	11	49	0.2244898
NODE_1553_length_1830_cov_2.512998	308	357	7	1	49	0.0204082
NODE_1554_length_1828_cov_40.437825	789	869	0	80	80	1.0000000
NODE_1554_length_1828_cov_40.437825	842	922	0	80	80	1.0000000
NODE_1554_length_1828_cov_40.437825	918	998	0	10	80	0.1250000
NODE_1554_length_1828_cov_40.437825	918	998	2	57	80	0.7125000
NODE_1554_length_1828_cov_40.437825	918	998	3	2	80	0.0250000
NODE_1554_length_1828_cov_40.437825	918	998	4	3	80	0.0375000
NODE_1554_length_1828_cov_40.437825	918	998	8	5	80	0.0625000
NODE_1554_length_1828_cov_40.437825	918	998	10	3	80	0.0375000
NODE_1554_length_1828_cov_40.437825	971	1051	2	14	80	0.1750000
NODE_1554_length_1828_cov_40.437825	971	1051	3	2	80	0.0250000
NODE_1554_length_1828_cov_40.437825	971	1051	4	3	80	0.0375000
NODE_1554_length_1828_cov_40.437825	971	1051	8	32	80	0.4000000
NODE_1554_length_1828_cov_40.437825	971	1051	10	29	80	0.3625000
NODE_1559_length_1825_cov_6.652955	641	689	0	48	48	1.0000000
NODE_1559_length_1825_cov_6.652955	694	744	0	6	50	0.1200000
NODE_1559_length_1825_cov_6.652955	694	744	4	44	50	0.8800000
NODE_1562_length_1824_cov_10.152464	685	765	6	4	80	0.0500000
NODE_1562_length_1824_cov_10.152464	685	765	8	11	80	0.1375000
NODE_1562_length_1824_cov_10.152464	685	765	10	10	80	0.1250000
NODE_1562_length_1824_cov_10.152464	685	765	12	11	80	0.1375000
NODE_1562_length_1824_cov_10.152464	685	765	14	44	80	0.5500000
NODE_1562_length_1824_cov_10.152464	738	818	0	16	80	0.2000000
NODE_1562_length_1824_cov_10.152464	738	818	2	24	80	0.3000000
NODE_1562_length_1824_cov_10.152464	738	818	4	1	80	0.0125000
NODE_1562_length_1824_cov_10.152464	738	818	6	16	80	0.2000000
NODE_1562_length_1824_cov_10.152464	738	818	8	11	80	0.1375000
NODE_1562_length_1824_cov_10.152464	738	818	12	3	80	0.0375000
NODE_1562_length_1824_cov_10.152464	738	818	14	9	80	0.1125000
NODE_1562_length_1824_cov_10.152464	1412	1433	12	2	21	0.0952381
NODE_1562_length_1824_cov_10.152464	1412	1433	14	19	21	0.9047619
NODE_1564_length_1821_cov_7.682346	953	1033	0	80	80	1.0000000
NODE_1564_length_1821_cov_7.682346	1006	1086	0	80	80	1.0000000
NODE_1566_length_1820_cov_12.061592	477	557	0	8	80	0.1000000
NODE_1566_length_1820_cov_12.061592	477	557	4	35	80	0.4375000
NODE_1566_length_1820_cov_12.061592	477	557	6	37	80	0.4625000
NODE_1566_length_1820_cov_12.061592	530	610	2	7	80	0.0875000
NODE_1566_length_1820_cov_12.061592	530	610	6	73	80	0.9125000
NODE_1566_length_1820_cov_12.061592	1232	1312	0	80	80	1.0000000
NODE_1566_length_1820_cov_12.061592	1285	1365	0	80	80	1.0000000
NODE_1572_length_1817_cov_8.302095	63	122	0	33	59	0.5593221
NODE_1572_length_1817_cov_8.302095	63	122	2	20	59	0.3389831
NODE_1572_length_1817_cov_8.302095	63	122	4	6	59	0.1016949
NODE_1572_length_1817_cov_8.302095	1195	1275	0	13	80	0.1625000
NODE_1572_length_1817_cov_8.302095	1195	1275	2	67	80	0.8375000
NODE_1572_length_1817_cov_8.302095	1248	1328	0	33	80	0.4125000
NODE_1572_length_1817_cov_8.302095	1248	1328	2	47	80	0.5875000
NODE_1573_length_1816_cov_25.489225	1059	1139	0	62	80	0.7750000
NODE_1573_length_1816_cov_25.489225	1059	1139	2	18	80	0.2250000
NODE_1573_length_1816_cov_25.489225	1112	1192	0	80	80	1.0000000
NODE_1578_length_1812_cov_11.453006	398	427	1	29	29	1.0000000
NODE_1578_length_1812_cov_11.453006	400	480	1	80	80	1.0000000
NODE_1586_length_1807_cov_3.977752	1743	1807	0	64	64	1.0000000
NODE_1590_length_1806_cov_2.681312	1461	1541	0	6	80	0.0750000
NODE_1590_length_1806_cov_2.681312	1461	1541	4	1	80	0.0125000
NODE_1590_length_1806_cov_2.681312	1461	1541	11	3	80	0.0375000
NODE_1590_length_1806_cov_2.681312	1461	1541	12	1	80	0.0125000
NODE_1590_length_1806_cov_2.681312	1461	1541	13	1	80	0.0125000
NODE_1590_length_1806_cov_2.681312	1461	1541	15	4	80	0.0500000
NODE_1590_length_1806_cov_2.681312	1461	1541	17	2	80	0.0250000
NODE_1590_length_1806_cov_2.681312	1461	1541	21	1	80	0.0125000
NODE_1590_length_1806_cov_2.681312	1461	1541	23	2	80	0.0250000
NODE_1590_length_1806_cov_2.681312	1461	1541	25	8	80	0.1000000
NODE_1590_length_1806_cov_2.681312	1461	1541	27	10	80	0.1250000
NODE_1590_length_1806_cov_2.681312	1461	1541	31	15	80	0.1875000
NODE_1590_length_1806_cov_2.681312	1461	1541	34	2	80	0.0250000
NODE_1590_length_1806_cov_2.681312	1461	1541	42	1	80	0.0125000
NODE_1590_length_1806_cov_2.681312	1461	1541	48	3	80	0.0375000
NODE_1590_length_1806_cov_2.681312	1461	1541	50	1	80	0.0125000
NODE_1590_length_1806_cov_2.681312	1461	1541	54	3	80	0.0375000
NODE_1590_length_1806_cov_2.681312	1461	1541	56	11	80	0.1375000
NODE_1590_length_1806_cov_2.681312	1461	1541	57	1	80	0.0125000
NODE_1590_length_1806_cov_2.681312	1461	1541	58	1	80	0.0125000
NODE_1590_length_1806_cov_2.681312	1461	1541	60	1	80	0.0125000
NODE_1590_length_1806_cov_2.681312	1461	1541	69	1	80	0.0125000
NODE_1590_length_1806_cov_2.681312	1461	1541	72	1	80	0.0125000
NODE_1590_length_1806_cov_2.681312	1517	1594	0	59	77	0.7662337
NODE_1590_length_1806_cov_2.681312	1517	1594	4	1	77	0.0129870
NODE_1590_length_1806_cov_2.681312	1517	1594	11	3	77	0.0389610
NODE_1590_length_1806_cov_2.681312	1517	1594	12	1	77	0.0129870
NODE_1590_length_1806_cov_2.681312	1517	1594	13	1	77	0.0129870
NODE_1590_length_1806_cov_2.681312	1517	1594	15	4	77	0.0519481
NODE_1590_length_1806_cov_2.681312	1517	1594	17	2	77	0.0259740
NODE_1590_length_1806_cov_2.681312	1517	1594	21	1	77	0.0129870
NODE_1590_length_1806_cov_2.681312	1517	1594	23	2	77	0.0259740
NODE_1590_length_1806_cov_2.681312	1517	1594	25	3	77	0.0389610
NODE_1593_length_1805_cov_10.271395	258	329	1	17	71	0.2394366
NODE_1593_length_1805_cov_10.271395	258	329	2	5	71	0.0704225
NODE_1593_length_1805_cov_10.271395	258	329	3	12	71	0.1690141
NODE_1593_length_1805_cov_10.271395	258	329	5	37	71	0.5211267
NODE_1593_length_1805_cov_10.271395	311	391	4	11	80	0.1375000
NODE_1593_length_1805_cov_10.271395	311	391	5	50	80	0.6250000
NODE_1593_length_1805_cov_10.271395	311	391	6	19	80	0.2375000
NODE_1598_length_1802_cov_11.546682	1284	1364	0	80	80	1.0000000
NODE_1598_length_1802_cov_11.546682	1337	1417	0	80	80	1.0000000
NODE_1600_length_1801_cov_12.145711	85	165	14	1	80	0.0125000
NODE_1600_length_1801_cov_12.145711	85	165	16	3	80	0.0375000
NODE_1600_length_1801_cov_12.145711	85	165	18	7	80	0.0875000
NODE_1600_length_1801_cov_12.145711	85	165	20	4	80	0.0500000
NODE_1600_length_1801_cov_12.145711	85	165	26	4	80	0.0500000
NODE_1600_length_1801_cov_12.145711	85	165	28	8	80	0.1000000
NODE_1600_length_1801_cov_12.145711	85	165	30	2	80	0.0250000
NODE_1600_length_1801_cov_12.145711	85	165	32	5	80	0.0625000
NODE_1600_length_1801_cov_12.145711	85	165	36	2	80	0.0250000
NODE_1600_length_1801_cov_12.145711	85	165	40	2	80	0.0250000
NODE_1600_length_1801_cov_12.145711	85	165	42	14	80	0.1750000
NODE_1600_length_1801_cov_12.145711	85	165	44	28	80	0.3500000
NODE_1600_length_1801_cov_12.145711	138	218	14	4	80	0.0500000
NODE_1600_length_1801_cov_12.145711	138	218	18	6	80	0.0750000
NODE_1600_length_1801_cov_12.145711	138	218	22	4	80	0.0500000
NODE_1600_length_1801_cov_12.145711	138	218	24	1	80	0.0125000
NODE_1600_length_1801_cov_12.145711	138	218	26	2	80	0.0250000
NODE_1600_length_1801_cov_12.145711	138	218	28	3	80	0.0375000
NODE_1600_length_1801_cov_12.145711	138	218	30	7	80	0.0875000
NODE_1600_length_1801_cov_12.145711	138	218	32	3	80	0.0375000
NODE_1600_length_1801_cov_12.145711	138	218	34	6	80	0.0750000
NODE_1600_length_1801_cov_12.145711	138	218	36	3	80	0.0375000
NODE_1600_length_1801_cov_12.145711	138	218	38	1	80	0.0125000
NODE_1600_length_1801_cov_12.145711	138	218	40	3	80	0.0375000
NODE_1600_length_1801_cov_12.145711	138	218	42	2	80	0.0250000
NODE_1600_length_1801_cov_12.145711	138	218	44	35	80	0.4375000
NODE_1601_length_1801_cov_9.793184	1010	1090	2	11	80	0.1375000
NODE_1601_length_1801_cov_9.793184	1010	1090	6	11	80	0.1375000
NODE_1601_length_1801_cov_9.793184	1010	1090	8	58	80	0.7250000
NODE_1601_length_1801_cov_9.793184	1063	1143	0	36	80	0.4500000
NODE_1601_length_1801_cov_9.793184	1063	1143	1	13	80	0.1625000
NODE_1601_length_1801_cov_9.793184	1063	1143	2	15	80	0.1875000
NODE_1601_length_1801_cov_9.793184	1063	1143	6	11	80	0.1375000
NODE_1601_length_1801_cov_9.793184	1063	1143	8	5	80	0.0625000
NODE_1604_length_1800_cov_15.074662	695	775	0	80	80	1.0000000
NODE_1604_length_1800_cov_15.074662	755	826	0	71	71	1.0000000
NODE_1605_length_1800_cov_7.281599	10	74	49	2	64	0.0312500
NODE_1605_length_1800_cov_7.281599	10	74	58	4	64	0.0625000
NODE_1605_length_1800_cov_7.281599	10	74	66	8	64	0.1250000
NODE_1605_length_1800_cov_7.281599	10	74	68	1	64	0.0156250
NODE_1605_length_1800_cov_7.281599	10	74	72	1	64	0.0156250
NODE_1605_length_1800_cov_7.281599	10	74	74	1	64	0.0156250
NODE_1605_length_1800_cov_7.281599	10	74	76	2	64	0.0312500
NODE_1605_length_1800_cov_7.281599	10	74	82	1	64	0.0156250
NODE_1605_length_1800_cov_7.281599	10	74	96	5	64	0.0781250
NODE_1605_length_1800_cov_7.281599	10	74	98	21	64	0.3281250
NODE_1605_length_1800_cov_7.281599	10	74	100	1	64	0.0156250
NODE_1605_length_1800_cov_7.281599	10	74	101	6	64	0.0937500
NODE_1605_length_1800_cov_7.281599	10	74	103	2	64	0.0312500
NODE_1605_length_1800_cov_7.281599	10	74	107	8	64	0.1250000
NODE_1605_length_1800_cov_7.281599	10	74	109	1	64	0.0156250
NODE_1605_length_1800_cov_7.281599	10	74	49	2	64	0.0312500
NODE_1605_length_1800_cov_7.281599	10	74	58	4	64	0.0625000
NODE_1605_length_1800_cov_7.281599	10	74	66	8	64	0.1250000
NODE_1605_length_1800_cov_7.281599	10	74	68	1	64	0.0156250
NODE_1605_length_1800_cov_7.281599	10	74	72	1	64	0.0156250
NODE_1605_length_1800_cov_7.281599	10	74	74	1	64	0.0156250
NODE_1605_length_1800_cov_7.281599	10	74	76	2	64	0.0312500
NODE_1605_length_1800_cov_7.281599	10	74	82	1	64	0.0156250
NODE_1605_length_1800_cov_7.281599	10	74	96	5	64	0.0781250
NODE_1605_length_1800_cov_7.281599	10	74	98	21	64	0.3281250
NODE_1605_length_1800_cov_7.281599	10	74	100	1	64	0.0156250
NODE_1605_length_1800_cov_7.281599	10	74	101	6	64	0.0937500
NODE_1605_length_1800_cov_7.281599	10	74	103	2	64	0.0312500
NODE_1605_length_1800_cov_7.281599	10	74	107	8	64	0.1250000
NODE_1605_length_1800_cov_7.281599	10	74	109	1	64	0.0156250
NODE_1605_length_1800_cov_7.281599	10	74	49	2	64	0.0312500
NODE_1605_length_1800_cov_7.281599	10	74	58	4	64	0.0625000
NODE_1605_length_1800_cov_7.281599	10	74	66	8	64	0.1250000
NODE_1605_length_1800_cov_7.281599	10	74	68	1	64	0.0156250
NODE_1605_length_1800_cov_7.281599	10	74	72	1	64	0.0156250
NODE_1605_length_1800_cov_7.281599	10	74	74	1	64	0.0156250
NODE_1605_length_1800_cov_7.281599	10	74	76	2	64	0.0312500
NODE_1605_length_1800_cov_7.281599	10	74	82	1	64	0.0156250
NODE_1605_length_1800_cov_7.281599	10	74	96	5	64	0.0781250
NODE_1605_length_1800_cov_7.281599	10	74	98	21	64	0.3281250
NODE_1605_length_1800_cov_7.281599	10	74	100	1	64	0.0156250
NODE_1605_length_1800_cov_7.281599	10	74	101	6	64	0.0937500
NODE_1605_length_1800_cov_7.281599	10	74	103	2	64	0.0312500
NODE_1605_length_1800_cov_7.281599	10	74	107	8	64	0.1250000
NODE_1605_length_1800_cov_7.281599	10	74	109	1	64	0.0156250
NODE_1605_length_1800_cov_7.281599	47	127	98	9	80	0.1125000
NODE_1605_length_1800_cov_7.281599	47	127	100	1	80	0.0125000
NODE_1605_length_1800_cov_7.281599	47	127	101	6	80	0.0750000
NODE_1605_length_1800_cov_7.281599	47	127	103	2	80	0.0250000
NODE_1605_length_1800_cov_7.281599	47	127	107	8	80	0.1000000
NODE_1605_length_1800_cov_7.281599	47	127	109	3	80	0.0375000
NODE_1605_length_1800_cov_7.281599	47	127	110	2	80	0.0250000
NODE_1605_length_1800_cov_7.281599	47	127	111	1	80	0.0125000
NODE_1605_length_1800_cov_7.281599	47	127	115	1	80	0.0125000
NODE_1605_length_1800_cov_7.281599	47	127	116	1	80	0.0125000
NODE_1605_length_1800_cov_7.281599	47	127	117	3	80	0.0375000
NODE_1605_length_1800_cov_7.281599	47	127	118	1	80	0.0125000
NODE_1605_length_1800_cov_7.281599	47	127	119	3	80	0.0375000
NODE_1605_length_1800_cov_7.281599	47	127	121	5	80	0.0625000
NODE_1605_length_1800_cov_7.281599	47	127	123	3	80	0.0375000
NODE_1605_length_1800_cov_7.281599	47	127	124	4	80	0.0500000
NODE_1605_length_1800_cov_7.281599	47	127	125	4	80	0.0500000
NODE_1605_length_1800_cov_7.281599	47	127	129	7	80	0.0875000
NODE_1605_length_1800_cov_7.281599	47	127	130	1	80	0.0125000
NODE_1605_length_1800_cov_7.281599	47	127	132	15	80	0.1875000
NODE_1605_length_1800_cov_7.281599	63	126	103	2	63	0.0317460
NODE_1605_length_1800_cov_7.281599	63	126	107	8	63	0.1269841
NODE_1605_length_1800_cov_7.281599	63	126	109	3	63	0.0476190
NODE_1605_length_1800_cov_7.281599	63	126	110	2	63	0.0317460
NODE_1605_length_1800_cov_7.281599	63	126	115	1	63	0.0158730
NODE_1605_length_1800_cov_7.281599	63	126	116	1	63	0.0158730
NODE_1605_length_1800_cov_7.281599	63	126	117	3	63	0.0476190
NODE_1605_length_1800_cov_7.281599	63	126	118	1	63	0.0158730
NODE_1605_length_1800_cov_7.281599	63	126	119	3	63	0.0476190
NODE_1605_length_1800_cov_7.281599	63	126	121	5	63	0.0793651
NODE_1605_length_1800_cov_7.281599	63	126	123	3	63	0.0476190
NODE_1605_length_1800_cov_7.281599	63	126	124	4	63	0.0634921
NODE_1605_length_1800_cov_7.281599	63	126	125	4	63	0.0634921
NODE_1605_length_1800_cov_7.281599	63	126	129	7	63	0.1111111
NODE_1605_length_1800_cov_7.281599	63	126	130	1	63	0.0158730
NODE_1605_length_1800_cov_7.281599	63	126	132	15	63	0.2380952
NODE_1616_length_1793_cov_16.161157	539	619	0	69	80	0.8625000
NODE_1616_length_1793_cov_16.161157	539	619	2	11	80	0.1375000
NODE_1616_length_1793_cov_16.161157	592	672	0	16	80	0.2000000
NODE_1616_length_1793_cov_16.161157	592	672	2	64	80	0.8000000
NODE_1616_length_1793_cov_16.161157	1202	1281	2	10	79	0.1265823
NODE_1616_length_1793_cov_16.161157	1202	1281	4	31	79	0.3924051
NODE_1616_length_1793_cov_16.161157	1202	1281	6	24	79	0.3037975
NODE_1616_length_1793_cov_16.161157	1202	1281	7	14	79	0.1772152
NODE_1616_length_1793_cov_16.161157	1254	1335	5	1	81	0.0123457
NODE_1616_length_1793_cov_16.161157	1254	1335	6	34	81	0.4197531
NODE_1616_length_1793_cov_16.161157	1254	1335	7	46	81	0.5679013
NODE_1617_length_1793_cov_14.322904	521	601	0	2	80	0.0250000
NODE_1617_length_1793_cov_14.322904	521	601	2	5	80	0.0625000
NODE_1617_length_1793_cov_14.322904	521	601	4	73	80	0.9125000
NODE_1617_length_1793_cov_14.322904	574	654	0	55	80	0.6875000
NODE_1617_length_1793_cov_14.322904	574	654	2	5	80	0.0625000
NODE_1617_length_1793_cov_14.322904	574	654	4	20	80	0.2500000
NODE_1617_length_1793_cov_14.322904	1230	1310	2	62	80	0.7750000
NODE_1617_length_1793_cov_14.322904	1230	1310	4	18	80	0.2250000
NODE_1618_length_1791_cov_5.516548	1190	1261	0	71	71	1.0000000
NODE_1621_length_1790_cov_4.282082	684	764	0	80	80	1.0000000
NODE_1621_length_1790_cov_4.282082	737	817	0	80	80	1.0000000
NODE_1623_length_1788_cov_39.558911	385	465	1	80	80	1.0000000
NODE_1623_length_1788_cov_39.558911	438	518	1	80	80	1.0000000
NODE_1623_length_1788_cov_39.558911	514	594	0	60	80	0.7500000
NODE_1623_length_1788_cov_39.558911	514	594	1	20	80	0.2500000
NODE_1623_length_1788_cov_39.558911	567	647	0	24	80	0.3000000
NODE_1623_length_1788_cov_39.558911	567	647	1	56	80	0.7000000
NODE_1624_length_1787_cov_44.927133	530	610	8	1	80	0.0125000
NODE_1624_length_1787_cov_44.927133	530	610	10	35	80	0.4375000
NODE_1624_length_1787_cov_44.927133	530	610	12	3	80	0.0375000
NODE_1624_length_1787_cov_44.927133	530	610	14	1	80	0.0125000
NODE_1624_length_1787_cov_44.927133	530	610	16	2	80	0.0250000
NODE_1624_length_1787_cov_44.927133	530	610	22	12	80	0.1500000
NODE_1624_length_1787_cov_44.927133	530	610	24	3	80	0.0375000
NODE_1624_length_1787_cov_44.927133	530	610	26	5	80	0.0625000
NODE_1624_length_1787_cov_44.927133	530	610	28	10	80	0.1250000
NODE_1624_length_1787_cov_44.927133	530	610	30	4	80	0.0500000
NODE_1624_length_1787_cov_44.927133	530	610	34	4	80	0.0500000
NODE_1625_length_1787_cov_2.752370	675	755	0	80	80	1.0000000
NODE_1625_length_1787_cov_2.752370	728	806	0	54	78	0.6923077
NODE_1625_length_1787_cov_2.752370	728	806	1	24	78	0.3076923
NODE_1626_length_1786_cov_13.459395	523	603	2	12	80	0.1500000
NODE_1626_length_1786_cov_13.459395	523	603	4	52	80	0.6500000
NODE_1626_length_1786_cov_13.459395	523	603	6	16	80	0.2000000
NODE_1626_length_1786_cov_13.459395	576	656	2	26	80	0.3250000
NODE_1626_length_1786_cov_13.459395	576	656	4	22	80	0.2750000
NODE_1626_length_1786_cov_13.459395	576	656	6	32	80	0.4000000
NODE_1633_length_1784_cov_40.769733	358	438	2	80	80	1.0000000
NODE_1633_length_1784_cov_40.769733	411	491	0	4	80	0.0500000
NODE_1633_length_1784_cov_40.769733	411	491	2	76	80	0.9500000
NODE_1633_length_1784_cov_40.769733	1057	1137	6	12	80	0.1500000
NODE_1633_length_1784_cov_40.769733	1057	1137	8	23	80	0.2875000
NODE_1633_length_1784_cov_40.769733	1057	1137	10	45	80	0.5625000
NODE_1633_length_1784_cov_40.769733	1110	1190	0	26	80	0.3250000
NODE_1633_length_1784_cov_40.769733	1110	1190	2	24	80	0.3000000
NODE_1633_length_1784_cov_40.769733	1110	1190	6	7	80	0.0875000
NODE_1633_length_1784_cov_40.769733	1110	1190	8	23	80	0.2875000
NODE_1633_length_1784_cov_40.769733	1186	1266	0	22	80	0.2750000
NODE_1633_length_1784_cov_40.769733	1186	1266	2	15	80	0.1875000
NODE_1633_length_1784_cov_40.769733	1186	1266	8	43	80	0.5375000
NODE_1633_length_1784_cov_40.769733	1239	1319	6	13	80	0.1625000
NODE_1633_length_1784_cov_40.769733	1239	1319	8	67	80	0.8375000
NODE_1634_length_1784_cov_6.049258	1646	1725	0	79	79	1.0000000
NODE_1637_length_1783_cov_45.569477	600	680	0	80	80	1.0000000
NODE_1637_length_1783_cov_45.569477	653	733	0	80	80	1.0000000
NODE_1640_length_1780_cov_21.089233	361	441	0	21	80	0.2625000
NODE_1640_length_1780_cov_21.089233	361	441	2	59	80	0.7375000
NODE_1640_length_1780_cov_21.089233	414	494	0	34	80	0.4250000
NODE_1640_length_1780_cov_21.089233	414	494	2	46	80	0.5750000
NODE_1640_length_1780_cov_21.089233	1031	1104	6	8	73	0.1095890
NODE_1640_length_1780_cov_21.089233	1031	1104	8	10	73	0.1369863
NODE_1640_length_1780_cov_21.089233	1031	1104	10	5	73	0.0684932
NODE_1640_length_1780_cov_21.089233	1031	1104	12	6	73	0.0821918
NODE_1640_length_1780_cov_21.089233	1031	1104	16	5	73	0.0684932
NODE_1640_length_1780_cov_21.089233	1031	1104	18	2	73	0.0273973
NODE_1640_length_1780_cov_21.089233	1031	1104	20	3	73	0.0410959
NODE_1640_length_1780_cov_21.089233	1031	1104	24	2	73	0.0273973
NODE_1640_length_1780_cov_21.089233	1031	1104	28	2	73	0.0273973
NODE_1640_length_1780_cov_21.089233	1031	1104	32	2	73	0.0273973
NODE_1640_length_1780_cov_21.089233	1031	1104	34	1	73	0.0136986
NODE_1640_length_1780_cov_21.089233	1031	1104	36	1	73	0.0136986
NODE_1640_length_1780_cov_21.089233	1031	1104	37	6	73	0.0821918
NODE_1640_length_1780_cov_21.089233	1031	1104	41	3	73	0.0410959
NODE_1640_length_1780_cov_21.089233	1031	1104	43	5	73	0.0684932
NODE_1640_length_1780_cov_21.089233	1031	1104	45	1	73	0.0136986
NODE_1640_length_1780_cov_21.089233	1031	1104	46	4	73	0.0547945
NODE_1640_length_1780_cov_21.089233	1031	1104	48	2	73	0.0273973
NODE_1640_length_1780_cov_21.089233	1031	1104	50	1	73	0.0136986
NODE_1640_length_1780_cov_21.089233	1031	1104	52	2	73	0.0273973
NODE_1640_length_1780_cov_21.089233	1031	1104	54	2	73	0.0273973
NODE_1640_length_1780_cov_21.089233	1071	1112	24	1	41	0.0243902
NODE_1640_length_1780_cov_21.089233	1071	1112	28	2	41	0.0487805
NODE_1640_length_1780_cov_21.089233	1071	1112	32	2	41	0.0487805
NODE_1640_length_1780_cov_21.089233	1071	1112	34	1	41	0.0243902
NODE_1640_length_1780_cov_21.089233	1071	1112	36	1	41	0.0243902
NODE_1640_length_1780_cov_21.089233	1071	1112	37	6	41	0.1463415
NODE_1640_length_1780_cov_21.089233	1071	1112	41	3	41	0.0731707
NODE_1640_length_1780_cov_21.089233	1071	1112	43	5	41	0.1219512
NODE_1640_length_1780_cov_21.089233	1071	1112	45	1	41	0.0243902
NODE_1640_length_1780_cov_21.089233	1071	1112	46	4	41	0.0975610
NODE_1640_length_1780_cov_21.089233	1071	1112	48	2	41	0.0487805
NODE_1640_length_1780_cov_21.089233	1071	1112	50	1	41	0.0243902
NODE_1640_length_1780_cov_21.089233	1071	1112	52	2	41	0.0487805
NODE_1640_length_1780_cov_21.089233	1071	1112	54	6	41	0.1463415
NODE_1640_length_1780_cov_21.089233	1071	1112	56	1	41	0.0243902
NODE_1640_length_1780_cov_21.089233	1071	1112	58	2	41	0.0487805
NODE_1640_length_1780_cov_21.089233	1071	1112	59	1	41	0.0243902
NODE_1641_length_1780_cov_7.837597	1682	1747	2	65	65	1.0000000
NODE_1649_length_1778_cov_52.804050	1528	1568	0	3	40	0.0750000
NODE_1649_length_1778_cov_52.804050	1528	1568	2	2	40	0.0500000
NODE_1649_length_1778_cov_52.804050	1528	1568	4	4	40	0.1000000
NODE_1649_length_1778_cov_52.804050	1528	1568	6	1	40	0.0250000
NODE_1649_length_1778_cov_52.804050	1528	1568	8	1	40	0.0250000
NODE_1649_length_1778_cov_52.804050	1528	1568	10	2	40	0.0500000
NODE_1649_length_1778_cov_52.804050	1528	1568	12	1	40	0.0250000
NODE_1649_length_1778_cov_52.804050	1528	1568	16	1	40	0.0250000
NODE_1649_length_1778_cov_52.804050	1528	1568	17	1	40	0.0250000
NODE_1649_length_1778_cov_52.804050	1528	1568	19	1	40	0.0250000
NODE_1649_length_1778_cov_52.804050	1528	1568	20	3	40	0.0750000
NODE_1649_length_1778_cov_52.804050	1528	1568	24	2	40	0.0500000
NODE_1649_length_1778_cov_52.804050	1528	1568	26	1	40	0.0250000
NODE_1649_length_1778_cov_52.804050	1528	1568	29	1	40	0.0250000
NODE_1649_length_1778_cov_52.804050	1528	1568	33	5	40	0.1250000
NODE_1649_length_1778_cov_52.804050	1528	1568	35	10	40	0.2500000
NODE_1649_length_1778_cov_52.804050	1528	1568	36	1	40	0.0250000
NODE_1649_length_1778_cov_52.804050	1541	1621	12	1	80	0.0125000
NODE_1649_length_1778_cov_52.804050	1541	1621	16	1	80	0.0125000
NODE_1649_length_1778_cov_52.804050	1541	1621	17	1	80	0.0125000
NODE_1649_length_1778_cov_52.804050	1541	1621	19	1	80	0.0125000
NODE_1649_length_1778_cov_52.804050	1541	1621	20	3	80	0.0375000
NODE_1649_length_1778_cov_52.804050	1541	1621	24	2	80	0.0250000
NODE_1649_length_1778_cov_52.804050	1541	1621	26	1	80	0.0125000
NODE_1649_length_1778_cov_52.804050	1541	1621	29	1	80	0.0125000
NODE_1649_length_1778_cov_52.804050	1541	1621	33	5	80	0.0625000
NODE_1649_length_1778_cov_52.804050	1541	1621	35	10	80	0.1250000
NODE_1649_length_1778_cov_52.804050	1541	1621	36	14	80	0.1750000
NODE_1649_length_1778_cov_52.804050	1541	1621	38	5	80	0.0625000
NODE_1649_length_1778_cov_52.804050	1541	1621	40	29	80	0.3625000
NODE_1649_length_1778_cov_52.804050	1541	1621	42	6	80	0.0750000
NODE_1649_length_1778_cov_52.804050	1541	1621	12	1	80	0.0125000
NODE_1649_length_1778_cov_52.804050	1541	1621	16	1	80	0.0125000
NODE_1649_length_1778_cov_52.804050	1541	1621	17	1	80	0.0125000
NODE_1649_length_1778_cov_52.804050	1541	1621	19	1	80	0.0125000
NODE_1649_length_1778_cov_52.804050	1541	1621	20	3	80	0.0375000
NODE_1649_length_1778_cov_52.804050	1541	1621	24	2	80	0.0250000
NODE_1649_length_1778_cov_52.804050	1541	1621	26	1	80	0.0125000
NODE_1649_length_1778_cov_52.804050	1541	1621	29	1	80	0.0125000
NODE_1649_length_1778_cov_52.804050	1541	1621	33	5	80	0.0625000
NODE_1649_length_1778_cov_52.804050	1541	1621	35	10	80	0.1250000
NODE_1649_length_1778_cov_52.804050	1541	1621	36	14	80	0.1750000
NODE_1649_length_1778_cov_52.804050	1541	1621	38	5	80	0.0625000
NODE_1649_length_1778_cov_52.804050	1541	1621	40	29	80	0.3625000
NODE_1649_length_1778_cov_52.804050	1541	1621	42	6	80	0.0750000
NODE_1649_length_1778_cov_52.804050	1541	1621	12	1	80	0.0125000
NODE_1649_length_1778_cov_52.804050	1541	1621	16	1	80	0.0125000
NODE_1649_length_1778_cov_52.804050	1541	1621	17	1	80	0.0125000
NODE_1649_length_1778_cov_52.804050	1541	1621	19	1	80	0.0125000
NODE_1649_length_1778_cov_52.804050	1541	1621	20	3	80	0.0375000
NODE_1649_length_1778_cov_52.804050	1541	1621	24	2	80	0.0250000
NODE_1649_length_1778_cov_52.804050	1541	1621	26	1	80	0.0125000
NODE_1649_length_1778_cov_52.804050	1541	1621	29	1	80	0.0125000
NODE_1649_length_1778_cov_52.804050	1541	1621	33	5	80	0.0625000
NODE_1649_length_1778_cov_52.804050	1541	1621	35	10	80	0.1250000
NODE_1649_length_1778_cov_52.804050	1541	1621	36	14	80	0.1750000
NODE_1649_length_1778_cov_52.804050	1541	1621	38	5	80	0.0625000
NODE_1649_length_1778_cov_52.804050	1541	1621	40	29	80	0.3625000
NODE_1649_length_1778_cov_52.804050	1541	1621	42	6	80	0.0750000
NODE_1649_length_1778_cov_52.804050	1541	1621	12	1	80	0.0125000
NODE_1649_length_1778_cov_52.804050	1541	1621	16	1	80	0.0125000
NODE_1649_length_1778_cov_52.804050	1541	1621	17	1	80	0.0125000
NODE_1649_length_1778_cov_52.804050	1541	1621	19	1	80	0.0125000
NODE_1649_length_1778_cov_52.804050	1541	1621	20	3	80	0.0375000
NODE_1649_length_1778_cov_52.804050	1541	1621	24	2	80	0.0250000
NODE_1649_length_1778_cov_52.804050	1541	1621	26	1	80	0.0125000
NODE_1649_length_1778_cov_52.804050	1541	1621	29	1	80	0.0125000
NODE_1649_length_1778_cov_52.804050	1541	1621	33	5	80	0.0625000
NODE_1649_length_1778_cov_52.804050	1541	1621	35	10	80	0.1250000
NODE_1649_length_1778_cov_52.804050	1541	1621	36	14	80	0.1750000
NODE_1649_length_1778_cov_52.804050	1541	1621	38	5	80	0.0625000
NODE_1649_length_1778_cov_52.804050	1541	1621	40	29	80	0.3625000
NODE_1649_length_1778_cov_52.804050	1541	1621	42	6	80	0.0750000
NODE_1649_length_1778_cov_52.804050	1541	1621	12	1	80	0.0125000
NODE_1649_length_1778_cov_52.804050	1541	1621	16	1	80	0.0125000
NODE_1649_length_1778_cov_52.804050	1541	1621	17	1	80	0.0125000
NODE_1649_length_1778_cov_52.804050	1541	1621	19	1	80	0.0125000
NODE_1649_length_1778_cov_52.804050	1541	1621	20	3	80	0.0375000
NODE_1649_length_1778_cov_52.804050	1541	1621	24	2	80	0.0250000
NODE_1649_length_1778_cov_52.804050	1541	1621	26	1	80	0.0125000
NODE_1649_length_1778_cov_52.804050	1541	1621	29	1	80	0.0125000
NODE_1649_length_1778_cov_52.804050	1541	1621	33	5	80	0.0625000
NODE_1649_length_1778_cov_52.804050	1541	1621	35	10	80	0.1250000
NODE_1649_length_1778_cov_52.804050	1541	1621	36	14	80	0.1750000
NODE_1649_length_1778_cov_52.804050	1541	1621	38	5	80	0.0625000
NODE_1649_length_1778_cov_52.804050	1541	1621	40	29	80	0.3625000
NODE_1649_length_1778_cov_52.804050	1541	1621	42	6	80	0.0750000
NODE_1649_length_1778_cov_52.804050	1541	1621	12	1	80	0.0125000
NODE_1649_length_1778_cov_52.804050	1541	1621	16	1	80	0.0125000
NODE_1649_length_1778_cov_52.804050	1541	1621	17	1	80	0.0125000
NODE_1649_length_1778_cov_52.804050	1541	1621	19	1	80	0.0125000
NODE_1649_length_1778_cov_52.804050	1541	1621	20	3	80	0.0375000
NODE_1649_length_1778_cov_52.804050	1541	1621	24	2	80	0.0250000
NODE_1649_length_1778_cov_52.804050	1541	1621	26	1	80	0.0125000
NODE_1649_length_1778_cov_52.804050	1541	1621	29	1	80	0.0125000
NODE_1649_length_1778_cov_52.804050	1541	1621	33	5	80	0.0625000
NODE_1649_length_1778_cov_52.804050	1541	1621	35	10	80	0.1250000
NODE_1649_length_1778_cov_52.804050	1541	1621	36	14	80	0.1750000
NODE_1649_length_1778_cov_52.804050	1541	1621	38	5	80	0.0625000
NODE_1649_length_1778_cov_52.804050	1541	1621	40	29	80	0.3625000
NODE_1649_length_1778_cov_52.804050	1541	1621	42	6	80	0.0750000
NODE_1649_length_1778_cov_52.804050	1617	1697	42	4	80	0.0500000
NODE_1649_length_1778_cov_52.804050	1617	1697	44	3	80	0.0375000
NODE_1649_length_1778_cov_52.804050	1617	1697	46	4	80	0.0500000
NODE_1649_length_1778_cov_52.804050	1617	1697	50	8	80	0.1000000
NODE_1649_length_1778_cov_52.804050	1617	1697	52	1	80	0.0125000
NODE_1649_length_1778_cov_52.804050	1617	1697	54	11	80	0.1375000
NODE_1649_length_1778_cov_52.804050	1617	1697	56	1	80	0.0125000
NODE_1649_length_1778_cov_52.804050	1617	1697	58	3	80	0.0375000
NODE_1649_length_1778_cov_52.804050	1617	1697	60	4	80	0.0500000
NODE_1649_length_1778_cov_52.804050	1617	1697	62	1	80	0.0125000
NODE_1649_length_1778_cov_52.804050	1617	1697	64	4	80	0.0500000
NODE_1649_length_1778_cov_52.804050	1617	1697	68	2	80	0.0250000
NODE_1649_length_1778_cov_52.804050	1617	1697	70	13	80	0.1625000
NODE_1649_length_1778_cov_52.804050	1617	1697	72	5	80	0.0625000
NODE_1649_length_1778_cov_52.804050	1617	1697	73	1	80	0.0125000
NODE_1649_length_1778_cov_52.804050	1617	1697	74	13	80	0.1625000
NODE_1649_length_1778_cov_52.804050	1617	1697	76	2	80	0.0250000
NODE_1649_length_1778_cov_52.804050	1617	1697	42	4	80	0.0500000
NODE_1649_length_1778_cov_52.804050	1617	1697	44	3	80	0.0375000
NODE_1649_length_1778_cov_52.804050	1617	1697	46	4	80	0.0500000
NODE_1649_length_1778_cov_52.804050	1617	1697	50	8	80	0.1000000
NODE_1649_length_1778_cov_52.804050	1617	1697	52	1	80	0.0125000
NODE_1649_length_1778_cov_52.804050	1617	1697	54	11	80	0.1375000
NODE_1649_length_1778_cov_52.804050	1617	1697	56	1	80	0.0125000
NODE_1649_length_1778_cov_52.804050	1617	1697	58	3	80	0.0375000
NODE_1649_length_1778_cov_52.804050	1617	1697	60	4	80	0.0500000
NODE_1649_length_1778_cov_52.804050	1617	1697	62	1	80	0.0125000
NODE_1649_length_1778_cov_52.804050	1617	1697	64	4	80	0.0500000
NODE_1649_length_1778_cov_52.804050	1617	1697	68	2	80	0.0250000
NODE_1649_length_1778_cov_52.804050	1617	1697	70	13	80	0.1625000
NODE_1649_length_1778_cov_52.804050	1617	1697	72	5	80	0.0625000
NODE_1649_length_1778_cov_52.804050	1617	1697	73	1	80	0.0125000
NODE_1649_length_1778_cov_52.804050	1617	1697	74	13	80	0.1625000
NODE_1649_length_1778_cov_52.804050	1617	1697	76	2	80	0.0250000
NODE_1649_length_1778_cov_52.804050	1617	1697	42	4	80	0.0500000
NODE_1649_length_1778_cov_52.804050	1617	1697	44	3	80	0.0375000
NODE_1649_length_1778_cov_52.804050	1617	1697	46	4	80	0.0500000
NODE_1649_length_1778_cov_52.804050	1617	1697	50	8	80	0.1000000
NODE_1649_length_1778_cov_52.804050	1617	1697	52	1	80	0.0125000
NODE_1649_length_1778_cov_52.804050	1617	1697	54	11	80	0.1375000
NODE_1649_length_1778_cov_52.804050	1617	1697	56	1	80	0.0125000
NODE_1649_length_1778_cov_52.804050	1617	1697	58	3	80	0.0375000
NODE_1649_length_1778_cov_52.804050	1617	1697	60	4	80	0.0500000
NODE_1649_length_1778_cov_52.804050	1617	1697	62	1	80	0.0125000
NODE_1649_length_1778_cov_52.804050	1617	1697	64	4	80	0.0500000
NODE_1649_length_1778_cov_52.804050	1617	1697	68	2	80	0.0250000
NODE_1649_length_1778_cov_52.804050	1617	1697	70	13	80	0.1625000
NODE_1649_length_1778_cov_52.804050	1617	1697	72	5	80	0.0625000
NODE_1649_length_1778_cov_52.804050	1617	1697	73	1	80	0.0125000
NODE_1649_length_1778_cov_52.804050	1617	1697	74	13	80	0.1625000
NODE_1649_length_1778_cov_52.804050	1617	1697	76	2	80	0.0250000
NODE_1649_length_1778_cov_52.804050	1617	1697	42	4	80	0.0500000
NODE_1649_length_1778_cov_52.804050	1617	1697	44	3	80	0.0375000
NODE_1649_length_1778_cov_52.804050	1617	1697	46	4	80	0.0500000
NODE_1649_length_1778_cov_52.804050	1617	1697	50	8	80	0.1000000
NODE_1649_length_1778_cov_52.804050	1617	1697	52	1	80	0.0125000
NODE_1649_length_1778_cov_52.804050	1617	1697	54	11	80	0.1375000
NODE_1649_length_1778_cov_52.804050	1617	1697	56	1	80	0.0125000
NODE_1649_length_1778_cov_52.804050	1617	1697	58	3	80	0.0375000
NODE_1649_length_1778_cov_52.804050	1617	1697	60	4	80	0.0500000
NODE_1649_length_1778_cov_52.804050	1617	1697	62	1	80	0.0125000
NODE_1649_length_1778_cov_52.804050	1617	1697	64	4	80	0.0500000
NODE_1649_length_1778_cov_52.804050	1617	1697	68	2	80	0.0250000
NODE_1649_length_1778_cov_52.804050	1617	1697	70	13	80	0.1625000
NODE_1649_length_1778_cov_52.804050	1617	1697	72	5	80	0.0625000
NODE_1649_length_1778_cov_52.804050	1617	1697	73	1	80	0.0125000
NODE_1649_length_1778_cov_52.804050	1617	1697	74	13	80	0.1625000
NODE_1649_length_1778_cov_52.804050	1617	1697	76	2	80	0.0250000
NODE_1649_length_1778_cov_52.804050	1670	1750	16	3	80	0.0375000
NODE_1649_length_1778_cov_52.804050	1670	1750	22	1	80	0.0125000
NODE_1649_length_1778_cov_52.804050	1670	1750	24	4	80	0.0500000
NODE_1649_length_1778_cov_52.804050	1670	1750	26	1	80	0.0125000
NODE_1649_length_1778_cov_52.804050	1670	1750	32	1	80	0.0125000
NODE_1649_length_1778_cov_52.804050	1670	1750	40	3	80	0.0375000
NODE_1649_length_1778_cov_52.804050	1670	1750	42	11	80	0.1375000
NODE_1649_length_1778_cov_52.804050	1670	1750	44	9	80	0.1125000
NODE_1649_length_1778_cov_52.804050	1670	1750	45	11	80	0.1375000
NODE_1649_length_1778_cov_52.804050	1670	1750	47	2	80	0.0250000
NODE_1649_length_1778_cov_52.804050	1670	1750	49	3	80	0.0375000
NODE_1649_length_1778_cov_52.804050	1670	1750	50	12	80	0.1500000
NODE_1649_length_1778_cov_52.804050	1670	1750	52	1	80	0.0125000
NODE_1649_length_1778_cov_52.804050	1670	1750	54	10	80	0.1250000
NODE_1649_length_1778_cov_52.804050	1670	1750	56	1	80	0.0125000
NODE_1649_length_1778_cov_52.804050	1670	1750	58	3	80	0.0375000
NODE_1649_length_1778_cov_52.804050	1670	1750	60	3	80	0.0375000
NODE_1649_length_1778_cov_52.804050	1670	1750	64	1	80	0.0125000
NODE_1649_length_1778_cov_52.804050	1670	1750	16	3	80	0.0375000
NODE_1649_length_1778_cov_52.804050	1670	1750	22	1	80	0.0125000
NODE_1649_length_1778_cov_52.804050	1670	1750	24	4	80	0.0500000
NODE_1649_length_1778_cov_52.804050	1670	1750	26	1	80	0.0125000
NODE_1649_length_1778_cov_52.804050	1670	1750	32	1	80	0.0125000
NODE_1649_length_1778_cov_52.804050	1670	1750	40	3	80	0.0375000
NODE_1649_length_1778_cov_52.804050	1670	1750	42	11	80	0.1375000
NODE_1649_length_1778_cov_52.804050	1670	1750	44	9	80	0.1125000
NODE_1649_length_1778_cov_52.804050	1670	1750	45	11	80	0.1375000
NODE_1649_length_1778_cov_52.804050	1670	1750	47	2	80	0.0250000
NODE_1649_length_1778_cov_52.804050	1670	1750	49	3	80	0.0375000
NODE_1649_length_1778_cov_52.804050	1670	1750	50	12	80	0.1500000
NODE_1649_length_1778_cov_52.804050	1670	1750	52	1	80	0.0125000
NODE_1649_length_1778_cov_52.804050	1670	1750	54	10	80	0.1250000
NODE_1649_length_1778_cov_52.804050	1670	1750	56	1	80	0.0125000
NODE_1649_length_1778_cov_52.804050	1670	1750	58	3	80	0.0375000
NODE_1649_length_1778_cov_52.804050	1670	1750	60	3	80	0.0375000
NODE_1649_length_1778_cov_52.804050	1670	1750	64	1	80	0.0125000
NODE_1649_length_1778_cov_52.804050	1670	1750	16	3	80	0.0375000
NODE_1649_length_1778_cov_52.804050	1670	1750	22	1	80	0.0125000
NODE_1649_length_1778_cov_52.804050	1670	1750	24	4	80	0.0500000
NODE_1649_length_1778_cov_52.804050	1670	1750	26	1	80	0.0125000
NODE_1649_length_1778_cov_52.804050	1670	1750	32	1	80	0.0125000
NODE_1649_length_1778_cov_52.804050	1670	1750	40	3	80	0.0375000
NODE_1649_length_1778_cov_52.804050	1670	1750	42	11	80	0.1375000
NODE_1649_length_1778_cov_52.804050	1670	1750	44	9	80	0.1125000
NODE_1649_length_1778_cov_52.804050	1670	1750	45	11	80	0.1375000
NODE_1649_length_1778_cov_52.804050	1670	1750	47	2	80	0.0250000
NODE_1649_length_1778_cov_52.804050	1670	1750	49	3	80	0.0375000
NODE_1649_length_1778_cov_52.804050	1670	1750	50	12	80	0.1500000
NODE_1649_length_1778_cov_52.804050	1670	1750	52	1	80	0.0125000
NODE_1649_length_1778_cov_52.804050	1670	1750	54	10	80	0.1250000
NODE_1649_length_1778_cov_52.804050	1670	1750	56	1	80	0.0125000
NODE_1649_length_1778_cov_52.804050	1670	1750	58	3	80	0.0375000
NODE_1649_length_1778_cov_52.804050	1670	1750	60	3	80	0.0375000
NODE_1649_length_1778_cov_52.804050	1670	1750	64	1	80	0.0125000
NODE_1649_length_1778_cov_52.804050	1670	1741	32	1	71	0.0140845
NODE_1649_length_1778_cov_52.804050	1670	1741	40	3	71	0.0422535
NODE_1649_length_1778_cov_52.804050	1670	1741	42	11	71	0.1549296
NODE_1649_length_1778_cov_52.804050	1670	1741	44	9	71	0.1267606
NODE_1649_length_1778_cov_52.804050	1670	1741	45	11	71	0.1549296
NODE_1649_length_1778_cov_52.804050	1670	1741	47	2	71	0.0281690
NODE_1649_length_1778_cov_52.804050	1670	1741	49	3	71	0.0422535
NODE_1649_length_1778_cov_52.804050	1670	1741	50	12	71	0.1690141
NODE_1649_length_1778_cov_52.804050	1670	1741	52	1	71	0.0140845
NODE_1649_length_1778_cov_52.804050	1670	1741	54	10	71	0.1408451
NODE_1649_length_1778_cov_52.804050	1670	1741	56	1	71	0.0140845
NODE_1649_length_1778_cov_52.804050	1670	1741	58	3	71	0.0422535
NODE_1649_length_1778_cov_52.804050	1670	1741	60	3	71	0.0422535
NODE_1649_length_1778_cov_52.804050	1670	1741	64	1	71	0.0140845
NODE_1649_length_1778_cov_52.804050	1673	1743	24	1	70	0.0142857
NODE_1649_length_1778_cov_52.804050	1673	1743	26	1	70	0.0142857
NODE_1649_length_1778_cov_52.804050	1673	1743	32	1	70	0.0142857
NODE_1649_length_1778_cov_52.804050	1673	1743	40	3	70	0.0428571
NODE_1649_length_1778_cov_52.804050	1673	1743	42	11	70	0.1571429
NODE_1649_length_1778_cov_52.804050	1673	1743	44	9	70	0.1285714
NODE_1649_length_1778_cov_52.804050	1673	1743	45	11	70	0.1571429
NODE_1649_length_1778_cov_52.804050	1673	1743	47	2	70	0.0285714
NODE_1649_length_1778_cov_52.804050	1673	1743	49	3	70	0.0428571
NODE_1649_length_1778_cov_52.804050	1673	1743	50	12	70	0.1714286
NODE_1649_length_1778_cov_52.804050	1673	1743	52	1	70	0.0142857
NODE_1649_length_1778_cov_52.804050	1673	1743	54	10	70	0.1428571
NODE_1649_length_1778_cov_52.804050	1673	1743	56	1	70	0.0142857
NODE_1649_length_1778_cov_52.804050	1673	1743	58	3	70	0.0428571
NODE_1649_length_1778_cov_52.804050	1673	1743	60	1	70	0.0142857
NODE_1649_length_1778_cov_52.804050	1679	1750	16	3	71	0.0422535
NODE_1649_length_1778_cov_52.804050	1679	1750	22	1	71	0.0140845
NODE_1649_length_1778_cov_52.804050	1679	1750	24	4	71	0.0563380
NODE_1649_length_1778_cov_52.804050	1679	1750	26	1	71	0.0140845
NODE_1649_length_1778_cov_52.804050	1679	1750	32	1	71	0.0140845
NODE_1649_length_1778_cov_52.804050	1679	1750	40	3	71	0.0422535
NODE_1649_length_1778_cov_52.804050	1679	1750	42	11	71	0.1549296
NODE_1649_length_1778_cov_52.804050	1679	1750	44	9	71	0.1267606
NODE_1649_length_1778_cov_52.804050	1679	1750	45	11	71	0.1549296
NODE_1649_length_1778_cov_52.804050	1679	1750	47	2	71	0.0281690
NODE_1649_length_1778_cov_52.804050	1679	1750	49	3	71	0.0422535
NODE_1649_length_1778_cov_52.804050	1679	1750	50	12	71	0.1690141
NODE_1649_length_1778_cov_52.804050	1679	1750	52	1	71	0.0140845
NODE_1649_length_1778_cov_52.804050	1679	1750	54	9	71	0.1267606
NODE_1651_length_1776_cov_43.081694	1246	1308	2	56	62	0.9032258
NODE_1651_length_1776_cov_43.081694	1246	1308	13	5	62	0.0806452
NODE_1651_length_1776_cov_43.081694	1246	1308	27	1	62	0.0161290
NODE_1651_length_1776_cov_43.081694	1281	1361	0	19	80	0.2375000
NODE_1651_length_1776_cov_43.081694	1281	1361	1	4	80	0.0500000
NODE_1651_length_1776_cov_43.081694	1281	1361	2	57	80	0.7125000
NODE_1652_length_1776_cov_9.256410	1120	1200	0	80	80	1.0000000
NODE_1652_length_1776_cov_9.256410	1173	1253	0	54	80	0.6750000
NODE_1652_length_1776_cov_9.256410	1173	1253	2	26	80	0.3250000
NODE_1652_length_1776_cov_9.256410	1249	1329	2	80	80	1.0000000
NODE_1652_length_1776_cov_9.256410	1302	1382	0	6	80	0.0750000
NODE_1652_length_1776_cov_9.256410	1302	1382	2	74	80	0.9250000
NODE_1657_length_1775_cov_54.208234	1103	1167	94	4	64	0.0625000
NODE_1657_length_1775_cov_54.208234	1103	1167	99	1	64	0.0156250
NODE_1657_length_1775_cov_54.208234	1103	1167	100	1	64	0.0156250
NODE_1657_length_1775_cov_54.208234	1103	1167	103	1	64	0.0156250
NODE_1657_length_1775_cov_54.208234	1103	1167	104	1	64	0.0156250
NODE_1657_length_1775_cov_54.208234	1103	1167	107	3	64	0.0468750
NODE_1657_length_1775_cov_54.208234	1103	1167	109	3	64	0.0468750
NODE_1657_length_1775_cov_54.208234	1103	1167	111	4	64	0.0625000
NODE_1657_length_1775_cov_54.208234	1103	1167	114	2	64	0.0312500
NODE_1657_length_1775_cov_54.208234	1103	1167	115	2	64	0.0312500
NODE_1657_length_1775_cov_54.208234	1103	1167	116	1	64	0.0156250
NODE_1657_length_1775_cov_54.208234	1103	1167	117	1	64	0.0156250
NODE_1657_length_1775_cov_54.208234	1103	1167	118	4	64	0.0625000
NODE_1657_length_1775_cov_54.208234	1103	1167	119	4	64	0.0625000
NODE_1657_length_1775_cov_54.208234	1103	1167	120	1	64	0.0156250
NODE_1657_length_1775_cov_54.208234	1103	1167	121	7	64	0.1093750
NODE_1657_length_1775_cov_54.208234	1103	1167	122	1	64	0.0156250
NODE_1657_length_1775_cov_54.208234	1103	1167	123	7	64	0.1093750
NODE_1657_length_1775_cov_54.208234	1103	1167	125	2	64	0.0312500
NODE_1657_length_1775_cov_54.208234	1103	1167	127	2	64	0.0312500
NODE_1657_length_1775_cov_54.208234	1103	1167	133	1	64	0.0156250
NODE_1657_length_1775_cov_54.208234	1103	1167	134	5	64	0.0781250
NODE_1657_length_1775_cov_54.208234	1103	1167	137	3	64	0.0468750
NODE_1657_length_1775_cov_54.208234	1103	1167	138	3	64	0.0468750
NODE_1657_length_1775_cov_54.208234	1103	1167	94	4	64	0.0625000
NODE_1657_length_1775_cov_54.208234	1103	1167	99	1	64	0.0156250
NODE_1657_length_1775_cov_54.208234	1103	1167	100	1	64	0.0156250
NODE_1657_length_1775_cov_54.208234	1103	1167	103	1	64	0.0156250
NODE_1657_length_1775_cov_54.208234	1103	1167	104	1	64	0.0156250
NODE_1657_length_1775_cov_54.208234	1103	1167	107	3	64	0.0468750
NODE_1657_length_1775_cov_54.208234	1103	1167	109	3	64	0.0468750
NODE_1657_length_1775_cov_54.208234	1103	1167	111	4	64	0.0625000
NODE_1657_length_1775_cov_54.208234	1103	1167	114	2	64	0.0312500
NODE_1657_length_1775_cov_54.208234	1103	1167	115	2	64	0.0312500
NODE_1657_length_1775_cov_54.208234	1103	1167	116	1	64	0.0156250
NODE_1657_length_1775_cov_54.208234	1103	1167	117	1	64	0.0156250
NODE_1657_length_1775_cov_54.208234	1103	1167	118	4	64	0.0625000
NODE_1657_length_1775_cov_54.208234	1103	1167	119	4	64	0.0625000
NODE_1657_length_1775_cov_54.208234	1103	1167	120	1	64	0.0156250
NODE_1657_length_1775_cov_54.208234	1103	1167	121	7	64	0.1093750
NODE_1657_length_1775_cov_54.208234	1103	1167	122	1	64	0.0156250
NODE_1657_length_1775_cov_54.208234	1103	1167	123	7	64	0.1093750
NODE_1657_length_1775_cov_54.208234	1103	1167	125	2	64	0.0312500
NODE_1657_length_1775_cov_54.208234	1103	1167	127	2	64	0.0312500
NODE_1657_length_1775_cov_54.208234	1103	1167	133	1	64	0.0156250
NODE_1657_length_1775_cov_54.208234	1103	1167	134	5	64	0.0781250
NODE_1657_length_1775_cov_54.208234	1103	1167	137	3	64	0.0468750
NODE_1657_length_1775_cov_54.208234	1103	1167	138	3	64	0.0468750
NODE_1657_length_1775_cov_54.208234	1140	1200	39	1	60	0.0166667
NODE_1657_length_1775_cov_54.208234	1140	1200	41	1	60	0.0166667
NODE_1657_length_1775_cov_54.208234	1140	1200	43	5	60	0.0833333
NODE_1657_length_1775_cov_54.208234	1140	1200	45	3	60	0.0500000
NODE_1657_length_1775_cov_54.208234	1140	1200	47	2	60	0.0333333
NODE_1657_length_1775_cov_54.208234	1140	1200	48	2	60	0.0333333
NODE_1657_length_1775_cov_54.208234	1140	1200	51	1	60	0.0166667
NODE_1657_length_1775_cov_54.208234	1140	1200	53	2	60	0.0333333
NODE_1657_length_1775_cov_54.208234	1140	1200	57	1	60	0.0166667
NODE_1657_length_1775_cov_54.208234	1140	1200	59	1	60	0.0166667
NODE_1657_length_1775_cov_54.208234	1140	1200	61	1	60	0.0166667
NODE_1657_length_1775_cov_54.208234	1140	1200	63	2	60	0.0333333
NODE_1657_length_1775_cov_54.208234	1140	1200	69	1	60	0.0166667
NODE_1657_length_1775_cov_54.208234	1140	1200	71	1	60	0.0166667
NODE_1657_length_1775_cov_54.208234	1140	1200	73	4	60	0.0666667
NODE_1657_length_1775_cov_54.208234	1140	1200	75	2	60	0.0333333
NODE_1657_length_1775_cov_54.208234	1140	1200	81	1	60	0.0166667
NODE_1657_length_1775_cov_54.208234	1140	1200	86	1	60	0.0166667
NODE_1657_length_1775_cov_54.208234	1140	1200	90	1	60	0.0166667
NODE_1657_length_1775_cov_54.208234	1140	1200	94	4	60	0.0666667
NODE_1657_length_1775_cov_54.208234	1140	1200	99	1	60	0.0166667
NODE_1657_length_1775_cov_54.208234	1140	1200	100	1	60	0.0166667
NODE_1657_length_1775_cov_54.208234	1140	1200	103	1	60	0.0166667
NODE_1657_length_1775_cov_54.208234	1140	1200	104	1	60	0.0166667
NODE_1657_length_1775_cov_54.208234	1140	1200	107	3	60	0.0500000
NODE_1657_length_1775_cov_54.208234	1140	1200	109	3	60	0.0500000
NODE_1657_length_1775_cov_54.208234	1140	1200	111	4	60	0.0666667
NODE_1657_length_1775_cov_54.208234	1140	1200	114	2	60	0.0333333
NODE_1657_length_1775_cov_54.208234	1140	1200	115	2	60	0.0333333
NODE_1657_length_1775_cov_54.208234	1140	1200	118	4	60	0.0666667
NODE_1657_length_1775_cov_54.208234	1140	1200	120	1	60	0.0166667
NODE_1658_length_1775_cov_13.181981	1170	1250	2	73	80	0.9125000
NODE_1658_length_1775_cov_13.181981	1170	1250	3	7	80	0.0875000
NODE_1658_length_1775_cov_13.181981	1223	1303	0	39	80	0.4875000
NODE_1658_length_1775_cov_13.181981	1223	1303	2	41	80	0.5125000
NODE_1659_length_1775_cov_4.218974	1304	1384	2	31	80	0.3875000
NODE_1659_length_1775_cov_4.218974	1304	1384	4	49	80	0.6125000
NODE_1659_length_1775_cov_4.218974	1357	1437	0	1	80	0.0125000
NODE_1659_length_1775_cov_4.218974	1357	1437	2	7	80	0.0875000
NODE_1659_length_1775_cov_4.218974	1357	1437	4	72	80	0.9000000
NODE_1660_length_1774_cov_48.617313	345	425	0	21	80	0.2625000
NODE_1660_length_1774_cov_48.617313	345	425	2	59	80	0.7375000
NODE_1660_length_1774_cov_48.617313	398	478	0	18	80	0.2250000
NODE_1660_length_1774_cov_48.617313	398	478	2	62	80	0.7750000
NODE_1660_length_1774_cov_48.617313	474	554	0	80	80	1.0000000
NODE_1660_length_1774_cov_48.617313	527	607	0	80	80	1.0000000
NODE_1660_length_1774_cov_48.617313	1027	1107	4	6	80	0.0750000
NODE_1660_length_1774_cov_48.617313	1027	1107	6	63	80	0.7875000
NODE_1660_length_1774_cov_48.617313	1027	1107	8	11	80	0.1375000
NODE_1660_length_1774_cov_48.617313	1080	1160	0	6	80	0.0750000
NODE_1660_length_1774_cov_48.617313	1080	1160	2	36	80	0.4500000
NODE_1660_length_1774_cov_48.617313	1080	1160	6	38	80	0.4750000
NODE_1660_length_1774_cov_48.617313	1156	1236	0	80	80	1.0000000
NODE_1660_length_1774_cov_48.617313	1209	1289	0	80	80	1.0000000
NODE_1662_length_1774_cov_8.011343	1655	1735	0	33	80	0.4125000
NODE_1662_length_1774_cov_8.011343	1655	1735	2	47	80	0.5875000
NODE_1663_length_1773_cov_5.547192	433	513	0	36	80	0.4500000
NODE_1663_length_1773_cov_5.547192	433	513	2	44	80	0.5500000
NODE_1663_length_1773_cov_5.547192	486	566	0	9	80	0.1125000
NODE_1663_length_1773_cov_5.547192	486	566	2	71	80	0.8875000
NODE_1664_length_1773_cov_3.925329	267	347	2	80	80	1.0000000
NODE_1664_length_1773_cov_3.925329	320	400	0	24	80	0.3000000
NODE_1664_length_1773_cov_3.925329	320	400	2	56	80	0.7000000
NODE_1666_length_1770_cov_9.912029	369	437	0	68	68	1.0000000
NODE_1666_length_1770_cov_9.912029	388	431	0	43	43	1.0000000
NODE_1666_length_1770_cov_9.912029	509	577	0	68	68	1.0000000
NODE_1666_length_1770_cov_9.912029	515	571	0	56	56	1.0000000
NODE_1666_length_1770_cov_9.912029	579	618	0	39	39	1.0000000
NODE_1666_length_1770_cov_9.912029	697	776	0	78	79	0.9873418
NODE_1666_length_1770_cov_9.912029	697	776	2	1	79	0.0126582
NODE_1666_length_1770_cov_9.912029	714	794	0	61	80	0.7625000
NODE_1666_length_1770_cov_9.912029	714	794	2	19	80	0.2375000
NODE_1666_length_1770_cov_9.912029	767	819	0	8	52	0.1538462
NODE_1666_length_1770_cov_9.912029	767	819	2	44	52	0.8461539
NODE_1666_length_1770_cov_9.912029	785	819	2	34	34	1.0000000
NODE_1667_length_1768_cov_9.134811	687	736	64	6	49	0.1224490
NODE_1667_length_1768_cov_9.134811	687	736	66	3	49	0.0612245
NODE_1667_length_1768_cov_9.134811	687	736	68	1	49	0.0204082
NODE_1667_length_1768_cov_9.134811	687	736	69	3	49	0.0612245
NODE_1667_length_1768_cov_9.134811	687	736	70	1	49	0.0204082
NODE_1667_length_1768_cov_9.134811	687	736	71	3	49	0.0612245
NODE_1667_length_1768_cov_9.134811	687	736	72	5	49	0.1020408
NODE_1667_length_1768_cov_9.134811	687	736	73	9	49	0.1836735
NODE_1667_length_1768_cov_9.134811	687	736	74	1	49	0.0204082
NODE_1667_length_1768_cov_9.134811	687	736	75	6	49	0.1224490
NODE_1667_length_1768_cov_9.134811	687	736	76	3	49	0.0612245
NODE_1667_length_1768_cov_9.134811	687	736	77	6	49	0.1224490
NODE_1667_length_1768_cov_9.134811	687	736	78	2	49	0.0408163
NODE_1668_length_1768_cov_6.605153	1207	1287	0	80	80	1.0000000
NODE_1668_length_1768_cov_6.605153	1260	1340	0	80	80	1.0000000
NODE_1668_length_1768_cov_6.605153	1336	1416	0	80	80	1.0000000
NODE_1668_length_1768_cov_6.605153	1389	1469	0	80	80	1.0000000
NODE_1669_length_1767_cov_5.475420	508	588	0	25	80	0.3125000
NODE_1669_length_1767_cov_5.475420	508	588	2	55	80	0.6875000
NODE_1680_length_1762_cov_18.673482	606	686	0	80	80	1.0000000
NODE_1680_length_1762_cov_18.673482	659	739	0	80	80	1.0000000
NODE_1680_length_1762_cov_18.673482	735	815	0	63	80	0.7875000
NODE_1680_length_1762_cov_18.673482	735	815	2	17	80	0.2125000
NODE_1680_length_1762_cov_18.673482	788	868	0	10	80	0.1250000
NODE_1680_length_1762_cov_18.673482	788	868	2	23	80	0.2875000
NODE_1680_length_1762_cov_18.673482	788	868	4	1	80	0.0125000
NODE_1680_length_1762_cov_18.673482	788	868	6	30	80	0.3750000
NODE_1680_length_1762_cov_18.673482	788	868	8	16	80	0.2000000
NODE_1681_length_1762_cov_6.760072	1033	1113	6	44	80	0.5500000
NODE_1681_length_1762_cov_6.760072	1033	1113	8	36	80	0.4500000
NODE_1681_length_1762_cov_6.760072	1086	1166	0	9	80	0.1125000
NODE_1681_length_1762_cov_6.760072	1086	1166	2	2	80	0.0250000
NODE_1681_length_1762_cov_6.760072	1086	1166	6	7	80	0.0875000
NODE_1681_length_1762_cov_6.760072	1086	1166	8	62	80	0.7750000
NODE_1685_length_1760_cov_8.064419	941	1021	2	31	80	0.3875000
NODE_1685_length_1760_cov_8.064419	941	1021	4	49	80	0.6125000
NODE_1685_length_1760_cov_8.064419	994	1074	0	3	80	0.0375000
NODE_1685_length_1760_cov_8.064419	994	1074	2	77	80	0.9625000
NODE_1692_length_1758_cov_99.869198	599	679	11	11	80	0.1375000
NODE_1692_length_1758_cov_99.869198	599	679	13	1	80	0.0125000
NODE_1692_length_1758_cov_99.869198	599	679	14	20	80	0.2500000
NODE_1692_length_1758_cov_99.869198	599	679	16	21	80	0.2625000
NODE_1692_length_1758_cov_99.869198	599	679	18	21	80	0.2625000
NODE_1692_length_1758_cov_99.869198	599	679	19	6	80	0.0750000
NODE_1692_length_1758_cov_99.869198	652	732	12	3	80	0.0375000
NODE_1692_length_1758_cov_99.869198	652	732	14	2	80	0.0250000
NODE_1692_length_1758_cov_99.869198	652	732	16	25	80	0.3125000
NODE_1692_length_1758_cov_99.869198	652	732	18	16	80	0.2000000
NODE_1692_length_1758_cov_99.869198	652	732	20	16	80	0.2000000
NODE_1692_length_1758_cov_99.869198	652	732	21	1	80	0.0125000
NODE_1692_length_1758_cov_99.869198	652	732	22	17	80	0.2125000
NODE_1692_length_1758_cov_99.869198	728	808	12	1	80	0.0125000
NODE_1692_length_1758_cov_99.869198	728	808	16	5	80	0.0625000
NODE_1692_length_1758_cov_99.869198	728	808	20	3	80	0.0375000
NODE_1692_length_1758_cov_99.869198	728	808	30	1	80	0.0125000
NODE_1692_length_1758_cov_99.869198	728	808	31	8	80	0.1000000
NODE_1692_length_1758_cov_99.869198	728	808	33	4	80	0.0500000
NODE_1692_length_1758_cov_99.869198	728	808	34	8	80	0.1000000
NODE_1692_length_1758_cov_99.869198	728	808	35	4	80	0.0500000
NODE_1692_length_1758_cov_99.869198	728	808	36	4	80	0.0500000
NODE_1692_length_1758_cov_99.869198	728	808	37	6	80	0.0750000
NODE_1692_length_1758_cov_99.869198	728	808	38	12	80	0.1500000
NODE_1692_length_1758_cov_99.869198	728	808	39	21	80	0.2625000
NODE_1692_length_1758_cov_99.869198	728	808	41	3	80	0.0375000
NODE_1692_length_1758_cov_99.869198	781	861	10	1	80	0.0125000
NODE_1692_length_1758_cov_99.869198	781	861	12	1	80	0.0125000
NODE_1692_length_1758_cov_99.869198	781	861	14	24	80	0.3000000
NODE_1692_length_1758_cov_99.869198	781	861	16	2	80	0.0250000
NODE_1692_length_1758_cov_99.869198	781	861	18	3	80	0.0375000
NODE_1692_length_1758_cov_99.869198	781	861	20	3	80	0.0375000
NODE_1692_length_1758_cov_99.869198	781	861	32	6	80	0.0750000
NODE_1692_length_1758_cov_99.869198	781	861	34	10	80	0.1250000
NODE_1692_length_1758_cov_99.869198	781	861	35	1	80	0.0125000
NODE_1692_length_1758_cov_99.869198	781	861	36	4	80	0.0500000
NODE_1692_length_1758_cov_99.869198	781	861	37	5	80	0.0625000
NODE_1692_length_1758_cov_99.869198	781	861	38	13	80	0.1625000
NODE_1692_length_1758_cov_99.869198	781	861	39	4	80	0.0500000
NODE_1692_length_1758_cov_99.869198	781	861	41	3	80	0.0375000
NODE_1693_length_1757_cov_3.126659	49	121	0	72	72	1.0000000
NODE_1696_length_1755_cov_9.938406	231	311	0	4	80	0.0500000
NODE_1696_length_1755_cov_9.938406	231	311	2	76	80	0.9500000
NODE_1696_length_1755_cov_9.938406	284	364	2	80	80	1.0000000
NODE_1698_length_1755_cov_3.614130	171	222	2	51	51	1.0000000
NODE_1699_length_1754_cov_8.523263	0	77	0	41	77	0.5324675
NODE_1699_length_1754_cov_8.523263	0	77	3	36	77	0.4675325
NODE_1699_length_1754_cov_8.523263	0	77	0	41	77	0.5324675
NODE_1699_length_1754_cov_8.523263	0	77	3	36	77	0.4675325
NODE_1699_length_1754_cov_8.523263	0	77	0	41	77	0.5324675
NODE_1699_length_1754_cov_8.523263	0	77	3	36	77	0.4675325
NODE_1699_length_1754_cov_8.523263	50	99	3	47	49	0.9591837
NODE_1699_length_1754_cov_8.523263	50	99	5	2	49	0.0408163
NODE_1699_length_1754_cov_8.523263	53	99	3	44	46	0.9565217
NODE_1699_length_1754_cov_8.523263	53	99	5	2	46	0.0434783
NODE_1699_length_1754_cov_8.523263	55	99	3	42	44	0.9545454
NODE_1699_length_1754_cov_8.523263	55	99	5	2	44	0.0454545
NODE_1700_length_1753_cov_26.851874	356	436	0	80	80	1.0000000
NODE_1700_length_1753_cov_26.851874	409	489	0	80	80	1.0000000
NODE_1701_length_1753_cov_12.297461	355	435	0	80	80	1.0000000
NODE_1701_length_1753_cov_12.297461	408	488	0	80	80	1.0000000
NODE_1705_length_1750_cov_90.732283	1191	1254	104	1	63	0.0158730
NODE_1705_length_1750_cov_90.732283	1191	1254	107	1	63	0.0158730
NODE_1705_length_1750_cov_90.732283	1191	1254	110	2	63	0.0317460
NODE_1705_length_1750_cov_90.732283	1191	1254	111	1	63	0.0158730
NODE_1705_length_1750_cov_90.732283	1191	1254	112	5	63	0.0793651
NODE_1705_length_1750_cov_90.732283	1191	1254	113	9	63	0.1428571
NODE_1705_length_1750_cov_90.732283	1191	1254	115	2	63	0.0317460
NODE_1705_length_1750_cov_90.732283	1191	1254	116	4	63	0.0634921
NODE_1705_length_1750_cov_90.732283	1191	1254	117	2	63	0.0317460
NODE_1705_length_1750_cov_90.732283	1191	1254	119	1	63	0.0158730
NODE_1705_length_1750_cov_90.732283	1191	1254	120	1	63	0.0158730
NODE_1705_length_1750_cov_90.732283	1191	1254	124	1	63	0.0158730
NODE_1705_length_1750_cov_90.732283	1191	1254	126	7	63	0.1111111
NODE_1705_length_1750_cov_90.732283	1191	1254	134	5	63	0.0793651
NODE_1705_length_1750_cov_90.732283	1191	1254	135	1	63	0.0158730
NODE_1705_length_1750_cov_90.732283	1191	1254	136	1	63	0.0158730
NODE_1705_length_1750_cov_90.732283	1191	1254	138	1	63	0.0158730
NODE_1705_length_1750_cov_90.732283	1191	1254	142	1	63	0.0158730
NODE_1705_length_1750_cov_90.732283	1191	1254	144	1	63	0.0158730
NODE_1705_length_1750_cov_90.732283	1191	1254	150	1	63	0.0158730
NODE_1705_length_1750_cov_90.732283	1191	1254	151	1	63	0.0158730
NODE_1705_length_1750_cov_90.732283	1191	1254	152	10	63	0.1587302
NODE_1705_length_1750_cov_90.732283	1191	1254	153	1	63	0.0158730
NODE_1705_length_1750_cov_90.732283	1191	1254	154	1	63	0.0158730
NODE_1705_length_1750_cov_90.732283	1191	1254	156	2	63	0.0317460
NODE_1705_length_1750_cov_90.732283	1239	1310	150	1	71	0.0140845
NODE_1705_length_1750_cov_90.732283	1239	1310	151	1	71	0.0140845
NODE_1705_length_1750_cov_90.732283	1239	1310	152	9	71	0.1267606
NODE_1705_length_1750_cov_90.732283	1239	1310	153	1	71	0.0140845
NODE_1705_length_1750_cov_90.732283	1239	1310	154	1	71	0.0140845
NODE_1705_length_1750_cov_90.732283	1239	1310	156	2	71	0.0281690
NODE_1705_length_1750_cov_90.732283	1239	1310	157	1	71	0.0140845
NODE_1705_length_1750_cov_90.732283	1239	1310	159	1	71	0.0140845
NODE_1705_length_1750_cov_90.732283	1239	1310	160	1	71	0.0140845
NODE_1705_length_1750_cov_90.732283	1239	1310	162	2	71	0.0281690
NODE_1705_length_1750_cov_90.732283	1239	1310	163	1	71	0.0140845
NODE_1705_length_1750_cov_90.732283	1239	1310	165	1	71	0.0140845
NODE_1705_length_1750_cov_90.732283	1239	1310	166	2	71	0.0281690
NODE_1705_length_1750_cov_90.732283	1239	1310	167	1	71	0.0140845
NODE_1705_length_1750_cov_90.732283	1239	1310	173	2	71	0.0281690
NODE_1705_length_1750_cov_90.732283	1239	1310	179	1	71	0.0140845
NODE_1705_length_1750_cov_90.732283	1239	1310	180	2	71	0.0281690
NODE_1705_length_1750_cov_90.732283	1239	1310	182	1	71	0.0140845
NODE_1705_length_1750_cov_90.732283	1239	1310	184	2	71	0.0281690
NODE_1705_length_1750_cov_90.732283	1239	1310	185	2	71	0.0281690
NODE_1705_length_1750_cov_90.732283	1239	1310	188	1	71	0.0140845
NODE_1705_length_1750_cov_90.732283	1239	1310	189	1	71	0.0140845
NODE_1705_length_1750_cov_90.732283	1239	1310	191	4	71	0.0563380
NODE_1705_length_1750_cov_90.732283	1239	1310	192	4	71	0.0563380
NODE_1705_length_1750_cov_90.732283	1239	1310	193	1	71	0.0140845
NODE_1705_length_1750_cov_90.732283	1239	1310	195	2	71	0.0281690
NODE_1705_length_1750_cov_90.732283	1239	1310	196	3	71	0.0422535
NODE_1705_length_1750_cov_90.732283	1239	1310	197	4	71	0.0563380
NODE_1705_length_1750_cov_90.732283	1239	1310	198	5	71	0.0704225
NODE_1705_length_1750_cov_90.732283	1239	1310	199	1	71	0.0140845
NODE_1705_length_1750_cov_90.732283	1239	1310	200	4	71	0.0563380
NODE_1705_length_1750_cov_90.732283	1239	1310	201	5	71	0.0704225
NODE_1705_length_1750_cov_90.732283	1239	1310	203	1	71	0.0140845
NODE_1711_length_1746_cov_3.095932	458	524	0	3	66	0.0454545
NODE_1711_length_1746_cov_3.095932	458	524	2	63	66	0.9545454
NODE_1712_length_1745_cov_7.646416	430	510	0	80	80	1.0000000
NODE_1712_length_1745_cov_7.646416	483	563	0	80	80	1.0000000
NODE_1715_length_1744_cov_10.144681	1213	1289	0	8	76	0.1052632
NODE_1715_length_1744_cov_10.144681	1213	1289	2	28	76	0.3684210
NODE_1715_length_1744_cov_10.144681	1213	1289	4	24	76	0.3157895
NODE_1715_length_1744_cov_10.144681	1213	1289	6	16	76	0.2105263
NODE_1715_length_1744_cov_10.144681	1262	1342	4	11	80	0.1375000
NODE_1715_length_1744_cov_10.144681	1262	1342	6	33	80	0.4125000
NODE_1715_length_1744_cov_10.144681	1262	1342	8	26	80	0.3250000
NODE_1715_length_1744_cov_10.144681	1262	1342	10	10	80	0.1250000
NODE_1719_length_1742_cov_18.923311	699	776	0	77	77	1.0000000
NODE_1719_length_1742_cov_18.923311	749	829	0	80	80	1.0000000
NODE_1722_length_1741_cov_7.657734	1234	1314	0	80	80	1.0000000
NODE_1722_length_1741_cov_7.657734	1287	1367	0	80	80	1.0000000
NODE_1722_length_1741_cov_7.657734	1363	1443	0	80	80	1.0000000
NODE_1722_length_1741_cov_7.657734	1416	1496	0	80	80	1.0000000
NODE_1726_length_1740_cov_38.411335	517	597	0	80	80	1.0000000
NODE_1726_length_1740_cov_38.411335	570	650	0	80	80	1.0000000
NODE_1726_length_1740_cov_38.411335	646	726	0	11	80	0.1375000
NODE_1726_length_1740_cov_38.411335	646	726	2	19	80	0.2375000
NODE_1726_length_1740_cov_38.411335	646	726	4	33	80	0.4125000
NODE_1726_length_1740_cov_38.411335	646	726	6	17	80	0.2125000
NODE_1726_length_1740_cov_38.411335	699	779	2	7	80	0.0875000
NODE_1726_length_1740_cov_38.411335	699	779	4	14	80	0.1750000
NODE_1726_length_1740_cov_38.411335	699	779	6	59	80	0.7375000
NODE_1727_length_1740_cov_10.843388	552	632	2	10	80	0.1250000
NODE_1727_length_1740_cov_10.843388	552	632	4	70	80	0.8750000
NODE_1727_length_1740_cov_10.843388	708	788	2	24	80	0.3000000
NODE_1727_length_1740_cov_10.843388	708	788	4	56	80	0.7000000
NODE_1727_length_1740_cov_10.843388	708	788	2	24	80	0.3000000
NODE_1727_length_1740_cov_10.843388	708	788	4	56	80	0.7000000
NODE_1727_length_1740_cov_10.843388	708	788	2	24	80	0.3000000
NODE_1727_length_1740_cov_10.843388	708	788	4	56	80	0.7000000
NODE_1727_length_1740_cov_10.843388	761	841	0	33	80	0.4125000
NODE_1727_length_1740_cov_10.843388	761	841	2	44	80	0.5500000
NODE_1727_length_1740_cov_10.843388	761	841	4	3	80	0.0375000
NODE_1727_length_1740_cov_10.843388	761	808	2	44	47	0.9361702
NODE_1727_length_1740_cov_10.843388	761	808	4	3	47	0.0638298
NODE_1727_length_1740_cov_10.843388	761	808	2	44	47	0.9361702
NODE_1727_length_1740_cov_10.843388	761	808	4	3	47	0.0638298
NODE_1737_length_1736_cov_71.959682	841	901	75	5	60	0.0833333
NODE_1737_length_1736_cov_71.959682	841	901	79	8	60	0.1333333
NODE_1737_length_1736_cov_71.959682	841	901	81	14	60	0.2333333
NODE_1737_length_1736_cov_71.959682	841	901	82	1	60	0.0166667
NODE_1737_length_1736_cov_71.959682	841	901	83	23	60	0.3833333
NODE_1737_length_1736_cov_71.959682	841	901	85	6	60	0.1000000
NODE_1737_length_1736_cov_71.959682	841	901	87	3	60	0.0500000
NODE_1738_length_1736_cov_29.174710	1361	1390	142	2	29	0.0689655
NODE_1738_length_1736_cov_29.174710	1361	1390	144	5	29	0.1724138
NODE_1738_length_1736_cov_29.174710	1361	1390	145	1	29	0.0344828
NODE_1738_length_1736_cov_29.174710	1361	1390	149	1	29	0.0344828
NODE_1738_length_1736_cov_29.174710	1361	1390	151	1	29	0.0344828
NODE_1738_length_1736_cov_29.174710	1361	1390	153	3	29	0.1034483
NODE_1738_length_1736_cov_29.174710	1361	1390	154	1	29	0.0344828
NODE_1738_length_1736_cov_29.174710	1361	1390	155	1	29	0.0344828
NODE_1738_length_1736_cov_29.174710	1361	1390	157	1	29	0.0344828
NODE_1738_length_1736_cov_29.174710	1361	1390	159	2	29	0.0689655
NODE_1738_length_1736_cov_29.174710	1361	1390	160	1	29	0.0344828
NODE_1738_length_1736_cov_29.174710	1361	1390	163	5	29	0.1724138
NODE_1738_length_1736_cov_29.174710	1361	1390	165	3	29	0.1034483
NODE_1738_length_1736_cov_29.174710	1361	1390	171	2	29	0.0689655
NODE_1738_length_1736_cov_29.174710	1566	1628	166	1	62	0.0161290
NODE_1738_length_1736_cov_29.174710	1566	1628	168	1	62	0.0161290
NODE_1738_length_1736_cov_29.174710	1566	1628	170	2	62	0.0322581
NODE_1738_length_1736_cov_29.174710	1566	1628	172	1	62	0.0161290
NODE_1738_length_1736_cov_29.174710	1566	1628	174	1	62	0.0161290
NODE_1738_length_1736_cov_29.174710	1566	1628	176	1	62	0.0161290
NODE_1738_length_1736_cov_29.174710	1566	1628	180	2	62	0.0322581
NODE_1738_length_1736_cov_29.174710	1566	1628	182	2	62	0.0322581
NODE_1738_length_1736_cov_29.174710	1566	1628	183	3	62	0.0483871
NODE_1738_length_1736_cov_29.174710	1566	1628	184	1	62	0.0161290
NODE_1738_length_1736_cov_29.174710	1566	1628	185	3	62	0.0483871
NODE_1738_length_1736_cov_29.174710	1566	1628	186	2	62	0.0322581
NODE_1738_length_1736_cov_29.174710	1566	1628	187	3	62	0.0483871
NODE_1738_length_1736_cov_29.174710	1566	1628	188	4	62	0.0645161
NODE_1738_length_1736_cov_29.174710	1566	1628	189	6	62	0.0967742
NODE_1738_length_1736_cov_29.174710	1566	1628	190	5	62	0.0806452
NODE_1738_length_1736_cov_29.174710	1566	1628	191	4	62	0.0645161
NODE_1738_length_1736_cov_29.174710	1566	1628	192	1	62	0.0161290
NODE_1738_length_1736_cov_29.174710	1566	1628	193	1	62	0.0161290
NODE_1738_length_1736_cov_29.174710	1566	1628	194	8	62	0.1290323
NODE_1738_length_1736_cov_29.174710	1566	1628	198	2	62	0.0322581
NODE_1738_length_1736_cov_29.174710	1566	1628	200	2	62	0.0322581
NODE_1738_length_1736_cov_29.174710	1566	1628	204	1	62	0.0161290
NODE_1738_length_1736_cov_29.174710	1566	1628	206	2	62	0.0322581
NODE_1738_length_1736_cov_29.174710	1566	1628	208	3	62	0.0483871
NODE_1743_length_1732_cov_6.162890	807	887	0	80	80	1.0000000
NODE_1743_length_1732_cov_6.162890	860	940	0	80	80	1.0000000
NODE_1749_length_1729_cov_23.708589	364	443	0	13	79	0.1645570
NODE_1749_length_1729_cov_23.708589	364	443	2	8	79	0.1012658
NODE_1749_length_1729_cov_23.708589	364	443	4	58	79	0.7341772
NODE_1749_length_1729_cov_23.708589	416	496	0	56	80	0.7000000
NODE_1749_length_1729_cov_23.708589	416	496	2	18	80	0.2250000
NODE_1749_length_1729_cov_23.708589	416	496	4	6	80	0.0750000
NODE_1749_length_1729_cov_23.708589	492	572	2	51	80	0.6375000
NODE_1749_length_1729_cov_23.708589	492	572	4	4	80	0.0500000
NODE_1749_length_1729_cov_23.708589	492	572	6	25	80	0.3125000
NODE_1749_length_1729_cov_23.708589	545	625	2	6	80	0.0750000
NODE_1749_length_1729_cov_23.708589	545	625	4	39	80	0.4875000
NODE_1749_length_1729_cov_23.708589	545	625	6	35	80	0.4375000
NODE_1753_length_1728_cov_26.505832	259	339	8	2	80	0.0250000
NODE_1753_length_1728_cov_26.505832	259	339	10	19	80	0.2375000
NODE_1753_length_1728_cov_26.505832	259	339	14	3	80	0.0375000
NODE_1753_length_1728_cov_26.505832	259	339	16	15	80	0.1875000
NODE_1753_length_1728_cov_26.505832	259	339	18	40	80	0.5000000
NODE_1753_length_1728_cov_26.505832	259	339	20	1	80	0.0125000
NODE_1753_length_1728_cov_26.505832	312	392	10	8	80	0.1000000
NODE_1753_length_1728_cov_26.505832	312	392	12	20	80	0.2500000
NODE_1753_length_1728_cov_26.505832	312	392	16	11	80	0.1375000
NODE_1753_length_1728_cov_26.505832	312	392	18	31	80	0.3875000
NODE_1753_length_1728_cov_26.505832	312	392	20	1	80	0.0125000
NODE_1753_length_1728_cov_26.505832	312	392	22	9	80	0.1125000
NODE_1757_length_1725_cov_142.158057	767	814	337	1	47	0.0212766
NODE_1757_length_1725_cov_142.158057	767	814	339	2	47	0.0425532
NODE_1757_length_1725_cov_142.158057	767	814	340	1	47	0.0212766
NODE_1757_length_1725_cov_142.158057	767	814	342	2	47	0.0425532
NODE_1757_length_1725_cov_142.158057	767	814	354	1	47	0.0212766
NODE_1757_length_1725_cov_142.158057	767	814	356	1	47	0.0212766
NODE_1757_length_1725_cov_142.158057	767	814	358	1	47	0.0212766
NODE_1757_length_1725_cov_142.158057	767	814	360	1	47	0.0212766
NODE_1757_length_1725_cov_142.158057	767	814	361	1	47	0.0212766
NODE_1757_length_1725_cov_142.158057	767	814	368	1	47	0.0212766
NODE_1757_length_1725_cov_142.158057	767	814	371	1	47	0.0212766
NODE_1757_length_1725_cov_142.158057	767	814	373	1	47	0.0212766
NODE_1757_length_1725_cov_142.158057	767	814	380	1	47	0.0212766
NODE_1757_length_1725_cov_142.158057	767	814	385	1	47	0.0212766
NODE_1757_length_1725_cov_142.158057	767	814	393	1	47	0.0212766
NODE_1757_length_1725_cov_142.158057	767	814	395	1	47	0.0212766
NODE_1757_length_1725_cov_142.158057	767	814	401	1	47	0.0212766
NODE_1757_length_1725_cov_142.158057	767	814	408	1	47	0.0212766
NODE_1757_length_1725_cov_142.158057	767	814	410	1	47	0.0212766
NODE_1757_length_1725_cov_142.158057	767	814	413	1	47	0.0212766
NODE_1757_length_1725_cov_142.158057	767	814	419	1	47	0.0212766
NODE_1757_length_1725_cov_142.158057	767	814	435	1	47	0.0212766
NODE_1757_length_1725_cov_142.158057	767	814	443	1	47	0.0212766
NODE_1757_length_1725_cov_142.158057	767	814	445	1	47	0.0212766
NODE_1757_length_1725_cov_142.158057	767	814	451	1	47	0.0212766
NODE_1757_length_1725_cov_142.158057	767	814	467	1	47	0.0212766
NODE_1757_length_1725_cov_142.158057	767	814	471	1	47	0.0212766
NODE_1757_length_1725_cov_142.158057	767	814	475	1	47	0.0212766
NODE_1757_length_1725_cov_142.158057	767	814	476	1	47	0.0212766
NODE_1757_length_1725_cov_142.158057	767	814	478	1	47	0.0212766
NODE_1757_length_1725_cov_142.158057	767	814	483	1	47	0.0212766
NODE_1757_length_1725_cov_142.158057	767	814	484	2	47	0.0425532
NODE_1757_length_1725_cov_142.158057	767	814	489	1	47	0.0212766
NODE_1757_length_1725_cov_142.158057	767	814	490	2	47	0.0425532
NODE_1757_length_1725_cov_142.158057	767	814	492	1	47	0.0212766
NODE_1757_length_1725_cov_142.158057	767	814	495	1	47	0.0212766
NODE_1757_length_1725_cov_142.158057	767	814	500	1	47	0.0212766
NODE_1757_length_1725_cov_142.158057	767	814	502	2	47	0.0425532
NODE_1757_length_1725_cov_142.158057	767	814	504	4	47	0.0851064
NODE_1757_length_1725_cov_142.158057	803	867	425	1	64	0.0156250
NODE_1757_length_1725_cov_142.158057	803	867	427	1	64	0.0156250
NODE_1757_length_1725_cov_142.158057	803	867	431	2	64	0.0312500
NODE_1757_length_1725_cov_142.158057	803	867	433	1	64	0.0156250
NODE_1757_length_1725_cov_142.158057	803	867	435	3	64	0.0468750
NODE_1757_length_1725_cov_142.158057	803	867	436	1	64	0.0156250
NODE_1757_length_1725_cov_142.158057	803	867	437	5	64	0.0781250
NODE_1757_length_1725_cov_142.158057	803	867	439	3	64	0.0468750
NODE_1757_length_1725_cov_142.158057	803	867	441	1	64	0.0156250
NODE_1757_length_1725_cov_142.158057	803	867	443	1	64	0.0156250
NODE_1757_length_1725_cov_142.158057	803	867	445	1	64	0.0156250
NODE_1757_length_1725_cov_142.158057	803	867	447	1	64	0.0156250
NODE_1757_length_1725_cov_142.158057	803	867	457	1	64	0.0156250
NODE_1757_length_1725_cov_142.158057	803	867	465	1	64	0.0156250
NODE_1757_length_1725_cov_142.158057	803	867	469	1	64	0.0156250
NODE_1757_length_1725_cov_142.158057	803	867	471	1	64	0.0156250
NODE_1757_length_1725_cov_142.158057	803	867	473	1	64	0.0156250
NODE_1757_length_1725_cov_142.158057	803	867	477	3	64	0.0468750
NODE_1757_length_1725_cov_142.158057	803	867	481	3	64	0.0468750
NODE_1757_length_1725_cov_142.158057	803	867	485	1	64	0.0156250
NODE_1757_length_1725_cov_142.158057	803	867	487	1	64	0.0156250
NODE_1757_length_1725_cov_142.158057	803	867	489	2	64	0.0312500
NODE_1757_length_1725_cov_142.158057	803	867	490	2	64	0.0312500
NODE_1757_length_1725_cov_142.158057	803	867	493	1	64	0.0156250
NODE_1757_length_1725_cov_142.158057	803	867	494	1	64	0.0156250
NODE_1757_length_1725_cov_142.158057	803	867	495	4	64	0.0625000
NODE_1757_length_1725_cov_142.158057	803	867	497	1	64	0.0156250
NODE_1757_length_1725_cov_142.158057	803	867	498	3	64	0.0468750
NODE_1757_length_1725_cov_142.158057	803	867	499	2	64	0.0312500
NODE_1757_length_1725_cov_142.158057	803	867	500	7	64	0.1093750
NODE_1757_length_1725_cov_142.158057	803	867	502	3	64	0.0468750
NODE_1757_length_1725_cov_142.158057	803	867	504	4	64	0.0625000
NODE_1759_length_1724_cov_17.931077	677	746	0	69	69	1.0000000
NODE_1759_length_1724_cov_17.931077	788	850	0	62	62	1.0000000
NODE_1761_length_1723_cov_35.355296	1174	1254	0	76	80	0.9500000
NODE_1761_length_1723_cov_35.355296	1174	1254	2	4	80	0.0500000
NODE_1761_length_1723_cov_35.355296	1227	1307	0	80	80	1.0000000
NODE_1763_length_1722_cov_13.235367	708	788	2	35	80	0.4375000
NODE_1763_length_1722_cov_13.235367	708	788	4	45	80	0.5625000
NODE_1763_length_1722_cov_13.235367	761	841	0	4	80	0.0500000
NODE_1763_length_1722_cov_13.235367	761	841	2	35	80	0.4375000
NODE_1763_length_1722_cov_13.235367	761	841	3	2	80	0.0250000
NODE_1763_length_1722_cov_13.235367	761	841	4	39	80	0.4875000
NODE_1763_length_1722_cov_13.235367	1319	1399	0	80	80	1.0000000
NODE_1763_length_1722_cov_13.235367	1372	1452	0	80	80	1.0000000
NODE_1765_length_1720_cov_27.328192	1248	1307	2	4	59	0.0677966
NODE_1765_length_1720_cov_27.328192	1248	1307	6	12	59	0.2033898
NODE_1765_length_1720_cov_27.328192	1248	1307	7	20	59	0.3389831
NODE_1765_length_1720_cov_27.328192	1248	1307	8	17	59	0.2881356
NODE_1765_length_1720_cov_27.328192	1248	1307	10	6	59	0.1016949
NODE_1765_length_1720_cov_27.328192	1280	1360	7	4	80	0.0500000
NODE_1765_length_1720_cov_27.328192	1280	1360	8	18	80	0.2250000
NODE_1765_length_1720_cov_27.328192	1280	1360	10	58	80	0.7250000
NODE_1766_length_1720_cov_4.129550	241	321	0	80	80	1.0000000
NODE_1766_length_1720_cov_4.129550	294	374	0	80	80	1.0000000
NODE_1768_length_1719_cov_9.878395	410	490	0	80	80	1.0000000
NODE_1768_length_1719_cov_9.878395	463	543	0	80	80	1.0000000
NODE_1768_length_1719_cov_9.878395	539	619	0	24	80	0.3000000
NODE_1768_length_1719_cov_9.878395	539	619	2	56	80	0.7000000
NODE_1768_length_1719_cov_9.878395	592	672	0	34	80	0.4250000
NODE_1768_length_1719_cov_9.878395	592	672	2	46	80	0.5750000
NODE_1772_length_1717_cov_5.159456	145	219	4	5	74	0.0675676
NODE_1772_length_1717_cov_5.159456	145	219	6	2	74	0.0270270
NODE_1772_length_1717_cov_5.159456	145	219	10	2	74	0.0270270
NODE_1772_length_1717_cov_5.159456	145	219	12	2	74	0.0270270
NODE_1772_length_1717_cov_5.159456	145	219	14	1	74	0.0135135
NODE_1772_length_1717_cov_5.159456	145	219	18	1	74	0.0135135
NODE_1772_length_1717_cov_5.159456	145	219	20	6	74	0.0810811
NODE_1772_length_1717_cov_5.159456	145	219	22	1	74	0.0135135
NODE_1772_length_1717_cov_5.159456	145	219	26	4	74	0.0540541
NODE_1772_length_1717_cov_5.159456	145	219	28	1	74	0.0135135
NODE_1772_length_1717_cov_5.159456	145	219	36	2	74	0.0270270
NODE_1772_length_1717_cov_5.159456	145	219	38	4	74	0.0540541
NODE_1772_length_1717_cov_5.159456	145	219	40	1	74	0.0135135
NODE_1772_length_1717_cov_5.159456	145	219	44	1	74	0.0135135
NODE_1772_length_1717_cov_5.159456	145	219	46	5	74	0.0675676
NODE_1772_length_1717_cov_5.159456	145	219	48	1	74	0.0135135
NODE_1772_length_1717_cov_5.159456	145	219	56	1	74	0.0135135
NODE_1772_length_1717_cov_5.159456	145	219	58	2	74	0.0270270
NODE_1772_length_1717_cov_5.159456	145	219	60	5	74	0.0675676
NODE_1772_length_1717_cov_5.159456	145	219	62	4	74	0.0540541
NODE_1772_length_1717_cov_5.159456	145	219	64	3	74	0.0405405
NODE_1772_length_1717_cov_5.159456	145	219	66	12	74	0.1621622
NODE_1772_length_1717_cov_5.159456	145	219	68	8	74	0.1081081
NODE_1772_length_1717_cov_5.159456	1450	1508	2	54	58	0.9310345
NODE_1772_length_1717_cov_5.159456	1450	1508	3	1	58	0.0172414
NODE_1772_length_1717_cov_5.159456	1450	1508	4	3	58	0.0517241
NODE_1772_length_1717_cov_5.159456	1503	1561	0	15	58	0.2586207
NODE_1772_length_1717_cov_5.159456	1503	1561	2	43	58	0.7413793
NODE_1778_length_1715_cov_12.607054	555	635	0	80	80	1.0000000
NODE_1778_length_1715_cov_12.607054	608	688	0	80	80	1.0000000
NODE_1778_length_1715_cov_12.607054	684	764	0	80	80	1.0000000
NODE_1778_length_1715_cov_12.607054	737	817	0	80	80	1.0000000
NODE_1788_length_1707_cov_16.909204	397	477	0	47	80	0.5875000
NODE_1788_length_1707_cov_16.909204	397	477	2	33	80	0.4125000
NODE_1788_length_1707_cov_16.909204	450	530	2	80	80	1.0000000
NODE_1788_length_1707_cov_16.909204	1151	1231	4	29	80	0.3625000
NODE_1788_length_1707_cov_16.909204	1151	1231	6	17	80	0.2125000
NODE_1788_length_1707_cov_16.909204	1151	1231	8	29	80	0.3625000
NODE_1788_length_1707_cov_16.909204	1151	1231	10	5	80	0.0625000
NODE_1788_length_1707_cov_16.909204	1204	1284	0	23	80	0.2875000
NODE_1788_length_1707_cov_16.909204	1204	1284	2	13	80	0.1625000
NODE_1788_length_1707_cov_16.909204	1204	1284	4	44	80	0.5500000
NODE_1792_length_1705_cov_19.645081	451	531	1	40	80	0.5000000
NODE_1792_length_1705_cov_19.645081	451	531	2	16	80	0.2000000
NODE_1792_length_1705_cov_19.645081	451	531	4	24	80	0.3000000
NODE_1792_length_1705_cov_19.645081	504	584	1	10	80	0.1250000
NODE_1792_length_1705_cov_19.645081	504	584	2	3	80	0.0375000
NODE_1792_length_1705_cov_19.645081	504	584	4	67	80	0.8375000
NODE_1792_length_1705_cov_19.645081	580	660	0	19	80	0.2375000
NODE_1792_length_1705_cov_19.645081	580	660	1	61	80	0.7625000
NODE_1792_length_1705_cov_19.645081	633	714	0	50	81	0.6172839
NODE_1792_length_1705_cov_19.645081	633	714	1	8	81	0.0987654
NODE_1792_length_1705_cov_19.645081	633	714	2	10	81	0.1234568
NODE_1792_length_1705_cov_19.645081	633	714	4	13	81	0.1604938
NODE_1792_length_1705_cov_19.645081	1315	1395	0	14	80	0.1750000
NODE_1792_length_1705_cov_19.645081	1315	1395	2	66	80	0.8250000
NODE_1792_length_1705_cov_19.645081	1368	1448	0	21	80	0.2625000
NODE_1792_length_1705_cov_19.645081	1368	1448	2	59	80	0.7375000
NODE_1796_length_1703_cov_26.016833	1201	1264	0	35	63	0.5555556
NODE_1796_length_1703_cov_26.016833	1201	1264	2	17	63	0.2698413
NODE_1796_length_1703_cov_26.016833	1201	1264	6	1	63	0.0158730
NODE_1796_length_1703_cov_26.016833	1201	1264	8	2	63	0.0317460
NODE_1796_length_1703_cov_26.016833	1201	1264	19	1	63	0.0158730
NODE_1796_length_1703_cov_26.016833	1201	1264	21	7	63	0.1111111
NODE_1796_length_1703_cov_26.016833	1207	1264	0	35	57	0.6140351
NODE_1796_length_1703_cov_26.016833	1207	1264	2	17	57	0.2982456
NODE_1796_length_1703_cov_26.016833	1207	1264	6	1	57	0.0175439
NODE_1796_length_1703_cov_26.016833	1207	1264	8	2	57	0.0350877
NODE_1796_length_1703_cov_26.016833	1207	1264	19	1	57	0.0175439
NODE_1796_length_1703_cov_26.016833	1207	1264	21	1	57	0.0175439
NODE_1796_length_1703_cov_26.016833	1207	1264	0	35	57	0.6140351
NODE_1796_length_1703_cov_26.016833	1207	1264	2	17	57	0.2982456
NODE_1796_length_1703_cov_26.016833	1207	1264	6	1	57	0.0175439
NODE_1796_length_1703_cov_26.016833	1207	1264	8	2	57	0.0350877
NODE_1796_length_1703_cov_26.016833	1207	1264	19	1	57	0.0175439
NODE_1796_length_1703_cov_26.016833	1207	1264	21	1	57	0.0175439
NODE_1799_length_1701_cov_15.969413	1490	1565	11	1	75	0.0133333
NODE_1799_length_1701_cov_15.969413	1490	1565	12	1	75	0.0133333
NODE_1799_length_1701_cov_15.969413	1490	1565	15	9	75	0.1200000
NODE_1799_length_1701_cov_15.969413	1490	1565	19	7	75	0.0933333
NODE_1799_length_1701_cov_15.969413	1490	1565	21	3	75	0.0400000
NODE_1799_length_1701_cov_15.969413	1490	1565	23	2	75	0.0266667
NODE_1799_length_1701_cov_15.969413	1490	1565	25	1	75	0.0133333
NODE_1799_length_1701_cov_15.969413	1490	1565	27	3	75	0.0400000
NODE_1799_length_1701_cov_15.969413	1490	1565	29	2	75	0.0266667
NODE_1799_length_1701_cov_15.969413	1490	1565	32	2	75	0.0266667
NODE_1799_length_1701_cov_15.969413	1490	1565	34	1	75	0.0133333
NODE_1799_length_1701_cov_15.969413	1490	1565	36	4	75	0.0533333
NODE_1799_length_1701_cov_15.969413	1490	1565	38	1	75	0.0133333
NODE_1799_length_1701_cov_15.969413	1490	1565	40	2	75	0.0266667
NODE_1799_length_1701_cov_15.969413	1490	1565	42	4	75	0.0533333
NODE_1799_length_1701_cov_15.969413	1490	1565	46	1	75	0.0133333
NODE_1799_length_1701_cov_15.969413	1490	1565	50	5	75	0.0666667
NODE_1799_length_1701_cov_15.969413	1490	1565	52	4	75	0.0533333
NODE_1799_length_1701_cov_15.969413	1490	1565	53	5	75	0.0666667
NODE_1799_length_1701_cov_15.969413	1490	1565	55	6	75	0.0800000
NODE_1799_length_1701_cov_15.969413	1490	1565	57	1	75	0.0133333
NODE_1799_length_1701_cov_15.969413	1490	1565	59	5	75	0.0666667
NODE_1799_length_1701_cov_15.969413	1490	1565	64	3	75	0.0400000
NODE_1799_length_1701_cov_15.969413	1490	1565	65	2	75	0.0266667
NODE_1799_length_1701_cov_15.969413	1538	1603	50	1	65	0.0153846
NODE_1799_length_1701_cov_15.969413	1538	1603	52	4	65	0.0615385
NODE_1799_length_1701_cov_15.969413	1538	1603	53	5	65	0.0769231
NODE_1799_length_1701_cov_15.969413	1538	1603	55	6	65	0.0923077
NODE_1799_length_1701_cov_15.969413	1538	1603	57	1	65	0.0153846
NODE_1799_length_1701_cov_15.969413	1538	1603	59	5	65	0.0769231
NODE_1799_length_1701_cov_15.969413	1538	1603	64	3	65	0.0461538
NODE_1799_length_1701_cov_15.969413	1538	1603	65	2	65	0.0307692
NODE_1799_length_1701_cov_15.969413	1538	1603	70	1	65	0.0153846
NODE_1799_length_1701_cov_15.969413	1538	1603	72	1	65	0.0153846
NODE_1799_length_1701_cov_15.969413	1538	1603	74	2	65	0.0307692
NODE_1799_length_1701_cov_15.969413	1538	1603	76	12	65	0.1846154
NODE_1799_length_1701_cov_15.969413	1538	1603	78	3	65	0.0461538
NODE_1799_length_1701_cov_15.969413	1538	1603	80	2	65	0.0307692
NODE_1799_length_1701_cov_15.969413	1538	1603	82	1	65	0.0153846
NODE_1799_length_1701_cov_15.969413	1538	1603	84	1	65	0.0153846
NODE_1799_length_1701_cov_15.969413	1538	1603	86	1	65	0.0153846
NODE_1799_length_1701_cov_15.969413	1538	1603	88	2	65	0.0307692
NODE_1799_length_1701_cov_15.969413	1538	1603	90	1	65	0.0153846
NODE_1799_length_1701_cov_15.969413	1538	1603	93	1	65	0.0153846
NODE_1799_length_1701_cov_15.969413	1538	1603	94	2	65	0.0307692
NODE_1799_length_1701_cov_15.969413	1538	1603	96	7	65	0.1076923
NODE_1799_length_1701_cov_15.969413	1538	1603	100	1	65	0.0153846
NODE_1800_length_1701_cov_13.549313	607	687	2	15	80	0.1875000
NODE_1800_length_1701_cov_13.549313	607	687	6	65	80	0.8125000
NODE_1800_length_1701_cov_13.549313	660	740	2	52	80	0.6500000
NODE_1800_length_1701_cov_13.549313	660	740	4	16	80	0.2000000
NODE_1800_length_1701_cov_13.549313	660	740	6	12	80	0.1500000
NODE_1805_length_1700_cov_20.003123	1168	1197	177	1	29	0.0344828
NODE_1805_length_1700_cov_20.003123	1168	1197	179	2	29	0.0689655
NODE_1805_length_1700_cov_20.003123	1168	1197	181	2	29	0.0689655
NODE_1805_length_1700_cov_20.003123	1168	1197	183	1	29	0.0344828
NODE_1805_length_1700_cov_20.003123	1168	1197	184	1	29	0.0344828
NODE_1805_length_1700_cov_20.003123	1168	1197	185	2	29	0.0689655
NODE_1805_length_1700_cov_20.003123	1168	1197	187	1	29	0.0344828
NODE_1805_length_1700_cov_20.003123	1168	1197	190	2	29	0.0689655
NODE_1805_length_1700_cov_20.003123	1168	1197	191	1	29	0.0344828
NODE_1805_length_1700_cov_20.003123	1168	1197	192	2	29	0.0689655
NODE_1805_length_1700_cov_20.003123	1168	1197	193	1	29	0.0344828
NODE_1805_length_1700_cov_20.003123	1168	1197	194	1	29	0.0344828
NODE_1805_length_1700_cov_20.003123	1168	1197	195	1	29	0.0344828
NODE_1805_length_1700_cov_20.003123	1168	1197	196	2	29	0.0689655
NODE_1805_length_1700_cov_20.003123	1168	1197	197	1	29	0.0344828
NODE_1805_length_1700_cov_20.003123	1168	1197	198	1	29	0.0344828
NODE_1805_length_1700_cov_20.003123	1168	1197	199	5	29	0.1724138
NODE_1805_length_1700_cov_20.003123	1168	1197	201	2	29	0.0689655
NODE_1805_length_1700_cov_20.003123	1184	1263	177	1	79	0.0126582
NODE_1805_length_1700_cov_20.003123	1184	1263	179	2	79	0.0253165
NODE_1805_length_1700_cov_20.003123	1184	1263	181	2	79	0.0253165
NODE_1805_length_1700_cov_20.003123	1184	1263	186	1	79	0.0126582
NODE_1805_length_1700_cov_20.003123	1184	1263	187	1	79	0.0126582
NODE_1805_length_1700_cov_20.003123	1184	1263	190	1	79	0.0126582
NODE_1805_length_1700_cov_20.003123	1184	1263	191	1	79	0.0126582
NODE_1805_length_1700_cov_20.003123	1184	1263	192	2	79	0.0253165
NODE_1805_length_1700_cov_20.003123	1184	1263	194	2	79	0.0253165
NODE_1805_length_1700_cov_20.003123	1184	1263	195	1	79	0.0126582
NODE_1805_length_1700_cov_20.003123	1184	1263	196	1	79	0.0126582
NODE_1805_length_1700_cov_20.003123	1184	1263	207	2	79	0.0253165
NODE_1805_length_1700_cov_20.003123	1184	1263	208	2	79	0.0253165
NODE_1805_length_1700_cov_20.003123	1184	1263	209	3	79	0.0379747
NODE_1805_length_1700_cov_20.003123	1184	1263	211	2	79	0.0253165
NODE_1805_length_1700_cov_20.003123	1184	1263	212	2	79	0.0253165
NODE_1805_length_1700_cov_20.003123	1184	1263	213	2	79	0.0253165
NODE_1805_length_1700_cov_20.003123	1184	1263	215	3	79	0.0379747
NODE_1805_length_1700_cov_20.003123	1184	1263	231	1	79	0.0126582
NODE_1805_length_1700_cov_20.003123	1184	1263	234	1	79	0.0126582
NODE_1805_length_1700_cov_20.003123	1184	1263	237	1	79	0.0126582
NODE_1805_length_1700_cov_20.003123	1184	1263	242	1	79	0.0126582
NODE_1805_length_1700_cov_20.003123	1184	1263	247	2	79	0.0253165
NODE_1805_length_1700_cov_20.003123	1184	1263	248	1	79	0.0126582
NODE_1805_length_1700_cov_20.003123	1184	1263	250	3	79	0.0379747
NODE_1805_length_1700_cov_20.003123	1184	1263	255	2	79	0.0253165
NODE_1805_length_1700_cov_20.003123	1184	1263	256	1	79	0.0126582
NODE_1805_length_1700_cov_20.003123	1184	1263	257	1	79	0.0126582
NODE_1805_length_1700_cov_20.003123	1184	1263	261	4	79	0.0506329
NODE_1805_length_1700_cov_20.003123	1184	1263	262	1	79	0.0126582
NODE_1805_length_1700_cov_20.003123	1184	1263	270	1	79	0.0126582
NODE_1805_length_1700_cov_20.003123	1184	1263	272	2	79	0.0253165
NODE_1805_length_1700_cov_20.003123	1184	1263	276	2	79	0.0253165
NODE_1805_length_1700_cov_20.003123	1184	1263	280	1	79	0.0126582
NODE_1805_length_1700_cov_20.003123	1184	1263	282	1	79	0.0126582
NODE_1805_length_1700_cov_20.003123	1184	1263	287	1	79	0.0126582
NODE_1805_length_1700_cov_20.003123	1184	1263	290	1	79	0.0126582
NODE_1805_length_1700_cov_20.003123	1184	1263	292	1	79	0.0126582
NODE_1805_length_1700_cov_20.003123	1184	1263	297	1	79	0.0126582
NODE_1805_length_1700_cov_20.003123	1184	1263	298	1	79	0.0126582
NODE_1805_length_1700_cov_20.003123	1184	1263	300	1	79	0.0126582
NODE_1805_length_1700_cov_20.003123	1184	1263	304	3	79	0.0379747
NODE_1805_length_1700_cov_20.003123	1184	1263	306	1	79	0.0126582
NODE_1805_length_1700_cov_20.003123	1184	1263	308	2	79	0.0253165
NODE_1805_length_1700_cov_20.003123	1184	1263	310	1	79	0.0126582
NODE_1805_length_1700_cov_20.003123	1184	1263	311	1	79	0.0126582
NODE_1805_length_1700_cov_20.003123	1184	1263	312	1	79	0.0126582
NODE_1805_length_1700_cov_20.003123	1184	1263	319	1	79	0.0126582
NODE_1805_length_1700_cov_20.003123	1184	1263	321	1	79	0.0126582
NODE_1805_length_1700_cov_20.003123	1184	1263	330	1	79	0.0126582
NODE_1805_length_1700_cov_20.003123	1184	1263	332	1	79	0.0126582
NODE_1805_length_1700_cov_20.003123	1184	1263	334	1	79	0.0126582
NODE_1805_length_1700_cov_20.003123	1184	1263	336	1	79	0.0126582
NODE_1805_length_1700_cov_20.003123	1184	1263	340	1	79	0.0126582
NODE_1810_length_1698_cov_19.175735	1001	1081	0	14	80	0.1750000
NODE_1810_length_1698_cov_19.175735	1001	1081	2	66	80	0.8250000
NODE_1810_length_1698_cov_19.175735	1054	1134	0	60	80	0.7500000
NODE_1810_length_1698_cov_19.175735	1054	1134	2	20	80	0.2500000
NODE_1814_length_1696_cov_11.494678	590	670	1	3	80	0.0375000
NODE_1814_length_1696_cov_11.494678	590	670	5	4	80	0.0500000
NODE_1814_length_1696_cov_11.494678	590	670	8	43	80	0.5375000
NODE_1814_length_1696_cov_11.494678	590	670	9	30	80	0.3750000
NODE_1814_length_1696_cov_11.494678	643	723	0	33	80	0.4125000
NODE_1814_length_1696_cov_11.494678	643	723	4	12	80	0.1500000
NODE_1814_length_1696_cov_11.494678	643	723	8	35	80	0.4375000
NODE_1815_length_1696_cov_6.620539	369	449	2	27	80	0.3375000
NODE_1815_length_1696_cov_6.620539	369	449	4	52	80	0.6500000
NODE_1815_length_1696_cov_6.620539	369	449	6	1	80	0.0125000
NODE_1815_length_1696_cov_6.620539	422	502	4	50	80	0.6250000
NODE_1815_length_1696_cov_6.620539	422	502	5	1	80	0.0125000
NODE_1815_length_1696_cov_6.620539	422	502	6	29	80	0.3625000
NODE_1816_length_1695_cov_27.783208	399	479	4	45	80	0.5625000
NODE_1816_length_1695_cov_27.783208	399	479	5	12	80	0.1500000
NODE_1816_length_1695_cov_27.783208	399	479	6	23	80	0.2875000
NODE_1816_length_1695_cov_27.783208	452	532	0	37	80	0.4625000
NODE_1816_length_1695_cov_27.783208	452	532	4	43	80	0.5375000
NODE_1817_length_1695_cov_12.084586	1047	1127	4	80	80	1.0000000
NODE_1817_length_1695_cov_12.084586	1100	1180	0	37	80	0.4625000
NODE_1817_length_1695_cov_12.084586	1100	1180	4	43	80	0.5375000
NODE_1825_length_1692_cov_4.557439	727	807	0	61	80	0.7625000
NODE_1825_length_1692_cov_4.557439	727	807	4	19	80	0.2375000
NODE_1825_length_1692_cov_4.557439	780	860	0	49	80	0.6125000
NODE_1825_length_1692_cov_4.557439	780	860	2	31	80	0.3875000
NODE_1830_length_1689_cov_5.844025	1210	1285	0	75	75	1.0000000
NODE_1830_length_1689_cov_5.844025	1260	1338	0	62	78	0.7948718
NODE_1830_length_1689_cov_5.844025	1260	1338	2	16	78	0.2051282
NODE_1837_length_1682_cov_14.416930	1183	1263	0	22	80	0.2750000
NODE_1837_length_1682_cov_14.416930	1183	1263	2	58	80	0.7250000
NODE_1837_length_1682_cov_14.416930	1236	1315	0	74	79	0.9367089
NODE_1837_length_1682_cov_14.416930	1236	1315	2	5	79	0.0632911
NODE_1843_length_1678_cov_23.965168	636	716	2	18	80	0.2250000
NODE_1843_length_1678_cov_23.965168	636	716	4	62	80	0.7750000
NODE_1843_length_1678_cov_23.965168	689	769	0	24	80	0.3000000
NODE_1843_length_1678_cov_23.965168	689	769	2	43	80	0.5375000
NODE_1843_length_1678_cov_23.965168	689	769	4	13	80	0.1625000
NODE_1843_length_1678_cov_23.965168	1145	1225	2	6	80	0.0750000
NODE_1843_length_1678_cov_23.965168	1145	1225	4	72	80	0.9000000
NODE_1843_length_1678_cov_23.965168	1145	1225	6	2	80	0.0250000
NODE_1843_length_1678_cov_23.965168	1198	1278	2	50	80	0.6250000
NODE_1843_length_1678_cov_23.965168	1198	1278	4	28	80	0.3500000
NODE_1843_length_1678_cov_23.965168	1198	1278	6	2	80	0.0250000
NODE_1846_length_1677_cov_3.578580	407	487	6	80	80	1.0000000
NODE_1846_length_1677_cov_3.578580	460	530	0	29	70	0.4142857
NODE_1846_length_1677_cov_3.578580	460	530	6	41	70	0.5857143
NODE_1846_length_1677_cov_3.578580	666	724	0	58	58	1.0000000
NODE_1856_length_1670_cov_29.264163	741	821	2	26	80	0.3250000
NODE_1856_length_1670_cov_29.264163	741	821	4	12	80	0.1500000
NODE_1856_length_1670_cov_29.264163	741	821	8	26	80	0.3250000
NODE_1856_length_1670_cov_29.264163	741	821	10	16	80	0.2000000
NODE_1856_length_1670_cov_29.264163	794	874	2	13	80	0.1625000
NODE_1856_length_1670_cov_29.264163	794	874	4	16	80	0.2000000
NODE_1856_length_1670_cov_29.264163	794	874	6	5	80	0.0625000
NODE_1856_length_1670_cov_29.264163	794	874	8	36	80	0.4500000
NODE_1856_length_1670_cov_29.264163	794	874	10	10	80	0.1250000
NODE_1857_length_1669_cov_5.913376	246	326	0	25	80	0.3125000
NODE_1857_length_1669_cov_5.913376	246	326	2	55	80	0.6875000
NODE_1857_length_1669_cov_5.913376	299	379	0	78	80	0.9750000
NODE_1857_length_1669_cov_5.913376	299	379	2	2	80	0.0250000
NODE_1860_length_1668_cov_18.372212	1100	1180	0	8	80	0.1000000
NODE_1860_length_1668_cov_18.372212	1100	1180	2	72	80	0.9000000
NODE_1860_length_1668_cov_18.372212	1153	1233	0	42	80	0.5250000
NODE_1860_length_1668_cov_18.372212	1153	1233	2	38	80	0.4750000
NODE_1861_length_1667_cov_15.651786	902	982	10	6	80	0.0750000
NODE_1861_length_1667_cov_15.651786	902	982	12	18	80	0.2250000
NODE_1861_length_1667_cov_15.651786	902	982	13	5	80	0.0625000
NODE_1861_length_1667_cov_15.651786	902	982	14	31	80	0.3875000
NODE_1861_length_1667_cov_15.651786	902	982	15	20	80	0.2500000
NODE_1861_length_1667_cov_15.651786	955	1035	2	2	80	0.0250000
NODE_1861_length_1667_cov_15.651786	955	1035	3	2	80	0.0250000
NODE_1861_length_1667_cov_15.651786	955	1035	7	6	80	0.0750000
NODE_1861_length_1667_cov_15.651786	955	1035	8	36	80	0.4500000
NODE_1861_length_1667_cov_15.651786	955	1035	10	7	80	0.0875000
NODE_1861_length_1667_cov_15.651786	955	1035	12	2	80	0.0250000
NODE_1861_length_1667_cov_15.651786	955	1035	13	1	80	0.0125000
NODE_1861_length_1667_cov_15.651786	955	1035	14	24	80	0.3000000
NODE_1862_length_1667_cov_3.661352	649	679	0	30	30	1.0000000
NODE_1865_length_1666_cov_4.601149	1541	1623	15	12	82	0.1463415
NODE_1865_length_1666_cov_4.601149	1541	1623	19	8	82	0.0975610
NODE_1865_length_1666_cov_4.601149	1541	1623	28	24	82	0.2926829
NODE_1865_length_1666_cov_4.601149	1541	1623	30	2	82	0.0243902
NODE_1865_length_1666_cov_4.601149	1541	1623	31	36	82	0.4390244
NODE_1865_length_1666_cov_4.601149	1553	1613	19	8	60	0.1333333
NODE_1865_length_1666_cov_4.601149	1553	1613	28	14	60	0.2333333
NODE_1865_length_1666_cov_4.601149	1553	1613	30	2	60	0.0333333
NODE_1865_length_1666_cov_4.601149	1553	1613	31	36	60	0.6000000
NODE_1865_length_1666_cov_4.601149	1553	1613	19	8	60	0.1333333
NODE_1865_length_1666_cov_4.601149	1553	1613	28	14	60	0.2333333
NODE_1865_length_1666_cov_4.601149	1553	1613	30	2	60	0.0333333
NODE_1865_length_1666_cov_4.601149	1553	1613	31	36	60	0.6000000
NODE_1865_length_1666_cov_4.601149	1557	1623	19	4	66	0.0606061
NODE_1865_length_1666_cov_4.601149	1557	1623	28	24	66	0.3636364
NODE_1865_length_1666_cov_4.601149	1557	1623	30	2	66	0.0303030
NODE_1865_length_1666_cov_4.601149	1557	1623	31	36	66	0.5454546
NODE_1865_length_1666_cov_4.601149	1596	1666	4	8	70	0.1142857
NODE_1865_length_1666_cov_4.601149	1596	1666	6	1	70	0.0142857
NODE_1865_length_1666_cov_4.601149	1596	1666	16	2	70	0.0285714
NODE_1865_length_1666_cov_4.601149	1596	1666	28	56	70	0.8000000
NODE_1865_length_1666_cov_4.601149	1596	1666	30	2	70	0.0285714
NODE_1865_length_1666_cov_4.601149	1596	1666	31	1	70	0.0142857
NODE_1865_length_1666_cov_4.601149	1596	1666	4	8	70	0.1142857
NODE_1865_length_1666_cov_4.601149	1596	1666	6	1	70	0.0142857
NODE_1865_length_1666_cov_4.601149	1596	1666	16	2	70	0.0285714
NODE_1865_length_1666_cov_4.601149	1596	1666	28	56	70	0.8000000
NODE_1865_length_1666_cov_4.601149	1596	1666	30	2	70	0.0285714
NODE_1865_length_1666_cov_4.601149	1596	1666	31	1	70	0.0142857
NODE_1865_length_1666_cov_4.601149	1596	1666	4	8	70	0.1142857
NODE_1865_length_1666_cov_4.601149	1596	1666	6	1	70	0.0142857
NODE_1865_length_1666_cov_4.601149	1596	1666	16	2	70	0.0285714
NODE_1865_length_1666_cov_4.601149	1596	1666	28	56	70	0.8000000
NODE_1865_length_1666_cov_4.601149	1596	1666	30	2	70	0.0285714
NODE_1865_length_1666_cov_4.601149	1596	1666	31	1	70	0.0142857
NODE_1872_length_1662_cov_16.638516	538	618	1	19	80	0.2375000
NODE_1872_length_1662_cov_16.638516	538	618	2	61	80	0.7625000
NODE_1872_length_1662_cov_16.638516	591	671	1	3	80	0.0375000
NODE_1872_length_1662_cov_16.638516	591	671	2	77	80	0.9625000
NODE_1872_length_1662_cov_16.638516	667	747	1	27	80	0.3375000
NODE_1872_length_1662_cov_16.638516	667	747	2	1	80	0.0125000
NODE_1872_length_1662_cov_16.638516	667	747	3	12	80	0.1500000
NODE_1872_length_1662_cov_16.638516	667	747	4	40	80	0.5000000
NODE_1872_length_1662_cov_16.638516	720	800	0	19	80	0.2375000
NODE_1872_length_1662_cov_16.638516	720	800	2	2	80	0.0250000
NODE_1872_length_1662_cov_16.638516	720	800	4	59	80	0.7375000
NODE_1876_length_1660_cov_28.297886	415	495	2	32	80	0.4000000
NODE_1876_length_1660_cov_28.297886	415	495	4	27	80	0.3375000
NODE_1876_length_1660_cov_28.297886	415	495	8	21	80	0.2625000
NODE_1876_length_1660_cov_28.297886	468	548	0	22	80	0.2750000
NODE_1876_length_1660_cov_28.297886	468	548	2	58	80	0.7250000
NODE_1886_length_1654_cov_17.245016	631	711	0	80	80	1.0000000
NODE_1886_length_1654_cov_17.245016	684	764	0	80	80	1.0000000
NODE_1888_length_1653_cov_34.827542	0	41	0	41	41	1.0000000
NODE_1888_length_1653_cov_34.827542	14	44	0	30	30	1.0000000
NODE_1888_length_1653_cov_34.827542	1081	1161	0	9	80	0.1125000
NODE_1888_length_1653_cov_34.827542	1081	1161	2	41	80	0.5125000
NODE_1888_length_1653_cov_34.827542	1081	1161	4	18	80	0.2250000
NODE_1888_length_1653_cov_34.827542	1081	1161	6	11	80	0.1375000
NODE_1888_length_1653_cov_34.827542	1081	1161	8	1	80	0.0125000
NODE_1888_length_1653_cov_34.827542	1134	1214	0	9	80	0.1125000
NODE_1888_length_1653_cov_34.827542	1134	1214	2	14	80	0.1750000
NODE_1888_length_1653_cov_34.827542	1134	1214	4	49	80	0.6125000
NODE_1888_length_1653_cov_34.827542	1134	1214	5	1	80	0.0125000
NODE_1888_length_1653_cov_34.827542	1134	1214	6	7	80	0.0875000
NODE_1888_length_1653_cov_34.827542	1210	1290	1	1	80	0.0125000
NODE_1888_length_1653_cov_34.827542	1210	1290	2	23	80	0.2875000
NODE_1888_length_1653_cov_34.827542	1210	1290	6	56	80	0.7000000
NODE_1888_length_1653_cov_34.827542	1263	1339	0	49	76	0.6447368
NODE_1888_length_1653_cov_34.827542	1263	1339	1	1	76	0.0131579
NODE_1888_length_1653_cov_34.827542	1263	1339	2	23	76	0.3026316
NODE_1888_length_1653_cov_34.827542	1263	1339	6	3	76	0.0394737
NODE_1892_length_1652_cov_23.939472	1352	1432	8	80	80	1.0000000
NODE_1892_length_1652_cov_23.939472	1405	1485	0	37	80	0.4625000
NODE_1892_length_1652_cov_23.939472	1405	1485	8	43	80	0.5375000
NODE_1894_length_1651_cov_3.916881	1552	1617	2	65	65	1.0000000
NODE_1899_length_1649_cov_7.480000	774	854	0	80	80	1.0000000
NODE_1899_length_1649_cov_7.480000	827	907	0	80	80	1.0000000
NODE_1903_length_1647_cov_3.534238	1012	1075	0	63	63	1.0000000
NODE_1906_length_1645_cov_16.040103	155	235	2	80	80	1.0000000
NODE_1906_length_1645_cov_16.040103	208	288	0	10	80	0.1250000
NODE_1906_length_1645_cov_16.040103	208	288	2	70	80	0.8750000
NODE_1906_length_1645_cov_16.040103	1090	1170	0	11	80	0.1375000
NODE_1906_length_1645_cov_16.040103	1090	1170	2	69	80	0.8625000
NODE_1906_length_1645_cov_16.040103	1143	1222	0	63	79	0.7974684
NODE_1906_length_1645_cov_16.040103	1143	1222	2	16	79	0.2025317
NODE_1908_length_1644_cov_2.902913	1160	1240	6	5	80	0.0625000
NODE_1908_length_1644_cov_2.902913	1160	1240	8	4	80	0.0500000
NODE_1908_length_1644_cov_2.902913	1160	1240	10	62	80	0.7750000
NODE_1908_length_1644_cov_2.902913	1160	1240	12	9	80	0.1125000
NODE_1917_length_1641_cov_34.032425	487	567	0	80	80	1.0000000
NODE_1917_length_1641_cov_34.032425	540	620	0	31	80	0.3875000
NODE_1917_length_1641_cov_34.032425	540	620	1	11	80	0.1375000
NODE_1917_length_1641_cov_34.032425	540	620	2	38	80	0.4750000
NODE_1917_length_1641_cov_34.032425	616	696	2	80	80	1.0000000
NODE_1917_length_1641_cov_34.032425	669	749	0	17	80	0.2125000
NODE_1917_length_1641_cov_34.032425	669	749	1	11	80	0.1375000
NODE_1917_length_1641_cov_34.032425	669	749	2	52	80	0.6500000
NODE_1917_length_1641_cov_34.032425	1168	1248	2	58	80	0.7250000
NODE_1917_length_1641_cov_34.032425	1168	1248	4	22	80	0.2750000
NODE_1917_length_1641_cov_34.032425	1219	1301	2	59	82	0.7195122
NODE_1917_length_1641_cov_34.032425	1219	1301	4	23	82	0.2804878
NODE_1918_length_1641_cov_7.042802	339	390	0	51	51	1.0000000
NODE_1922_length_1640_cov_33.097339	943	1023	0	7	80	0.0875000
NODE_1922_length_1640_cov_33.097339	943	1023	4	71	80	0.8875000
NODE_1922_length_1640_cov_33.097339	943	1023	6	2	80	0.0250000
NODE_1922_length_1640_cov_33.097339	996	1076	4	25	80	0.3125000
NODE_1922_length_1640_cov_33.097339	996	1076	6	18	80	0.2250000
NODE_1922_length_1640_cov_33.097339	996	1076	8	25	80	0.3125000
NODE_1922_length_1640_cov_33.097339	996	1076	10	12	80	0.1500000
NODE_1922_length_1640_cov_33.097339	1072	1152	4	11	80	0.1375000
NODE_1922_length_1640_cov_33.097339	1072	1152	6	41	80	0.5125000
NODE_1922_length_1640_cov_33.097339	1072	1152	8	20	80	0.2500000
NODE_1922_length_1640_cov_33.097339	1072	1152	10	8	80	0.1000000
NODE_1922_length_1640_cov_33.097339	1125	1206	0	3	81	0.0370370
NODE_1922_length_1640_cov_33.097339	1125	1206	2	41	81	0.5061728
NODE_1922_length_1640_cov_33.097339	1125	1206	4	21	81	0.2592593
NODE_1922_length_1640_cov_33.097339	1125	1206	6	16	81	0.1975309
NODE_1923_length_1640_cov_18.519143	471	551	0	80	80	1.0000000
NODE_1923_length_1640_cov_18.519143	524	604	0	80	80	1.0000000
NODE_1925_length_1639_cov_6.585714	975	1056	0	81	81	1.0000000
NODE_1925_length_1639_cov_6.585714	1028	1109	0	81	81	1.0000000
NODE_1926_length_1639_cov_2.163636	1260	1334	2	32	74	0.4324324
NODE_1926_length_1639_cov_2.163636	1260	1334	3	42	74	0.5675676
NODE_1926_length_1639_cov_2.163636	1312	1387	0	16	75	0.2133333
NODE_1926_length_1639_cov_2.163636	1312	1387	2	30	75	0.4000000
NODE_1926_length_1639_cov_2.163636	1312	1387	4	4	75	0.0533333
NODE_1926_length_1639_cov_2.163636	1312	1387	6	25	75	0.3333333
NODE_1928_length_1638_cov_18.598441	443	523	0	80	80	1.0000000
NODE_1928_length_1638_cov_18.598441	496	576	0	37	80	0.4625000
NODE_1928_length_1638_cov_18.598441	496	576	2	43	80	0.5375000
NODE_1928_length_1638_cov_18.598441	1157	1237	0	80	80	1.0000000
NODE_1928_length_1638_cov_18.598441	1210	1290	0	80	80	1.0000000
NODE_1932_length_1637_cov_12.048765	410	490	0	12	80	0.1500000
NODE_1932_length_1637_cov_12.048765	410	490	2	1	80	0.0125000
NODE_1932_length_1637_cov_12.048765	410	490	4	34	80	0.4250000
NODE_1932_length_1637_cov_12.048765	410	490	6	5	80	0.0625000
NODE_1932_length_1637_cov_12.048765	410	490	8	2	80	0.0250000
NODE_1932_length_1637_cov_12.048765	410	490	10	26	80	0.3250000
NODE_1932_length_1637_cov_12.048765	463	543	2	4	80	0.0500000
NODE_1932_length_1637_cov_12.048765	463	543	4	14	80	0.1750000
NODE_1932_length_1637_cov_12.048765	463	543	6	14	80	0.1750000
NODE_1932_length_1637_cov_12.048765	463	543	8	23	80	0.2875000
NODE_1932_length_1637_cov_12.048765	463	543	10	25	80	0.3125000
NODE_1932_length_1637_cov_12.048765	1081	1161	0	17	80	0.2125000
NODE_1932_length_1637_cov_12.048765	1081	1161	4	63	80	0.7875000
NODE_1932_length_1637_cov_12.048765	1134	1214	0	70	80	0.8750000
NODE_1932_length_1637_cov_12.048765	1134	1214	4	10	80	0.1250000
NODE_1934_length_1635_cov_21.022786	958	1038	0	13	80	0.1625000
NODE_1934_length_1635_cov_21.022786	958	1038	4	67	80	0.8375000
NODE_1934_length_1635_cov_21.022786	1011	1091	0	28	80	0.3500000
NODE_1934_length_1635_cov_21.022786	1011	1091	4	52	80	0.6500000
NODE_1934_length_1635_cov_21.022786	1087	1167	0	7	80	0.0875000
NODE_1934_length_1635_cov_21.022786	1087	1167	2	73	80	0.9125000
NODE_1934_length_1635_cov_21.022786	1140	1220	0	36	80	0.4500000
NODE_1934_length_1635_cov_21.022786	1140	1220	2	44	80	0.5500000
NODE_1936_length_1633_cov_16.743807	1067	1147	0	21	80	0.2625000
NODE_1936_length_1633_cov_16.743807	1067	1147	2	3	80	0.0375000
NODE_1936_length_1633_cov_16.743807	1067	1147	6	56	80	0.7000000
NODE_1936_length_1633_cov_16.743807	1120	1200	0	28	80	0.3500000
NODE_1936_length_1633_cov_16.743807	1120	1200	4	9	80	0.1125000
NODE_1936_length_1633_cov_16.743807	1120	1200	6	43	80	0.5375000
NODE_1937_length_1633_cov_14.271838	977	1057	0	60	80	0.7500000
NODE_1937_length_1633_cov_14.271838	977	1057	2	10	80	0.1250000
NODE_1937_length_1633_cov_14.271838	977	1057	4	10	80	0.1250000
NODE_1937_length_1633_cov_14.271838	1030	1110	0	7	80	0.0875000
NODE_1937_length_1633_cov_14.271838	1030	1110	2	10	80	0.1250000
NODE_1937_length_1633_cov_14.271838	1030	1110	4	63	80	0.7875000
NODE_1937_length_1633_cov_14.271838	1106	1186	0	41	80	0.5125000
NODE_1937_length_1633_cov_14.271838	1106	1186	2	4	80	0.0500000
NODE_1937_length_1633_cov_14.271838	1106	1186	4	35	80	0.4375000
NODE_1937_length_1633_cov_14.271838	1159	1239	0	80	80	1.0000000
NODE_1939_length_1631_cov_25.881201	424	504	2	55	80	0.6875000
NODE_1939_length_1631_cov_25.881201	424	504	4	4	80	0.0500000
NODE_1939_length_1631_cov_25.881201	424	504	6	21	80	0.2625000
NODE_1939_length_1631_cov_25.881201	477	557	2	2	80	0.0250000
NODE_1939_length_1631_cov_25.881201	477	557	4	36	80	0.4500000
NODE_1939_length_1631_cov_25.881201	477	557	6	42	80	0.5250000
NODE_1939_length_1631_cov_25.881201	553	633	0	54	80	0.6750000
NODE_1939_length_1631_cov_25.881201	553	633	2	1	80	0.0125000
NODE_1939_length_1631_cov_25.881201	553	633	4	25	80	0.3125000
NODE_1939_length_1631_cov_25.881201	606	686	0	80	80	1.0000000
NODE_1943_length_1629_cov_32.733987	518	598	0	80	80	1.0000000
NODE_1943_length_1629_cov_32.733987	635	715	0	14	80	0.1750000
NODE_1943_length_1629_cov_32.733987	635	715	4	22	80	0.2750000
NODE_1943_length_1629_cov_32.733987	635	715	6	11	80	0.1375000
NODE_1943_length_1629_cov_32.733987	635	715	7	8	80	0.1000000
NODE_1943_length_1629_cov_32.733987	635	715	8	4	80	0.0500000
NODE_1943_length_1629_cov_32.733987	635	715	10	8	80	0.1000000
NODE_1943_length_1629_cov_32.733987	635	715	12	13	80	0.1625000
NODE_1943_length_1629_cov_32.733987	688	768	7	2	80	0.0250000
NODE_1943_length_1629_cov_32.733987	688	768	8	9	80	0.1125000
NODE_1943_length_1629_cov_32.733987	688	768	10	10	80	0.1250000
NODE_1943_length_1629_cov_32.733987	688	768	12	59	80	0.7375000
NODE_1946_length_1628_cov_15.551995	1454	1518	156	1	64	0.0156250
NODE_1946_length_1628_cov_15.551995	1454	1518	159	1	64	0.0156250
NODE_1946_length_1628_cov_15.551995	1454	1518	180	2	64	0.0312500
NODE_1946_length_1628_cov_15.551995	1454	1518	199	1	64	0.0156250
NODE_1946_length_1628_cov_15.551995	1454	1518	211	1	64	0.0156250
NODE_1946_length_1628_cov_15.551995	1454	1518	219	2	64	0.0312500
NODE_1946_length_1628_cov_15.551995	1454	1518	223	1	64	0.0156250
NODE_1946_length_1628_cov_15.551995	1454	1518	226	1	64	0.0156250
NODE_1946_length_1628_cov_15.551995	1454	1518	230	2	64	0.0312500
NODE_1946_length_1628_cov_15.551995	1454	1518	234	1	64	0.0156250
NODE_1946_length_1628_cov_15.551995	1454	1518	247	1	64	0.0156250
NODE_1946_length_1628_cov_15.551995	1454	1518	251	1	64	0.0156250
NODE_1946_length_1628_cov_15.551995	1454	1518	261	1	64	0.0156250
NODE_1946_length_1628_cov_15.551995	1454	1518	273	1	64	0.0156250
NODE_1946_length_1628_cov_15.551995	1454	1518	285	1	64	0.0156250
NODE_1946_length_1628_cov_15.551995	1454	1518	289	1	64	0.0156250
NODE_1946_length_1628_cov_15.551995	1454	1518	302	1	64	0.0156250
NODE_1946_length_1628_cov_15.551995	1454	1518	317	1	64	0.0156250
NODE_1946_length_1628_cov_15.551995	1454	1518	318	1	64	0.0156250
NODE_1946_length_1628_cov_15.551995	1454	1518	322	1	64	0.0156250
NODE_1946_length_1628_cov_15.551995	1454	1518	346	1	64	0.0156250
NODE_1946_length_1628_cov_15.551995	1454	1518	351	1	64	0.0156250
NODE_1946_length_1628_cov_15.551995	1454	1518	353	1	64	0.0156250
NODE_1946_length_1628_cov_15.551995	1454	1518	359	1	64	0.0156250
NODE_1946_length_1628_cov_15.551995	1454	1518	371	2	64	0.0312500
NODE_1946_length_1628_cov_15.551995	1454	1518	387	1	64	0.0156250
NODE_1946_length_1628_cov_15.551995	1454	1518	399	1	64	0.0156250
NODE_1946_length_1628_cov_15.551995	1454	1518	403	1	64	0.0156250
NODE_1946_length_1628_cov_15.551995	1454	1518	409	1	64	0.0156250
NODE_1946_length_1628_cov_15.551995	1454	1518	411	1	64	0.0156250
NODE_1946_length_1628_cov_15.551995	1454	1518	416	1	64	0.0156250
NODE_1946_length_1628_cov_15.551995	1454	1518	418	1	64	0.0156250
NODE_1946_length_1628_cov_15.551995	1454	1518	420	1	64	0.0156250
NODE_1946_length_1628_cov_15.551995	1454	1518	424	1	64	0.0156250
NODE_1946_length_1628_cov_15.551995	1454	1518	430	1	64	0.0156250
NODE_1946_length_1628_cov_15.551995	1454	1518	432	2	64	0.0312500
NODE_1946_length_1628_cov_15.551995	1454	1518	438	1	64	0.0156250
NODE_1946_length_1628_cov_15.551995	1454	1518	448	1	64	0.0156250
NODE_1946_length_1628_cov_15.551995	1454	1518	450	1	64	0.0156250
NODE_1946_length_1628_cov_15.551995	1454	1518	454	1	64	0.0156250
NODE_1946_length_1628_cov_15.551995	1454	1518	464	1	64	0.0156250
NODE_1946_length_1628_cov_15.551995	1454	1518	472	1	64	0.0156250
NODE_1946_length_1628_cov_15.551995	1454	1518	478	1	64	0.0156250
NODE_1946_length_1628_cov_15.551995	1454	1518	479	2	64	0.0312500
NODE_1946_length_1628_cov_15.551995	1454	1518	483	1	64	0.0156250
NODE_1946_length_1628_cov_15.551995	1454	1518	489	1	64	0.0156250
NODE_1946_length_1628_cov_15.551995	1454	1518	491	3	64	0.0468750
NODE_1946_length_1628_cov_15.551995	1454	1518	497	2	64	0.0312500
NODE_1946_length_1628_cov_15.551995	1454	1518	499	1	64	0.0156250
NODE_1946_length_1628_cov_15.551995	1454	1518	506	1	64	0.0156250
NODE_1946_length_1628_cov_15.551995	1454	1518	510	1	64	0.0156250
NODE_1946_length_1628_cov_15.551995	1454	1518	514	4	64	0.0625000
NODE_1947_length_1628_cov_4.852845	81	163	20	12	82	0.1463415
NODE_1947_length_1628_cov_4.852845	81	163	22	21	82	0.2560976
NODE_1947_length_1628_cov_4.852845	81	163	24	2	82	0.0243902
NODE_1947_length_1628_cov_4.852845	81	163	28	2	82	0.0243902
NODE_1947_length_1628_cov_4.852845	81	163	32	3	82	0.0365854
NODE_1947_length_1628_cov_4.852845	81	163	34	12	82	0.1463415
NODE_1947_length_1628_cov_4.852845	81	163	35	13	82	0.1585366
NODE_1947_length_1628_cov_4.852845	81	163	36	8	82	0.0975610
NODE_1947_length_1628_cov_4.852845	81	163	38	4	82	0.0487805
NODE_1947_length_1628_cov_4.852845	81	163	40	5	82	0.0609756
NODE_1952_length_1626_cov_20.549443	495	575	0	80	80	1.0000000
NODE_1952_length_1626_cov_20.549443	548	628	0	80	80	1.0000000
NODE_1953_length_1626_cov_6.552718	1189	1269	0	80	80	1.0000000
NODE_1953_length_1626_cov_6.552718	1242	1321	0	79	79	1.0000000
NODE_1954_length_1626_cov_4.728880	247	329	4	21	82	0.2560976
NODE_1954_length_1626_cov_4.728880	247	329	6	14	82	0.1707317
NODE_1954_length_1626_cov_4.728880	247	329	7	3	82	0.0365854
NODE_1954_length_1626_cov_4.728880	247	329	8	44	82	0.5365854
NODE_1954_length_1626_cov_4.728880	302	382	4	45	80	0.5625000
NODE_1954_length_1626_cov_4.728880	302	382	6	22	80	0.2750000
NODE_1954_length_1626_cov_4.728880	302	382	8	13	80	0.1625000
NODE_1956_length_1625_cov_20.598952	938	1018	0	80	80	1.0000000
NODE_1956_length_1625_cov_20.598952	991	1071	0	80	80	1.0000000
NODE_1962_length_1623_cov_28.551181	416	486	16	2	70	0.0285714
NODE_1962_length_1623_cov_28.551181	416	486	18	13	70	0.1857143
NODE_1962_length_1623_cov_28.551181	416	486	20	15	70	0.2142857
NODE_1962_length_1623_cov_28.551181	416	486	22	10	70	0.1428571
NODE_1962_length_1623_cov_28.551181	416	486	23	2	70	0.0285714
NODE_1962_length_1623_cov_28.551181	416	486	24	10	70	0.1428571
NODE_1962_length_1623_cov_28.551181	416	486	28	2	70	0.0285714
NODE_1962_length_1623_cov_28.551181	416	486	29	3	70	0.0428571
NODE_1962_length_1623_cov_28.551181	416	486	30	2	70	0.0285714
NODE_1962_length_1623_cov_28.551181	416	486	32	11	70	0.1571429
NODE_1962_length_1623_cov_28.551181	459	507	8	1	48	0.0208333
NODE_1962_length_1623_cov_28.551181	459	507	10	6	48	0.1250000
NODE_1962_length_1623_cov_28.551181	459	507	12	6	48	0.1250000
NODE_1962_length_1623_cov_28.551181	459	507	13	1	48	0.0208333
NODE_1962_length_1623_cov_28.551181	459	507	14	5	48	0.1041667
NODE_1962_length_1623_cov_28.551181	459	507	16	4	48	0.0833333
NODE_1962_length_1623_cov_28.551181	459	507	18	13	48	0.2708333
NODE_1962_length_1623_cov_28.551181	459	507	20	12	48	0.2500000
NODE_1965_length_1622_cov_7.969140	645	725	0	13	80	0.1625000
NODE_1965_length_1622_cov_7.969140	645	725	2	67	80	0.8375000
NODE_1965_length_1622_cov_7.969140	698	778	0	43	80	0.5375000
NODE_1965_length_1622_cov_7.969140	698	778	2	37	80	0.4625000
NODE_1970_length_1621_cov_2.192510	330	401	8	7	71	0.0985916
NODE_1970_length_1621_cov_2.192510	330	401	12	53	71	0.7464789
NODE_1970_length_1621_cov_2.192510	330	401	14	11	71	0.1549296
NODE_1975_length_1618_cov_44.138907	361	441	0	6	80	0.0750000
NODE_1975_length_1618_cov_44.138907	361	441	2	74	80	0.9250000
NODE_1975_length_1618_cov_44.138907	414	494	0	34	80	0.4250000
NODE_1975_length_1618_cov_44.138907	414	494	2	46	80	0.5750000
NODE_1975_length_1618_cov_44.138907	1063	1143	0	80	80	1.0000000
NODE_1975_length_1618_cov_44.138907	1116	1196	0	80	80	1.0000000
NODE_1976_length_1618_cov_5.779460	332	414	0	4	82	0.0487805
NODE_1976_length_1618_cov_5.779460	332	414	2	78	82	0.9512195
NODE_1976_length_1618_cov_5.779460	387	467	0	44	80	0.5500000
NODE_1976_length_1618_cov_5.779460	387	467	2	36	80	0.4500000
NODE_1976_length_1618_cov_5.779460	972	1028	0	56	56	1.0000000
NODE_1980_length_1616_cov_5.313777	589	669	0	80	80	1.0000000
NODE_1980_length_1616_cov_5.313777	642	722	0	80	80	1.0000000
NODE_1981_length_1615_cov_12.575858	1032	1112	4	24	80	0.3000000
NODE_1981_length_1615_cov_12.575858	1032	1112	8	56	80	0.7000000
NODE_1981_length_1615_cov_12.575858	1085	1162	0	10	77	0.1298701
NODE_1981_length_1615_cov_12.575858	1085	1162	4	37	77	0.4805195
NODE_1981_length_1615_cov_12.575858	1085	1162	8	30	77	0.3896104
NODE_1981_length_1615_cov_12.575858	1158	1238	0	80	80	1.0000000
NODE_1981_length_1615_cov_12.575858	1211	1291	0	80	80	1.0000000
NODE_1983_length_1614_cov_94.900990	0	46	0	7	46	0.1521739
NODE_1983_length_1614_cov_94.900990	0	46	2	5	46	0.1086956
NODE_1983_length_1614_cov_94.900990	0	46	4	2	46	0.0434783
NODE_1983_length_1614_cov_94.900990	0	46	6	32	46	0.6956522
NODE_1983_length_1614_cov_94.900990	23	99	6	76	76	1.0000000
NODE_1984_length_1614_cov_18.799340	655	735	0	6	80	0.0750000
NODE_1984_length_1614_cov_18.799340	655	735	2	11	80	0.1375000
NODE_1984_length_1614_cov_18.799340	655	735	4	63	80	0.7875000
NODE_1984_length_1614_cov_18.799340	708	788	0	59	80	0.7375000
NODE_1984_length_1614_cov_18.799340	708	788	2	11	80	0.1375000
NODE_1984_length_1614_cov_18.799340	708	788	4	10	80	0.1250000
NODE_1986_length_1613_cov_6.865258	1128	1203	0	3	75	0.0400000
NODE_1986_length_1613_cov_6.865258	1128	1203	2	44	75	0.5866666
NODE_1986_length_1613_cov_6.865258	1128	1203	4	10	75	0.1333333
NODE_1986_length_1613_cov_6.865258	1128	1203	6	18	75	0.2400000
NODE_1986_length_1613_cov_6.865258	1176	1256	4	48	80	0.6000000
NODE_1986_length_1613_cov_6.865258	1176	1256	6	32	80	0.4000000
NODE_1993_length_1610_cov_18.014560	1035	1115	2	4	80	0.0500000
NODE_1993_length_1610_cov_18.014560	1035	1115	6	59	80	0.7375000
NODE_1993_length_1610_cov_18.014560	1035	1115	8	17	80	0.2125000
NODE_1993_length_1610_cov_18.014560	1088	1168	2	31	80	0.3875000
NODE_1993_length_1610_cov_18.014560	1088	1168	6	42	80	0.5250000
NODE_1993_length_1610_cov_18.014560	1088	1168	8	7	80	0.0875000
NODE_2001_length_1603_cov_9.128324	1109	1189	2	20	80	0.2500000
NODE_2001_length_1603_cov_9.128324	1109	1189	4	49	80	0.6125000
NODE_2001_length_1603_cov_9.128324	1109	1189	6	11	80	0.1375000
NODE_2001_length_1603_cov_9.128324	1162	1242	4	37	80	0.4625000
NODE_2001_length_1603_cov_9.128324	1162	1242	6	35	80	0.4375000
NODE_2001_length_1603_cov_9.128324	1162	1242	7	1	80	0.0125000
NODE_2001_length_1603_cov_9.128324	1162	1242	8	7	80	0.0875000
NODE_2003_length_1602_cov_79.840319	1378	1445	48	3	67	0.0447761
NODE_2003_length_1602_cov_79.840319	1378	1445	50	1	67	0.0149254
NODE_2003_length_1602_cov_79.840319	1378	1445	51	1	67	0.0149254
NODE_2003_length_1602_cov_79.840319	1378	1445	52	7	67	0.1044776
NODE_2003_length_1602_cov_79.840319	1378	1445	54	1	67	0.0149254
NODE_2003_length_1602_cov_79.840319	1378	1445	58	1	67	0.0149254
NODE_2003_length_1602_cov_79.840319	1378	1445	60	1	67	0.0149254
NODE_2003_length_1602_cov_79.840319	1378	1445	62	3	67	0.0447761
NODE_2003_length_1602_cov_79.840319	1378	1445	64	1	67	0.0149254
NODE_2003_length_1602_cov_79.840319	1378	1445	66	2	67	0.0298507
NODE_2003_length_1602_cov_79.840319	1378	1445	67	1	67	0.0149254
NODE_2003_length_1602_cov_79.840319	1378	1445	71	1	67	0.0149254
NODE_2003_length_1602_cov_79.840319	1378	1445	73	1	67	0.0149254
NODE_2003_length_1602_cov_79.840319	1378	1445	75	1	67	0.0149254
NODE_2003_length_1602_cov_79.840319	1378	1445	77	3	67	0.0447761
NODE_2003_length_1602_cov_79.840319	1378	1445	79	1	67	0.0149254
NODE_2003_length_1602_cov_79.840319	1378	1445	87	1	67	0.0149254
NODE_2003_length_1602_cov_79.840319	1378	1445	89	1	67	0.0149254
NODE_2003_length_1602_cov_79.840319	1378	1445	92	1	67	0.0149254
NODE_2003_length_1602_cov_79.840319	1378	1445	93	1	67	0.0149254
NODE_2003_length_1602_cov_79.840319	1378	1445	94	2	67	0.0298507
NODE_2003_length_1602_cov_79.840319	1378	1445	95	3	67	0.0447761
NODE_2003_length_1602_cov_79.840319	1378	1445	96	1	67	0.0149254
NODE_2003_length_1602_cov_79.840319	1378	1445	97	3	67	0.0447761
NODE_2003_length_1602_cov_79.840319	1378	1445	98	1	67	0.0149254
NODE_2003_length_1602_cov_79.840319	1378	1445	102	1	67	0.0149254
NODE_2003_length_1602_cov_79.840319	1378	1445	104	1	67	0.0149254
NODE_2003_length_1602_cov_79.840319	1378	1445	119	1	67	0.0149254
NODE_2003_length_1602_cov_79.840319	1378	1445	120	1	67	0.0149254
NODE_2003_length_1602_cov_79.840319	1378	1445	122	1	67	0.0149254
NODE_2003_length_1602_cov_79.840319	1378	1445	124	2	67	0.0298507
NODE_2003_length_1602_cov_79.840319	1378	1445	126	1	67	0.0149254
NODE_2003_length_1602_cov_79.840319	1378	1445	128	1	67	0.0149254
NODE_2003_length_1602_cov_79.840319	1378	1445	132	1	67	0.0149254
NODE_2003_length_1602_cov_79.840319	1378	1445	138	1	67	0.0149254
NODE_2003_length_1602_cov_79.840319	1378	1445	150	1	67	0.0149254
NODE_2003_length_1602_cov_79.840319	1378	1445	154	1	67	0.0149254
NODE_2003_length_1602_cov_79.840319	1378	1445	166	2	67	0.0298507
NODE_2003_length_1602_cov_79.840319	1378	1445	168	1	67	0.0149254
NODE_2003_length_1602_cov_79.840319	1378	1445	170	1	67	0.0149254
NODE_2003_length_1602_cov_79.840319	1378	1445	178	2	67	0.0298507
NODE_2003_length_1602_cov_79.840319	1378	1445	185	1	67	0.0149254
NODE_2003_length_1602_cov_79.840319	1378	1445	186	1	67	0.0149254
NODE_2003_length_1602_cov_79.840319	1378	1445	187	1	67	0.0149254
NODE_2003_length_1602_cov_79.840319	1378	1445	189	1	67	0.0149254
NODE_2003_length_1602_cov_79.840319	1378	1445	191	1	67	0.0149254
NODE_2003_length_1602_cov_79.840319	1462	1508	31	1	46	0.0217391
NODE_2003_length_1602_cov_79.840319	1462	1508	35	24	46	0.5217391
NODE_2003_length_1602_cov_79.840319	1462	1508	36	3	46	0.0652174
NODE_2003_length_1602_cov_79.840319	1462	1508	37	1	46	0.0217391
NODE_2003_length_1602_cov_79.840319	1462	1508	40	10	46	0.2173913
NODE_2003_length_1602_cov_79.840319	1462	1508	41	7	46	0.1521739
NODE_2004_length_1602_cov_2.701264	1490	1570	6	13	80	0.1625000
NODE_2004_length_1602_cov_2.701264	1490	1570	8	7	80	0.0875000
NODE_2004_length_1602_cov_2.701264	1490	1570	9	15	80	0.1875000
NODE_2004_length_1602_cov_2.701264	1490	1570	11	45	80	0.5625000
NODE_2009_length_1600_cov_34.988008	785	865	0	7	80	0.0875000
NODE_2009_length_1600_cov_34.988008	785	865	6	4	80	0.0500000
NODE_2009_length_1600_cov_34.988008	785	865	8	25	80	0.3125000
NODE_2009_length_1600_cov_34.988008	785	865	9	2	80	0.0250000
NODE_2009_length_1600_cov_34.988008	785	865	10	26	80	0.3250000
NODE_2009_length_1600_cov_34.988008	785	865	12	16	80	0.2000000
NODE_2009_length_1600_cov_34.988008	838	918	4	36	80	0.4500000
NODE_2009_length_1600_cov_34.988008	838	918	10	24	80	0.3000000
NODE_2009_length_1600_cov_34.988008	838	918	12	20	80	0.2500000
NODE_2009_length_1600_cov_34.988008	914	994	2	21	80	0.2625000
NODE_2009_length_1600_cov_34.988008	914	994	3	2	80	0.0250000
NODE_2009_length_1600_cov_34.988008	914	994	4	30	80	0.3750000
NODE_2009_length_1600_cov_34.988008	914	994	6	27	80	0.3375000
NODE_2009_length_1600_cov_34.988008	967	1047	0	2	80	0.0250000
NODE_2009_length_1600_cov_34.988008	967	1047	2	72	80	0.9000000
NODE_2009_length_1600_cov_34.988008	967	1047	3	2	80	0.0250000
NODE_2009_length_1600_cov_34.988008	967	1047	4	4	80	0.0500000
NODE_2011_length_1600_cov_11.383744	0	72	0	72	72	1.0000000
NODE_2011_length_1600_cov_11.383744	45	99	0	54	54	1.0000000
NODE_2011_length_1600_cov_11.383744	891	971	4	10	80	0.1250000
NODE_2011_length_1600_cov_11.383744	891	971	6	15	80	0.1875000
NODE_2011_length_1600_cov_11.383744	891	971	8	55	80	0.6875000
NODE_2011_length_1600_cov_11.383744	944	1024	0	8	80	0.1000000
NODE_2011_length_1600_cov_11.383744	944	1024	2	16	80	0.2000000
NODE_2011_length_1600_cov_11.383744	944	1024	4	13	80	0.1625000
NODE_2011_length_1600_cov_11.383744	944	1024	6	11	80	0.1375000
NODE_2011_length_1600_cov_11.383744	944	1024	8	32	80	0.4000000
NODE_2013_length_1600_cov_7.236509	1037	1109	0	72	72	1.0000000
NODE_2013_length_1600_cov_7.236509	1090	1160	0	70	70	1.0000000
NODE_2018_length_1598_cov_29.337558	335	415	0	75	80	0.9375000
NODE_2018_length_1598_cov_29.337558	335	415	2	5	80	0.0625000
NODE_2018_length_1598_cov_29.337558	388	468	0	22	80	0.2750000
NODE_2018_length_1598_cov_29.337558	388	468	2	48	80	0.6000000
NODE_2018_length_1598_cov_29.337558	388	468	4	2	80	0.0250000
NODE_2018_length_1598_cov_29.337558	388	468	6	1	80	0.0125000
NODE_2018_length_1598_cov_29.337558	388	468	17	5	80	0.0625000
NODE_2018_length_1598_cov_29.337558	388	468	21	2	80	0.0250000
NODE_2018_length_1598_cov_29.337558	464	516	17	2	52	0.0384615
NODE_2018_length_1598_cov_29.337558	464	516	21	9	52	0.1730769
NODE_2018_length_1598_cov_29.337558	464	516	22	2	52	0.0384615
NODE_2018_length_1598_cov_29.337558	464	516	24	1	52	0.0192308
NODE_2018_length_1598_cov_29.337558	464	516	26	2	52	0.0384615
NODE_2018_length_1598_cov_29.337558	464	516	28	11	52	0.2115385
NODE_2018_length_1598_cov_29.337558	464	516	30	1	52	0.0192308
NODE_2018_length_1598_cov_29.337558	464	516	32	24	52	0.4615385
NODE_2018_length_1598_cov_29.337558	1026	1106	0	80	80	1.0000000
NODE_2018_length_1598_cov_29.337558	1079	1159	0	80	80	1.0000000
NODE_2019_length_1598_cov_3.730487	1117	1197	0	11	80	0.1375000
NODE_2019_length_1598_cov_3.730487	1117	1197	2	6	80	0.0750000
NODE_2019_length_1598_cov_3.730487	1117	1197	4	63	80	0.7875000
NODE_2021_length_1597_cov_7.434579	1373	1453	2	5	80	0.0625000
NODE_2021_length_1597_cov_7.434579	1373	1453	4	5	80	0.0625000
NODE_2021_length_1597_cov_7.434579	1373	1453	5	3	80	0.0375000
NODE_2021_length_1597_cov_7.434579	1373	1453	6	9	80	0.1125000
NODE_2021_length_1597_cov_7.434579	1373	1453	7	19	80	0.2375000
NODE_2021_length_1597_cov_7.434579	1373	1453	8	11	80	0.1375000
NODE_2021_length_1597_cov_7.434579	1373	1453	9	7	80	0.0875000
NODE_2021_length_1597_cov_7.434579	1373	1453	13	2	80	0.0250000
NODE_2021_length_1597_cov_7.434579	1373	1453	33	1	80	0.0125000
NODE_2021_length_1597_cov_7.434579	1373	1453	36	1	80	0.0125000
NODE_2021_length_1597_cov_7.434579	1373	1453	39	2	80	0.0250000
NODE_2021_length_1597_cov_7.434579	1373	1453	44	2	80	0.0250000
NODE_2021_length_1597_cov_7.434579	1373	1453	51	2	80	0.0250000
NODE_2021_length_1597_cov_7.434579	1373	1453	53	1	80	0.0125000
NODE_2021_length_1597_cov_7.434579	1373	1453	58	1	80	0.0125000
NODE_2021_length_1597_cov_7.434579	1373	1453	60	1	80	0.0125000
NODE_2021_length_1597_cov_7.434579	1373	1453	68	1	80	0.0125000
NODE_2021_length_1597_cov_7.434579	1373	1453	70	3	80	0.0375000
NODE_2021_length_1597_cov_7.434579	1373	1453	72	1	80	0.0125000
NODE_2021_length_1597_cov_7.434579	1373	1453	77	1	80	0.0125000
NODE_2021_length_1597_cov_7.434579	1373	1453	78	1	80	0.0125000
NODE_2021_length_1597_cov_7.434579	1373	1453	80	1	80	0.0125000
NODE_2021_length_1597_cov_7.434579	1382	1453	4	1	71	0.0140845
NODE_2021_length_1597_cov_7.434579	1382	1453	5	3	71	0.0422535
NODE_2021_length_1597_cov_7.434579	1382	1453	6	9	71	0.1267606
NODE_2021_length_1597_cov_7.434579	1382	1453	7	19	71	0.2676056
NODE_2021_length_1597_cov_7.434579	1382	1453	8	11	71	0.1549296
NODE_2021_length_1597_cov_7.434579	1382	1453	9	7	71	0.0985916
NODE_2021_length_1597_cov_7.434579	1382	1453	13	2	71	0.0281690
NODE_2021_length_1597_cov_7.434579	1382	1453	33	1	71	0.0140845
NODE_2021_length_1597_cov_7.434579	1382	1453	36	1	71	0.0140845
NODE_2021_length_1597_cov_7.434579	1382	1453	39	2	71	0.0281690
NODE_2021_length_1597_cov_7.434579	1382	1453	44	2	71	0.0281690
NODE_2021_length_1597_cov_7.434579	1382	1453	51	2	71	0.0281690
NODE_2021_length_1597_cov_7.434579	1382	1453	53	1	71	0.0140845
NODE_2021_length_1597_cov_7.434579	1382	1453	58	1	71	0.0140845
NODE_2021_length_1597_cov_7.434579	1382	1453	60	1	71	0.0140845
NODE_2021_length_1597_cov_7.434579	1382	1453	68	1	71	0.0140845
NODE_2021_length_1597_cov_7.434579	1382	1453	70	3	71	0.0422535
NODE_2021_length_1597_cov_7.434579	1382	1453	72	1	71	0.0140845
NODE_2021_length_1597_cov_7.434579	1382	1453	77	1	71	0.0140845
NODE_2021_length_1597_cov_7.434579	1382	1453	78	1	71	0.0140845
NODE_2021_length_1597_cov_7.434579	1382	1453	80	1	71	0.0140845
NODE_2022_length_1595_cov_16.788770	215	267	4	29	52	0.5576923
NODE_2022_length_1595_cov_16.788770	215	267	6	23	52	0.4423077
NODE_2022_length_1595_cov_16.788770	614	673	2	2	59	0.0338983
NODE_2022_length_1595_cov_16.788770	614	673	8	4	59	0.0677966
NODE_2022_length_1595_cov_16.788770	614	673	18	53	59	0.8983051
NODE_2025_length_1593_cov_22.412316	144	224	5	14	80	0.1750000
NODE_2025_length_1593_cov_22.412316	144	224	7	30	80	0.3750000
NODE_2025_length_1593_cov_22.412316	144	224	8	36	80	0.4500000
NODE_2025_length_1593_cov_22.412316	197	277	0	32	80	0.4000000
NODE_2025_length_1593_cov_22.412316	197	277	2	10	80	0.1250000
NODE_2025_length_1593_cov_22.412316	197	277	5	1	80	0.0125000
NODE_2025_length_1593_cov_22.412316	197	277	6	10	80	0.1250000
NODE_2025_length_1593_cov_22.412316	197	277	8	27	80	0.3375000
NODE_2025_length_1593_cov_22.412316	1192	1272	0	62	80	0.7750000
NODE_2025_length_1593_cov_22.412316	1192	1272	2	11	80	0.1375000
NODE_2025_length_1593_cov_22.412316	1192	1272	4	7	80	0.0875000
NODE_2025_length_1593_cov_22.412316	1245	1325	0	16	80	0.2000000
NODE_2025_length_1593_cov_22.412316	1245	1325	2	36	80	0.4500000
NODE_2025_length_1593_cov_22.412316	1245	1325	3	1	80	0.0125000
NODE_2025_length_1593_cov_22.412316	1245	1325	4	27	80	0.3375000
NODE_2026_length_1593_cov_14.092369	357	437	2	80	80	1.0000000
NODE_2026_length_1593_cov_14.092369	410	490	0	51	80	0.6375000
NODE_2026_length_1593_cov_14.092369	410	490	2	29	80	0.3625000
NODE_2026_length_1593_cov_14.092369	1061	1141	0	43	80	0.5375000
NODE_2026_length_1593_cov_14.092369	1061	1141	4	37	80	0.4625000
NODE_2026_length_1593_cov_14.092369	1114	1194	4	80	80	1.0000000
NODE_2031_length_1592_cov_4.576691	277	357	0	2	80	0.0250000
NODE_2031_length_1592_cov_4.576691	277	357	2	13	80	0.1625000
NODE_2031_length_1592_cov_4.576691	277	357	6	6	80	0.0750000
NODE_2031_length_1592_cov_4.576691	277	357	10	59	80	0.7375000
NODE_2031_length_1592_cov_4.576691	330	410	0	17	80	0.2125000
NODE_2031_length_1592_cov_4.576691	330	410	3	2	80	0.0250000
NODE_2031_length_1592_cov_4.576691	330	410	4	9	80	0.1125000
NODE_2031_length_1592_cov_4.576691	330	410	8	10	80	0.1250000
NODE_2031_length_1592_cov_4.576691	330	410	10	42	80	0.5250000
NODE_2034_length_1591_cov_15.481233	841	921	1	24	80	0.3000000
NODE_2034_length_1591_cov_15.481233	841	921	3	1	80	0.0125000
NODE_2034_length_1591_cov_15.481233	841	921	4	1	80	0.0125000
NODE_2034_length_1591_cov_15.481233	841	921	6	16	80	0.2000000
NODE_2034_length_1591_cov_15.481233	841	921	10	8	80	0.1000000
NODE_2034_length_1591_cov_15.481233	841	921	11	30	80	0.3750000
NODE_2034_length_1591_cov_15.481233	894	974	8	4	80	0.0500000
NODE_2034_length_1591_cov_15.481233	894	974	10	29	80	0.3625000
NODE_2034_length_1591_cov_15.481233	894	974	11	34	80	0.4250000
NODE_2034_length_1591_cov_15.481233	894	974	12	13	80	0.1625000
NODE_2035_length_1591_cov_4.040885	35	65	0	30	30	1.0000000
NODE_2035_length_1591_cov_4.040885	38	99	0	60	61	0.9836066
NODE_2035_length_1591_cov_4.040885	38	99	7	1	61	0.0163934
NODE_2042_length_1589_cov_10.184564	379	459	2	28	80	0.3500000
NODE_2042_length_1589_cov_10.184564	379	459	4	52	80	0.6500000
NODE_2042_length_1589_cov_10.184564	432	512	0	43	80	0.5375000
NODE_2042_length_1589_cov_10.184564	432	512	2	37	80	0.4625000
NODE_2042_length_1589_cov_10.184564	473	512	0	30	39	0.7692308
NODE_2042_length_1589_cov_10.184564	473	512	2	9	39	0.2307692
NODE_2042_length_1589_cov_10.184564	508	588	2	11	80	0.1375000
NODE_2042_length_1589_cov_10.184564	508	588	4	69	80	0.8625000
NODE_2042_length_1589_cov_10.184564	561	641	0	37	80	0.4625000
NODE_2042_length_1589_cov_10.184564	561	641	2	7	80	0.0875000
NODE_2042_length_1589_cov_10.184564	561	641	4	36	80	0.4500000
NODE_2043_length_1588_cov_9.955675	415	495	0	12	80	0.1500000
NODE_2043_length_1588_cov_9.955675	415	495	2	68	80	0.8500000
NODE_2043_length_1588_cov_9.955675	468	548	0	65	80	0.8125000
NODE_2043_length_1588_cov_9.955675	468	548	2	15	80	0.1875000
NODE_2046_length_1587_cov_7.942204	710	790	8	6	80	0.0750000
NODE_2046_length_1587_cov_7.942204	710	790	10	50	80	0.6250000
NODE_2046_length_1587_cov_7.942204	710	790	12	24	80	0.3000000
NODE_2046_length_1587_cov_7.942204	763	843	2	5	80	0.0625000
NODE_2046_length_1587_cov_7.942204	763	843	4	3	80	0.0375000
NODE_2046_length_1587_cov_7.942204	763	843	10	72	80	0.9000000
NODE_2049_length_1586_cov_6.488231	447	474	4	27	27	1.0000000
NODE_2049_length_1586_cov_6.488231	447	527	4	80	80	1.0000000
NODE_2049_length_1586_cov_6.488231	500	580	0	19	80	0.2375000
NODE_2049_length_1586_cov_6.488231	500	580	3	2	80	0.0250000
NODE_2049_length_1586_cov_6.488231	500	580	4	59	80	0.7375000
NODE_2056_length_1583_cov_27.825472	800	880	0	16	80	0.2000000
NODE_2056_length_1583_cov_27.825472	800	880	2	64	80	0.8000000
NODE_2056_length_1583_cov_27.825472	853	933	0	16	80	0.2000000
NODE_2056_length_1583_cov_27.825472	853	933	2	42	80	0.5250000
NODE_2056_length_1583_cov_27.825472	853	933	4	22	80	0.2750000
NODE_2056_length_1583_cov_27.825472	929	1009	4	18	80	0.2250000
NODE_2056_length_1583_cov_27.825472	929	1009	6	47	80	0.5875000
NODE_2056_length_1583_cov_27.825472	929	1009	8	15	80	0.1875000
NODE_2056_length_1583_cov_27.825472	982	1062	2	24	80	0.3000000
NODE_2056_length_1583_cov_27.825472	982	1062	4	36	80	0.4500000
NODE_2056_length_1583_cov_27.825472	982	1062	6	20	80	0.2500000
NODE_2060_length_1581_cov_10.610661	457	537	0	80	80	1.0000000
NODE_2060_length_1581_cov_10.610661	510	590	0	80	80	1.0000000
NODE_2065_length_1579_cov_7.395946	5	80	0	75	75	1.0000000
NODE_2065_length_1579_cov_7.395946	58	126	0	68	68	1.0000000
NODE_2066_length_1579_cov_7.152027	1331	1409	0	3	78	0.0384615
NODE_2066_length_1579_cov_7.152027	1331	1409	2	55	78	0.7051282
NODE_2066_length_1579_cov_7.152027	1331	1409	4	4	78	0.0512821
NODE_2066_length_1579_cov_7.152027	1331	1409	6	16	78	0.2051282
NODE_2066_length_1579_cov_7.152027	1382	1462	0	5	80	0.0625000
NODE_2066_length_1579_cov_7.152027	1382	1462	2	7	80	0.0875000
NODE_2066_length_1579_cov_7.152027	1382	1462	4	52	80	0.6500000
NODE_2066_length_1579_cov_7.152027	1382	1462	6	16	80	0.2000000
NODE_2067_length_1579_cov_6.741892	4	52	24	3	48	0.0625000
NODE_2067_length_1579_cov_6.741892	4	52	27	12	48	0.2500000
NODE_2067_length_1579_cov_6.741892	4	52	31	1	48	0.0208333
NODE_2067_length_1579_cov_6.741892	4	52	33	9	48	0.1875000
NODE_2067_length_1579_cov_6.741892	4	52	36	2	48	0.0416667
NODE_2067_length_1579_cov_6.741892	4	52	37	1	48	0.0208333
NODE_2067_length_1579_cov_6.741892	4	52	38	2	48	0.0416667
NODE_2067_length_1579_cov_6.741892	4	52	39	1	48	0.0208333
NODE_2067_length_1579_cov_6.741892	4	52	40	6	48	0.1250000
NODE_2067_length_1579_cov_6.741892	4	52	42	1	48	0.0208333
NODE_2067_length_1579_cov_6.741892	4	52	43	2	48	0.0416667
NODE_2067_length_1579_cov_6.741892	4	52	45	2	48	0.0416667
NODE_2067_length_1579_cov_6.741892	4	52	53	6	48	0.1250000
NODE_2067_length_1579_cov_6.741892	4	52	24	3	48	0.0625000
NODE_2067_length_1579_cov_6.741892	4	52	27	12	48	0.2500000
NODE_2067_length_1579_cov_6.741892	4	52	31	1	48	0.0208333
NODE_2067_length_1579_cov_6.741892	4	52	33	9	48	0.1875000
NODE_2067_length_1579_cov_6.741892	4	52	36	2	48	0.0416667
NODE_2067_length_1579_cov_6.741892	4	52	37	1	48	0.0208333
NODE_2067_length_1579_cov_6.741892	4	52	38	2	48	0.0416667
NODE_2067_length_1579_cov_6.741892	4	52	39	1	48	0.0208333
NODE_2067_length_1579_cov_6.741892	4	52	40	6	48	0.1250000
NODE_2067_length_1579_cov_6.741892	4	52	42	1	48	0.0208333
NODE_2067_length_1579_cov_6.741892	4	52	43	2	48	0.0416667
NODE_2067_length_1579_cov_6.741892	4	52	45	2	48	0.0416667
NODE_2067_length_1579_cov_6.741892	4	52	53	6	48	0.1250000
NODE_2067_length_1579_cov_6.741892	4	52	24	3	48	0.0625000
NODE_2067_length_1579_cov_6.741892	4	52	27	12	48	0.2500000
NODE_2067_length_1579_cov_6.741892	4	52	31	1	48	0.0208333
NODE_2067_length_1579_cov_6.741892	4	52	33	9	48	0.1875000
NODE_2067_length_1579_cov_6.741892	4	52	36	2	48	0.0416667
NODE_2067_length_1579_cov_6.741892	4	52	37	1	48	0.0208333
NODE_2067_length_1579_cov_6.741892	4	52	38	2	48	0.0416667
NODE_2067_length_1579_cov_6.741892	4	52	39	1	48	0.0208333
NODE_2067_length_1579_cov_6.741892	4	52	40	6	48	0.1250000
NODE_2067_length_1579_cov_6.741892	4	52	42	1	48	0.0208333
NODE_2067_length_1579_cov_6.741892	4	52	43	2	48	0.0416667
NODE_2067_length_1579_cov_6.741892	4	52	45	2	48	0.0416667
NODE_2067_length_1579_cov_6.741892	4	52	53	6	48	0.1250000
NODE_2067_length_1579_cov_6.741892	25	105	33	4	80	0.0500000
NODE_2067_length_1579_cov_6.741892	25	105	36	2	80	0.0250000
NODE_2067_length_1579_cov_6.741892	25	105	37	1	80	0.0125000
NODE_2067_length_1579_cov_6.741892	25	105	38	2	80	0.0250000
NODE_2067_length_1579_cov_6.741892	25	105	39	1	80	0.0125000
NODE_2067_length_1579_cov_6.741892	25	105	40	6	80	0.0750000
NODE_2067_length_1579_cov_6.741892	25	105	42	1	80	0.0125000
NODE_2067_length_1579_cov_6.741892	25	105	43	2	80	0.0250000
NODE_2067_length_1579_cov_6.741892	25	105	45	2	80	0.0250000
NODE_2067_length_1579_cov_6.741892	25	105	53	12	80	0.1500000
NODE_2067_length_1579_cov_6.741892	25	105	56	15	80	0.1875000
NODE_2067_length_1579_cov_6.741892	25	105	64	32	80	0.4000000
NODE_2067_length_1579_cov_6.741892	25	91	33	4	66	0.0606061
NODE_2067_length_1579_cov_6.741892	25	91	36	2	66	0.0303030
NODE_2067_length_1579_cov_6.741892	25	91	37	1	66	0.0151515
NODE_2067_length_1579_cov_6.741892	25	91	38	2	66	0.0303030
NODE_2067_length_1579_cov_6.741892	25	91	39	1	66	0.0151515
NODE_2067_length_1579_cov_6.741892	25	91	40	6	66	0.0909091
NODE_2067_length_1579_cov_6.741892	25	91	42	1	66	0.0151515
NODE_2067_length_1579_cov_6.741892	25	91	43	2	66	0.0303030
NODE_2067_length_1579_cov_6.741892	25	91	45	2	66	0.0303030
NODE_2067_length_1579_cov_6.741892	25	91	53	12	66	0.1818182
NODE_2067_length_1579_cov_6.741892	25	91	56	15	66	0.2272727
NODE_2067_length_1579_cov_6.741892	25	91	64	18	66	0.2727273
NODE_2067_length_1579_cov_6.741892	25	96	33	4	71	0.0563380
NODE_2067_length_1579_cov_6.741892	25	96	36	2	71	0.0281690
NODE_2067_length_1579_cov_6.741892	25	96	37	1	71	0.0140845
NODE_2067_length_1579_cov_6.741892	25	96	38	2	71	0.0281690
NODE_2067_length_1579_cov_6.741892	25	96	39	1	71	0.0140845
NODE_2067_length_1579_cov_6.741892	25	96	40	6	71	0.0845070
NODE_2067_length_1579_cov_6.741892	25	96	42	1	71	0.0140845
NODE_2067_length_1579_cov_6.741892	25	96	43	2	71	0.0281690
NODE_2067_length_1579_cov_6.741892	25	96	45	2	71	0.0281690
NODE_2067_length_1579_cov_6.741892	25	96	53	12	71	0.1690141
NODE_2067_length_1579_cov_6.741892	25	96	56	15	71	0.2112676
NODE_2067_length_1579_cov_6.741892	25	96	64	23	71	0.3239437
NODE_2076_length_1575_cov_4.250000	993	1073	0	80	80	1.0000000
NODE_2076_length_1575_cov_4.250000	1046	1126	0	80	80	1.0000000
NODE_2078_length_1574_cov_40.682034	551	631	0	20	80	0.2500000
NODE_2078_length_1574_cov_40.682034	551	631	2	60	80	0.7500000
NODE_2078_length_1574_cov_40.682034	604	684	0	23	80	0.2875000
NODE_2078_length_1574_cov_40.682034	604	684	2	57	80	0.7125000
NODE_2078_length_1574_cov_40.682034	680	760	2	28	80	0.3500000
NODE_2078_length_1574_cov_40.682034	680	760	4	52	80	0.6500000
NODE_2078_length_1574_cov_40.682034	733	813	0	36	80	0.4500000
NODE_2078_length_1574_cov_40.682034	733	813	2	14	80	0.1750000
NODE_2078_length_1574_cov_40.682034	733	813	4	30	80	0.3750000
NODE_2079_length_1574_cov_7.572203	1306	1386	6	48	80	0.6000000
NODE_2079_length_1574_cov_7.572203	1306	1386	8	32	80	0.4000000
NODE_2079_length_1574_cov_7.572203	1359	1439	1	6	80	0.0750000
NODE_2079_length_1574_cov_7.572203	1359	1439	3	22	80	0.2750000
NODE_2079_length_1574_cov_7.572203	1359	1439	5	25	80	0.3125000
NODE_2079_length_1574_cov_7.572203	1359	1439	6	27	80	0.3375000
NODE_2081_length_1573_cov_16.107191	437	512	0	74	75	0.9866667
NODE_2081_length_1573_cov_16.107191	437	512	2	1	75	0.0133333
NODE_2081_length_1573_cov_16.107191	485	565	0	26	80	0.3250000
NODE_2081_length_1573_cov_16.107191	485	565	2	46	80	0.5750000
NODE_2081_length_1573_cov_16.107191	485	565	4	2	80	0.0250000
NODE_2081_length_1573_cov_16.107191	485	565	6	6	80	0.0750000
NODE_2081_length_1573_cov_16.107191	561	639	6	28	78	0.3589744
NODE_2081_length_1573_cov_16.107191	561	639	8	7	78	0.0897436
NODE_2081_length_1573_cov_16.107191	561	639	10	43	78	0.5512820
NODE_2081_length_1573_cov_16.107191	612	692	0	5	80	0.0625000
NODE_2081_length_1573_cov_16.107191	612	692	2	1	80	0.0125000
NODE_2081_length_1573_cov_16.107191	612	692	4	1	80	0.0125000
NODE_2081_length_1573_cov_16.107191	612	692	8	11	80	0.1375000
NODE_2081_length_1573_cov_16.107191	612	692	10	62	80	0.7750000
NODE_2085_length_1572_cov_25.966735	359	404	154	1	45	0.0222222
NODE_2085_length_1572_cov_25.966735	359	404	156	1	45	0.0222222
NODE_2085_length_1572_cov_25.966735	359	404	163	5	45	0.1111111
NODE_2085_length_1572_cov_25.966735	359	404	165	1	45	0.0222222
NODE_2085_length_1572_cov_25.966735	359	404	166	2	45	0.0444444
NODE_2085_length_1572_cov_25.966735	359	404	168	2	45	0.0444444
NODE_2085_length_1572_cov_25.966735	359	404	169	1	45	0.0222222
NODE_2085_length_1572_cov_25.966735	359	404	170	1	45	0.0222222
NODE_2085_length_1572_cov_25.966735	359	404	174	1	45	0.0222222
NODE_2085_length_1572_cov_25.966735	359	404	176	2	45	0.0444444
NODE_2085_length_1572_cov_25.966735	359	404	182	1	45	0.0222222
NODE_2085_length_1572_cov_25.966735	359	404	183	1	45	0.0222222
NODE_2085_length_1572_cov_25.966735	359	404	184	1	45	0.0222222
NODE_2085_length_1572_cov_25.966735	359	404	186	1	45	0.0222222
NODE_2085_length_1572_cov_25.966735	359	404	196	1	45	0.0222222
NODE_2085_length_1572_cov_25.966735	359	404	201	1	45	0.0222222
NODE_2085_length_1572_cov_25.966735	359	404	204	1	45	0.0222222
NODE_2085_length_1572_cov_25.966735	359	404	207	1	45	0.0222222
NODE_2085_length_1572_cov_25.966735	359	404	215	1	45	0.0222222
NODE_2085_length_1572_cov_25.966735	359	404	222	1	45	0.0222222
NODE_2085_length_1572_cov_25.966735	359	404	224	1	45	0.0222222
NODE_2085_length_1572_cov_25.966735	359	404	229	1	45	0.0222222
NODE_2085_length_1572_cov_25.966735	359	404	231	1	45	0.0222222
NODE_2085_length_1572_cov_25.966735	359	404	233	5	45	0.1111111
NODE_2085_length_1572_cov_25.966735	359	404	237	1	45	0.0222222
NODE_2085_length_1572_cov_25.966735	359	404	241	2	45	0.0444444
NODE_2085_length_1572_cov_25.966735	359	404	242	2	45	0.0444444
NODE_2085_length_1572_cov_25.966735	359	404	243	1	45	0.0222222
NODE_2085_length_1572_cov_25.966735	359	404	245	2	45	0.0444444
NODE_2085_length_1572_cov_25.966735	359	404	246	1	45	0.0222222
NODE_2085_length_1572_cov_25.966735	359	404	250	1	45	0.0222222
NODE_2085_length_1572_cov_25.966735	405	477	123	7	72	0.0972222
NODE_2085_length_1572_cov_25.966735	405	477	124	2	72	0.0277778
NODE_2085_length_1572_cov_25.966735	405	477	125	5	72	0.0694444
NODE_2085_length_1572_cov_25.966735	405	477	126	4	72	0.0555556
NODE_2085_length_1572_cov_25.966735	405	477	127	5	72	0.0694444
NODE_2085_length_1572_cov_25.966735	405	477	128	7	72	0.0972222
NODE_2085_length_1572_cov_25.966735	405	477	129	6	72	0.0833333
NODE_2085_length_1572_cov_25.966735	405	477	130	5	72	0.0694444
NODE_2085_length_1572_cov_25.966735	405	477	131	8	72	0.1111111
NODE_2085_length_1572_cov_25.966735	405	477	133	1	72	0.0138889
NODE_2085_length_1572_cov_25.966735	405	477	138	1	72	0.0138889
NODE_2085_length_1572_cov_25.966735	405	477	144	1	72	0.0138889
NODE_2085_length_1572_cov_25.966735	405	477	145	1	72	0.0138889
NODE_2085_length_1572_cov_25.966735	405	477	146	2	72	0.0277778
NODE_2085_length_1572_cov_25.966735	405	477	147	5	72	0.0694444
NODE_2085_length_1572_cov_25.966735	405	477	149	5	72	0.0694444
NODE_2085_length_1572_cov_25.966735	405	477	152	2	72	0.0277778
NODE_2085_length_1572_cov_25.966735	405	477	154	1	72	0.0138889
NODE_2085_length_1572_cov_25.966735	405	477	155	2	72	0.0277778
NODE_2085_length_1572_cov_25.966735	405	477	158	1	72	0.0138889
NODE_2085_length_1572_cov_25.966735	405	477	159	1	72	0.0138889
NODE_2085_length_1572_cov_25.966735	1016	1096	0	34	80	0.4250000
NODE_2085_length_1572_cov_25.966735	1016	1096	1	4	80	0.0500000
NODE_2085_length_1572_cov_25.966735	1016	1096	2	42	80	0.5250000
NODE_2085_length_1572_cov_25.966735	1069	1149	0	7	80	0.0875000
NODE_2085_length_1572_cov_25.966735	1069	1149	2	73	80	0.9125000
NODE_2086_length_1572_cov_3.513238	1386	1462	4	13	76	0.1710526
NODE_2086_length_1572_cov_3.513238	1386	1462	6	9	76	0.1184211
NODE_2086_length_1572_cov_3.513238	1386	1462	8	42	76	0.5526316
NODE_2086_length_1572_cov_3.513238	1386	1462	12	12	76	0.1578947
NODE_2090_length_1570_cov_21.745071	700	780	2	1	80	0.0125000
NODE_2090_length_1570_cov_21.745071	700	780	4	29	80	0.3625000
NODE_2090_length_1570_cov_21.745071	700	780	6	17	80	0.2125000
NODE_2090_length_1570_cov_21.745071	700	780	8	10	80	0.1250000
NODE_2090_length_1570_cov_21.745071	700	780	10	23	80	0.2875000
NODE_2090_length_1570_cov_21.745071	753	833	5	9	80	0.1125000
NODE_2090_length_1570_cov_21.745071	753	833	6	12	80	0.1500000
NODE_2090_length_1570_cov_21.745071	753	833	8	42	80	0.5250000
NODE_2090_length_1570_cov_21.745071	753	833	10	17	80	0.2125000
NODE_2091_length_1570_cov_3.276003	387	467	0	80	80	1.0000000
NODE_2091_length_1570_cov_3.276003	440	520	0	80	80	1.0000000
NODE_2093_length_1569_cov_53.941497	741	821	0	5	80	0.0625000
NODE_2093_length_1569_cov_53.941497	741	821	2	29	80	0.3625000
NODE_2093_length_1569_cov_53.941497	741	821	4	3	80	0.0375000
NODE_2093_length_1569_cov_53.941497	741	821	8	43	80	0.5375000
NODE_2093_length_1569_cov_53.941497	794	874	4	15	80	0.1875000
NODE_2093_length_1569_cov_53.941497	794	874	6	5	80	0.0625000
NODE_2093_length_1569_cov_53.941497	794	874	8	60	80	0.7500000
NODE_2093_length_1569_cov_53.941497	870	950	2	31	80	0.3875000
NODE_2093_length_1569_cov_53.941497	870	950	4	21	80	0.2625000
NODE_2093_length_1569_cov_53.941497	870	950	6	28	80	0.3500000
NODE_2093_length_1569_cov_53.941497	923	1003	0	9	80	0.1125000
NODE_2093_length_1569_cov_53.941497	923	1003	2	71	80	0.8875000
NODE_2094_length_1569_cov_12.426531	640	720	0	30	80	0.3750000
NODE_2094_length_1569_cov_12.426531	640	720	2	50	80	0.6250000
NODE_2094_length_1569_cov_12.426531	693	773	2	80	80	1.0000000
NODE_2094_length_1569_cov_12.426531	769	849	0	36	80	0.4500000
NODE_2094_length_1569_cov_12.426531	769	849	2	44	80	0.5500000
NODE_2094_length_1569_cov_12.426531	822	902	0	10	80	0.1250000
NODE_2094_length_1569_cov_12.426531	822	902	2	70	80	0.8750000
NODE_2095_length_1569_cov_12.365986	450	530	4	79	80	0.9875000
NODE_2095_length_1569_cov_12.365986	450	530	6	1	80	0.0125000
NODE_2095_length_1569_cov_12.365986	450	530	4	79	80	0.9875000
NODE_2095_length_1569_cov_12.365986	450	530	6	1	80	0.0125000
NODE_2095_length_1569_cov_12.365986	503	564	2	5	61	0.0819672
NODE_2095_length_1569_cov_12.365986	503	564	4	44	61	0.7213115
NODE_2095_length_1569_cov_12.365986	503	564	6	12	61	0.1967213
NODE_2095_length_1569_cov_12.365986	503	556	2	5	53	0.0943396
NODE_2095_length_1569_cov_12.365986	503	556	4	43	53	0.8113208
NODE_2095_length_1569_cov_12.365986	503	556	6	5	53	0.0943396
NODE_2096_length_1569_cov_11.599320	798	878	0	59	80	0.7375000
NODE_2096_length_1569_cov_11.599320	798	878	2	21	80	0.2625000
NODE_2096_length_1569_cov_11.599320	851	931	0	80	80	1.0000000
NODE_2097_length_1569_cov_10.917687	521	601	0	80	80	1.0000000
NODE_2097_length_1569_cov_10.917687	574	654	0	80	80	1.0000000
NODE_2108_length_1563_cov_15.357240	590	670	0	80	80	1.0000000
NODE_2108_length_1563_cov_15.357240	643	723	0	37	80	0.4625000
NODE_2108_length_1563_cov_15.357240	643	723	1	2	80	0.0250000
NODE_2108_length_1563_cov_15.357240	643	723	2	41	80	0.5125000
NODE_2110_length_1561_cov_18.420657	354	434	0	3	80	0.0375000
NODE_2110_length_1561_cov_18.420657	354	434	2	77	80	0.9625000
NODE_2110_length_1561_cov_18.420657	407	487	0	7	80	0.0875000
NODE_2110_length_1561_cov_18.420657	407	487	2	73	80	0.9125000
NODE_2110_length_1561_cov_18.420657	483	563	0	80	80	1.0000000
NODE_2110_length_1561_cov_18.420657	536	616	0	62	80	0.7750000
NODE_2110_length_1561_cov_18.420657	536	616	2	18	80	0.2250000
NODE_2116_length_1559_cov_7.071233	347	427	4	57	80	0.7125000
NODE_2116_length_1559_cov_7.071233	347	427	6	4	80	0.0500000
NODE_2116_length_1559_cov_7.071233	347	427	7	14	80	0.1750000
NODE_2116_length_1559_cov_7.071233	347	427	8	5	80	0.0625000
NODE_2116_length_1559_cov_7.071233	400	478	2	5	78	0.0641026
NODE_2116_length_1559_cov_7.071233	400	478	4	23	78	0.2948718
NODE_2116_length_1559_cov_7.071233	400	478	6	50	78	0.6410257
NODE_2116_length_1559_cov_7.071233	1187	1238	0	1	51	0.0196078
NODE_2116_length_1559_cov_7.071233	1187	1238	2	50	51	0.9803922
NODE_2118_length_1558_cov_3.486635	338	418	0	80	80	1.0000000
NODE_2118_length_1558_cov_3.486635	391	471	0	80	80	1.0000000
NODE_2119_length_1557_cov_17.089163	542	622	0	32	80	0.4000000
NODE_2119_length_1557_cov_17.089163	542	622	2	4	80	0.0500000
NODE_2119_length_1557_cov_17.089163	542	622	4	44	80	0.5500000
NODE_2119_length_1557_cov_17.089163	595	675	2	6	80	0.0750000
NODE_2119_length_1557_cov_17.089163	595	675	4	74	80	0.9250000
NODE_2120_length_1557_cov_4.639918	0	56	0	56	56	1.0000000
NODE_2120_length_1557_cov_4.639918	49	112	0	63	63	1.0000000
NODE_2120_length_1557_cov_4.639918	85	161	0	76	76	1.0000000
NODE_2123_length_1556_cov_23.289636	456	536	2	46	80	0.5750000
NODE_2123_length_1556_cov_23.289636	456	536	4	27	80	0.3375000
NODE_2123_length_1556_cov_23.289636	456	536	6	7	80	0.0875000
NODE_2123_length_1556_cov_23.289636	509	589	2	80	80	1.0000000
NODE_2123_length_1556_cov_23.289636	681	761	0	37	80	0.4625000
NODE_2123_length_1556_cov_23.289636	681	761	1	43	80	0.5375000
NODE_2123_length_1556_cov_23.289636	734	814	1	43	80	0.5375000
NODE_2123_length_1556_cov_23.289636	734	814	2	37	80	0.4625000
NODE_2123_length_1556_cov_23.289636	1445	1525	80	4	80	0.0500000
NODE_2123_length_1556_cov_23.289636	1445	1525	81	3	80	0.0375000
NODE_2123_length_1556_cov_23.289636	1445	1525	82	73	80	0.9125000
NODE_2124_length_1556_cov_7.494166	300	380	0	74	80	0.9250000
NODE_2124_length_1556_cov_7.494166	300	380	2	6	80	0.0750000
NODE_2124_length_1556_cov_7.494166	353	433	0	21	80	0.2625000
NODE_2124_length_1556_cov_7.494166	353	433	2	59	80	0.7375000
NODE_2126_length_1555_cov_13.461538	666	746	0	40	80	0.5000000
NODE_2126_length_1555_cov_13.461538	666	746	2	40	80	0.5000000
NODE_2126_length_1555_cov_13.461538	719	799	2	44	80	0.5500000
NODE_2126_length_1555_cov_13.461538	719	799	4	36	80	0.4500000
NODE_2127_length_1554_cov_30.239175	144	226	0	6	82	0.0731707
NODE_2127_length_1554_cov_30.239175	144	226	2	26	82	0.3170732
NODE_2127_length_1554_cov_30.239175	144	226	4	50	82	0.6097561
NODE_2127_length_1554_cov_30.239175	199	279	0	6	80	0.0750000
NODE_2127_length_1554_cov_30.239175	199	279	2	22	80	0.2750000
NODE_2127_length_1554_cov_30.239175	199	279	4	2	80	0.0250000
NODE_2127_length_1554_cov_30.239175	199	279	6	2	80	0.0250000
NODE_2127_length_1554_cov_30.239175	199	279	10	3	80	0.0375000
NODE_2127_length_1554_cov_30.239175	199	279	14	2	80	0.0250000
NODE_2127_length_1554_cov_30.239175	199	279	15	5	80	0.0625000
NODE_2127_length_1554_cov_30.239175	199	279	17	3	80	0.0375000
NODE_2127_length_1554_cov_30.239175	199	279	19	5	80	0.0625000
NODE_2127_length_1554_cov_30.239175	199	279	21	2	80	0.0250000
NODE_2127_length_1554_cov_30.239175	199	279	22	2	80	0.0250000
NODE_2127_length_1554_cov_30.239175	199	279	24	2	80	0.0250000
NODE_2127_length_1554_cov_30.239175	199	279	25	4	80	0.0500000
NODE_2127_length_1554_cov_30.239175	199	279	27	3	80	0.0375000
NODE_2127_length_1554_cov_30.239175	199	279	30	1	80	0.0125000
NODE_2127_length_1554_cov_30.239175	199	279	31	1	80	0.0125000
NODE_2127_length_1554_cov_30.239175	199	279	33	2	80	0.0250000
NODE_2127_length_1554_cov_30.239175	199	279	35	6	80	0.0750000
NODE_2127_length_1554_cov_30.239175	199	279	36	1	80	0.0125000
NODE_2127_length_1554_cov_30.239175	199	279	38	2	80	0.0250000
NODE_2127_length_1554_cov_30.239175	199	279	40	1	80	0.0125000
NODE_2127_length_1554_cov_30.239175	199	279	41	1	80	0.0125000
NODE_2127_length_1554_cov_30.239175	199	279	43	2	80	0.0250000
NODE_2127_length_1554_cov_30.239175	877	903	6	26	26	1.0000000
NODE_2127_length_1554_cov_30.239175	930	1010	0	80	80	1.0000000
NODE_2127_length_1554_cov_30.239175	983	1063	0	80	80	1.0000000
NODE_2128_length_1554_cov_5.381443	1494	1554	12	2	60	0.0333333
NODE_2128_length_1554_cov_5.381443	1494	1554	16	2	60	0.0333333
NODE_2128_length_1554_cov_5.381443	1494	1554	24	3	60	0.0500000
NODE_2128_length_1554_cov_5.381443	1494	1554	26	5	60	0.0833333
NODE_2128_length_1554_cov_5.381443	1494	1554	34	1	60	0.0166667
NODE_2128_length_1554_cov_5.381443	1494	1554	40	1	60	0.0166667
NODE_2128_length_1554_cov_5.381443	1494	1554	42	3	60	0.0500000
NODE_2128_length_1554_cov_5.381443	1494	1554	44	43	60	0.7166666
NODE_2132_length_1552_cov_11.367515	379	445	0	66	66	1.0000000
NODE_2132_length_1552_cov_11.367515	418	484	0	66	66	1.0000000
NODE_2138_length_1549_cov_15.480000	1288	1368	0	20	80	0.2500000
NODE_2138_length_1549_cov_15.480000	1288	1368	2	60	80	0.7500000
NODE_2138_length_1549_cov_15.480000	1341	1421	0	39	80	0.4875000
NODE_2138_length_1549_cov_15.480000	1341	1421	2	7	80	0.0875000
NODE_2138_length_1549_cov_15.480000	1341	1421	8	34	80	0.4250000
NODE_2142_length_1548_cov_12.789510	770	850	0	80	80	1.0000000
NODE_2142_length_1548_cov_12.789510	823	903	0	80	80	1.0000000
NODE_2149_length_1546_cov_24.069800	775	855	0	80	80	1.0000000
NODE_2149_length_1546_cov_24.069800	828	908	0	80	80	1.0000000
NODE_2150_length_1546_cov_10.911541	417	497	0	1	80	0.0125000
NODE_2150_length_1546_cov_10.911541	417	497	4	79	80	0.9875000
NODE_2150_length_1546_cov_10.911541	470	550	0	54	80	0.6750000
NODE_2150_length_1546_cov_10.911541	470	550	4	26	80	0.3250000
NODE_2150_length_1546_cov_10.911541	1065	1145	0	80	80	1.0000000
NODE_2150_length_1546_cov_10.911541	1118	1198	0	80	80	1.0000000
NODE_2155_length_1543_cov_10.400970	480	560	0	51	80	0.6375000
NODE_2155_length_1543_cov_10.400970	480	560	2	29	80	0.3625000
NODE_2155_length_1543_cov_10.400970	533	613	0	80	80	1.0000000
NODE_2156_length_1543_cov_4.532548	43	98	0	55	55	1.0000000
NODE_2162_length_1541_cov_7.316921	523	603	4	6	80	0.0750000
NODE_2162_length_1541_cov_7.316921	523	603	6	21	80	0.2625000
NODE_2162_length_1541_cov_7.316921	523	603	8	6	80	0.0750000
NODE_2162_length_1541_cov_7.316921	523	603	12	47	80	0.5875000
NODE_2162_length_1541_cov_7.316921	576	658	0	18	82	0.2195122
NODE_2162_length_1541_cov_7.316921	576	658	4	11	82	0.1341463
NODE_2162_length_1541_cov_7.316921	576	658	5	1	82	0.0121951
NODE_2162_length_1541_cov_7.316921	576	658	7	6	82	0.0731707
NODE_2162_length_1541_cov_7.316921	576	658	8	3	82	0.0365854
NODE_2162_length_1541_cov_7.316921	576	658	10	8	82	0.0975610
NODE_2162_length_1541_cov_7.316921	576	658	12	35	82	0.4268293
NODE_2165_length_1539_cov_19.067361	334	414	0	80	80	1.0000000
NODE_2165_length_1539_cov_19.067361	387	467	0	80	80	1.0000000
NODE_2165_length_1539_cov_19.067361	463	543	0	80	80	1.0000000
NODE_2165_length_1539_cov_19.067361	516	596	0	80	80	1.0000000
NODE_2171_length_1538_cov_68.273801	604	684	2	7	80	0.0875000
NODE_2171_length_1538_cov_68.273801	604	684	4	32	80	0.4000000
NODE_2171_length_1538_cov_68.273801	604	684	6	12	80	0.1500000
NODE_2171_length_1538_cov_68.273801	604	684	8	5	80	0.0625000
NODE_2171_length_1538_cov_68.273801	604	684	10	20	80	0.2500000
NODE_2171_length_1538_cov_68.273801	604	684	12	4	80	0.0500000
NODE_2171_length_1538_cov_68.273801	657	737	3	4	80	0.0500000
NODE_2171_length_1538_cov_68.273801	657	737	7	3	80	0.0375000
NODE_2171_length_1538_cov_68.273801	657	737	8	3	80	0.0375000
NODE_2171_length_1538_cov_68.273801	657	737	9	21	80	0.2625000
NODE_2171_length_1538_cov_68.273801	657	737	10	23	80	0.2875000
NODE_2171_length_1538_cov_68.273801	657	737	11	22	80	0.2750000
NODE_2171_length_1538_cov_68.273801	657	737	12	4	80	0.0500000
NODE_2172_length_1538_cov_2.402363	1456	1499	4	43	43	1.0000000
NODE_2173_length_1537_cov_39.413074	782	862	2	26	80	0.3250000
NODE_2173_length_1537_cov_39.413074	782	862	4	54	80	0.6750000
NODE_2173_length_1537_cov_39.413074	835	915	0	42	80	0.5250000
NODE_2173_length_1537_cov_39.413074	835	915	2	37	80	0.4625000
NODE_2173_length_1537_cov_39.413074	835	915	4	1	80	0.0125000
NODE_2173_length_1537_cov_39.413074	911	991	0	44	80	0.5500000
NODE_2173_length_1537_cov_39.413074	911	991	2	36	80	0.4500000
NODE_2173_length_1537_cov_39.413074	964	1044	2	80	80	1.0000000
NODE_2174_length_1537_cov_30.412378	739	819	2	9	80	0.1125000
NODE_2174_length_1537_cov_30.412378	739	819	4	47	80	0.5875000
NODE_2174_length_1537_cov_30.412378	739	819	6	2	80	0.0250000
NODE_2174_length_1537_cov_30.412378	739	819	8	22	80	0.2750000
NODE_2174_length_1537_cov_30.412378	792	872	0	7	80	0.0875000
NODE_2174_length_1537_cov_30.412378	792	872	4	33	80	0.4125000
NODE_2174_length_1537_cov_30.412378	792	872	6	18	80	0.2250000
NODE_2174_length_1537_cov_30.412378	792	872	8	22	80	0.2750000
NODE_2174_length_1537_cov_30.412378	868	948	0	80	80	1.0000000
NODE_2174_length_1537_cov_30.412378	921	1001	0	80	80	1.0000000
NODE_2175_length_1537_cov_18.707232	669	749	8	15	80	0.1875000
NODE_2175_length_1537_cov_18.707232	669	749	10	65	80	0.8125000
NODE_2175_length_1537_cov_18.707232	722	802	2	23	80	0.2875000
NODE_2175_length_1537_cov_18.707232	722	802	4	9	80	0.1125000
NODE_2175_length_1537_cov_18.707232	722	802	8	30	80	0.3750000
NODE_2175_length_1537_cov_18.707232	722	802	10	18	80	0.2250000
NODE_2176_length_1536_cov_24.991649	832	912	0	11	80	0.1375000
NODE_2176_length_1536_cov_24.991649	832	912	2	54	80	0.6750000
NODE_2176_length_1536_cov_24.991649	832	912	4	15	80	0.1875000
NODE_2176_length_1536_cov_24.991649	885	965	0	64	80	0.8000000
NODE_2176_length_1536_cov_24.991649	885	965	2	16	80	0.2000000
NODE_2176_length_1536_cov_24.991649	961	1041	0	12	80	0.1500000
NODE_2176_length_1536_cov_24.991649	961	1041	2	68	80	0.8500000
NODE_2176_length_1536_cov_24.991649	1014	1094	2	28	80	0.3500000
NODE_2176_length_1536_cov_24.991649	1014	1094	4	52	80	0.6500000
NODE_2183_length_1535_cov_46.662256	992	1072	0	26	80	0.3250000
NODE_2183_length_1535_cov_46.662256	992	1072	2	54	80	0.6750000
NODE_2183_length_1535_cov_46.662256	1045	1125	2	50	80	0.6250000
NODE_2183_length_1535_cov_46.662256	1045	1125	4	13	80	0.1625000
NODE_2183_length_1535_cov_46.662256	1045	1125	6	17	80	0.2125000
NODE_2183_length_1535_cov_46.662256	1127	1203	4	76	76	1.0000000
NODE_2183_length_1535_cov_46.662256	1176	1256	0	49	80	0.6125000
NODE_2183_length_1535_cov_46.662256	1176	1256	4	31	80	0.3875000
NODE_2184_length_1535_cov_32.610724	992	1072	2	80	80	1.0000000
NODE_2184_length_1535_cov_32.610724	1045	1125	0	29	80	0.3625000
NODE_2184_length_1535_cov_32.610724	1045	1125	2	51	80	0.6375000
NODE_2184_length_1535_cov_32.610724	1121	1201	0	32	80	0.4000000
NODE_2184_length_1535_cov_32.610724	1121	1201	7	1	80	0.0125000
NODE_2184_length_1535_cov_32.610724	1121	1201	8	47	80	0.5875000
NODE_2184_length_1535_cov_32.610724	1174	1254	4	10	80	0.1250000
NODE_2184_length_1535_cov_32.610724	1174	1254	8	33	80	0.4125000
NODE_2184_length_1535_cov_32.610724	1174	1254	10	3	80	0.0375000
NODE_2184_length_1535_cov_32.610724	1174	1254	11	1	80	0.0125000
NODE_2184_length_1535_cov_32.610724	1174	1254	12	33	80	0.4125000
NODE_2185_length_1535_cov_25.406685	619	699	0	68	80	0.8500000
NODE_2185_length_1535_cov_25.406685	619	699	2	2	80	0.0250000
NODE_2185_length_1535_cov_25.406685	619	699	4	10	80	0.1250000
NODE_2185_length_1535_cov_25.406685	672	752	0	15	80	0.1875000
NODE_2185_length_1535_cov_25.406685	672	752	2	2	80	0.0250000
NODE_2185_length_1535_cov_25.406685	672	752	4	63	80	0.7875000
NODE_2190_length_1534_cov_13.542857	439	519	0	6	80	0.0750000
NODE_2190_length_1534_cov_13.542857	439	519	6	22	80	0.2750000
NODE_2190_length_1534_cov_13.542857	439	519	8	52	80	0.6500000
NODE_2190_length_1534_cov_13.542857	492	567	0	16	75	0.2133333
NODE_2190_length_1534_cov_13.542857	492	567	2	4	75	0.0533333
NODE_2190_length_1534_cov_13.542857	492	567	8	55	75	0.7333333
NODE_2197_length_1531_cov_17.336592	324	404	0	5	80	0.0625000
NODE_2197_length_1531_cov_17.336592	324	404	2	8	80	0.1000000
NODE_2197_length_1531_cov_17.336592	324	404	4	15	80	0.1875000
NODE_2197_length_1531_cov_17.336592	324	404	6	47	80	0.5875000
NODE_2197_length_1531_cov_17.336592	324	404	10	5	80	0.0625000
NODE_2198_length_1531_cov_6.267458	606	686	0	80	80	1.0000000
NODE_2198_length_1531_cov_6.267458	659	739	0	80	80	1.0000000
NODE_2199_length_1530_cov_13.514326	323	403	2	8	80	0.1000000
NODE_2199_length_1530_cov_13.514326	323	403	4	12	80	0.1500000
NODE_2199_length_1530_cov_13.514326	323	403	10	8	80	0.1000000
NODE_2199_length_1530_cov_13.514326	323	403	12	45	80	0.5625000
NODE_2199_length_1530_cov_13.514326	323	403	14	7	80	0.0875000
NODE_2199_length_1530_cov_13.514326	376	456	0	19	80	0.2375000
NODE_2199_length_1530_cov_13.514326	376	456	2	7	80	0.0875000
NODE_2199_length_1530_cov_13.514326	376	456	10	12	80	0.1500000
NODE_2199_length_1530_cov_13.514326	376	456	12	42	80	0.5250000
NODE_2199_length_1530_cov_13.514326	1465	1513	0	48	48	1.0000000
NODE_2200_length_1530_cov_9.012579	637	717	2	7	80	0.0875000
NODE_2200_length_1530_cov_9.012579	637	717	4	38	80	0.4750000
NODE_2200_length_1530_cov_9.012579	637	717	6	35	80	0.4375000
NODE_2200_length_1530_cov_9.012579	690	770	0	2	80	0.0250000
NODE_2200_length_1530_cov_9.012579	690	770	2	30	80	0.3750000
NODE_2200_length_1530_cov_9.012579	690	770	4	36	80	0.4500000
NODE_2200_length_1530_cov_9.012579	690	770	6	12	80	0.1500000
NODE_2203_length_1529_cov_21.061538	983	1063	2	8	80	0.1000000
NODE_2203_length_1529_cov_21.061538	983	1063	4	49	80	0.6125000
NODE_2203_length_1529_cov_21.061538	983	1063	6	23	80	0.2875000
NODE_2203_length_1529_cov_21.061538	1036	1116	0	1	80	0.0125000
NODE_2203_length_1529_cov_21.061538	1036	1116	2	18	80	0.2250000
NODE_2203_length_1529_cov_21.061538	1036	1116	4	17	80	0.2125000
NODE_2203_length_1529_cov_21.061538	1036	1116	6	44	80	0.5500000
NODE_2205_length_1529_cov_1.380420	219	282	0	6	63	0.0952381
NODE_2205_length_1529_cov_1.380420	219	282	2	57	63	0.9047619
NODE_2205_length_1529_cov_1.380420	272	323	2	40	51	0.7843137
NODE_2205_length_1529_cov_1.380420	272	323	4	11	51	0.2156863
NODE_2206_length_1528_cov_8.578027	449	529	0	15	80	0.1875000
NODE_2206_length_1528_cov_8.578027	449	529	2	9	80	0.1125000
NODE_2206_length_1528_cov_8.578027	449	529	4	56	80	0.7000000
NODE_2206_length_1528_cov_8.578027	502	582	4	80	80	1.0000000
NODE_2210_length_1526_cov_92.265592	986	1066	0	80	80	1.0000000
NODE_2210_length_1526_cov_92.265592	1039	1119	0	80	80	1.0000000
NODE_2211_length_1526_cov_4.051857	291	370	8	1	79	0.0126582
NODE_2211_length_1526_cov_4.051857	291	370	10	1	79	0.0126582
NODE_2211_length_1526_cov_4.051857	291	370	12	36	79	0.4556962
NODE_2211_length_1526_cov_4.051857	291	370	13	25	79	0.3164557
NODE_2211_length_1526_cov_4.051857	291	370	14	16	79	0.2025317
NODE_2213_length_1525_cov_20.232118	1014	1090	187	1	76	0.0131579
NODE_2213_length_1525_cov_20.232118	1014	1090	191	1	76	0.0131579
NODE_2213_length_1525_cov_20.232118	1014	1090	195	1	76	0.0131579
NODE_2213_length_1525_cov_20.232118	1014	1090	196	3	76	0.0394737
NODE_2213_length_1525_cov_20.232118	1014	1090	197	1	76	0.0131579
NODE_2213_length_1525_cov_20.232118	1014	1090	201	1	76	0.0131579
NODE_2213_length_1525_cov_20.232118	1014	1090	213	1	76	0.0131579
NODE_2213_length_1525_cov_20.232118	1014	1090	217	1	76	0.0131579
NODE_2213_length_1525_cov_20.232118	1014	1090	219	1	76	0.0131579
NODE_2213_length_1525_cov_20.232118	1014	1090	225	1	76	0.0131579
NODE_2213_length_1525_cov_20.232118	1014	1090	236	1	76	0.0131579
NODE_2213_length_1525_cov_20.232118	1014	1090	238	1	76	0.0131579
NODE_2213_length_1525_cov_20.232118	1014	1090	242	1	76	0.0131579
NODE_2213_length_1525_cov_20.232118	1014	1090	246	1	76	0.0131579
NODE_2213_length_1525_cov_20.232118	1014	1090	250	3	76	0.0394737
NODE_2213_length_1525_cov_20.232118	1014	1090	251	1	76	0.0131579
NODE_2213_length_1525_cov_20.232118	1014	1090	252	5	76	0.0657895
NODE_2213_length_1525_cov_20.232118	1014	1090	254	1	76	0.0131579
NODE_2213_length_1525_cov_20.232118	1014	1090	258	1	76	0.0131579
NODE_2213_length_1525_cov_20.232118	1014	1090	259	1	76	0.0131579
NODE_2213_length_1525_cov_20.232118	1014	1090	260	2	76	0.0263158
NODE_2213_length_1525_cov_20.232118	1014	1090	262	1	76	0.0131579
NODE_2213_length_1525_cov_20.232118	1014	1090	263	2	76	0.0263158
NODE_2213_length_1525_cov_20.232118	1014	1090	264	1	76	0.0131579
NODE_2213_length_1525_cov_20.232118	1014	1090	267	2	76	0.0263158
NODE_2213_length_1525_cov_20.232118	1014	1090	271	3	76	0.0394737
NODE_2213_length_1525_cov_20.232118	1014	1090	274	1	76	0.0131579
NODE_2213_length_1525_cov_20.232118	1014	1090	275	2	76	0.0263158
NODE_2213_length_1525_cov_20.232118	1014	1090	276	1	76	0.0131579
NODE_2213_length_1525_cov_20.232118	1014	1090	277	4	76	0.0526316
NODE_2213_length_1525_cov_20.232118	1014	1090	278	2	76	0.0263158
NODE_2213_length_1525_cov_20.232118	1014	1090	279	4	76	0.0526316
NODE_2213_length_1525_cov_20.232118	1014	1090	281	5	76	0.0657895
NODE_2213_length_1525_cov_20.232118	1014	1090	282	1	76	0.0131579
NODE_2213_length_1525_cov_20.232118	1014	1090	284	8	76	0.1052632
NODE_2213_length_1525_cov_20.232118	1014	1090	286	2	76	0.0263158
NODE_2213_length_1525_cov_20.232118	1014	1090	288	2	76	0.0263158
NODE_2213_length_1525_cov_20.232118	1014	1090	290	2	76	0.0263158
NODE_2213_length_1525_cov_20.232118	1014	1090	292	3	76	0.0394737
NODE_2213_length_1525_cov_20.232118	1281	1338	0	57	57	1.0000000
NODE_2214_length_1525_cov_11.421459	804	884	3	8	80	0.1000000
NODE_2214_length_1525_cov_11.421459	804	884	4	12	80	0.1500000
NODE_2214_length_1525_cov_11.421459	804	884	5	51	80	0.6375000
NODE_2214_length_1525_cov_11.421459	804	884	6	9	80	0.1125000
NODE_2214_length_1525_cov_11.421459	857	937	3	19	80	0.2375000
NODE_2214_length_1525_cov_11.421459	857	937	5	61	80	0.7625000
NODE_2217_length_1524_cov_130.874386	171	243	181	2	72	0.0277778
NODE_2217_length_1524_cov_130.874386	171	243	186	1	72	0.0138889
NODE_2217_length_1524_cov_130.874386	171	243	189	3	72	0.0416667
NODE_2217_length_1524_cov_130.874386	171	243	190	1	72	0.0138889
NODE_2217_length_1524_cov_130.874386	171	243	192	1	72	0.0138889
NODE_2217_length_1524_cov_130.874386	171	243	194	1	72	0.0138889
NODE_2217_length_1524_cov_130.874386	171	243	200	1	72	0.0138889
NODE_2217_length_1524_cov_130.874386	171	243	204	1	72	0.0138889
NODE_2217_length_1524_cov_130.874386	171	243	216	1	72	0.0138889
NODE_2217_length_1524_cov_130.874386	171	243	218	1	72	0.0138889
NODE_2217_length_1524_cov_130.874386	171	243	224	1	72	0.0138889
NODE_2217_length_1524_cov_130.874386	171	243	228	1	72	0.0138889
NODE_2217_length_1524_cov_130.874386	171	243	234	3	72	0.0416667
NODE_2217_length_1524_cov_130.874386	171	243	236	1	72	0.0138889
NODE_2217_length_1524_cov_130.874386	171	243	242	1	72	0.0138889
NODE_2217_length_1524_cov_130.874386	171	243	243	1	72	0.0138889
NODE_2217_length_1524_cov_130.874386	171	243	259	1	72	0.0138889
NODE_2217_length_1524_cov_130.874386	171	243	270	1	72	0.0138889
NODE_2217_length_1524_cov_130.874386	171	243	272	1	72	0.0138889
NODE_2217_length_1524_cov_130.874386	171	243	276	1	72	0.0138889
NODE_2217_length_1524_cov_130.874386	171	243	293	1	72	0.0138889
NODE_2217_length_1524_cov_130.874386	171	243	297	1	72	0.0138889
NODE_2217_length_1524_cov_130.874386	171	243	315	1	72	0.0138889
NODE_2217_length_1524_cov_130.874386	171	243	323	1	72	0.0138889
NODE_2217_length_1524_cov_130.874386	171	243	350	1	72	0.0138889
NODE_2217_length_1524_cov_130.874386	171	243	358	1	72	0.0138889
NODE_2217_length_1524_cov_130.874386	171	243	362	1	72	0.0138889
NODE_2217_length_1524_cov_130.874386	171	243	378	1	72	0.0138889
NODE_2217_length_1524_cov_130.874386	171	243	382	1	72	0.0138889
NODE_2217_length_1524_cov_130.874386	171	243	384	2	72	0.0277778
NODE_2217_length_1524_cov_130.874386	171	243	385	3	72	0.0416667
NODE_2217_length_1524_cov_130.874386	171	243	387	2	72	0.0277778
NODE_2217_length_1524_cov_130.874386	171	243	389	1	72	0.0138889
NODE_2217_length_1524_cov_130.874386	171	243	390	2	72	0.0277778
NODE_2217_length_1524_cov_130.874386	171	243	391	2	72	0.0277778
NODE_2217_length_1524_cov_130.874386	171	243	392	1	72	0.0138889
NODE_2217_length_1524_cov_130.874386	171	243	397	1	72	0.0138889
NODE_2217_length_1524_cov_130.874386	171	243	398	2	72	0.0277778
NODE_2217_length_1524_cov_130.874386	171	243	399	1	72	0.0138889
NODE_2217_length_1524_cov_130.874386	171	243	401	1	72	0.0138889
NODE_2217_length_1524_cov_130.874386	171	243	403	1	72	0.0138889
NODE_2217_length_1524_cov_130.874386	171	243	404	2	72	0.0277778
NODE_2217_length_1524_cov_130.874386	171	243	405	1	72	0.0138889
NODE_2217_length_1524_cov_130.874386	171	243	406	2	72	0.0277778
NODE_2217_length_1524_cov_130.874386	171	243	408	1	72	0.0138889
NODE_2217_length_1524_cov_130.874386	171	243	409	3	72	0.0416667
NODE_2217_length_1524_cov_130.874386	171	243	410	2	72	0.0277778
NODE_2217_length_1524_cov_130.874386	171	243	411	1	72	0.0138889
NODE_2217_length_1524_cov_130.874386	171	243	412	2	72	0.0277778
NODE_2217_length_1524_cov_130.874386	171	243	413	1	72	0.0138889
NODE_2217_length_1524_cov_130.874386	171	243	414	1	72	0.0138889
NODE_2217_length_1524_cov_130.874386	171	243	415	1	72	0.0138889
NODE_2217_length_1524_cov_130.874386	171	243	416	2	72	0.0277778
NODE_2217_length_1524_cov_130.874386	191	247	243	1	56	0.0178571
NODE_2217_length_1524_cov_130.874386	191	247	259	1	56	0.0178571
NODE_2217_length_1524_cov_130.874386	191	247	270	1	56	0.0178571
NODE_2217_length_1524_cov_130.874386	191	247	272	1	56	0.0178571
NODE_2217_length_1524_cov_130.874386	191	247	276	1	56	0.0178571
NODE_2217_length_1524_cov_130.874386	191	247	293	1	56	0.0178571
NODE_2217_length_1524_cov_130.874386	191	247	297	1	56	0.0178571
NODE_2217_length_1524_cov_130.874386	191	247	315	1	56	0.0178571
NODE_2217_length_1524_cov_130.874386	191	247	323	1	56	0.0178571
NODE_2217_length_1524_cov_130.874386	191	247	350	1	56	0.0178571
NODE_2217_length_1524_cov_130.874386	191	247	358	1	56	0.0178571
NODE_2217_length_1524_cov_130.874386	191	247	362	1	56	0.0178571
NODE_2217_length_1524_cov_130.874386	191	247	378	1	56	0.0178571
NODE_2217_length_1524_cov_130.874386	191	247	381	1	56	0.0178571
NODE_2217_length_1524_cov_130.874386	191	247	382	2	56	0.0357143
NODE_2217_length_1524_cov_130.874386	191	247	383	1	56	0.0178571
NODE_2217_length_1524_cov_130.874386	191	247	384	2	56	0.0357143
NODE_2217_length_1524_cov_130.874386	191	247	385	3	56	0.0535714
NODE_2217_length_1524_cov_130.874386	191	247	387	3	56	0.0535714
NODE_2217_length_1524_cov_130.874386	191	247	389	1	56	0.0178571
NODE_2217_length_1524_cov_130.874386	191	247	390	2	56	0.0357143
NODE_2217_length_1524_cov_130.874386	191	247	391	2	56	0.0357143
NODE_2217_length_1524_cov_130.874386	191	247	392	1	56	0.0178571
NODE_2217_length_1524_cov_130.874386	191	247	397	1	56	0.0178571
NODE_2217_length_1524_cov_130.874386	191	247	398	2	56	0.0357143
NODE_2217_length_1524_cov_130.874386	191	247	399	1	56	0.0178571
NODE_2217_length_1524_cov_130.874386	191	247	401	1	56	0.0178571
NODE_2217_length_1524_cov_130.874386	191	247	403	1	56	0.0178571
NODE_2217_length_1524_cov_130.874386	191	247	404	2	56	0.0357143
NODE_2217_length_1524_cov_130.874386	191	247	405	1	56	0.0178571
NODE_2217_length_1524_cov_130.874386	191	247	406	2	56	0.0357143
NODE_2217_length_1524_cov_130.874386	191	247	408	1	56	0.0178571
NODE_2217_length_1524_cov_130.874386	191	247	409	3	56	0.0535714
NODE_2217_length_1524_cov_130.874386	191	247	410	2	56	0.0357143
NODE_2217_length_1524_cov_130.874386	191	247	411	1	56	0.0178571
NODE_2217_length_1524_cov_130.874386	191	247	412	2	56	0.0357143
NODE_2217_length_1524_cov_130.874386	191	247	413	1	56	0.0178571
NODE_2217_length_1524_cov_130.874386	191	247	414	1	56	0.0178571
NODE_2217_length_1524_cov_130.874386	191	247	415	1	56	0.0178571
NODE_2217_length_1524_cov_130.874386	191	247	416	2	56	0.0357143
NODE_2217_length_1524_cov_130.874386	219	296	234	1	77	0.0129870
NODE_2217_length_1524_cov_130.874386	219	296	250	1	77	0.0129870
NODE_2217_length_1524_cov_130.874386	219	296	260	1	77	0.0129870
NODE_2217_length_1524_cov_130.874386	219	296	264	1	77	0.0129870
NODE_2217_length_1524_cov_130.874386	219	296	266	1	77	0.0129870
NODE_2217_length_1524_cov_130.874386	219	296	276	1	77	0.0129870
NODE_2217_length_1524_cov_130.874386	219	296	280	2	77	0.0259740
NODE_2217_length_1524_cov_130.874386	219	296	286	1	77	0.0129870
NODE_2217_length_1524_cov_130.874386	219	296	292	1	77	0.0129870
NODE_2217_length_1524_cov_130.874386	219	296	298	2	77	0.0259740
NODE_2217_length_1524_cov_130.874386	219	296	306	2	77	0.0259740
NODE_2217_length_1524_cov_130.874386	219	296	317	1	77	0.0129870
NODE_2217_length_1524_cov_130.874386	219	296	319	1	77	0.0129870
NODE_2217_length_1524_cov_130.874386	219	296	325	1	77	0.0129870
NODE_2217_length_1524_cov_130.874386	219	296	327	3	77	0.0389610
NODE_2217_length_1524_cov_130.874386	219	296	328	2	77	0.0259740
NODE_2217_length_1524_cov_130.874386	219	296	331	1	77	0.0129870
NODE_2217_length_1524_cov_130.874386	219	296	333	1	77	0.0129870
NODE_2217_length_1524_cov_130.874386	219	296	337	1	77	0.0129870
NODE_2217_length_1524_cov_130.874386	219	296	339	1	77	0.0129870
NODE_2217_length_1524_cov_130.874386	219	296	342	1	77	0.0129870
NODE_2217_length_1524_cov_130.874386	219	296	344	1	77	0.0129870
NODE_2217_length_1524_cov_130.874386	219	296	347	2	77	0.0259740
NODE_2217_length_1524_cov_130.874386	219	296	349	1	77	0.0129870
NODE_2217_length_1524_cov_130.874386	219	296	351	1	77	0.0129870
NODE_2217_length_1524_cov_130.874386	219	296	353	1	77	0.0129870
NODE_2217_length_1524_cov_130.874386	219	296	354	1	77	0.0129870
NODE_2217_length_1524_cov_130.874386	219	296	356	1	77	0.0129870
NODE_2217_length_1524_cov_130.874386	219	296	358	1	77	0.0129870
NODE_2217_length_1524_cov_130.874386	219	296	360	1	77	0.0129870
NODE_2217_length_1524_cov_130.874386	219	296	364	1	77	0.0129870
NODE_2217_length_1524_cov_130.874386	219	296	366	1	77	0.0129870
NODE_2217_length_1524_cov_130.874386	219	296	370	2	77	0.0259740
NODE_2217_length_1524_cov_130.874386	219	296	374	4	77	0.0519481
NODE_2217_length_1524_cov_130.874386	219	296	376	3	77	0.0389610
NODE_2217_length_1524_cov_130.874386	219	296	378	1	77	0.0129870
NODE_2217_length_1524_cov_130.874386	219	296	381	1	77	0.0129870
NODE_2217_length_1524_cov_130.874386	219	296	382	2	77	0.0259740
NODE_2217_length_1524_cov_130.874386	219	296	383	1	77	0.0129870
NODE_2217_length_1524_cov_130.874386	219	296	384	2	77	0.0259740
NODE_2217_length_1524_cov_130.874386	219	296	385	3	77	0.0389610
NODE_2217_length_1524_cov_130.874386	219	296	387	3	77	0.0389610
NODE_2217_length_1524_cov_130.874386	219	296	389	1	77	0.0129870
NODE_2217_length_1524_cov_130.874386	219	296	390	2	77	0.0259740
NODE_2217_length_1524_cov_130.874386	219	296	391	1	77	0.0129870
NODE_2217_length_1524_cov_130.874386	219	296	392	1	77	0.0129870
NODE_2217_length_1524_cov_130.874386	219	296	397	1	77	0.0129870
NODE_2217_length_1524_cov_130.874386	219	296	398	2	77	0.0259740
NODE_2217_length_1524_cov_130.874386	219	296	399	1	77	0.0129870
NODE_2217_length_1524_cov_130.874386	219	296	401	1	77	0.0129870
NODE_2217_length_1524_cov_130.874386	219	296	403	1	77	0.0129870
NODE_2217_length_1524_cov_130.874386	219	296	405	1	77	0.0129870
NODE_2217_length_1524_cov_130.874386	219	296	408	1	77	0.0129870
NODE_2217_length_1524_cov_130.874386	219	296	409	3	77	0.0389610
NODE_2217_length_1524_cov_130.874386	253	333	68	3	80	0.0375000
NODE_2217_length_1524_cov_130.874386	253	333	72	1	80	0.0125000
NODE_2217_length_1524_cov_130.874386	253	333	76	1	80	0.0125000
NODE_2217_length_1524_cov_130.874386	253	333	78	1	80	0.0125000
NODE_2217_length_1524_cov_130.874386	253	333	82	3	80	0.0375000
NODE_2217_length_1524_cov_130.874386	253	333	84	2	80	0.0250000
NODE_2217_length_1524_cov_130.874386	253	333	93	1	80	0.0125000
NODE_2217_length_1524_cov_130.874386	253	333	99	1	80	0.0125000
NODE_2217_length_1524_cov_130.874386	253	333	100	1	80	0.0125000
NODE_2217_length_1524_cov_130.874386	253	333	106	1	80	0.0125000
NODE_2217_length_1524_cov_130.874386	253	333	110	1	80	0.0125000
NODE_2217_length_1524_cov_130.874386	253	333	112	1	80	0.0125000
NODE_2217_length_1524_cov_130.874386	253	333	120	1	80	0.0125000
NODE_2217_length_1524_cov_130.874386	253	333	126	1	80	0.0125000
NODE_2217_length_1524_cov_130.874386	253	333	128	1	80	0.0125000
NODE_2217_length_1524_cov_130.874386	253	333	130	1	80	0.0125000
NODE_2217_length_1524_cov_130.874386	253	333	132	1	80	0.0125000
NODE_2217_length_1524_cov_130.874386	253	333	139	1	80	0.0125000
NODE_2217_length_1524_cov_130.874386	253	333	145	2	80	0.0250000
NODE_2217_length_1524_cov_130.874386	253	333	151	1	80	0.0125000
NODE_2217_length_1524_cov_130.874386	253	333	155	1	80	0.0125000
NODE_2217_length_1524_cov_130.874386	253	333	163	1	80	0.0125000
NODE_2217_length_1524_cov_130.874386	253	333	177	1	80	0.0125000
NODE_2217_length_1524_cov_130.874386	253	333	190	1	80	0.0125000
NODE_2217_length_1524_cov_130.874386	253	333	196	1	80	0.0125000
NODE_2217_length_1524_cov_130.874386	253	333	200	1	80	0.0125000
NODE_2217_length_1524_cov_130.874386	253	333	212	1	80	0.0125000
NODE_2217_length_1524_cov_130.874386	253	333	221	1	80	0.0125000
NODE_2217_length_1524_cov_130.874386	253	333	225	1	80	0.0125000
NODE_2217_length_1524_cov_130.874386	253	333	226	1	80	0.0125000
NODE_2217_length_1524_cov_130.874386	253	333	228	1	80	0.0125000
NODE_2217_length_1524_cov_130.874386	253	333	234	1	80	0.0125000
NODE_2217_length_1524_cov_130.874386	253	333	250	1	80	0.0125000
NODE_2217_length_1524_cov_130.874386	253	333	260	1	80	0.0125000
NODE_2217_length_1524_cov_130.874386	253	333	264	1	80	0.0125000
NODE_2217_length_1524_cov_130.874386	253	333	266	1	80	0.0125000
NODE_2217_length_1524_cov_130.874386	253	333	276	1	80	0.0125000
NODE_2217_length_1524_cov_130.874386	253	333	280	2	80	0.0250000
NODE_2217_length_1524_cov_130.874386	253	333	286	1	80	0.0125000
NODE_2217_length_1524_cov_130.874386	253	333	292	1	80	0.0125000
NODE_2217_length_1524_cov_130.874386	253	333	298	2	80	0.0250000
NODE_2217_length_1524_cov_130.874386	253	333	306	2	80	0.0250000
NODE_2217_length_1524_cov_130.874386	253	333	317	1	80	0.0125000
NODE_2217_length_1524_cov_130.874386	253	333	319	1	80	0.0125000
NODE_2217_length_1524_cov_130.874386	253	333	325	1	80	0.0125000
NODE_2217_length_1524_cov_130.874386	253	333	327	3	80	0.0375000
NODE_2217_length_1524_cov_130.874386	253	333	328	2	80	0.0250000
NODE_2217_length_1524_cov_130.874386	253	333	331	1	80	0.0125000
NODE_2217_length_1524_cov_130.874386	253	333	333	1	80	0.0125000
NODE_2217_length_1524_cov_130.874386	253	333	337	1	80	0.0125000
NODE_2217_length_1524_cov_130.874386	253	333	339	1	80	0.0125000
NODE_2217_length_1524_cov_130.874386	253	333	342	1	80	0.0125000
NODE_2217_length_1524_cov_130.874386	253	333	344	1	80	0.0125000
NODE_2217_length_1524_cov_130.874386	253	333	347	2	80	0.0250000
NODE_2217_length_1524_cov_130.874386	253	333	349	1	80	0.0125000
NODE_2217_length_1524_cov_130.874386	253	333	351	1	80	0.0125000
NODE_2217_length_1524_cov_130.874386	253	333	353	1	80	0.0125000
NODE_2217_length_1524_cov_130.874386	253	333	354	1	80	0.0125000
NODE_2217_length_1524_cov_130.874386	253	333	356	1	80	0.0125000
NODE_2217_length_1524_cov_130.874386	253	333	358	1	80	0.0125000
NODE_2217_length_1524_cov_130.874386	253	333	360	1	80	0.0125000
NODE_2217_length_1524_cov_130.874386	253	333	364	1	80	0.0125000
NODE_2217_length_1524_cov_130.874386	253	333	366	1	80	0.0125000
NODE_2217_length_1524_cov_130.874386	253	333	370	2	80	0.0250000
NODE_2217_length_1524_cov_130.874386	253	333	374	2	80	0.0250000
NODE_2217_length_1524_cov_130.874386	306	386	23	1	80	0.0125000
NODE_2217_length_1524_cov_130.874386	306	386	26	1	80	0.0125000
NODE_2217_length_1524_cov_130.874386	306	386	35	1	80	0.0125000
NODE_2217_length_1524_cov_130.874386	306	386	37	2	80	0.0250000
NODE_2217_length_1524_cov_130.874386	306	386	39	3	80	0.0375000
NODE_2217_length_1524_cov_130.874386	306	386	40	8	80	0.1000000
NODE_2217_length_1524_cov_130.874386	306	386	41	5	80	0.0625000
NODE_2217_length_1524_cov_130.874386	306	386	42	1	80	0.0125000
NODE_2217_length_1524_cov_130.874386	306	386	44	2	80	0.0250000
NODE_2217_length_1524_cov_130.874386	306	386	46	2	80	0.0250000
NODE_2217_length_1524_cov_130.874386	306	386	48	5	80	0.0625000
NODE_2217_length_1524_cov_130.874386	306	386	49	1	80	0.0125000
NODE_2217_length_1524_cov_130.874386	306	386	50	3	80	0.0375000
NODE_2217_length_1524_cov_130.874386	306	386	54	1	80	0.0125000
NODE_2217_length_1524_cov_130.874386	306	386	55	4	80	0.0500000
NODE_2217_length_1524_cov_130.874386	306	386	56	3	80	0.0375000
NODE_2217_length_1524_cov_130.874386	306	386	58	8	80	0.1000000
NODE_2217_length_1524_cov_130.874386	306	386	60	1	80	0.0125000
NODE_2217_length_1524_cov_130.874386	306	386	62	1	80	0.0125000
NODE_2217_length_1524_cov_130.874386	306	386	68	3	80	0.0375000
NODE_2217_length_1524_cov_130.874386	306	386	72	1	80	0.0125000
NODE_2217_length_1524_cov_130.874386	306	386	76	1	80	0.0125000
NODE_2217_length_1524_cov_130.874386	306	386	78	1	80	0.0125000
NODE_2217_length_1524_cov_130.874386	306	386	82	3	80	0.0375000
NODE_2217_length_1524_cov_130.874386	306	386	84	2	80	0.0250000
NODE_2217_length_1524_cov_130.874386	306	386	93	1	80	0.0125000
NODE_2217_length_1524_cov_130.874386	306	386	99	1	80	0.0125000
NODE_2217_length_1524_cov_130.874386	306	386	100	1	80	0.0125000
NODE_2217_length_1524_cov_130.874386	306	386	106	1	80	0.0125000
NODE_2217_length_1524_cov_130.874386	306	386	110	1	80	0.0125000
NODE_2217_length_1524_cov_130.874386	306	386	112	1	80	0.0125000
NODE_2217_length_1524_cov_130.874386	306	386	120	1	80	0.0125000
NODE_2217_length_1524_cov_130.874386	306	386	126	1	80	0.0125000
NODE_2217_length_1524_cov_130.874386	306	386	128	1	80	0.0125000
NODE_2217_length_1524_cov_130.874386	306	386	130	1	80	0.0125000
NODE_2217_length_1524_cov_130.874386	306	386	132	1	80	0.0125000
NODE_2217_length_1524_cov_130.874386	306	386	139	1	80	0.0125000
NODE_2217_length_1524_cov_130.874386	306	386	145	2	80	0.0250000
NODE_2217_length_1524_cov_130.874386	306	386	151	1	80	0.0125000
NODE_2217_length_1524_cov_130.874386	306	386	155	1	80	0.0125000
NODE_2219_length_1523_cov_24.115169	366	446	2	80	80	1.0000000
NODE_2219_length_1523_cov_24.115169	419	499	1	44	80	0.5500000
NODE_2219_length_1523_cov_24.115169	419	499	2	36	80	0.4500000
NODE_2219_length_1523_cov_24.115169	495	575	0	69	80	0.8625000
NODE_2219_length_1523_cov_24.115169	495	575	1	11	80	0.1375000
NODE_2219_length_1523_cov_24.115169	548	628	0	34	80	0.4250000
NODE_2219_length_1523_cov_24.115169	548	628	2	46	80	0.5750000
NODE_2223_length_1522_cov_13.278988	361	441	2	80	80	1.0000000
NODE_2223_length_1522_cov_13.278988	414	494	2	71	80	0.8875000
NODE_2223_length_1522_cov_13.278988	414	494	4	9	80	0.1125000
NODE_2225_length_1521_cov_20.965541	772	852	0	15	80	0.1875000
NODE_2225_length_1521_cov_20.965541	772	852	2	9	80	0.1125000
NODE_2225_length_1521_cov_20.965541	772	852	4	56	80	0.7000000
NODE_2225_length_1521_cov_20.965541	825	905	2	9	80	0.1125000
NODE_2225_length_1521_cov_20.965541	825	905	4	71	80	0.8875000
NODE_2226_length_1521_cov_15.381153	907	987	0	22	80	0.2750000
NODE_2226_length_1521_cov_15.381153	907	987	2	58	80	0.7250000
NODE_2226_length_1521_cov_15.381153	960	1040	0	75	80	0.9375000
NODE_2226_length_1521_cov_15.381153	960	1040	2	5	80	0.0625000
NODE_2226_length_1521_cov_15.381153	988	1040	0	52	52	1.0000000
NODE_2227_length_1521_cov_7.682138	525	605	0	80	80	1.0000000
NODE_2227_length_1521_cov_7.682138	578	658	0	80	80	1.0000000
NODE_2236_length_1519_cov_20.792958	714	794	26	21	80	0.2625000
NODE_2236_length_1519_cov_20.792958	714	794	28	20	80	0.2500000
NODE_2236_length_1519_cov_20.792958	714	794	30	7	80	0.0875000
NODE_2236_length_1519_cov_20.792958	714	794	32	32	80	0.4000000
NODE_2236_length_1519_cov_20.792958	767	847	0	26	80	0.3250000
NODE_2236_length_1519_cov_20.792958	767	847	4	5	80	0.0625000
NODE_2236_length_1519_cov_20.792958	767	847	6	3	80	0.0375000
NODE_2236_length_1519_cov_20.792958	767	847	12	2	80	0.0250000
NODE_2236_length_1519_cov_20.792958	767	847	14	6	80	0.0750000
NODE_2236_length_1519_cov_20.792958	767	847	17	1	80	0.0125000
NODE_2236_length_1519_cov_20.792958	767	847	18	2	80	0.0250000
NODE_2236_length_1519_cov_20.792958	767	847	20	1	80	0.0125000
NODE_2236_length_1519_cov_20.792958	767	847	22	3	80	0.0375000
NODE_2236_length_1519_cov_20.792958	767	847	24	2	80	0.0250000
NODE_2236_length_1519_cov_20.792958	767	847	26	8	80	0.1000000
NODE_2236_length_1519_cov_20.792958	767	847	28	19	80	0.2375000
NODE_2236_length_1519_cov_20.792958	767	847	30	2	80	0.0250000
NODE_2239_length_1517_cov_24.074048	413	450	4	15	37	0.4054054
NODE_2239_length_1517_cov_24.074048	413	450	6	22	37	0.5945946
NODE_2239_length_1517_cov_24.074048	842	922	0	7	80	0.0875000
NODE_2239_length_1517_cov_24.074048	842	922	2	12	80	0.1500000
NODE_2239_length_1517_cov_24.074048	842	922	8	61	80	0.7625000
NODE_2239_length_1517_cov_24.074048	895	975	0	19	80	0.2375000
NODE_2239_length_1517_cov_24.074048	895	975	2	9	80	0.1125000
NODE_2239_length_1517_cov_24.074048	895	975	6	2	80	0.0250000
NODE_2239_length_1517_cov_24.074048	895	975	8	50	80	0.6250000
NODE_2240_length_1517_cov_22.897743	383	463	0	13	80	0.1625000
NODE_2240_length_1517_cov_22.897743	383	463	1	1	80	0.0125000
NODE_2240_length_1517_cov_22.897743	383	463	2	12	80	0.1500000
NODE_2240_length_1517_cov_22.897743	383	463	8	30	80	0.3750000
NODE_2240_length_1517_cov_22.897743	383	463	10	24	80	0.3000000
NODE_2240_length_1517_cov_22.897743	436	516	4	10	80	0.1250000
NODE_2240_length_1517_cov_22.897743	436	516	5	1	80	0.0125000
NODE_2240_length_1517_cov_22.897743	436	516	6	7	80	0.0875000
NODE_2240_length_1517_cov_22.897743	436	516	8	3	80	0.0375000
NODE_2240_length_1517_cov_22.897743	436	516	10	50	80	0.6250000
NODE_2240_length_1517_cov_22.897743	436	516	11	2	80	0.0250000
NODE_2240_length_1517_cov_22.897743	436	516	12	7	80	0.0875000
NODE_2241_length_1517_cov_11.781382	381	461	0	23	80	0.2875000
NODE_2241_length_1517_cov_11.781382	381	461	1	27	80	0.3375000
NODE_2241_length_1517_cov_11.781382	381	461	2	6	80	0.0750000
NODE_2241_length_1517_cov_11.781382	381	461	4	24	80	0.3000000
NODE_2241_length_1517_cov_11.781382	434	514	2	3	80	0.0375000
NODE_2241_length_1517_cov_11.781382	434	514	4	77	80	0.9625000
NODE_2243_length_1517_cov_4.944993	393	473	2	1	80	0.0125000
NODE_2243_length_1517_cov_4.944993	393	473	6	75	80	0.9375000
NODE_2243_length_1517_cov_4.944993	393	473	8	4	80	0.0500000
NODE_2243_length_1517_cov_4.944993	446	526	0	53	80	0.6625000
NODE_2243_length_1517_cov_4.944993	446	526	2	1	80	0.0125000
NODE_2243_length_1517_cov_4.944993	446	526	6	26	80	0.3250000
NODE_2247_length_1516_cov_11.177135	230	310	0	22	80	0.2750000
NODE_2247_length_1516_cov_11.177135	230	310	2	58	80	0.7250000
NODE_2247_length_1516_cov_11.177135	283	363	0	75	80	0.9375000
NODE_2247_length_1516_cov_11.177135	283	363	2	5	80	0.0625000
NODE_2248_length_1516_cov_8.608327	580	660	4	5	80	0.0625000
NODE_2248_length_1516_cov_8.608327	580	660	8	16	80	0.2000000
NODE_2248_length_1516_cov_8.608327	580	660	10	59	80	0.7375000
NODE_2248_length_1516_cov_8.608327	633	713	0	9	80	0.1125000
NODE_2248_length_1516_cov_8.608327	633	713	1	2	80	0.0250000
NODE_2248_length_1516_cov_8.608327	633	713	2	11	80	0.1375000
NODE_2248_length_1516_cov_8.608327	633	713	4	36	80	0.4500000
NODE_2248_length_1516_cov_8.608327	633	713	8	9	80	0.1125000
NODE_2248_length_1516_cov_8.608327	633	713	10	13	80	0.1625000
NODE_2250_length_1515_cov_16.990819	333	413	14	17	80	0.2125000
NODE_2250_length_1515_cov_16.990819	333	413	15	2	80	0.0250000
NODE_2250_length_1515_cov_16.990819	333	413	16	13	80	0.1625000
NODE_2250_length_1515_cov_16.990819	333	413	17	1	80	0.0125000
NODE_2250_length_1515_cov_16.990819	333	413	19	2	80	0.0250000
NODE_2250_length_1515_cov_16.990819	333	413	21	3	80	0.0375000
NODE_2250_length_1515_cov_16.990819	333	413	23	1	80	0.0125000
NODE_2250_length_1515_cov_16.990819	333	413	25	4	80	0.0500000
NODE_2250_length_1515_cov_16.990819	333	413	27	4	80	0.0500000
NODE_2250_length_1515_cov_16.990819	333	413	28	4	80	0.0500000
NODE_2250_length_1515_cov_16.990819	333	413	31	3	80	0.0375000
NODE_2250_length_1515_cov_16.990819	333	413	35	2	80	0.0250000
NODE_2250_length_1515_cov_16.990819	333	413	40	2	80	0.0250000
NODE_2250_length_1515_cov_16.990819	333	413	41	8	80	0.1000000
NODE_2250_length_1515_cov_16.990819	333	413	42	1	80	0.0125000
NODE_2250_length_1515_cov_16.990819	333	413	43	6	80	0.0750000
NODE_2250_length_1515_cov_16.990819	333	413	44	1	80	0.0125000
NODE_2250_length_1515_cov_16.990819	333	413	45	3	80	0.0375000
NODE_2250_length_1515_cov_16.990819	333	413	46	2	80	0.0250000
NODE_2250_length_1515_cov_16.990819	333	413	53	1	80	0.0125000
NODE_2250_length_1515_cov_16.990819	386	448	6	16	62	0.2580645
NODE_2250_length_1515_cov_16.990819	386	448	8	4	62	0.0645161
NODE_2250_length_1515_cov_16.990819	386	448	12	7	62	0.1129032
NODE_2250_length_1515_cov_16.990819	386	448	14	25	62	0.4032258
NODE_2250_length_1515_cov_16.990819	386	448	16	10	62	0.1612903
NODE_2258_length_1512_cov_5.111819	506	560	2	54	54	1.0000000
NODE_2258_length_1512_cov_5.111819	677	698	0	4	21	0.1904762
NODE_2258_length_1512_cov_5.111819	677	698	2	17	21	0.8095238
NODE_2258_length_1512_cov_5.111819	677	698	0	4	21	0.1904762
NODE_2258_length_1512_cov_5.111819	677	698	2	17	21	0.8095238
NODE_2258_length_1512_cov_5.111819	1057	1137	0	80	80	1.0000000
NODE_2258_length_1512_cov_5.111819	1110	1190	0	80	80	1.0000000
NODE_2258_length_1512_cov_5.111819	1144	1190	0	46	46	1.0000000
NODE_2259_length_1512_cov_4.251946	132	204	0	72	72	1.0000000
NODE_2262_length_1511_cov_30.963173	787	867	0	54	80	0.6750000
NODE_2262_length_1511_cov_30.963173	787	867	2	26	80	0.3250000
NODE_2262_length_1511_cov_30.963173	840	920	0	1	80	0.0125000
NODE_2262_length_1511_cov_30.963173	840	920	2	76	80	0.9500000
NODE_2262_length_1511_cov_30.963173	840	920	4	3	80	0.0375000
NODE_2262_length_1511_cov_30.963173	916	996	2	24	80	0.3000000
NODE_2262_length_1511_cov_30.963173	916	996	4	15	80	0.1875000
NODE_2262_length_1511_cov_30.963173	916	996	6	41	80	0.5125000
NODE_2262_length_1511_cov_30.963173	969	1059	2	5	90	0.0555556
NODE_2262_length_1511_cov_30.963173	969	1059	4	46	90	0.5111111
NODE_2262_length_1511_cov_30.963173	969	1059	6	39	90	0.4333333
NODE_2265_length_1510_cov_24.184975	434	514	2	12	80	0.1500000
NODE_2265_length_1510_cov_24.184975	434	514	4	45	80	0.5625000
NODE_2265_length_1510_cov_24.184975	434	514	6	23	80	0.2875000
NODE_2265_length_1510_cov_24.184975	487	567	0	2	80	0.0250000
NODE_2265_length_1510_cov_24.184975	487	567	2	39	80	0.4875000
NODE_2265_length_1510_cov_24.184975	487	567	4	8	80	0.1000000
NODE_2265_length_1510_cov_24.184975	487	567	6	31	80	0.3875000
NODE_2265_length_1510_cov_24.184975	563	643	0	12	80	0.1500000
NODE_2265_length_1510_cov_24.184975	563	643	2	68	80	0.8500000
NODE_2265_length_1510_cov_24.184975	616	696	0	30	80	0.3750000
NODE_2265_length_1510_cov_24.184975	616	696	2	50	80	0.6250000
NODE_2269_length_1509_cov_51.836170	655	735	2	13	80	0.1625000
NODE_2269_length_1509_cov_51.836170	655	735	3	18	80	0.2250000
NODE_2269_length_1509_cov_51.836170	655	735	4	17	80	0.2125000
NODE_2269_length_1509_cov_51.836170	655	735	5	32	80	0.4000000
NODE_2269_length_1509_cov_51.836170	708	788	3	28	80	0.3500000
NODE_2269_length_1509_cov_51.836170	708	788	5	20	80	0.2500000
NODE_2269_length_1509_cov_51.836170	708	788	7	32	80	0.4000000
NODE_2269_length_1509_cov_51.836170	784	864	6	9	80	0.1125000
NODE_2269_length_1509_cov_51.836170	784	864	7	9	80	0.1125000
NODE_2269_length_1509_cov_51.836170	784	864	8	21	80	0.2625000
NODE_2269_length_1509_cov_51.836170	784	864	9	21	80	0.2625000
NODE_2269_length_1509_cov_51.836170	784	864	11	20	80	0.2500000
NODE_2269_length_1509_cov_51.836170	837	917	4	22	80	0.2750000
NODE_2269_length_1509_cov_51.836170	837	917	6	20	80	0.2500000
NODE_2269_length_1509_cov_51.836170	837	917	8	38	80	0.4750000
NODE_2270_length_1509_cov_16.010638	497	577	0	80	80	1.0000000
NODE_2270_length_1509_cov_16.010638	550	630	0	80	80	1.0000000
NODE_2270_length_1509_cov_16.010638	626	706	0	28	80	0.3500000
NODE_2270_length_1509_cov_16.010638	626	706	1	9	80	0.1125000
NODE_2270_length_1509_cov_16.010638	626	706	3	10	80	0.1250000
NODE_2270_length_1509_cov_16.010638	626	706	5	30	80	0.3750000
NODE_2270_length_1509_cov_16.010638	626	706	6	3	80	0.0375000
NODE_2270_length_1509_cov_16.010638	679	759	5	24	80	0.3000000
NODE_2270_length_1509_cov_16.010638	679	759	6	56	80	0.7000000
NODE_2271_length_1509_cov_8.883688	252	332	0	80	80	1.0000000
NODE_2271_length_1509_cov_8.883688	305	385	0	80	80	1.0000000
NODE_2271_length_1509_cov_8.883688	327	385	0	58	58	1.0000000
NODE_2271_length_1509_cov_8.883688	381	461	0	25	80	0.3125000
NODE_2271_length_1509_cov_8.883688	381	461	2	23	80	0.2875000
NODE_2271_length_1509_cov_8.883688	381	461	4	32	80	0.4000000
NODE_2271_length_1509_cov_8.883688	434	514	2	31	80	0.3875000
NODE_2271_length_1509_cov_8.883688	434	514	4	49	80	0.6125000
NODE_2272_length_1509_cov_5.826950	1029	1109	0	80	80	1.0000000
NODE_2272_length_1509_cov_5.826950	1082	1162	0	80	80	1.0000000
NODE_2277_length_1508_cov_24.176011	765	845	0	12	80	0.1500000
NODE_2277_length_1508_cov_24.176011	765	845	2	68	80	0.8500000
NODE_2277_length_1508_cov_24.176011	818	898	0	14	80	0.1750000
NODE_2277_length_1508_cov_24.176011	818	898	2	66	80	0.8250000
NODE_2290_length_1504_cov_17.449822	596	676	0	37	80	0.4625000
NODE_2290_length_1504_cov_17.449822	596	676	2	5	80	0.0625000
NODE_2290_length_1504_cov_17.449822	596	676	6	12	80	0.1500000
NODE_2290_length_1504_cov_17.449822	596	676	8	26	80	0.3250000
NODE_2290_length_1504_cov_17.449822	649	729	4	18	80	0.2250000
NODE_2290_length_1504_cov_17.449822	649	729	6	1	80	0.0125000
NODE_2290_length_1504_cov_17.449822	649	729	8	61	80	0.7625000
NODE_2293_length_1502_cov_42.989309	559	639	2	38	80	0.4750000
NODE_2293_length_1502_cov_42.989309	559	639	4	42	80	0.5250000
NODE_2293_length_1502_cov_42.989309	612	692	0	34	80	0.4250000
NODE_2293_length_1502_cov_42.989309	612	692	2	6	80	0.0750000
NODE_2293_length_1502_cov_42.989309	612	692	4	40	80	0.5000000
NODE_2294_length_1501_cov_22.828816	421	500	0	79	79	1.0000000
NODE_2294_length_1501_cov_22.828816	473	553	0	80	80	1.0000000
NODE_2294_length_1501_cov_22.828816	549	629	0	15	80	0.1875000
NODE_2294_length_1501_cov_22.828816	549	629	2	65	80	0.8125000
NODE_2294_length_1501_cov_22.828816	602	682	2	80	80	1.0000000
NODE_2295_length_1501_cov_14.422254	973	1053	1	2	80	0.0250000
NODE_2295_length_1501_cov_14.422254	973	1053	2	21	80	0.2625000
NODE_2295_length_1501_cov_14.422254	973	1053	4	57	80	0.7125000
NODE_2295_length_1501_cov_14.422254	1026	1106	2	3	80	0.0375000
NODE_2295_length_1501_cov_14.422254	1026	1106	4	77	80	0.9625000
NODE_2296_length_1501_cov_14.060628	225	305	2	24	80	0.3000000
NODE_2296_length_1501_cov_14.060628	225	305	4	56	80	0.7000000
NODE_2296_length_1501_cov_14.060628	278	358	4	53	80	0.6625000
NODE_2296_length_1501_cov_14.060628	278	358	6	27	80	0.3375000
NODE_2296_length_1501_cov_14.060628	986	1066	0	80	80	1.0000000
NODE_2296_length_1501_cov_14.060628	1039	1119	0	80	80	1.0000000
NODE_2300_length_1500_cov_40.056388	619	699	0	80	80	1.0000000
NODE_2300_length_1500_cov_40.056388	672	752	0	32	80	0.4000000
NODE_2300_length_1500_cov_40.056388	672	752	2	48	80	0.6000000
NODE_2305_length_1497_cov_38.344063	1401	1481	19	2	80	0.0250000
NODE_2305_length_1497_cov_38.344063	1401	1481	23	2	80	0.0250000
NODE_2305_length_1497_cov_38.344063	1401	1481	27	1	80	0.0125000
NODE_2305_length_1497_cov_38.344063	1401	1481	29	4	80	0.0500000
NODE_2305_length_1497_cov_38.344063	1401	1481	31	2	80	0.0250000
NODE_2305_length_1497_cov_38.344063	1401	1481	33	5	80	0.0625000
NODE_2305_length_1497_cov_38.344063	1401	1481	34	3	80	0.0375000
NODE_2305_length_1497_cov_38.344063	1401	1481	35	3	80	0.0375000
NODE_2305_length_1497_cov_38.344063	1401	1481	36	20	80	0.2500000
NODE_2305_length_1497_cov_38.344063	1401	1481	38	13	80	0.1625000
NODE_2305_length_1497_cov_38.344063	1401	1481	40	1	80	0.0125000
NODE_2305_length_1497_cov_38.344063	1401	1481	42	1	80	0.0125000
NODE_2305_length_1497_cov_38.344063	1401	1481	44	5	80	0.0625000
NODE_2305_length_1497_cov_38.344063	1401	1481	46	3	80	0.0375000
NODE_2305_length_1497_cov_38.344063	1401	1481	50	2	80	0.0250000
NODE_2305_length_1497_cov_38.344063	1401	1481	54	1	80	0.0125000
NODE_2305_length_1497_cov_38.344063	1401	1481	56	9	80	0.1125000
NODE_2305_length_1497_cov_38.344063	1401	1481	58	2	80	0.0250000
NODE_2305_length_1497_cov_38.344063	1401	1481	60	1	80	0.0125000
NODE_2308_length_1496_cov_3.936292	0	44	0	44	44	1.0000000
NODE_2308_length_1496_cov_3.936292	17	97	0	80	80	1.0000000
NODE_2311_length_1496_cov_1.103794	405	428	2	17	23	0.7391304
NODE_2311_length_1496_cov_1.103794	405	428	4	6	23	0.2608696
NODE_2313_length_1494_cov_65.437276	460	540	2	24	80	0.3000000
NODE_2313_length_1494_cov_65.437276	460	540	4	56	80	0.7000000
NODE_2313_length_1494_cov_65.437276	513	594	0	25	81	0.3086420
NODE_2313_length_1494_cov_65.437276	513	594	2	12	81	0.1481481
NODE_2313_length_1494_cov_65.437276	513	594	4	44	81	0.5432099
NODE_2313_length_1494_cov_65.437276	787	854	4	18	67	0.2686567
NODE_2313_length_1494_cov_65.437276	787	854	6	33	67	0.4925373
NODE_2313_length_1494_cov_65.437276	787	854	8	16	67	0.2388060
NODE_2313_length_1494_cov_65.437276	827	907	4	12	80	0.1500000
NODE_2313_length_1494_cov_65.437276	827	907	6	42	80	0.5250000
NODE_2313_length_1494_cov_65.437276	827	907	8	26	80	0.3250000
NODE_2316_length_1493_cov_100.467719	947	1028	46	1	81	0.0123457
NODE_2316_length_1493_cov_100.467719	947	1028	48	3	81	0.0370370
NODE_2316_length_1493_cov_100.467719	947	1028	50	1	81	0.0123457
NODE_2316_length_1493_cov_100.467719	947	1028	58	3	81	0.0370370
NODE_2316_length_1493_cov_100.467719	947	1028	62	1	81	0.0123457
NODE_2316_length_1493_cov_100.467719	947	1028	64	1	81	0.0123457
NODE_2316_length_1493_cov_100.467719	947	1028	69	1	81	0.0123457
NODE_2316_length_1493_cov_100.467719	947	1028	73	1	81	0.0123457
NODE_2316_length_1493_cov_100.467719	947	1028	77	1	81	0.0123457
NODE_2316_length_1493_cov_100.467719	947	1028	81	2	81	0.0246914
NODE_2316_length_1493_cov_100.467719	947	1028	83	1	81	0.0123457
NODE_2316_length_1493_cov_100.467719	947	1028	85	1	81	0.0123457
NODE_2316_length_1493_cov_100.467719	947	1028	87	1	81	0.0123457
NODE_2316_length_1493_cov_100.467719	947	1028	93	3	81	0.0370370
NODE_2316_length_1493_cov_100.467719	947	1028	98	1	81	0.0123457
NODE_2316_length_1493_cov_100.467719	947	1028	105	2	81	0.0246914
NODE_2316_length_1493_cov_100.467719	947	1028	107	1	81	0.0123457
NODE_2316_length_1493_cov_100.467719	947	1028	109	1	81	0.0123457
NODE_2316_length_1493_cov_100.467719	947	1028	111	1	81	0.0123457
NODE_2316_length_1493_cov_100.467719	947	1028	117	2	81	0.0246914
NODE_2316_length_1493_cov_100.467719	947	1028	119	1	81	0.0123457
NODE_2316_length_1493_cov_100.467719	947	1028	121	2	81	0.0246914
NODE_2316_length_1493_cov_100.467719	947	1028	123	1	81	0.0123457
NODE_2316_length_1493_cov_100.467719	947	1028	132	1	81	0.0123457
NODE_2316_length_1493_cov_100.467719	947	1028	140	1	81	0.0123457
NODE_2316_length_1493_cov_100.467719	947	1028	142	1	81	0.0123457
NODE_2316_length_1493_cov_100.467719	947	1028	148	1	81	0.0123457
NODE_2316_length_1493_cov_100.467719	947	1028	150	2	81	0.0246914
NODE_2316_length_1493_cov_100.467719	947	1028	151	1	81	0.0123457
NODE_2316_length_1493_cov_100.467719	947	1028	157	1	81	0.0123457
NODE_2316_length_1493_cov_100.467719	947	1028	161	1	81	0.0123457
NODE_2316_length_1493_cov_100.467719	947	1028	164	1	81	0.0123457
NODE_2316_length_1493_cov_100.467719	947	1028	168	1	81	0.0123457
NODE_2316_length_1493_cov_100.467719	947	1028	169	4	81	0.0493827
NODE_2316_length_1493_cov_100.467719	947	1028	170	1	81	0.0123457
NODE_2316_length_1493_cov_100.467719	947	1028	180	3	81	0.0370370
NODE_2316_length_1493_cov_100.467719	947	1028	182	2	81	0.0246914
NODE_2316_length_1493_cov_100.467719	947	1028	188	1	81	0.0123457
NODE_2316_length_1493_cov_100.467719	947	1028	194	1	81	0.0123457
NODE_2316_length_1493_cov_100.467719	947	1028	198	1	81	0.0123457
NODE_2316_length_1493_cov_100.467719	947	1028	202	1	81	0.0123457
NODE_2316_length_1493_cov_100.467719	947	1028	206	1	81	0.0123457
NODE_2316_length_1493_cov_100.467719	947	1028	208	1	81	0.0123457
NODE_2316_length_1493_cov_100.467719	947	1028	212	1	81	0.0123457
NODE_2316_length_1493_cov_100.467719	947	1028	217	1	81	0.0123457
NODE_2316_length_1493_cov_100.467719	947	1028	225	1	81	0.0123457
NODE_2316_length_1493_cov_100.467719	947	1028	233	1	81	0.0123457
NODE_2316_length_1493_cov_100.467719	947	1028	235	1	81	0.0123457
NODE_2316_length_1493_cov_100.467719	947	1028	238	2	81	0.0246914
NODE_2316_length_1493_cov_100.467719	947	1028	243	2	81	0.0246914
NODE_2316_length_1493_cov_100.467719	947	1028	244	2	81	0.0246914
NODE_2316_length_1493_cov_100.467719	947	1028	247	2	81	0.0246914
NODE_2316_length_1493_cov_100.467719	947	1028	249	1	81	0.0123457
NODE_2316_length_1493_cov_100.467719	947	1028	250	1	81	0.0123457
NODE_2316_length_1493_cov_100.467719	947	1028	254	1	81	0.0123457
NODE_2316_length_1493_cov_100.467719	947	1028	262	1	81	0.0123457
NODE_2316_length_1493_cov_100.467719	947	1028	273	1	81	0.0123457
NODE_2316_length_1493_cov_100.467719	947	1028	277	1	81	0.0123457
NODE_2316_length_1493_cov_100.467719	947	1028	279	2	81	0.0246914
NODE_2316_length_1493_cov_100.467719	1001	1071	188	1	70	0.0142857
NODE_2316_length_1493_cov_100.467719	1001	1071	194	1	70	0.0142857
NODE_2316_length_1493_cov_100.467719	1001	1071	198	1	70	0.0142857
NODE_2316_length_1493_cov_100.467719	1001	1071	202	1	70	0.0142857
NODE_2316_length_1493_cov_100.467719	1001	1071	206	1	70	0.0142857
NODE_2316_length_1493_cov_100.467719	1001	1071	208	1	70	0.0142857
NODE_2316_length_1493_cov_100.467719	1001	1071	212	1	70	0.0142857
NODE_2316_length_1493_cov_100.467719	1001	1071	217	1	70	0.0142857
NODE_2316_length_1493_cov_100.467719	1001	1071	225	1	70	0.0142857
NODE_2316_length_1493_cov_100.467719	1001	1071	233	1	70	0.0142857
NODE_2316_length_1493_cov_100.467719	1001	1071	235	1	70	0.0142857
NODE_2316_length_1493_cov_100.467719	1001	1071	238	2	70	0.0285714
NODE_2316_length_1493_cov_100.467719	1001	1071	243	2	70	0.0285714
NODE_2316_length_1493_cov_100.467719	1001	1071	244	2	70	0.0285714
NODE_2316_length_1493_cov_100.467719	1001	1071	247	2	70	0.0285714
NODE_2316_length_1493_cov_100.467719	1001	1071	249	1	70	0.0142857
NODE_2316_length_1493_cov_100.467719	1001	1071	250	1	70	0.0142857
NODE_2316_length_1493_cov_100.467719	1001	1071	254	1	70	0.0142857
NODE_2316_length_1493_cov_100.467719	1001	1071	262	1	70	0.0142857
NODE_2316_length_1493_cov_100.467719	1001	1071	273	1	70	0.0142857
NODE_2316_length_1493_cov_100.467719	1001	1071	277	1	70	0.0142857
NODE_2316_length_1493_cov_100.467719	1001	1071	279	2	70	0.0285714
NODE_2316_length_1493_cov_100.467719	1001	1071	282	1	70	0.0142857
NODE_2316_length_1493_cov_100.467719	1001	1071	293	1	70	0.0142857
NODE_2316_length_1493_cov_100.467719	1001	1071	309	1	70	0.0142857
NODE_2316_length_1493_cov_100.467719	1001	1071	318	1	70	0.0142857
NODE_2316_length_1493_cov_100.467719	1001	1071	320	2	70	0.0285714
NODE_2316_length_1493_cov_100.467719	1001	1071	323	1	70	0.0142857
NODE_2316_length_1493_cov_100.467719	1001	1071	327	1	70	0.0142857
NODE_2316_length_1493_cov_100.467719	1001	1071	329	2	70	0.0285714
NODE_2316_length_1493_cov_100.467719	1001	1071	331	2	70	0.0285714
NODE_2316_length_1493_cov_100.467719	1001	1071	333	3	70	0.0428571
NODE_2316_length_1493_cov_100.467719	1001	1071	335	1	70	0.0142857
NODE_2316_length_1493_cov_100.467719	1001	1071	339	1	70	0.0142857
NODE_2316_length_1493_cov_100.467719	1001	1071	359	1	70	0.0142857
NODE_2316_length_1493_cov_100.467719	1001	1071	363	1	70	0.0142857
NODE_2316_length_1493_cov_100.467719	1001	1071	364	2	70	0.0285714
NODE_2316_length_1493_cov_100.467719	1001	1071	367	1	70	0.0142857
NODE_2316_length_1493_cov_100.467719	1001	1071	372	1	70	0.0142857
NODE_2316_length_1493_cov_100.467719	1001	1071	373	1	70	0.0142857
NODE_2316_length_1493_cov_100.467719	1001	1071	375	2	70	0.0285714
NODE_2316_length_1493_cov_100.467719	1001	1071	378	1	70	0.0142857
NODE_2316_length_1493_cov_100.467719	1001	1071	381	1	70	0.0142857
NODE_2316_length_1493_cov_100.467719	1001	1071	383	1	70	0.0142857
NODE_2316_length_1493_cov_100.467719	1001	1071	387	1	70	0.0142857
NODE_2316_length_1493_cov_100.467719	1001	1071	388	2	70	0.0285714
NODE_2316_length_1493_cov_100.467719	1001	1071	390	1	70	0.0142857
NODE_2316_length_1493_cov_100.467719	1001	1071	392	1	70	0.0142857
NODE_2316_length_1493_cov_100.467719	1001	1071	400	1	70	0.0142857
NODE_2316_length_1493_cov_100.467719	1001	1071	402	1	70	0.0142857
NODE_2316_length_1493_cov_100.467719	1001	1071	408	1	70	0.0142857
NODE_2316_length_1493_cov_100.467719	1001	1071	410	3	70	0.0428571
NODE_2316_length_1493_cov_100.467719	1001	1071	412	2	70	0.0285714
NODE_2316_length_1493_cov_100.467719	1001	1071	415	1	70	0.0142857
NODE_2316_length_1493_cov_100.467719	1077	1157	413	2	80	0.0250000
NODE_2316_length_1493_cov_100.467719	1077	1157	417	1	80	0.0125000
NODE_2316_length_1493_cov_100.467719	1077	1157	419	1	80	0.0125000
NODE_2316_length_1493_cov_100.467719	1077	1157	423	1	80	0.0125000
NODE_2316_length_1493_cov_100.467719	1077	1157	449	1	80	0.0125000
NODE_2316_length_1493_cov_100.467719	1077	1157	452	1	80	0.0125000
NODE_2316_length_1493_cov_100.467719	1077	1157	453	1	80	0.0125000
NODE_2316_length_1493_cov_100.467719	1077	1157	454	3	80	0.0375000
NODE_2316_length_1493_cov_100.467719	1077	1157	455	2	80	0.0250000
NODE_2316_length_1493_cov_100.467719	1077	1157	456	3	80	0.0375000
NODE_2316_length_1493_cov_100.467719	1077	1157	457	2	80	0.0250000
NODE_2316_length_1493_cov_100.467719	1077	1157	458	1	80	0.0125000
NODE_2316_length_1493_cov_100.467719	1077	1157	459	1	80	0.0125000
NODE_2316_length_1493_cov_100.467719	1077	1157	460	1	80	0.0125000
NODE_2316_length_1493_cov_100.467719	1077	1157	461	2	80	0.0250000
NODE_2316_length_1493_cov_100.467719	1077	1157	464	5	80	0.0625000
NODE_2316_length_1493_cov_100.467719	1077	1157	474	1	80	0.0125000
NODE_2316_length_1493_cov_100.467719	1077	1157	490	1	80	0.0125000
NODE_2316_length_1493_cov_100.467719	1077	1157	499	3	80	0.0375000
NODE_2316_length_1493_cov_100.467719	1077	1157	508	1	80	0.0125000
NODE_2316_length_1493_cov_100.467719	1077	1157	509	3	80	0.0375000
NODE_2316_length_1493_cov_100.467719	1077	1157	515	1	80	0.0125000
NODE_2316_length_1493_cov_100.467719	1077	1157	516	2	80	0.0250000
NODE_2316_length_1493_cov_100.467719	1077	1157	517	1	80	0.0125000
NODE_2316_length_1493_cov_100.467719	1077	1157	520	1	80	0.0125000
NODE_2316_length_1493_cov_100.467719	1077	1157	522	1	80	0.0125000
NODE_2316_length_1493_cov_100.467719	1077	1157	525	1	80	0.0125000
NODE_2316_length_1493_cov_100.467719	1077	1157	526	1	80	0.0125000
NODE_2316_length_1493_cov_100.467719	1077	1157	527	1	80	0.0125000
NODE_2316_length_1493_cov_100.467719	1077	1157	532	1	80	0.0125000
NODE_2316_length_1493_cov_100.467719	1077	1157	542	1	80	0.0125000
NODE_2316_length_1493_cov_100.467719	1077	1157	550	1	80	0.0125000
NODE_2316_length_1493_cov_100.467719	1077	1157	557	1	80	0.0125000
NODE_2316_length_1493_cov_100.467719	1077	1157	562	1	80	0.0125000
NODE_2316_length_1493_cov_100.467719	1077	1157	572	1	80	0.0125000
NODE_2316_length_1493_cov_100.467719	1077	1157	573	1	80	0.0125000
NODE_2316_length_1493_cov_100.467719	1077	1157	576	1	80	0.0125000
NODE_2316_length_1493_cov_100.467719	1077	1157	582	1	80	0.0125000
NODE_2316_length_1493_cov_100.467719	1077	1157	586	1	80	0.0125000
NODE_2316_length_1493_cov_100.467719	1077	1157	590	1	80	0.0125000
NODE_2316_length_1493_cov_100.467719	1077	1157	593	1	80	0.0125000
NODE_2316_length_1493_cov_100.467719	1077	1157	596	1	80	0.0125000
NODE_2316_length_1493_cov_100.467719	1077	1157	597	1	80	0.0125000
NODE_2316_length_1493_cov_100.467719	1077	1157	599	2	80	0.0250000
NODE_2316_length_1493_cov_100.467719	1077	1157	600	2	80	0.0250000
NODE_2316_length_1493_cov_100.467719	1077	1157	601	2	80	0.0250000
NODE_2316_length_1493_cov_100.467719	1077	1157	605	1	80	0.0125000
NODE_2316_length_1493_cov_100.467719	1077	1157	610	1	80	0.0125000
NODE_2316_length_1493_cov_100.467719	1077	1157	611	1	80	0.0125000
NODE_2316_length_1493_cov_100.467719	1077	1157	612	1	80	0.0125000
NODE_2316_length_1493_cov_100.467719	1077	1157	615	1	80	0.0125000
NODE_2316_length_1493_cov_100.467719	1077	1157	619	1	80	0.0125000
NODE_2316_length_1493_cov_100.467719	1077	1157	628	3	80	0.0375000
NODE_2316_length_1493_cov_100.467719	1077	1157	629	2	80	0.0250000
NODE_2316_length_1493_cov_100.467719	1077	1157	630	1	80	0.0125000
NODE_2316_length_1493_cov_100.467719	1077	1157	638	1	80	0.0125000
NODE_2316_length_1493_cov_100.467719	1077	1157	639	1	80	0.0125000
NODE_2316_length_1493_cov_100.467719	1130	1210	576	1	80	0.0125000
NODE_2316_length_1493_cov_100.467719	1130	1210	582	1	80	0.0125000
NODE_2316_length_1493_cov_100.467719	1130	1210	586	1	80	0.0125000
NODE_2316_length_1493_cov_100.467719	1130	1210	590	1	80	0.0125000
NODE_2316_length_1493_cov_100.467719	1130	1210	593	1	80	0.0125000
NODE_2316_length_1493_cov_100.467719	1130	1210	596	1	80	0.0125000
NODE_2316_length_1493_cov_100.467719	1130	1210	597	1	80	0.0125000
NODE_2316_length_1493_cov_100.467719	1130	1210	599	2	80	0.0250000
NODE_2316_length_1493_cov_100.467719	1130	1210	600	2	80	0.0250000
NODE_2316_length_1493_cov_100.467719	1130	1210	601	2	80	0.0250000
NODE_2316_length_1493_cov_100.467719	1130	1210	605	1	80	0.0125000
NODE_2316_length_1493_cov_100.467719	1130	1210	610	1	80	0.0125000
NODE_2316_length_1493_cov_100.467719	1130	1210	611	1	80	0.0125000
NODE_2316_length_1493_cov_100.467719	1130	1210	612	1	80	0.0125000
NODE_2316_length_1493_cov_100.467719	1130	1210	613	2	80	0.0250000
NODE_2316_length_1493_cov_100.467719	1130	1210	615	1	80	0.0125000
NODE_2316_length_1493_cov_100.467719	1130	1210	616	1	80	0.0125000
NODE_2316_length_1493_cov_100.467719	1130	1210	617	1	80	0.0125000
NODE_2316_length_1493_cov_100.467719	1130	1210	619	1	80	0.0125000
NODE_2316_length_1493_cov_100.467719	1130	1210	620	1	80	0.0125000
NODE_2316_length_1493_cov_100.467719	1130	1210	621	2	80	0.0250000
NODE_2316_length_1493_cov_100.467719	1130	1210	624	1	80	0.0125000
NODE_2316_length_1493_cov_100.467719	1130	1210	628	3	80	0.0375000
NODE_2316_length_1493_cov_100.467719	1130	1210	629	2	80	0.0250000
NODE_2316_length_1493_cov_100.467719	1130	1210	630	1	80	0.0125000
NODE_2316_length_1493_cov_100.467719	1130	1210	632	1	80	0.0125000
NODE_2316_length_1493_cov_100.467719	1130	1210	634	2	80	0.0250000
NODE_2316_length_1493_cov_100.467719	1130	1210	638	1	80	0.0125000
NODE_2316_length_1493_cov_100.467719	1130	1210	639	1	80	0.0125000
NODE_2316_length_1493_cov_100.467719	1130	1210	640	2	80	0.0250000
NODE_2316_length_1493_cov_100.467719	1130	1210	643	1	80	0.0125000
NODE_2316_length_1493_cov_100.467719	1130	1210	647	3	80	0.0375000
NODE_2316_length_1493_cov_100.467719	1130	1210	657	1	80	0.0125000
NODE_2316_length_1493_cov_100.467719	1130	1210	668	1	80	0.0125000
NODE_2316_length_1493_cov_100.467719	1130	1210	688	1	80	0.0125000
NODE_2316_length_1493_cov_100.467719	1130	1210	698	1	80	0.0125000
NODE_2316_length_1493_cov_100.467719	1130	1210	719	1	80	0.0125000
NODE_2316_length_1493_cov_100.467719	1130	1210	721	2	80	0.0250000
NODE_2316_length_1493_cov_100.467719	1130	1210	722	1	80	0.0125000
NODE_2316_length_1493_cov_100.467719	1130	1210	724	3	80	0.0375000
NODE_2316_length_1493_cov_100.467719	1130	1210	726	1	80	0.0125000
NODE_2316_length_1493_cov_100.467719	1130	1210	730	2	80	0.0250000
NODE_2316_length_1493_cov_100.467719	1130	1210	734	1	80	0.0125000
NODE_2316_length_1493_cov_100.467719	1130	1210	735	1	80	0.0125000
NODE_2316_length_1493_cov_100.467719	1130	1210	737	2	80	0.0250000
NODE_2316_length_1493_cov_100.467719	1130	1210	739	1	80	0.0125000
NODE_2316_length_1493_cov_100.467719	1130	1210	740	3	80	0.0375000
NODE_2316_length_1493_cov_100.467719	1130	1210	741	2	80	0.0250000
NODE_2316_length_1493_cov_100.467719	1130	1210	742	2	80	0.0250000
NODE_2316_length_1493_cov_100.467719	1130	1210	743	1	80	0.0125000
NODE_2316_length_1493_cov_100.467719	1130	1210	745	1	80	0.0125000
NODE_2316_length_1493_cov_100.467719	1130	1210	747	1	80	0.0125000
NODE_2316_length_1493_cov_100.467719	1130	1210	749	1	80	0.0125000
NODE_2316_length_1493_cov_100.467719	1130	1210	751	1	80	0.0125000
NODE_2316_length_1493_cov_100.467719	1130	1210	753	2	80	0.0250000
NODE_2316_length_1493_cov_100.467719	1130	1210	754	1	80	0.0125000
NODE_2316_length_1493_cov_100.467719	1130	1210	757	2	80	0.0250000
NODE_2321_length_1493_cov_1.138451	1341	1420	0	41	79	0.5189874
NODE_2321_length_1493_cov_1.138451	1341	1420	2	3	79	0.0379747
NODE_2321_length_1493_cov_1.138451	1341	1420	4	35	79	0.4430380
NODE_2321_length_1493_cov_1.138451	1341	1420	0	41	79	0.5189874
NODE_2321_length_1493_cov_1.138451	1341	1420	2	3	79	0.0379747
NODE_2321_length_1493_cov_1.138451	1341	1420	4	35	79	0.4430380
NODE_2321_length_1493_cov_1.138451	1393	1459	2	30	66	0.4545455
NODE_2321_length_1493_cov_1.138451	1393	1459	4	36	66	0.5454546
NODE_2332_length_1490_cov_5.726096	233	295	0	62	62	1.0000000
NODE_2332_length_1490_cov_5.726096	1065	1149	0	84	84	1.0000000
NODE_2333_length_1490_cov_4.687275	318	399	2	81	81	1.0000000
NODE_2333_length_1490_cov_4.687275	372	452	0	52	80	0.6500000
NODE_2333_length_1490_cov_4.687275	372	452	2	28	80	0.3500000
NODE_2338_length_1488_cov_3.734341	1141	1221	0	80	80	1.0000000
NODE_2340_length_1487_cov_19.332133	673	753	0	33	80	0.4125000
NODE_2340_length_1487_cov_19.332133	673	753	2	17	80	0.2125000
NODE_2340_length_1487_cov_19.332133	673	753	4	11	80	0.1375000
NODE_2340_length_1487_cov_19.332133	673	753	8	19	80	0.2375000
NODE_2340_length_1487_cov_19.332133	726	806	4	8	80	0.1000000
NODE_2340_length_1487_cov_19.332133	726	806	6	6	80	0.0750000
NODE_2340_length_1487_cov_19.332133	726	806	8	66	80	0.8250000
NODE_2348_length_1484_cov_38.342960	706	786	2	1	80	0.0125000
NODE_2348_length_1484_cov_38.342960	706	786	4	38	80	0.4750000
NODE_2348_length_1484_cov_38.342960	706	786	6	17	80	0.2125000
NODE_2348_length_1484_cov_38.342960	706	786	8	24	80	0.3000000
NODE_2348_length_1484_cov_38.342960	759	839	0	26	80	0.3250000
NODE_2348_length_1484_cov_38.342960	759	839	2	28	80	0.3500000
NODE_2348_length_1484_cov_38.342960	759	839	4	26	80	0.3250000
NODE_2349_length_1484_cov_21.260650	348	428	0	20	80	0.2500000
NODE_2349_length_1484_cov_21.260650	348	428	2	55	80	0.6875000
NODE_2349_length_1484_cov_21.260650	348	428	6	5	80	0.0625000
NODE_2349_length_1484_cov_21.260650	401	481	0	73	80	0.9125000
NODE_2349_length_1484_cov_21.260650	401	481	2	7	80	0.0875000
NODE_2349_length_1484_cov_21.260650	978	1058	2	80	80	1.0000000
NODE_2349_length_1484_cov_21.260650	1031	1111	0	39	80	0.4875000
NODE_2349_length_1484_cov_21.260650	1031	1111	2	41	80	0.5125000
NODE_2350_length_1484_cov_19.243321	952	1032	2	12	80	0.1500000
NODE_2350_length_1484_cov_19.243321	952	1032	7	15	80	0.1875000
NODE_2350_length_1484_cov_19.243321	952	1032	8	10	80	0.1250000
NODE_2350_length_1484_cov_19.243321	952	1032	9	3	80	0.0375000
NODE_2350_length_1484_cov_19.243321	952	1032	10	3	80	0.0375000
NODE_2350_length_1484_cov_19.243321	952	1032	11	37	80	0.4625000
NODE_2350_length_1484_cov_19.243321	1005	1085	4	1	80	0.0125000
NODE_2350_length_1484_cov_19.243321	1005	1085	6	24	80	0.3000000
NODE_2350_length_1484_cov_19.243321	1005	1085	11	28	80	0.3500000
NODE_2350_length_1484_cov_19.243321	1005	1085	12	18	80	0.2250000
NODE_2350_length_1484_cov_19.243321	1005	1085	14	9	80	0.1125000
NODE_2351_length_1484_cov_9.085199	314	394	2	41	80	0.5125000
NODE_2351_length_1484_cov_9.085199	314	394	6	39	80	0.4875000
NODE_2351_length_1484_cov_9.085199	367	447	3	40	80	0.5000000
NODE_2351_length_1484_cov_9.085199	367	447	5	7	80	0.0875000
NODE_2351_length_1484_cov_9.085199	367	447	6	33	80	0.4125000
NODE_2353_length_1483_cov_21.207370	555	635	16	7	80	0.0875000
NODE_2353_length_1483_cov_21.207370	555	635	18	56	80	0.7000000
NODE_2353_length_1483_cov_21.207370	555	635	20	17	80	0.2125000
NODE_2353_length_1483_cov_21.207370	608	688	0	8	80	0.1000000
NODE_2353_length_1483_cov_21.207370	608	688	2	12	80	0.1500000
NODE_2353_length_1483_cov_21.207370	608	688	6	7	80	0.0875000
NODE_2353_length_1483_cov_21.207370	608	688	10	8	80	0.1000000
NODE_2353_length_1483_cov_21.207370	608	688	16	22	80	0.2750000
NODE_2353_length_1483_cov_21.207370	608	688	18	23	80	0.2875000
NODE_2359_length_1482_cov_20.177874	430	510	0	3	80	0.0375000
NODE_2359_length_1482_cov_20.177874	430	510	2	18	80	0.2250000
NODE_2359_length_1482_cov_20.177874	430	510	4	19	80	0.2375000
NODE_2359_length_1482_cov_20.177874	430	510	6	40	80	0.5000000
NODE_2359_length_1482_cov_20.177874	483	563	0	14	80	0.1750000
NODE_2359_length_1482_cov_20.177874	483	563	2	20	80	0.2500000
NODE_2359_length_1482_cov_20.177874	483	563	6	46	80	0.5750000
NODE_2359_length_1482_cov_20.177874	559	639	2	71	80	0.8875000
NODE_2359_length_1482_cov_20.177874	559	639	4	9	80	0.1125000
NODE_2359_length_1482_cov_20.177874	612	692	2	23	80	0.2875000
NODE_2359_length_1482_cov_20.177874	612	692	4	57	80	0.7125000
NODE_2360_length_1482_cov_13.644252	1000	1080	0	6	80	0.0750000
NODE_2360_length_1482_cov_13.644252	1000	1080	2	18	80	0.2250000
NODE_2360_length_1482_cov_13.644252	1000	1080	4	56	80	0.7000000
NODE_2360_length_1482_cov_13.644252	1053	1133	0	59	80	0.7375000
NODE_2360_length_1482_cov_13.644252	1053	1133	2	18	80	0.2250000
NODE_2360_length_1482_cov_13.644252	1053	1133	4	3	80	0.0375000
NODE_2361_length_1482_cov_6.157628	525	605	0	80	80	1.0000000
NODE_2361_length_1482_cov_6.157628	578	658	0	80	80	1.0000000
NODE_2361_length_1482_cov_6.157628	1306	1388	8	7	82	0.0853659
NODE_2361_length_1482_cov_6.157628	1306	1388	10	6	82	0.0731707
NODE_2361_length_1482_cov_6.157628	1306	1388	12	1	82	0.0121951
NODE_2361_length_1482_cov_6.157628	1306	1388	14	8	82	0.0975610
NODE_2361_length_1482_cov_6.157628	1306	1388	16	23	82	0.2804878
NODE_2361_length_1482_cov_6.157628	1306	1388	18	19	82	0.2317073
NODE_2361_length_1482_cov_6.157628	1306	1388	20	18	82	0.2195122
NODE_2364_length_1481_cov_19.238784	480	560	4	1	80	0.0125000
NODE_2364_length_1481_cov_19.238784	480	560	6	23	80	0.2875000
NODE_2364_length_1481_cov_19.238784	480	560	8	43	80	0.5375000
NODE_2364_length_1481_cov_19.238784	480	560	9	1	80	0.0125000
NODE_2364_length_1481_cov_19.238784	480	560	10	12	80	0.1500000
NODE_2364_length_1481_cov_19.238784	533	613	0	9	80	0.1125000
NODE_2364_length_1481_cov_19.238784	533	613	2	37	80	0.4625000
NODE_2364_length_1481_cov_19.238784	533	613	4	8	80	0.1000000
NODE_2364_length_1481_cov_19.238784	533	613	6	23	80	0.2875000
NODE_2364_length_1481_cov_19.238784	533	613	8	3	80	0.0375000
NODE_2365_length_1481_cov_18.139653	706	786	2	80	80	1.0000000
NODE_2365_length_1481_cov_18.139653	759	839	0	50	80	0.6250000
NODE_2365_length_1481_cov_18.139653	759	839	2	30	80	0.3750000
NODE_2367_length_1480_cov_27.552498	762	842	0	22	80	0.2750000
NODE_2367_length_1480_cov_27.552498	762	842	2	58	80	0.7250000
NODE_2367_length_1480_cov_27.552498	815	895	0	37	80	0.4625000
NODE_2367_length_1480_cov_27.552498	815	895	2	43	80	0.5375000
NODE_2367_length_1480_cov_27.552498	891	971	0	80	80	1.0000000
NODE_2367_length_1480_cov_27.552498	944	1024	0	80	80	1.0000000
NODE_2367_length_1480_cov_27.552498	1171	1222	0	3	51	0.0588235
NODE_2367_length_1480_cov_27.552498	1171	1222	2	5	51	0.0980392
NODE_2367_length_1480_cov_27.552498	1171	1222	4	4	51	0.0784314
NODE_2367_length_1480_cov_27.552498	1171	1222	6	3	51	0.0588235
NODE_2367_length_1480_cov_27.552498	1171	1222	8	1	51	0.0196078
NODE_2367_length_1480_cov_27.552498	1171	1222	10	5	51	0.0980392
NODE_2367_length_1480_cov_27.552498	1171	1222	14	4	51	0.0784314
NODE_2367_length_1480_cov_27.552498	1171	1222	16	1	51	0.0196078
NODE_2367_length_1480_cov_27.552498	1171	1222	18	1	51	0.0196078
NODE_2367_length_1480_cov_27.552498	1171	1222	21	1	51	0.0196078
NODE_2367_length_1480_cov_27.552498	1171	1222	23	1	51	0.0196078
NODE_2367_length_1480_cov_27.552498	1171	1222	25	1	51	0.0196078
NODE_2367_length_1480_cov_27.552498	1171	1222	26	1	51	0.0196078
NODE_2367_length_1480_cov_27.552498	1171	1222	28	3	51	0.0588235
NODE_2367_length_1480_cov_27.552498	1171	1222	30	3	51	0.0588235
NODE_2367_length_1480_cov_27.552498	1171	1222	32	6	51	0.1176471
NODE_2367_length_1480_cov_27.552498	1171	1222	34	4	51	0.0784314
NODE_2367_length_1480_cov_27.552498	1171	1222	36	4	51	0.0784314
NODE_2369_length_1480_cov_12.535844	466	546	0	80	80	1.0000000
NODE_2369_length_1480_cov_12.535844	519	599	0	80	80	1.0000000
NODE_2373_length_1479_cov_17.035507	708	788	0	63	80	0.7875000
NODE_2373_length_1479_cov_17.035507	708	788	2	17	80	0.2125000
NODE_2373_length_1479_cov_17.035507	761	841	0	10	80	0.1250000
NODE_2373_length_1479_cov_17.035507	761	841	2	70	80	0.8750000
NODE_2373_length_1479_cov_17.035507	837	917	0	61	80	0.7625000
NODE_2373_length_1479_cov_17.035507	837	917	2	19	80	0.2375000
NODE_2373_length_1479_cov_17.035507	890	970	0	80	80	1.0000000
NODE_2374_length_1479_cov_16.448551	908	988	0	10	80	0.1250000
NODE_2374_length_1479_cov_16.448551	908	988	2	10	80	0.1250000
NODE_2374_length_1479_cov_16.448551	908	988	4	60	80	0.7500000
NODE_2374_length_1479_cov_16.448551	961	1041	0	17	80	0.2125000
NODE_2374_length_1479_cov_16.448551	961	1041	2	1	80	0.0125000
NODE_2374_length_1479_cov_16.448551	961	1041	4	62	80	0.7750000
NODE_2375_length_1479_cov_5.285507	123	185	11	6	62	0.0967742
NODE_2375_length_1479_cov_5.285507	123	185	15	1	62	0.0161290
NODE_2375_length_1479_cov_5.285507	123	185	16	1	62	0.0161290
NODE_2375_length_1479_cov_5.285507	123	185	17	6	62	0.0967742
NODE_2375_length_1479_cov_5.285507	123	185	18	7	62	0.1129032
NODE_2375_length_1479_cov_5.285507	123	185	20	1	62	0.0161290
NODE_2375_length_1479_cov_5.285507	123	185	24	5	62	0.0806452
NODE_2375_length_1479_cov_5.285507	123	185	25	1	62	0.0161290
NODE_2375_length_1479_cov_5.285507	123	185	27	3	62	0.0483871
NODE_2375_length_1479_cov_5.285507	123	185	31	5	62	0.0806452
NODE_2375_length_1479_cov_5.285507	123	185	37	1	62	0.0161290
NODE_2375_length_1479_cov_5.285507	123	185	41	2	62	0.0322581
NODE_2375_length_1479_cov_5.285507	123	185	43	1	62	0.0161290
NODE_2375_length_1479_cov_5.285507	123	185	45	1	62	0.0161290
NODE_2375_length_1479_cov_5.285507	123	185	47	3	62	0.0483871
NODE_2375_length_1479_cov_5.285507	123	185	49	2	62	0.0322581
NODE_2375_length_1479_cov_5.285507	123	185	51	1	62	0.0161290
NODE_2375_length_1479_cov_5.285507	123	185	54	1	62	0.0161290
NODE_2375_length_1479_cov_5.285507	123	185	56	1	62	0.0161290
NODE_2375_length_1479_cov_5.285507	123	185	58	1	62	0.0161290
NODE_2375_length_1479_cov_5.285507	123	185	62	1	62	0.0161290
NODE_2375_length_1479_cov_5.285507	123	185	64	2	62	0.0322581
NODE_2375_length_1479_cov_5.285507	123	185	66	3	62	0.0483871
NODE_2375_length_1479_cov_5.285507	123	185	67	1	62	0.0161290
NODE_2375_length_1479_cov_5.285507	123	185	68	2	62	0.0322581
NODE_2375_length_1479_cov_5.285507	123	185	70	1	62	0.0161290
NODE_2375_length_1479_cov_5.285507	123	185	72	1	62	0.0161290
NODE_2375_length_1479_cov_5.285507	123	185	74	1	62	0.0161290
NODE_2376_length_1479_cov_2.018841	881	967	0	86	86	1.0000000
NODE_2377_length_1478_cov_32.050761	411	491	0	35	80	0.4375000
NODE_2377_length_1478_cov_32.050761	411	491	2	45	80	0.5625000
NODE_2377_length_1478_cov_32.050761	464	544	0	11	80	0.1375000
NODE_2377_length_1478_cov_32.050761	464	544	2	69	80	0.8625000
NODE_2377_length_1478_cov_32.050761	540	620	2	69	80	0.8625000
NODE_2377_length_1478_cov_32.050761	540	620	4	11	80	0.1375000
NODE_2377_length_1478_cov_32.050761	593	673	2	80	80	1.0000000
NODE_2378_length_1478_cov_27.414793	817	897	0	80	80	1.0000000
NODE_2378_length_1478_cov_27.414793	870	950	0	80	80	1.0000000
NODE_2379_length_1478_cov_23.472081	1212	1241	55	2	29	0.0689655
NODE_2379_length_1478_cov_23.472081	1212	1241	57	7	29	0.2413793
NODE_2379_length_1478_cov_23.472081	1212	1241	59	1	29	0.0344828
NODE_2379_length_1478_cov_23.472081	1212	1241	60	1	29	0.0344828
NODE_2379_length_1478_cov_23.472081	1212	1241	61	1	29	0.0344828
NODE_2379_length_1478_cov_23.472081	1212	1241	63	2	29	0.0689655
NODE_2379_length_1478_cov_23.472081	1212	1241	64	4	29	0.1379310
NODE_2379_length_1478_cov_23.472081	1212	1241	65	1	29	0.0344828
NODE_2379_length_1478_cov_23.472081	1212	1241	74	2	29	0.0689655
NODE_2379_length_1478_cov_23.472081	1212	1241	76	3	29	0.1034483
NODE_2379_length_1478_cov_23.472081	1212	1241	80	4	29	0.1379310
NODE_2379_length_1478_cov_23.472081	1212	1241	84	1	29	0.0344828
NODE_2380_length_1478_cov_10.746193	678	758	9	13	80	0.1625000
NODE_2380_length_1478_cov_10.746193	678	758	10	44	80	0.5500000
NODE_2380_length_1478_cov_10.746193	678	758	13	2	80	0.0250000
NODE_2380_length_1478_cov_10.746193	678	758	14	21	80	0.2625000
NODE_2380_length_1478_cov_10.746193	731	811	4	6	80	0.0750000
NODE_2380_length_1478_cov_10.746193	731	811	5	1	80	0.0125000
NODE_2380_length_1478_cov_10.746193	731	811	6	28	80	0.3500000
NODE_2380_length_1478_cov_10.746193	731	811	7	5	80	0.0625000
NODE_2380_length_1478_cov_10.746193	731	811	10	4	80	0.0500000
NODE_2380_length_1478_cov_10.746193	731	811	11	10	80	0.1250000
NODE_2380_length_1478_cov_10.746193	731	811	13	5	80	0.0625000
NODE_2380_length_1478_cov_10.746193	731	811	14	21	80	0.2625000
NODE_2380_length_1478_cov_10.746193	807	892	2	45	85	0.5294118
NODE_2380_length_1478_cov_10.746193	807	892	6	40	85	0.4705882
NODE_2380_length_1478_cov_10.746193	860	945	0	47	85	0.5529412
NODE_2380_length_1478_cov_10.746193	860	945	2	38	85	0.4470588
NODE_2384_length_1476_cov_6.522150	791	871	0	41	80	0.5125000
NODE_2384_length_1476_cov_6.522150	791	871	2	39	80	0.4875000
NODE_2384_length_1476_cov_6.522150	844	924	0	6	80	0.0750000
NODE_2384_length_1476_cov_6.522150	844	924	2	74	80	0.9250000
NODE_2392_length_1474_cov_11.209455	515	595	0	80	80	1.0000000
NODE_2392_length_1474_cov_11.209455	568	648	0	80	80	1.0000000
NODE_2397_length_1472_cov_22.159505	428	508	0	37	80	0.4625000
NODE_2397_length_1472_cov_22.159505	428	508	2	43	80	0.5375000
NODE_2397_length_1472_cov_22.159505	428	508	0	37	80	0.4625000
NODE_2397_length_1472_cov_22.159505	428	508	2	43	80	0.5375000
NODE_2397_length_1472_cov_22.159505	481	561	0	62	80	0.7750000
NODE_2397_length_1472_cov_22.159505	481	561	6	2	80	0.0250000
NODE_2397_length_1472_cov_22.159505	481	561	15	1	80	0.0125000
NODE_2397_length_1472_cov_22.159505	481	561	17	2	80	0.0250000
NODE_2397_length_1472_cov_22.159505	481	561	19	1	80	0.0125000
NODE_2397_length_1472_cov_22.159505	481	561	22	1	80	0.0125000
NODE_2397_length_1472_cov_22.159505	481	561	24	4	80	0.0500000
NODE_2397_length_1472_cov_22.159505	481	561	26	2	80	0.0250000
NODE_2397_length_1472_cov_22.159505	481	561	28	1	80	0.0125000
NODE_2397_length_1472_cov_22.159505	481	561	30	4	80	0.0500000
NODE_2397_length_1472_cov_22.159505	913	993	0	80	80	1.0000000
NODE_2397_length_1472_cov_22.159505	966	1046	0	30	80	0.3750000
NODE_2397_length_1472_cov_22.159505	966	1046	2	50	80	0.6250000
NODE_2397_length_1472_cov_22.159505	1042	1122	0	19	80	0.2375000
NODE_2397_length_1472_cov_22.159505	1042	1122	2	61	80	0.7625000
NODE_2397_length_1472_cov_22.159505	1095	1175	0	72	80	0.9000000
NODE_2397_length_1472_cov_22.159505	1095	1175	2	8	80	0.1000000
NODE_2398_length_1472_cov_22.018208	523	590	0	58	67	0.8656716
NODE_2398_length_1472_cov_22.018208	523	590	2	9	67	0.1343284
NODE_2398_length_1472_cov_22.018208	563	643	0	80	80	1.0000000
NODE_2398_length_1472_cov_22.018208	639	719	0	31	80	0.3875000
NODE_2398_length_1472_cov_22.018208	639	719	2	19	80	0.2375000
NODE_2398_length_1472_cov_22.018208	639	719	9	30	80	0.3750000
NODE_2398_length_1472_cov_22.018208	692	772	9	46	80	0.5750000
NODE_2398_length_1472_cov_22.018208	692	772	10	23	80	0.2875000
NODE_2398_length_1472_cov_22.018208	692	772	13	2	80	0.0250000
NODE_2398_length_1472_cov_22.018208	692	772	14	9	80	0.1125000
NODE_2404_length_1470_cov_7.042305	5	57	8	4	52	0.0769231
NODE_2404_length_1470_cov_7.042305	5	57	10	3	52	0.0576923
NODE_2404_length_1470_cov_7.042305	5	57	14	2	52	0.0384615
NODE_2404_length_1470_cov_7.042305	5	57	16	1	52	0.0192308
NODE_2404_length_1470_cov_7.042305	5	57	18	3	52	0.0576923
NODE_2404_length_1470_cov_7.042305	5	57	20	1	52	0.0192308
NODE_2404_length_1470_cov_7.042305	5	57	22	2	52	0.0384615
NODE_2404_length_1470_cov_7.042305	5	57	26	3	52	0.0576923
NODE_2404_length_1470_cov_7.042305	5	57	34	2	52	0.0384615
NODE_2404_length_1470_cov_7.042305	5	57	38	31	52	0.5961539
NODE_2405_length_1470_cov_2.185266	199	245	0	46	46	1.0000000
NODE_2407_length_1469_cov_5.683942	834	914	2	19	80	0.2375000
NODE_2407_length_1469_cov_5.683942	834	914	4	61	80	0.7625000
NODE_2407_length_1469_cov_5.683942	887	967	0	10	80	0.1250000
NODE_2407_length_1469_cov_5.683942	887	967	2	36	80	0.4500000
NODE_2407_length_1469_cov_5.683942	887	967	4	34	80	0.4250000
NODE_2410_length_1467_cov_31.231725	1048	1131	0	83	83	1.0000000
NODE_2411_length_1467_cov_19.731725	485	565	2	28	80	0.3500000
NODE_2411_length_1467_cov_19.731725	485	565	6	52	80	0.6500000
NODE_2411_length_1467_cov_19.731725	538	618	0	13	80	0.1625000
NODE_2411_length_1467_cov_19.731725	538	618	4	21	80	0.2625000
NODE_2411_length_1467_cov_19.731725	538	618	6	46	80	0.5750000
NODE_2412_length_1467_cov_11.807749	180	242	6	4	62	0.0645161
NODE_2412_length_1467_cov_11.807749	180	242	8	8	62	0.1290323
NODE_2412_length_1467_cov_11.807749	180	242	12	1	62	0.0161290
NODE_2412_length_1467_cov_11.807749	180	242	16	1	62	0.0161290
NODE_2412_length_1467_cov_11.807749	180	242	18	1	62	0.0161290
NODE_2412_length_1467_cov_11.807749	180	242	20	6	62	0.0967742
NODE_2412_length_1467_cov_11.807749	180	242	22	18	62	0.2903226
NODE_2412_length_1467_cov_11.807749	180	242	23	12	62	0.1935484
NODE_2412_length_1467_cov_11.807749	180	242	25	11	62	0.1774193
NODE_2412_length_1467_cov_11.807749	264	293	12	5	29	0.1724138
NODE_2412_length_1467_cov_11.807749	264	293	16	3	29	0.1034483
NODE_2412_length_1467_cov_11.807749	264	293	20	2	29	0.0689655
NODE_2412_length_1467_cov_11.807749	264	293	22	17	29	0.5862069
NODE_2412_length_1467_cov_11.807749	264	293	24	2	29	0.0689655
NODE_2412_length_1467_cov_11.807749	930	1010	4	38	80	0.4750000
NODE_2412_length_1467_cov_11.807749	930	1010	10	18	80	0.2250000
NODE_2412_length_1467_cov_11.807749	930	1010	12	24	80	0.3000000
NODE_2412_length_1467_cov_11.807749	983	1063	0	9	80	0.1125000
NODE_2412_length_1467_cov_11.807749	983	1063	6	28	80	0.3500000
NODE_2412_length_1467_cov_11.807749	983	1063	8	3	80	0.0375000
NODE_2412_length_1467_cov_11.807749	983	1063	10	27	80	0.3375000
NODE_2412_length_1467_cov_11.807749	983	1063	12	13	80	0.1625000
NODE_2414_length_1466_cov_41.326993	664	744	0	4	80	0.0500000
NODE_2414_length_1466_cov_41.326993	664	744	2	76	80	0.9500000
NODE_2414_length_1466_cov_41.326993	717	797	0	57	80	0.7125000
NODE_2414_length_1466_cov_41.326993	717	797	2	23	80	0.2875000
NODE_2414_length_1466_cov_41.326993	793	873	0	57	80	0.7125000
NODE_2414_length_1466_cov_41.326993	793	873	2	23	80	0.2875000
NODE_2414_length_1466_cov_41.326993	846	926	0	4	80	0.0500000
NODE_2414_length_1466_cov_41.326993	846	926	2	34	80	0.4250000
NODE_2414_length_1466_cov_41.326993	846	926	4	42	80	0.5250000
NODE_2420_length_1464_cov_6.726740	137	204	12	16	67	0.2388060
NODE_2420_length_1464_cov_6.726740	137	204	14	10	67	0.1492537
NODE_2420_length_1464_cov_6.726740	137	204	18	13	67	0.1940299
NODE_2420_length_1464_cov_6.726740	137	204	22	5	67	0.0746269
NODE_2420_length_1464_cov_6.726740	137	204	24	23	67	0.3432836
NODE_2422_length_1464_cov_2.198535	1301	1363	4	5	62	0.0806452
NODE_2422_length_1464_cov_2.198535	1301	1363	6	10	62	0.1612903
NODE_2422_length_1464_cov_2.198535	1301	1363	8	9	62	0.1451613
NODE_2422_length_1464_cov_2.198535	1301	1363	10	3	62	0.0483871
NODE_2422_length_1464_cov_2.198535	1301	1363	12	1	62	0.0161290
NODE_2422_length_1464_cov_2.198535	1301	1363	14	3	62	0.0483871
NODE_2422_length_1464_cov_2.198535	1301	1363	16	1	62	0.0161290
NODE_2422_length_1464_cov_2.198535	1301	1363	18	1	62	0.0161290
NODE_2422_length_1464_cov_2.198535	1301	1363	20	1	62	0.0161290
NODE_2422_length_1464_cov_2.198535	1301	1363	22	3	62	0.0483871
NODE_2422_length_1464_cov_2.198535	1301	1363	24	2	62	0.0322581
NODE_2422_length_1464_cov_2.198535	1301	1363	26	20	62	0.3225806
NODE_2422_length_1464_cov_2.198535	1301	1363	28	3	62	0.0483871
NODE_2425_length_1463_cov_15.345308	314	394	0	80	80	1.0000000
NODE_2425_length_1463_cov_15.345308	367	447	0	80	80	1.0000000
NODE_2427_length_1462_cov_18.082172	418	498	1	59	80	0.7375000
NODE_2427_length_1462_cov_18.082172	418	498	3	21	80	0.2625000
NODE_2427_length_1462_cov_18.082172	471	551	0	2	80	0.0250000
NODE_2427_length_1462_cov_18.082172	471	551	1	6	80	0.0750000
NODE_2427_length_1462_cov_18.082172	471	551	2	40	80	0.5000000
NODE_2427_length_1462_cov_18.082172	471	551	3	32	80	0.4000000
NODE_2427_length_1462_cov_18.082172	1036	1116	0	12	80	0.1500000
NODE_2427_length_1462_cov_18.082172	1036	1116	4	68	80	0.8500000
NODE_2427_length_1462_cov_18.082172	1089	1169	0	65	80	0.8125000
NODE_2427_length_1462_cov_18.082172	1089	1169	4	15	80	0.1875000
NODE_2428_length_1462_cov_1.792370	1247	1319	0	72	72	1.0000000
NODE_2428_length_1462_cov_1.792370	1305	1374	0	69	69	1.0000000
NODE_2433_length_1460_cov_23.927994	852	932	10	10	80	0.1250000
NODE_2433_length_1460_cov_23.927994	852	932	14	24	80	0.3000000
NODE_2433_length_1460_cov_23.927994	852	932	16	27	80	0.3375000
NODE_2433_length_1460_cov_23.927994	852	932	20	19	80	0.2375000
NODE_2433_length_1460_cov_23.927994	905	985	4	7	80	0.0875000
NODE_2433_length_1460_cov_23.927994	905	985	6	6	80	0.0750000
NODE_2433_length_1460_cov_23.927994	905	985	10	7	80	0.0875000
NODE_2433_length_1460_cov_23.927994	905	985	16	14	80	0.1750000
NODE_2433_length_1460_cov_23.927994	905	985	19	1	80	0.0125000
NODE_2433_length_1460_cov_23.927994	905	985	20	45	80	0.5625000
NODE_2436_length_1459_cov_43.600000	535	615	0	42	80	0.5250000
NODE_2436_length_1459_cov_43.600000	535	615	2	36	80	0.4500000
NODE_2436_length_1459_cov_43.600000	535	615	4	2	80	0.0250000
NODE_2436_length_1459_cov_43.600000	588	668	2	25	80	0.3125000
NODE_2436_length_1459_cov_43.600000	588	668	4	22	80	0.2750000
NODE_2436_length_1459_cov_43.600000	588	668	6	15	80	0.1875000
NODE_2436_length_1459_cov_43.600000	588	668	8	18	80	0.2250000
NODE_2436_length_1459_cov_43.600000	664	744	4	7	80	0.0875000
NODE_2436_length_1459_cov_43.600000	664	744	6	61	80	0.7625000
NODE_2436_length_1459_cov_43.600000	664	744	8	12	80	0.1500000
NODE_2436_length_1459_cov_43.600000	717	797	2	8	80	0.1000000
NODE_2436_length_1459_cov_43.600000	717	797	4	52	80	0.6500000
NODE_2436_length_1459_cov_43.600000	717	797	6	20	80	0.2500000
NODE_2437_length_1459_cov_32.276471	865	945	0	80	80	1.0000000
NODE_2437_length_1459_cov_32.276471	918	998	0	69	80	0.8625000
NODE_2437_length_1459_cov_32.276471	918	998	2	2	80	0.0250000
NODE_2437_length_1459_cov_32.276471	918	998	4	9	80	0.1125000
NODE_2437_length_1459_cov_32.276471	994	1074	4	19	80	0.2375000
NODE_2437_length_1459_cov_32.276471	994	1074	6	12	80	0.1500000
NODE_2437_length_1459_cov_32.276471	994	1074	8	49	80	0.6125000
NODE_2437_length_1459_cov_32.276471	1047	1127	0	12	80	0.1500000
NODE_2437_length_1459_cov_32.276471	1047	1127	2	8	80	0.1000000
NODE_2437_length_1459_cov_32.276471	1047	1127	4	9	80	0.1125000
NODE_2437_length_1459_cov_32.276471	1047	1127	6	20	80	0.2500000
NODE_2437_length_1459_cov_32.276471	1047	1127	8	31	80	0.3875000
NODE_2441_length_1458_cov_2.184695	1361	1441	2	55	80	0.6875000
NODE_2441_length_1458_cov_2.184695	1361	1441	4	25	80	0.3125000
NODE_2442_length_1457_cov_19.687040	834	914	4	25	80	0.3125000
NODE_2442_length_1457_cov_19.687040	834	914	6	55	80	0.6875000
NODE_2442_length_1457_cov_19.687040	887	967	2	12	80	0.1500000
NODE_2442_length_1457_cov_19.687040	887	967	6	68	80	0.8500000
NODE_2442_length_1457_cov_19.687040	963	1043	0	26	80	0.3250000
NODE_2442_length_1457_cov_19.687040	963	1043	2	11	80	0.1375000
NODE_2442_length_1457_cov_19.687040	963	1043	6	43	80	0.5375000
NODE_2442_length_1457_cov_19.687040	1016	1096	4	1	80	0.0125000
NODE_2442_length_1457_cov_19.687040	1016	1096	6	79	80	0.9875000
NODE_2444_length_1457_cov_14.944772	754	834	0	15	80	0.1875000
NODE_2444_length_1457_cov_14.944772	754	834	2	15	80	0.1875000
NODE_2444_length_1457_cov_14.944772	754	834	4	26	80	0.3250000
NODE_2444_length_1457_cov_14.944772	754	834	8	24	80	0.3000000
NODE_2444_length_1457_cov_14.944772	807	887	2	17	80	0.2125000
NODE_2444_length_1457_cov_14.944772	807	887	4	9	80	0.1125000
NODE_2444_length_1457_cov_14.944772	807	887	6	14	80	0.1750000
NODE_2444_length_1457_cov_14.944772	807	887	8	40	80	0.5000000
NODE_2445_length_1457_cov_10.168630	827	907	1	51	80	0.6375000
NODE_2445_length_1457_cov_10.168630	827	907	2	22	80	0.2750000
NODE_2445_length_1457_cov_10.168630	827	907	3	7	80	0.0875000
NODE_2445_length_1457_cov_10.168630	880	960	1	5	80	0.0625000
NODE_2445_length_1457_cov_10.168630	880	960	2	75	80	0.9375000
NODE_2445_length_1457_cov_10.168630	956	1036	1	21	80	0.2625000
NODE_2445_length_1457_cov_10.168630	956	1036	2	10	80	0.1250000
NODE_2445_length_1457_cov_10.168630	956	1036	6	2	80	0.0250000
NODE_2445_length_1457_cov_10.168630	956	1036	7	47	80	0.5875000
NODE_2445_length_1457_cov_10.168630	1009	1089	6	55	80	0.6875000
NODE_2445_length_1457_cov_10.168630	1009	1089	7	25	80	0.3125000
NODE_2448_length_1456_cov_13.675755	557	637	2	24	80	0.3000000
NODE_2448_length_1456_cov_13.675755	557	637	4	1	80	0.0125000
NODE_2448_length_1456_cov_13.675755	557	637	6	2	80	0.0250000
NODE_2448_length_1456_cov_13.675755	557	637	8	53	80	0.6625000
NODE_2448_length_1456_cov_13.675755	610	690	4	28	80	0.3500000
NODE_2448_length_1456_cov_13.675755	610	690	6	6	80	0.0750000
NODE_2448_length_1456_cov_13.675755	610	690	8	46	80	0.5750000
NODE_2449_length_1456_cov_11.109064	951	1031	0	80	80	1.0000000
NODE_2449_length_1456_cov_11.109064	1004	1084	0	80	80	1.0000000
NODE_2452_length_1456_cov_3.137067	374	410	0	5	36	0.1388889
NODE_2452_length_1456_cov_3.137067	374	410	2	12	36	0.3333333
NODE_2452_length_1456_cov_3.137067	374	410	4	1	36	0.0277778
NODE_2452_length_1456_cov_3.137067	374	410	6	17	36	0.4722222
NODE_2452_length_1456_cov_3.137067	374	410	8	1	36	0.0277778
NODE_2454_length_1456_cov_1.889462	35	99	2	64	64	1.0000000
NODE_2456_length_1455_cov_60.874631	369	449	2	80	80	1.0000000
NODE_2456_length_1455_cov_60.874631	422	502	0	32	80	0.4000000
NODE_2456_length_1455_cov_60.874631	422	502	2	48	80	0.6000000
NODE_2456_length_1455_cov_60.874631	498	578	2	41	80	0.5125000
NODE_2456_length_1455_cov_60.874631	498	578	4	39	80	0.4875000
NODE_2456_length_1455_cov_60.874631	551	631	0	4	80	0.0500000
NODE_2456_length_1455_cov_60.874631	551	631	2	26	80	0.3250000
NODE_2456_length_1455_cov_60.874631	551	631	4	50	80	0.6250000
NODE_2458_length_1455_cov_35.253687	615	695	0	13	80	0.1625000
NODE_2458_length_1455_cov_35.253687	615	695	2	67	80	0.8375000
NODE_2458_length_1455_cov_35.253687	668	748	0	39	80	0.4875000
NODE_2458_length_1455_cov_35.253687	668	748	2	41	80	0.5125000
NODE_2458_length_1455_cov_35.253687	744	824	0	15	80	0.1875000
NODE_2458_length_1455_cov_35.253687	744	824	2	6	80	0.0750000
NODE_2458_length_1455_cov_35.253687	744	824	4	59	80	0.7375000
NODE_2458_length_1455_cov_35.253687	797	877	2	22	80	0.2750000
NODE_2458_length_1455_cov_35.253687	797	877	4	58	80	0.7250000
NODE_2465_length_1452_cov_7.101256	976	1056	0	80	80	1.0000000
NODE_2465_length_1452_cov_7.101256	1029	1109	0	80	80	1.0000000
NODE_2465_length_1452_cov_7.101256	1105	1185	0	38	80	0.4750000
NODE_2465_length_1452_cov_7.101256	1105	1185	2	42	80	0.5250000
NODE_2465_length_1452_cov_7.101256	1158	1238	2	80	80	1.0000000
NODE_2470_length_1451_cov_23.880178	439	520	6	6	81	0.0740741
NODE_2470_length_1451_cov_23.880178	439	520	13	1	81	0.0123457
NODE_2470_length_1451_cov_23.880178	439	520	14	9	81	0.1111111
NODE_2470_length_1451_cov_23.880178	439	520	16	1	81	0.0123457
NODE_2470_length_1451_cov_23.880178	439	520	18	12	81	0.1481481
NODE_2470_length_1451_cov_23.880178	439	520	20	1	81	0.0123457
NODE_2470_length_1451_cov_23.880178	439	520	21	16	81	0.1975309
NODE_2470_length_1451_cov_23.880178	439	520	22	22	81	0.2716049
NODE_2470_length_1451_cov_23.880178	439	520	25	13	81	0.1604938
NODE_2470_length_1451_cov_23.880178	493	573	8	2	80	0.0250000
NODE_2470_length_1451_cov_23.880178	493	573	15	1	80	0.0125000
NODE_2470_length_1451_cov_23.880178	493	573	17	6	80	0.0750000
NODE_2470_length_1451_cov_23.880178	493	573	19	10	80	0.1250000
NODE_2470_length_1451_cov_23.880178	493	573	21	26	80	0.3250000
NODE_2470_length_1451_cov_23.880178	493	573	22	2	80	0.0250000
NODE_2470_length_1451_cov_23.880178	493	573	24	7	80	0.0875000
NODE_2470_length_1451_cov_23.880178	493	573	25	26	80	0.3250000
NODE_2471_length_1451_cov_16.249260	422	502	0	52	80	0.6500000
NODE_2471_length_1451_cov_16.249260	422	502	2	28	80	0.3500000
NODE_2471_length_1451_cov_16.249260	475	555	2	80	80	1.0000000
NODE_2472_length_1451_cov_8.663462	908	988	0	80	80	1.0000000
NODE_2472_length_1451_cov_8.663462	961	1040	0	79	79	1.0000000
NODE_2474_length_1451_cov_5.219675	897	977	0	17	80	0.2125000
NODE_2474_length_1451_cov_5.219675	897	977	2	63	80	0.7875000
NODE_2474_length_1451_cov_5.219675	950	1030	0	33	80	0.4125000
NODE_2474_length_1451_cov_5.219675	950	1030	2	47	80	0.5875000
NODE_2477_length_1450_cov_20.371577	611	691	2	22	80	0.2750000
NODE_2477_length_1450_cov_20.371577	611	691	4	16	80	0.2000000
NODE_2477_length_1450_cov_20.371577	611	691	6	34	80	0.4250000
NODE_2477_length_1450_cov_20.371577	611	691	8	8	80	0.1000000
NODE_2477_length_1450_cov_20.371577	664	744	2	1	80	0.0125000
NODE_2477_length_1450_cov_20.371577	664	744	4	6	80	0.0750000
NODE_2477_length_1450_cov_20.371577	664	744	6	62	80	0.7750000
NODE_2477_length_1450_cov_20.371577	664	744	8	11	80	0.1375000
NODE_2482_length_1449_cov_24.665926	432	512	0	32	80	0.4000000
NODE_2482_length_1449_cov_24.665926	432	512	1	1	80	0.0125000
NODE_2482_length_1449_cov_24.665926	432	512	2	47	80	0.5875000
NODE_2482_length_1449_cov_24.665926	485	565	0	80	80	1.0000000
NODE_2482_length_1449_cov_24.665926	561	643	0	82	82	1.0000000
NODE_2482_length_1449_cov_24.665926	616	696	0	80	80	1.0000000
NODE_2485_length_1448_cov_20.587102	904	984	2	32	80	0.4000000
NODE_2485_length_1448_cov_20.587102	904	984	4	48	80	0.6000000
NODE_2485_length_1448_cov_20.587102	957	1037	0	7	80	0.0875000
NODE_2485_length_1448_cov_20.587102	957	1037	2	73	80	0.9125000
NODE_2487_length_1448_cov_8.693847	537	617	0	9	80	0.1125000
NODE_2487_length_1448_cov_8.693847	537	617	2	66	80	0.8250000
NODE_2487_length_1448_cov_8.693847	537	617	4	5	80	0.0625000
NODE_2487_length_1448_cov_8.693847	590	670	2	22	80	0.2750000
NODE_2487_length_1448_cov_8.693847	590	670	4	23	80	0.2875000
NODE_2487_length_1448_cov_8.693847	590	670	6	35	80	0.4375000
NODE_2488_length_1447_cov_21.391691	519	599	2	24	80	0.3000000
NODE_2488_length_1447_cov_21.391691	519	599	4	56	80	0.7000000
NODE_2488_length_1447_cov_21.391691	572	652	3	10	80	0.1250000
NODE_2488_length_1447_cov_21.391691	572	652	4	45	80	0.5625000
NODE_2488_length_1447_cov_21.391691	572	652	5	6	80	0.0750000
NODE_2488_length_1447_cov_21.391691	572	652	6	5	80	0.0625000
NODE_2488_length_1447_cov_21.391691	572	652	7	14	80	0.1750000
NODE_2488_length_1447_cov_21.391691	648	728	2	3	80	0.0375000
NODE_2488_length_1447_cov_21.391691	648	728	4	31	80	0.3875000
NODE_2488_length_1447_cov_21.391691	648	728	6	46	80	0.5750000
NODE_2488_length_1447_cov_21.391691	701	781	2	56	80	0.7000000
NODE_2488_length_1447_cov_21.391691	701	781	4	22	80	0.2750000
NODE_2488_length_1447_cov_21.391691	701	781	6	2	80	0.0250000
NODE_2491_length_1447_cov_2.262611	1268	1325	6	2	57	0.0350877
NODE_2491_length_1447_cov_2.262611	1268	1325	7	9	57	0.1578947
NODE_2491_length_1447_cov_2.262611	1268	1325	11	8	57	0.1403509
NODE_2491_length_1447_cov_2.262611	1268	1325	15	1	57	0.0175439
NODE_2491_length_1447_cov_2.262611	1268	1325	17	1	57	0.0175439
NODE_2491_length_1447_cov_2.262611	1268	1325	18	1	57	0.0175439
NODE_2491_length_1447_cov_2.262611	1268	1325	19	1	57	0.0175439
NODE_2491_length_1447_cov_2.262611	1268	1325	20	2	57	0.0350877
NODE_2491_length_1447_cov_2.262611	1268	1325	22	5	57	0.0877193
NODE_2491_length_1447_cov_2.262611	1268	1325	26	24	57	0.4210526
NODE_2491_length_1447_cov_2.262611	1268	1325	28	3	57	0.0526316
NODE_2491_length_1447_cov_2.262611	1321	1378	26	5	57	0.0877193
NODE_2491_length_1447_cov_2.262611	1321	1378	28	18	57	0.3157895
NODE_2491_length_1447_cov_2.262611	1321	1378	30	34	57	0.5964912
NODE_2494_length_1445_cov_22.052006	759	839	0	7	80	0.0875000
NODE_2494_length_1445_cov_22.052006	759	839	4	49	80	0.6125000
NODE_2494_length_1445_cov_22.052006	759	839	5	24	80	0.3000000
NODE_2494_length_1445_cov_22.052006	812	892	1	33	80	0.4125000
NODE_2494_length_1445_cov_22.052006	812	892	4	3	80	0.0375000
NODE_2494_length_1445_cov_22.052006	812	892	5	44	80	0.5500000
NODE_2494_length_1445_cov_22.052006	888	968	0	4	80	0.0500000
NODE_2494_length_1445_cov_22.052006	888	968	1	76	80	0.9500000
NODE_2494_length_1445_cov_22.052006	941	1021	0	57	80	0.7125000
NODE_2494_length_1445_cov_22.052006	941	1021	1	23	80	0.2875000
NODE_2495_length_1445_cov_13.378900	584	664	0	80	80	1.0000000
NODE_2495_length_1445_cov_13.378900	637	717	0	80	80	1.0000000
NODE_2501_length_1443_cov_7.628720	480	560	0	2	80	0.0250000
NODE_2501_length_1443_cov_7.628720	480	560	2	61	80	0.7625000
NODE_2501_length_1443_cov_7.628720	480	560	4	17	80	0.2125000
NODE_2501_length_1443_cov_7.628720	533	613	0	55	80	0.6875000
NODE_2501_length_1443_cov_7.628720	533	613	2	25	80	0.3125000
NODE_2501_length_1443_cov_7.628720	609	689	0	59	80	0.7375000
NODE_2501_length_1443_cov_7.628720	609	689	2	21	80	0.2625000
NODE_2501_length_1443_cov_7.628720	662	742	0	6	80	0.0750000
NODE_2501_length_1443_cov_7.628720	662	742	2	74	80	0.9250000
NODE_2502_length_1443_cov_4.843006	924	1004	0	56	80	0.7000000
NODE_2502_length_1443_cov_4.843006	924	1004	2	24	80	0.3000000
NODE_2502_length_1443_cov_4.843006	977	1057	0	80	80	1.0000000
NODE_2508_length_1442_cov_24.551750	427	507	0	27	80	0.3375000
NODE_2508_length_1442_cov_24.551750	427	507	2	53	80	0.6625000
NODE_2508_length_1442_cov_24.551750	480	560	0	80	80	1.0000000
NODE_2508_length_1442_cov_24.551750	556	636	0	41	80	0.5125000
NODE_2508_length_1442_cov_24.551750	556	636	2	14	80	0.1750000
NODE_2508_length_1442_cov_24.551750	556	636	4	25	80	0.3125000
NODE_2508_length_1442_cov_24.551750	609	689	2	2	80	0.0250000
NODE_2508_length_1442_cov_24.551750	609	689	4	78	80	0.9750000
NODE_2509_length_1442_cov_24.032762	424	504	6	6	80	0.0750000
NODE_2509_length_1442_cov_24.032762	424	504	9	15	80	0.1875000
NODE_2509_length_1442_cov_24.032762	424	504	10	56	80	0.7000000
NODE_2509_length_1442_cov_24.032762	424	504	11	3	80	0.0375000
NODE_2509_length_1442_cov_24.032762	477	557	1	1	80	0.0125000
NODE_2509_length_1442_cov_24.032762	477	557	2	26	80	0.3250000
NODE_2509_length_1442_cov_24.032762	477	557	5	5	80	0.0625000
NODE_2509_length_1442_cov_24.032762	477	557	9	36	80	0.4500000
NODE_2509_length_1442_cov_24.032762	477	557	10	9	80	0.1125000
NODE_2509_length_1442_cov_24.032762	477	557	11	3	80	0.0375000
NODE_2511_length_1441_cov_16.528316	963	1043	0	26	80	0.3250000
NODE_2511_length_1441_cov_16.528316	963	1043	2	54	80	0.6750000
NODE_2511_length_1441_cov_16.528316	1016	1096	2	27	80	0.3375000
NODE_2511_length_1441_cov_16.528316	1016	1096	4	27	80	0.3375000
NODE_2511_length_1441_cov_16.528316	1016	1096	6	26	80	0.3250000
NODE_2512_length_1441_cov_3.781669	80	156	0	76	76	1.0000000
NODE_2512_length_1441_cov_3.781669	129	209	0	80	80	1.0000000
NODE_2515_length_1440_cov_34.523490	446	526	0	80	80	1.0000000
NODE_2515_length_1440_cov_34.523490	499	576	0	60	77	0.7792208
NODE_2515_length_1440_cov_34.523490	499	576	2	17	77	0.2207792
NODE_2515_length_1440_cov_34.523490	576	654	2	15	78	0.1923077
NODE_2515_length_1440_cov_34.523490	576	654	4	59	78	0.7564102
NODE_2515_length_1440_cov_34.523490	576	654	6	4	78	0.0512821
NODE_2515_length_1440_cov_34.523490	627	707	4	37	80	0.4625000
NODE_2515_length_1440_cov_34.523490	627	707	6	36	80	0.4500000
NODE_2515_length_1440_cov_34.523490	627	707	8	7	80	0.0875000
NODE_2516_length_1440_cov_20.372110	776	856	0	16	80	0.2000000
NODE_2516_length_1440_cov_20.372110	776	856	2	64	80	0.8000000
NODE_2516_length_1440_cov_20.372110	829	909	0	31	80	0.3875000
NODE_2516_length_1440_cov_20.372110	829	909	2	49	80	0.6125000
NODE_2516_length_1440_cov_20.372110	905	985	0	80	80	1.0000000
NODE_2516_length_1440_cov_20.372110	958	1038	0	80	80	1.0000000
NODE_2517_length_1440_cov_14.476510	586	615	0	29	29	1.0000000
NODE_2517_length_1440_cov_14.476510	666	695	0	29	29	1.0000000
NODE_2517_length_1440_cov_14.476510	1295	1359	60	1	64	0.0156250
NODE_2517_length_1440_cov_14.476510	1295	1359	62	2	64	0.0312500
NODE_2517_length_1440_cov_14.476510	1295	1359	64	1	64	0.0156250
NODE_2517_length_1440_cov_14.476510	1295	1359	68	3	64	0.0468750
NODE_2517_length_1440_cov_14.476510	1295	1359	70	9	64	0.1406250
NODE_2517_length_1440_cov_14.476510	1295	1359	74	4	64	0.0625000
NODE_2517_length_1440_cov_14.476510	1295	1359	78	3	64	0.0468750
NODE_2517_length_1440_cov_14.476510	1295	1359	80	2	64	0.0312500
NODE_2517_length_1440_cov_14.476510	1295	1359	82	4	64	0.0625000
NODE_2517_length_1440_cov_14.476510	1295	1359	84	1	64	0.0156250
NODE_2517_length_1440_cov_14.476510	1295	1359	85	5	64	0.0781250
NODE_2517_length_1440_cov_14.476510	1295	1359	86	17	64	0.2656250
NODE_2517_length_1440_cov_14.476510	1295	1359	88	1	64	0.0156250
NODE_2517_length_1440_cov_14.476510	1295	1359	90	2	64	0.0312500
NODE_2517_length_1440_cov_14.476510	1295	1359	92	9	64	0.1406250
NODE_2518_length_1440_cov_9.049217	384	464	0	80	80	1.0000000
NODE_2518_length_1440_cov_9.049217	437	517	0	80	80	1.0000000
NODE_2520_length_1439_cov_11.784328	898	978	0	80	80	1.0000000
NODE_2520_length_1439_cov_11.784328	951	1031	0	80	80	1.0000000
NODE_2525_length_1438_cov_41.481703	671	751	2	46	80	0.5750000
NODE_2525_length_1438_cov_41.481703	671	751	4	19	80	0.2375000
NODE_2525_length_1438_cov_41.481703	671	751	6	15	80	0.1875000
NODE_2525_length_1438_cov_41.481703	724	804	4	35	80	0.4375000
NODE_2525_length_1438_cov_41.481703	724	804	6	45	80	0.5625000
NODE_2529_length_1437_cov_14.449178	815	895	0	50	80	0.6250000
NODE_2529_length_1437_cov_14.449178	815	895	2	30	80	0.3750000
NODE_2529_length_1437_cov_14.449178	868	948	0	80	80	1.0000000
NODE_2529_length_1437_cov_14.449178	944	1024	0	80	80	1.0000000
NODE_2529_length_1437_cov_14.449178	997	1077	0	80	80	1.0000000
NODE_2532_length_1436_cov_96.256545	1145	1225	2	38	80	0.4750000
NODE_2532_length_1436_cov_96.256545	1145	1225	4	12	80	0.1500000
NODE_2532_length_1436_cov_96.256545	1145	1225	6	30	80	0.3750000
NODE_2532_length_1436_cov_96.256545	1198	1278	2	6	80	0.0750000
NODE_2532_length_1436_cov_96.256545	1198	1278	4	1	80	0.0125000
NODE_2532_length_1436_cov_96.256545	1198	1278	6	73	80	0.9125000
NODE_2532_length_1436_cov_96.256545	1274	1354	0	9	80	0.1125000
NODE_2532_length_1436_cov_96.256545	1274	1354	2	21	80	0.2625000
NODE_2532_length_1436_cov_96.256545	1274	1354	4	50	80	0.6250000
NODE_2532_length_1436_cov_96.256545	1327	1407	0	62	80	0.7750000
NODE_2532_length_1436_cov_96.256545	1327	1407	2	17	80	0.2125000
NODE_2532_length_1436_cov_96.256545	1327	1407	4	1	80	0.0125000
NODE_2536_length_1435_cov_21.468563	783	863	0	73	80	0.9125000
NODE_2536_length_1435_cov_21.468563	783	863	2	7	80	0.0875000
NODE_2536_length_1435_cov_21.468563	836	916	0	20	80	0.2500000
NODE_2536_length_1435_cov_21.468563	836	916	2	51	80	0.6375000
NODE_2536_length_1435_cov_21.468563	836	916	4	9	80	0.1125000
NODE_2536_length_1435_cov_21.468563	912	992	4	6	80	0.0750000
NODE_2536_length_1435_cov_21.468563	912	992	8	19	80	0.2375000
NODE_2536_length_1435_cov_21.468563	912	992	10	55	80	0.6875000
NODE_2536_length_1435_cov_21.468563	965	1045	2	14	80	0.1750000
NODE_2536_length_1435_cov_21.468563	965	1045	6	7	80	0.0875000
NODE_2536_length_1435_cov_21.468563	965	1045	8	34	80	0.4250000
NODE_2536_length_1435_cov_21.468563	965	1045	10	25	80	0.3125000
NODE_2537_length_1435_cov_18.593563	1123	1203	6	55	80	0.6875000
NODE_2537_length_1435_cov_18.593563	1123	1203	8	7	80	0.0875000
NODE_2537_length_1435_cov_18.593563	1123	1203	9	9	80	0.1125000
NODE_2537_length_1435_cov_18.593563	1123	1203	11	9	80	0.1125000
NODE_2537_length_1435_cov_18.593563	1176	1256	0	41	80	0.5125000
NODE_2537_length_1435_cov_18.593563	1176	1256	2	10	80	0.1250000
NODE_2537_length_1435_cov_18.593563	1176	1256	6	29	80	0.3625000
NODE_2538_length_1435_cov_5.828593	299	379	2	80	80	1.0000000
NODE_2538_length_1435_cov_5.828593	352	432	0	53	80	0.6625000
NODE_2538_length_1435_cov_5.828593	352	432	2	27	80	0.3375000
NODE_2540_length_1434_cov_17.610487	1023	1103	0	80	80	1.0000000
NODE_2540_length_1434_cov_17.610487	1076	1156	0	80	80	1.0000000
NODE_2540_length_1434_cov_17.610487	1152	1232	0	80	80	1.0000000
NODE_2540_length_1434_cov_17.610487	1205	1285	0	80	80	1.0000000
NODE_2541_length_1434_cov_9.845693	846	926	0	20	80	0.2500000
NODE_2541_length_1434_cov_9.845693	846	926	2	60	80	0.7500000
NODE_2541_length_1434_cov_9.845693	899	978	2	32	79	0.4050633
NODE_2541_length_1434_cov_9.845693	899	978	4	31	79	0.3924051
NODE_2541_length_1434_cov_9.845693	899	978	6	13	79	0.1645570
NODE_2541_length_1434_cov_9.845693	899	978	8	3	79	0.0379747
NODE_2544_length_1433_cov_36.452774	538	618	2	80	80	1.0000000
NODE_2544_length_1433_cov_36.452774	591	671	0	53	80	0.6625000
NODE_2544_length_1433_cov_36.452774	591	671	2	27	80	0.3375000
NODE_2544_length_1433_cov_36.452774	667	747	0	14	80	0.1750000
NODE_2544_length_1433_cov_36.452774	667	747	2	66	80	0.8250000
NODE_2544_length_1433_cov_36.452774	720	800	0	26	80	0.3250000
NODE_2544_length_1433_cov_36.452774	720	800	2	54	80	0.6750000
NODE_2550_length_1431_cov_7.409159	513	593	0	59	80	0.7375000
NODE_2550_length_1431_cov_7.409159	513	593	2	21	80	0.2625000
NODE_2550_length_1431_cov_7.409159	566	646	0	6	80	0.0750000
NODE_2550_length_1431_cov_7.409159	566	646	2	74	80	0.9250000
NODE_2551_length_1431_cov_6.721471	1074	1154	0	80	80	1.0000000
NODE_2551_length_1431_cov_6.721471	1127	1207	0	80	80	1.0000000
NODE_2552_length_1430_cov_32.643877	753	833	0	67	80	0.8375000
NODE_2552_length_1430_cov_32.643877	753	833	1	13	80	0.1625000
NODE_2552_length_1430_cov_32.643877	806	886	0	14	80	0.1750000
NODE_2552_length_1430_cov_32.643877	806	886	1	66	80	0.8250000
NODE_2552_length_1430_cov_32.643877	882	962	1	45	80	0.5625000
NODE_2552_length_1430_cov_32.643877	882	962	2	15	80	0.1875000
NODE_2552_length_1430_cov_32.643877	882	962	3	20	80	0.2500000
NODE_2552_length_1430_cov_32.643877	935	1016	2	53	81	0.6543210
NODE_2552_length_1430_cov_32.643877	935	1016	3	28	81	0.3456790
NODE_2557_length_1428_cov_5.895410	340	416	0	29	76	0.3815790
NODE_2557_length_1428_cov_5.895410	340	416	2	2	76	0.0263158
NODE_2557_length_1428_cov_5.895410	340	416	4	45	76	0.5921053
NODE_2557_length_1428_cov_5.895410	393	476	0	24	83	0.2891566
NODE_2557_length_1428_cov_5.895410	393	476	2	7	83	0.0843373
NODE_2557_length_1428_cov_5.895410	393	476	4	52	83	0.6265060
NODE_2560_length_1427_cov_38.919428	707	787	0	75	80	0.9375000
NODE_2560_length_1427_cov_38.919428	707	787	2	5	80	0.0625000
NODE_2560_length_1427_cov_38.919428	760	840	0	22	80	0.2750000
NODE_2560_length_1427_cov_38.919428	760	840	2	58	80	0.7250000
NODE_2560_length_1427_cov_38.919428	836	916	2	47	80	0.5875000
NODE_2560_length_1427_cov_38.919428	836	916	4	33	80	0.4125000
NODE_2560_length_1427_cov_38.919428	889	969	0	40	80	0.5000000
NODE_2560_length_1427_cov_38.919428	889	969	2	40	80	0.5000000
NODE_2561_length_1427_cov_19.442771	808	888	4	36	80	0.4500000
NODE_2561_length_1427_cov_19.442771	808	888	6	28	80	0.3500000
NODE_2561_length_1427_cov_19.442771	808	888	7	1	80	0.0125000
NODE_2561_length_1427_cov_19.442771	808	888	8	15	80	0.1875000
NODE_2561_length_1427_cov_19.442771	861	941	0	9	80	0.1125000
NODE_2561_length_1427_cov_19.442771	861	941	2	43	80	0.5375000
NODE_2561_length_1427_cov_19.442771	861	941	4	28	80	0.3500000
NODE_2561_length_1427_cov_19.442771	937	1017	0	80	80	1.0000000
NODE_2561_length_1427_cov_19.442771	990	1070	0	80	80	1.0000000
NODE_2562_length_1427_cov_10.490964	728	808	0	80	80	1.0000000
NODE_2562_length_1427_cov_10.490964	781	861	0	80	80	1.0000000
NODE_2562_length_1427_cov_10.490964	857	937	0	80	80	1.0000000
NODE_2562_length_1427_cov_10.490964	910	990	0	80	80	1.0000000
NODE_2563_length_1427_cov_9.929217	646	726	2	15	80	0.1875000
NODE_2563_length_1427_cov_9.929217	646	726	4	65	80	0.8125000
NODE_2563_length_1427_cov_9.929217	699	779	0	21	80	0.2625000
NODE_2563_length_1427_cov_9.929217	699	779	2	31	80	0.3875000
NODE_2563_length_1427_cov_9.929217	699	779	4	28	80	0.3500000
NODE_2563_length_1427_cov_9.929217	775	855	0	80	80	1.0000000
NODE_2563_length_1427_cov_9.929217	828	908	0	80	80	1.0000000
NODE_2563_length_1427_cov_9.929217	1248	1324	0	76	76	1.0000000
NODE_2563_length_1427_cov_9.929217	1301	1376	0	75	75	1.0000000
NODE_2564_length_1427_cov_3.122741	1336	1399	0	63	63	1.0000000
NODE_2570_length_1426_cov_36.580256	422	502	0	30	80	0.3750000
NODE_2570_length_1426_cov_36.580256	422	502	2	50	80	0.6250000
NODE_2570_length_1426_cov_36.580256	475	555	0	6	80	0.0750000
NODE_2570_length_1426_cov_36.580256	475	555	2	74	80	0.9250000
NODE_2570_length_1426_cov_36.580256	551	631	0	47	80	0.5875000
NODE_2570_length_1426_cov_36.580256	551	631	2	31	80	0.3875000
NODE_2570_length_1426_cov_36.580256	551	631	4	2	80	0.0250000
NODE_2570_length_1426_cov_36.580256	604	684	2	36	80	0.4500000
NODE_2570_length_1426_cov_36.580256	604	684	4	44	80	0.5500000
NODE_2574_length_1425_cov_25.524133	561	641	0	41	80	0.5125000
NODE_2574_length_1425_cov_25.524133	561	641	2	39	80	0.4875000
NODE_2574_length_1425_cov_25.524133	614	694	0	80	80	1.0000000
NODE_2575_length_1425_cov_10.175716	361	441	0	2	80	0.0250000
NODE_2575_length_1425_cov_10.175716	361	441	6	39	80	0.4875000
NODE_2575_length_1425_cov_10.175716	361	441	10	1	80	0.0125000
NODE_2575_length_1425_cov_10.175716	361	441	14	38	80	0.4750000
NODE_2575_length_1425_cov_10.175716	414	494	14	80	80	1.0000000
NODE_2587_length_1423_cov_31.158610	862	942	2	80	80	1.0000000
NODE_2587_length_1423_cov_31.158610	915	995	0	47	80	0.5875000
NODE_2587_length_1423_cov_31.158610	915	995	2	33	80	0.4125000
NODE_2588_length_1423_cov_30.731873	764	844	0	80	80	1.0000000
NODE_2588_length_1423_cov_30.731873	817	897	0	80	80	1.0000000
NODE_2596_length_1421_cov_8.285930	136	212	127	2	76	0.0263158
NODE_2596_length_1421_cov_8.285930	136	212	128	3	76	0.0394737
NODE_2596_length_1421_cov_8.285930	136	212	130	1	76	0.0131579
NODE_2596_length_1421_cov_8.285930	136	212	131	4	76	0.0526316
NODE_2596_length_1421_cov_8.285930	136	212	133	4	76	0.0526316
NODE_2596_length_1421_cov_8.285930	136	212	141	3	76	0.0394737
NODE_2596_length_1421_cov_8.285930	136	212	143	5	76	0.0657895
NODE_2596_length_1421_cov_8.285930	136	212	148	4	76	0.0526316
NODE_2596_length_1421_cov_8.285930	136	212	149	3	76	0.0394737
NODE_2596_length_1421_cov_8.285930	136	212	150	1	76	0.0131579
NODE_2596_length_1421_cov_8.285930	136	212	154	1	76	0.0131579
NODE_2596_length_1421_cov_8.285930	136	212	159	1	76	0.0131579
NODE_2596_length_1421_cov_8.285930	136	212	164	1	76	0.0131579
NODE_2596_length_1421_cov_8.285930	136	212	166	1	76	0.0131579
NODE_2596_length_1421_cov_8.285930	136	212	169	1	76	0.0131579
NODE_2596_length_1421_cov_8.285930	136	212	171	1	76	0.0131579
NODE_2596_length_1421_cov_8.285930	136	212	173	3	76	0.0394737
NODE_2596_length_1421_cov_8.285930	136	212	177	3	76	0.0394737
NODE_2596_length_1421_cov_8.285930	136	212	180	1	76	0.0131579
NODE_2596_length_1421_cov_8.285930	136	212	183	1	76	0.0131579
NODE_2596_length_1421_cov_8.285930	136	212	185	3	76	0.0394737
NODE_2596_length_1421_cov_8.285930	136	212	187	1	76	0.0131579
NODE_2596_length_1421_cov_8.285930	136	212	188	1	76	0.0131579
NODE_2596_length_1421_cov_8.285930	136	212	189	6	76	0.0789474
NODE_2596_length_1421_cov_8.285930	136	212	190	1	76	0.0131579
NODE_2596_length_1421_cov_8.285930	136	212	191	2	76	0.0263158
NODE_2596_length_1421_cov_8.285930	136	212	199	1	76	0.0131579
NODE_2596_length_1421_cov_8.285930	136	212	200	3	76	0.0394737
NODE_2596_length_1421_cov_8.285930	136	212	202	7	76	0.0921053
NODE_2596_length_1421_cov_8.285930	136	212	203	1	76	0.0131579
NODE_2596_length_1421_cov_8.285930	136	212	204	6	76	0.0789474
NODE_2598_length_1421_cov_2.574130	22	102	8	80	80	1.0000000
NODE_2598_length_1421_cov_2.574130	75	132	4	28	57	0.4912281
NODE_2598_length_1421_cov_2.574130	75	132	8	29	57	0.5087720
NODE_2599_length_1420_cov_256.442846	60	140	2	68	80	0.8500000
NODE_2599_length_1420_cov_256.442846	60	140	4	12	80	0.1500000
NODE_2599_length_1420_cov_256.442846	1294	1360	6	2	66	0.0303030
NODE_2599_length_1420_cov_256.442846	1294	1360	10	6	66	0.0909091
NODE_2599_length_1420_cov_256.442846	1294	1360	12	1	66	0.0151515
NODE_2599_length_1420_cov_256.442846	1294	1360	13	1	66	0.0151515
NODE_2599_length_1420_cov_256.442846	1294	1360	16	1	66	0.0151515
NODE_2599_length_1420_cov_256.442846	1294	1360	18	1	66	0.0151515
NODE_2599_length_1420_cov_256.442846	1294	1360	20	4	66	0.0606061
NODE_2599_length_1420_cov_256.442846	1294	1360	22	3	66	0.0454545
NODE_2599_length_1420_cov_256.442846	1294	1360	24	47	66	0.7121212
NODE_2600_length_1420_cov_7.547313	628	708	0	80	80	1.0000000
NODE_2600_length_1420_cov_7.547313	681	761	0	80	80	1.0000000
NODE_2602_length_1420_cov_2.051476	972	1039	0	62	67	0.9253731
NODE_2602_length_1420_cov_2.051476	972	1039	2	5	67	0.0746269
NODE_2604_length_1419_cov_46.997727	1230	1305	0	10	75	0.1333333
NODE_2604_length_1419_cov_46.997727	1230	1305	6	25	75	0.3333333
NODE_2604_length_1419_cov_46.997727	1230	1305	8	40	75	0.5333334
NODE_2604_length_1419_cov_46.997727	1278	1332	7	6	54	0.1111111
NODE_2604_length_1419_cov_46.997727	1278	1332	8	48	54	0.8888889
NODE_2609_length_1418_cov_11.373010	432	512	0	11	80	0.1375000
NODE_2609_length_1418_cov_11.373010	432	512	2	20	80	0.2500000
NODE_2609_length_1418_cov_11.373010	432	512	4	3	80	0.0375000
NODE_2609_length_1418_cov_11.373010	432	512	6	11	80	0.1375000
NODE_2609_length_1418_cov_11.373010	432	512	8	35	80	0.4375000
NODE_2609_length_1418_cov_11.373010	485	556	2	11	71	0.1549296
NODE_2609_length_1418_cov_11.373010	485	556	4	6	71	0.0845070
NODE_2609_length_1418_cov_11.373010	485	556	6	8	71	0.1126761
NODE_2609_length_1418_cov_11.373010	485	556	8	46	71	0.6478873
NODE_2615_length_1417_cov_12.477997	354	399	0	45	45	1.0000000
NODE_2616_length_1417_cov_11.120637	794	874	0	80	80	1.0000000
NODE_2616_length_1417_cov_11.120637	847	927	0	56	80	0.7000000
NODE_2616_length_1417_cov_11.120637	847	927	2	24	80	0.3000000
NODE_2625_length_1415_cov_51.375380	423	503	0	19	80	0.2375000
NODE_2625_length_1415_cov_51.375380	423	503	2	11	80	0.1375000
NODE_2625_length_1415_cov_51.375380	423	503	4	16	80	0.2000000
NODE_2625_length_1415_cov_51.375380	423	503	6	34	80	0.4250000
NODE_2625_length_1415_cov_51.375380	476	556	4	69	80	0.8625000
NODE_2625_length_1415_cov_51.375380	476	556	6	11	80	0.1375000
NODE_2625_length_1415_cov_51.375380	552	632	0	32	80	0.4000000
NODE_2625_length_1415_cov_51.375380	552	632	4	48	80	0.6000000
NODE_2625_length_1415_cov_51.375380	605	683	0	46	78	0.5897436
NODE_2625_length_1415_cov_51.375380	605	683	1	5	78	0.0641026
NODE_2625_length_1415_cov_51.375380	605	683	2	1	78	0.0128205
NODE_2625_length_1415_cov_51.375380	605	683	4	26	78	0.3333333
NODE_2626_length_1415_cov_38.272036	513	593	2	7	80	0.0875000
NODE_2626_length_1415_cov_38.272036	513	593	4	17	80	0.2125000
NODE_2626_length_1415_cov_38.272036	513	593	5	18	80	0.2250000
NODE_2626_length_1415_cov_38.272036	513	593	7	18	80	0.2250000
NODE_2626_length_1415_cov_38.272036	513	593	8	5	80	0.0625000
NODE_2626_length_1415_cov_38.272036	513	593	9	15	80	0.1875000
NODE_2626_length_1415_cov_38.272036	566	646	1	32	80	0.4000000
NODE_2626_length_1415_cov_38.272036	566	646	5	39	80	0.4875000
NODE_2626_length_1415_cov_38.272036	566	646	7	9	80	0.1125000
NODE_2627_length_1415_cov_17.232523	642	722	2	36	80	0.4500000
NODE_2627_length_1415_cov_17.232523	642	722	4	35	80	0.4375000
NODE_2627_length_1415_cov_17.232523	642	722	6	9	80	0.1125000
NODE_2627_length_1415_cov_17.232523	695	775	0	17	80	0.2125000
NODE_2627_length_1415_cov_17.232523	695	775	4	63	80	0.7875000
NODE_2629_length_1414_cov_5.307985	1026	1106	0	14	80	0.1750000
NODE_2629_length_1414_cov_5.307985	1026	1106	2	66	80	0.8250000
NODE_2629_length_1414_cov_5.307985	1079	1159	2	80	80	1.0000000
NODE_2637_length_1412_cov_17.723534	875	955	0	80	80	1.0000000
NODE_2637_length_1412_cov_17.723534	928	1008	0	61	80	0.7625000
NODE_2637_length_1412_cov_17.723534	928	1008	2	19	80	0.2375000
NODE_2641_length_1411_cov_34.004573	516	596	0	35	80	0.4375000
NODE_2641_length_1411_cov_34.004573	516	596	6	45	80	0.5625000
NODE_2641_length_1411_cov_34.004573	569	649	6	80	80	1.0000000
NODE_2641_length_1411_cov_34.004573	645	725	2	38	80	0.4750000
NODE_2641_length_1411_cov_34.004573	645	725	4	17	80	0.2125000
NODE_2641_length_1411_cov_34.004573	645	725	6	13	80	0.1625000
NODE_2641_length_1411_cov_34.004573	645	725	8	12	80	0.1500000
NODE_2641_length_1411_cov_34.004573	698	778	2	63	80	0.7875000
NODE_2641_length_1411_cov_34.004573	698	778	4	17	80	0.2125000
NODE_2643_length_1409_cov_25.380153	828	908	2	43	80	0.5375000
NODE_2643_length_1409_cov_25.380153	828	908	4	7	80	0.0875000
NODE_2643_length_1409_cov_25.380153	828	908	6	30	80	0.3750000
NODE_2643_length_1409_cov_25.380153	881	961	2	18	80	0.2250000
NODE_2643_length_1409_cov_25.380153	881	961	4	7	80	0.0875000
NODE_2643_length_1409_cov_25.380153	881	961	6	55	80	0.6875000
NODE_2644_length_1409_cov_13.028244	349	405	0	19	56	0.3392857
NODE_2644_length_1409_cov_13.028244	349	405	2	18	56	0.3214286
NODE_2644_length_1409_cov_13.028244	349	405	4	19	56	0.3392857
NODE_2644_length_1409_cov_13.028244	416	482	0	66	66	1.0000000
NODE_2648_length_1408_cov_6.261268	492	572	0	26	80	0.3250000
NODE_2648_length_1408_cov_6.261268	492	572	4	33	80	0.4125000
NODE_2648_length_1408_cov_6.261268	492	572	6	21	80	0.2625000
NODE_2648_length_1408_cov_6.261268	545	625	0	24	80	0.3000000
NODE_2648_length_1408_cov_6.261268	545	625	4	56	80	0.7000000
NODE_2652_length_1407_cov_27.711009	772	852	6	7	80	0.0875000
NODE_2652_length_1407_cov_27.711009	772	852	8	7	80	0.0875000
NODE_2652_length_1407_cov_27.711009	772	852	10	12	80	0.1500000
NODE_2652_length_1407_cov_27.711009	772	852	12	54	80	0.6750000
NODE_2652_length_1407_cov_27.711009	825	905	0	33	80	0.4125000
NODE_2652_length_1407_cov_27.711009	825	905	2	1	80	0.0125000
NODE_2652_length_1407_cov_27.711009	825	905	4	17	80	0.2125000
NODE_2652_length_1407_cov_27.711009	825	905	6	9	80	0.1125000
NODE_2652_length_1407_cov_27.711009	825	905	8	7	80	0.0875000
NODE_2652_length_1407_cov_27.711009	825	905	12	13	80	0.1625000
NODE_2653_length_1407_cov_24.387615	586	666	4	15	80	0.1875000
NODE_2653_length_1407_cov_24.387615	586	666	6	10	80	0.1250000
NODE_2653_length_1407_cov_24.387615	586	666	8	1	80	0.0125000
NODE_2653_length_1407_cov_24.387615	586	666	12	3	80	0.0375000
NODE_2653_length_1407_cov_24.387615	586	666	14	9	80	0.1125000
NODE_2653_length_1407_cov_24.387615	586	666	15	6	80	0.0750000
NODE_2653_length_1407_cov_24.387615	586	666	16	36	80	0.4500000
NODE_2653_length_1407_cov_24.387615	639	719	2	5	80	0.0625000
NODE_2653_length_1407_cov_24.387615	639	719	4	2	80	0.0250000
NODE_2653_length_1407_cov_24.387615	639	719	8	2	80	0.0250000
NODE_2653_length_1407_cov_24.387615	639	719	10	2	80	0.0250000
NODE_2653_length_1407_cov_24.387615	639	719	12	45	80	0.5625000
NODE_2653_length_1407_cov_24.387615	639	719	16	24	80	0.3000000
NODE_2653_length_1407_cov_24.387615	715	795	2	2	80	0.0250000
NODE_2653_length_1407_cov_24.387615	715	795	4	30	80	0.3750000
NODE_2653_length_1407_cov_24.387615	715	795	5	6	80	0.0750000
NODE_2653_length_1407_cov_24.387615	715	795	6	42	80	0.5250000
NODE_2653_length_1407_cov_24.387615	768	848	0	35	80	0.4375000
NODE_2653_length_1407_cov_24.387615	768	848	2	11	80	0.1375000
NODE_2653_length_1407_cov_24.387615	768	848	4	25	80	0.3125000
NODE_2653_length_1407_cov_24.387615	768	848	5	6	80	0.0750000
NODE_2653_length_1407_cov_24.387615	768	848	6	3	80	0.0375000
NODE_2654_length_1407_cov_19.022936	551	629	10	1	78	0.0128205
NODE_2654_length_1407_cov_19.022936	551	629	12	38	78	0.4871795
NODE_2654_length_1407_cov_19.022936	551	629	14	1	78	0.0128205
NODE_2654_length_1407_cov_19.022936	551	629	16	2	78	0.0256410
NODE_2654_length_1407_cov_19.022936	551	629	19	15	78	0.1923077
NODE_2654_length_1407_cov_19.022936	551	629	20	21	78	0.2692308
NODE_2654_length_1407_cov_19.022936	602	665	8	21	63	0.3333333
NODE_2654_length_1407_cov_19.022936	602	665	12	42	63	0.6666667
NODE_2655_length_1407_cov_11.266820	813	893	0	80	80	1.0000000
NODE_2655_length_1407_cov_11.266820	866	946	0	30	80	0.3750000
NODE_2655_length_1407_cov_11.266820	866	946	2	41	80	0.5125000
NODE_2655_length_1407_cov_11.266820	866	946	4	9	80	0.1125000
NODE_2655_length_1407_cov_11.266820	942	1022	0	7	80	0.0875000
NODE_2655_length_1407_cov_11.266820	942	1022	2	29	80	0.3625000
NODE_2655_length_1407_cov_11.266820	942	1022	4	44	80	0.5500000
NODE_2655_length_1407_cov_11.266820	995	1075	0	60	80	0.7500000
NODE_2655_length_1407_cov_11.266820	995	1075	2	20	80	0.2500000
NODE_2657_length_1406_cov_7.247896	761	841	0	52	80	0.6500000
NODE_2657_length_1406_cov_7.247896	761	841	2	28	80	0.3500000
NODE_2657_length_1406_cov_7.247896	814	894	0	29	80	0.3625000
NODE_2657_length_1406_cov_7.247896	814	894	2	51	80	0.6375000
NODE_2659_length_1404_cov_23.406130	826	906	8	11	80	0.1375000
NODE_2659_length_1404_cov_23.406130	826	906	16	69	80	0.8625000
NODE_2659_length_1404_cov_23.406130	879	959	0	32	80	0.4000000
NODE_2659_length_1404_cov_23.406130	879	959	16	48	80	0.6000000
NODE_2659_length_1404_cov_23.406130	955	1035	0	13	80	0.1625000
NODE_2659_length_1404_cov_23.406130	955	1035	2	67	80	0.8375000
NODE_2659_length_1404_cov_23.406130	1008	1088	0	44	80	0.5500000
NODE_2659_length_1404_cov_23.406130	1008	1088	2	36	80	0.4500000
NODE_2666_length_1403_cov_14.331288	325	405	0	80	80	1.0000000
NODE_2666_length_1403_cov_14.331288	378	458	0	80	80	1.0000000
NODE_2666_length_1403_cov_14.331288	454	534	0	80	80	1.0000000
NODE_2666_length_1403_cov_14.331288	454	534	0	80	80	1.0000000
NODE_2666_length_1403_cov_14.331288	454	524	0	70	70	1.0000000
NODE_2666_length_1403_cov_14.331288	507	587	0	80	80	1.0000000
NODE_2666_length_1403_cov_14.331288	507	579	0	72	72	1.0000000
NODE_2668_length_1402_cov_29.095165	610	690	0	80	80	1.0000000
NODE_2668_length_1402_cov_29.095165	663	743	0	80	80	1.0000000
NODE_2669_length_1402_cov_23.411358	528	608	0	4	80	0.0500000
NODE_2669_length_1402_cov_23.411358	528	608	2	76	80	0.9500000
NODE_2669_length_1402_cov_23.411358	581	661	2	33	80	0.4125000
NODE_2669_length_1402_cov_23.411358	581	661	5	18	80	0.2250000
NODE_2669_length_1402_cov_23.411358	581	661	6	10	80	0.1250000
NODE_2669_length_1402_cov_23.411358	581	661	7	19	80	0.2375000
NODE_2669_length_1402_cov_23.411358	657	737	5	67	80	0.8375000
NODE_2669_length_1402_cov_23.411358	657	737	6	13	80	0.1625000
NODE_2669_length_1402_cov_23.411358	710	790	0	51	80	0.6375000
NODE_2669_length_1402_cov_23.411358	710	790	5	29	80	0.3625000
NODE_2670_length_1402_cov_11.732924	661	741	0	80	80	1.0000000
NODE_2670_length_1402_cov_11.732924	714	794	0	80	80	1.0000000
NODE_2671_length_1402_cov_9.929394	766	846	0	45	80	0.5625000
NODE_2671_length_1402_cov_9.929394	766	846	2	35	80	0.4375000
NODE_2671_length_1402_cov_9.929394	819	899	0	28	80	0.3500000
NODE_2671_length_1402_cov_9.929394	819	899	2	52	80	0.6500000
NODE_2677_length_1401_cov_35.754992	825	905	2	18	80	0.2250000
NODE_2677_length_1401_cov_35.754992	825	905	4	54	80	0.6750000
NODE_2677_length_1401_cov_35.754992	825	905	8	8	80	0.1000000
NODE_2677_length_1401_cov_35.754992	878	958	2	15	80	0.1875000
NODE_2677_length_1401_cov_35.754992	878	958	4	4	80	0.0500000
NODE_2677_length_1401_cov_35.754992	878	958	6	51	80	0.6375000
NODE_2677_length_1401_cov_35.754992	878	958	8	10	80	0.1250000
NODE_2678_length_1401_cov_10.811828	539	619	0	47	80	0.5875000
NODE_2678_length_1401_cov_10.811828	539	619	2	33	80	0.4125000
NODE_2678_length_1401_cov_10.811828	592	672	2	52	80	0.6500000
NODE_2678_length_1401_cov_10.811828	592	672	4	28	80	0.3500000
NODE_2679_length_1401_cov_5.438556	241	321	0	13	80	0.1625000
NODE_2679_length_1401_cov_5.438556	241	321	2	67	80	0.8375000
NODE_2679_length_1401_cov_5.438556	294	374	0	66	80	0.8250000
NODE_2679_length_1401_cov_5.438556	294	374	2	14	80	0.1750000
NODE_2683_length_1400_cov_16.680246	813	893	2	68	80	0.8500000
NODE_2683_length_1400_cov_16.680246	813	893	4	12	80	0.1500000
NODE_2683_length_1400_cov_16.680246	866	946	0	6	80	0.0750000
NODE_2683_length_1400_cov_16.680246	866	946	2	64	80	0.8000000
NODE_2683_length_1400_cov_16.680246	866	946	4	10	80	0.1250000
NODE_2684_length_1400_cov_8.166795	53	133	0	2	80	0.0250000
NODE_2684_length_1400_cov_8.166795	53	133	2	78	80	0.9750000
NODE_2684_length_1400_cov_8.166795	106	186	0	32	80	0.4000000
NODE_2684_length_1400_cov_8.166795	106	186	2	48	80	0.6000000
NODE_2694_length_1397_cov_25.549307	869	918	13	21	49	0.4285714
NODE_2694_length_1397_cov_25.549307	869	918	15	5	49	0.1020408
NODE_2694_length_1397_cov_25.549307	869	918	17	4	49	0.0816327
NODE_2694_length_1397_cov_25.549307	869	918	18	7	49	0.1428571
NODE_2694_length_1397_cov_25.549307	869	918	19	12	49	0.2448980
NODE_2694_length_1397_cov_25.549307	891	971	8	11	80	0.1375000
NODE_2694_length_1397_cov_25.549307	891	971	10	1	80	0.0125000
NODE_2694_length_1397_cov_25.549307	891	971	12	6	80	0.0750000
NODE_2694_length_1397_cov_25.549307	891	971	15	4	80	0.0500000
NODE_2694_length_1397_cov_25.549307	891	971	17	4	80	0.0500000
NODE_2694_length_1397_cov_25.549307	891	971	18	10	80	0.1250000
NODE_2694_length_1397_cov_25.549307	891	971	19	33	80	0.4125000
NODE_2694_length_1397_cov_25.549307	891	971	20	11	80	0.1375000
NODE_2695_length_1397_cov_14.395223	672	752	0	1	80	0.0125000
NODE_2695_length_1397_cov_14.395223	672	752	2	8	80	0.1000000
NODE_2695_length_1397_cov_14.395223	672	752	8	3	80	0.0375000
NODE_2695_length_1397_cov_14.395223	672	752	10	15	80	0.1875000
NODE_2695_length_1397_cov_14.395223	672	752	12	53	80	0.6625000
NODE_2695_length_1397_cov_14.395223	725	805	4	4	80	0.0500000
NODE_2695_length_1397_cov_14.395223	725	805	6	24	80	0.3000000
NODE_2695_length_1397_cov_14.395223	725	805	12	52	80	0.6500000
NODE_2695_length_1397_cov_14.395223	801	881	0	32	80	0.4000000
NODE_2695_length_1397_cov_14.395223	801	881	2	26	80	0.3250000
NODE_2695_length_1397_cov_14.395223	801	881	4	22	80	0.2750000
NODE_2695_length_1397_cov_14.395223	854	934	0	80	80	1.0000000
NODE_2699_length_1396_cov_21.656130	825	905	0	80	80	1.0000000
NODE_2699_length_1396_cov_21.656130	878	958	0	80	80	1.0000000
NODE_2700_length_1396_cov_18.108712	560	640	0	2	80	0.0250000
NODE_2700_length_1396_cov_18.108712	560	640	2	54	80	0.6750000
NODE_2700_length_1396_cov_18.108712	560	640	4	5	80	0.0625000
NODE_2700_length_1396_cov_18.108712	560	640	6	19	80	0.2375000
NODE_2700_length_1396_cov_18.108712	613	693	0	1	80	0.0125000
NODE_2700_length_1396_cov_18.108712	613	693	2	3	80	0.0375000
NODE_2700_length_1396_cov_18.108712	613	693	4	57	80	0.7125000
NODE_2700_length_1396_cov_18.108712	613	693	6	19	80	0.2375000
NODE_2701_length_1396_cov_16.208944	136	198	2	11	62	0.1774193
NODE_2701_length_1396_cov_16.208944	136	198	6	10	62	0.1612903
NODE_2701_length_1396_cov_16.208944	136	198	8	3	62	0.0483871
NODE_2701_length_1396_cov_16.208944	136	198	10	6	62	0.0967742
NODE_2701_length_1396_cov_16.208944	136	198	13	1	62	0.0161290
NODE_2701_length_1396_cov_16.208944	136	198	16	5	62	0.0806452
NODE_2701_length_1396_cov_16.208944	136	198	18	11	62	0.1774193
NODE_2701_length_1396_cov_16.208944	136	198	20	8	62	0.1290323
NODE_2701_length_1396_cov_16.208944	136	198	24	7	62	0.1129032
NODE_2701_length_1396_cov_16.208944	848	928	0	10	80	0.1250000
NODE_2701_length_1396_cov_16.208944	848	928	2	14	80	0.1750000
NODE_2701_length_1396_cov_16.208944	848	928	4	56	80	0.7000000
NODE_2701_length_1396_cov_16.208944	901	981	2	54	80	0.6750000
NODE_2701_length_1396_cov_16.208944	901	981	4	26	80	0.3250000
NODE_2701_length_1396_cov_16.208944	977	1057	0	10	80	0.1250000
NODE_2701_length_1396_cov_16.208944	977	1057	2	70	80	0.8750000
NODE_2701_length_1396_cov_16.208944	1030	1110	0	16	80	0.2000000
NODE_2701_length_1396_cov_16.208944	1030	1110	2	64	80	0.8000000
NODE_2702_length_1396_cov_9.196608	428	508	4	53	80	0.6625000
NODE_2702_length_1396_cov_9.196608	428	508	6	3	80	0.0375000
NODE_2702_length_1396_cov_9.196608	428	508	8	24	80	0.3000000
NODE_2702_length_1396_cov_9.196608	481	561	2	6	80	0.0750000
NODE_2702_length_1396_cov_9.196608	481	561	4	53	80	0.6625000
NODE_2702_length_1396_cov_9.196608	481	561	8	21	80	0.2625000
NODE_2712_length_1394_cov_29.602317	349	415	0	66	66	1.0000000
NODE_2712_length_1394_cov_29.602317	349	416	0	67	67	1.0000000
NODE_2712_length_1394_cov_29.602317	1117	1197	0	40	80	0.5000000
NODE_2712_length_1394_cov_29.602317	1117	1197	2	40	80	0.5000000
NODE_2712_length_1394_cov_29.602317	1170	1250	2	39	80	0.4875000
NODE_2712_length_1394_cov_29.602317	1170	1250	4	41	80	0.5125000
NODE_2713_length_1394_cov_6.291892	313	393	0	25	80	0.3125000
NODE_2713_length_1394_cov_6.291892	313	393	4	14	80	0.1750000
NODE_2713_length_1394_cov_6.291892	313	393	6	2	80	0.0250000
NODE_2713_length_1394_cov_6.291892	313	393	10	3	80	0.0375000
NODE_2713_length_1394_cov_6.291892	313	393	12	36	80	0.4500000
NODE_2713_length_1394_cov_6.291892	366	446	4	5	80	0.0625000
NODE_2713_length_1394_cov_6.291892	366	446	6	6	80	0.0750000
NODE_2713_length_1394_cov_6.291892	366	446	12	69	80	0.8625000
NODE_2716_length_1393_cov_14.635240	1286	1339	0	2	53	0.0377358
NODE_2716_length_1393_cov_14.635240	1286	1339	2	51	53	0.9622642
NODE_2717_length_1393_cov_12.032457	737	817	0	80	80	1.0000000
NODE_2717_length_1393_cov_12.032457	790	870	0	31	80	0.3875000
NODE_2717_length_1393_cov_12.032457	790	870	2	49	80	0.6125000
NODE_2720_length_1392_cov_5.898685	270	350	2	80	80	1.0000000
NODE_2720_length_1392_cov_5.898685	323	399	0	38	76	0.5000000
NODE_2720_length_1392_cov_5.898685	323	399	2	38	76	0.5000000
NODE_2723_length_1391_cov_35.921827	415	495	2	56	80	0.7000000
NODE_2723_length_1391_cov_35.921827	415	495	4	20	80	0.2500000
NODE_2723_length_1391_cov_35.921827	415	495	6	4	80	0.0500000
NODE_2723_length_1391_cov_35.921827	468	548	2	80	80	1.0000000
NODE_2723_length_1391_cov_35.921827	544	624	0	28	80	0.3500000
NODE_2723_length_1391_cov_35.921827	544	624	2	52	80	0.6500000
NODE_2723_length_1391_cov_35.921827	597	677	0	6	80	0.0750000
NODE_2723_length_1391_cov_35.921827	597	677	2	74	80	0.9250000
NODE_2729_length_1390_cov_16.326878	550	630	0	43	80	0.5375000
NODE_2729_length_1390_cov_16.326878	550	630	2	37	80	0.4625000
NODE_2729_length_1390_cov_16.326878	603	683	2	80	80	1.0000000
NODE_2731_length_1389_cov_29.772093	780	860	0	80	80	1.0000000
NODE_2731_length_1389_cov_29.772093	833	913	0	80	80	1.0000000
NODE_2732_length_1389_cov_12.858140	821	901	0	23	80	0.2875000
NODE_2732_length_1389_cov_12.858140	821	901	2	57	80	0.7125000
NODE_2732_length_1389_cov_12.858140	874	954	0	76	80	0.9500000
NODE_2732_length_1389_cov_12.858140	874	954	2	4	80	0.0500000
NODE_2735_length_1388_cov_14.641583	529	610	0	81	81	1.0000000
NODE_2735_length_1388_cov_14.641583	583	660	0	29	77	0.3766234
NODE_2735_length_1388_cov_14.641583	583	660	2	48	77	0.6233766
NODE_2736_length_1388_cov_5.168348	427	499	38	6	72	0.0833333
NODE_2736_length_1388_cov_5.168348	427	499	39	1	72	0.0138889
NODE_2736_length_1388_cov_5.168348	427	499	40	2	72	0.0277778
NODE_2736_length_1388_cov_5.168348	427	499	42	7	72	0.0972222
NODE_2736_length_1388_cov_5.168348	427	499	43	6	72	0.0833333
NODE_2736_length_1388_cov_5.168348	427	499	44	1	72	0.0138889
NODE_2736_length_1388_cov_5.168348	427	499	45	11	72	0.1527778
NODE_2736_length_1388_cov_5.168348	427	499	46	1	72	0.0138889
NODE_2736_length_1388_cov_5.168348	427	499	47	7	72	0.0972222
NODE_2736_length_1388_cov_5.168348	427	499	48	10	72	0.1388889
NODE_2736_length_1388_cov_5.168348	427	499	49	4	72	0.0555556
NODE_2736_length_1388_cov_5.168348	427	499	50	4	72	0.0555556
NODE_2736_length_1388_cov_5.168348	427	499	52	4	72	0.0555556
NODE_2736_length_1388_cov_5.168348	427	499	54	8	72	0.1111111
NODE_2742_length_1386_cov_55.384615	559	639	0	11	80	0.1375000
NODE_2742_length_1386_cov_55.384615	559	639	4	69	80	0.8625000
NODE_2742_length_1386_cov_55.384615	612	692	0	64	80	0.8000000
NODE_2742_length_1386_cov_55.384615	612	692	4	16	80	0.2000000
NODE_2742_length_1386_cov_55.384615	688	768	0	51	80	0.6375000
NODE_2742_length_1386_cov_55.384615	688	768	2	14	80	0.1750000
NODE_2742_length_1386_cov_55.384615	688	768	4	9	80	0.1125000
NODE_2742_length_1386_cov_55.384615	688	768	8	6	80	0.0750000
NODE_2742_length_1386_cov_55.384615	741	821	2	12	80	0.1500000
NODE_2742_length_1386_cov_55.384615	741	821	4	9	80	0.1125000
NODE_2742_length_1386_cov_55.384615	741	821	8	59	80	0.7375000
NODE_2744_length_1386_cov_13.181041	549	629	4	80	80	1.0000000
NODE_2744_length_1386_cov_13.181041	602	682	0	53	80	0.6625000
NODE_2744_length_1386_cov_13.181041	602	682	4	27	80	0.3375000
NODE_2748_length_1385_cov_41.636081	968	1048	0	4	80	0.0500000
NODE_2748_length_1385_cov_41.636081	968	1048	1	25	80	0.3125000
NODE_2748_length_1385_cov_41.636081	968	1048	2	3	80	0.0375000
NODE_2748_length_1385_cov_41.636081	968	1048	3	48	80	0.6000000
NODE_2748_length_1385_cov_41.636081	1021	1101	1	78	80	0.9750000
NODE_2748_length_1385_cov_41.636081	1021	1101	3	2	80	0.0250000
NODE_2749_length_1385_cov_38.877138	707	787	8	4	80	0.0500000
NODE_2749_length_1385_cov_38.877138	707	787	11	8	80	0.1000000
NODE_2749_length_1385_cov_38.877138	707	787	12	6	80	0.0750000
NODE_2749_length_1385_cov_38.877138	707	787	17	1	80	0.0125000
NODE_2749_length_1385_cov_38.877138	707	787	19	5	80	0.0625000
NODE_2749_length_1385_cov_38.877138	707	787	20	1	80	0.0125000
NODE_2749_length_1385_cov_38.877138	707	787	21	24	80	0.3000000
NODE_2749_length_1385_cov_38.877138	707	787	22	27	80	0.3375000
NODE_2749_length_1385_cov_38.877138	707	787	23	4	80	0.0500000
NODE_2749_length_1385_cov_38.877138	760	840	2	4	80	0.0500000
NODE_2749_length_1385_cov_38.877138	760	840	4	11	80	0.1375000
NODE_2749_length_1385_cov_38.877138	760	840	6	3	80	0.0375000
NODE_2749_length_1385_cov_38.877138	760	840	8	4	80	0.0500000
NODE_2749_length_1385_cov_38.877138	760	840	11	1	80	0.0125000
NODE_2749_length_1385_cov_38.877138	760	840	12	1	80	0.0125000
NODE_2749_length_1385_cov_38.877138	760	840	16	2	80	0.0250000
NODE_2749_length_1385_cov_38.877138	760	840	20	28	80	0.3500000
NODE_2749_length_1385_cov_38.877138	760	840	22	26	80	0.3250000
NODE_2749_length_1385_cov_38.877138	836	916	8	14	80	0.1750000
NODE_2749_length_1385_cov_38.877138	836	916	12	66	80	0.8250000
NODE_2749_length_1385_cov_38.877138	889	969	8	12	80	0.1500000
NODE_2749_length_1385_cov_38.877138	889	969	12	68	80	0.8500000
NODE_2751_length_1385_cov_4.608865	844	904	0	26	60	0.4333333
NODE_2751_length_1385_cov_4.608865	844	904	2	11	60	0.1833333
NODE_2751_length_1385_cov_4.608865	844	904	3	1	60	0.0166667
NODE_2751_length_1385_cov_4.608865	844	904	5	7	60	0.1166667
NODE_2751_length_1385_cov_4.608865	844	904	6	15	60	0.2500000
NODE_2758_length_1384_cov_10.574319	865	922	2	57	57	1.0000000
NODE_2758_length_1384_cov_10.574319	933	1013	2	80	80	1.0000000
NODE_2758_length_1384_cov_10.574319	986	1066	0	36	80	0.4500000
NODE_2758_length_1384_cov_10.574319	986	1066	2	44	80	0.5500000
NODE_2759_length_1383_cov_10.710280	414	493	2	42	79	0.5316456
NODE_2759_length_1383_cov_10.710280	414	493	4	37	79	0.4683544
NODE_2759_length_1383_cov_10.710280	466	546	0	45	80	0.5625000
NODE_2759_length_1383_cov_10.710280	466	546	2	35	80	0.4375000
NODE_2763_length_1382_cov_12.521434	837	917	0	39	80	0.4875000
NODE_2763_length_1382_cov_12.521434	837	917	2	41	80	0.5125000
NODE_2763_length_1382_cov_12.521434	890	970	0	4	80	0.0500000
NODE_2763_length_1382_cov_12.521434	890	970	2	76	80	0.9500000
NODE_2764_length_1382_cov_5.074045	1028	1108	2	80	80	1.0000000
NODE_2764_length_1382_cov_5.074045	1081	1161	0	11	80	0.1375000
NODE_2764_length_1382_cov_5.074045	1081	1161	2	69	80	0.8625000
NODE_2771_length_1381_cov_7.796412	307	387	0	80	80	1.0000000
NODE_2771_length_1381_cov_7.796412	360	440	0	39	80	0.4875000
NODE_2771_length_1381_cov_7.796412	360	440	2	41	80	0.5125000
NODE_2775_length_1380_cov_12.804059	835	915	0	80	80	1.0000000
NODE_2775_length_1380_cov_12.804059	888	968	0	80	80	1.0000000
NODE_2782_length_1378_cov_25.362002	368	448	0	80	80	1.0000000
NODE_2782_length_1378_cov_25.362002	421	501	0	80	80	1.0000000
NODE_2782_length_1378_cov_25.362002	497	577	0	22	80	0.2750000
NODE_2782_length_1378_cov_25.362002	497	577	2	43	80	0.5375000
NODE_2782_length_1378_cov_25.362002	497	577	6	15	80	0.1875000
NODE_2782_length_1378_cov_25.362002	550	630	2	12	80	0.1500000
NODE_2782_length_1378_cov_25.362002	550	630	4	42	80	0.5250000
NODE_2782_length_1378_cov_25.362002	550	630	6	26	80	0.3250000
NODE_2783_length_1378_cov_20.508210	318	338	2	2	20	0.1000000
NODE_2783_length_1378_cov_20.508210	318	338	4	1	20	0.0500000
NODE_2783_length_1378_cov_20.508210	318	338	6	14	20	0.7000000
NODE_2783_length_1378_cov_20.508210	318	338	8	3	20	0.1500000
NODE_2783_length_1378_cov_20.508210	318	391	2	2	73	0.0273973
NODE_2783_length_1378_cov_20.508210	318	391	4	1	73	0.0136986
NODE_2783_length_1378_cov_20.508210	318	391	6	14	73	0.1917808
NODE_2783_length_1378_cov_20.508210	318	391	8	6	73	0.0821918
NODE_2783_length_1378_cov_20.508210	318	391	10	1	73	0.0136986
NODE_2783_length_1378_cov_20.508210	318	391	12	2	73	0.0273973
NODE_2783_length_1378_cov_20.508210	318	391	13	1	73	0.0136986
NODE_2783_length_1378_cov_20.508210	318	391	14	1	73	0.0136986
NODE_2783_length_1378_cov_20.508210	318	391	16	27	73	0.3698630
NODE_2783_length_1378_cov_20.508210	318	391	18	9	73	0.1232877
NODE_2783_length_1378_cov_20.508210	318	391	20	5	73	0.0684932
NODE_2783_length_1378_cov_20.508210	318	391	22	1	73	0.0136986
NODE_2783_length_1378_cov_20.508210	318	391	24	3	73	0.0410959
NODE_2785_length_1377_cov_103.832551	1259	1299	110	3	40	0.0750000
NODE_2785_length_1377_cov_103.832551	1259	1299	111	1	40	0.0250000
NODE_2785_length_1377_cov_103.832551	1259	1299	113	3	40	0.0750000
NODE_2785_length_1377_cov_103.832551	1259	1299	115	2	40	0.0500000
NODE_2785_length_1377_cov_103.832551	1259	1299	119	2	40	0.0500000
NODE_2785_length_1377_cov_103.832551	1259	1299	121	1	40	0.0250000
NODE_2785_length_1377_cov_103.832551	1259	1299	125	1	40	0.0250000
NODE_2785_length_1377_cov_103.832551	1259	1299	127	4	40	0.1000000
NODE_2785_length_1377_cov_103.832551	1259	1299	131	1	40	0.0250000
NODE_2785_length_1377_cov_103.832551	1259	1299	133	3	40	0.0750000
NODE_2785_length_1377_cov_103.832551	1259	1299	135	1	40	0.0250000
NODE_2785_length_1377_cov_103.832551	1259	1299	137	2	40	0.0500000
NODE_2785_length_1377_cov_103.832551	1259	1299	139	1	40	0.0250000
NODE_2785_length_1377_cov_103.832551	1259	1299	140	1	40	0.0250000
NODE_2785_length_1377_cov_103.832551	1259	1299	141	1	40	0.0250000
NODE_2785_length_1377_cov_103.832551	1259	1299	146	1	40	0.0250000
NODE_2785_length_1377_cov_103.832551	1259	1299	148	2	40	0.0500000
NODE_2785_length_1377_cov_103.832551	1259	1299	150	6	40	0.1500000
NODE_2785_length_1377_cov_103.832551	1259	1299	153	3	40	0.0750000
NODE_2785_length_1377_cov_103.832551	1259	1299	157	1	40	0.0250000
NODE_2788_length_1376_cov_7.967110	904	984	0	5	80	0.0625000
NODE_2788_length_1376_cov_7.967110	904	984	4	1	80	0.0125000
NODE_2788_length_1376_cov_7.967110	904	984	6	1	80	0.0125000
NODE_2788_length_1376_cov_7.967110	904	984	12	58	80	0.7250000
NODE_2788_length_1376_cov_7.967110	904	984	14	15	80	0.1875000
NODE_2788_length_1376_cov_7.967110	957	1037	2	8	80	0.1000000
NODE_2788_length_1376_cov_7.967110	957	1037	6	1	80	0.0125000
NODE_2788_length_1376_cov_7.967110	957	1037	12	56	80	0.7000000
NODE_2788_length_1376_cov_7.967110	957	1037	14	15	80	0.1875000
NODE_2798_length_1373_cov_52.691523	524	606	2	27	82	0.3292683
NODE_2798_length_1373_cov_52.691523	524	606	6	26	82	0.3170732
NODE_2798_length_1373_cov_52.691523	524	606	8	29	82	0.3536585
NODE_2798_length_1373_cov_52.691523	579	659	0	3	80	0.0375000
NODE_2798_length_1373_cov_52.691523	579	659	2	33	80	0.4125000
NODE_2798_length_1373_cov_52.691523	579	659	6	43	80	0.5375000
NODE_2798_length_1373_cov_52.691523	579	659	8	1	80	0.0125000
NODE_2799_length_1373_cov_20.880691	987	1067	2	2	80	0.0250000
NODE_2799_length_1373_cov_20.880691	987	1067	7	1	80	0.0125000
NODE_2799_length_1373_cov_20.880691	987	1067	8	8	80	0.1000000
NODE_2799_length_1373_cov_20.880691	987	1067	10	2	80	0.0250000
NODE_2799_length_1373_cov_20.880691	987	1067	12	1	80	0.0125000
NODE_2799_length_1373_cov_20.880691	987	1067	14	9	80	0.1125000
NODE_2799_length_1373_cov_20.880691	987	1067	16	1	80	0.0125000
NODE_2799_length_1373_cov_20.880691	987	1067	17	19	80	0.2375000
NODE_2799_length_1373_cov_20.880691	987	1067	18	15	80	0.1875000
NODE_2799_length_1373_cov_20.880691	987	1067	19	12	80	0.1500000
NODE_2799_length_1373_cov_20.880691	987	1067	21	10	80	0.1250000
NODE_2799_length_1373_cov_20.880691	1116	1195	12	22	79	0.2784810
NODE_2799_length_1373_cov_20.880691	1116	1195	14	3	79	0.0379747
NODE_2799_length_1373_cov_20.880691	1116	1195	18	11	79	0.1392405
NODE_2799_length_1373_cov_20.880691	1116	1195	20	6	79	0.0759494
NODE_2799_length_1373_cov_20.880691	1116	1195	22	2	79	0.0253165
NODE_2799_length_1373_cov_20.880691	1116	1195	24	15	79	0.1898734
NODE_2799_length_1373_cov_20.880691	1116	1195	25	19	79	0.2405063
NODE_2799_length_1373_cov_20.880691	1116	1195	26	1	79	0.0126582
NODE_2799_length_1373_cov_20.880691	1168	1248	6	5	80	0.0625000
NODE_2799_length_1373_cov_20.880691	1168	1248	8	10	80	0.1250000
NODE_2799_length_1373_cov_20.880691	1168	1248	12	5	80	0.0625000
NODE_2799_length_1373_cov_20.880691	1168	1248	16	18	80	0.2250000
NODE_2799_length_1373_cov_20.880691	1168	1248	19	1	80	0.0125000
NODE_2799_length_1373_cov_20.880691	1168	1248	21	14	80	0.1750000
NODE_2799_length_1373_cov_20.880691	1168	1248	24	15	80	0.1875000
NODE_2799_length_1373_cov_20.880691	1168	1248	25	12	80	0.1500000
NODE_2800_length_1373_cov_12.694662	94	167	16	4	73	0.0547945
NODE_2800_length_1373_cov_12.694662	94	167	18	6	73	0.0821918
NODE_2800_length_1373_cov_12.694662	94	167	20	11	73	0.1506849
NODE_2800_length_1373_cov_12.694662	94	167	22	12	73	0.1643836
NODE_2800_length_1373_cov_12.694662	94	167	24	5	73	0.0684932
NODE_2800_length_1373_cov_12.694662	94	167	28	2	73	0.0273973
NODE_2800_length_1373_cov_12.694662	94	167	30	2	73	0.0273973
NODE_2800_length_1373_cov_12.694662	94	167	32	6	73	0.0821918
NODE_2800_length_1373_cov_12.694662	94	167	34	8	73	0.1095890
NODE_2800_length_1373_cov_12.694662	94	167	36	2	73	0.0273973
NODE_2800_length_1373_cov_12.694662	94	167	42	1	73	0.0136986
NODE_2800_length_1373_cov_12.694662	94	167	44	3	73	0.0410959
NODE_2800_length_1373_cov_12.694662	94	167	45	3	73	0.0410959
NODE_2800_length_1373_cov_12.694662	94	167	46	4	73	0.0547945
NODE_2800_length_1373_cov_12.694662	94	167	47	3	73	0.0410959
NODE_2800_length_1373_cov_12.694662	94	167	49	1	73	0.0136986
NODE_2800_length_1373_cov_12.694662	140	224	32	2	84	0.0238095
NODE_2800_length_1373_cov_12.694662	140	224	34	8	84	0.0952381
NODE_2800_length_1373_cov_12.694662	140	224	36	2	84	0.0238095
NODE_2800_length_1373_cov_12.694662	140	224	42	1	84	0.0119048
NODE_2800_length_1373_cov_12.694662	140	224	44	3	84	0.0357143
NODE_2800_length_1373_cov_12.694662	140	224	45	6	84	0.0714286
NODE_2800_length_1373_cov_12.694662	140	224	46	4	84	0.0476190
NODE_2800_length_1373_cov_12.694662	140	224	47	3	84	0.0357143
NODE_2800_length_1373_cov_12.694662	140	224	49	2	84	0.0238095
NODE_2800_length_1373_cov_12.694662	140	224	51	8	84	0.0952381
NODE_2800_length_1373_cov_12.694662	140	224	55	1	84	0.0119048
NODE_2800_length_1373_cov_12.694662	140	224	61	6	84	0.0714286
NODE_2800_length_1373_cov_12.694662	140	224	63	1	84	0.0119048
NODE_2800_length_1373_cov_12.694662	140	224	65	2	84	0.0238095
NODE_2800_length_1373_cov_12.694662	140	224	67	6	84	0.0714286
NODE_2800_length_1373_cov_12.694662	140	224	69	2	84	0.0238095
NODE_2800_length_1373_cov_12.694662	140	224	71	16	84	0.1904762
NODE_2800_length_1373_cov_12.694662	140	224	73	6	84	0.0714286
NODE_2800_length_1373_cov_12.694662	140	224	75	5	84	0.0595238
NODE_2800_length_1373_cov_12.694662	1214	1286	0	5	72	0.0694444
NODE_2800_length_1373_cov_12.694662	1214	1286	2	67	72	0.9305556
NODE_2800_length_1373_cov_12.694662	1267	1339	0	4	72	0.0555556
NODE_2800_length_1373_cov_12.694662	1267	1339	2	68	72	0.9444444
NODE_2801_length_1372_cov_25.408484	665	745	2	80	80	1.0000000
NODE_2801_length_1372_cov_25.408484	718	798	0	52	80	0.6500000
NODE_2801_length_1372_cov_25.408484	718	798	2	28	80	0.3500000
NODE_2802_length_1372_cov_17.123331	647	727	2	16	80	0.2000000
NODE_2802_length_1372_cov_17.123331	647	727	4	51	80	0.6375000
NODE_2802_length_1372_cov_17.123331	647	727	6	13	80	0.1625000
NODE_2802_length_1372_cov_17.123331	700	780	4	80	80	1.0000000
NODE_2802_length_1372_cov_17.123331	776	856	4	24	80	0.3000000
NODE_2802_length_1372_cov_17.123331	776	856	5	47	80	0.5875000
NODE_2802_length_1372_cov_17.123331	776	856	8	2	80	0.0250000
NODE_2802_length_1372_cov_17.123331	776	856	9	7	80	0.0875000
NODE_2802_length_1372_cov_17.123331	829	909	5	33	80	0.4125000
NODE_2802_length_1372_cov_17.123331	829	909	6	2	80	0.0250000
NODE_2802_length_1372_cov_17.123331	829	909	8	45	80	0.5625000
NODE_2803_length_1372_cov_14.418696	211	291	1	47	80	0.5875000
NODE_2803_length_1372_cov_14.418696	211	291	2	4	80	0.0500000
NODE_2803_length_1372_cov_14.418696	211	291	5	29	80	0.3625000
NODE_2803_length_1372_cov_14.418696	264	344	5	67	80	0.8375000
NODE_2803_length_1372_cov_14.418696	264	344	6	13	80	0.1625000
NODE_2806_length_1371_cov_39.366352	715	795	12	4	80	0.0500000
NODE_2806_length_1371_cov_39.366352	715	795	14	4	80	0.0500000
NODE_2806_length_1371_cov_39.366352	715	795	16	7	80	0.0875000
NODE_2806_length_1371_cov_39.366352	715	795	18	42	80	0.5250000
NODE_2806_length_1371_cov_39.366352	715	795	20	6	80	0.0750000
NODE_2806_length_1371_cov_39.366352	715	795	23	5	80	0.0625000
NODE_2806_length_1371_cov_39.366352	715	795	24	7	80	0.0875000
NODE_2806_length_1371_cov_39.366352	715	795	29	5	80	0.0625000
NODE_2806_length_1371_cov_39.366352	768	848	16	2	80	0.0250000
NODE_2806_length_1371_cov_39.366352	768	848	18	7	80	0.0875000
NODE_2806_length_1371_cov_39.366352	768	848	20	20	80	0.2500000
NODE_2806_length_1371_cov_39.366352	768	848	22	4	80	0.0500000
NODE_2806_length_1371_cov_39.366352	768	848	23	31	80	0.3875000
NODE_2806_length_1371_cov_39.366352	768	848	24	7	80	0.0875000
NODE_2806_length_1371_cov_39.366352	768	848	27	3	80	0.0375000
NODE_2806_length_1371_cov_39.366352	768	848	29	6	80	0.0750000
NODE_2807_length_1371_cov_36.961478	371	455	0	84	84	1.0000000
NODE_2807_length_1371_cov_36.961478	424	508	0	84	84	1.0000000
NODE_2807_length_1371_cov_36.961478	504	584	0	62	80	0.7750000
NODE_2807_length_1371_cov_36.961478	504	584	2	18	80	0.2250000
NODE_2807_length_1371_cov_36.961478	557	637	0	9	80	0.1125000
NODE_2807_length_1371_cov_36.961478	557	637	2	71	80	0.8875000
NODE_2808_length_1371_cov_16.944182	459	539	0	80	80	1.0000000
NODE_2808_length_1371_cov_16.944182	512	592	0	80	80	1.0000000
NODE_2808_length_1371_cov_16.944182	588	668	0	80	80	1.0000000
NODE_2808_length_1371_cov_16.944182	641	721	0	80	80	1.0000000
NODE_2812_length_1370_cov_11.627065	502	582	0	80	80	1.0000000
NODE_2812_length_1370_cov_11.627065	555	635	0	80	80	1.0000000
NODE_2812_length_1370_cov_11.627065	631	711	0	80	80	1.0000000
NODE_2812_length_1370_cov_11.627065	684	764	0	80	80	1.0000000
NODE_2813_length_1369_cov_27.937795	597	677	6	46	80	0.5750000
NODE_2813_length_1369_cov_27.937795	597	677	8	34	80	0.4250000
NODE_2813_length_1369_cov_27.937795	650	730	0	51	80	0.6375000
NODE_2813_length_1369_cov_27.937795	650	730	6	29	80	0.3625000
NODE_2820_length_1368_cov_35.148148	546	626	4	5	80	0.0625000
NODE_2820_length_1368_cov_35.148148	546	626	8	21	80	0.2625000
NODE_2820_length_1368_cov_35.148148	546	626	10	44	80	0.5500000
NODE_2820_length_1368_cov_35.148148	546	626	11	10	80	0.1250000
NODE_2820_length_1368_cov_35.148148	599	679	2	15	80	0.1875000
NODE_2820_length_1368_cov_35.148148	599	679	4	43	80	0.5375000
NODE_2820_length_1368_cov_35.148148	599	679	10	22	80	0.2750000
NODE_2821_length_1368_cov_27.847912	486	559	4	51	73	0.6986302
NODE_2821_length_1368_cov_27.847912	486	559	6	22	73	0.3013699
NODE_2821_length_1368_cov_27.847912	532	612	0	51	80	0.6375000
NODE_2821_length_1368_cov_27.847912	532	612	4	29	80	0.3625000
NODE_2821_length_1368_cov_27.847912	608	688	0	80	80	1.0000000
NODE_2821_length_1368_cov_27.847912	661	741	0	80	80	1.0000000
NODE_2822_length_1368_cov_26.832151	458	538	0	80	80	1.0000000
NODE_2822_length_1368_cov_26.832151	511	591	0	80	80	1.0000000
NODE_2822_length_1368_cov_26.832151	587	667	0	4	80	0.0500000
NODE_2822_length_1368_cov_26.832151	587	667	1	1	80	0.0125000
NODE_2822_length_1368_cov_26.832151	587	667	2	13	80	0.1625000
NODE_2822_length_1368_cov_26.832151	587	667	4	62	80	0.7750000
NODE_2822_length_1368_cov_26.832151	640	720	4	80	80	1.0000000
NODE_2823_length_1368_cov_18.205674	603	683	0	80	80	1.0000000
NODE_2823_length_1368_cov_18.205674	656	736	0	80	80	1.0000000
NODE_2826_length_1367_cov_576.769716	799	879	153	1	80	0.0125000
NODE_2826_length_1367_cov_576.769716	799	879	155	1	80	0.0125000
NODE_2826_length_1367_cov_576.769716	799	879	158	2	80	0.0250000
NODE_2826_length_1367_cov_576.769716	799	879	159	1	80	0.0125000
NODE_2826_length_1367_cov_576.769716	799	879	160	1	80	0.0125000
NODE_2826_length_1367_cov_576.769716	799	879	161	1	80	0.0125000
NODE_2826_length_1367_cov_576.769716	799	879	164	1	80	0.0125000
NODE_2826_length_1367_cov_576.769716	799	879	167	1	80	0.0125000
NODE_2826_length_1367_cov_576.769716	799	879	169	1	80	0.0125000
NODE_2826_length_1367_cov_576.769716	799	879	170	2	80	0.0250000
NODE_2826_length_1367_cov_576.769716	799	879	171	1	80	0.0125000
NODE_2826_length_1367_cov_576.769716	799	879	173	1	80	0.0125000
NODE_2826_length_1367_cov_576.769716	799	879	176	1	80	0.0125000
NODE_2826_length_1367_cov_576.769716	799	879	179	1	80	0.0125000
NODE_2826_length_1367_cov_576.769716	799	879	187	1	80	0.0125000
NODE_2826_length_1367_cov_576.769716	799	879	188	3	80	0.0375000
NODE_2826_length_1367_cov_576.769716	799	879	191	1	80	0.0125000
NODE_2826_length_1367_cov_576.769716	799	879	198	1	80	0.0125000
NODE_2826_length_1367_cov_576.769716	799	879	200	1	80	0.0125000
NODE_2826_length_1367_cov_576.769716	799	879	202	1	80	0.0125000
NODE_2826_length_1367_cov_576.769716	799	879	204	1	80	0.0125000
NODE_2826_length_1367_cov_576.769716	799	879	209	1	80	0.0125000
NODE_2826_length_1367_cov_576.769716	799	879	210	1	80	0.0125000
NODE_2826_length_1367_cov_576.769716	799	879	214	3	80	0.0375000
NODE_2826_length_1367_cov_576.769716	799	879	215	1	80	0.0125000
NODE_2826_length_1367_cov_576.769716	799	879	223	1	80	0.0125000
NODE_2826_length_1367_cov_576.769716	799	879	226	1	80	0.0125000
NODE_2826_length_1367_cov_576.769716	799	879	227	1	80	0.0125000
NODE_2826_length_1367_cov_576.769716	799	879	228	1	80	0.0125000
NODE_2826_length_1367_cov_576.769716	799	879	229	1	80	0.0125000
NODE_2826_length_1367_cov_576.769716	799	879	232	2	80	0.0250000
NODE_2826_length_1367_cov_576.769716	799	879	234	1	80	0.0125000
NODE_2826_length_1367_cov_576.769716	799	879	235	1	80	0.0125000
NODE_2826_length_1367_cov_576.769716	799	879	239	1	80	0.0125000
NODE_2826_length_1367_cov_576.769716	799	879	246	1	80	0.0125000
NODE_2826_length_1367_cov_576.769716	799	879	248	1	80	0.0125000
NODE_2826_length_1367_cov_576.769716	799	879	251	1	80	0.0125000
NODE_2826_length_1367_cov_576.769716	799	879	253	1	80	0.0125000
NODE_2826_length_1367_cov_576.769716	799	879	258	1	80	0.0125000
NODE_2826_length_1367_cov_576.769716	799	879	259	1	80	0.0125000
NODE_2826_length_1367_cov_576.769716	799	879	263	2	80	0.0250000
NODE_2826_length_1367_cov_576.769716	799	879	265	1	80	0.0125000
NODE_2826_length_1367_cov_576.769716	799	879	271	1	80	0.0125000
NODE_2826_length_1367_cov_576.769716	799	879	273	2	80	0.0250000
NODE_2826_length_1367_cov_576.769716	799	879	274	2	80	0.0250000
NODE_2826_length_1367_cov_576.769716	799	879	276	1	80	0.0125000
NODE_2826_length_1367_cov_576.769716	799	879	278	1	80	0.0125000
NODE_2826_length_1367_cov_576.769716	799	879	280	1	80	0.0125000
NODE_2826_length_1367_cov_576.769716	799	879	286	1	80	0.0125000
NODE_2826_length_1367_cov_576.769716	799	879	288	1	80	0.0125000
NODE_2826_length_1367_cov_576.769716	799	879	290	1	80	0.0125000
NODE_2826_length_1367_cov_576.769716	799	879	293	1	80	0.0125000
NODE_2826_length_1367_cov_576.769716	799	879	297	1	80	0.0125000
NODE_2826_length_1367_cov_576.769716	799	879	305	1	80	0.0125000
NODE_2826_length_1367_cov_576.769716	799	879	310	1	80	0.0125000
NODE_2826_length_1367_cov_576.769716	799	879	327	1	80	0.0125000
NODE_2826_length_1367_cov_576.769716	799	879	332	1	80	0.0125000
NODE_2826_length_1367_cov_576.769716	799	879	334	1	80	0.0125000
NODE_2826_length_1367_cov_576.769716	799	879	366	1	80	0.0125000
NODE_2826_length_1367_cov_576.769716	799	879	368	1	80	0.0125000
NODE_2826_length_1367_cov_576.769716	799	879	392	1	80	0.0125000
NODE_2826_length_1367_cov_576.769716	799	879	406	1	80	0.0125000
NODE_2826_length_1367_cov_576.769716	799	879	411	1	80	0.0125000
NODE_2826_length_1367_cov_576.769716	799	879	414	1	80	0.0125000
NODE_2826_length_1367_cov_576.769716	799	879	434	1	80	0.0125000
NODE_2826_length_1367_cov_576.769716	799	879	448	1	80	0.0125000
NODE_2826_length_1367_cov_576.769716	799	879	450	4	80	0.0500000
NODE_2826_length_1367_cov_576.769716	852	932	228	1	80	0.0125000
NODE_2826_length_1367_cov_576.769716	852	932	232	1	80	0.0125000
NODE_2826_length_1367_cov_576.769716	852	932	271	1	80	0.0125000
NODE_2826_length_1367_cov_576.769716	852	932	274	1	80	0.0125000
NODE_2826_length_1367_cov_576.769716	852	932	276	1	80	0.0125000
NODE_2826_length_1367_cov_576.769716	852	932	280	1	80	0.0125000
NODE_2826_length_1367_cov_576.769716	852	932	286	1	80	0.0125000
NODE_2826_length_1367_cov_576.769716	852	932	290	1	80	0.0125000
NODE_2826_length_1367_cov_576.769716	852	932	293	1	80	0.0125000
NODE_2826_length_1367_cov_576.769716	852	932	297	1	80	0.0125000
NODE_2826_length_1367_cov_576.769716	852	932	305	1	80	0.0125000
NODE_2826_length_1367_cov_576.769716	852	932	310	1	80	0.0125000
NODE_2826_length_1367_cov_576.769716	852	932	327	1	80	0.0125000
NODE_2826_length_1367_cov_576.769716	852	932	332	1	80	0.0125000
NODE_2826_length_1367_cov_576.769716	852	932	334	1	80	0.0125000
NODE_2826_length_1367_cov_576.769716	852	932	366	1	80	0.0125000
NODE_2826_length_1367_cov_576.769716	852	932	368	1	80	0.0125000
NODE_2826_length_1367_cov_576.769716	852	932	392	1	80	0.0125000
NODE_2826_length_1367_cov_576.769716	852	932	406	1	80	0.0125000
NODE_2826_length_1367_cov_576.769716	852	932	411	1	80	0.0125000
NODE_2826_length_1367_cov_576.769716	852	932	414	1	80	0.0125000
NODE_2826_length_1367_cov_576.769716	852	932	434	1	80	0.0125000
NODE_2826_length_1367_cov_576.769716	852	932	447	1	80	0.0125000
NODE_2826_length_1367_cov_576.769716	852	932	448	1	80	0.0125000
NODE_2826_length_1367_cov_576.769716	852	932	449	2	80	0.0250000
NODE_2826_length_1367_cov_576.769716	852	932	450	5	80	0.0625000
NODE_2826_length_1367_cov_576.769716	852	932	459	1	80	0.0125000
NODE_2826_length_1367_cov_576.769716	852	932	469	1	80	0.0125000
NODE_2826_length_1367_cov_576.769716	852	932	477	1	80	0.0125000
NODE_2826_length_1367_cov_576.769716	852	932	485	1	80	0.0125000
NODE_2826_length_1367_cov_576.769716	852	932	491	1	80	0.0125000
NODE_2826_length_1367_cov_576.769716	852	932	510	1	80	0.0125000
NODE_2826_length_1367_cov_576.769716	852	932	513	1	80	0.0125000
NODE_2826_length_1367_cov_576.769716	852	932	517	1	80	0.0125000
NODE_2826_length_1367_cov_576.769716	852	932	523	1	80	0.0125000
NODE_2826_length_1367_cov_576.769716	852	932	525	2	80	0.0250000
NODE_2826_length_1367_cov_576.769716	852	932	534	1	80	0.0125000
NODE_2826_length_1367_cov_576.769716	852	932	536	3	80	0.0375000
NODE_2826_length_1367_cov_576.769716	852	932	537	2	80	0.0250000
NODE_2826_length_1367_cov_576.769716	852	932	538	9	80	0.1125000
NODE_2826_length_1367_cov_576.769716	852	932	541	1	80	0.0125000
NODE_2826_length_1367_cov_576.769716	852	932	543	1	80	0.0125000
NODE_2826_length_1367_cov_576.769716	852	932	547	1	80	0.0125000
NODE_2826_length_1367_cov_576.769716	852	932	550	1	80	0.0125000
NODE_2826_length_1367_cov_576.769716	852	932	552	5	80	0.0625000
NODE_2826_length_1367_cov_576.769716	852	932	553	1	80	0.0125000
NODE_2826_length_1367_cov_576.769716	852	932	555	3	80	0.0375000
NODE_2826_length_1367_cov_576.769716	852	932	557	3	80	0.0375000
NODE_2826_length_1367_cov_576.769716	852	932	558	5	80	0.0625000
NODE_2826_length_1367_cov_576.769716	852	932	562	1	80	0.0125000
NODE_2826_length_1367_cov_576.769716	852	932	563	1	80	0.0125000
NODE_2826_length_1367_cov_576.769716	900	980	332	1	80	0.0125000
NODE_2826_length_1367_cov_576.769716	900	980	341	1	80	0.0125000
NODE_2826_length_1367_cov_576.769716	900	980	366	1	80	0.0125000
NODE_2826_length_1367_cov_576.769716	900	980	394	1	80	0.0125000
NODE_2826_length_1367_cov_576.769716	900	980	410	1	80	0.0125000
NODE_2826_length_1367_cov_576.769716	900	980	428	1	80	0.0125000
NODE_2826_length_1367_cov_576.769716	900	980	433	2	80	0.0250000
NODE_2826_length_1367_cov_576.769716	900	980	439	1	80	0.0125000
NODE_2826_length_1367_cov_576.769716	900	980	443	1	80	0.0125000
NODE_2826_length_1367_cov_576.769716	900	980	446	1	80	0.0125000
NODE_2826_length_1367_cov_576.769716	900	980	450	1	80	0.0125000
NODE_2826_length_1367_cov_576.769716	900	980	461	1	80	0.0125000
NODE_2826_length_1367_cov_576.769716	900	980	464	1	80	0.0125000
NODE_2826_length_1367_cov_576.769716	900	980	466	1	80	0.0125000
NODE_2826_length_1367_cov_576.769716	900	980	470	1	80	0.0125000
NODE_2826_length_1367_cov_576.769716	900	980	476	2	80	0.0250000
NODE_2826_length_1367_cov_576.769716	900	980	478	1	80	0.0125000
NODE_2826_length_1367_cov_576.769716	900	980	481	1	80	0.0125000
NODE_2826_length_1367_cov_576.769716	900	980	484	1	80	0.0125000
NODE_2826_length_1367_cov_576.769716	900	980	486	1	80	0.0125000
NODE_2826_length_1367_cov_576.769716	900	980	493	1	80	0.0125000
NODE_2826_length_1367_cov_576.769716	900	980	494	1	80	0.0125000
NODE_2826_length_1367_cov_576.769716	900	980	496	2	80	0.0250000
NODE_2826_length_1367_cov_576.769716	900	980	498	1	80	0.0125000
NODE_2826_length_1367_cov_576.769716	900	980	499	1	80	0.0125000
NODE_2826_length_1367_cov_576.769716	900	980	503	1	80	0.0125000
NODE_2826_length_1367_cov_576.769716	900	980	513	4	80	0.0500000
NODE_2826_length_1367_cov_576.769716	900	980	519	1	80	0.0125000
NODE_2826_length_1367_cov_576.769716	900	980	521	1	80	0.0125000
NODE_2826_length_1367_cov_576.769716	900	980	524	1	80	0.0125000
NODE_2826_length_1367_cov_576.769716	900	980	527	1	80	0.0125000
NODE_2826_length_1367_cov_576.769716	900	980	528	1	80	0.0125000
NODE_2826_length_1367_cov_576.769716	900	980	529	1	80	0.0125000
NODE_2826_length_1367_cov_576.769716	900	980	531	2	80	0.0250000
NODE_2826_length_1367_cov_576.769716	900	980	535	3	80	0.0375000
NODE_2826_length_1367_cov_576.769716	900	980	536	2	80	0.0250000
NODE_2826_length_1367_cov_576.769716	900	980	537	4	80	0.0500000
NODE_2826_length_1367_cov_576.769716	900	980	538	7	80	0.0875000
NODE_2826_length_1367_cov_576.769716	900	980	541	1	80	0.0125000
NODE_2826_length_1367_cov_576.769716	900	980	543	1	80	0.0125000
NODE_2826_length_1367_cov_576.769716	900	980	547	1	80	0.0125000
NODE_2826_length_1367_cov_576.769716	900	980	550	1	80	0.0125000
NODE_2826_length_1367_cov_576.769716	900	980	552	5	80	0.0625000
NODE_2826_length_1367_cov_576.769716	900	980	553	1	80	0.0125000
NODE_2826_length_1367_cov_576.769716	900	980	555	3	80	0.0375000
NODE_2826_length_1367_cov_576.769716	900	980	557	3	80	0.0375000
NODE_2826_length_1367_cov_576.769716	900	980	558	5	80	0.0625000
NODE_2826_length_1367_cov_576.769716	900	980	562	1	80	0.0125000
NODE_2826_length_1367_cov_576.769716	900	980	563	1	80	0.0125000
NODE_2826_length_1367_cov_576.769716	905	927	537	1	22	0.0454545
NODE_2826_length_1367_cov_576.769716	905	927	541	1	22	0.0454545
NODE_2826_length_1367_cov_576.769716	905	927	547	1	22	0.0454545
NODE_2826_length_1367_cov_576.769716	905	927	550	1	22	0.0454545
NODE_2826_length_1367_cov_576.769716	905	927	552	5	22	0.2272727
NODE_2826_length_1367_cov_576.769716	905	927	553	1	22	0.0454545
NODE_2826_length_1367_cov_576.769716	905	927	555	2	22	0.0909091
NODE_2826_length_1367_cov_576.769716	905	927	557	3	22	0.1363636
NODE_2826_length_1367_cov_576.769716	905	927	558	5	22	0.2272727
NODE_2826_length_1367_cov_576.769716	905	927	562	1	22	0.0454545
NODE_2826_length_1367_cov_576.769716	905	927	563	1	22	0.0454545
NODE_2826_length_1367_cov_576.769716	1051	1131	12	4	80	0.0500000
NODE_2826_length_1367_cov_576.769716	1051	1131	14	1	80	0.0125000
NODE_2826_length_1367_cov_576.769716	1051	1131	15	5	80	0.0625000
NODE_2826_length_1367_cov_576.769716	1051	1131	16	13	80	0.1625000
NODE_2826_length_1367_cov_576.769716	1051	1131	17	1	80	0.0125000
NODE_2826_length_1367_cov_576.769716	1051	1131	18	3	80	0.0375000
NODE_2826_length_1367_cov_576.769716	1051	1131	19	7	80	0.0875000
NODE_2826_length_1367_cov_576.769716	1051	1131	20	6	80	0.0750000
NODE_2826_length_1367_cov_576.769716	1051	1131	21	2	80	0.0250000
NODE_2826_length_1367_cov_576.769716	1051	1131	24	2	80	0.0250000
NODE_2826_length_1367_cov_576.769716	1051	1131	30	1	80	0.0125000
NODE_2826_length_1367_cov_576.769716	1051	1131	33	1	80	0.0125000
NODE_2826_length_1367_cov_576.769716	1051	1131	35	5	80	0.0625000
NODE_2826_length_1367_cov_576.769716	1051	1131	42	2	80	0.0250000
NODE_2826_length_1367_cov_576.769716	1051	1131	43	3	80	0.0375000
NODE_2826_length_1367_cov_576.769716	1051	1131	47	2	80	0.0250000
NODE_2826_length_1367_cov_576.769716	1051	1131	49	5	80	0.0625000
NODE_2826_length_1367_cov_576.769716	1051	1131	50	1	80	0.0125000
NODE_2826_length_1367_cov_576.769716	1051	1131	52	2	80	0.0250000
NODE_2826_length_1367_cov_576.769716	1051	1131	56	2	80	0.0250000
NODE_2826_length_1367_cov_576.769716	1051	1131	58	3	80	0.0375000
NODE_2826_length_1367_cov_576.769716	1051	1131	62	3	80	0.0375000
NODE_2826_length_1367_cov_576.769716	1051	1131	64	1	80	0.0125000
NODE_2826_length_1367_cov_576.769716	1051	1131	65	5	80	0.0625000
NODE_2826_length_1367_cov_576.769716	1104	1184	43	3	80	0.0375000
NODE_2826_length_1367_cov_576.769716	1104	1184	47	2	80	0.0250000
NODE_2826_length_1367_cov_576.769716	1104	1184	49	5	80	0.0625000
NODE_2826_length_1367_cov_576.769716	1104	1184	50	1	80	0.0125000
NODE_2826_length_1367_cov_576.769716	1104	1184	52	2	80	0.0250000
NODE_2826_length_1367_cov_576.769716	1104	1184	56	2	80	0.0250000
NODE_2826_length_1367_cov_576.769716	1104	1184	58	3	80	0.0375000
NODE_2826_length_1367_cov_576.769716	1104	1184	62	3	80	0.0375000
NODE_2826_length_1367_cov_576.769716	1104	1184	64	1	80	0.0125000
NODE_2826_length_1367_cov_576.769716	1104	1184	65	5	80	0.0625000
NODE_2826_length_1367_cov_576.769716	1104	1184	67	4	80	0.0500000
NODE_2826_length_1367_cov_576.769716	1104	1184	71	6	80	0.0750000
NODE_2826_length_1367_cov_576.769716	1104	1184	75	3	80	0.0375000
NODE_2826_length_1367_cov_576.769716	1104	1184	79	1	80	0.0125000
NODE_2826_length_1367_cov_576.769716	1104	1184	83	1	80	0.0125000
NODE_2826_length_1367_cov_576.769716	1104	1184	93	1	80	0.0125000
NODE_2826_length_1367_cov_576.769716	1104	1184	95	2	80	0.0250000
NODE_2826_length_1367_cov_576.769716	1104	1184	97	6	80	0.0750000
NODE_2826_length_1367_cov_576.769716	1104	1184	101	3	80	0.0375000
NODE_2826_length_1367_cov_576.769716	1104	1184	107	1	80	0.0125000
NODE_2826_length_1367_cov_576.769716	1104	1184	111	1	80	0.0125000
NODE_2826_length_1367_cov_576.769716	1104	1184	113	3	80	0.0375000
NODE_2826_length_1367_cov_576.769716	1104	1184	121	4	80	0.0500000
NODE_2826_length_1367_cov_576.769716	1104	1184	122	1	80	0.0125000
NODE_2826_length_1367_cov_576.769716	1104	1184	123	2	80	0.0250000
NODE_2826_length_1367_cov_576.769716	1104	1184	124	5	80	0.0625000
NODE_2826_length_1367_cov_576.769716	1104	1184	128	1	80	0.0125000
NODE_2826_length_1367_cov_576.769716	1104	1184	132	1	80	0.0125000
NODE_2826_length_1367_cov_576.769716	1104	1184	137	3	80	0.0375000
NODE_2826_length_1367_cov_576.769716	1104	1184	139	1	80	0.0125000
NODE_2826_length_1367_cov_576.769716	1104	1184	141	2	80	0.0250000
NODE_2826_length_1367_cov_576.769716	1104	1184	143	1	80	0.0125000
NODE_2827_length_1367_cov_152.824921	513	593	2	24	80	0.3000000
NODE_2827_length_1367_cov_152.824921	513	593	4	56	80	0.7000000
NODE_2827_length_1367_cov_152.824921	566	646	0	14	80	0.1750000
NODE_2827_length_1367_cov_152.824921	566	646	2	38	80	0.4750000
NODE_2827_length_1367_cov_152.824921	566	646	4	28	80	0.3500000
NODE_2827_length_1367_cov_152.824921	642	722	0	46	80	0.5750000
NODE_2827_length_1367_cov_152.824921	642	722	1	1	80	0.0125000
NODE_2827_length_1367_cov_152.824921	642	722	2	19	80	0.2375000
NODE_2827_length_1367_cov_152.824921	642	722	4	1	80	0.0125000
NODE_2827_length_1367_cov_152.824921	642	722	6	13	80	0.1625000
NODE_2827_length_1367_cov_152.824921	695	775	2	20	80	0.2500000
NODE_2827_length_1367_cov_152.824921	695	775	4	1	80	0.0125000
NODE_2827_length_1367_cov_152.824921	695	775	6	59	80	0.7375000
NODE_2829_length_1367_cov_2.947161	250	326	4	21	76	0.2763158
NODE_2829_length_1367_cov_2.947161	250	326	6	7	76	0.0921053
NODE_2829_length_1367_cov_2.947161	250	326	8	31	76	0.4078947
NODE_2829_length_1367_cov_2.947161	250	326	10	17	76	0.2236842
NODE_2831_length_1366_cov_82.742699	198	278	2	29	80	0.3625000
NODE_2831_length_1366_cov_82.742699	198	278	4	51	80	0.6375000
NODE_2831_length_1366_cov_82.742699	251	331	2	70	80	0.8750000
NODE_2831_length_1366_cov_82.742699	251	331	4	10	80	0.1250000
NODE_2832_length_1366_cov_36.659037	577	657	0	17	80	0.2125000
NODE_2832_length_1366_cov_36.659037	577	657	2	45	80	0.5625000
NODE_2832_length_1366_cov_36.659037	577	657	4	18	80	0.2250000
NODE_2832_length_1366_cov_36.659037	630	710	2	14	80	0.1750000
NODE_2832_length_1366_cov_36.659037	630	710	4	66	80	0.8250000
NODE_2834_length_1366_cov_2.320442	47	116	2	6	69	0.0869565
NODE_2834_length_1366_cov_2.320442	47	116	4	2	69	0.0289855
NODE_2834_length_1366_cov_2.320442	47	116	6	61	69	0.8840580
NODE_2834_length_1366_cov_2.320442	1122	1202	0	36	80	0.4500000
NODE_2834_length_1366_cov_2.320442	1122	1202	1	2	80	0.0250000
NODE_2834_length_1366_cov_2.320442	1122	1202	2	1	80	0.0125000
NODE_2834_length_1366_cov_2.320442	1122	1202	4	2	80	0.0250000
NODE_2834_length_1366_cov_2.320442	1122	1202	6	4	80	0.0500000
NODE_2834_length_1366_cov_2.320442	1122	1202	8	6	80	0.0750000
NODE_2834_length_1366_cov_2.320442	1122	1202	10	6	80	0.0750000
NODE_2834_length_1366_cov_2.320442	1122	1202	11	13	80	0.1625000
NODE_2834_length_1366_cov_2.320442	1122	1202	12	3	80	0.0375000
NODE_2834_length_1366_cov_2.320442	1122	1202	14	7	80	0.0875000
NODE_2834_length_1366_cov_2.320442	1175	1255	0	22	80	0.2750000
NODE_2834_length_1366_cov_2.320442	1175	1255	1	2	80	0.0250000
NODE_2834_length_1366_cov_2.320442	1175	1255	2	1	80	0.0125000
NODE_2834_length_1366_cov_2.320442	1175	1255	4	3	80	0.0375000
NODE_2834_length_1366_cov_2.320442	1175	1255	5	3	80	0.0375000
NODE_2834_length_1366_cov_2.320442	1175	1255	8	3	80	0.0375000
NODE_2834_length_1366_cov_2.320442	1175	1255	10	1	80	0.0125000
NODE_2834_length_1366_cov_2.320442	1175	1255	12	1	80	0.0125000
NODE_2834_length_1366_cov_2.320442	1175	1255	14	1	80	0.0125000
NODE_2834_length_1366_cov_2.320442	1175	1255	18	1	80	0.0125000
NODE_2834_length_1366_cov_2.320442	1175	1255	20	3	80	0.0375000
NODE_2834_length_1366_cov_2.320442	1175	1255	21	1	80	0.0125000
NODE_2834_length_1366_cov_2.320442	1175	1255	22	2	80	0.0250000
NODE_2834_length_1366_cov_2.320442	1175	1255	24	3	80	0.0375000
NODE_2834_length_1366_cov_2.320442	1175	1255	26	7	80	0.0875000
NODE_2834_length_1366_cov_2.320442	1175	1255	28	7	80	0.0875000
NODE_2834_length_1366_cov_2.320442	1175	1255	30	2	80	0.0250000
NODE_2834_length_1366_cov_2.320442	1175	1255	36	6	80	0.0750000
NODE_2834_length_1366_cov_2.320442	1175	1255	38	6	80	0.0750000
NODE_2834_length_1366_cov_2.320442	1175	1255	42	1	80	0.0125000
NODE_2834_length_1366_cov_2.320442	1175	1255	44	4	80	0.0500000
NODE_2834_length_1366_cov_2.320442	1251	1331	34	3	80	0.0375000
NODE_2834_length_1366_cov_2.320442	1251	1331	36	1	80	0.0125000
NODE_2834_length_1366_cov_2.320442	1251	1331	38	7	80	0.0875000
NODE_2834_length_1366_cov_2.320442	1251	1331	40	5	80	0.0625000
NODE_2834_length_1366_cov_2.320442	1251	1331	42	6	80	0.0750000
NODE_2834_length_1366_cov_2.320442	1251	1331	44	9	80	0.1125000
NODE_2834_length_1366_cov_2.320442	1251	1331	45	1	80	0.0125000
NODE_2834_length_1366_cov_2.320442	1251	1331	46	1	80	0.0125000
NODE_2834_length_1366_cov_2.320442	1251	1331	47	20	80	0.2500000
NODE_2834_length_1366_cov_2.320442	1251	1331	48	27	80	0.3375000
NODE_2835_length_1365_cov_25.540284	432	509	2	33	77	0.4285714
NODE_2835_length_1365_cov_25.540284	432	509	4	1	77	0.0129870
NODE_2835_length_1365_cov_25.540284	432	509	6	16	77	0.2077922
NODE_2835_length_1365_cov_25.540284	432	509	8	6	77	0.0779221
NODE_2835_length_1365_cov_25.540284	432	509	10	10	77	0.1298701
NODE_2835_length_1365_cov_25.540284	432	509	12	11	77	0.1428571
NODE_2835_length_1365_cov_25.540284	482	562	8	6	80	0.0750000
NODE_2835_length_1365_cov_25.540284	482	562	10	10	80	0.1250000
NODE_2835_length_1365_cov_25.540284	482	562	12	64	80	0.8000000
NODE_2835_length_1365_cov_25.540284	558	635	0	22	77	0.2857143
NODE_2835_length_1365_cov_25.540284	558	635	2	3	77	0.0389610
NODE_2835_length_1365_cov_25.540284	558	635	4	12	77	0.1558442
NODE_2835_length_1365_cov_25.540284	558	635	6	11	77	0.1428571
NODE_2835_length_1365_cov_25.540284	558	635	8	10	77	0.1298701
NODE_2835_length_1365_cov_25.540284	558	635	10	6	77	0.0779221
NODE_2835_length_1365_cov_25.540284	558	635	12	13	77	0.1688312
NODE_2835_length_1365_cov_25.540284	625	688	0	63	63	1.0000000
NODE_2838_length_1364_cov_15.222134	120	191	15	6	71	0.0845070
NODE_2838_length_1364_cov_15.222134	120	191	19	8	71	0.1126761
NODE_2838_length_1364_cov_15.222134	120	191	20	4	71	0.0563380
NODE_2838_length_1364_cov_15.222134	120	191	21	3	71	0.0422535
NODE_2838_length_1364_cov_15.222134	120	191	22	3	71	0.0422535
NODE_2838_length_1364_cov_15.222134	120	191	23	2	71	0.0281690
NODE_2838_length_1364_cov_15.222134	120	191	25	3	71	0.0422535
NODE_2838_length_1364_cov_15.222134	120	191	26	3	71	0.0422535
NODE_2838_length_1364_cov_15.222134	120	191	27	1	71	0.0140845
NODE_2838_length_1364_cov_15.222134	120	191	29	1	71	0.0140845
NODE_2838_length_1364_cov_15.222134	120	191	30	1	71	0.0140845
NODE_2838_length_1364_cov_15.222134	120	191	33	1	71	0.0140845
NODE_2838_length_1364_cov_15.222134	120	191	36	3	71	0.0422535
NODE_2838_length_1364_cov_15.222134	120	191	39	1	71	0.0140845
NODE_2838_length_1364_cov_15.222134	120	191	40	1	71	0.0140845
NODE_2838_length_1364_cov_15.222134	120	191	41	5	71	0.0704225
NODE_2838_length_1364_cov_15.222134	120	191	42	1	71	0.0140845
NODE_2838_length_1364_cov_15.222134	120	191	44	3	71	0.0422535
NODE_2838_length_1364_cov_15.222134	120	191	45	1	71	0.0140845
NODE_2838_length_1364_cov_15.222134	120	191	48	1	71	0.0140845
NODE_2838_length_1364_cov_15.222134	120	191	50	2	71	0.0281690
NODE_2838_length_1364_cov_15.222134	120	191	52	4	71	0.0563380
NODE_2838_length_1364_cov_15.222134	120	191	54	2	71	0.0281690
NODE_2838_length_1364_cov_15.222134	120	191	60	1	71	0.0140845
NODE_2838_length_1364_cov_15.222134	120	191	62	2	71	0.0281690
NODE_2838_length_1364_cov_15.222134	120	191	64	3	71	0.0422535
NODE_2838_length_1364_cov_15.222134	120	191	66	2	71	0.0281690
NODE_2838_length_1364_cov_15.222134	120	191	68	2	71	0.0281690
NODE_2838_length_1364_cov_15.222134	120	191	70	1	71	0.0140845
NODE_2839_length_1364_cov_7.456917	843	923	0	45	80	0.5625000
NODE_2839_length_1364_cov_7.456917	843	923	6	35	80	0.4375000
NODE_2839_length_1364_cov_7.456917	896	976	6	80	80	1.0000000
NODE_2840_length_1364_cov_5.055336	239	290	2	27	51	0.5294118
NODE_2840_length_1364_cov_5.055336	239	290	4	24	51	0.4705882
NODE_2840_length_1364_cov_5.055336	263	343	0	10	80	0.1250000
NODE_2840_length_1364_cov_5.055336	263	343	2	70	80	0.8750000
NODE_2846_length_1363_cov_19.442247	615	695	0	34	80	0.4250000
NODE_2846_length_1363_cov_19.442247	615	695	2	46	80	0.5750000
NODE_2846_length_1363_cov_19.442247	668	748	0	24	80	0.3000000
NODE_2846_length_1363_cov_19.442247	668	748	2	56	80	0.7000000
NODE_2847_length_1363_cov_13.575949	619	699	2	4	80	0.0500000
NODE_2847_length_1363_cov_13.575949	619	699	4	76	80	0.9500000
NODE_2847_length_1363_cov_13.575949	672	752	0	51	80	0.6375000
NODE_2847_length_1363_cov_13.575949	672	752	2	6	80	0.0750000
NODE_2847_length_1363_cov_13.575949	672	752	4	23	80	0.2875000
NODE_2850_length_1362_cov_15.796516	898	978	6	80	80	1.0000000
NODE_2850_length_1362_cov_15.796516	951	1031	0	26	80	0.3250000
NODE_2850_length_1362_cov_15.796516	951	1031	6	54	80	0.6750000
NODE_2855_length_1361_cov_24.574485	528	608	0	80	80	1.0000000
NODE_2855_length_1361_cov_24.574485	581	661	0	63	80	0.7875000
NODE_2855_length_1361_cov_24.574485	581	661	2	17	80	0.2125000
NODE_2856_length_1361_cov_20.148970	866	946	0	70	80	0.8750000
NODE_2856_length_1361_cov_20.148970	866	946	2	10	80	0.1250000
NODE_2856_length_1361_cov_20.148970	919	999	0	17	80	0.2125000
NODE_2856_length_1361_cov_20.148970	919	999	2	63	80	0.7875000
NODE_2858_length_1361_cov_10.530903	1139	1219	0	59	80	0.7375000
NODE_2858_length_1361_cov_10.530903	1139	1219	1	16	80	0.2000000
NODE_2858_length_1361_cov_10.530903	1139	1219	2	5	80	0.0625000
NODE_2858_length_1361_cov_10.530903	1139	1219	0	59	80	0.7375000
NODE_2858_length_1361_cov_10.530903	1139	1219	1	16	80	0.2000000
NODE_2858_length_1361_cov_10.530903	1139	1219	2	5	80	0.0625000
NODE_2858_length_1361_cov_10.530903	1192	1277	0	85	85	1.0000000
NODE_2858_length_1361_cov_10.530903	1273	1353	0	80	80	1.0000000
NODE_2858_length_1361_cov_10.530903	1273	1353	0	80	80	1.0000000
NODE_2858_length_1361_cov_10.530903	1273	1353	0	80	80	1.0000000
NODE_2858_length_1361_cov_10.530903	1273	1353	0	80	80	1.0000000
NODE_2858_length_1361_cov_10.530903	1273	1353	0	80	80	1.0000000
NODE_2858_length_1361_cov_10.530903	1273	1353	0	80	80	1.0000000
NODE_2859_length_1360_cov_42.789056	351	431	6	45	80	0.5625000
NODE_2859_length_1360_cov_42.789056	351	431	12	15	80	0.1875000
NODE_2859_length_1360_cov_42.789056	351	431	14	2	80	0.0250000
NODE_2859_length_1360_cov_42.789056	351	431	16	18	80	0.2250000
NODE_2859_length_1360_cov_42.789056	404	484	6	8	80	0.1000000
NODE_2859_length_1360_cov_42.789056	404	484	12	23	80	0.2875000
NODE_2859_length_1360_cov_42.789056	404	484	14	2	80	0.0250000
NODE_2859_length_1360_cov_42.789056	404	484	16	22	80	0.2750000
NODE_2859_length_1360_cov_42.789056	404	484	18	25	80	0.3125000
NODE_2860_length_1360_cov_26.407613	531	611	2	7	80	0.0875000
NODE_2860_length_1360_cov_26.407613	531	611	4	1	80	0.0125000
NODE_2860_length_1360_cov_26.407613	531	611	6	5	80	0.0625000
NODE_2860_length_1360_cov_26.407613	531	611	8	23	80	0.2875000
NODE_2860_length_1360_cov_26.407613	531	611	10	11	80	0.1375000
NODE_2860_length_1360_cov_26.407613	531	611	12	27	80	0.3375000
NODE_2860_length_1360_cov_26.407613	531	611	14	6	80	0.0750000
NODE_2860_length_1360_cov_26.407613	584	669	6	20	85	0.2352941
NODE_2860_length_1360_cov_26.407613	584	669	8	17	85	0.2000000
NODE_2860_length_1360_cov_26.407613	584	669	10	17	85	0.2000000
NODE_2860_length_1360_cov_26.407613	584	669	12	25	85	0.2941177
NODE_2860_length_1360_cov_26.407613	584	669	14	6	85	0.0705882
NODE_2861_length_1360_cov_16.182395	796	876	1	5	80	0.0625000
NODE_2861_length_1360_cov_16.182395	796	876	3	24	80	0.3000000
NODE_2861_length_1360_cov_16.182395	796	876	4	51	80	0.6375000
NODE_2861_length_1360_cov_16.182395	849	929	1	16	80	0.2000000
NODE_2861_length_1360_cov_16.182395	849	929	2	32	80	0.4000000
NODE_2861_length_1360_cov_16.182395	849	929	4	32	80	0.4000000
NODE_2861_length_1360_cov_16.182395	925	1005	0	30	80	0.3750000
NODE_2861_length_1360_cov_16.182395	925	1005	1	50	80	0.6250000
NODE_2861_length_1360_cov_16.182395	978	1058	0	80	80	1.0000000
NODE_2862_length_1360_cov_12.763680	582	662	0	80	80	1.0000000
NODE_2862_length_1360_cov_12.763680	635	715	0	80	80	1.0000000
NODE_2866_length_1359_cov_41.324603	674	754	0	80	80	1.0000000
NODE_2866_length_1359_cov_41.324603	727	807	0	80	80	1.0000000
NODE_2866_length_1359_cov_41.324603	803	883	0	80	80	1.0000000
NODE_2866_length_1359_cov_41.324603	856	936	0	80	80	1.0000000
NODE_2871_length_1358_cov_23.427323	292	372	1	11	80	0.1375000
NODE_2871_length_1358_cov_23.427323	292	372	2	3	80	0.0375000
NODE_2871_length_1358_cov_23.427323	292	372	3	62	80	0.7750000
NODE_2871_length_1358_cov_23.427323	292	372	4	4	80	0.0500000
NODE_2871_length_1358_cov_23.427323	345	425	1	32	80	0.4000000
NODE_2871_length_1358_cov_23.427323	345	425	3	48	80	0.6000000
NODE_2872_length_1358_cov_19.489277	411	491	0	17	80	0.2125000
NODE_2872_length_1358_cov_19.489277	411	491	3	10	80	0.1250000
NODE_2872_length_1358_cov_19.489277	411	491	4	40	80	0.5000000
NODE_2872_length_1358_cov_19.489277	411	491	9	13	80	0.1625000
NODE_2872_length_1358_cov_19.489277	464	544	3	9	80	0.1125000
NODE_2872_length_1358_cov_19.489277	464	544	4	5	80	0.0625000
NODE_2872_length_1358_cov_19.489277	464	544	9	26	80	0.3250000
NODE_2872_length_1358_cov_19.489277	464	544	11	40	80	0.5000000
NODE_2875_length_1357_cov_15.962639	732	812	0	80	80	1.0000000
NODE_2875_length_1357_cov_15.962639	785	865	0	80	80	1.0000000
NODE_2879_length_1354_cov_9.854980	735	815	0	15	80	0.1875000
NODE_2879_length_1354_cov_9.854980	735	815	2	1	80	0.0125000
NODE_2879_length_1354_cov_9.854980	735	815	4	11	80	0.1375000
NODE_2879_length_1354_cov_9.854980	735	815	6	1	80	0.0125000
NODE_2879_length_1354_cov_9.854980	735	815	8	8	80	0.1000000
NODE_2879_length_1354_cov_9.854980	735	815	10	38	80	0.4750000
NODE_2879_length_1354_cov_9.854980	735	815	12	6	80	0.0750000
NODE_2879_length_1354_cov_9.854980	788	868	4	1	80	0.0125000
NODE_2879_length_1354_cov_9.854980	788	868	6	6	80	0.0750000
NODE_2879_length_1354_cov_9.854980	788	868	8	8	80	0.1000000
NODE_2879_length_1354_cov_9.854980	788	868	10	32	80	0.4000000
NODE_2879_length_1354_cov_9.854980	788	868	12	33	80	0.4125000
NODE_2882_length_1353_cov_32.982456	708	788	0	8	80	0.1000000
NODE_2882_length_1353_cov_32.982456	708	788	2	16	80	0.2000000
NODE_2882_length_1353_cov_32.982456	708	788	4	56	80	0.7000000
NODE_2882_length_1353_cov_32.982456	761	841	0	61	80	0.7625000
NODE_2882_length_1353_cov_32.982456	761	841	2	16	80	0.2000000
NODE_2882_length_1353_cov_32.982456	761	841	4	3	80	0.0375000
NODE_2883_length_1353_cov_21.775120	493	573	0	18	80	0.2250000
NODE_2883_length_1353_cov_21.775120	493	573	2	62	80	0.7750000
NODE_2883_length_1353_cov_21.775120	546	626	0	12	80	0.1500000
NODE_2883_length_1353_cov_21.775120	546	626	2	68	80	0.8500000
NODE_2884_length_1353_cov_18.201754	696	776	2	2	80	0.0250000
NODE_2884_length_1353_cov_18.201754	696	776	4	15	80	0.1875000
NODE_2884_length_1353_cov_18.201754	696	776	6	2	80	0.0250000
NODE_2884_length_1353_cov_18.201754	696	776	8	56	80	0.7000000
NODE_2884_length_1353_cov_18.201754	696	776	10	5	80	0.0625000
NODE_2884_length_1353_cov_18.201754	749	829	2	18	80	0.2250000
NODE_2884_length_1353_cov_18.201754	749	829	4	25	80	0.3125000
NODE_2884_length_1353_cov_18.201754	749	829	6	8	80	0.1000000
NODE_2884_length_1353_cov_18.201754	749	829	8	24	80	0.3000000
NODE_2884_length_1353_cov_18.201754	749	829	10	5	80	0.0625000
NODE_2888_length_1352_cov_26.942538	455	535	6	80	80	1.0000000
NODE_2888_length_1352_cov_26.942538	508	588	0	4	80	0.0500000
NODE_2888_length_1352_cov_26.942538	508	588	4	40	80	0.5000000
NODE_2888_length_1352_cov_26.942538	508	588	6	36	80	0.4500000
NODE_2889_length_1352_cov_17.189944	717	797	0	80	80	1.0000000
NODE_2889_length_1352_cov_17.189944	770	850	0	80	80	1.0000000
NODE_2890_length_1352_cov_15.752594	640	720	0	26	80	0.3250000
NODE_2890_length_1352_cov_15.752594	640	720	2	21	80	0.2625000
NODE_2890_length_1352_cov_15.752594	640	720	4	33	80	0.4125000
NODE_2890_length_1352_cov_15.752594	693	773	2	65	80	0.8125000
NODE_2890_length_1352_cov_15.752594	693	773	4	15	80	0.1875000
NODE_2891_length_1352_cov_10.699920	237	317	0	80	80	1.0000000
NODE_2891_length_1352_cov_10.699920	290	370	0	80	80	1.0000000
NODE_2894_length_1351_cov_32.325879	561	641	0	80	80	1.0000000
NODE_2894_length_1351_cov_32.325879	614	694	0	80	80	1.0000000
NODE_2895_length_1351_cov_16.861022	97	162	8	1	65	0.0153846
NODE_2895_length_1351_cov_16.861022	97	162	10	1	65	0.0153846
NODE_2895_length_1351_cov_16.861022	97	162	12	2	65	0.0307692
NODE_2895_length_1351_cov_16.861022	97	162	14	1	65	0.0153846
NODE_2895_length_1351_cov_16.861022	97	162	18	8	65	0.1230769
NODE_2895_length_1351_cov_16.861022	97	162	26	2	65	0.0307692
NODE_2895_length_1351_cov_16.861022	97	162	28	2	65	0.0307692
NODE_2895_length_1351_cov_16.861022	97	162	29	1	65	0.0153846
NODE_2895_length_1351_cov_16.861022	97	162	30	1	65	0.0153846
NODE_2895_length_1351_cov_16.861022	97	162	32	2	65	0.0307692
NODE_2895_length_1351_cov_16.861022	97	162	36	9	65	0.1384615
NODE_2895_length_1351_cov_16.861022	97	162	38	35	65	0.5384616
NODE_2896_length_1351_cov_9.894569	331	411	0	11	80	0.1375000
NODE_2896_length_1351_cov_9.894569	331	411	2	69	80	0.8625000
NODE_2896_length_1351_cov_9.894569	384	464	0	27	80	0.3375000
NODE_2896_length_1351_cov_9.894569	384	464	2	53	80	0.6625000
NODE_2897_length_1351_cov_8.699681	1055	1137	0	75	82	0.9146342
NODE_2897_length_1351_cov_8.699681	1055	1137	6	3	82	0.0365854
NODE_2897_length_1351_cov_8.699681	1055	1137	8	1	82	0.0121951
NODE_2897_length_1351_cov_8.699681	1055	1137	12	3	82	0.0365854
NODE_2897_length_1351_cov_8.699681	1110	1175	0	65	65	1.0000000
NODE_2898_length_1351_cov_2.931310	68	148	30	2	80	0.0250000
NODE_2898_length_1351_cov_2.931310	68	148	32	22	80	0.2750000
NODE_2898_length_1351_cov_2.931310	68	148	36	3	80	0.0375000
NODE_2898_length_1351_cov_2.931310	68	148	38	2	80	0.0250000
NODE_2898_length_1351_cov_2.931310	68	148	40	7	80	0.0875000
NODE_2898_length_1351_cov_2.931310	68	148	42	13	80	0.1625000
NODE_2898_length_1351_cov_2.931310	68	148	43	3	80	0.0375000
NODE_2898_length_1351_cov_2.931310	68	148	44	2	80	0.0250000
NODE_2898_length_1351_cov_2.931310	68	148	45	1	80	0.0125000
NODE_2898_length_1351_cov_2.931310	68	148	46	12	80	0.1500000
NODE_2898_length_1351_cov_2.931310	68	148	47	4	80	0.0500000
NODE_2898_length_1351_cov_2.931310	68	148	48	9	80	0.1125000
NODE_2898_length_1351_cov_2.931310	495	528	0	33	33	1.0000000
NODE_2899_length_1350_cov_18.274181	424	504	2	36	80	0.4500000
NODE_2899_length_1350_cov_18.274181	424	504	4	6	80	0.0750000
NODE_2899_length_1350_cov_18.274181	424	504	6	38	80	0.4750000
NODE_2899_length_1350_cov_18.274181	477	557	3	15	80	0.1875000
NODE_2899_length_1350_cov_18.274181	477	557	4	3	80	0.0375000
NODE_2899_length_1350_cov_18.274181	477	557	5	16	80	0.2000000
NODE_2899_length_1350_cov_18.274181	477	557	6	46	80	0.5750000
NODE_2899_length_1350_cov_18.274181	553	633	3	8	80	0.1000000
NODE_2899_length_1350_cov_18.274181	553	633	4	4	80	0.0500000
NODE_2899_length_1350_cov_18.274181	553	633	6	64	80	0.8000000
NODE_2899_length_1350_cov_18.274181	553	633	8	4	80	0.0500000
NODE_2899_length_1350_cov_18.274181	606	686	6	23	80	0.2875000
NODE_2899_length_1350_cov_18.274181	606	686	8	57	80	0.7125000
NODE_2900_length_1350_cov_8.053557	737	817	0	28	80	0.3500000
NODE_2900_length_1350_cov_8.053557	737	817	2	52	80	0.6500000
NODE_2900_length_1350_cov_8.053557	790	870	0	80	80	1.0000000
NODE_2903_length_1349_cov_23.782400	839	919	0	59	80	0.7375000
NODE_2903_length_1349_cov_23.782400	839	919	2	2	80	0.0250000
NODE_2903_length_1349_cov_23.782400	839	919	4	19	80	0.2375000
NODE_2903_length_1349_cov_23.782400	892	972	0	80	80	1.0000000
NODE_2903_length_1349_cov_23.782400	968	1048	0	60	80	0.7500000
NODE_2903_length_1349_cov_23.782400	968	1048	2	20	80	0.2500000
NODE_2903_length_1349_cov_23.782400	1021	1101	0	7	80	0.0875000
NODE_2903_length_1349_cov_23.782400	1021	1101	2	73	80	0.9125000
NODE_2904_length_1349_cov_17.776800	811	891	2	3	80	0.0375000
NODE_2904_length_1349_cov_17.776800	811	891	4	38	80	0.4750000
NODE_2904_length_1349_cov_17.776800	811	891	5	39	80	0.4875000
NODE_2904_length_1349_cov_17.776800	864	944	1	41	80	0.5125000
NODE_2904_length_1349_cov_17.776800	864	944	3	11	80	0.1375000
NODE_2904_length_1349_cov_17.776800	864	944	5	28	80	0.3500000
NODE_2905_length_1349_cov_16.468800	828	908	0	80	80	1.0000000
NODE_2905_length_1349_cov_16.468800	881	961	0	80	80	1.0000000
NODE_2908_length_1348_cov_22.731785	468	548	0	17	80	0.2125000
NODE_2908_length_1348_cov_22.731785	468	548	6	63	80	0.7875000
NODE_2908_length_1348_cov_22.731785	521	601	0	14	80	0.1750000
NODE_2908_length_1348_cov_22.731785	521	601	5	1	80	0.0125000
NODE_2908_length_1348_cov_22.731785	521	601	6	65	80	0.8125000
NODE_2909_length_1348_cov_20.778223	517	597	0	46	80	0.5750000
NODE_2909_length_1348_cov_20.778223	517	597	2	34	80	0.4250000
NODE_2909_length_1348_cov_20.778223	570	650	2	80	80	1.0000000
NODE_2910_length_1348_cov_11.180144	673	753	0	10	80	0.1250000
NODE_2910_length_1348_cov_11.180144	673	753	1	70	80	0.8750000
NODE_2910_length_1348_cov_11.180144	726	806	1	78	80	0.9750000
NODE_2910_length_1348_cov_11.180144	726	806	3	2	80	0.0250000
NODE_2916_length_1347_cov_45.906250	683	763	2	17	80	0.2125000
NODE_2916_length_1347_cov_45.906250	683	763	6	46	80	0.5750000
NODE_2916_length_1347_cov_45.906250	683	763	8	17	80	0.2125000
NODE_2916_length_1347_cov_45.906250	736	816	0	53	80	0.6625000
NODE_2916_length_1347_cov_45.906250	736	816	2	17	80	0.2125000
NODE_2916_length_1347_cov_45.906250	736	816	6	10	80	0.1250000
NODE_2916_length_1347_cov_45.906250	812	892	0	40	80	0.5000000
NODE_2916_length_1347_cov_45.906250	812	892	4	10	80	0.1250000
NODE_2916_length_1347_cov_45.906250	812	892	6	30	80	0.3750000
NODE_2916_length_1347_cov_45.906250	865	945	6	43	80	0.5375000
NODE_2916_length_1347_cov_45.906250	865	945	8	37	80	0.4625000
NODE_2917_length_1347_cov_41.643429	439	519	3	6	80	0.0750000
NODE_2917_length_1347_cov_41.643429	439	519	7	5	80	0.0625000
NODE_2917_length_1347_cov_41.643429	439	519	11	13	80	0.1625000
NODE_2917_length_1347_cov_41.643429	439	519	13	19	80	0.2375000
NODE_2917_length_1347_cov_41.643429	439	519	15	1	80	0.0125000
NODE_2917_length_1347_cov_41.643429	439	519	16	4	80	0.0500000
NODE_2917_length_1347_cov_41.643429	439	519	17	4	80	0.0500000
NODE_2917_length_1347_cov_41.643429	439	519	18	15	80	0.1875000
NODE_2917_length_1347_cov_41.643429	439	519	19	3	80	0.0375000
NODE_2917_length_1347_cov_41.643429	439	519	21	10	80	0.1250000
NODE_2917_length_1347_cov_41.643429	492	572	3	7	80	0.0875000
NODE_2917_length_1347_cov_41.643429	492	572	5	51	80	0.6375000
NODE_2917_length_1347_cov_41.643429	492	572	7	6	80	0.0750000
NODE_2917_length_1347_cov_41.643429	492	572	11	5	80	0.0625000
NODE_2917_length_1347_cov_41.643429	492	572	13	11	80	0.1375000
NODE_2918_length_1347_cov_19.941506	458	538	0	80	80	1.0000000
NODE_2918_length_1347_cov_19.941506	511	591	0	80	80	1.0000000
NODE_2918_length_1347_cov_19.941506	587	667	0	80	80	1.0000000
NODE_2918_length_1347_cov_19.941506	640	720	0	80	80	1.0000000
NODE_2919_length_1347_cov_16.520833	713	793	0	80	80	1.0000000
NODE_2919_length_1347_cov_16.520833	766	846	0	80	80	1.0000000
NODE_2920_length_1347_cov_15.967147	638	718	0	23	80	0.2875000
NODE_2920_length_1347_cov_15.967147	638	718	1	21	80	0.2625000
NODE_2920_length_1347_cov_15.967147	638	718	2	36	80	0.4500000
NODE_2920_length_1347_cov_15.967147	691	771	2	80	80	1.0000000
NODE_2925_length_1346_cov_13.112269	429	509	5	7	80	0.0875000
NODE_2925_length_1346_cov_13.112269	429	509	7	37	80	0.4625000
NODE_2925_length_1346_cov_13.112269	429	509	8	36	80	0.4500000
NODE_2925_length_1346_cov_13.112269	482	562	0	15	80	0.1875000
NODE_2925_length_1346_cov_13.112269	482	562	2	25	80	0.3125000
NODE_2925_length_1346_cov_13.112269	482	562	4	12	80	0.1500000
NODE_2925_length_1346_cov_13.112269	482	562	5	8	80	0.1000000
NODE_2925_length_1346_cov_13.112269	482	562	7	20	80	0.2500000
NODE_2928_length_1345_cov_32.099518	629	709	6	38	80	0.4750000
NODE_2928_length_1345_cov_32.099518	629	709	8	14	80	0.1750000
NODE_2928_length_1345_cov_32.099518	629	709	10	28	80	0.3500000
NODE_2928_length_1345_cov_32.099518	682	762	0	15	80	0.1875000
NODE_2928_length_1345_cov_32.099518	682	762	4	7	80	0.0875000
NODE_2928_length_1345_cov_32.099518	682	762	6	20	80	0.2500000
NODE_2928_length_1345_cov_32.099518	682	762	8	22	80	0.2750000
NODE_2928_length_1345_cov_32.099518	682	762	10	16	80	0.2000000
NODE_2929_length_1345_cov_19.837881	723	803	0	80	80	1.0000000
NODE_2929_length_1345_cov_19.837881	776	856	0	80	80	1.0000000
NODE_2930_length_1345_cov_14.262440	361	441	0	80	80	1.0000000
NODE_2930_length_1345_cov_14.262440	414	494	0	80	80	1.0000000
NODE_2930_length_1345_cov_14.262440	490	570	0	80	80	1.0000000
NODE_2930_length_1345_cov_14.262440	543	623	0	80	80	1.0000000
NODE_2931_length_1345_cov_14.103531	950	1030	0	9	80	0.1125000
NODE_2931_length_1345_cov_14.103531	950	1030	2	71	80	0.8875000
NODE_2931_length_1345_cov_14.103531	1003	1083	0	62	80	0.7750000
NODE_2931_length_1345_cov_14.103531	1003	1083	2	18	80	0.2250000
NODE_2934_length_1344_cov_15.013655	345	425	3	8	80	0.1000000
NODE_2934_length_1344_cov_15.013655	345	425	6	72	80	0.9000000
NODE_2934_length_1344_cov_15.013655	398	478	0	44	80	0.5500000
NODE_2934_length_1344_cov_15.013655	398	478	3	17	80	0.2125000
NODE_2934_length_1344_cov_15.013655	398	478	6	19	80	0.2375000
NODE_2935_length_1344_cov_11.383133	519	599	1	11	80	0.1375000
NODE_2935_length_1344_cov_11.383133	519	599	2	56	80	0.7000000
NODE_2935_length_1344_cov_11.383133	519	599	4	13	80	0.1625000
NODE_2935_length_1344_cov_11.383133	572	652	2	14	80	0.1750000
NODE_2935_length_1344_cov_11.383133	572	652	3	50	80	0.6250000
NODE_2935_length_1344_cov_11.383133	572	652	4	16	80	0.2000000
NODE_2935_length_1344_cov_11.383133	648	728	0	36	80	0.4500000
NODE_2935_length_1344_cov_11.383133	648	728	2	31	80	0.3875000
NODE_2935_length_1344_cov_11.383133	648	728	3	13	80	0.1625000
NODE_2935_length_1344_cov_11.383133	701	781	0	42	80	0.5250000
NODE_2935_length_1344_cov_11.383133	701	781	2	38	80	0.4750000
NODE_2936_length_1344_cov_10.924498	529	609	0	51	80	0.6375000
NODE_2936_length_1344_cov_10.924498	529	609	2	21	80	0.2625000
NODE_2936_length_1344_cov_10.924498	529	609	4	8	80	0.1000000
NODE_2936_length_1344_cov_10.924498	582	662	0	80	80	1.0000000
NODE_2937_length_1344_cov_5.531727	920	975	0	55	55	1.0000000
NODE_2942_length_1343_cov_36.005627	150	230	26	40	80	0.5000000
NODE_2942_length_1343_cov_36.005627	150	230	28	2	80	0.0250000
NODE_2942_length_1343_cov_36.005627	150	230	30	13	80	0.1625000
NODE_2942_length_1343_cov_36.005627	150	230	31	7	80	0.0875000
NODE_2942_length_1343_cov_36.005627	150	230	33	12	80	0.1500000
NODE_2942_length_1343_cov_36.005627	150	230	37	4	80	0.0500000
NODE_2942_length_1343_cov_36.005627	150	230	39	2	80	0.0250000
NODE_2942_length_1343_cov_36.005627	286	366	0	1	80	0.0125000
NODE_2942_length_1343_cov_36.005627	286	366	2	12	80	0.1500000
NODE_2942_length_1343_cov_36.005627	286	366	4	67	80	0.8375000
NODE_2942_length_1343_cov_36.005627	339	419	0	54	80	0.6750000
NODE_2942_length_1343_cov_36.005627	339	419	2	2	80	0.0250000
NODE_2942_length_1343_cov_36.005627	339	419	4	24	80	0.3000000
NODE_2942_length_1343_cov_36.005627	415	495	0	37	80	0.4625000
NODE_2942_length_1343_cov_36.005627	415	495	3	1	80	0.0125000
NODE_2942_length_1343_cov_36.005627	415	495	4	42	80	0.5250000
NODE_2942_length_1343_cov_36.005627	468	548	4	80	80	1.0000000
NODE_2943_length_1343_cov_26.826367	782	862	0	80	80	1.0000000
NODE_2943_length_1343_cov_26.826367	835	915	0	80	80	1.0000000
NODE_2944_length_1343_cov_19.353698	799	879	0	14	80	0.1750000
NODE_2944_length_1343_cov_19.353698	799	879	2	25	80	0.3125000
NODE_2944_length_1343_cov_19.353698	799	879	4	41	80	0.5125000
NODE_2944_length_1343_cov_19.353698	852	932	0	67	80	0.8375000
NODE_2944_length_1343_cov_19.353698	852	932	2	13	80	0.1625000
NODE_2944_length_1343_cov_19.353698	928	1008	0	31	80	0.3875000
NODE_2944_length_1343_cov_19.353698	928	1008	2	24	80	0.3000000
NODE_2944_length_1343_cov_19.353698	928	1008	6	24	80	0.3000000
NODE_2944_length_1343_cov_19.353698	928	1008	8	1	80	0.0125000
NODE_2944_length_1343_cov_19.353698	981	1061	2	2	80	0.0250000
NODE_2944_length_1343_cov_19.353698	981	1061	6	61	80	0.7625000
NODE_2944_length_1343_cov_19.353698	981	1061	8	17	80	0.2125000
NODE_2945_length_1343_cov_15.717846	745	825	0	80	80	1.0000000
NODE_2945_length_1343_cov_15.717846	798	878	0	80	80	1.0000000
NODE_2949_length_1342_cov_30.491553	456	536	2	80	80	1.0000000
NODE_2949_length_1342_cov_30.491553	509	589	0	39	80	0.4875000
NODE_2949_length_1342_cov_30.491553	509	589	2	41	80	0.5125000
NODE_2949_length_1342_cov_30.491553	585	665	0	80	80	1.0000000
NODE_2949_length_1342_cov_30.491553	638	718	0	80	80	1.0000000
NODE_2950_length_1342_cov_26.796460	538	618	0	27	80	0.3375000
NODE_2950_length_1342_cov_26.796460	538	618	4	53	80	0.6625000
NODE_2950_length_1342_cov_26.796460	591	671	0	80	80	1.0000000
NODE_2950_length_1342_cov_26.796460	667	747	0	40	80	0.5000000
NODE_2950_length_1342_cov_26.796460	667	747	2	40	80	0.5000000
NODE_2950_length_1342_cov_26.796460	720	800	2	80	80	1.0000000
NODE_2951_length_1342_cov_22.769912	298	378	0	60	80	0.7500000
NODE_2951_length_1342_cov_22.769912	298	378	2	16	80	0.2000000
NODE_2951_length_1342_cov_22.769912	298	378	9	4	80	0.0500000
NODE_2951_length_1342_cov_22.769912	351	431	0	7	80	0.0875000
NODE_2951_length_1342_cov_22.769912	351	431	2	16	80	0.2000000
NODE_2951_length_1342_cov_22.769912	351	431	9	56	80	0.7000000
NODE_2951_length_1342_cov_22.769912	351	431	11	1	80	0.0125000
NODE_2951_length_1342_cov_22.769912	427	507	9	3	80	0.0375000
NODE_2951_length_1342_cov_22.769912	427	507	10	36	80	0.4500000
NODE_2951_length_1342_cov_22.769912	427	507	11	22	80	0.2750000
NODE_2951_length_1342_cov_22.769912	427	507	13	19	80	0.2375000
NODE_2951_length_1342_cov_22.769912	480	560	0	34	80	0.4250000
NODE_2951_length_1342_cov_22.769912	480	560	2	8	80	0.1000000
NODE_2951_length_1342_cov_22.769912	480	560	8	9	80	0.1125000
NODE_2951_length_1342_cov_22.769912	480	560	10	29	80	0.3625000
NODE_2953_length_1341_cov_22.449275	494	574	0	80	80	1.0000000
NODE_2953_length_1341_cov_22.449275	547	627	0	80	80	1.0000000
NODE_2953_length_1341_cov_22.449275	623	703	0	80	80	1.0000000
NODE_2953_length_1341_cov_22.449275	676	755	0	79	79	1.0000000
NODE_2954_length_1341_cov_14.497585	415	495	2	5	80	0.0625000
NODE_2954_length_1341_cov_14.497585	415	495	4	75	80	0.9375000
NODE_2954_length_1341_cov_14.497585	468	548	0	46	80	0.5750000
NODE_2954_length_1341_cov_14.497585	468	548	2	7	80	0.0875000
NODE_2954_length_1341_cov_14.497585	468	548	4	27	80	0.3375000
NODE_2954_length_1341_cov_14.497585	544	624	0	45	80	0.5625000
NODE_2954_length_1341_cov_14.497585	544	624	2	31	80	0.3875000
NODE_2954_length_1341_cov_14.497585	544	624	4	4	80	0.0500000
NODE_2954_length_1341_cov_14.497585	597	677	2	23	80	0.2875000
NODE_2954_length_1341_cov_14.497585	597	677	4	57	80	0.7125000
NODE_2960_length_1340_cov_9.460113	531	611	0	80	80	1.0000000
NODE_2960_length_1340_cov_9.460113	584	664	0	80	80	1.0000000
NODE_2961_length_1340_cov_6.511684	735	815	0	80	80	1.0000000
NODE_2961_length_1340_cov_6.511684	788	868	0	80	80	1.0000000
NODE_2966_length_1339_cov_22.725000	751	831	0	80	80	1.0000000
NODE_2966_length_1339_cov_22.725000	804	884	0	80	80	1.0000000
NODE_2967_length_1339_cov_9.322581	329	409	0	2	80	0.0250000
NODE_2967_length_1339_cov_9.322581	329	409	1	15	80	0.1875000
NODE_2967_length_1339_cov_9.322581	329	409	3	55	80	0.6875000
NODE_2967_length_1339_cov_9.322581	329	409	5	8	80	0.1000000
NODE_2967_length_1339_cov_9.322581	382	462	3	39	80	0.4875000
NODE_2967_length_1339_cov_9.322581	382	462	5	41	80	0.5125000
NODE_2970_length_1338_cov_31.740920	527	607	0	51	80	0.6375000
NODE_2970_length_1338_cov_31.740920	527	607	2	29	80	0.3625000
NODE_2970_length_1338_cov_31.740920	580	660	0	79	80	0.9875000
NODE_2970_length_1338_cov_31.740920	580	660	2	1	80	0.0125000
NODE_2970_length_1338_cov_31.740920	656	736	0	3	80	0.0375000
NODE_2970_length_1338_cov_31.740920	656	736	2	77	80	0.9625000
NODE_2970_length_1338_cov_31.740920	709	789	0	10	80	0.1250000
NODE_2970_length_1338_cov_31.740920	709	789	2	70	80	0.8750000
NODE_2971_length_1338_cov_21.254237	639	719	0	34	80	0.4250000
NODE_2971_length_1338_cov_21.254237	639	719	2	46	80	0.5750000
NODE_2971_length_1338_cov_21.254237	692	772	2	80	80	1.0000000
NODE_2974_length_1337_cov_32.307754	739	819	4	1	80	0.0125000
NODE_2974_length_1337_cov_32.307754	739	819	6	11	80	0.1375000
NODE_2974_length_1337_cov_32.307754	739	819	8	5	80	0.0625000
NODE_2974_length_1337_cov_32.307754	739	819	11	6	80	0.0750000
NODE_2974_length_1337_cov_32.307754	739	819	12	4	80	0.0500000
NODE_2974_length_1337_cov_32.307754	739	819	13	51	80	0.6375000
NODE_2974_length_1337_cov_32.307754	739	819	14	2	80	0.0250000
NODE_2974_length_1337_cov_32.307754	792	872	2	2	80	0.0250000
NODE_2974_length_1337_cov_32.307754	792	872	4	7	80	0.0875000
NODE_2974_length_1337_cov_32.307754	792	872	6	29	80	0.3625000
NODE_2974_length_1337_cov_32.307754	792	872	8	7	80	0.0875000
NODE_2974_length_1337_cov_32.307754	792	872	9	3	80	0.0375000
NODE_2974_length_1337_cov_32.307754	792	872	11	11	80	0.1375000
NODE_2974_length_1337_cov_32.307754	792	872	13	21	80	0.2625000
NODE_2975_length_1337_cov_30.412763	465	545	2	69	80	0.8625000
NODE_2975_length_1337_cov_30.412763	465	545	4	11	80	0.1375000
NODE_2975_length_1337_cov_30.412763	518	598	2	54	80	0.6750000
NODE_2975_length_1337_cov_30.412763	518	598	3	14	80	0.1750000
NODE_2975_length_1337_cov_30.412763	518	598	4	11	80	0.1375000
NODE_2975_length_1337_cov_30.412763	518	598	5	1	80	0.0125000
NODE_2976_length_1337_cov_12.760905	560	640	0	46	80	0.5750000
NODE_2976_length_1337_cov_12.760905	560	640	4	34	80	0.4250000
NODE_2976_length_1337_cov_12.760905	613	693	0	10	80	0.1250000
NODE_2976_length_1337_cov_12.760905	613	693	4	70	80	0.8750000
NODE_2977_length_1337_cov_9.463651	724	804	0	44	80	0.5500000
NODE_2977_length_1337_cov_9.463651	724	804	2	36	80	0.4500000
NODE_2977_length_1337_cov_9.463651	777	857	2	80	80	1.0000000
NODE_2979_length_1337_cov_4.540388	216	296	0	80	80	1.0000000
NODE_2979_length_1337_cov_4.540388	272	349	0	77	77	1.0000000
NODE_2981_length_1336_cov_28.161681	394	474	0	80	80	1.0000000
NODE_2981_length_1336_cov_28.161681	447	527	0	80	80	1.0000000
NODE_2981_length_1336_cov_28.161681	523	603	0	6	80	0.0750000
NODE_2981_length_1336_cov_28.161681	523	603	2	74	80	0.9250000
NODE_2981_length_1336_cov_28.161681	576	656	0	34	80	0.4250000
NODE_2981_length_1336_cov_28.161681	576	656	2	46	80	0.5750000
NODE_2982_length_1336_cov_7.860954	17	98	0	57	81	0.7037037
NODE_2982_length_1336_cov_7.860954	17	98	2	24	81	0.2962963
NODE_2984_length_1336_cov_1.689572	1229	1289	5	1	60	0.0166667
NODE_2984_length_1336_cov_1.689572	1229	1289	6	59	60	0.9833333
NODE_2984_length_1336_cov_1.689572	1262	1336	0	20	74	0.2702703
NODE_2984_length_1336_cov_1.689572	1262	1336	2	19	74	0.2567568
NODE_2984_length_1336_cov_1.689572	1262	1336	4	5	74	0.0675676
NODE_2984_length_1336_cov_1.689572	1262	1336	6	30	74	0.4054054
NODE_2985_length_1335_cov_19.547735	530	607	0	14	77	0.1818182
NODE_2985_length_1335_cov_19.547735	530	607	2	39	77	0.5064935
NODE_2985_length_1335_cov_19.547735	530	607	4	24	77	0.3116883
NODE_2985_length_1335_cov_19.547735	582	660	0	67	78	0.8589743
NODE_2985_length_1335_cov_19.547735	582	660	2	11	78	0.1410256
NODE_2985_length_1335_cov_19.547735	656	736	0	80	80	1.0000000
NODE_2985_length_1335_cov_19.547735	709	789	0	64	80	0.8000000
NODE_2985_length_1335_cov_19.547735	709	789	2	16	80	0.2000000
NODE_2986_length_1335_cov_15.383495	419	499	2	77	80	0.9625000
NODE_2986_length_1335_cov_15.383495	419	499	4	3	80	0.0375000
NODE_2986_length_1335_cov_15.383495	472	552	2	80	80	1.0000000
NODE_2986_length_1335_cov_15.383495	548	628	0	67	80	0.8375000
NODE_2986_length_1335_cov_15.383495	548	628	1	1	80	0.0125000
NODE_2986_length_1335_cov_15.383495	548	628	2	12	80	0.1500000
NODE_2986_length_1335_cov_15.383495	601	681	0	80	80	1.0000000
NODE_2991_length_1333_cov_27.372771	493	573	4	48	80	0.6000000
NODE_2991_length_1333_cov_27.372771	493	573	6	32	80	0.4000000
NODE_2991_length_1333_cov_27.372771	546	626	2	11	80	0.1375000
NODE_2991_length_1333_cov_27.372771	546	626	3	22	80	0.2750000
NODE_2991_length_1333_cov_27.372771	546	626	4	47	80	0.5875000
NODE_2996_length_1332_cov_18.978913	648	728	0	4	80	0.0500000
NODE_2996_length_1332_cov_18.978913	648	728	1	20	80	0.2500000
NODE_2996_length_1332_cov_18.978913	648	728	3	56	80	0.7000000
NODE_2996_length_1332_cov_18.978913	701	781	0	57	80	0.7125000
NODE_2996_length_1332_cov_18.978913	701	781	1	20	80	0.2500000
NODE_2996_length_1332_cov_18.978913	701	781	3	3	80	0.0375000
NODE_2996_length_1332_cov_18.978913	777	857	0	80	80	1.0000000
NODE_2996_length_1332_cov_18.978913	830	910	0	80	80	1.0000000
NODE_2997_length_1332_cov_3.112733	87	151	0	14	64	0.2187500
NODE_2997_length_1332_cov_3.112733	87	151	2	37	64	0.5781250
NODE_2997_length_1332_cov_3.112733	87	151	4	1	64	0.0156250
NODE_2997_length_1332_cov_3.112733	87	151	6	4	64	0.0625000
NODE_2997_length_1332_cov_3.112733	87	151	10	1	64	0.0156250
NODE_2997_length_1332_cov_3.112733	87	151	12	5	64	0.0781250
NODE_2997_length_1332_cov_3.112733	87	151	14	2	64	0.0312500
NODE_3000_length_1331_cov_16.831981	392	472	0	80	80	1.0000000
NODE_3000_length_1331_cov_16.831981	445	525	0	80	80	1.0000000
NODE_3000_length_1331_cov_16.831981	521	601	0	80	80	1.0000000
NODE_3000_length_1331_cov_16.831981	574	654	0	80	80	1.0000000
NODE_3001_length_1331_cov_12.841721	871	951	0	80	80	1.0000000
NODE_3001_length_1331_cov_12.841721	924	1004	0	80	80	1.0000000
NODE_3004_length_1331_cov_2.090097	0	76	0	76	76	1.0000000
NODE_3004_length_1331_cov_2.090097	49	98	0	49	49	1.0000000
NODE_3007_length_1330_cov_48.993501	278	358	4	9	80	0.1125000
NODE_3007_length_1330_cov_48.993501	278	358	6	23	80	0.2875000
NODE_3007_length_1330_cov_48.993501	278	358	8	2	80	0.0250000
NODE_3007_length_1330_cov_48.993501	278	358	10	6	80	0.0750000
NODE_3007_length_1330_cov_48.993501	278	358	14	40	80	0.5000000
NODE_3007_length_1330_cov_48.993501	331	411	6	24	80	0.3000000
NODE_3007_length_1330_cov_48.993501	331	411	9	1	80	0.0125000
NODE_3007_length_1330_cov_48.993501	331	411	10	30	80	0.3750000
NODE_3007_length_1330_cov_48.993501	331	411	14	25	80	0.3125000
NODE_3007_length_1330_cov_48.993501	742	822	0	4	80	0.0500000
NODE_3007_length_1330_cov_48.993501	742	822	2	76	80	0.9500000
NODE_3007_length_1330_cov_48.993501	795	875	2	45	80	0.5625000
NODE_3007_length_1330_cov_48.993501	795	875	4	35	80	0.4375000
NODE_3008_length_1330_cov_11.037368	407	487	0	80	80	1.0000000
NODE_3008_length_1330_cov_11.037368	460	540	0	80	80	1.0000000
NODE_3008_length_1330_cov_11.037368	536	617	0	81	81	1.0000000
NODE_3008_length_1330_cov_11.037368	590	670	0	80	80	1.0000000
NODE_3009_length_1330_cov_9.026807	551	631	0	80	80	1.0000000
NODE_3009_length_1330_cov_9.026807	604	684	0	80	80	1.0000000
NODE_3011_length_1329_cov_17.036585	691	771	0	80	80	1.0000000
NODE_3011_length_1329_cov_17.036585	744	824	0	80	80	1.0000000
NODE_3011_length_1329_cov_17.036585	820	900	0	80	80	1.0000000
NODE_3011_length_1329_cov_17.036585	873	953	0	80	80	1.0000000
NODE_3012_length_1329_cov_16.341463	428	476	4	2	48	0.0416667
NODE_3012_length_1329_cov_16.341463	428	476	5	10	48	0.2083333
NODE_3012_length_1329_cov_16.341463	428	476	6	5	48	0.1041667
NODE_3012_length_1329_cov_16.341463	428	476	7	2	48	0.0416667
NODE_3012_length_1329_cov_16.341463	428	476	11	5	48	0.1041667
NODE_3012_length_1329_cov_16.341463	428	476	13	4	48	0.0833333
NODE_3012_length_1329_cov_16.341463	428	476	14	1	48	0.0208333
NODE_3012_length_1329_cov_16.341463	428	476	16	2	48	0.0416667
NODE_3012_length_1329_cov_16.341463	428	476	18	2	48	0.0416667
NODE_3012_length_1329_cov_16.341463	428	476	20	1	48	0.0208333
NODE_3012_length_1329_cov_16.341463	428	476	22	3	48	0.0625000
NODE_3012_length_1329_cov_16.341463	428	476	23	1	48	0.0208333
NODE_3012_length_1329_cov_16.341463	428	476	25	1	48	0.0208333
NODE_3012_length_1329_cov_16.341463	428	476	27	1	48	0.0208333
NODE_3012_length_1329_cov_16.341463	428	476	29	2	48	0.0416667
NODE_3012_length_1329_cov_16.341463	428	476	31	6	48	0.1250000
NODE_3013_length_1329_cov_5.620325	888	955	0	42	67	0.6268657
NODE_3013_length_1329_cov_5.620325	888	955	2	4	67	0.0597015
NODE_3013_length_1329_cov_5.620325	888	955	4	21	67	0.3134328
NODE_3013_length_1329_cov_5.620325	941	999	4	22	58	0.3793103
NODE_3013_length_1329_cov_5.620325	941	999	6	36	58	0.6206896
NODE_3017_length_1328_cov_12.954434	794	874	0	80	80	1.0000000
NODE_3017_length_1328_cov_12.954434	847	927	0	80	80	1.0000000
NODE_3018_length_1328_cov_8.810415	762	842	0	80	80	1.0000000
NODE_3018_length_1328_cov_8.810415	815	895	0	80	80	1.0000000
NODE_3021_length_1327_cov_15.938925	260	340	0	41	80	0.5125000
NODE_3021_length_1327_cov_15.938925	260	340	2	39	80	0.4875000
NODE_3021_length_1327_cov_15.938925	313	393	0	2	80	0.0250000
NODE_3021_length_1327_cov_15.938925	313	393	2	78	80	0.9750000
NODE_3022_length_1327_cov_7.274430	159	235	0	76	76	1.0000000
NODE_3022_length_1327_cov_7.274430	774	854	0	80	80	1.0000000
NODE_3022_length_1327_cov_7.274430	827	890	0	63	63	1.0000000
NODE_3023_length_1327_cov_6.486156	896	976	0	80	80	1.0000000
NODE_3023_length_1327_cov_6.486156	949	1029	0	80	80	1.0000000
NODE_3029_length_1326_cov_32.382233	571	651	0	80	80	1.0000000
NODE_3029_length_1326_cov_32.382233	624	704	0	80	80	1.0000000
NODE_3030_length_1326_cov_30.614507	760	840	2	32	80	0.4000000
NODE_3030_length_1326_cov_30.614507	760	840	4	5	80	0.0625000
NODE_3030_length_1326_cov_30.614507	760	840	5	4	80	0.0500000
NODE_3030_length_1326_cov_30.614507	760	840	7	39	80	0.4875000
NODE_3030_length_1326_cov_30.614507	813	893	6	9	80	0.1125000
NODE_3030_length_1326_cov_30.614507	813	893	7	67	80	0.8375000
NODE_3030_length_1326_cov_30.614507	813	893	8	1	80	0.0125000
NODE_3030_length_1326_cov_30.614507	813	893	9	3	80	0.0375000
NODE_3031_length_1326_cov_30.304808	488	568	17	11	80	0.1375000
NODE_3031_length_1326_cov_30.304808	488	568	19	11	80	0.1375000
NODE_3031_length_1326_cov_30.304808	488	568	21	29	80	0.3625000
NODE_3031_length_1326_cov_30.304808	488	568	22	29	80	0.3625000
NODE_3031_length_1326_cov_30.304808	541	621	0	25	80	0.3125000
NODE_3031_length_1326_cov_30.304808	541	621	5	10	80	0.1250000
NODE_3031_length_1326_cov_30.304808	541	621	7	2	80	0.0250000
NODE_3031_length_1326_cov_30.304808	541	621	14	1	80	0.0125000
NODE_3031_length_1326_cov_30.304808	541	621	15	4	80	0.0500000
NODE_3031_length_1326_cov_30.304808	541	621	16	7	80	0.0875000
NODE_3031_length_1326_cov_30.304808	541	621	20	4	80	0.0500000
NODE_3031_length_1326_cov_30.304808	541	621	22	27	80	0.3375000
NODE_3031_length_1326_cov_30.304808	617	697	0	80	80	1.0000000
NODE_3031_length_1326_cov_30.304808	670	750	0	80	80	1.0000000
NODE_3032_length_1326_cov_10.913610	238	318	0	80	80	1.0000000
NODE_3032_length_1326_cov_10.913610	291	371	0	80	80	1.0000000
NODE_3036_length_1325_cov_38.136215	0	46	2	25	46	0.5434783
NODE_3036_length_1325_cov_38.136215	0	46	8	19	46	0.4130435
NODE_3036_length_1325_cov_38.136215	0	46	10	2	46	0.0434783
NODE_3036_length_1325_cov_38.136215	19	99	2	6	80	0.0750000
NODE_3036_length_1325_cov_38.136215	19	99	8	19	80	0.2375000
NODE_3036_length_1325_cov_38.136215	19	99	10	24	80	0.3000000
NODE_3036_length_1325_cov_38.136215	19	99	12	29	80	0.3625000
NODE_3036_length_1325_cov_38.136215	19	99	14	2	80	0.0250000
NODE_3036_length_1325_cov_38.136215	948	1022	6	21	74	0.2837838
NODE_3036_length_1325_cov_38.136215	948	1022	8	32	74	0.4324324
NODE_3036_length_1325_cov_38.136215	948	1022	10	8	74	0.1081081
NODE_3036_length_1325_cov_38.136215	948	1022	12	8	74	0.1081081
NODE_3036_length_1325_cov_38.136215	948	1022	14	1	74	0.0135135
NODE_3036_length_1325_cov_38.136215	948	1022	16	2	74	0.0270270
NODE_3036_length_1325_cov_38.136215	948	1022	18	2	74	0.0270270
NODE_3036_length_1325_cov_38.136215	1001	1063	8	7	62	0.1129032
NODE_3036_length_1325_cov_38.136215	1001	1063	10	1	62	0.0161290
NODE_3036_length_1325_cov_38.136215	1001	1063	12	8	62	0.1290323
NODE_3036_length_1325_cov_38.136215	1001	1063	14	1	62	0.0161290
NODE_3036_length_1325_cov_38.136215	1001	1063	16	2	62	0.0322581
NODE_3036_length_1325_cov_38.136215	1001	1063	18	7	62	0.1129032
NODE_3036_length_1325_cov_38.136215	1001	1063	20	2	62	0.0322581
NODE_3036_length_1325_cov_38.136215	1001	1063	22	3	62	0.0483871
NODE_3036_length_1325_cov_38.136215	1001	1063	23	9	62	0.1451613
NODE_3036_length_1325_cov_38.136215	1001	1063	25	2	62	0.0322581
NODE_3036_length_1325_cov_38.136215	1001	1063	30	1	62	0.0161290
NODE_3036_length_1325_cov_38.136215	1001	1063	36	1	62	0.0161290
NODE_3036_length_1325_cov_38.136215	1001	1063	38	1	62	0.0161290
NODE_3036_length_1325_cov_38.136215	1001	1063	40	3	62	0.0483871
NODE_3036_length_1325_cov_38.136215	1001	1063	41	1	62	0.0161290
NODE_3036_length_1325_cov_38.136215	1001	1063	43	3	62	0.0483871
NODE_3036_length_1325_cov_38.136215	1001	1063	47	6	62	0.0967742
NODE_3036_length_1325_cov_38.136215	1001	1063	48	1	62	0.0161290
NODE_3036_length_1325_cov_38.136215	1001	1063	50	3	62	0.0483871
NODE_3037_length_1325_cov_29.201468	613	693	0	80	80	1.0000000
NODE_3037_length_1325_cov_29.201468	666	746	0	80	80	1.0000000
NODE_3038_length_1325_cov_11.902121	697	777	0	80	80	1.0000000
NODE_3038_length_1325_cov_11.902121	750	830	0	80	80	1.0000000
NODE_3039_length_1325_cov_7.876835	645	725	0	13	80	0.1625000
NODE_3039_length_1325_cov_7.876835	645	725	2	46	80	0.5750000
NODE_3039_length_1325_cov_7.876835	645	725	4	21	80	0.2625000
NODE_3039_length_1325_cov_7.876835	698	778	0	10	80	0.1250000
NODE_3039_length_1325_cov_7.876835	698	778	2	31	80	0.3875000
NODE_3039_length_1325_cov_7.876835	698	778	4	39	80	0.4875000
NODE_3040_length_1325_cov_3.774062	1157	1218	0	4	61	0.0655738
NODE_3040_length_1325_cov_3.774062	1157	1218	2	19	61	0.3114754
NODE_3040_length_1325_cov_3.774062	1157	1218	4	5	61	0.0819672
NODE_3040_length_1325_cov_3.774062	1157	1218	6	10	61	0.1639344
NODE_3040_length_1325_cov_3.774062	1157	1218	10	21	61	0.3442623
NODE_3040_length_1325_cov_3.774062	1157	1218	12	1	61	0.0163934
NODE_3040_length_1325_cov_3.774062	1157	1218	22	1	61	0.0163934
NODE_3040_length_1325_cov_3.774062	1191	1271	6	15	80	0.1875000
NODE_3040_length_1325_cov_3.774062	1191	1271	8	36	80	0.4500000
NODE_3040_length_1325_cov_3.774062	1191	1271	10	29	80	0.3625000
NODE_3041_length_1325_cov_2.896411	0	58	0	28	58	0.4827586
NODE_3041_length_1325_cov_2.896411	0	58	2	4	58	0.0689655
NODE_3041_length_1325_cov_2.896411	0	58	4	7	58	0.1206897
NODE_3041_length_1325_cov_2.896411	0	58	6	19	58	0.3275862
NODE_3041_length_1325_cov_2.896411	8	67	0	20	59	0.3389831
NODE_3041_length_1325_cov_2.896411	8	67	2	4	59	0.0677966
NODE_3041_length_1325_cov_2.896411	8	67	4	7	59	0.1186441
NODE_3041_length_1325_cov_2.896411	8	67	6	28	59	0.4745763
NODE_3046_length_1324_cov_30.340408	939	1019	0	13	80	0.1625000
NODE_3046_length_1324_cov_30.340408	939	1019	1	8	80	0.1000000
NODE_3046_length_1324_cov_30.340408	939	1019	3	11	80	0.1375000
NODE_3046_length_1324_cov_30.340408	939	1019	4	4	80	0.0500000
NODE_3046_length_1324_cov_30.340408	939	1019	5	1	80	0.0125000
NODE_3046_length_1324_cov_30.340408	939	1019	6	11	80	0.1375000
NODE_3046_length_1324_cov_30.340408	939	1019	8	32	80	0.4000000
NODE_3046_length_1324_cov_30.340408	992	1072	0	20	80	0.2500000
NODE_3046_length_1324_cov_30.340408	992	1072	1	8	80	0.1000000
NODE_3046_length_1324_cov_30.340408	992	1072	2	46	80	0.5750000
NODE_3046_length_1324_cov_30.340408	992	1072	3	6	80	0.0750000
NODE_3047_length_1324_cov_7.391020	742	822	0	80	80	1.0000000
NODE_3047_length_1324_cov_7.391020	795	875	0	70	80	0.8750000
NODE_3047_length_1324_cov_7.391020	795	875	2	10	80	0.1250000
NODE_3053_length_1323_cov_30.600490	392	472	0	14	80	0.1750000
NODE_3053_length_1323_cov_30.600490	392	472	2	36	80	0.4500000
NODE_3053_length_1323_cov_30.600490	392	472	4	30	80	0.3750000
NODE_3053_length_1323_cov_30.600490	445	525	0	67	80	0.8375000
NODE_3053_length_1323_cov_30.600490	445	525	2	13	80	0.1625000
NODE_3053_length_1323_cov_30.600490	521	601	0	44	80	0.5500000
NODE_3053_length_1323_cov_30.600490	521	601	3	1	80	0.0125000
NODE_3053_length_1323_cov_30.600490	521	601	4	35	80	0.4375000
NODE_3053_length_1323_cov_30.600490	574	654	0	12	80	0.1500000
NODE_3053_length_1323_cov_30.600490	574	654	4	68	80	0.8500000
NODE_3054_length_1323_cov_20.888889	758	838	6	80	80	1.0000000
NODE_3054_length_1323_cov_20.888889	811	891	0	6	80	0.0750000
NODE_3054_length_1323_cov_20.888889	811	891	6	74	80	0.9250000
NODE_3061_length_1322_cov_8.988553	287	368	0	57	81	0.7037037
NODE_3061_length_1322_cov_8.988553	287	368	2	24	81	0.2962963
NODE_3061_length_1322_cov_8.988553	341	421	0	80	80	1.0000000
NODE_3061_length_1322_cov_8.988553	417	497	0	80	80	1.0000000
NODE_3061_length_1322_cov_8.988553	470	550	0	80	80	1.0000000
NODE_3068_length_1321_cov_57.885434	359	439	1	27	80	0.3375000
NODE_3068_length_1321_cov_57.885434	359	439	2	53	80	0.6625000
NODE_3068_length_1321_cov_57.885434	412	492	0	12	80	0.1500000
NODE_3068_length_1321_cov_57.885434	412	492	1	68	80	0.8500000
NODE_3068_length_1321_cov_57.885434	488	568	0	52	80	0.6500000
NODE_3068_length_1321_cov_57.885434	488	568	2	27	80	0.3375000
NODE_3068_length_1321_cov_57.885434	488	568	4	1	80	0.0125000
NODE_3068_length_1321_cov_57.885434	541	621	2	39	80	0.4875000
NODE_3068_length_1321_cov_57.885434	541	621	4	41	80	0.5125000
NODE_3071_length_1320_cov_70.753481	432	512	2	7	80	0.0875000
NODE_3071_length_1320_cov_70.753481	432	512	4	17	80	0.2125000
NODE_3071_length_1320_cov_70.753481	432	512	6	40	80	0.5000000
NODE_3071_length_1320_cov_70.753481	432	512	8	16	80	0.2000000
NODE_3071_length_1320_cov_70.753481	485	565	0	14	80	0.1750000
NODE_3071_length_1320_cov_70.753481	485	565	4	22	80	0.2750000
NODE_3071_length_1320_cov_70.753481	485	565	6	44	80	0.5500000
NODE_3071_length_1320_cov_70.753481	561	641	0	23	80	0.2875000
NODE_3071_length_1320_cov_70.753481	561	641	2	57	80	0.7125000
NODE_3071_length_1320_cov_70.753481	614	694	2	80	80	1.0000000
NODE_3072_length_1320_cov_39.149058	715	795	2	20	80	0.2500000
NODE_3072_length_1320_cov_39.149058	715	795	6	60	80	0.7500000
NODE_3072_length_1320_cov_39.149058	768	848	0	52	80	0.6500000
NODE_3072_length_1320_cov_39.149058	768	848	2	21	80	0.2625000
NODE_3072_length_1320_cov_39.149058	768	848	6	7	80	0.0875000
NODE_3072_length_1320_cov_39.149058	844	924	0	13	80	0.1625000
NODE_3072_length_1320_cov_39.149058	844	924	2	1	80	0.0125000
NODE_3072_length_1320_cov_39.149058	844	924	4	27	80	0.3375000
NODE_3072_length_1320_cov_39.149058	844	924	8	22	80	0.2750000
NODE_3072_length_1320_cov_39.149058	844	924	12	17	80	0.2125000
NODE_3072_length_1320_cov_39.149058	897	977	4	21	80	0.2625000
NODE_3072_length_1320_cov_39.149058	897	977	8	10	80	0.1250000
NODE_3072_length_1320_cov_39.149058	897	977	10	13	80	0.1625000
NODE_3072_length_1320_cov_39.149058	897	977	12	36	80	0.4500000
NODE_3073_length_1320_cov_19.175266	707	783	6	33	76	0.4342105
NODE_3073_length_1320_cov_19.175266	707	783	8	43	76	0.5657895
NODE_3073_length_1320_cov_19.175266	760	840	0	27	80	0.3375000
NODE_3073_length_1320_cov_19.175266	760	840	2	17	80	0.2125000
NODE_3073_length_1320_cov_19.175266	760	840	6	15	80	0.1875000
NODE_3073_length_1320_cov_19.175266	760	840	8	21	80	0.2625000
NODE_3074_length_1320_cov_11.224406	860	940	2	44	80	0.5500000
NODE_3074_length_1320_cov_11.224406	860	940	10	36	80	0.4500000
NODE_3074_length_1320_cov_11.224406	913	993	8	50	80	0.6250000
NODE_3074_length_1320_cov_11.224406	913	993	10	30	80	0.3750000
NODE_3075_length_1320_cov_11.036036	760	840	0	80	80	1.0000000
NODE_3075_length_1320_cov_11.036036	813	893	0	80	80	1.0000000
NODE_3076_length_1320_cov_8.357084	800	880	0	65	80	0.8125000
NODE_3076_length_1320_cov_8.357084	800	880	2	15	80	0.1875000
NODE_3076_length_1320_cov_8.357084	853	933	0	12	80	0.1500000
NODE_3076_length_1320_cov_8.357084	853	933	2	68	80	0.8500000
NODE_3080_length_1319_cov_27.098361	630	710	2	2	80	0.0250000
NODE_3080_length_1319_cov_27.098361	630	710	4	3	80	0.0375000
NODE_3080_length_1319_cov_27.098361	630	710	9	15	80	0.1875000
NODE_3080_length_1319_cov_27.098361	630	710	10	15	80	0.1875000
NODE_3080_length_1319_cov_27.098361	630	710	11	7	80	0.0875000
NODE_3080_length_1319_cov_27.098361	630	710	12	38	80	0.4750000
NODE_3080_length_1319_cov_27.098361	683	763	2	20	80	0.2500000
NODE_3080_length_1319_cov_27.098361	683	763	4	11	80	0.1375000
NODE_3080_length_1319_cov_27.098361	683	763	10	30	80	0.3750000
NODE_3080_length_1319_cov_27.098361	683	763	12	19	80	0.2375000
NODE_3081_length_1319_cov_22.992623	490	570	0	80	80	1.0000000
NODE_3081_length_1319_cov_22.992623	543	623	0	80	80	1.0000000
NODE_3086_length_1318_cov_13.624282	642	722	0	80	80	1.0000000
NODE_3086_length_1318_cov_13.624282	695	775	0	80	80	1.0000000
NODE_3086_length_1318_cov_13.624282	771	851	0	80	80	1.0000000
NODE_3086_length_1318_cov_13.624282	824	904	0	80	80	1.0000000
NODE_3089_length_1317_cov_162.041872	66	143	14	1	77	0.0129870
NODE_3089_length_1317_cov_162.041872	66	143	16	5	77	0.0649351
NODE_3089_length_1317_cov_162.041872	66	143	18	1	77	0.0129870
NODE_3089_length_1317_cov_162.041872	66	143	22	6	77	0.0779221
NODE_3089_length_1317_cov_162.041872	66	143	26	10	77	0.1298701
NODE_3089_length_1317_cov_162.041872	66	143	28	32	77	0.4155844
NODE_3089_length_1317_cov_162.041872	66	143	30	3	77	0.0389610
NODE_3089_length_1317_cov_162.041872	66	143	32	16	77	0.2077922
NODE_3089_length_1317_cov_162.041872	66	143	130	1	77	0.0129870
NODE_3089_length_1317_cov_162.041872	66	143	158	1	77	0.0129870
NODE_3089_length_1317_cov_162.041872	66	143	175	1	77	0.0129870
NODE_3090_length_1317_cov_19.736453	675	755	0	80	80	1.0000000
NODE_3090_length_1317_cov_19.736453	728	808	0	80	80	1.0000000
NODE_3090_length_1317_cov_19.736453	804	884	0	24	80	0.3000000
NODE_3090_length_1317_cov_19.736453	804	884	2	56	80	0.7000000
NODE_3090_length_1317_cov_19.736453	857	937	2	80	80	1.0000000
NODE_3092_length_1317_cov_2.203612	779	859	4	26	80	0.3250000
NODE_3092_length_1317_cov_2.203612	779	859	6	28	80	0.3500000
NODE_3092_length_1317_cov_2.203612	779	859	8	20	80	0.2500000
NODE_3092_length_1317_cov_2.203612	779	859	10	6	80	0.0750000
NODE_3095_length_1316_cov_25.377157	557	637	2	13	80	0.1625000
NODE_3095_length_1316_cov_25.377157	557	637	3	2	80	0.0250000
NODE_3095_length_1316_cov_25.377157	557	637	7	1	80	0.0125000
NODE_3095_length_1316_cov_25.377157	557	637	8	64	80	0.8000000
NODE_3095_length_1316_cov_25.377157	610	690	6	7	80	0.0875000
NODE_3095_length_1316_cov_25.377157	610	690	7	32	80	0.4000000
NODE_3095_length_1316_cov_25.377157	610	690	8	41	80	0.5125000
NODE_3096_length_1316_cov_15.891537	446	526	2	80	80	1.0000000
NODE_3096_length_1316_cov_15.891537	499	579	0	45	80	0.5625000
NODE_3096_length_1316_cov_15.891537	499	579	2	35	80	0.4375000
NODE_3096_length_1316_cov_15.891537	575	655	0	7	80	0.0875000
NODE_3096_length_1316_cov_15.891537	575	655	2	49	80	0.6125000
NODE_3096_length_1316_cov_15.891537	575	655	4	15	80	0.1875000
NODE_3096_length_1316_cov_15.891537	575	655	6	9	80	0.1125000
NODE_3096_length_1316_cov_15.891537	628	708	2	3	80	0.0375000
NODE_3096_length_1316_cov_15.891537	628	708	4	15	80	0.1875000
NODE_3096_length_1316_cov_15.891537	628	708	6	25	80	0.3125000
NODE_3096_length_1316_cov_15.891537	628	708	8	37	80	0.4625000
NODE_3101_length_1315_cov_24.136513	592	672	2	35	80	0.4375000
NODE_3101_length_1315_cov_24.136513	592	672	4	45	80	0.5625000
NODE_3101_length_1315_cov_24.136513	645	725	0	27	80	0.3375000
NODE_3101_length_1315_cov_24.136513	645	725	2	25	80	0.3125000
NODE_3101_length_1315_cov_24.136513	645	725	4	28	80	0.3500000
NODE_3105_length_1314_cov_38.391770	647	727	0	10	80	0.1250000
NODE_3105_length_1314_cov_38.391770	647	727	2	70	80	0.8750000
NODE_3105_length_1314_cov_38.391770	700	780	0	63	80	0.7875000
NODE_3105_length_1314_cov_38.391770	700	780	2	17	80	0.2125000
NODE_3105_length_1314_cov_38.391770	776	856	0	48	80	0.6000000
NODE_3105_length_1314_cov_38.391770	776	856	2	5	80	0.0625000
NODE_3105_length_1314_cov_38.391770	776	856	4	2	80	0.0250000
NODE_3105_length_1314_cov_38.391770	776	856	6	25	80	0.3125000
NODE_3105_length_1314_cov_38.391770	829	909	4	3	80	0.0375000
NODE_3105_length_1314_cov_38.391770	829	909	6	77	80	0.9625000
NODE_3106_length_1314_cov_30.167078	736	816	0	28	80	0.3500000
NODE_3106_length_1314_cov_30.167078	736	816	2	19	80	0.2375000
NODE_3106_length_1314_cov_30.167078	736	816	4	33	80	0.4125000
NODE_3106_length_1314_cov_30.167078	789	869	2	26	80	0.3250000
NODE_3106_length_1314_cov_30.167078	789	869	4	54	80	0.6750000
NODE_3107_length_1314_cov_11.221399	523	603	4	6	80	0.0750000
NODE_3107_length_1314_cov_11.221399	523	603	6	16	80	0.2000000
NODE_3107_length_1314_cov_11.221399	523	603	8	58	80	0.7250000
NODE_3107_length_1314_cov_11.221399	576	656	2	11	80	0.1375000
NODE_3107_length_1314_cov_11.221399	576	656	4	3	80	0.0375000
NODE_3107_length_1314_cov_11.221399	576	656	6	47	80	0.5875000
NODE_3107_length_1314_cov_11.221399	576	656	8	19	80	0.2375000
NODE_3114_length_1313_cov_29.315486	463	543	0	29	80	0.3625000
NODE_3114_length_1313_cov_29.315486	463	543	4	15	80	0.1875000
NODE_3114_length_1313_cov_29.315486	463	543	8	7	80	0.0875000
NODE_3114_length_1313_cov_29.315486	463	543	10	29	80	0.3625000
NODE_3114_length_1313_cov_29.315486	516	596	6	13	80	0.1625000
NODE_3114_length_1313_cov_29.315486	516	596	9	1	80	0.0125000
NODE_3114_length_1313_cov_29.315486	516	596	10	66	80	0.8250000
NODE_3115_length_1313_cov_25.144975	709	789	0	42	80	0.5250000
NODE_3115_length_1313_cov_25.144975	709	789	2	38	80	0.4750000
NODE_3115_length_1313_cov_25.144975	762	842	0	80	80	1.0000000
NODE_3115_length_1313_cov_25.144975	838	918	0	80	80	1.0000000
NODE_3115_length_1313_cov_25.144975	891	971	0	80	80	1.0000000
NODE_3118_length_1312_cov_20.378401	138	218	0	80	80	1.0000000
NODE_3118_length_1312_cov_20.378401	191	271	0	33	80	0.4125000
NODE_3118_length_1312_cov_20.378401	191	271	2	9	80	0.1125000
NODE_3118_length_1312_cov_20.378401	191	271	4	38	80	0.4750000
NODE_3121_length_1311_cov_38.468647	584	664	0	41	80	0.5125000
NODE_3121_length_1311_cov_38.468647	584	664	1	14	80	0.1750000
NODE_3121_length_1311_cov_38.468647	584	664	2	25	80	0.3125000
NODE_3121_length_1311_cov_38.468647	637	717	1	2	80	0.0250000
NODE_3121_length_1311_cov_38.468647	637	717	2	78	80	0.9750000
NODE_3121_length_1311_cov_38.468647	713	793	2	20	80	0.2500000
NODE_3121_length_1311_cov_38.468647	713	793	3	14	80	0.1750000
NODE_3121_length_1311_cov_38.468647	713	793	4	46	80	0.5750000
NODE_3121_length_1311_cov_38.468647	766	846	0	19	80	0.2375000
NODE_3121_length_1311_cov_38.468647	766	846	2	38	80	0.4750000
NODE_3121_length_1311_cov_38.468647	766	846	3	14	80	0.1750000
NODE_3121_length_1311_cov_38.468647	766	846	4	9	80	0.1125000
NODE_3125_length_1310_cov_37.739884	679	759	2	26	80	0.3250000
NODE_3125_length_1310_cov_37.739884	679	759	6	9	80	0.1125000
NODE_3125_length_1310_cov_37.739884	679	759	10	45	80	0.5625000
NODE_3125_length_1310_cov_37.739884	683	763	2	22	80	0.2750000
NODE_3125_length_1310_cov_37.739884	683	763	6	9	80	0.1125000
NODE_3125_length_1310_cov_37.739884	683	763	10	49	80	0.6125000
NODE_3125_length_1310_cov_37.739884	732	816	6	24	84	0.2857143
NODE_3125_length_1310_cov_37.739884	732	816	10	54	84	0.6428571
NODE_3125_length_1310_cov_37.739884	732	816	12	6	84	0.0714286
NODE_3125_length_1310_cov_37.739884	736	816	6	24	80	0.3000000
NODE_3125_length_1310_cov_37.739884	736	816	10	50	80	0.6250000
NODE_3125_length_1310_cov_37.739884	736	816	12	6	80	0.0750000
NODE_3125_length_1310_cov_37.739884	812	892	4	22	80	0.2750000
NODE_3125_length_1310_cov_37.739884	812	892	6	46	80	0.5750000
NODE_3125_length_1310_cov_37.739884	812	892	9	1	80	0.0125000
NODE_3125_length_1310_cov_37.739884	812	892	10	11	80	0.1375000
NODE_3125_length_1310_cov_37.739884	865	945	4	16	80	0.2000000
NODE_3125_length_1310_cov_37.739884	865	945	6	32	80	0.4000000
NODE_3125_length_1310_cov_37.739884	865	945	8	32	80	0.4000000
NODE_3126_length_1310_cov_12.245252	615	695	0	80	80	1.0000000
NODE_3126_length_1310_cov_12.245252	668	748	0	80	80	1.0000000
NODE_3127_length_1310_cov_10.184971	422	502	0	15	80	0.1875000
NODE_3127_length_1310_cov_10.184971	422	502	1	9	80	0.1125000
NODE_3127_length_1310_cov_10.184971	422	502	3	35	80	0.4375000
NODE_3127_length_1310_cov_10.184971	422	502	5	8	80	0.1000000
NODE_3127_length_1310_cov_10.184971	422	502	9	13	80	0.1625000
NODE_3127_length_1310_cov_10.184971	475	555	3	6	80	0.0750000
NODE_3127_length_1310_cov_10.184971	475	555	5	8	80	0.1000000
NODE_3127_length_1310_cov_10.184971	475	555	9	51	80	0.6375000
NODE_3127_length_1310_cov_10.184971	475	555	11	15	80	0.1875000
NODE_3128_length_1310_cov_3.186623	876	956	0	80	80	1.0000000
NODE_3128_length_1310_cov_3.186623	929	1009	0	80	80	1.0000000
NODE_3131_length_1310_cov_0.757225	1255	1310	0	4	55	0.0727273
NODE_3131_length_1310_cov_0.757225	1255	1310	2	5	55	0.0909091
NODE_3131_length_1310_cov_0.757225	1255	1310	4	21	55	0.3818182
NODE_3131_length_1310_cov_0.757225	1255	1310	6	4	55	0.0727273
NODE_3131_length_1310_cov_0.757225	1255	1310	7	1	55	0.0181818
NODE_3131_length_1310_cov_0.757225	1255	1310	8	10	55	0.1818182
NODE_3131_length_1310_cov_0.757225	1255	1310	10	10	55	0.1818182
NODE_3132_length_1309_cov_34.942149	474	554	0	80	80	1.0000000
NODE_3132_length_1309_cov_34.942149	527	607	0	80	80	1.0000000
NODE_3132_length_1309_cov_34.942149	603	683	0	80	80	1.0000000
NODE_3132_length_1309_cov_34.942149	656	736	0	80	80	1.0000000
NODE_3133_length_1309_cov_10.571074	839	921	0	82	82	1.0000000
NODE_3133_length_1309_cov_10.571074	894	974	0	80	80	1.0000000
NODE_3135_length_1308_cov_43.461538	330	410	0	77	80	0.9625000
NODE_3135_length_1308_cov_43.461538	330	410	2	3	80	0.0375000
NODE_3135_length_1308_cov_43.461538	383	463	0	24	80	0.3000000
NODE_3135_length_1308_cov_43.461538	383	463	2	17	80	0.2125000
NODE_3135_length_1308_cov_43.461538	383	463	4	39	80	0.4875000
NODE_3145_length_1307_cov_11.290563	595	673	0	23	78	0.2948718
NODE_3145_length_1307_cov_11.290563	595	673	2	55	78	0.7051282
NODE_3145_length_1307_cov_11.290563	646	726	0	76	80	0.9500000
NODE_3145_length_1307_cov_11.290563	646	726	2	4	80	0.0500000
NODE_3146_length_1307_cov_8.653146	430	510	0	80	80	1.0000000
NODE_3146_length_1307_cov_8.653146	483	563	0	80	80	1.0000000
NODE_3153_length_1306_cov_26.813587	369	449	0	43	80	0.5375000
NODE_3153_length_1306_cov_26.813587	369	449	2	4	80	0.0500000
NODE_3153_length_1306_cov_26.813587	369	449	4	33	80	0.4125000
NODE_3153_length_1306_cov_26.813587	422	502	0	80	80	1.0000000
NODE_3153_length_1306_cov_26.813587	498	578	0	80	80	1.0000000
NODE_3153_length_1306_cov_26.813587	551	631	0	80	80	1.0000000
NODE_3154_length_1306_cov_24.904722	634	714	0	80	80	1.0000000
NODE_3154_length_1306_cov_24.904722	687	767	0	80	80	1.0000000
NODE_3155_length_1306_cov_18.274234	388	468	4	42	80	0.5250000
NODE_3155_length_1306_cov_18.274234	388	468	5	12	80	0.1500000
NODE_3155_length_1306_cov_18.274234	388	468	6	26	80	0.3250000
NODE_3155_length_1306_cov_18.274234	441	521	4	35	80	0.4375000
NODE_3155_length_1306_cov_18.274234	441	521	6	45	80	0.5625000
NODE_3156_length_1306_cov_15.176471	1214	1294	0	41	80	0.5125000
NODE_3156_length_1306_cov_15.176471	1214	1294	2	9	80	0.1125000
NODE_3156_length_1306_cov_15.176471	1214	1294	3	30	80	0.3750000
NODE_3157_length_1306_cov_12.699254	458	538	0	80	80	1.0000000
NODE_3157_length_1306_cov_12.699254	511	591	0	80	80	1.0000000
NODE_3158_length_1306_cov_9.958575	630	710	0	80	80	1.0000000
NODE_3158_length_1306_cov_9.958575	683	764	0	81	81	1.0000000
NODE_3159_length_1306_cov_2.739851	1206	1246	0	40	40	1.0000000
NODE_3168_length_1304_cov_28.444813	511	591	0	1	80	0.0125000
NODE_3168_length_1304_cov_28.444813	511	591	4	19	80	0.2375000
NODE_3168_length_1304_cov_28.444813	511	591	6	5	80	0.0625000
NODE_3168_length_1304_cov_28.444813	511	591	8	55	80	0.6875000
NODE_3168_length_1304_cov_28.444813	564	644	5	2	80	0.0250000
NODE_3168_length_1304_cov_28.444813	564	644	6	1	80	0.0125000
NODE_3168_length_1304_cov_28.444813	564	644	7	8	80	0.1000000
NODE_3168_length_1304_cov_28.444813	564	644	8	69	80	0.8625000
NODE_3168_length_1304_cov_28.444813	640	720	1	10	80	0.1250000
NODE_3168_length_1304_cov_28.444813	640	720	3	18	80	0.2250000
NODE_3168_length_1304_cov_28.444813	640	720	5	13	80	0.1625000
NODE_3168_length_1304_cov_28.444813	640	720	7	12	80	0.1500000
NODE_3168_length_1304_cov_28.444813	640	720	9	26	80	0.3250000
NODE_3168_length_1304_cov_28.444813	640	720	11	1	80	0.0125000
NODE_3168_length_1304_cov_28.444813	693	773	9	38	80	0.4750000
NODE_3168_length_1304_cov_28.444813	693	773	11	42	80	0.5250000
NODE_3169_length_1304_cov_27.137759	575	655	0	14	80	0.1750000
NODE_3169_length_1304_cov_27.137759	575	655	2	66	80	0.8250000
NODE_3169_length_1304_cov_27.137759	628	708	0	67	80	0.8375000
NODE_3169_length_1304_cov_27.137759	628	708	2	13	80	0.1625000
NODE_3169_length_1304_cov_27.137759	704	784	0	4	80	0.0500000
NODE_3169_length_1304_cov_27.137759	704	784	2	17	80	0.2125000
NODE_3169_length_1304_cov_27.137759	704	784	8	9	80	0.1125000
NODE_3169_length_1304_cov_27.137759	704	784	10	50	80	0.6250000
NODE_3169_length_1304_cov_27.137759	757	837	2	3	80	0.0375000
NODE_3169_length_1304_cov_27.137759	757	837	8	8	80	0.1000000
NODE_3169_length_1304_cov_27.137759	757	837	10	36	80	0.4500000
NODE_3169_length_1304_cov_27.137759	757	837	12	33	80	0.4125000
NODE_3171_length_1303_cov_36.546512	458	538	0	30	80	0.3750000
NODE_3171_length_1303_cov_36.546512	458	538	2	20	80	0.2500000
NODE_3171_length_1303_cov_36.546512	458	538	4	3	80	0.0375000
NODE_3171_length_1303_cov_36.546512	458	538	6	11	80	0.1375000
NODE_3171_length_1303_cov_36.546512	458	538	7	16	80	0.2000000
NODE_3171_length_1303_cov_36.546512	511	591	6	11	80	0.1375000
NODE_3171_length_1303_cov_36.546512	511	591	7	26	80	0.3250000
NODE_3171_length_1303_cov_36.546512	511	591	8	39	80	0.4875000
NODE_3171_length_1303_cov_36.546512	511	591	10	4	80	0.0500000
NODE_3171_length_1303_cov_36.546512	587	667	2	8	80	0.1000000
NODE_3171_length_1303_cov_36.546512	587	667	4	36	80	0.4500000
NODE_3171_length_1303_cov_36.546512	587	667	6	27	80	0.3375000
NODE_3171_length_1303_cov_36.546512	587	667	8	9	80	0.1125000
NODE_3171_length_1303_cov_36.546512	640	720	0	21	80	0.2625000
NODE_3171_length_1303_cov_36.546512	640	720	1	26	80	0.3250000
NODE_3171_length_1303_cov_36.546512	640	720	2	14	80	0.1750000
NODE_3171_length_1303_cov_36.546512	640	720	4	19	80	0.2375000
NODE_3174_length_1302_cov_22.265170	747	827	0	80	80	1.0000000
NODE_3174_length_1302_cov_22.265170	800	880	0	80	80	1.0000000
NODE_3175_length_1302_cov_16.199501	480	560	0	80	80	1.0000000
NODE_3175_length_1302_cov_16.199501	533	613	0	80	80	1.0000000
NODE_3176_length_1302_cov_6.953450	687	767	0	30	80	0.3750000
NODE_3176_length_1302_cov_6.953450	687	767	3	23	80	0.2875000
NODE_3176_length_1302_cov_6.953450	687	767	7	4	80	0.0500000
NODE_3176_length_1302_cov_6.953450	687	767	9	13	80	0.1625000
NODE_3176_length_1302_cov_6.953450	687	767	11	6	80	0.0750000
NODE_3176_length_1302_cov_6.953450	687	767	13	4	80	0.0500000
NODE_3176_length_1302_cov_6.953450	740	820	7	4	80	0.0500000
NODE_3176_length_1302_cov_6.953450	740	820	9	13	80	0.1625000
NODE_3176_length_1302_cov_6.953450	740	820	11	6	80	0.0750000
NODE_3176_length_1302_cov_6.953450	740	820	13	5	80	0.0625000
NODE_3176_length_1302_cov_6.953450	740	820	15	3	80	0.0375000
NODE_3176_length_1302_cov_6.953450	740	820	16	1	80	0.0125000
NODE_3176_length_1302_cov_6.953450	740	820	18	48	80	0.6000000
NODE_3179_length_1301_cov_31.711314	401	481	4	54	80	0.6750000
NODE_3179_length_1301_cov_31.711314	401	481	6	7	80	0.0875000
NODE_3179_length_1301_cov_31.711314	401	481	8	19	80	0.2375000
NODE_3179_length_1301_cov_31.711314	454	534	0	2	80	0.0250000
NODE_3179_length_1301_cov_31.711314	454	534	4	78	80	0.9750000
NODE_3181_length_1301_cov_5.529950	246	326	0	12	80	0.1500000
NODE_3181_length_1301_cov_5.529950	246	326	2	68	80	0.8500000
NODE_3181_length_1301_cov_5.529950	299	379	2	59	80	0.7375000
NODE_3181_length_1301_cov_5.529950	299	379	4	21	80	0.2625000
NODE_3186_length_1300_cov_39.109908	602	682	0	17	80	0.2125000
NODE_3186_length_1300_cov_39.109908	602	682	2	7	80	0.0875000
NODE_3186_length_1300_cov_39.109908	602	682	4	10	80	0.1250000
NODE_3186_length_1300_cov_39.109908	602	682	6	16	80	0.2000000
NODE_3186_length_1300_cov_39.109908	602	682	8	4	80	0.0500000
NODE_3186_length_1300_cov_39.109908	602	682	10	26	80	0.3250000
NODE_3186_length_1300_cov_39.109908	655	735	4	15	80	0.1875000
NODE_3186_length_1300_cov_39.109908	655	735	6	5	80	0.0625000
NODE_3186_length_1300_cov_39.109908	655	735	8	2	80	0.0250000
NODE_3186_length_1300_cov_39.109908	655	735	10	58	80	0.7250000
NODE_3187_length_1300_cov_34.360533	586	666	0	4	80	0.0500000
NODE_3187_length_1300_cov_34.360533	586	666	2	11	80	0.1375000
NODE_3187_length_1300_cov_34.360533	586	666	4	40	80	0.5000000
NODE_3187_length_1300_cov_34.360533	586	666	6	20	80	0.2500000
NODE_3187_length_1300_cov_34.360533	586	666	8	5	80	0.0625000
NODE_3187_length_1300_cov_34.360533	639	719	2	7	80	0.0875000
NODE_3187_length_1300_cov_34.360533	639	719	4	25	80	0.3125000
NODE_3187_length_1300_cov_34.360533	639	719	6	43	80	0.5375000
NODE_3187_length_1300_cov_34.360533	639	719	8	5	80	0.0625000
NODE_3188_length_1300_cov_4.659450	454	535	4	2	81	0.0246914
NODE_3188_length_1300_cov_4.659450	454	535	12	79	81	0.9753087
NODE_3188_length_1300_cov_4.659450	508	588	7	6	80	0.0750000
NODE_3188_length_1300_cov_4.659450	508	588	8	20	80	0.2500000
NODE_3188_length_1300_cov_4.659450	508	588	9	3	80	0.0375000
NODE_3188_length_1300_cov_4.659450	508	588	10	24	80	0.3000000
NODE_3188_length_1300_cov_4.659450	508	588	12	27	80	0.3375000
NODE_3189_length_1299_cov_29.071667	452	532	0	80	80	1.0000000
NODE_3190_length_1299_cov_23.600833	818	898	4	15	80	0.1875000
NODE_3190_length_1299_cov_23.600833	818	898	8	65	80	0.8125000
NODE_3190_length_1299_cov_23.600833	871	951	0	28	80	0.3500000
NODE_3190_length_1299_cov_23.600833	871	951	2	3	80	0.0375000
NODE_3190_length_1299_cov_23.600833	871	951	4	8	80	0.1000000
NODE_3190_length_1299_cov_23.600833	871	951	8	41	80	0.5125000
NODE_3191_length_1299_cov_23.169167	625	705	0	80	80	1.0000000
NODE_3191_length_1299_cov_23.169167	678	758	0	80	80	1.0000000
NODE_3191_length_1299_cov_23.169167	754	834	0	80	80	1.0000000
NODE_3191_length_1299_cov_23.169167	807	887	0	80	80	1.0000000
NODE_3192_length_1299_cov_19.315000	306	386	0	36	80	0.4500000
NODE_3192_length_1299_cov_19.315000	306	386	4	44	80	0.5500000
NODE_3192_length_1299_cov_19.315000	359	439	0	80	80	1.0000000
NODE_3192_length_1299_cov_19.315000	435	515	0	80	80	1.0000000
NODE_3192_length_1299_cov_19.315000	488	568	0	80	80	1.0000000
NODE_3193_length_1299_cov_13.691667	540	620	0	31	80	0.3875000
NODE_3193_length_1299_cov_13.691667	540	620	4	49	80	0.6125000
NODE_3193_length_1299_cov_13.691667	593	673	4	80	80	1.0000000
NODE_3195_length_1298_cov_58.277731	679	759	4	38	80	0.4750000
NODE_3195_length_1298_cov_58.277731	679	759	6	42	80	0.5250000
NODE_3195_length_1298_cov_58.277731	732	812	0	7	80	0.0875000
NODE_3195_length_1298_cov_58.277731	732	812	2	35	80	0.4375000
NODE_3195_length_1298_cov_58.277731	732	812	4	38	80	0.4750000
NODE_3195_length_1298_cov_58.277731	808	888	2	80	80	1.0000000
NODE_3195_length_1298_cov_58.277731	861	941	0	28	80	0.3500000
NODE_3195_length_1298_cov_58.277731	861	941	2	52	80	0.6500000
NODE_3196_length_1298_cov_31.319433	375	455	0	69	80	0.8625000
NODE_3196_length_1298_cov_31.319433	375	455	1	11	80	0.1375000
NODE_3196_length_1298_cov_31.319433	428	508	0	16	80	0.2000000
NODE_3196_length_1298_cov_31.319433	428	508	1	16	80	0.2000000
NODE_3196_length_1298_cov_31.319433	428	508	2	48	80	0.6000000
NODE_3196_length_1298_cov_31.319433	504	584	2	80	80	1.0000000
NODE_3196_length_1298_cov_31.319433	557	637	0	27	80	0.3375000
NODE_3196_length_1298_cov_31.319433	557	637	1	17	80	0.2125000
NODE_3196_length_1298_cov_31.319433	557	637	2	36	80	0.4500000
NODE_3197_length_1298_cov_2.158465	294	360	0	66	66	1.0000000
NODE_3201_length_1296_cov_34.778613	620	700	6	49	80	0.6125000
NODE_3201_length_1296_cov_34.778613	620	700	8	31	80	0.3875000
NODE_3201_length_1296_cov_34.778613	673	753	0	16	80	0.2000000
NODE_3201_length_1296_cov_34.778613	673	753	2	11	80	0.1375000
NODE_3201_length_1296_cov_34.778613	673	753	8	53	80	0.6625000
NODE_3202_length_1296_cov_28.726817	671	751	0	80	80	1.0000000
NODE_3202_length_1296_cov_28.726817	724	804	0	55	80	0.6875000
NODE_3202_length_1296_cov_28.726817	724	804	2	25	80	0.3125000
NODE_3202_length_1296_cov_28.726817	800	880	0	1	80	0.0125000
NODE_3202_length_1296_cov_28.726817	800	880	2	79	80	0.9875000
NODE_3202_length_1296_cov_28.726817	853	933	0	54	80	0.6750000
NODE_3202_length_1296_cov_28.726817	853	933	2	26	80	0.3250000
NODE_3205_length_1295_cov_10.661371	818	898	0	12	80	0.1500000
NODE_3205_length_1295_cov_10.661371	818	898	2	68	80	0.8500000
NODE_3205_length_1295_cov_10.661371	871	951	0	62	80	0.7750000
NODE_3205_length_1295_cov_10.661371	871	951	2	18	80	0.2250000
NODE_3211_length_1294_cov_15.098745	353	433	0	49	80	0.6125000
NODE_3211_length_1294_cov_15.098745	353	433	6	31	80	0.3875000
NODE_3211_length_1294_cov_15.098745	406	486	6	80	80	1.0000000
NODE_3216_length_1293_cov_26.580402	595	675	0	5	80	0.0625000
NODE_3216_length_1293_cov_26.580402	595	675	2	75	80	0.9375000
NODE_3216_length_1293_cov_26.580402	648	728	0	58	80	0.7250000
NODE_3216_length_1293_cov_26.580402	648	728	2	22	80	0.2750000
NODE_3216_length_1293_cov_26.580402	724	804	0	80	80	1.0000000
NODE_3216_length_1293_cov_26.580402	777	857	0	80	80	1.0000000
NODE_3217_length_1293_cov_9.252094	1187	1207	2	20	20	1.0000000
NODE_3220_length_1293_cov_2.118090	1131	1195	2	13	64	0.2031250
NODE_3220_length_1293_cov_2.118090	1131	1195	4	51	64	0.7968750
NODE_3220_length_1293_cov_2.118090	1184	1248	2	46	64	0.7187500
NODE_3220_length_1293_cov_2.118090	1184	1248	4	18	64	0.2812500
NODE_3224_length_1292_cov_50.158424	402	482	5	10	80	0.1250000
NODE_3224_length_1292_cov_50.158424	402	482	6	7	80	0.0875000
NODE_3224_length_1292_cov_50.158424	402	482	7	9	80	0.1125000
NODE_3224_length_1292_cov_50.158424	402	482	8	9	80	0.1125000
NODE_3224_length_1292_cov_50.158424	402	482	12	44	80	0.5500000
NODE_3224_length_1292_cov_50.158424	402	482	14	1	80	0.0125000
NODE_3224_length_1292_cov_50.158424	455	535	0	9	80	0.1125000
NODE_3224_length_1292_cov_50.158424	455	535	2	3	80	0.0375000
NODE_3224_length_1292_cov_50.158424	455	535	4	35	80	0.4375000
NODE_3224_length_1292_cov_50.158424	455	535	5	16	80	0.2000000
NODE_3224_length_1292_cov_50.158424	455	535	7	9	80	0.1125000
NODE_3224_length_1292_cov_50.158424	455	535	8	8	80	0.1000000
NODE_3224_length_1292_cov_50.158424	531	611	0	30	80	0.3750000
NODE_3224_length_1292_cov_50.158424	531	611	4	50	80	0.6250000
NODE_3224_length_1292_cov_50.158424	584	664	0	1	80	0.0125000
NODE_3224_length_1292_cov_50.158424	584	664	4	79	80	0.9875000
NODE_3225_length_1292_cov_36.535624	670	750	1	8	80	0.1000000
NODE_3225_length_1292_cov_36.535624	670	750	3	13	80	0.1625000
NODE_3225_length_1292_cov_36.535624	670	750	4	12	80	0.1500000
NODE_3225_length_1292_cov_36.535624	670	750	8	6	80	0.0750000
NODE_3225_length_1292_cov_36.535624	670	750	12	41	80	0.5125000
NODE_3225_length_1292_cov_36.535624	723	803	3	4	80	0.0500000
NODE_3225_length_1292_cov_36.535624	723	803	4	3	80	0.0375000
NODE_3225_length_1292_cov_36.535624	723	803	8	14	80	0.1750000
NODE_3225_length_1292_cov_36.535624	723	803	10	9	80	0.1125000
NODE_3225_length_1292_cov_36.535624	723	803	12	50	80	0.6250000
NODE_3226_length_1292_cov_24.523889	420	500	2	16	80	0.2000000
NODE_3226_length_1292_cov_24.523889	420	500	6	62	80	0.7750000
NODE_3226_length_1292_cov_24.523889	420	500	8	2	80	0.0250000
NODE_3226_length_1292_cov_24.523889	473	553	0	16	80	0.2000000
NODE_3226_length_1292_cov_24.523889	473	553	2	53	80	0.6625000
NODE_3226_length_1292_cov_24.523889	473	553	6	11	80	0.1375000
NODE_3232_length_1291_cov_8.734060	623	703	0	80	80	1.0000000
NODE_3232_length_1291_cov_8.734060	676	756	0	80	80	1.0000000
NODE_3233_length_1291_cov_8.625839	756	836	0	80	80	1.0000000
NODE_3233_length_1291_cov_8.625839	809	889	0	80	80	1.0000000
NODE_3236_length_1290_cov_24.120067	497	577	0	36	80	0.4500000
NODE_3236_length_1290_cov_24.120067	497	577	2	5	80	0.0625000
NODE_3236_length_1290_cov_24.120067	497	577	4	33	80	0.4125000
NODE_3236_length_1290_cov_24.120067	497	577	6	6	80	0.0750000
NODE_3236_length_1290_cov_24.120067	550	630	4	36	80	0.4500000
NODE_3236_length_1290_cov_24.120067	550	630	6	44	80	0.5500000
NODE_3236_length_1290_cov_24.120067	626	706	4	76	80	0.9500000
NODE_3236_length_1290_cov_24.120067	626	706	6	4	80	0.0500000
NODE_3236_length_1290_cov_24.120067	679	759	0	10	80	0.1250000
NODE_3236_length_1290_cov_24.120067	679	759	2	26	80	0.3250000
NODE_3236_length_1290_cov_24.120067	679	759	4	44	80	0.5500000
NODE_3237_length_1290_cov_18.874895	671	751	0	26	80	0.3250000
NODE_3237_length_1290_cov_18.874895	671	751	2	54	80	0.6750000
NODE_3237_length_1290_cov_18.874895	724	804	2	80	80	1.0000000
NODE_3238_length_1290_cov_11.627204	573	653	0	53	80	0.6625000
NODE_3238_length_1290_cov_11.627204	573	653	2	27	80	0.3375000
NODE_3238_length_1290_cov_11.627204	626	706	2	80	80	1.0000000
NODE_3239_length_1290_cov_11.215785	373	453	0	42	80	0.5250000
NODE_3239_length_1290_cov_11.215785	373	453	2	24	80	0.3000000
NODE_3239_length_1290_cov_11.215785	373	453	8	14	80	0.1750000
NODE_3239_length_1290_cov_11.215785	426	506	2	13	80	0.1625000
NODE_3239_length_1290_cov_11.215785	426	506	8	47	80	0.5875000
NODE_3239_length_1290_cov_11.215785	426	506	10	19	80	0.2375000
NODE_3239_length_1290_cov_11.215785	426	506	12	1	80	0.0125000
NODE_3240_length_1290_cov_8.752309	788	868	0	18	80	0.2250000
NODE_3240_length_1290_cov_8.752309	788	868	2	62	80	0.7750000
NODE_3240_length_1290_cov_8.752309	841	921	0	37	80	0.4625000
NODE_3240_length_1290_cov_8.752309	841	921	2	43	80	0.5375000
NODE_3242_length_1289_cov_47.476471	919	999	0	1	80	0.0125000
NODE_3242_length_1289_cov_47.476471	919	999	3	8	80	0.1000000
NODE_3242_length_1289_cov_47.476471	919	999	4	1	80	0.0125000
NODE_3242_length_1289_cov_47.476471	919	999	5	12	80	0.1500000
NODE_3242_length_1289_cov_47.476471	919	999	6	14	80	0.1750000
NODE_3242_length_1289_cov_47.476471	919	999	7	18	80	0.2250000
NODE_3242_length_1289_cov_47.476471	919	999	8	26	80	0.3250000
NODE_3242_length_1289_cov_47.476471	972	1052	0	54	80	0.6750000
NODE_3242_length_1289_cov_47.476471	972	1052	4	1	80	0.0125000
NODE_3242_length_1289_cov_47.476471	972	1052	6	14	80	0.1750000
NODE_3242_length_1289_cov_47.476471	972	1052	7	1	80	0.0125000
NODE_3242_length_1289_cov_47.476471	972	1052	8	10	80	0.1250000
NODE_3243_length_1289_cov_18.497479	688	768	0	3	80	0.0375000
NODE_3243_length_1289_cov_18.497479	688	768	6	77	80	0.9625000
NODE_3243_length_1289_cov_18.497479	741	821	0	56	80	0.7000000
NODE_3243_length_1289_cov_18.497479	741	821	6	24	80	0.3000000
NODE_3243_length_1289_cov_18.497479	817	893	0	76	76	1.0000000
NODE_3243_length_1289_cov_18.497479	878	958	0	80	80	1.0000000
NODE_3244_length_1289_cov_11.692437	574	654	0	80	80	1.0000000
NODE_3244_length_1289_cov_11.692437	627	707	0	80	80	1.0000000
NODE_3244_length_1289_cov_11.692437	703	783	0	80	80	1.0000000
NODE_3244_length_1289_cov_11.692437	756	836	0	80	80	1.0000000
NODE_3249_length_1288_cov_29.369218	711	791	2	20	80	0.2500000
NODE_3249_length_1288_cov_29.369218	711	791	6	19	80	0.2375000
NODE_3249_length_1288_cov_29.369218	711	791	7	18	80	0.2250000
NODE_3249_length_1288_cov_29.369218	711	791	8	23	80	0.2875000
NODE_3249_length_1288_cov_29.369218	764	844	6	58	80	0.7250000
NODE_3249_length_1288_cov_29.369218	764	844	8	22	80	0.2750000
NODE_3250_length_1288_cov_6.207738	735	815	0	34	80	0.4250000
NODE_3250_length_1288_cov_6.207738	735	815	2	6	80	0.0750000
NODE_3250_length_1288_cov_6.207738	735	815	4	40	80	0.5000000
NODE_3250_length_1288_cov_6.207738	788	868	2	15	80	0.1875000
NODE_3250_length_1288_cov_6.207738	788	868	4	65	80	0.8125000
NODE_3255_length_1288_cov_1.731707	1017	1095	0	11	78	0.1410256
NODE_3255_length_1288_cov_1.731707	1017	1095	2	62	78	0.7948718
NODE_3255_length_1288_cov_1.731707	1017	1095	4	1	78	0.0128205
NODE_3255_length_1288_cov_1.731707	1017	1095	6	4	78	0.0512821
NODE_3261_length_1287_cov_29.186027	730	810	0	18	80	0.2250000
NODE_3261_length_1287_cov_29.186027	730	810	2	62	80	0.7750000
NODE_3261_length_1287_cov_29.186027	783	863	0	1	80	0.0125000
NODE_3261_length_1287_cov_29.186027	783	863	2	79	80	0.9875000
NODE_3262_length_1287_cov_22.747475	168	248	0	80	80	1.0000000
NODE_3262_length_1287_cov_22.747475	221	301	0	80	80	1.0000000
NODE_3263_length_1287_cov_19.478956	575	655	0	54	80	0.6750000
NODE_3263_length_1287_cov_19.478956	575	655	2	26	80	0.3250000
NODE_3263_length_1287_cov_19.478956	628	708	0	44	80	0.5500000
NODE_3263_length_1287_cov_19.478956	628	708	2	36	80	0.4500000
NODE_3266_length_1286_cov_27.128054	428	508	2	80	80	1.0000000
NODE_3266_length_1286_cov_27.128054	481	561	2	34	80	0.4250000
NODE_3266_length_1286_cov_27.128054	481	561	4	29	80	0.3625000
NODE_3266_length_1286_cov_27.128054	481	561	6	17	80	0.2125000
NODE_3266_length_1286_cov_27.128054	557	637	0	2	80	0.0250000
NODE_3266_length_1286_cov_27.128054	557	637	2	8	80	0.1000000
NODE_3266_length_1286_cov_27.128054	557	637	4	53	80	0.6625000
NODE_3266_length_1286_cov_27.128054	557	637	9	2	80	0.0250000
NODE_3266_length_1286_cov_27.128054	557	637	10	15	80	0.1875000
NODE_3266_length_1286_cov_27.128054	610	690	4	10	80	0.1250000
NODE_3266_length_1286_cov_27.128054	610	690	6	5	80	0.0625000
NODE_3266_length_1286_cov_27.128054	610	690	8	4	80	0.0500000
NODE_3266_length_1286_cov_27.128054	610	690	9	2	80	0.0250000
NODE_3266_length_1286_cov_27.128054	610	690	10	59	80	0.7375000
NODE_3267_length_1286_cov_12.192081	647	727	0	80	80	1.0000000
NODE_3267_length_1286_cov_12.192081	700	780	0	80	80	1.0000000
NODE_3267_length_1286_cov_12.192081	776	856	0	65	80	0.8125000
NODE_3267_length_1286_cov_12.192081	776	856	2	15	80	0.1875000
NODE_3267_length_1286_cov_12.192081	829	909	0	12	80	0.1500000
NODE_3267_length_1286_cov_12.192081	829	909	2	32	80	0.4000000
NODE_3267_length_1286_cov_12.192081	829	909	3	23	80	0.2875000
NODE_3267_length_1286_cov_12.192081	829	909	4	13	80	0.1625000
NODE_3268_length_1286_cov_8.338669	577	657	0	80	80	1.0000000
NODE_3268_length_1286_cov_8.338669	630	710	0	80	80	1.0000000
NODE_3273_length_1285_cov_40.282462	751	831	0	80	80	1.0000000
NODE_3273_length_1285_cov_40.282462	804	884	0	80	80	1.0000000
NODE_3274_length_1285_cov_15.422428	647	727	0	48	80	0.6000000
NODE_3274_length_1285_cov_15.422428	647	727	2	32	80	0.4000000
NODE_3274_length_1285_cov_15.422428	700	780	2	55	80	0.6875000
NODE_3274_length_1285_cov_15.422428	700	780	4	8	80	0.1000000
NODE_3274_length_1285_cov_15.422428	700	780	6	17	80	0.2125000
NODE_3275_length_1285_cov_6.620573	589	669	0	80	80	1.0000000
NODE_3275_length_1285_cov_6.620573	642	722	0	80	80	1.0000000
NODE_3279_length_1284_cov_5.637975	294	374	0	80	80	1.0000000
NODE_3279_length_1284_cov_5.637975	347	427	0	80	80	1.0000000
NODE_3283_length_1283_cov_10.070101	408	488	0	5	80	0.0625000
NODE_3283_length_1283_cov_10.070101	408	488	2	32	80	0.4000000
NODE_3283_length_1283_cov_10.070101	408	488	4	43	80	0.5375000
NODE_3283_length_1283_cov_10.070101	461	541	2	51	80	0.6375000
NODE_3283_length_1283_cov_10.070101	461	541	4	29	80	0.3625000
NODE_3288_length_1282_cov_37.786137	649	729	6	65	80	0.8125000
NODE_3288_length_1282_cov_37.786137	649	729	8	15	80	0.1875000
NODE_3288_length_1282_cov_37.786137	702	782	0	33	80	0.4125000
NODE_3288_length_1282_cov_37.786137	702	782	4	1	80	0.0125000
NODE_3288_length_1282_cov_37.786137	702	782	6	46	80	0.5750000
NODE_3288_length_1282_cov_37.786137	778	858	0	15	80	0.1875000
NODE_3288_length_1282_cov_37.786137	778	858	2	4	80	0.0500000
NODE_3288_length_1282_cov_37.786137	778	858	7	19	80	0.2375000
NODE_3288_length_1282_cov_37.786137	778	858	9	15	80	0.1875000
NODE_3288_length_1282_cov_37.786137	778	858	11	9	80	0.1125000
NODE_3288_length_1282_cov_37.786137	778	858	13	7	80	0.0875000
NODE_3288_length_1282_cov_37.786137	778	858	14	2	80	0.0250000
NODE_3288_length_1282_cov_37.786137	778	858	16	9	80	0.1125000
NODE_3288_length_1282_cov_37.786137	831	911	11	9	80	0.1125000
NODE_3288_length_1282_cov_37.786137	831	911	13	8	80	0.1000000
NODE_3288_length_1282_cov_37.786137	831	911	14	2	80	0.0250000
NODE_3288_length_1282_cov_37.786137	831	911	15	39	80	0.4875000
NODE_3288_length_1282_cov_37.786137	831	911	16	22	80	0.2750000
NODE_3289_length_1282_cov_25.900254	85	167	4	4	82	0.0487805
NODE_3289_length_1282_cov_25.900254	85	167	8	2	82	0.0243902
NODE_3289_length_1282_cov_25.900254	85	167	12	3	82	0.0365854
NODE_3289_length_1282_cov_25.900254	85	167	16	13	82	0.1585366
NODE_3289_length_1282_cov_25.900254	85	167	20	2	82	0.0243902
NODE_3289_length_1282_cov_25.900254	85	167	21	1	82	0.0121951
NODE_3289_length_1282_cov_25.900254	85	167	22	1	82	0.0121951
NODE_3289_length_1282_cov_25.900254	85	167	24	7	82	0.0853659
NODE_3289_length_1282_cov_25.900254	85	167	26	2	82	0.0243902
NODE_3289_length_1282_cov_25.900254	85	167	34	1	82	0.0121951
NODE_3289_length_1282_cov_25.900254	85	167	38	1	82	0.0121951
NODE_3289_length_1282_cov_25.900254	85	167	40	3	82	0.0365854
NODE_3289_length_1282_cov_25.900254	85	167	42	2	82	0.0243902
NODE_3289_length_1282_cov_25.900254	85	167	44	7	82	0.0853659
NODE_3289_length_1282_cov_25.900254	85	167	46	12	82	0.1463415
NODE_3289_length_1282_cov_25.900254	85	167	50	3	82	0.0365854
NODE_3289_length_1282_cov_25.900254	85	167	52	18	82	0.2195122
NODE_3289_length_1282_cov_25.900254	140	183	2	3	43	0.0697674
NODE_3289_length_1282_cov_25.900254	140	183	4	17	43	0.3953488
NODE_3289_length_1282_cov_25.900254	140	183	8	2	43	0.0465116
NODE_3289_length_1282_cov_25.900254	140	183	12	3	43	0.0697674
NODE_3289_length_1282_cov_25.900254	140	183	16	13	43	0.3023256
NODE_3289_length_1282_cov_25.900254	140	183	20	2	43	0.0465116
NODE_3289_length_1282_cov_25.900254	140	183	21	1	43	0.0232558
NODE_3289_length_1282_cov_25.900254	140	183	22	1	43	0.0232558
NODE_3289_length_1282_cov_25.900254	140	183	24	1	43	0.0232558
NODE_3289_length_1282_cov_25.900254	1006	1086	1	10	80	0.1250000
NODE_3289_length_1282_cov_25.900254	1006	1086	5	16	80	0.2000000
NODE_3289_length_1282_cov_25.900254	1006	1086	7	1	80	0.0125000
NODE_3289_length_1282_cov_25.900254	1006	1086	9	44	80	0.5500000
NODE_3289_length_1282_cov_25.900254	1006	1086	10	9	80	0.1125000
NODE_3289_length_1282_cov_25.900254	1006	1086	1	10	80	0.1250000
NODE_3289_length_1282_cov_25.900254	1006	1086	5	16	80	0.2000000
NODE_3289_length_1282_cov_25.900254	1006	1086	7	1	80	0.0125000
NODE_3289_length_1282_cov_25.900254	1006	1086	9	44	80	0.5500000
NODE_3289_length_1282_cov_25.900254	1006	1086	10	9	80	0.1125000
NODE_3289_length_1282_cov_25.900254	1015	1086	1	10	71	0.1408451
NODE_3289_length_1282_cov_25.900254	1015	1086	5	16	71	0.2253521
NODE_3289_length_1282_cov_25.900254	1015	1086	7	1	71	0.0140845
NODE_3289_length_1282_cov_25.900254	1015	1086	9	35	71	0.4929577
NODE_3289_length_1282_cov_25.900254	1015	1086	10	9	71	0.1267606
NODE_3290_length_1282_cov_14.600169	429	477	2	48	48	1.0000000
NODE_3290_length_1282_cov_14.600169	708	788	0	36	80	0.4500000
NODE_3290_length_1282_cov_14.600169	708	788	2	44	80	0.5500000
NODE_3291_length_1282_cov_8.017751	343	420	2	67	77	0.8701299
NODE_3291_length_1282_cov_8.017751	343	420	4	10	77	0.1298701
NODE_3292_length_1282_cov_5.092984	239	319	0	13	80	0.1625000
NODE_3292_length_1282_cov_5.092984	239	319	2	67	80	0.8375000
NODE_3292_length_1282_cov_5.092984	292	372	0	66	80	0.8250000
NODE_3292_length_1282_cov_5.092984	292	372	2	14	80	0.1750000
NODE_3295_length_1281_cov_31.342640	470	550	1	1	80	0.0125000
NODE_3295_length_1281_cov_31.342640	470	550	2	56	80	0.7000000
NODE_3295_length_1281_cov_31.342640	470	550	3	1	80	0.0125000
NODE_3295_length_1281_cov_31.342640	470	550	4	22	80	0.2750000
NODE_3295_length_1281_cov_31.342640	523	603	0	44	80	0.5500000
NODE_3295_length_1281_cov_31.342640	523	603	1	10	80	0.1250000
NODE_3295_length_1281_cov_31.342640	523	603	2	26	80	0.3250000
NODE_3295_length_1281_cov_31.342640	599	679	0	80	80	1.0000000
NODE_3295_length_1281_cov_31.342640	652	732	0	80	80	1.0000000
NODE_3296_length_1281_cov_25.482234	474	554	0	9	80	0.1125000
NODE_3296_length_1281_cov_25.482234	474	554	4	33	80	0.4125000
NODE_3296_length_1281_cov_25.482234	474	554	6	4	80	0.0500000
NODE_3296_length_1281_cov_25.482234	474	554	8	34	80	0.4250000
NODE_3296_length_1281_cov_25.482234	527	607	0	6	80	0.0750000
NODE_3296_length_1281_cov_25.482234	527	607	2	1	80	0.0125000
NODE_3296_length_1281_cov_25.482234	527	607	4	45	80	0.5625000
NODE_3296_length_1281_cov_25.482234	527	607	8	28	80	0.3500000
NODE_3297_length_1281_cov_14.617597	809	887	2	78	78	1.0000000
NODE_3297_length_1281_cov_14.617597	860	940	0	43	80	0.5375000
NODE_3297_length_1281_cov_14.617597	860	940	2	37	80	0.4625000
NODE_3298_length_1281_cov_12.065144	655	735	0	43	80	0.5375000
NODE_3298_length_1281_cov_12.065144	655	735	2	6	80	0.0750000
NODE_3298_length_1281_cov_12.065144	655	735	4	14	80	0.1750000
NODE_3298_length_1281_cov_12.065144	655	735	6	17	80	0.2125000
NODE_3298_length_1281_cov_12.065144	708	788	4	22	80	0.2750000
NODE_3298_length_1281_cov_12.065144	708	788	6	58	80	0.7250000
NODE_3299_length_1281_cov_9.235195	408	488	0	10	80	0.1250000
NODE_3299_length_1281_cov_9.235195	408	488	2	70	80	0.8750000
NODE_3299_length_1281_cov_9.235195	461	541	0	39	80	0.4875000
NODE_3299_length_1281_cov_9.235195	461	541	2	41	80	0.5125000
NODE_3300_length_1281_cov_7.153976	469	549	2	51	80	0.6375000
NODE_3300_length_1281_cov_7.153976	469	549	3	29	80	0.3625000
NODE_3300_length_1281_cov_7.153976	522	602	1	19	80	0.2375000
NODE_3300_length_1281_cov_7.153976	522	602	2	15	80	0.1875000
NODE_3300_length_1281_cov_7.153976	522	602	3	46	80	0.5750000
NODE_3307_length_1280_cov_24.231160	418	498	0	42	80	0.5250000
NODE_3307_length_1280_cov_24.231160	418	498	2	38	80	0.4750000
NODE_3307_length_1280_cov_24.231160	471	551	0	5	80	0.0625000
NODE_3307_length_1280_cov_24.231160	471	551	2	75	80	0.9375000
NODE_3307_length_1280_cov_24.231160	547	627	0	68	80	0.8500000
NODE_3307_length_1280_cov_24.231160	547	627	2	12	80	0.1500000
NODE_3307_length_1280_cov_24.231160	600	680	0	15	80	0.1875000
NODE_3307_length_1280_cov_24.231160	600	680	2	65	80	0.8125000
NODE_3308_length_1280_cov_5.908552	1077	1138	12	1	61	0.0163934
NODE_3308_length_1280_cov_5.908552	1077	1138	31	2	61	0.0327869
NODE_3308_length_1280_cov_5.908552	1077	1138	32	3	61	0.0491803
NODE_3308_length_1280_cov_5.908552	1077	1138	34	1	61	0.0163934
NODE_3308_length_1280_cov_5.908552	1077	1138	41	3	61	0.0491803
NODE_3308_length_1280_cov_5.908552	1077	1138	47	1	61	0.0163934
NODE_3308_length_1280_cov_5.908552	1077	1138	49	1	61	0.0163934
NODE_3308_length_1280_cov_5.908552	1077	1138	61	1	61	0.0163934
NODE_3308_length_1280_cov_5.908552	1077	1138	63	1	61	0.0163934
NODE_3308_length_1280_cov_5.908552	1077	1138	66	1	61	0.0163934
NODE_3308_length_1280_cov_5.908552	1077	1138	78	1	61	0.0163934
NODE_3308_length_1280_cov_5.908552	1077	1138	88	2	61	0.0327869
NODE_3308_length_1280_cov_5.908552	1077	1138	90	4	61	0.0655738
NODE_3308_length_1280_cov_5.908552	1077	1138	92	8	61	0.1311475
NODE_3308_length_1280_cov_5.908552	1077	1138	94	1	61	0.0163934
NODE_3308_length_1280_cov_5.908552	1077	1138	98	1	61	0.0163934
NODE_3308_length_1280_cov_5.908552	1077	1138	100	2	61	0.0327869
NODE_3308_length_1280_cov_5.908552	1077	1138	102	1	61	0.0163934
NODE_3308_length_1280_cov_5.908552	1077	1138	106	1	61	0.0163934
NODE_3308_length_1280_cov_5.908552	1077	1138	116	1	61	0.0163934
NODE_3308_length_1280_cov_5.908552	1077	1138	118	1	61	0.0163934
NODE_3308_length_1280_cov_5.908552	1077	1138	122	2	61	0.0327869
NODE_3308_length_1280_cov_5.908552	1077	1138	128	1	61	0.0163934
NODE_3308_length_1280_cov_5.908552	1077	1138	134	2	61	0.0327869
NODE_3308_length_1280_cov_5.908552	1077	1138	137	1	61	0.0163934
NODE_3308_length_1280_cov_5.908552	1077	1138	140	1	61	0.0163934
NODE_3308_length_1280_cov_5.908552	1077	1138	142	6	61	0.0983607
NODE_3308_length_1280_cov_5.908552	1077	1138	144	1	61	0.0163934
NODE_3308_length_1280_cov_5.908552	1077	1138	146	1	61	0.0163934
NODE_3308_length_1280_cov_5.908552	1077	1138	152	1	61	0.0163934
NODE_3308_length_1280_cov_5.908552	1077	1138	156	2	61	0.0327869
NODE_3308_length_1280_cov_5.908552	1077	1138	158	1	61	0.0163934
NODE_3308_length_1280_cov_5.908552	1077	1138	159	2	61	0.0327869
NODE_3308_length_1280_cov_5.908552	1077	1138	161	2	61	0.0327869
NODE_3311_length_1279_cov_16.840678	749	829	4	6	80	0.0750000
NODE_3311_length_1279_cov_16.840678	749	829	5	46	80	0.5750000
NODE_3311_length_1279_cov_16.840678	749	829	6	28	80	0.3500000
NODE_3311_length_1279_cov_16.840678	802	882	1	45	80	0.5625000
NODE_3311_length_1279_cov_16.840678	802	882	3	3	80	0.0375000
NODE_3311_length_1279_cov_16.840678	802	882	5	32	80	0.4000000
NODE_3312_length_1279_cov_3.772881	951	981	0	4	30	0.1333333
NODE_3312_length_1279_cov_3.772881	951	981	4	26	30	0.8666667
NODE_3317_length_1278_cov_45.991518	411	491	0	80	80	1.0000000
NODE_3317_length_1278_cov_45.991518	464	530	0	66	66	1.0000000
NODE_3318_length_1278_cov_37.164546	447	527	0	80	80	1.0000000
NODE_3318_length_1278_cov_37.164546	500	580	0	43	80	0.5375000
NODE_3318_length_1278_cov_37.164546	500	580	2	28	80	0.3500000
NODE_3318_length_1278_cov_37.164546	500	580	4	9	80	0.1125000
NODE_3318_length_1278_cov_37.164546	576	656	4	30	80	0.3750000
NODE_3318_length_1278_cov_37.164546	576	656	6	14	80	0.1750000
NODE_3318_length_1278_cov_37.164546	576	656	8	2	80	0.0250000
NODE_3318_length_1278_cov_37.164546	576	656	10	34	80	0.4250000
NODE_3318_length_1278_cov_37.164546	629	709	6	55	80	0.6875000
NODE_3318_length_1278_cov_37.164546	629	709	8	2	80	0.0250000
NODE_3318_length_1278_cov_37.164546	629	709	10	23	80	0.2875000
NODE_3319_length_1278_cov_12.505513	522	602	0	23	80	0.2875000
NODE_3319_length_1278_cov_12.505513	522	602	2	57	80	0.7125000
NODE_3319_length_1278_cov_12.505513	575	655	0	14	80	0.1750000
NODE_3319_length_1278_cov_12.505513	575	655	1	1	80	0.0125000
NODE_3319_length_1278_cov_12.505513	575	655	2	65	80	0.8125000
NODE_3320_length_1278_cov_12.171332	212	292	0	21	80	0.2625000
NODE_3320_length_1278_cov_12.171332	212	292	2	5	80	0.0625000
NODE_3320_length_1278_cov_12.171332	212	292	4	42	80	0.5250000
NODE_3320_length_1278_cov_12.171332	212	292	6	12	80	0.1500000
NODE_3320_length_1278_cov_12.171332	265	344	4	42	79	0.5316456
NODE_3320_length_1278_cov_12.171332	265	344	6	37	79	0.4683544
NODE_3329_length_1277_cov_21.407470	667	717	0	50	50	1.0000000
NODE_3329_length_1277_cov_21.407470	690	770	0	80	80	1.0000000
NODE_3330_length_1277_cov_18.111205	834	914	1	80	80	1.0000000
NODE_3330_length_1277_cov_18.111205	887	967	0	26	80	0.3250000
NODE_3330_length_1277_cov_18.111205	887	967	1	54	80	0.6750000
NODE_3331_length_1277_cov_12.449066	276	356	0	80	80	1.0000000
NODE_3331_length_1277_cov_12.449066	329	409	0	61	80	0.7625000
NODE_3331_length_1277_cov_12.449066	329	409	2	19	80	0.2375000
NODE_3331_length_1277_cov_12.449066	405	485	2	80	80	1.0000000
NODE_3331_length_1277_cov_12.449066	458	538	0	6	80	0.0750000
NODE_3331_length_1277_cov_12.449066	458	538	2	74	80	0.9250000
NODE_3337_length_1276_cov_21.446899	526	606	0	80	80	1.0000000
NODE_3337_length_1276_cov_21.446899	579	659	0	80	80	1.0000000
NODE_3337_length_1276_cov_21.446899	655	735	0	80	80	1.0000000
NODE_3337_length_1276_cov_21.446899	708	788	0	80	80	1.0000000
NODE_3346_length_1275_cov_35.471939	632	712	2	68	80	0.8500000
NODE_3346_length_1275_cov_35.471939	632	712	4	8	80	0.1000000
NODE_3346_length_1275_cov_35.471939	632	712	6	4	80	0.0500000
NODE_3346_length_1275_cov_35.471939	685	765	2	15	80	0.1875000
NODE_3346_length_1275_cov_35.471939	685	765	4	33	80	0.4125000
NODE_3346_length_1275_cov_35.471939	685	765	6	32	80	0.4000000
NODE_3347_length_1275_cov_19.910714	361	441	0	80	80	1.0000000
NODE_3347_length_1275_cov_19.910714	414	494	0	80	80	1.0000000
NODE_3347_length_1275_cov_19.910714	879	949	12	8	70	0.1142857
NODE_3347_length_1275_cov_19.910714	879	949	14	30	70	0.4285714
NODE_3347_length_1275_cov_19.910714	879	949	16	32	70	0.4571429
NODE_3351_length_1274_cov_23.404255	427	507	0	59	80	0.7375000
NODE_3351_length_1274_cov_23.404255	427	507	2	21	80	0.2625000
NODE_3351_length_1274_cov_23.404255	480	560	0	64	80	0.8000000
NODE_3351_length_1274_cov_23.404255	480	560	2	16	80	0.2000000
NODE_3351_length_1274_cov_23.404255	556	636	0	22	80	0.2750000
NODE_3351_length_1274_cov_23.404255	556	636	2	58	80	0.7250000
NODE_3351_length_1274_cov_23.404255	609	689	0	75	80	0.9375000
NODE_3351_length_1274_cov_23.404255	609	689	2	5	80	0.0625000
NODE_3352_length_1274_cov_20.178723	545	625	4	51	80	0.6375000
NODE_3352_length_1274_cov_20.178723	545	625	6	29	80	0.3625000
NODE_3352_length_1274_cov_20.178723	598	678	2	30	80	0.3750000
NODE_3352_length_1274_cov_20.178723	598	678	4	17	80	0.2125000
NODE_3352_length_1274_cov_20.178723	598	678	6	33	80	0.4125000
NODE_3354_length_1274_cov_2.019574	841	907	0	32	66	0.4848485
NODE_3354_length_1274_cov_2.019574	841	907	2	20	66	0.3030303
NODE_3354_length_1274_cov_2.019574	841	907	4	14	66	0.2121212
NODE_3354_length_1274_cov_2.019574	894	961	4	15	67	0.2238806
NODE_3354_length_1274_cov_2.019574	894	961	6	52	67	0.7761194
NODE_3361_length_1273_cov_42.349233	337	417	0	80	80	1.0000000
NODE_3361_length_1273_cov_42.349233	390	470	0	70	80	0.8750000
NODE_3361_length_1273_cov_42.349233	390	470	8	8	80	0.1000000
NODE_3361_length_1273_cov_42.349233	390	470	10	2	80	0.0250000
NODE_3361_length_1273_cov_42.349233	466	546	8	2	80	0.0250000
NODE_3361_length_1273_cov_42.349233	466	546	10	13	80	0.1625000
NODE_3361_length_1273_cov_42.349233	466	546	12	11	80	0.1375000
NODE_3361_length_1273_cov_42.349233	466	546	14	54	80	0.6750000
NODE_3361_length_1273_cov_42.349233	519	599	0	3	80	0.0375000
NODE_3361_length_1273_cov_42.349233	519	599	2	3	80	0.0375000
NODE_3361_length_1273_cov_42.349233	519	599	4	8	80	0.1000000
NODE_3361_length_1273_cov_42.349233	519	599	6	6	80	0.0750000
NODE_3361_length_1273_cov_42.349233	519	599	14	60	80	0.7500000
NODE_3364_length_1273_cov_4.404600	407	487	0	80	80	1.0000000
NODE_3364_length_1273_cov_4.404600	460	540	0	80	80	1.0000000
NODE_3368_length_1272_cov_28.887468	588	668	0	3	80	0.0375000
NODE_3368_length_1272_cov_28.887468	588	668	2	52	80	0.6500000
NODE_3368_length_1272_cov_28.887468	588	668	4	11	80	0.1375000
NODE_3368_length_1272_cov_28.887468	588	668	8	14	80	0.1750000
NODE_3368_length_1272_cov_28.887468	641	721	2	2	80	0.0250000
NODE_3368_length_1272_cov_28.887468	641	721	4	11	80	0.1375000
NODE_3368_length_1272_cov_28.887468	641	721	8	39	80	0.4875000
NODE_3368_length_1272_cov_28.887468	641	721	10	10	80	0.1250000
NODE_3368_length_1272_cov_28.887468	641	721	12	18	80	0.2250000
NODE_3369_length_1272_cov_11.290708	366	447	10	13	81	0.1604938
NODE_3369_length_1272_cov_11.290708	366	447	12	5	81	0.0617284
NODE_3369_length_1272_cov_11.290708	366	447	13	6	81	0.0740741
NODE_3369_length_1272_cov_11.290708	366	447	14	21	81	0.2592593
NODE_3369_length_1272_cov_11.290708	366	447	16	17	81	0.2098765
NODE_3369_length_1272_cov_11.290708	366	447	18	6	81	0.0740741
NODE_3369_length_1272_cov_11.290708	366	447	20	13	81	0.1604938
NODE_3375_length_1270_cov_13.617421	365	445	0	80	80	1.0000000
NODE_3375_length_1270_cov_13.617421	396	473	0	77	77	1.0000000
NODE_3375_length_1270_cov_13.617421	418	498	0	80	80	1.0000000
NODE_3375_length_1270_cov_13.617421	449	473	0	24	24	1.0000000
NODE_3375_length_1270_cov_13.617421	465	498	0	33	33	1.0000000
NODE_3376_length_1270_cov_11.645602	294	374	0	30	80	0.3750000
NODE_3376_length_1270_cov_11.645602	294	374	4	50	80	0.6250000
NODE_3376_length_1270_cov_11.645602	347	427	4	80	80	1.0000000
NODE_3377_length_1270_cov_2.495303	74	131	8	3	57	0.0526316
NODE_3377_length_1270_cov_2.495303	74	131	10	2	57	0.0350877
NODE_3377_length_1270_cov_2.495303	74	131	12	4	57	0.0701754
NODE_3377_length_1270_cov_2.495303	74	131	14	48	57	0.8421053
NODE_3378_length_1269_cov_55.070940	492	569	0	77	77	1.0000000
NODE_3378_length_1269_cov_55.070940	545	625	0	80	80	1.0000000
NODE_3378_length_1269_cov_55.070940	621	701	0	31	80	0.3875000
NODE_3378_length_1269_cov_55.070940	621	701	2	29	80	0.3625000
NODE_3378_length_1269_cov_55.070940	621	701	4	20	80	0.2500000
NODE_3378_length_1269_cov_55.070940	674	754	2	7	80	0.0875000
NODE_3378_length_1269_cov_55.070940	674	754	4	73	80	0.9125000
NODE_3379_length_1269_cov_22.154701	1152	1216	6	64	64	1.0000000
NODE_3379_length_1269_cov_22.154701	1152	1216	6	64	64	1.0000000
NODE_3379_length_1269_cov_22.154701	1152	1216	6	64	64	1.0000000
NODE_3379_length_1269_cov_22.154701	1189	1269	2	11	80	0.1375000
NODE_3379_length_1269_cov_22.154701	1189	1269	4	1	80	0.0125000
NODE_3379_length_1269_cov_22.154701	1189	1269	6	68	80	0.8500000
NODE_3379_length_1269_cov_22.154701	1189	1269	2	11	80	0.1375000
NODE_3379_length_1269_cov_22.154701	1189	1269	4	1	80	0.0125000
NODE_3379_length_1269_cov_22.154701	1189	1269	6	68	80	0.8500000
NODE_3380_length_1269_cov_18.753846	317	398	2	7	81	0.0864198
NODE_3380_length_1269_cov_18.753846	317	398	6	2	81	0.0246914
NODE_3380_length_1269_cov_18.753846	317	398	8	6	81	0.0740741
NODE_3380_length_1269_cov_18.753846	317	398	11	1	81	0.0123457
NODE_3380_length_1269_cov_18.753846	317	398	12	58	81	0.7160494
NODE_3380_length_1269_cov_18.753846	317	398	18	7	81	0.0864198
NODE_3381_length_1269_cov_12.637607	580	660	0	19	80	0.2375000
NODE_3381_length_1269_cov_12.637607	580	660	2	61	80	0.7625000
NODE_3381_length_1269_cov_12.637607	633	713	2	80	80	1.0000000
NODE_3381_length_1269_cov_12.637607	709	729	2	20	20	1.0000000
NODE_3381_length_1269_cov_12.637607	709	789	0	48	80	0.6000000
NODE_3381_length_1269_cov_12.637607	709	789	2	32	80	0.4000000
NODE_3381_length_1269_cov_12.637607	762	842	0	80	80	1.0000000
NODE_3382_length_1269_cov_10.552137	765	845	0	80	80	1.0000000
NODE_3382_length_1269_cov_10.552137	818	898	0	80	80	1.0000000
NODE_3391_length_1268_cov_12.862275	300	350	20	4	50	0.0800000
NODE_3391_length_1268_cov_12.862275	300	350	22	4	50	0.0800000
NODE_3391_length_1268_cov_12.862275	300	350	24	9	50	0.1800000
NODE_3391_length_1268_cov_12.862275	300	350	26	10	50	0.2000000
NODE_3391_length_1268_cov_12.862275	300	350	28	1	50	0.0200000
NODE_3391_length_1268_cov_12.862275	300	350	30	1	50	0.0200000
NODE_3391_length_1268_cov_12.862275	300	350	36	6	50	0.1200000
NODE_3391_length_1268_cov_12.862275	300	350	38	15	50	0.3000000
NODE_3392_length_1268_cov_9.523524	265	345	0	80	80	1.0000000
NODE_3392_length_1268_cov_9.523524	318	398	0	80	80	1.0000000
NODE_3393_length_1267_cov_21.315068	299	379	0	80	80	1.0000000
NODE_3393_length_1267_cov_21.315068	352	432	0	41	80	0.5125000
NODE_3393_length_1267_cov_21.315068	352	432	2	39	80	0.4875000
NODE_3393_length_1267_cov_21.315068	698	778	8	16	80	0.2000000
NODE_3393_length_1267_cov_21.315068	698	778	10	64	80	0.8000000
NODE_3393_length_1267_cov_21.315068	751	831	4	5	80	0.0625000
NODE_3393_length_1267_cov_21.315068	751	831	6	3	80	0.0375000
NODE_3393_length_1267_cov_21.315068	751	831	10	72	80	0.9000000
NODE_3394_length_1267_cov_14.880137	606	686	0	26	80	0.3250000
NODE_3394_length_1267_cov_14.880137	606	686	2	54	80	0.6750000
NODE_3394_length_1267_cov_14.880137	659	739	0	14	80	0.1750000
NODE_3394_length_1267_cov_14.880137	659	739	2	66	80	0.8250000
NODE_3397_length_1266_cov_20.584404	357	437	9	4	80	0.0500000
NODE_3397_length_1266_cov_20.584404	357	437	10	15	80	0.1875000
NODE_3397_length_1266_cov_20.584404	357	437	11	30	80	0.3750000
NODE_3397_length_1266_cov_20.584404	357	437	13	25	80	0.3125000
NODE_3397_length_1266_cov_20.584404	357	437	15	6	80	0.0750000
NODE_3397_length_1266_cov_20.584404	410	490	6	43	80	0.5375000
NODE_3397_length_1266_cov_20.584404	410	490	10	25	80	0.3125000
NODE_3397_length_1266_cov_20.584404	410	490	13	6	80	0.0750000
NODE_3397_length_1266_cov_20.584404	410	490	15	6	80	0.0750000
NODE_3398_length_1266_cov_16.571551	359	435	0	28	76	0.3684210
NODE_3398_length_1266_cov_16.571551	359	435	2	48	76	0.6315789
NODE_3398_length_1266_cov_16.571551	408	488	0	8	80	0.1000000
NODE_3398_length_1266_cov_16.571551	408	488	1	1	80	0.0125000
NODE_3398_length_1266_cov_16.571551	408	488	2	71	80	0.8875000
NODE_3399_length_1266_cov_14.218509	517	595	0	78	78	1.0000000
NODE_3399_length_1266_cov_14.218509	568	648	0	80	80	1.0000000
NODE_3399_length_1266_cov_14.218509	644	724	0	80	80	1.0000000
NODE_3399_length_1266_cov_14.218509	697	777	0	50	80	0.6250000
NODE_3399_length_1266_cov_14.218509	697	777	4	30	80	0.3750000
NODE_3403_length_1265_cov_9.807890	429	509	0	35	80	0.4375000
NODE_3403_length_1265_cov_9.807890	429	509	2	45	80	0.5625000
NODE_3403_length_1265_cov_9.807890	482	562	0	80	80	1.0000000
NODE_3404_length_1265_cov_8.233276	160	207	10	16	47	0.3404255
NODE_3404_length_1265_cov_8.233276	160	207	14	13	47	0.2765957
NODE_3404_length_1265_cov_8.233276	160	207	16	16	47	0.3404255
NODE_3404_length_1265_cov_8.233276	160	207	18	2	47	0.0425532
NODE_3404_length_1265_cov_8.233276	1004	1058	0	6	54	0.1111111
NODE_3404_length_1265_cov_8.233276	1004	1058	2	8	54	0.1481481
NODE_3404_length_1265_cov_8.233276	1004	1058	4	8	54	0.1481481
NODE_3404_length_1265_cov_8.233276	1004	1058	6	32	54	0.5925926
NODE_3406_length_1265_cov_3.941681	503	583	0	80	80	1.0000000
NODE_3406_length_1265_cov_3.941681	556	636	0	80	80	1.0000000
NODE_3408_length_1264_cov_8.024034	290	370	0	35	80	0.4375000
NODE_3408_length_1264_cov_8.024034	290	370	2	4	80	0.0500000
NODE_3408_length_1264_cov_8.024034	290	370	4	7	80	0.0875000
NODE_3408_length_1264_cov_8.024034	290	370	8	34	80	0.4250000
NODE_3408_length_1264_cov_8.024034	343	423	4	14	80	0.1750000
NODE_3408_length_1264_cov_8.024034	343	423	6	10	80	0.1250000
NODE_3408_length_1264_cov_8.024034	343	423	8	56	80	0.7000000
NODE_3413_length_1263_cov_8.566151	698	778	0	7	80	0.0875000
NODE_3413_length_1263_cov_8.566151	698	778	2	73	80	0.9125000
NODE_3413_length_1263_cov_8.566151	751	831	0	6	80	0.0750000
NODE_3413_length_1263_cov_8.566151	751	831	2	74	80	0.9250000
NODE_3413_length_1263_cov_8.566151	833	910	0	21	77	0.2727273
NODE_3413_length_1263_cov_8.566151	833	910	2	56	77	0.7272727
NODE_3413_length_1263_cov_8.566151	883	963	2	80	80	1.0000000
NODE_3414_length_1263_cov_7.376289	1060	1140	4	54	80	0.6750000
NODE_3414_length_1263_cov_7.376289	1060	1140	6	26	80	0.3250000
NODE_3414_length_1263_cov_7.376289	1113	1213	0	28	100	0.2800000
NODE_3414_length_1263_cov_7.376289	1113	1213	1	1	100	0.0100000
NODE_3414_length_1263_cov_7.376289	1113	1213	2	16	100	0.1600000
NODE_3414_length_1263_cov_7.376289	1113	1213	4	41	100	0.4100000
NODE_3414_length_1263_cov_7.376289	1113	1213	6	14	100	0.1400000
NODE_3416_length_1263_cov_1.827320	227	307	4	43	80	0.5375000
NODE_3416_length_1263_cov_1.827320	227	307	6	37	80	0.4625000
NODE_3416_length_1263_cov_1.827320	280	360	0	26	80	0.3250000
NODE_3416_length_1263_cov_1.827320	280	360	2	14	80	0.1750000
NODE_3416_length_1263_cov_1.827320	280	360	4	40	80	0.5000000
NODE_3418_length_1262_cov_17.416165	404	484	0	80	80	1.0000000
NODE_3418_length_1262_cov_17.416165	457	537	0	80	80	1.0000000
NODE_3419_length_1262_cov_15.268272	648	728	0	80	80	1.0000000
NODE_3419_length_1262_cov_15.268272	701	781	0	80	80	1.0000000
NODE_3419_length_1262_cov_15.268272	777	857	0	80	80	1.0000000
NODE_3419_length_1262_cov_15.268272	830	910	0	80	80	1.0000000
NODE_3424_length_1261_cov_1.777969	272	318	0	5	46	0.1086956
NODE_3424_length_1261_cov_1.777969	272	318	2	41	46	0.8913044
NODE_3425_length_1260_cov_55.640827	499	579	8	17	80	0.2125000
NODE_3425_length_1260_cov_55.640827	499	579	9	10	80	0.1250000
NODE_3425_length_1260_cov_55.640827	499	579	10	53	80	0.6625000
NODE_3425_length_1260_cov_55.640827	552	632	2	6	80	0.0750000
NODE_3425_length_1260_cov_55.640827	552	632	3	1	80	0.0125000
NODE_3425_length_1260_cov_55.640827	552	632	4	32	80	0.4000000
NODE_3425_length_1260_cov_55.640827	552	632	6	4	80	0.0500000
NODE_3425_length_1260_cov_55.640827	552	632	8	12	80	0.1500000
NODE_3425_length_1260_cov_55.640827	552	632	10	25	80	0.3125000
NODE_3425_length_1260_cov_55.640827	628	708	2	12	80	0.1500000
NODE_3425_length_1260_cov_55.640827	628	708	4	25	80	0.3125000
NODE_3425_length_1260_cov_55.640827	628	708	6	43	80	0.5375000
NODE_3425_length_1260_cov_55.640827	681	761	0	39	80	0.4875000
NODE_3425_length_1260_cov_55.640827	681	761	4	39	80	0.4875000
NODE_3425_length_1260_cov_55.640827	681	761	6	2	80	0.0250000
NODE_3426_length_1260_cov_12.242894	427	507	2	15	80	0.1875000
NODE_3426_length_1260_cov_12.242894	427	507	6	52	80	0.6500000
NODE_3426_length_1260_cov_12.242894	427	507	8	13	80	0.1625000
NODE_3426_length_1260_cov_12.242894	480	560	2	68	80	0.8500000
NODE_3426_length_1260_cov_12.242894	480	560	6	12	80	0.1500000
NODE_3436_length_1259_cov_15.381897	509	589	0	27	80	0.3375000
NODE_3436_length_1259_cov_15.381897	509	589	2	22	80	0.2750000
NODE_3436_length_1259_cov_15.381897	509	589	4	31	80	0.3875000
NODE_3436_length_1259_cov_15.381897	562	642	0	2	80	0.0250000
NODE_3436_length_1259_cov_15.381897	562	642	2	14	80	0.1750000
NODE_3436_length_1259_cov_15.381897	562	642	4	64	80	0.8000000
NODE_3439_length_1258_cov_33.519413	608	688	0	65	80	0.8125000
NODE_3439_length_1258_cov_33.519413	608	688	4	15	80	0.1875000
NODE_3439_length_1258_cov_33.519413	661	741	0	12	80	0.1500000
NODE_3439_length_1258_cov_33.519413	661	741	4	68	80	0.8500000
NODE_3440_length_1258_cov_22.569456	583	663	0	15	80	0.1875000
NODE_3440_length_1258_cov_22.569456	583	663	2	65	80	0.8125000
NODE_3440_length_1258_cov_22.569456	636	716	0	68	80	0.8500000
NODE_3440_length_1258_cov_22.569456	636	716	2	12	80	0.1500000
NODE_3441_length_1258_cov_18.747196	308	388	2	43	80	0.5375000
NODE_3441_length_1258_cov_18.747196	308	388	4	37	80	0.4625000
NODE_3441_length_1258_cov_18.747196	361	441	0	11	80	0.1375000
NODE_3441_length_1258_cov_18.747196	361	441	2	35	80	0.4375000
NODE_3441_length_1258_cov_18.747196	361	441	4	34	80	0.4250000
NODE_3441_length_1258_cov_18.747196	437	517	0	80	80	1.0000000
NODE_3441_length_1258_cov_18.747196	490	570	0	66	80	0.8250000
NODE_3441_length_1258_cov_18.747196	490	570	1	1	80	0.0125000
NODE_3441_length_1258_cov_18.747196	490	570	2	13	80	0.1625000
NODE_3442_length_1258_cov_13.699741	332	412	0	55	80	0.6875000
NODE_3442_length_1258_cov_13.699741	332	412	2	25	80	0.3125000
NODE_3442_length_1258_cov_13.699741	385	465	0	80	80	1.0000000
NODE_3447_length_1257_cov_34.029361	567	647	0	80	80	1.0000000
NODE_3447_length_1257_cov_34.029361	620	700	0	80	80	1.0000000
NODE_3447_length_1257_cov_34.029361	696	776	0	80	80	1.0000000
NODE_3447_length_1257_cov_34.029361	749	829	0	80	80	1.0000000
NODE_3449_length_1257_cov_7.892919	317	397	0	22	80	0.2750000
NODE_3449_length_1257_cov_7.892919	317	397	2	36	80	0.4500000
NODE_3449_length_1257_cov_7.892919	317	397	4	22	80	0.2750000
NODE_3449_length_1257_cov_7.892919	370	450	0	5	80	0.0625000
NODE_3449_length_1257_cov_7.892919	370	450	2	24	80	0.3000000
NODE_3449_length_1257_cov_7.892919	370	450	4	51	80	0.6375000
NODE_3452_length_1256_cov_50.506482	389	469	0	14	80	0.1750000
NODE_3452_length_1256_cov_50.506482	389	469	2	66	80	0.8250000
NODE_3452_length_1256_cov_50.506482	442	522	0	12	80	0.1500000
NODE_3452_length_1256_cov_50.506482	442	522	2	62	80	0.7750000
NODE_3452_length_1256_cov_50.506482	442	522	6	6	80	0.0750000
NODE_3452_length_1256_cov_50.506482	518	598	6	14	80	0.1750000
NODE_3452_length_1256_cov_50.506482	518	598	13	1	80	0.0125000
NODE_3452_length_1256_cov_50.506482	518	598	15	26	80	0.3250000
NODE_3452_length_1256_cov_50.506482	518	598	16	39	80	0.4875000
NODE_3452_length_1256_cov_50.506482	571	651	0	2	80	0.0250000
NODE_3452_length_1256_cov_50.506482	571	651	4	1	80	0.0125000
NODE_3452_length_1256_cov_50.506482	571	651	5	10	80	0.1250000
NODE_3452_length_1256_cov_50.506482	571	651	15	28	80	0.3500000
NODE_3452_length_1256_cov_50.506482	571	651	16	39	80	0.4875000
NODE_3453_length_1256_cov_25.944685	754	834	0	6	80	0.0750000
NODE_3453_length_1256_cov_25.944685	754	834	1	5	80	0.0625000
NODE_3453_length_1256_cov_25.944685	754	834	2	4	80	0.0500000
NODE_3453_length_1256_cov_25.944685	754	834	4	33	80	0.4125000
NODE_3453_length_1256_cov_25.944685	754	834	6	14	80	0.1750000
NODE_3453_length_1256_cov_25.944685	754	834	10	18	80	0.2250000
NODE_3453_length_1256_cov_25.944685	807	887	6	9	80	0.1125000
NODE_3453_length_1256_cov_25.944685	807	887	8	29	80	0.3625000
NODE_3453_length_1256_cov_25.944685	807	887	10	42	80	0.5250000
NODE_3455_length_1256_cov_21.720830	713	793	0	80	80	1.0000000
NODE_3455_length_1256_cov_21.720830	766	846	0	70	80	0.8750000
NODE_3455_length_1256_cov_21.720830	766	846	2	10	80	0.1250000
NODE_3456_length_1256_cov_14.242005	595	675	0	80	80	1.0000000
NODE_3456_length_1256_cov_14.242005	648	728	0	65	80	0.8125000
NODE_3456_length_1256_cov_14.242005	648	728	2	7	80	0.0875000
NODE_3456_length_1256_cov_14.242005	648	728	4	8	80	0.1000000
NODE_3457_length_1256_cov_5.870354	879	959	0	80	80	1.0000000
NODE_3463_length_1255_cov_37.271626	458	538	0	24	80	0.3000000
NODE_3463_length_1255_cov_37.271626	458	538	2	56	80	0.7000000
NODE_3463_length_1255_cov_37.271626	511	591	0	18	80	0.2250000
NODE_3463_length_1255_cov_37.271626	511	591	2	60	80	0.7500000
NODE_3463_length_1255_cov_37.271626	511	591	6	2	80	0.0250000
NODE_3463_length_1255_cov_37.271626	587	667	0	2	80	0.0250000
NODE_3463_length_1255_cov_37.271626	587	667	6	10	80	0.1250000
NODE_3463_length_1255_cov_37.271626	587	667	8	25	80	0.3125000
NODE_3463_length_1255_cov_37.271626	587	667	14	1	80	0.0125000
NODE_3463_length_1255_cov_37.271626	587	667	16	10	80	0.1250000
NODE_3463_length_1255_cov_37.271626	587	667	18	3	80	0.0375000
NODE_3463_length_1255_cov_37.271626	587	667	20	29	80	0.3625000
NODE_3463_length_1255_cov_37.271626	640	720	10	14	80	0.1750000
NODE_3463_length_1255_cov_37.271626	640	720	12	4	80	0.0500000
NODE_3463_length_1255_cov_37.271626	640	720	19	1	80	0.0125000
NODE_3463_length_1255_cov_37.271626	640	720	20	61	80	0.7625000
NODE_3464_length_1255_cov_21.374567	516	596	0	80	80	1.0000000
NODE_3464_length_1255_cov_21.374567	569	649	0	80	80	1.0000000
NODE_3464_length_1255_cov_21.374567	645	725	0	80	80	1.0000000
NODE_3464_length_1255_cov_21.374567	698	778	0	80	80	1.0000000
NODE_3465_length_1255_cov_18.391869	521	601	0	80	80	1.0000000
NODE_3465_length_1255_cov_18.391869	574	654	0	80	80	1.0000000
NODE_3466_length_1255_cov_4.096021	1194	1242	0	48	48	1.0000000
NODE_3469_length_1254_cov_32.470996	612	692	4	80	80	1.0000000
NODE_3469_length_1254_cov_32.470996	665	745	4	80	80	1.0000000
NODE_3470_length_1254_cov_26.449351	488	568	0	13	80	0.1625000
NODE_3470_length_1254_cov_26.449351	488	568	2	67	80	0.8375000
NODE_3470_length_1254_cov_26.449351	541	621	0	5	80	0.0625000
NODE_3470_length_1254_cov_26.449351	541	621	2	75	80	0.9375000
NODE_3471_length_1254_cov_22.032035	531	611	0	80	80	1.0000000
NODE_3471_length_1254_cov_22.032035	584	664	0	80	80	1.0000000
NODE_3479_length_1253_cov_16.916811	651	731	0	80	80	1.0000000
NODE_3479_length_1253_cov_16.916811	704	784	0	68	80	0.8500000
NODE_3479_length_1253_cov_16.916811	704	784	2	12	80	0.1500000
NODE_3479_length_1253_cov_16.916811	780	860	0	12	80	0.1500000
NODE_3479_length_1253_cov_16.916811	780	860	2	68	80	0.8500000
NODE_3479_length_1253_cov_16.916811	833	913	0	65	80	0.8125000
NODE_3479_length_1253_cov_16.916811	833	913	2	15	80	0.1875000
NODE_3480_length_1253_cov_13.816291	811	891	0	80	80	1.0000000
NODE_3481_length_1253_cov_9.067591	306	386	2	8	80	0.1000000
NODE_3481_length_1253_cov_9.067591	306	386	4	72	80	0.9000000
NODE_3481_length_1253_cov_9.067591	359	439	0	13	80	0.1625000
NODE_3481_length_1253_cov_9.067591	359	439	2	48	80	0.6000000
NODE_3481_length_1253_cov_9.067591	359	439	4	19	80	0.2375000
NODE_3487_length_1252_cov_57.745880	477	557	0	80	80	1.0000000
NODE_3487_length_1252_cov_57.745880	530	610	0	80	80	1.0000000
NODE_3487_length_1252_cov_57.745880	606	686	0	80	80	1.0000000
NODE_3487_length_1252_cov_57.745880	659	739	0	37	80	0.4625000
NODE_3487_length_1252_cov_57.745880	659	739	1	28	80	0.3500000
NODE_3487_length_1252_cov_57.745880	659	739	2	15	80	0.1875000
NODE_3488_length_1252_cov_56.694709	594	674	0	80	80	1.0000000
NODE_3488_length_1252_cov_56.694709	647	727	0	80	80	1.0000000
NODE_3488_length_1252_cov_56.694709	723	803	0	37	80	0.4625000
NODE_3488_length_1252_cov_56.694709	723	803	2	30	80	0.3750000
NODE_3488_length_1252_cov_56.694709	723	803	4	10	80	0.1250000
NODE_3488_length_1252_cov_56.694709	723	803	6	3	80	0.0375000
NODE_3488_length_1252_cov_56.694709	785	847	2	5	62	0.0806452
NODE_3488_length_1252_cov_56.694709	785	847	4	10	62	0.1612903
NODE_3488_length_1252_cov_56.694709	785	847	6	47	62	0.7580645
NODE_3489_length_1252_cov_34.023417	468	548	2	40	80	0.5000000
NODE_3489_length_1252_cov_34.023417	468	548	4	40	80	0.5000000
NODE_3489_length_1252_cov_34.023417	521	601	0	30	80	0.3750000
NODE_3489_length_1252_cov_34.023417	521	601	2	38	80	0.4750000
NODE_3489_length_1252_cov_34.023417	521	601	4	12	80	0.1500000
NODE_3489_length_1252_cov_34.023417	597	677	0	80	80	1.0000000
NODE_3489_length_1252_cov_34.023417	650	730	0	46	80	0.5750000
NODE_3489_length_1252_cov_34.023417	650	730	2	34	80	0.4250000
NODE_3490_length_1252_cov_9.316565	573	653	4	5	80	0.0625000
NODE_3490_length_1252_cov_9.316565	573	653	6	10	80	0.1250000
NODE_3490_length_1252_cov_9.316565	573	653	10	3	80	0.0375000
NODE_3490_length_1252_cov_9.316565	573	653	12	47	80	0.5875000
NODE_3490_length_1252_cov_9.316565	573	653	14	13	80	0.1625000
NODE_3490_length_1252_cov_9.316565	573	653	16	2	80	0.0250000
NODE_3490_length_1252_cov_9.316565	626	706	4	10	80	0.1250000
NODE_3490_length_1252_cov_9.316565	626	706	8	9	80	0.1125000
NODE_3490_length_1252_cov_9.316565	626	706	10	7	80	0.0875000
NODE_3490_length_1252_cov_9.316565	626	706	12	25	80	0.3125000
NODE_3490_length_1252_cov_9.316565	626	706	14	26	80	0.3250000
NODE_3490_length_1252_cov_9.316565	626	706	16	3	80	0.0375000
NODE_3491_length_1252_cov_8.295750	602	682	0	2	80	0.0250000
NODE_3491_length_1252_cov_8.295750	602	682	2	78	80	0.9750000
NODE_3491_length_1252_cov_8.295750	655	735	2	80	80	1.0000000
NODE_3494_length_1251_cov_17.513889	579	659	0	75	80	0.9375000
NODE_3494_length_1251_cov_17.513889	579	659	2	5	80	0.0625000
NODE_3494_length_1251_cov_17.513889	632	712	0	80	80	1.0000000
NODE_3494_length_1251_cov_17.513889	708	788	0	4	80	0.0500000
NODE_3494_length_1251_cov_17.513889	708	788	2	75	80	0.9375000
NODE_3494_length_1251_cov_17.513889	708	788	4	1	80	0.0125000
NODE_3494_length_1251_cov_17.513889	761	841	2	79	80	0.9875000
NODE_3494_length_1251_cov_17.513889	761	841	4	1	80	0.0125000
NODE_3497_length_1251_cov_3.139757	0	76	0	76	76	1.0000000
NODE_3497_length_1251_cov_3.139757	49	98	0	41	49	0.8367347
NODE_3497_length_1251_cov_3.139757	49	98	2	6	49	0.1224490
NODE_3497_length_1251_cov_3.139757	49	98	9	2	49	0.0408163
NODE_3501_length_1250_cov_25.133797	325	405	0	3	80	0.0375000
NODE_3501_length_1250_cov_25.133797	325	405	3	11	80	0.1375000
NODE_3501_length_1250_cov_25.133797	325	405	4	29	80	0.3625000
NODE_3501_length_1250_cov_25.133797	325	405	7	37	80	0.4625000
NODE_3501_length_1250_cov_25.133797	378	458	0	56	80	0.7000000
NODE_3501_length_1250_cov_25.133797	378	458	4	24	80	0.3000000
NODE_3503_length_1250_cov_11.471764	652	733	2	61	81	0.7530864
NODE_3503_length_1250_cov_11.471764	652	733	4	20	81	0.2469136
NODE_3503_length_1250_cov_11.471764	706	786	0	17	80	0.2125000
NODE_3503_length_1250_cov_11.471764	706	786	2	43	80	0.5375000
NODE_3503_length_1250_cov_11.471764	706	786	4	20	80	0.2500000
NODE_3505_length_1249_cov_45.772174	543	623	0	80	80	1.0000000
NODE_3505_length_1249_cov_45.772174	596	676	0	80	80	1.0000000
NODE_3505_length_1249_cov_45.772174	672	749	0	34	77	0.4415585
NODE_3505_length_1249_cov_45.772174	672	749	10	22	77	0.2857143
NODE_3505_length_1249_cov_45.772174	672	749	11	1	77	0.0129870
NODE_3505_length_1249_cov_45.772174	672	749	12	20	77	0.2597403
NODE_3505_length_1249_cov_45.772174	729	802	12	21	73	0.2876712
NODE_3505_length_1249_cov_45.772174	729	802	14	5	73	0.0684932
NODE_3505_length_1249_cov_45.772174	729	802	16	6	73	0.0821918
NODE_3505_length_1249_cov_45.772174	729	802	18	41	73	0.5616438
NODE_3506_length_1249_cov_35.670435	515	595	0	80	80	1.0000000
NODE_3506_length_1249_cov_35.670435	568	648	0	80	80	1.0000000
NODE_3506_length_1249_cov_35.670435	644	724	0	80	80	1.0000000
NODE_3506_length_1249_cov_35.670435	697	777	0	80	80	1.0000000
NODE_3507_length_1249_cov_34.616522	576	656	0	80	80	1.0000000
NODE_3507_length_1249_cov_34.616522	629	709	0	80	80	1.0000000
NODE_3507_length_1249_cov_34.616522	705	785	0	80	80	1.0000000
NODE_3507_length_1249_cov_34.616522	758	838	0	80	80	1.0000000
NODE_3508_length_1249_cov_19.592174	461	541	2	42	80	0.5250000
NODE_3508_length_1249_cov_19.592174	461	541	3	11	80	0.1375000
NODE_3508_length_1249_cov_19.592174	461	541	4	27	80	0.3375000
NODE_3508_length_1249_cov_19.592174	514	594	2	68	80	0.8500000
NODE_3508_length_1249_cov_19.592174	514	594	3	11	80	0.1375000
NODE_3508_length_1249_cov_19.592174	514	594	4	1	80	0.0125000
NODE_3508_length_1249_cov_19.592174	860	940	0	80	80	1.0000000
NODE_3508_length_1249_cov_19.592174	913	993	0	80	80	1.0000000
NODE_3509_length_1249_cov_14.926957	1153	1219	2	66	66	1.0000000
NODE_3509_length_1249_cov_14.926957	1192	1249	2	57	57	1.0000000
NODE_3509_length_1249_cov_14.926957	1192	1247	2	55	55	1.0000000
NODE_3509_length_1249_cov_14.926957	1192	1249	2	57	57	1.0000000
NODE_3510_length_1249_cov_7.682609	757	837	0	80	80	1.0000000
NODE_3510_length_1249_cov_7.682609	810	890	0	80	80	1.0000000
NODE_3514_length_1248_cov_14.351610	469	549	0	80	80	1.0000000
NODE_3514_length_1248_cov_14.351610	522	602	0	80	80	1.0000000
NODE_3514_length_1248_cov_14.351610	598	678	0	34	80	0.4250000
NODE_3514_length_1248_cov_14.351610	598	678	2	46	80	0.5750000
NODE_3514_length_1248_cov_14.351610	651	731	0	8	80	0.1000000
NODE_3514_length_1248_cov_14.351610	651	731	2	72	80	0.9000000
NODE_3515_length_1248_cov_11.181027	303	383	0	80	80	1.0000000
NODE_3515_length_1248_cov_11.181027	356	436	0	80	80	1.0000000
NODE_3515_length_1248_cov_11.181027	432	512	0	80	80	1.0000000
NODE_3515_length_1248_cov_11.181027	485	565	0	68	80	0.8500000
NODE_3515_length_1248_cov_11.181027	485	565	2	3	80	0.0375000
NODE_3515_length_1248_cov_11.181027	485	565	4	9	80	0.1125000
NODE_3516_length_1248_cov_4.372498	17	98	0	81	81	1.0000000
NODE_3516_length_1248_cov_4.372498	94	152	0	58	58	1.0000000
NODE_3517_length_1248_cov_2.356832	952	1032	0	80	80	1.0000000
NODE_3517_length_1248_cov_2.356832	1005	1085	0	80	80	1.0000000
NODE_3518_length_1248_cov_2.283725	1102	1151	0	49	49	1.0000000
NODE_3522_length_1247_cov_25.355401	487	567	0	80	80	1.0000000
NODE_3522_length_1247_cov_25.355401	540	620	0	80	80	1.0000000
NODE_3522_length_1247_cov_25.355401	616	696	0	39	80	0.4875000
NODE_3522_length_1247_cov_25.355401	616	696	2	41	80	0.5125000
NODE_3522_length_1247_cov_25.355401	669	749	0	22	80	0.2750000
NODE_3522_length_1247_cov_25.355401	669	749	2	58	80	0.7250000
NODE_3528_length_1246_cov_30.231909	433	513	0	33	80	0.4125000
NODE_3528_length_1246_cov_30.231909	433	513	2	11	80	0.1375000
NODE_3528_length_1246_cov_30.231909	433	513	4	36	80	0.4500000
NODE_3528_length_1246_cov_30.231909	486	566	2	27	80	0.3375000
NODE_3528_length_1246_cov_30.231909	486	566	4	53	80	0.6625000
NODE_3528_length_1246_cov_30.231909	562	642	0	73	80	0.9125000
NODE_3528_length_1246_cov_30.231909	562	642	2	7	80	0.0875000
NODE_3528_length_1246_cov_30.231909	615	695	0	80	80	1.0000000
NODE_3529_length_1246_cov_13.847428	497	577	0	80	80	1.0000000
NODE_3529_length_1246_cov_13.847428	550	630	0	80	80	1.0000000
NODE_3535_length_1245_cov_31.472949	443	523	0	18	80	0.2250000
NODE_3535_length_1245_cov_31.472949	443	523	1	1	80	0.0125000
NODE_3535_length_1245_cov_31.472949	443	523	2	61	80	0.7625000
NODE_3535_length_1245_cov_31.472949	496	576	0	59	80	0.7375000
NODE_3535_length_1245_cov_31.472949	496	576	1	1	80	0.0125000
NODE_3535_length_1245_cov_31.472949	496	576	2	20	80	0.2500000
NODE_3536_length_1245_cov_30.068935	771	841	2	68	70	0.9714286
NODE_3536_length_1245_cov_30.068935	771	841	4	2	70	0.0285714
NODE_3537_length_1245_cov_24.765271	668	748	0	80	80	1.0000000
NODE_3537_length_1245_cov_24.765271	721	801	0	80	80	1.0000000
NODE_3537_length_1245_cov_24.765271	797	877	0	80	80	1.0000000
NODE_3537_length_1245_cov_24.765271	850	930	0	80	80	1.0000000
NODE_3538_length_1245_cov_16.854276	655	735	0	80	80	1.0000000
NODE_3538_length_1245_cov_16.854276	701	771	0	70	70	1.0000000
NODE_3538_length_1245_cov_16.854276	708	788	0	80	80	1.0000000
NODE_3540_length_1245_cov_1.187609	1148	1194	0	46	46	1.0000000
NODE_3540_length_1245_cov_1.187609	1167	1245	0	78	78	1.0000000
NODE_3541_length_1244_cov_52.633188	501	581	0	43	80	0.5375000
NODE_3541_length_1244_cov_52.633188	501	581	2	37	80	0.4625000
NODE_3541_length_1244_cov_52.633188	554	634	0	15	80	0.1875000
NODE_3541_length_1244_cov_52.633188	554	634	2	65	80	0.8125000
NODE_3541_length_1244_cov_52.633188	630	710	0	80	80	1.0000000
NODE_3541_length_1244_cov_52.633188	683	763	0	80	80	1.0000000
NODE_3542_length_1244_cov_33.889956	445	525	0	1	80	0.0125000
NODE_3542_length_1244_cov_33.889956	445	525	2	21	80	0.2625000
NODE_3542_length_1244_cov_33.889956	445	525	4	58	80	0.7250000
NODE_3542_length_1244_cov_33.889956	498	578	0	45	80	0.5625000
NODE_3542_length_1244_cov_33.889956	498	578	2	4	80	0.0500000
NODE_3542_length_1244_cov_33.889956	498	578	4	31	80	0.3875000
NODE_3542_length_1244_cov_33.889956	574	654	0	80	80	1.0000000
NODE_3542_length_1244_cov_33.889956	627	707	0	32	80	0.4000000
NODE_3542_length_1244_cov_33.889956	627	707	2	6	80	0.0750000
NODE_3542_length_1244_cov_33.889956	627	707	4	3	80	0.0375000
NODE_3542_length_1244_cov_33.889956	627	707	5	39	80	0.4875000
NODE_3543_length_1244_cov_16.798253	644	724	4	24	80	0.3000000
NODE_3543_length_1244_cov_16.798253	644	724	8	4	80	0.0500000
NODE_3543_length_1244_cov_16.798253	644	724	12	52	80	0.6500000
NODE_3543_length_1244_cov_16.798253	697	777	6	11	80	0.1375000
NODE_3543_length_1244_cov_16.798253	697	777	10	35	80	0.4375000
NODE_3543_length_1244_cov_16.798253	697	777	12	33	80	0.4125000
NODE_3543_length_1244_cov_16.798253	697	777	14	1	80	0.0125000
NODE_3544_length_1244_cov_1.735371	276	347	0	71	71	1.0000000
NODE_3544_length_1244_cov_1.735371	276	347	0	71	71	1.0000000
NODE_3544_length_1244_cov_1.735371	320	400	0	80	80	1.0000000
NODE_3544_length_1244_cov_1.735371	320	400	0	80	80	1.0000000
NODE_3548_length_1243_cov_34.284965	774	854	0	78	80	0.9750000
NODE_3548_length_1243_cov_34.284965	774	854	2	2	80	0.0250000
NODE_3548_length_1243_cov_34.284965	827	907	0	25	80	0.3125000
NODE_3548_length_1243_cov_34.284965	827	907	2	55	80	0.6875000
NODE_3552_length_1242_cov_29.665792	539	619	0	80	80	1.0000000
NODE_3552_length_1242_cov_29.665792	592	672	0	80	80	1.0000000
NODE_3553_length_1242_cov_28.304462	506	586	0	80	80	1.0000000
NODE_3553_length_1242_cov_28.304462	559	639	0	80	80	1.0000000
NODE_3553_length_1242_cov_28.304462	635	715	0	19	80	0.2375000
NODE_3553_length_1242_cov_28.304462	635	715	2	8	80	0.1000000
NODE_3553_length_1242_cov_28.304462	635	715	3	9	80	0.1125000
NODE_3553_length_1242_cov_28.304462	635	715	5	13	80	0.1625000
NODE_3553_length_1242_cov_28.304462	635	715	7	6	80	0.0750000
NODE_3553_length_1242_cov_28.304462	635	715	9	1	80	0.0125000
NODE_3553_length_1242_cov_28.304462	635	715	10	24	80	0.3000000
NODE_3553_length_1242_cov_28.304462	688	768	4	1	80	0.0125000
NODE_3553_length_1242_cov_28.304462	688	768	6	4	80	0.0500000
NODE_3553_length_1242_cov_28.304462	688	768	7	2	80	0.0250000
NODE_3553_length_1242_cov_28.304462	688	768	8	5	80	0.0625000
NODE_3553_length_1242_cov_28.304462	688	768	9	1	80	0.0125000
NODE_3553_length_1242_cov_28.304462	688	768	10	67	80	0.8375000
NODE_3554_length_1242_cov_16.383202	704	784	2	2	80	0.0250000
NODE_3554_length_1242_cov_16.383202	704	784	4	78	80	0.9750000
NODE_3554_length_1242_cov_16.383202	757	837	0	37	80	0.4625000
NODE_3554_length_1242_cov_16.383202	757	837	2	18	80	0.2250000
NODE_3554_length_1242_cov_16.383202	757	837	4	25	80	0.3125000
NODE_3555_length_1242_cov_8.081365	688	768	0	1	80	0.0125000
NODE_3555_length_1242_cov_8.081365	688	768	2	79	80	0.9875000
NODE_3555_length_1242_cov_8.081365	741	821	0	54	80	0.6750000
NODE_3555_length_1242_cov_8.081365	741	821	2	26	80	0.3250000
NODE_3561_length_1241_cov_36.544658	602	682	0	78	80	0.9750000
NODE_3561_length_1241_cov_36.544658	602	682	2	2	80	0.0250000
NODE_3561_length_1241_cov_36.544658	655	735	0	25	80	0.3125000
NODE_3561_length_1241_cov_36.544658	655	735	2	55	80	0.6875000
NODE_3562_length_1241_cov_19.894921	676	756	0	18	80	0.2250000
NODE_3562_length_1241_cov_19.894921	676	756	6	62	80	0.7750000
NODE_3562_length_1241_cov_19.894921	729	809	0	1	80	0.0125000
NODE_3562_length_1241_cov_19.894921	729	809	6	79	80	0.9875000
NODE_3569_length_1240_cov_38.375110	483	563	0	13	80	0.1625000
NODE_3569_length_1240_cov_38.375110	483	563	2	67	80	0.8375000
NODE_3569_length_1240_cov_38.375110	536	616	0	2	80	0.0250000
NODE_3569_length_1240_cov_38.375110	536	616	2	66	80	0.8250000
NODE_3569_length_1240_cov_38.375110	536	616	4	12	80	0.1500000
NODE_3569_length_1240_cov_38.375110	612	692	0	19	80	0.2375000
NODE_3569_length_1240_cov_38.375110	612	692	2	28	80	0.3500000
NODE_3569_length_1240_cov_38.375110	612	692	4	33	80	0.4125000
NODE_3569_length_1240_cov_38.375110	665	745	0	72	80	0.9000000
NODE_3569_length_1240_cov_38.375110	665	745	2	8	80	0.1000000
NODE_3570_length_1240_cov_24.975460	625	705	0	45	80	0.5625000
NODE_3570_length_1240_cov_24.975460	625	705	6	21	80	0.2625000
NODE_3570_length_1240_cov_24.975460	625	705	8	3	80	0.0375000
NODE_3570_length_1240_cov_24.975460	625	705	10	1	80	0.0125000
NODE_3570_length_1240_cov_24.975460	625	705	12	10	80	0.1250000
NODE_3570_length_1240_cov_24.975460	678	758	6	13	80	0.1625000
NODE_3570_length_1240_cov_24.975460	678	758	8	3	80	0.0375000
NODE_3570_length_1240_cov_24.975460	678	758	10	1	80	0.0125000
NODE_3570_length_1240_cov_24.975460	678	758	12	63	80	0.7875000
NODE_3571_length_1240_cov_23.812445	731	811	4	12	80	0.1500000
NODE_3571_length_1240_cov_23.812445	731	811	6	19	80	0.2375000
NODE_3571_length_1240_cov_23.812445	731	811	8	33	80	0.4125000
NODE_3571_length_1240_cov_23.812445	731	811	10	16	80	0.2000000
NODE_3571_length_1240_cov_23.812445	784	864	4	65	80	0.8125000
NODE_3571_length_1240_cov_23.812445	784	864	10	15	80	0.1875000
NODE_3576_length_1239_cov_37.657895	399	479	0	42	80	0.5250000
NODE_3576_length_1239_cov_37.657895	399	479	2	38	80	0.4750000
NODE_3576_length_1239_cov_37.657895	452	532	2	36	80	0.4500000
NODE_3576_length_1239_cov_37.657895	452	532	8	44	80	0.5500000
NODE_3576_length_1239_cov_37.657895	528	608	4	11	80	0.1375000
NODE_3576_length_1239_cov_37.657895	528	608	6	47	80	0.5875000
NODE_3576_length_1239_cov_37.657895	528	608	8	22	80	0.2750000
NODE_3576_length_1239_cov_37.657895	581	661	0	45	80	0.5625000
NODE_3576_length_1239_cov_37.657895	581	661	4	19	80	0.2375000
NODE_3576_length_1239_cov_37.657895	581	661	6	16	80	0.2000000
NODE_3577_length_1239_cov_14.984211	398	478	0	80	80	1.0000000
NODE_3577_length_1239_cov_14.984211	451	531	0	80	80	1.0000000
NODE_3577_length_1239_cov_14.984211	771	825	0	54	54	1.0000000
NODE_3577_length_1239_cov_14.984211	798	878	0	80	80	1.0000000
NODE_3578_length_1239_cov_13.312281	806	886	5	25	80	0.3125000
NODE_3578_length_1239_cov_13.312281	806	886	7	16	80	0.2000000
NODE_3578_length_1239_cov_13.312281	806	886	8	11	80	0.1375000
NODE_3578_length_1239_cov_13.312281	806	886	9	8	80	0.1000000
NODE_3578_length_1239_cov_13.312281	806	886	10	9	80	0.1125000
NODE_3578_length_1239_cov_13.312281	806	886	11	8	80	0.1000000
NODE_3578_length_1239_cov_13.312281	806	886	13	3	80	0.0375000
NODE_3578_length_1239_cov_13.312281	859	939	4	10	80	0.1250000
NODE_3578_length_1239_cov_13.312281	859	939	6	4	80	0.0500000
NODE_3578_length_1239_cov_13.312281	859	939	8	50	80	0.6250000
NODE_3578_length_1239_cov_13.312281	859	939	10	9	80	0.1125000
NODE_3578_length_1239_cov_13.312281	859	939	11	4	80	0.0500000
NODE_3578_length_1239_cov_13.312281	859	939	13	3	80	0.0375000
NODE_3579_length_1239_cov_7.116667	444	524	0	33	80	0.4125000
NODE_3579_length_1239_cov_7.116667	444	524	2	47	80	0.5875000
NODE_3579_length_1239_cov_7.116667	497	577	0	21	80	0.2625000
NODE_3579_length_1239_cov_7.116667	497	577	2	59	80	0.7375000
NODE_3582_length_1238_cov_33.830553	625	705	0	80	80	1.0000000
NODE_3582_length_1238_cov_33.830553	678	758	0	80	80	1.0000000
NODE_3583_length_1238_cov_8.163301	664	744	0	26	80	0.3250000
NODE_3583_length_1238_cov_8.163301	664	744	2	50	80	0.6250000
NODE_3583_length_1238_cov_8.163301	664	744	4	4	80	0.0500000
NODE_3583_length_1238_cov_8.163301	717	797	0	8	80	0.1000000
NODE_3583_length_1238_cov_8.163301	717	797	2	19	80	0.2375000
NODE_3583_length_1238_cov_8.163301	717	797	4	9	80	0.1125000
NODE_3583_length_1238_cov_8.163301	717	797	6	23	80	0.2875000
NODE_3583_length_1238_cov_8.163301	717	797	7	12	80	0.1500000
NODE_3583_length_1238_cov_8.163301	717	797	8	9	80	0.1125000
NODE_3586_length_1237_cov_24.562390	447	527	2	28	80	0.3500000
NODE_3586_length_1237_cov_24.562390	447	527	4	14	80	0.1750000
NODE_3586_length_1237_cov_24.562390	447	527	6	38	80	0.4750000
NODE_3586_length_1237_cov_24.562390	500	580	4	17	80	0.2125000
NODE_3586_length_1237_cov_24.562390	500	580	5	27	80	0.3375000
NODE_3586_length_1237_cov_24.562390	500	580	6	36	80	0.4500000
NODE_3587_length_1237_cov_9.297012	515	595	2	24	80	0.3000000
NODE_3587_length_1237_cov_9.297012	515	595	4	56	80	0.7000000
NODE_3587_length_1237_cov_9.297012	568	648	0	48	80	0.6000000
NODE_3587_length_1237_cov_9.297012	568	648	2	7	80	0.0875000
NODE_3587_length_1237_cov_9.297012	568	648	4	25	80	0.3125000
NODE_3594_length_1236_cov_46.661390	632	712	26	1	80	0.0125000
NODE_3594_length_1236_cov_46.661390	632	712	28	19	80	0.2375000
NODE_3594_length_1236_cov_46.661390	632	712	32	1	80	0.0125000
NODE_3594_length_1236_cov_46.661390	632	712	34	10	80	0.1250000
NODE_3594_length_1236_cov_46.661390	632	712	36	2	80	0.0250000
NODE_3594_length_1236_cov_46.661390	632	712	38	13	80	0.1625000
NODE_3594_length_1236_cov_46.661390	632	712	40	27	80	0.3375000
NODE_3594_length_1236_cov_46.661390	632	712	42	7	80	0.0875000
NODE_3594_length_1236_cov_46.661390	685	765	15	6	80	0.0750000
NODE_3594_length_1236_cov_46.661390	685	765	26	1	80	0.0125000
NODE_3594_length_1236_cov_46.661390	685	765	30	1	80	0.0125000
NODE_3594_length_1236_cov_46.661390	685	765	32	11	80	0.1375000
NODE_3594_length_1236_cov_46.661390	685	765	36	35	80	0.4375000
NODE_3594_length_1236_cov_46.661390	685	765	38	13	80	0.1625000
NODE_3594_length_1236_cov_46.661390	685	765	40	13	80	0.1625000
NODE_3595_length_1236_cov_8.625330	735	815	10	61	80	0.7625000
NODE_3595_length_1236_cov_8.625330	735	815	16	19	80	0.2375000
NODE_3595_length_1236_cov_8.625330	788	868	6	10	80	0.1250000
NODE_3595_length_1236_cov_8.625330	788	868	10	37	80	0.4625000
NODE_3595_length_1236_cov_8.625330	788	868	16	33	80	0.4125000
NODE_3597_length_1235_cov_31.619718	331	411	0	80	80	1.0000000
NODE_3597_length_1235_cov_31.619718	384	464	0	30	80	0.3750000
NODE_3597_length_1235_cov_31.619718	384	464	2	50	80	0.6250000
NODE_3598_length_1235_cov_20.252641	559	639	0	18	80	0.2250000
NODE_3598_length_1235_cov_20.252641	559	639	1	56	80	0.7000000
NODE_3598_length_1235_cov_20.252641	559	639	2	6	80	0.0750000
NODE_3598_length_1235_cov_20.252641	612	692	0	67	80	0.8375000
NODE_3598_length_1235_cov_20.252641	612	692	1	9	80	0.1125000
NODE_3598_length_1235_cov_20.252641	612	692	2	4	80	0.0500000
NODE_3598_length_1235_cov_20.252641	688	768	0	4	80	0.0500000
NODE_3598_length_1235_cov_20.252641	688	768	2	76	80	0.9500000
NODE_3598_length_1235_cov_20.252641	741	821	0	57	80	0.7125000
NODE_3598_length_1235_cov_20.252641	741	821	2	23	80	0.2875000
NODE_3599_length_1235_cov_18.462148	695	775	0	30	80	0.3750000
NODE_3599_length_1235_cov_18.462148	695	775	1	50	80	0.6250000
NODE_3599_length_1235_cov_18.462148	748	828	1	80	80	1.0000000
NODE_3600_length_1235_cov_8.696303	765	845	4	29	80	0.3625000
NODE_3600_length_1235_cov_8.696303	765	845	6	25	80	0.3125000
NODE_3600_length_1235_cov_8.696303	765	845	7	13	80	0.1625000
NODE_3600_length_1235_cov_8.696303	765	845	10	8	80	0.1000000
NODE_3600_length_1235_cov_8.696303	765	845	11	5	80	0.0625000
NODE_3600_length_1235_cov_8.696303	818	898	4	80	80	1.0000000
NODE_3601_length_1235_cov_5.580106	544	624	0	80	80	1.0000000
NODE_3601_length_1235_cov_5.580106	597	677	0	80	80	1.0000000
NODE_3608_length_1234_cov_27.136564	528	608	0	55	80	0.6875000
NODE_3608_length_1234_cov_27.136564	528	608	2	25	80	0.3125000
NODE_3608_length_1234_cov_27.136564	581	661	0	11	80	0.1375000
NODE_3608_length_1234_cov_27.136564	581	661	2	69	80	0.8625000
NODE_3611_length_1233_cov_64.374780	497	577	0	80	80	1.0000000
NODE_3611_length_1233_cov_64.374780	550	630	0	80	80	1.0000000
NODE_3611_length_1233_cov_64.374780	626	706	0	80	80	1.0000000
NODE_3611_length_1233_cov_64.374780	679	759	0	80	80	1.0000000
NODE_3612_length_1233_cov_52.833333	654	734	0	31	80	0.3875000
NODE_3612_length_1233_cov_52.833333	654	734	2	49	80	0.6125000
NODE_3612_length_1233_cov_52.833333	707	787	2	61	80	0.7625000
NODE_3612_length_1233_cov_52.833333	707	787	4	19	80	0.2375000
NODE_3613_length_1233_cov_18.096120	522	602	2	37	80	0.4625000
NODE_3613_length_1233_cov_18.096120	522	602	4	9	80	0.1125000
NODE_3613_length_1233_cov_18.096120	522	602	6	14	80	0.1750000
NODE_3613_length_1233_cov_18.096120	522	602	8	20	80	0.2500000
NODE_3613_length_1233_cov_18.096120	575	655	6	7	80	0.0875000
NODE_3613_length_1233_cov_18.096120	575	655	8	73	80	0.9125000
NODE_3613_length_1233_cov_18.096120	651	731	0	63	80	0.7875000
NODE_3613_length_1233_cov_18.096120	651	731	3	1	80	0.0125000
NODE_3613_length_1233_cov_18.096120	651	731	4	4	80	0.0500000
NODE_3613_length_1233_cov_18.096120	651	731	6	1	80	0.0125000
NODE_3613_length_1233_cov_18.096120	651	731	8	11	80	0.1375000
NODE_3613_length_1233_cov_18.096120	704	784	0	80	80	1.0000000
NODE_3614_length_1233_cov_15.360670	585	656	0	11	71	0.1549296
NODE_3614_length_1233_cov_15.360670	585	656	2	60	71	0.8450704
NODE_3614_length_1233_cov_15.360670	631	709	0	22	78	0.2820513
NODE_3614_length_1233_cov_15.360670	631	709	2	56	78	0.7179487
NODE_3620_length_1232_cov_62.112974	552	632	4	4	80	0.0500000
NODE_3620_length_1232_cov_62.112974	552	632	6	26	80	0.3250000
NODE_3620_length_1232_cov_62.112974	552	632	24	13	80	0.1625000
NODE_3620_length_1232_cov_62.112974	552	632	26	37	80	0.4625000
NODE_3620_length_1232_cov_62.112974	605	694	20	57	89	0.6404495
NODE_3620_length_1232_cov_62.112974	605	694	24	7	89	0.0786517
NODE_3620_length_1232_cov_62.112974	605	694	26	25	89	0.2808989
NODE_3620_length_1232_cov_62.112974	690	770	2	44	80	0.5500000
NODE_3620_length_1232_cov_62.112974	690	770	3	1	80	0.0125000
NODE_3620_length_1232_cov_62.112974	690	770	4	9	80	0.1125000
NODE_3620_length_1232_cov_62.112974	690	770	18	1	80	0.0125000
NODE_3620_length_1232_cov_62.112974	690	770	20	25	80	0.3125000
NODE_3620_length_1232_cov_62.112974	743	823	2	27	80	0.3375000
NODE_3620_length_1232_cov_62.112974	743	823	4	29	80	0.3625000
NODE_3620_length_1232_cov_62.112974	743	823	6	24	80	0.3000000
NODE_3621_length_1232_cov_34.635481	469	549	0	47	80	0.5875000
NODE_3621_length_1232_cov_34.635481	469	549	2	7	80	0.0875000
NODE_3621_length_1232_cov_34.635481	469	549	4	7	80	0.0875000
NODE_3621_length_1232_cov_34.635481	469	549	8	6	80	0.0750000
NODE_3621_length_1232_cov_34.635481	469	549	10	13	80	0.1625000
NODE_3621_length_1232_cov_34.635481	522	602	2	1	80	0.0125000
NODE_3621_length_1232_cov_34.635481	522	602	4	7	80	0.0875000
NODE_3621_length_1232_cov_34.635481	522	602	6	1	80	0.0125000
NODE_3621_length_1232_cov_34.635481	522	602	8	19	80	0.2375000
NODE_3621_length_1232_cov_34.635481	522	602	10	52	80	0.6500000
NODE_3622_length_1232_cov_16.362754	774	854	0	7	80	0.0875000
NODE_3622_length_1232_cov_16.362754	774	854	2	19	80	0.2375000
NODE_3622_length_1232_cov_16.362754	774	854	4	54	80	0.6750000
NODE_3622_length_1232_cov_16.362754	827	907	0	60	80	0.7500000
NODE_3622_length_1232_cov_16.362754	827	907	2	19	80	0.2375000
NODE_3622_length_1232_cov_16.362754	827	907	4	1	80	0.0125000
NODE_3623_length_1232_cov_13.395410	234	315	0	38	81	0.4691358
NODE_3623_length_1232_cov_13.395410	234	315	2	5	81	0.0617284
NODE_3623_length_1232_cov_13.395410	234	315	3	38	81	0.4691358
NODE_3623_length_1232_cov_13.395410	287	368	0	81	81	1.0000000
NODE_3623_length_1232_cov_13.395410	364	444	0	80	80	1.0000000
NODE_3623_length_1232_cov_13.395410	417	497	0	80	80	1.0000000
NODE_3625_length_1231_cov_47.606890	509	589	2	35	80	0.4375000
NODE_3625_length_1231_cov_47.606890	509	589	4	16	80	0.2000000
NODE_3625_length_1231_cov_47.606890	509	589	6	29	80	0.3625000
NODE_3625_length_1231_cov_47.606890	562	642	4	16	80	0.2000000
NODE_3625_length_1231_cov_47.606890	562	642	6	64	80	0.8000000
NODE_3625_length_1231_cov_47.606890	638	718	4	3	80	0.0375000
NODE_3625_length_1231_cov_47.606890	638	718	6	3	80	0.0375000
NODE_3625_length_1231_cov_47.606890	638	718	8	16	80	0.2000000
NODE_3625_length_1231_cov_47.606890	638	718	12	17	80	0.2125000
NODE_3625_length_1231_cov_47.606890	638	718	14	1	80	0.0125000
NODE_3625_length_1231_cov_47.606890	638	718	20	1	80	0.0125000
NODE_3625_length_1231_cov_47.606890	638	718	22	3	80	0.0375000
NODE_3625_length_1231_cov_47.606890	638	718	24	21	80	0.2625000
NODE_3625_length_1231_cov_47.606890	638	718	26	15	80	0.1875000
NODE_3625_length_1231_cov_47.606890	691	771	24	32	80	0.4000000
NODE_3625_length_1231_cov_47.606890	691	771	26	48	80	0.6000000
NODE_3626_length_1231_cov_27.498233	698	777	2	66	79	0.8354430
NODE_3626_length_1231_cov_27.498233	698	777	4	13	79	0.1645570
NODE_3626_length_1231_cov_27.498233	750	830	2	39	80	0.4875000
NODE_3626_length_1231_cov_27.498233	750	830	8	41	80	0.5125000
NODE_3627_length_1231_cov_21.245583	673	753	0	16	80	0.2000000
NODE_3627_length_1231_cov_21.245583	673	753	10	64	80	0.8000000
NODE_3627_length_1231_cov_21.245583	726	806	10	80	80	1.0000000
NODE_3627_length_1231_cov_21.245583	802	882	0	43	80	0.5375000
NODE_3627_length_1231_cov_21.245583	802	882	10	37	80	0.4625000
NODE_3627_length_1231_cov_21.245583	860	935	0	75	75	1.0000000
NODE_3628_length_1231_cov_9.895760	515	595	0	21	80	0.2625000
NODE_3628_length_1231_cov_9.895760	515	595	2	59	80	0.7375000
NODE_3628_length_1231_cov_9.895760	568	648	0	9	80	0.1125000
NODE_3628_length_1231_cov_9.895760	568	648	2	34	80	0.4250000
NODE_3628_length_1231_cov_9.895760	568	648	4	37	80	0.4625000
NODE_3630_length_1230_cov_43.705570	412	492	8	42	80	0.5250000
NODE_3630_length_1230_cov_43.705570	412	492	9	4	80	0.0500000
NODE_3630_length_1230_cov_43.705570	412	492	10	34	80	0.4250000
NODE_3630_length_1230_cov_43.705570	465	545	2	32	80	0.4000000
NODE_3630_length_1230_cov_43.705570	465	545	4	18	80	0.2250000
NODE_3630_length_1230_cov_43.705570	465	545	6	2	80	0.0250000
NODE_3630_length_1230_cov_43.705570	465	545	8	28	80	0.3500000
NODE_3631_length_1230_cov_43.663130	501	581	0	46	80	0.5750000
NODE_3631_length_1230_cov_43.663130	501	581	2	13	80	0.1625000
NODE_3631_length_1230_cov_43.663130	501	581	4	21	80	0.2625000
NODE_3631_length_1230_cov_43.663130	554	634	2	32	80	0.4000000
NODE_3631_length_1230_cov_43.663130	554	634	4	48	80	0.6000000
NODE_3632_length_1230_cov_33.173298	315	395	0	31	80	0.3875000
NODE_3632_length_1230_cov_33.173298	315	395	2	49	80	0.6125000
NODE_3632_length_1230_cov_33.173298	368	448	2	80	80	1.0000000
NODE_3633_length_1230_cov_12.939876	201	281	9	7	80	0.0875000
NODE_3633_length_1230_cov_12.939876	201	281	11	4	80	0.0500000
NODE_3633_length_1230_cov_12.939876	201	281	15	9	80	0.1125000
NODE_3633_length_1230_cov_12.939876	201	281	17	22	80	0.2750000
NODE_3633_length_1230_cov_12.939876	201	281	19	3	80	0.0375000
NODE_3633_length_1230_cov_12.939876	201	281	20	35	80	0.4375000
NODE_3633_length_1230_cov_12.939876	218	273	15	3	55	0.0545455
NODE_3633_length_1230_cov_12.939876	218	273	17	22	55	0.4000000
NODE_3633_length_1230_cov_12.939876	218	273	19	3	55	0.0545455
NODE_3633_length_1230_cov_12.939876	218	273	20	27	55	0.4909091
NODE_3633_length_1230_cov_12.939876	254	334	7	13	80	0.1625000
NODE_3633_length_1230_cov_12.939876	254	334	9	1	80	0.0125000
NODE_3633_length_1230_cov_12.939876	254	334	12	1	80	0.0125000
NODE_3633_length_1230_cov_12.939876	254	334	14	1	80	0.0125000
NODE_3633_length_1230_cov_12.939876	254	334	15	6	80	0.0750000
NODE_3633_length_1230_cov_12.939876	254	334	20	40	80	0.5000000
NODE_3633_length_1230_cov_12.939876	254	334	22	18	80	0.2250000
NODE_3633_length_1230_cov_12.939876	330	410	3	27	80	0.3375000
NODE_3633_length_1230_cov_12.939876	330	410	4	14	80	0.1750000
NODE_3633_length_1230_cov_12.939876	330	410	5	8	80	0.1000000
NODE_3633_length_1230_cov_12.939876	330	410	6	10	80	0.1250000
NODE_3633_length_1230_cov_12.939876	330	410	7	21	80	0.2625000
NODE_3633_length_1230_cov_12.939876	383	463	3	10	80	0.1250000
NODE_3633_length_1230_cov_12.939876	383	463	4	67	80	0.8375000
NODE_3633_length_1230_cov_12.939876	383	463	5	3	80	0.0375000
NODE_3634_length_1230_cov_5.155615	248	328	0	80	80	1.0000000
NODE_3634_length_1230_cov_5.155615	301	381	0	40	80	0.5000000
NODE_3634_length_1230_cov_5.155615	301	381	2	40	80	0.5000000
NODE_3640_length_1229_cov_30.214159	341	421	0	80	80	1.0000000
NODE_3640_length_1229_cov_30.214159	394	474	0	80	80	1.0000000
NODE_3641_length_1229_cov_23.165487	376	456	0	80	80	1.0000000
NODE_3641_length_1229_cov_23.165487	429	509	0	42	80	0.5250000
NODE_3641_length_1229_cov_23.165487	429	509	2	18	80	0.2250000
NODE_3641_length_1229_cov_23.165487	429	509	4	20	80	0.2500000
NODE_3641_length_1229_cov_23.165487	505	585	4	9	80	0.1125000
NODE_3641_length_1229_cov_23.165487	505	585	8	71	80	0.8875000
NODE_3641_length_1229_cov_23.165487	558	638	0	22	80	0.2750000
NODE_3641_length_1229_cov_23.165487	558	638	4	16	80	0.2000000
NODE_3641_length_1229_cov_23.165487	558	638	6	14	80	0.1750000
NODE_3641_length_1229_cov_23.165487	558	638	8	28	80	0.3500000
NODE_3642_length_1229_cov_19.376991	484	564	2	12	80	0.1500000
NODE_3642_length_1229_cov_19.376991	484	564	3	7	80	0.0875000
NODE_3642_length_1229_cov_19.376991	484	564	23	5	80	0.0625000
NODE_3642_length_1229_cov_19.376991	484	564	38	15	80	0.1875000
NODE_3642_length_1229_cov_19.376991	484	564	39	11	80	0.1375000
NODE_3642_length_1229_cov_19.376991	484	564	40	1	80	0.0125000
NODE_3642_length_1229_cov_19.376991	484	564	46	9	80	0.1125000
NODE_3642_length_1229_cov_19.376991	484	564	48	12	80	0.1500000
NODE_3642_length_1229_cov_19.376991	484	564	50	8	80	0.1000000
NODE_3642_length_1229_cov_19.376991	537	614	45	7	77	0.0909091
NODE_3642_length_1229_cov_19.376991	537	614	46	10	77	0.1298701
NODE_3642_length_1229_cov_19.376991	537	614	48	15	77	0.1948052
NODE_3642_length_1229_cov_19.376991	537	614	49	9	77	0.1168831
NODE_3642_length_1229_cov_19.376991	537	614	50	29	77	0.3766234
NODE_3642_length_1229_cov_19.376991	537	614	51	7	77	0.0909091
NODE_3643_length_1229_cov_11.799115	670	748	0	13	78	0.1666667
NODE_3643_length_1229_cov_11.799115	670	748	2	65	78	0.8333333
NODE_3643_length_1229_cov_11.799115	728	801	0	6	73	0.0821918
NODE_3643_length_1229_cov_11.799115	728	801	2	67	73	0.9178082
NODE_3644_length_1229_cov_8.140708	970	1050	0	80	80	1.0000000
NODE_3644_length_1229_cov_8.140708	1023	1103	0	80	80	1.0000000
NODE_3646_length_1229_cov_3.654867	765	840	0	75	75	1.0000000
NODE_3646_length_1229_cov_3.654867	813	893	0	80	80	1.0000000
NODE_3652_length_1229_cov_0.949558	1034	1079	2	26	45	0.5777778
NODE_3652_length_1229_cov_0.949558	1034	1079	4	19	45	0.4222222
NODE_3652_length_1229_cov_0.949558	1090	1130	6	14	40	0.3500000
NODE_3652_length_1229_cov_0.949558	1090	1130	7	6	40	0.1500000
NODE_3652_length_1229_cov_0.949558	1090	1130	8	8	40	0.2000000
NODE_3652_length_1229_cov_0.949558	1090	1130	9	12	40	0.3000000
NODE_3654_length_1228_cov_22.622675	604	684	0	54	80	0.6750000
NODE_3654_length_1228_cov_22.622675	604	684	4	26	80	0.3250000
NODE_3654_length_1228_cov_22.622675	657	738	0	1	81	0.0123457
NODE_3654_length_1228_cov_22.622675	657	738	2	21	81	0.2592593
NODE_3654_length_1228_cov_22.622675	657	738	3	7	81	0.0864198
NODE_3654_length_1228_cov_22.622675	657	738	4	52	81	0.6419753
NODE_3655_length_1228_cov_17.900797	423	503	0	80	80	1.0000000
NODE_3655_length_1228_cov_17.900797	423	503	0	80	80	1.0000000
NODE_3655_length_1228_cov_17.900797	423	503	0	80	80	1.0000000
NODE_3655_length_1228_cov_17.900797	476	538	0	62	62	1.0000000
NODE_3655_length_1228_cov_17.900797	476	538	0	62	62	1.0000000
NODE_3655_length_1228_cov_17.900797	476	538	0	62	62	1.0000000
NODE_3655_length_1228_cov_17.900797	476	556	0	80	80	1.0000000
NODE_3656_length_1228_cov_14.554473	367	447	0	80	80	1.0000000
NODE_3656_length_1228_cov_14.554473	420	500	0	80	80	1.0000000
NODE_3657_length_1228_cov_10.021258	661	741	0	80	80	1.0000000
NODE_3657_length_1228_cov_10.021258	714	794	0	80	80	1.0000000
NODE_3660_length_1228_cov_3.987600	1139	1219	0	80	80	1.0000000
NODE_3662_length_1227_cov_29.002660	423	503	0	33	80	0.4125000
NODE_3662_length_1227_cov_29.002660	423	503	2	4	80	0.0500000
NODE_3662_length_1227_cov_29.002660	423	503	4	20	80	0.2500000
NODE_3662_length_1227_cov_29.002660	423	503	6	23	80	0.2875000
NODE_3662_length_1227_cov_29.002660	476	556	4	12	80	0.1500000
NODE_3662_length_1227_cov_29.002660	476	556	6	68	80	0.8500000
NODE_3663_length_1227_cov_17.479610	759	839	0	36	80	0.4500000
NODE_3663_length_1227_cov_17.479610	759	839	2	44	80	0.5500000
NODE_3663_length_1227_cov_17.479610	812	892	0	10	80	0.1250000
NODE_3663_length_1227_cov_17.479610	812	892	2	70	80	0.8750000
NODE_3666_length_1227_cov_3.808511	120	186	6	11	66	0.1666667
NODE_3666_length_1227_cov_3.808511	120	186	8	2	66	0.0303030
NODE_3666_length_1227_cov_3.808511	120	186	10	18	66	0.2727273
NODE_3666_length_1227_cov_3.808511	120	186	14	2	66	0.0303030
NODE_3666_length_1227_cov_3.808511	120	186	15	7	66	0.1060606
NODE_3666_length_1227_cov_3.808511	120	186	16	7	66	0.1060606
NODE_3666_length_1227_cov_3.808511	120	186	18	19	66	0.2878788
NODE_3666_length_1227_cov_3.808511	173	239	10	1	66	0.0151515
NODE_3666_length_1227_cov_3.808511	173	239	12	6	66	0.0909091
NODE_3666_length_1227_cov_3.808511	173	239	14	1	66	0.0151515
NODE_3666_length_1227_cov_3.808511	173	239	16	7	66	0.1060606
NODE_3666_length_1227_cov_3.808511	173	239	18	51	66	0.7727273
NODE_3666_length_1227_cov_3.808511	229	299	0	4	70	0.0571429
NODE_3666_length_1227_cov_3.808511	229	299	1	37	70	0.5285714
NODE_3666_length_1227_cov_3.808511	229	299	2	12	70	0.1714286
NODE_3666_length_1227_cov_3.808511	229	299	4	1	70	0.0142857
NODE_3666_length_1227_cov_3.808511	229	299	6	4	70	0.0571429
NODE_3666_length_1227_cov_3.808511	229	299	10	3	70	0.0428571
NODE_3666_length_1227_cov_3.808511	229	299	12	6	70	0.0857143
NODE_3666_length_1227_cov_3.808511	229	299	14	1	70	0.0142857
NODE_3666_length_1227_cov_3.808511	229	299	16	2	70	0.0285714
NODE_3672_length_1226_cov_23.792369	579	659	0	64	80	0.8000000
NODE_3672_length_1226_cov_23.792369	579	659	2	16	80	0.2000000
NODE_3672_length_1226_cov_23.792369	632	712	0	80	80	1.0000000
NODE_3672_length_1226_cov_23.792369	708	788	0	80	80	1.0000000
NODE_3672_length_1226_cov_23.792369	761	839	0	78	78	1.0000000
NODE_3673_length_1226_cov_5.620231	463	543	0	80	80	1.0000000
NODE_3673_length_1226_cov_5.620231	516	596	0	80	80	1.0000000
NODE_3674_length_1226_cov_4.881988	582	662	0	46	80	0.5750000
NODE_3674_length_1226_cov_4.881988	582	662	2	34	80	0.4250000
NODE_3674_length_1226_cov_4.881988	635	715	0	12	80	0.1500000
NODE_3674_length_1226_cov_4.881988	635	715	2	68	80	0.8500000
NODE_3682_length_1225_cov_55.596803	637	717	2	17	80	0.2125000
NODE_3682_length_1225_cov_55.596803	637	717	4	5	80	0.0625000
NODE_3682_length_1225_cov_55.596803	637	717	6	58	80	0.7250000
NODE_3682_length_1225_cov_55.596803	690	770	0	22	80	0.2750000
NODE_3682_length_1225_cov_55.596803	690	770	2	8	80	0.1000000
NODE_3682_length_1225_cov_55.596803	690	770	4	21	80	0.2625000
NODE_3682_length_1225_cov_55.596803	690	770	6	29	80	0.3625000
NODE_3682_length_1225_cov_55.596803	766	846	2	80	80	1.0000000
NODE_3682_length_1225_cov_55.596803	819	899	0	53	80	0.6625000
NODE_3682_length_1225_cov_55.596803	819	899	2	27	80	0.3375000
NODE_3683_length_1225_cov_35.189165	661	742	0	57	81	0.7037037
NODE_3683_length_1225_cov_35.189165	661	742	2	24	81	0.2962963
NODE_3683_length_1225_cov_35.189165	714	795	0	81	81	1.0000000
NODE_3684_length_1225_cov_33.755773	456	535	9	29	79	0.3670886
NODE_3684_length_1225_cov_33.755773	456	535	11	6	79	0.0759494
NODE_3684_length_1225_cov_33.755773	456	535	13	3	79	0.0379747
NODE_3684_length_1225_cov_33.755773	456	535	17	2	79	0.0253165
NODE_3684_length_1225_cov_33.755773	456	535	19	38	79	0.4810127
NODE_3684_length_1225_cov_33.755773	456	535	21	1	79	0.0126582
NODE_3684_length_1225_cov_33.755773	508	588	10	12	80	0.1500000
NODE_3684_length_1225_cov_33.755773	508	588	13	1	80	0.0125000
NODE_3684_length_1225_cov_33.755773	508	588	15	4	80	0.0500000
NODE_3684_length_1225_cov_33.755773	508	588	19	26	80	0.3250000
NODE_3684_length_1225_cov_33.755773	508	588	21	1	80	0.0125000
NODE_3684_length_1225_cov_33.755773	508	588	22	30	80	0.3750000
NODE_3684_length_1225_cov_33.755773	508	588	23	6	80	0.0750000
NODE_3685_length_1225_cov_30.116341	566	646	0	8	80	0.1000000
NODE_3685_length_1225_cov_30.116341	566	646	2	50	80	0.6250000
NODE_3685_length_1225_cov_30.116341	566	646	4	22	80	0.2750000
NODE_3685_length_1225_cov_30.116341	619	699	2	32	80	0.4000000
NODE_3685_length_1225_cov_30.116341	619	699	4	48	80	0.6000000
NODE_3685_length_1225_cov_30.116341	695	775	4	24	80	0.3000000
NODE_3685_length_1225_cov_30.116341	695	775	6	56	80	0.7000000
NODE_3685_length_1225_cov_30.116341	748	828	0	8	80	0.1000000
NODE_3685_length_1225_cov_30.116341	748	828	2	27	80	0.3375000
NODE_3685_length_1225_cov_30.116341	748	828	4	9	80	0.1125000
NODE_3685_length_1225_cov_30.116341	748	828	6	36	80	0.4500000
NODE_3686_length_1225_cov_29.177620	195	275	0	80	80	1.0000000
NODE_3686_length_1225_cov_29.177620	248	328	0	80	80	1.0000000
NODE_3687_length_1225_cov_26.849023	588	668	2	5	80	0.0625000
NODE_3687_length_1225_cov_26.849023	588	668	4	13	80	0.1625000
NODE_3687_length_1225_cov_26.849023	588	668	5	1	80	0.0125000
NODE_3687_length_1225_cov_26.849023	588	668	6	61	80	0.7625000
NODE_3687_length_1225_cov_26.849023	641	721	0	48	80	0.6000000
NODE_3687_length_1225_cov_26.849023	641	721	2	10	80	0.1250000
NODE_3687_length_1225_cov_26.849023	641	721	5	1	80	0.0125000
NODE_3687_length_1225_cov_26.849023	641	721	6	21	80	0.2625000
NODE_3687_length_1225_cov_26.849023	717	797	0	80	80	1.0000000
NODE_3687_length_1225_cov_26.849023	770	850	0	41	80	0.5125000
NODE_3687_length_1225_cov_26.849023	770	850	2	39	80	0.4875000
NODE_3688_length_1225_cov_24.444938	386	466	0	22	80	0.2750000
NODE_3688_length_1225_cov_24.444938	386	466	2	58	80	0.7250000
NODE_3688_length_1225_cov_24.444938	439	519	2	80	80	1.0000000
NODE_3690_length_1225_cov_19.369449	491	571	0	80	80	1.0000000
NODE_3690_length_1225_cov_19.369449	544	624	0	47	80	0.5875000
NODE_3690_length_1225_cov_19.369449	544	624	2	33	80	0.4125000
NODE_3690_length_1225_cov_19.369449	620	700	2	55	80	0.6875000
NODE_3690_length_1225_cov_19.369449	620	700	4	25	80	0.3125000
NODE_3690_length_1225_cov_19.369449	673	753	2	57	80	0.7125000
NODE_3690_length_1225_cov_19.369449	673	753	4	23	80	0.2875000
NODE_3691_length_1225_cov_13.281528	462	542	0	42	80	0.5250000
NODE_3691_length_1225_cov_13.281528	462	542	4	38	80	0.4750000
NODE_3691_length_1225_cov_13.281528	515	595	0	80	80	1.0000000
NODE_3691_length_1225_cov_13.281528	591	671	0	44	80	0.5500000
NODE_3691_length_1225_cov_13.281528	591	671	2	36	80	0.4500000
NODE_3691_length_1225_cov_13.281528	644	724	1	7	80	0.0875000
NODE_3691_length_1225_cov_13.281528	644	724	2	68	80	0.8500000
NODE_3691_length_1225_cov_13.281528	644	724	3	5	80	0.0625000
NODE_3692_length_1225_cov_10.887211	566	646	2	16	80	0.2000000
NODE_3692_length_1225_cov_10.887211	566	646	4	42	80	0.5250000
NODE_3692_length_1225_cov_10.887211	566	646	6	22	80	0.2750000
NODE_3692_length_1225_cov_10.887211	619	699	2	1	80	0.0125000
NODE_3692_length_1225_cov_10.887211	619	699	4	20	80	0.2500000
NODE_3692_length_1225_cov_10.887211	619	699	6	59	80	0.7375000
NODE_3696_length_1224_cov_24.568889	613	693	2	43	80	0.5375000
NODE_3696_length_1224_cov_24.568889	613	693	4	37	80	0.4625000
NODE_3696_length_1224_cov_24.568889	666	746	0	25	80	0.3125000
NODE_3696_length_1224_cov_24.568889	666	746	1	20	80	0.2500000
NODE_3696_length_1224_cov_24.568889	666	746	2	35	80	0.4375000
NODE_3697_length_1224_cov_17.538667	762	842	0	80	80	1.0000000
NODE_3697_length_1224_cov_17.538667	815	895	0	80	80	1.0000000
NODE_3698_length_1224_cov_14.138667	389	469	0	12	80	0.1500000
NODE_3698_length_1224_cov_14.138667	389	469	2	19	80	0.2375000
NODE_3698_length_1224_cov_14.138667	389	469	4	49	80	0.6125000
NODE_3698_length_1224_cov_14.138667	442	522	0	10	80	0.1250000
NODE_3698_length_1224_cov_14.138667	442	522	2	3	80	0.0375000
NODE_3698_length_1224_cov_14.138667	442	522	4	67	80	0.8375000
NODE_3699_length_1224_cov_11.358222	704	784	2	80	80	1.0000000
NODE_3699_length_1224_cov_11.358222	757	837	0	47	80	0.5875000
NODE_3699_length_1224_cov_11.358222	757	837	2	33	80	0.4125000
NODE_3700_length_1224_cov_6.963556	516	581	6	65	65	1.0000000
NODE_3705_length_1223_cov_44.608541	548	630	2	82	82	1.0000000
NODE_3705_length_1223_cov_44.608541	601	683	0	24	82	0.2926829
NODE_3705_length_1223_cov_44.608541	601	683	2	58	82	0.7073171
NODE_3705_length_1223_cov_44.608541	679	759	0	80	80	1.0000000
NODE_3705_length_1223_cov_44.608541	732	812	0	80	80	1.0000000
NODE_3706_length_1223_cov_26.730427	508	588	4	5	80	0.0625000
NODE_3706_length_1223_cov_26.730427	508	588	5	15	80	0.1875000
NODE_3706_length_1223_cov_26.730427	508	588	6	47	80	0.5875000
NODE_3706_length_1223_cov_26.730427	508	588	7	13	80	0.1625000
NODE_3706_length_1223_cov_26.730427	561	641	0	24	80	0.3000000
NODE_3706_length_1223_cov_26.730427	561	641	1	12	80	0.1500000
NODE_3706_length_1223_cov_26.730427	561	641	2	14	80	0.1750000
NODE_3706_length_1223_cov_26.730427	561	641	4	8	80	0.1000000
NODE_3706_length_1223_cov_26.730427	561	641	5	1	80	0.0125000
NODE_3706_length_1223_cov_26.730427	561	641	6	21	80	0.2625000
NODE_3707_length_1223_cov_18.902135	460	540	0	49	80	0.6125000
NODE_3707_length_1223_cov_18.902135	460	540	2	31	80	0.3875000
NODE_3707_length_1223_cov_18.902135	513	593	2	80	80	1.0000000
NODE_3708_length_1223_cov_6.989324	707	778	0	71	71	1.0000000
NODE_3710_length_1223_cov_5.251779	666	746	0	49	80	0.6125000
NODE_3710_length_1223_cov_5.251779	666	746	2	31	80	0.3875000
NODE_3710_length_1223_cov_5.251779	719	799	0	80	80	1.0000000
NODE_3710_length_1223_cov_5.251779	795	875	0	22	80	0.2750000
NODE_3710_length_1223_cov_5.251779	795	875	2	23	80	0.2875000
NODE_3710_length_1223_cov_5.251779	795	875	4	35	80	0.4375000
NODE_3710_length_1223_cov_5.251779	848	928	4	47	80	0.5875000
NODE_3710_length_1223_cov_5.251779	848	928	5	30	80	0.3750000
NODE_3710_length_1223_cov_5.251779	848	928	6	3	80	0.0375000
NODE_3716_length_1222_cov_18.406946	273	353	0	8	80	0.1000000
NODE_3716_length_1222_cov_18.406946	273	353	2	12	80	0.1500000
NODE_3716_length_1222_cov_18.406946	273	353	4	60	80	0.7500000
NODE_3716_length_1222_cov_18.406946	326	406	0	16	80	0.2000000
NODE_3716_length_1222_cov_18.406946	326	406	2	15	80	0.1875000
NODE_3716_length_1222_cov_18.406946	326	406	4	49	80	0.6125000
NODE_3720_length_1221_cov_33.261141	505	577	4	28	72	0.3888889
NODE_3720_length_1221_cov_33.261141	505	577	6	1	72	0.0138889
NODE_3720_length_1221_cov_33.261141	505	577	8	15	72	0.2083333
NODE_3720_length_1221_cov_33.261141	505	577	10	28	72	0.3888889
NODE_3720_length_1221_cov_33.261141	558	637	2	8	79	0.1012658
NODE_3720_length_1221_cov_33.261141	558	637	4	25	79	0.3164557
NODE_3720_length_1221_cov_33.261141	558	637	8	23	79	0.2911392
NODE_3720_length_1221_cov_33.261141	558	637	10	23	79	0.2911392
NODE_3720_length_1221_cov_33.261141	633	713	1	7	80	0.0875000
NODE_3720_length_1221_cov_33.261141	633	713	2	6	80	0.0750000
NODE_3720_length_1221_cov_33.261141	633	713	3	67	80	0.8375000
NODE_3720_length_1221_cov_33.261141	686	766	1	58	80	0.7250000
NODE_3720_length_1221_cov_33.261141	686	766	2	2	80	0.0250000
NODE_3720_length_1221_cov_33.261141	686	766	3	20	80	0.2500000
NODE_3721_length_1221_cov_19.466132	541	621	0	31	80	0.3875000
NODE_3721_length_1221_cov_19.466132	541	621	2	3	80	0.0375000
NODE_3721_length_1221_cov_19.466132	541	621	5	46	80	0.5750000
NODE_3721_length_1221_cov_19.466132	594	674	4	17	80	0.2125000
NODE_3721_length_1221_cov_19.466132	594	674	5	34	80	0.4250000
NODE_3721_length_1221_cov_19.466132	594	674	6	29	80	0.3625000
NODE_3722_length_1221_cov_15.940285	788	868	0	9	80	0.1125000
NODE_3722_length_1221_cov_15.940285	788	868	2	12	80	0.1500000
NODE_3722_length_1221_cov_15.940285	788	868	3	6	80	0.0750000
NODE_3722_length_1221_cov_15.940285	788	868	4	53	80	0.6625000
NODE_3722_length_1221_cov_15.940285	841	921	0	23	80	0.2875000
NODE_3722_length_1221_cov_15.940285	841	921	2	16	80	0.2000000
NODE_3722_length_1221_cov_15.940285	841	921	4	41	80	0.5125000
NODE_3722_length_1221_cov_15.940285	917	997	2	80	80	1.0000000
NODE_3722_length_1221_cov_15.940285	970	1050	0	3	80	0.0375000
NODE_3722_length_1221_cov_15.940285	970	1050	2	77	80	0.9625000
NODE_3723_length_1221_cov_15.796791	484	564	0	80	80	1.0000000
NODE_3723_length_1221_cov_15.796791	537	617	0	80	80	1.0000000
NODE_3724_length_1221_cov_15.312834	342	415	4	29	73	0.3972603
NODE_3724_length_1221_cov_15.312834	342	415	6	44	73	0.6027398
NODE_3724_length_1221_cov_15.312834	395	474	0	12	79	0.1518987
NODE_3724_length_1221_cov_15.312834	395	474	2	42	79	0.5316456
NODE_3724_length_1221_cov_15.312834	395	474	6	25	79	0.3164557
NODE_3725_length_1221_cov_9.695187	988	1068	0	69	80	0.8625000
NODE_3725_length_1221_cov_9.695187	988	1068	3	11	80	0.1375000
NODE_3725_length_1221_cov_9.695187	1041	1100	0	59	59	1.0000000
NODE_3726_length_1221_cov_9.043672	695	775	0	80	80	1.0000000
NODE_3726_length_1221_cov_9.043672	748	828	0	80	80	1.0000000
NODE_3727_length_1221_cov_7.946524	147	227	0	30	80	0.3750000
NODE_3727_length_1221_cov_7.946524	147	227	2	50	80	0.6250000
NODE_3727_length_1221_cov_7.946524	200	280	2	80	80	1.0000000
NODE_3728_length_1221_cov_5.122103	248	328	0	22	80	0.2750000
NODE_3728_length_1221_cov_5.122103	248	328	2	58	80	0.7250000
NODE_3728_length_1221_cov_5.122103	301	381	0	28	80	0.3500000
NODE_3728_length_1221_cov_5.122103	301	381	2	52	80	0.6500000
NODE_3736_length_1220_cov_44.501338	319	399	0	80	80	1.0000000
NODE_3736_length_1220_cov_44.501338	372	452	0	79	80	0.9875000
NODE_3736_length_1220_cov_44.501338	372	452	2	1	80	0.0125000
NODE_3736_length_1220_cov_44.501338	448	528	0	3	80	0.0375000
NODE_3736_length_1220_cov_44.501338	448	528	2	49	80	0.6125000
NODE_3736_length_1220_cov_44.501338	448	528	3	28	80	0.3500000
NODE_3736_length_1220_cov_44.501338	501	581	1	3	80	0.0375000
NODE_3736_length_1220_cov_44.501338	501	581	2	36	80	0.4500000
NODE_3736_length_1220_cov_44.501338	501	581	3	30	80	0.3750000
NODE_3736_length_1220_cov_44.501338	501	581	4	11	80	0.1375000
NODE_3737_length_1220_cov_43.868867	720	800	4	23	80	0.2875000
NODE_3737_length_1220_cov_43.868867	720	800	6	18	80	0.2250000
NODE_3737_length_1220_cov_43.868867	720	800	8	22	80	0.2750000
NODE_3737_length_1220_cov_43.868867	720	800	10	17	80	0.2125000
NODE_3737_length_1220_cov_43.868867	773	853	4	2	80	0.0250000
NODE_3737_length_1220_cov_43.868867	773	853	6	45	80	0.5625000
NODE_3737_length_1220_cov_43.868867	773	853	8	10	80	0.1250000
NODE_3737_length_1220_cov_43.868867	773	853	10	23	80	0.2875000
NODE_3738_length_1220_cov_41.900089	593	673	2	9	80	0.1125000
NODE_3738_length_1220_cov_41.900089	593	673	6	2	80	0.0250000
NODE_3738_length_1220_cov_41.900089	593	673	14	25	80	0.3125000
NODE_3738_length_1220_cov_41.900089	593	673	16	17	80	0.2125000
NODE_3738_length_1220_cov_41.900089	593	673	17	18	80	0.2250000
NODE_3738_length_1220_cov_41.900089	593	673	18	9	80	0.1125000
NODE_3738_length_1220_cov_41.900089	646	726	2	62	80	0.7750000
NODE_3738_length_1220_cov_41.900089	646	726	6	2	80	0.0250000
NODE_3738_length_1220_cov_41.900089	646	726	14	16	80	0.2000000
NODE_3738_length_1220_cov_41.900089	722	802	0	49	80	0.6125000
NODE_3738_length_1220_cov_41.900089	722	802	2	31	80	0.3875000
NODE_3738_length_1220_cov_41.900089	775	855	0	2	80	0.0250000
NODE_3738_length_1220_cov_41.900089	775	855	2	78	80	0.9750000
NODE_3739_length_1220_cov_15.485281	395	475	2	7	80	0.0875000
NODE_3739_length_1220_cov_15.485281	395	475	8	12	80	0.1500000
NODE_3739_length_1220_cov_15.485281	395	475	10	53	80	0.6625000
NODE_3739_length_1220_cov_15.485281	395	475	12	8	80	0.1000000
NODE_3739_length_1220_cov_15.485281	448	528	0	18	80	0.2250000
NODE_3739_length_1220_cov_15.485281	448	528	6	3	80	0.0375000
NODE_3739_length_1220_cov_15.485281	448	528	8	4	80	0.0500000
NODE_3739_length_1220_cov_15.485281	448	528	10	55	80	0.6875000
NODE_3745_length_1219_cov_30.493750	643	723	0	80	80	1.0000000
NODE_3745_length_1219_cov_30.493750	696	776	0	80	80	1.0000000
NODE_3745_length_1219_cov_30.493750	772	852	0	80	80	1.0000000
NODE_3745_length_1219_cov_30.493750	825	905	0	80	80	1.0000000
NODE_3746_length_1219_cov_24.991071	566	646	0	80	80	1.0000000
NODE_3746_length_1219_cov_24.991071	619	699	0	39	80	0.4875000
NODE_3746_length_1219_cov_24.991071	619	699	2	20	80	0.2500000
NODE_3746_length_1219_cov_24.991071	619	699	4	21	80	0.2625000
NODE_3746_length_1219_cov_24.991071	695	775	2	11	80	0.1375000
NODE_3746_length_1219_cov_24.991071	695	775	4	69	80	0.8625000
NODE_3746_length_1219_cov_24.991071	748	828	0	19	80	0.2375000
NODE_3746_length_1219_cov_24.991071	748	828	2	34	80	0.4250000
NODE_3746_length_1219_cov_24.991071	748	828	4	27	80	0.3375000
NODE_3747_length_1219_cov_24.728571	465	545	2	80	80	1.0000000
NODE_3747_length_1219_cov_24.728571	518	598	2	80	80	1.0000000
NODE_3747_length_1219_cov_24.728571	594	674	0	19	80	0.2375000
NODE_3747_length_1219_cov_24.728571	594	674	1	1	80	0.0125000
NODE_3747_length_1219_cov_24.728571	594	674	2	8	80	0.1000000
NODE_3747_length_1219_cov_24.728571	594	674	3	1	80	0.0125000
NODE_3747_length_1219_cov_24.728571	594	674	4	51	80	0.6375000
NODE_3747_length_1219_cov_24.728571	647	727	0	25	80	0.3125000
NODE_3747_length_1219_cov_24.728571	647	727	4	43	80	0.5375000
NODE_3747_length_1219_cov_24.728571	647	727	6	12	80	0.1500000
NODE_3748_length_1219_cov_11.130357	535	615	0	4	80	0.0500000
NODE_3748_length_1219_cov_11.130357	535	615	4	5	80	0.0625000
NODE_3748_length_1219_cov_11.130357	535	615	8	71	80	0.8875000
NODE_3748_length_1219_cov_11.130357	588	668	0	34	80	0.4250000
NODE_3748_length_1219_cov_11.130357	588	668	4	15	80	0.1875000
NODE_3748_length_1219_cov_11.130357	588	668	8	31	80	0.3875000
NODE_3749_length_1219_cov_9.696429	734	814	0	7	80	0.0875000
NODE_3749_length_1219_cov_9.696429	734	814	3	1	80	0.0125000
NODE_3749_length_1219_cov_9.696429	734	814	4	59	80	0.7375000
NODE_3749_length_1219_cov_9.696429	734	814	6	13	80	0.1625000
NODE_3749_length_1219_cov_9.696429	787	867	2	14	80	0.1750000
NODE_3749_length_1219_cov_9.696429	787	867	4	14	80	0.1750000
NODE_3749_length_1219_cov_9.696429	787	867	6	52	80	0.6500000
NODE_3754_length_1218_cov_40.159071	554	634	0	34	80	0.4250000
NODE_3754_length_1218_cov_40.159071	554	634	2	2	80	0.0250000
NODE_3754_length_1218_cov_40.159071	554	634	4	44	80	0.5500000
NODE_3754_length_1218_cov_40.159071	607	687	2	13	80	0.1625000
NODE_3754_length_1218_cov_40.159071	607	687	4	67	80	0.8375000
NODE_3754_length_1218_cov_40.159071	683	763	2	8	80	0.1000000
NODE_3754_length_1218_cov_40.159071	683	763	4	6	80	0.0750000
NODE_3754_length_1218_cov_40.159071	683	763	6	53	80	0.6625000
NODE_3754_length_1218_cov_40.159071	683	763	8	13	80	0.1625000
NODE_3754_length_1218_cov_40.159071	736	816	2	16	80	0.2000000
NODE_3754_length_1218_cov_40.159071	736	816	4	11	80	0.1375000
NODE_3754_length_1218_cov_40.159071	736	816	6	40	80	0.5000000
NODE_3754_length_1218_cov_40.159071	736	816	8	13	80	0.1625000
NODE_3765_length_1216_cov_99.538944	44	124	92	2	80	0.0250000
NODE_3765_length_1216_cov_99.538944	44	124	96	2	80	0.0250000
NODE_3765_length_1216_cov_99.538944	44	124	98	3	80	0.0375000
NODE_3765_length_1216_cov_99.538944	44	124	99	1	80	0.0125000
NODE_3765_length_1216_cov_99.538944	44	124	103	1	80	0.0125000
NODE_3765_length_1216_cov_99.538944	44	124	105	1	80	0.0125000
NODE_3765_length_1216_cov_99.538944	44	124	109	1	80	0.0125000
NODE_3765_length_1216_cov_99.538944	44	124	111	2	80	0.0250000
NODE_3765_length_1216_cov_99.538944	44	124	113	1	80	0.0125000
NODE_3765_length_1216_cov_99.538944	44	124	115	2	80	0.0250000
NODE_3765_length_1216_cov_99.538944	44	124	123	2	80	0.0250000
NODE_3765_length_1216_cov_99.538944	44	124	124	5	80	0.0625000
NODE_3765_length_1216_cov_99.538944	44	124	130	1	80	0.0125000
NODE_3765_length_1216_cov_99.538944	44	124	134	1	80	0.0125000
NODE_3765_length_1216_cov_99.538944	44	124	138	1	80	0.0125000
NODE_3765_length_1216_cov_99.538944	44	124	139	1	80	0.0125000
NODE_3765_length_1216_cov_99.538944	44	124	145	1	80	0.0125000
NODE_3765_length_1216_cov_99.538944	44	124	149	2	80	0.0250000
NODE_3765_length_1216_cov_99.538944	44	124	151	2	80	0.0250000
NODE_3765_length_1216_cov_99.538944	44	124	153	1	80	0.0125000
NODE_3765_length_1216_cov_99.538944	44	124	155	2	80	0.0250000
NODE_3765_length_1216_cov_99.538944	44	124	157	5	80	0.0625000
NODE_3765_length_1216_cov_99.538944	44	124	161	1	80	0.0125000
NODE_3765_length_1216_cov_99.538944	44	124	163	1	80	0.0125000
NODE_3765_length_1216_cov_99.538944	44	124	165	1	80	0.0125000
NODE_3765_length_1216_cov_99.538944	44	124	167	1	80	0.0125000
NODE_3765_length_1216_cov_99.538944	44	124	173	1	80	0.0125000
NODE_3765_length_1216_cov_99.538944	44	124	174	2	80	0.0250000
NODE_3765_length_1216_cov_99.538944	44	124	180	1	80	0.0125000
NODE_3765_length_1216_cov_99.538944	44	124	182	2	80	0.0250000
NODE_3765_length_1216_cov_99.538944	44	124	186	2	80	0.0250000
NODE_3765_length_1216_cov_99.538944	44	124	188	2	80	0.0250000
NODE_3765_length_1216_cov_99.538944	44	124	192	1	80	0.0125000
NODE_3765_length_1216_cov_99.538944	44	124	194	4	80	0.0500000
NODE_3765_length_1216_cov_99.538944	44	124	196	1	80	0.0125000
NODE_3765_length_1216_cov_99.538944	44	124	199	1	80	0.0125000
NODE_3765_length_1216_cov_99.538944	44	124	200	1	80	0.0125000
NODE_3765_length_1216_cov_99.538944	44	124	201	1	80	0.0125000
NODE_3765_length_1216_cov_99.538944	44	124	205	3	80	0.0375000
NODE_3765_length_1216_cov_99.538944	44	124	206	2	80	0.0250000
NODE_3765_length_1216_cov_99.538944	44	124	207	5	80	0.0625000
NODE_3765_length_1216_cov_99.538944	44	124	208	1	80	0.0125000
NODE_3765_length_1216_cov_99.538944	44	124	209	3	80	0.0375000
NODE_3765_length_1216_cov_99.538944	44	124	211	3	80	0.0375000
NODE_3765_length_1216_cov_99.538944	97	157	188	1	60	0.0166667
NODE_3765_length_1216_cov_99.538944	97	157	192	1	60	0.0166667
NODE_3765_length_1216_cov_99.538944	97	157	194	4	60	0.0666667
NODE_3765_length_1216_cov_99.538944	97	157	196	1	60	0.0166667
NODE_3765_length_1216_cov_99.538944	97	157	199	1	60	0.0166667
NODE_3765_length_1216_cov_99.538944	97	157	200	1	60	0.0166667
NODE_3765_length_1216_cov_99.538944	97	157	201	1	60	0.0166667
NODE_3765_length_1216_cov_99.538944	97	157	203	1	60	0.0166667
NODE_3765_length_1216_cov_99.538944	97	157	205	4	60	0.0666667
NODE_3765_length_1216_cov_99.538944	97	157	206	2	60	0.0333333
NODE_3765_length_1216_cov_99.538944	97	157	207	5	60	0.0833333
NODE_3765_length_1216_cov_99.538944	97	157	208	1	60	0.0166667
NODE_3765_length_1216_cov_99.538944	97	157	209	4	60	0.0666667
NODE_3765_length_1216_cov_99.538944	97	157	211	6	60	0.1000000
NODE_3765_length_1216_cov_99.538944	97	157	213	1	60	0.0166667
NODE_3765_length_1216_cov_99.538944	97	157	215	1	60	0.0166667
NODE_3765_length_1216_cov_99.538944	97	157	216	1	60	0.0166667
NODE_3765_length_1216_cov_99.538944	97	157	217	2	60	0.0333333
NODE_3765_length_1216_cov_99.538944	97	157	219	3	60	0.0500000
NODE_3765_length_1216_cov_99.538944	97	157	220	2	60	0.0333333
NODE_3765_length_1216_cov_99.538944	97	157	221	1	60	0.0166667
NODE_3765_length_1216_cov_99.538944	97	157	224	1	60	0.0166667
NODE_3765_length_1216_cov_99.538944	97	157	229	1	60	0.0166667
NODE_3765_length_1216_cov_99.538944	97	157	236	1	60	0.0166667
NODE_3765_length_1216_cov_99.538944	97	157	243	2	60	0.0333333
NODE_3765_length_1216_cov_99.538944	97	157	245	1	60	0.0166667
NODE_3765_length_1216_cov_99.538944	97	157	252	1	60	0.0166667
NODE_3765_length_1216_cov_99.538944	97	157	253	1	60	0.0166667
NODE_3765_length_1216_cov_99.538944	97	157	256	1	60	0.0166667
NODE_3765_length_1216_cov_99.538944	97	157	257	1	60	0.0166667
NODE_3765_length_1216_cov_99.538944	97	157	258	1	60	0.0166667
NODE_3765_length_1216_cov_99.538944	97	157	260	1	60	0.0166667
NODE_3765_length_1216_cov_99.538944	97	157	263	2	60	0.0333333
NODE_3765_length_1216_cov_99.538944	97	157	264	1	60	0.0166667
NODE_3765_length_1216_cov_99.538944	97	157	265	1	60	0.0166667
NODE_3765_length_1216_cov_99.538944	824	903	121	3	79	0.0379747
NODE_3765_length_1216_cov_99.538944	824	903	124	1	79	0.0126582
NODE_3765_length_1216_cov_99.538944	824	903	126	3	79	0.0379747
NODE_3765_length_1216_cov_99.538944	824	903	128	4	79	0.0506329
NODE_3765_length_1216_cov_99.538944	824	903	129	1	79	0.0126582
NODE_3765_length_1216_cov_99.538944	824	903	132	2	79	0.0253165
NODE_3765_length_1216_cov_99.538944	824	903	133	1	79	0.0126582
NODE_3765_length_1216_cov_99.538944	824	903	134	1	79	0.0126582
NODE_3765_length_1216_cov_99.538944	824	903	135	3	79	0.0379747
NODE_3765_length_1216_cov_99.538944	824	903	138	3	79	0.0379747
NODE_3765_length_1216_cov_99.538944	824	903	140	6	79	0.0759494
NODE_3765_length_1216_cov_99.538944	824	903	141	1	79	0.0126582
NODE_3765_length_1216_cov_99.538944	824	903	142	2	79	0.0253165
NODE_3765_length_1216_cov_99.538944	824	903	144	5	79	0.0632911
NODE_3765_length_1216_cov_99.538944	824	903	145	1	79	0.0126582
NODE_3765_length_1216_cov_99.538944	824	903	147	2	79	0.0253165
NODE_3765_length_1216_cov_99.538944	824	903	149	2	79	0.0253165
NODE_3765_length_1216_cov_99.538944	824	903	150	1	79	0.0126582
NODE_3765_length_1216_cov_99.538944	824	903	153	2	79	0.0253165
NODE_3765_length_1216_cov_99.538944	824	903	154	1	79	0.0126582
NODE_3765_length_1216_cov_99.538944	824	903	155	1	79	0.0126582
NODE_3765_length_1216_cov_99.538944	824	903	160	1	79	0.0126582
NODE_3765_length_1216_cov_99.538944	824	903	161	4	79	0.0506329
NODE_3765_length_1216_cov_99.538944	824	903	162	3	79	0.0379747
NODE_3765_length_1216_cov_99.538944	824	903	163	1	79	0.0126582
NODE_3765_length_1216_cov_99.538944	824	903	164	2	79	0.0253165
NODE_3765_length_1216_cov_99.538944	824	903	165	4	79	0.0506329
NODE_3765_length_1216_cov_99.538944	824	903	167	10	79	0.1265823
NODE_3765_length_1216_cov_99.538944	824	903	173	1	79	0.0126582
NODE_3765_length_1216_cov_99.538944	824	903	179	2	79	0.0253165
NODE_3765_length_1216_cov_99.538944	824	903	181	1	79	0.0126582
NODE_3765_length_1216_cov_99.538944	824	903	185	1	79	0.0126582
NODE_3765_length_1216_cov_99.538944	824	903	191	2	79	0.0253165
NODE_3765_length_1216_cov_99.538944	824	903	195	1	79	0.0126582
NODE_3766_length_1216_cov_15.855864	668	748	0	21	80	0.2625000
NODE_3766_length_1216_cov_15.855864	668	748	10	59	80	0.7375000
NODE_3766_length_1216_cov_15.855864	721	801	10	80	80	1.0000000
NODE_3767_length_1216_cov_4.128917	720	800	0	80	80	1.0000000
NODE_3767_length_1216_cov_4.128917	773	853	0	52	80	0.6500000
NODE_3767_length_1216_cov_4.128917	773	853	2	28	80	0.3500000
NODE_3774_length_1215_cov_32.293011	411	491	7	35	80	0.4375000
NODE_3774_length_1215_cov_32.293011	411	491	8	6	80	0.0750000
NODE_3774_length_1215_cov_32.293011	411	491	10	8	80	0.1000000
NODE_3774_length_1215_cov_32.293011	411	491	11	20	80	0.2500000
NODE_3774_length_1215_cov_32.293011	411	491	13	5	80	0.0625000
NODE_3774_length_1215_cov_32.293011	411	491	15	6	80	0.0750000
NODE_3774_length_1215_cov_32.293011	464	544	0	16	80	0.2000000
NODE_3774_length_1215_cov_32.293011	464	544	1	10	80	0.1250000
NODE_3774_length_1215_cov_32.293011	464	544	5	19	80	0.2375000
NODE_3774_length_1215_cov_32.293011	464	544	7	35	80	0.4375000
NODE_3775_length_1215_cov_24.177419	729	809	0	74	80	0.9250000
NODE_3775_length_1215_cov_24.177419	729	809	2	6	80	0.0750000
NODE_3775_length_1215_cov_24.177419	782	862	0	21	80	0.2625000
NODE_3775_length_1215_cov_24.177419	782	862	2	59	80	0.7375000
NODE_3776_length_1215_cov_21.566308	645	725	0	28	80	0.3500000
NODE_3776_length_1215_cov_21.566308	645	725	2	52	80	0.6500000
NODE_3776_length_1215_cov_21.566308	698	778	0	80	80	1.0000000
NODE_3777_length_1215_cov_19.278674	630	710	0	20	80	0.2500000
NODE_3777_length_1215_cov_19.278674	630	710	2	11	80	0.1375000
NODE_3777_length_1215_cov_19.278674	630	710	4	49	80	0.6125000
NODE_3777_length_1215_cov_19.278674	683	763	2	5	80	0.0625000
NODE_3777_length_1215_cov_19.278674	683	763	4	75	80	0.9375000
NODE_3778_length_1215_cov_15.074373	664	744	2	42	80	0.5250000
NODE_3778_length_1215_cov_15.074373	664	744	4	38	80	0.4750000
NODE_3778_length_1215_cov_15.074373	717	797	0	13	80	0.1625000
NODE_3778_length_1215_cov_15.074373	717	797	2	52	80	0.6500000
NODE_3778_length_1215_cov_15.074373	717	797	4	15	80	0.1875000
NODE_3779_length_1215_cov_5.932796	507	587	0	80	80	1.0000000
NODE_3779_length_1215_cov_5.932796	560	640	0	80	80	1.0000000
NODE_3787_length_1214_cov_26.771300	420	500	61	1	80	0.0125000
NODE_3787_length_1214_cov_26.771300	420	500	63	2	80	0.0250000
NODE_3787_length_1214_cov_26.771300	420	500	65	1	80	0.0125000
NODE_3787_length_1214_cov_26.771300	420	500	69	1	80	0.0125000
NODE_3787_length_1214_cov_26.771300	420	500	75	1	80	0.0125000
NODE_3787_length_1214_cov_26.771300	420	500	83	1	80	0.0125000
NODE_3787_length_1214_cov_26.771300	420	500	93	1	80	0.0125000
NODE_3787_length_1214_cov_26.771300	420	500	95	1	80	0.0125000
NODE_3787_length_1214_cov_26.771300	420	500	101	1	80	0.0125000
NODE_3787_length_1214_cov_26.771300	420	500	105	1	80	0.0125000
NODE_3787_length_1214_cov_26.771300	420	500	123	1	80	0.0125000
NODE_3787_length_1214_cov_26.771300	420	500	131	2	80	0.0250000
NODE_3787_length_1214_cov_26.771300	420	500	139	1	80	0.0125000
NODE_3787_length_1214_cov_26.771300	420	500	145	1	80	0.0125000
NODE_3787_length_1214_cov_26.771300	420	500	147	1	80	0.0125000
NODE_3787_length_1214_cov_26.771300	420	500	154	1	80	0.0125000
NODE_3787_length_1214_cov_26.771300	420	500	160	1	80	0.0125000
NODE_3787_length_1214_cov_26.771300	420	500	169	4	80	0.0500000
NODE_3787_length_1214_cov_26.771300	420	500	188	2	80	0.0250000
NODE_3787_length_1214_cov_26.771300	420	500	198	1	80	0.0125000
NODE_3787_length_1214_cov_26.771300	420	500	200	1	80	0.0125000
NODE_3787_length_1214_cov_26.771300	420	500	202	1	80	0.0125000
NODE_3787_length_1214_cov_26.771300	420	500	204	1	80	0.0125000
NODE_3787_length_1214_cov_26.771300	420	500	206	1	80	0.0125000
NODE_3787_length_1214_cov_26.771300	420	500	208	1	80	0.0125000
NODE_3787_length_1214_cov_26.771300	420	500	209	1	80	0.0125000
NODE_3787_length_1214_cov_26.771300	420	500	216	2	80	0.0250000
NODE_3787_length_1214_cov_26.771300	420	500	217	1	80	0.0125000
NODE_3787_length_1214_cov_26.771300	420	500	221	4	80	0.0500000
NODE_3787_length_1214_cov_26.771300	420	500	227	2	80	0.0250000
NODE_3787_length_1214_cov_26.771300	420	500	231	1	80	0.0125000
NODE_3787_length_1214_cov_26.771300	420	500	235	2	80	0.0250000
NODE_3787_length_1214_cov_26.771300	420	500	239	1	80	0.0125000
NODE_3787_length_1214_cov_26.771300	420	500	241	1	80	0.0125000
NODE_3787_length_1214_cov_26.771300	420	500	242	1	80	0.0125000
NODE_3787_length_1214_cov_26.771300	420	500	245	1	80	0.0125000
NODE_3787_length_1214_cov_26.771300	420	500	248	1	80	0.0125000
NODE_3787_length_1214_cov_26.771300	420	500	249	1	80	0.0125000
NODE_3787_length_1214_cov_26.771300	420	500	250	1	80	0.0125000
NODE_3787_length_1214_cov_26.771300	420	500	252	5	80	0.0625000
NODE_3787_length_1214_cov_26.771300	420	500	253	1	80	0.0125000
NODE_3787_length_1214_cov_26.771300	420	500	255	3	80	0.0375000
NODE_3787_length_1214_cov_26.771300	420	500	257	8	80	0.1000000
NODE_3787_length_1214_cov_26.771300	420	500	259	4	80	0.0500000
NODE_3787_length_1214_cov_26.771300	420	500	261	5	80	0.0625000
NODE_3787_length_1214_cov_26.771300	420	500	263	3	80	0.0375000
NODE_3787_length_1214_cov_26.771300	473	553	51	1	80	0.0125000
NODE_3787_length_1214_cov_26.771300	473	553	66	1	80	0.0125000
NODE_3787_length_1214_cov_26.771300	473	553	70	1	80	0.0125000
NODE_3787_length_1214_cov_26.771300	473	553	76	1	80	0.0125000
NODE_3787_length_1214_cov_26.771300	473	553	86	1	80	0.0125000
NODE_3787_length_1214_cov_26.771300	473	553	94	1	80	0.0125000
NODE_3787_length_1214_cov_26.771300	473	553	107	1	80	0.0125000
NODE_3787_length_1214_cov_26.771300	473	553	112	3	80	0.0375000
NODE_3787_length_1214_cov_26.771300	473	553	116	1	80	0.0125000
NODE_3787_length_1214_cov_26.771300	473	553	118	1	80	0.0125000
NODE_3787_length_1214_cov_26.771300	473	553	122	1	80	0.0125000
NODE_3787_length_1214_cov_26.771300	473	553	126	1	80	0.0125000
NODE_3787_length_1214_cov_26.771300	473	553	128	3	80	0.0375000
NODE_3787_length_1214_cov_26.771300	473	553	130	1	80	0.0125000
NODE_3787_length_1214_cov_26.771300	473	553	135	1	80	0.0125000
NODE_3787_length_1214_cov_26.771300	473	553	139	1	80	0.0125000
NODE_3787_length_1214_cov_26.771300	473	553	146	1	80	0.0125000
NODE_3787_length_1214_cov_26.771300	473	553	148	1	80	0.0125000
NODE_3787_length_1214_cov_26.771300	473	553	155	1	80	0.0125000
NODE_3787_length_1214_cov_26.771300	473	553	160	2	80	0.0250000
NODE_3787_length_1214_cov_26.771300	473	553	169	1	80	0.0125000
NODE_3787_length_1214_cov_26.771300	473	553	174	1	80	0.0125000
NODE_3787_length_1214_cov_26.771300	473	553	175	2	80	0.0250000
NODE_3787_length_1214_cov_26.771300	473	553	177	1	80	0.0125000
NODE_3787_length_1214_cov_26.771300	473	553	179	2	80	0.0250000
NODE_3787_length_1214_cov_26.771300	473	553	185	1	80	0.0125000
NODE_3787_length_1214_cov_26.771300	473	553	189	2	80	0.0250000
NODE_3787_length_1214_cov_26.771300	473	553	192	1	80	0.0125000
NODE_3787_length_1214_cov_26.771300	473	553	199	1	80	0.0125000
NODE_3787_length_1214_cov_26.771300	473	553	201	1	80	0.0125000
NODE_3787_length_1214_cov_26.771300	473	553	215	1	80	0.0125000
NODE_3787_length_1214_cov_26.771300	473	553	225	1	80	0.0125000
NODE_3787_length_1214_cov_26.771300	473	553	227	3	80	0.0375000
NODE_3787_length_1214_cov_26.771300	473	553	229	2	80	0.0250000
NODE_3787_length_1214_cov_26.771300	473	553	231	1	80	0.0125000
NODE_3787_length_1214_cov_26.771300	473	553	235	1	80	0.0125000
NODE_3787_length_1214_cov_26.771300	473	553	240	3	80	0.0375000
NODE_3787_length_1214_cov_26.771300	473	553	242	4	80	0.0500000
NODE_3787_length_1214_cov_26.771300	473	553	249	1	80	0.0125000
NODE_3787_length_1214_cov_26.771300	473	553	252	1	80	0.0125000
NODE_3787_length_1214_cov_26.771300	473	553	253	1	80	0.0125000
NODE_3787_length_1214_cov_26.771300	473	553	255	3	80	0.0375000
NODE_3787_length_1214_cov_26.771300	473	553	257	8	80	0.1000000
NODE_3787_length_1214_cov_26.771300	473	553	259	4	80	0.0500000
NODE_3787_length_1214_cov_26.771300	473	553	261	5	80	0.0625000
NODE_3787_length_1214_cov_26.771300	473	553	263	3	80	0.0375000
NODE_3788_length_1214_cov_24.555157	480	560	0	5	80	0.0625000
NODE_3788_length_1214_cov_24.555157	480	560	2	75	80	0.9375000
NODE_3788_length_1214_cov_24.555157	533	613	0	58	80	0.7250000
NODE_3788_length_1214_cov_24.555157	533	613	2	22	80	0.2750000
NODE_3789_length_1214_cov_23.167713	623	703	0	19	80	0.2375000
NODE_3789_length_1214_cov_23.167713	623	703	4	61	80	0.7625000
NODE_3789_length_1214_cov_23.167713	676	756	0	72	80	0.9000000
NODE_3789_length_1214_cov_23.167713	676	756	4	8	80	0.1000000
NODE_3790_length_1214_cov_18.452915	555	635	0	80	80	1.0000000
NODE_3790_length_1214_cov_18.452915	608	688	0	80	80	1.0000000
NODE_3790_length_1214_cov_18.452915	684	764	0	80	80	1.0000000
NODE_3790_length_1214_cov_18.452915	737	817	0	80	80	1.0000000
NODE_3791_length_1214_cov_8.906726	206	286	0	7	80	0.0875000
NODE_3791_length_1214_cov_8.906726	206	286	1	20	80	0.2500000
NODE_3791_length_1214_cov_8.906726	206	286	4	39	80	0.4875000
NODE_3791_length_1214_cov_8.906726	206	286	6	14	80	0.1750000
NODE_3791_length_1214_cov_8.906726	259	339	2	4	80	0.0500000
NODE_3791_length_1214_cov_8.906726	259	339	4	13	80	0.1625000
NODE_3791_length_1214_cov_8.906726	259	339	6	63	80	0.7875000
NODE_3792_length_1214_cov_3.686996	415	495	0	80	80	1.0000000
NODE_3792_length_1214_cov_3.686996	468	548	0	80	80	1.0000000
NODE_3799_length_1214_cov_0.967713	1049	1129	189	1	80	0.0125000
NODE_3799_length_1214_cov_0.967713	1049	1129	192	1	80	0.0125000
NODE_3799_length_1214_cov_0.967713	1049	1129	195	1	80	0.0125000
NODE_3799_length_1214_cov_0.967713	1049	1129	196	1	80	0.0125000
NODE_3799_length_1214_cov_0.967713	1049	1129	199	1	80	0.0125000
NODE_3799_length_1214_cov_0.967713	1049	1129	209	1	80	0.0125000
NODE_3799_length_1214_cov_0.967713	1049	1129	211	2	80	0.0250000
NODE_3799_length_1214_cov_0.967713	1049	1129	229	1	80	0.0125000
NODE_3799_length_1214_cov_0.967713	1049	1129	237	1	80	0.0125000
NODE_3799_length_1214_cov_0.967713	1049	1129	253	1	80	0.0125000
NODE_3799_length_1214_cov_0.967713	1049	1129	255	1	80	0.0125000
NODE_3799_length_1214_cov_0.967713	1049	1129	279	1	80	0.0125000
NODE_3799_length_1214_cov_0.967713	1049	1129	288	1	80	0.0125000
NODE_3799_length_1214_cov_0.967713	1049	1129	294	1	80	0.0125000
NODE_3799_length_1214_cov_0.967713	1049	1129	299	1	80	0.0125000
NODE_3799_length_1214_cov_0.967713	1049	1129	305	1	80	0.0125000
NODE_3799_length_1214_cov_0.967713	1049	1129	307	1	80	0.0125000
NODE_3799_length_1214_cov_0.967713	1049	1129	313	2	80	0.0250000
NODE_3799_length_1214_cov_0.967713	1049	1129	320	3	80	0.0375000
NODE_3799_length_1214_cov_0.967713	1049	1129	323	1	80	0.0125000
NODE_3799_length_1214_cov_0.967713	1049	1129	325	1	80	0.0125000
NODE_3799_length_1214_cov_0.967713	1049	1129	329	2	80	0.0250000
NODE_3799_length_1214_cov_0.967713	1049	1129	331	2	80	0.0250000
NODE_3799_length_1214_cov_0.967713	1049	1129	338	1	80	0.0125000
NODE_3799_length_1214_cov_0.967713	1049	1129	340	1	80	0.0125000
NODE_3799_length_1214_cov_0.967713	1049	1129	349	1	80	0.0125000
NODE_3799_length_1214_cov_0.967713	1049	1129	351	1	80	0.0125000
NODE_3799_length_1214_cov_0.967713	1049	1129	352	3	80	0.0375000
NODE_3799_length_1214_cov_0.967713	1049	1129	354	4	80	0.0500000
NODE_3799_length_1214_cov_0.967713	1049	1129	355	1	80	0.0125000
NODE_3799_length_1214_cov_0.967713	1049	1129	363	3	80	0.0375000
NODE_3799_length_1214_cov_0.967713	1049	1129	365	1	80	0.0125000
NODE_3799_length_1214_cov_0.967713	1049	1129	366	1	80	0.0125000
NODE_3799_length_1214_cov_0.967713	1049	1129	367	1	80	0.0125000
NODE_3799_length_1214_cov_0.967713	1049	1129	368	4	80	0.0500000
NODE_3799_length_1214_cov_0.967713	1049	1129	369	1	80	0.0125000
NODE_3799_length_1214_cov_0.967713	1049	1129	372	1	80	0.0125000
NODE_3799_length_1214_cov_0.967713	1049	1129	379	1	80	0.0125000
NODE_3799_length_1214_cov_0.967713	1049	1129	381	2	80	0.0250000
NODE_3799_length_1214_cov_0.967713	1049	1129	382	2	80	0.0250000
NODE_3799_length_1214_cov_0.967713	1049	1129	383	3	80	0.0375000
NODE_3799_length_1214_cov_0.967713	1049	1129	384	3	80	0.0375000
NODE_3799_length_1214_cov_0.967713	1049	1129	385	1	80	0.0125000
NODE_3799_length_1214_cov_0.967713	1049	1129	386	2	80	0.0250000
NODE_3799_length_1214_cov_0.967713	1049	1129	387	5	80	0.0625000
NODE_3799_length_1214_cov_0.967713	1049	1129	388	3	80	0.0375000
NODE_3799_length_1214_cov_0.967713	1049	1129	389	1	80	0.0125000
NODE_3799_length_1214_cov_0.967713	1049	1129	390	2	80	0.0250000
NODE_3799_length_1214_cov_0.967713	1049	1129	391	2	80	0.0250000
NODE_3800_length_1213_cov_19.524237	499	579	2	80	80	1.0000000
NODE_3800_length_1213_cov_19.524237	552	632	0	41	80	0.5125000
NODE_3800_length_1213_cov_19.524237	552	632	2	39	80	0.4875000
NODE_3806_length_1212_cov_32.663073	688	768	2	80	80	1.0000000
NODE_3806_length_1212_cov_32.663073	741	821	0	44	80	0.5500000
NODE_3806_length_1212_cov_32.663073	741	821	2	36	80	0.4500000
NODE_3807_length_1212_cov_15.981132	33	113	16	2	80	0.0250000
NODE_3807_length_1212_cov_15.981132	33	113	18	3	80	0.0375000
NODE_3807_length_1212_cov_15.981132	33	113	19	8	80	0.1000000
NODE_3807_length_1212_cov_15.981132	33	113	20	12	80	0.1500000
NODE_3807_length_1212_cov_15.981132	33	113	22	27	80	0.3375000
NODE_3807_length_1212_cov_15.981132	33	113	24	28	80	0.3500000
NODE_3807_length_1212_cov_15.981132	511	591	2	80	80	1.0000000
NODE_3807_length_1212_cov_15.981132	564	637	0	32	73	0.4383562
NODE_3807_length_1212_cov_15.981132	564	637	2	41	73	0.5616438
NODE_3813_length_1211_cov_30.513489	561	641	0	80	80	1.0000000
NODE_3813_length_1211_cov_30.513489	614	694	0	80	80	1.0000000
NODE_3813_length_1211_cov_30.513489	690	770	0	80	80	1.0000000
NODE_3813_length_1211_cov_30.513489	743	823	0	80	80	1.0000000
NODE_3815_length_1211_cov_10.073741	380	460	0	80	80	1.0000000
NODE_3815_length_1211_cov_10.073741	433	513	0	80	80	1.0000000
NODE_3816_length_1211_cov_7.561151	598	678	0	80	80	1.0000000
NODE_3816_length_1211_cov_7.561151	651	731	0	80	80	1.0000000
NODE_3820_length_1210_cov_49.743474	398	478	0	11	80	0.1375000
NODE_3820_length_1210_cov_49.743474	398	478	6	24	80	0.3000000
NODE_3820_length_1210_cov_49.743474	398	478	8	45	80	0.5625000
NODE_3820_length_1210_cov_49.743474	451	531	2	20	80	0.2500000
NODE_3820_length_1210_cov_49.743474	451	531	8	60	80	0.7500000
NODE_3821_length_1210_cov_15.647165	647	727	0	80	80	1.0000000
NODE_3821_length_1210_cov_15.647165	700	780	0	80	80	1.0000000
NODE_3822_length_1210_cov_11.194419	794	874	1	2	80	0.0250000
NODE_3822_length_1210_cov_11.194419	794	874	2	78	80	0.9750000
NODE_3822_length_1210_cov_11.194419	847	927	0	51	80	0.6375000
NODE_3822_length_1210_cov_11.194419	847	927	1	4	80	0.0500000
NODE_3822_length_1210_cov_11.194419	847	927	2	25	80	0.3125000
NODE_3826_length_1209_cov_24.504505	582	662	0	13	80	0.1625000
NODE_3826_length_1209_cov_24.504505	582	662	2	67	80	0.8375000
NODE_3826_length_1209_cov_24.504505	635	715	2	57	80	0.7125000
NODE_3826_length_1209_cov_24.504505	635	715	3	2	80	0.0250000
NODE_3826_length_1209_cov_24.504505	635	715	4	21	80	0.2625000
NODE_3826_length_1209_cov_24.504505	711	791	0	1	80	0.0125000
NODE_3826_length_1209_cov_24.504505	711	791	2	79	80	0.9875000
NODE_3826_length_1209_cov_24.504505	764	844	0	54	80	0.6750000
NODE_3826_length_1209_cov_24.504505	764	844	2	26	80	0.3250000
NODE_3827_length_1209_cov_21.846847	520	600	0	44	80	0.5500000
NODE_3827_length_1209_cov_21.846847	520	600	2	36	80	0.4500000
NODE_3827_length_1209_cov_21.846847	573	653	0	80	80	1.0000000
NODE_3827_length_1209_cov_21.846847	649	729	0	62	80	0.7750000
NODE_3827_length_1209_cov_21.846847	649	729	2	18	80	0.2250000
NODE_3827_length_1209_cov_21.846847	702	782	0	9	80	0.1125000
NODE_3827_length_1209_cov_21.846847	702	782	2	71	80	0.8875000
NODE_3828_length_1209_cov_9.026126	782	862	0	63	80	0.7875000
NODE_3828_length_1209_cov_9.026126	782	862	2	17	80	0.2125000
NODE_3828_length_1209_cov_9.026126	835	915	0	80	80	1.0000000
NODE_3830_length_1209_cov_5.721622	926	1006	2	80	80	1.0000000
NODE_3830_length_1209_cov_5.721622	979	1059	2	80	80	1.0000000
NODE_3833_length_1208_cov_40.717764	886	966	82	1	80	0.0125000
NODE_3833_length_1208_cov_40.717764	886	966	83	2	80	0.0250000
NODE_3833_length_1208_cov_40.717764	886	966	84	6	80	0.0750000
NODE_3833_length_1208_cov_40.717764	886	966	85	1	80	0.0125000
NODE_3833_length_1208_cov_40.717764	886	966	87	1	80	0.0125000
NODE_3833_length_1208_cov_40.717764	886	966	88	4	80	0.0500000
NODE_3833_length_1208_cov_40.717764	886	966	90	2	80	0.0250000
NODE_3833_length_1208_cov_40.717764	886	966	91	5	80	0.0625000
NODE_3833_length_1208_cov_40.717764	886	966	92	1	80	0.0125000
NODE_3833_length_1208_cov_40.717764	886	966	95	1	80	0.0125000
NODE_3833_length_1208_cov_40.717764	886	966	97	1	80	0.0125000
NODE_3833_length_1208_cov_40.717764	886	966	101	1	80	0.0125000
NODE_3833_length_1208_cov_40.717764	886	966	103	2	80	0.0250000
NODE_3833_length_1208_cov_40.717764	886	966	105	2	80	0.0250000
NODE_3833_length_1208_cov_40.717764	886	966	107	2	80	0.0250000
NODE_3833_length_1208_cov_40.717764	886	966	111	1	80	0.0125000
NODE_3833_length_1208_cov_40.717764	886	966	113	1	80	0.0125000
NODE_3833_length_1208_cov_40.717764	886	966	114	2	80	0.0250000
NODE_3833_length_1208_cov_40.717764	886	966	118	2	80	0.0250000
NODE_3833_length_1208_cov_40.717764	886	966	122	1	80	0.0125000
NODE_3833_length_1208_cov_40.717764	886	966	124	1	80	0.0125000
NODE_3833_length_1208_cov_40.717764	886	966	134	1	80	0.0125000
NODE_3833_length_1208_cov_40.717764	886	966	137	3	80	0.0375000
NODE_3833_length_1208_cov_40.717764	886	966	138	2	80	0.0250000
NODE_3833_length_1208_cov_40.717764	886	966	139	2	80	0.0250000
NODE_3833_length_1208_cov_40.717764	886	966	140	1	80	0.0125000
NODE_3833_length_1208_cov_40.717764	886	966	145	1	80	0.0125000
NODE_3833_length_1208_cov_40.717764	886	966	149	1	80	0.0125000
NODE_3833_length_1208_cov_40.717764	886	966	152	2	80	0.0250000
NODE_3833_length_1208_cov_40.717764	886	966	167	1	80	0.0125000
NODE_3833_length_1208_cov_40.717764	886	966	171	1	80	0.0125000
NODE_3833_length_1208_cov_40.717764	886	966	178	1	80	0.0125000
NODE_3833_length_1208_cov_40.717764	886	966	191	1	80	0.0125000
NODE_3833_length_1208_cov_40.717764	886	966	199	1	80	0.0125000
NODE_3833_length_1208_cov_40.717764	886	966	201	1	80	0.0125000
NODE_3833_length_1208_cov_40.717764	886	966	206	1	80	0.0125000
NODE_3833_length_1208_cov_40.717764	886	966	216	1	80	0.0125000
NODE_3833_length_1208_cov_40.717764	886	966	220	1	80	0.0125000
NODE_3833_length_1208_cov_40.717764	886	966	222	1	80	0.0125000
NODE_3833_length_1208_cov_40.717764	886	966	224	1	80	0.0125000
NODE_3833_length_1208_cov_40.717764	886	966	228	1	80	0.0125000
NODE_3833_length_1208_cov_40.717764	886	966	236	1	80	0.0125000
NODE_3833_length_1208_cov_40.717764	886	966	242	1	80	0.0125000
NODE_3833_length_1208_cov_40.717764	886	966	255	1	80	0.0125000
NODE_3833_length_1208_cov_40.717764	886	966	265	1	80	0.0125000
NODE_3833_length_1208_cov_40.717764	886	966	277	1	80	0.0125000
NODE_3833_length_1208_cov_40.717764	886	966	281	1	80	0.0125000
NODE_3833_length_1208_cov_40.717764	886	966	294	1	80	0.0125000
NODE_3833_length_1208_cov_40.717764	886	966	308	1	80	0.0125000
NODE_3833_length_1208_cov_40.717764	886	966	329	1	80	0.0125000
NODE_3833_length_1208_cov_40.717764	886	966	341	1	80	0.0125000
NODE_3833_length_1208_cov_40.717764	886	966	370	1	80	0.0125000
NODE_3833_length_1208_cov_40.717764	886	966	374	1	80	0.0125000
NODE_3833_length_1208_cov_40.717764	886	966	380	1	80	0.0125000
NODE_3833_length_1208_cov_40.717764	886	966	401	1	80	0.0125000
NODE_3833_length_1208_cov_40.717764	886	966	420	1	80	0.0125000
NODE_3833_length_1208_cov_40.717764	939	985	167	1	46	0.0217391
NODE_3833_length_1208_cov_40.717764	939	985	171	1	46	0.0217391
NODE_3833_length_1208_cov_40.717764	939	985	178	1	46	0.0217391
NODE_3833_length_1208_cov_40.717764	939	985	191	1	46	0.0217391
NODE_3833_length_1208_cov_40.717764	939	985	199	1	46	0.0217391
NODE_3833_length_1208_cov_40.717764	939	985	201	1	46	0.0217391
NODE_3833_length_1208_cov_40.717764	939	985	206	1	46	0.0217391
NODE_3833_length_1208_cov_40.717764	939	985	216	1	46	0.0217391
NODE_3833_length_1208_cov_40.717764	939	985	220	1	46	0.0217391
NODE_3833_length_1208_cov_40.717764	939	985	222	1	46	0.0217391
NODE_3833_length_1208_cov_40.717764	939	985	224	1	46	0.0217391
NODE_3833_length_1208_cov_40.717764	939	985	228	1	46	0.0217391
NODE_3833_length_1208_cov_40.717764	939	985	236	1	46	0.0217391
NODE_3833_length_1208_cov_40.717764	939	985	242	1	46	0.0217391
NODE_3833_length_1208_cov_40.717764	939	985	255	1	46	0.0217391
NODE_3833_length_1208_cov_40.717764	939	985	265	1	46	0.0217391
NODE_3833_length_1208_cov_40.717764	939	985	277	1	46	0.0217391
NODE_3833_length_1208_cov_40.717764	939	985	281	1	46	0.0217391
NODE_3833_length_1208_cov_40.717764	939	985	294	1	46	0.0217391
NODE_3833_length_1208_cov_40.717764	939	985	308	1	46	0.0217391
NODE_3833_length_1208_cov_40.717764	939	985	329	1	46	0.0217391
NODE_3833_length_1208_cov_40.717764	939	985	341	1	46	0.0217391
NODE_3833_length_1208_cov_40.717764	939	985	370	1	46	0.0217391
NODE_3833_length_1208_cov_40.717764	939	985	374	1	46	0.0217391
NODE_3833_length_1208_cov_40.717764	939	985	380	1	46	0.0217391
NODE_3833_length_1208_cov_40.717764	939	985	401	1	46	0.0217391
NODE_3833_length_1208_cov_40.717764	939	985	420	1	46	0.0217391
NODE_3833_length_1208_cov_40.717764	939	985	438	1	46	0.0217391
NODE_3833_length_1208_cov_40.717764	939	985	453	1	46	0.0217391
NODE_3833_length_1208_cov_40.717764	939	985	472	1	46	0.0217391
NODE_3833_length_1208_cov_40.717764	939	985	504	1	46	0.0217391
NODE_3833_length_1208_cov_40.717764	939	985	524	1	46	0.0217391
NODE_3833_length_1208_cov_40.717764	939	985	541	1	46	0.0217391
NODE_3833_length_1208_cov_40.717764	939	985	547	1	46	0.0217391
NODE_3833_length_1208_cov_40.717764	939	985	580	1	46	0.0217391
NODE_3833_length_1208_cov_40.717764	939	985	592	1	46	0.0217391
NODE_3833_length_1208_cov_40.717764	939	985	593	1	46	0.0217391
NODE_3833_length_1208_cov_40.717764	939	985	604	1	46	0.0217391
NODE_3833_length_1208_cov_40.717764	939	985	616	1	46	0.0217391
NODE_3833_length_1208_cov_40.717764	939	985	626	1	46	0.0217391
NODE_3833_length_1208_cov_40.717764	939	985	647	1	46	0.0217391
NODE_3833_length_1208_cov_40.717764	939	985	652	1	46	0.0217391
NODE_3833_length_1208_cov_40.717764	939	985	670	1	46	0.0217391
NODE_3833_length_1208_cov_40.717764	939	985	672	1	46	0.0217391
NODE_3833_length_1208_cov_40.717764	939	985	675	1	46	0.0217391
NODE_3833_length_1208_cov_40.717764	939	985	682	1	46	0.0217391
NODE_3834_length_1208_cov_28.528404	614	694	0	22	80	0.2750000
NODE_3834_length_1208_cov_28.528404	614	694	2	1	80	0.0125000
NODE_3834_length_1208_cov_28.528404	614	694	4	36	80	0.4500000
NODE_3834_length_1208_cov_28.528404	614	694	5	16	80	0.2000000
NODE_3834_length_1208_cov_28.528404	614	694	6	5	80	0.0625000
NODE_3834_length_1208_cov_28.528404	667	747	0	75	80	0.9375000
NODE_3834_length_1208_cov_28.528404	667	747	2	1	80	0.0125000
NODE_3834_length_1208_cov_28.528404	667	747	4	4	80	0.0500000
NODE_3835_length_1208_cov_19.688007	682	762	0	80	80	1.0000000
NODE_3835_length_1208_cov_19.688007	735	815	0	80	80	1.0000000
NODE_3836_length_1208_cov_18.577096	455	535	0	80	80	1.0000000
NODE_3836_length_1208_cov_18.577096	508	588	0	80	80	1.0000000
NODE_3836_length_1208_cov_18.577096	584	664	0	42	80	0.5250000
NODE_3836_length_1208_cov_18.577096	584	664	2	38	80	0.4750000
NODE_3836_length_1208_cov_18.577096	637	717	0	6	80	0.0750000
NODE_3836_length_1208_cov_18.577096	637	717	2	74	80	0.9250000
NODE_3837_length_1208_cov_12.733995	766	846	0	80	80	1.0000000
NODE_3837_length_1208_cov_12.733995	819	899	0	57	80	0.7125000
NODE_3837_length_1208_cov_12.733995	819	899	2	23	80	0.2875000
NODE_3837_length_1208_cov_12.733995	895	975	2	57	80	0.7125000
NODE_3837_length_1208_cov_12.733995	895	975	6	23	80	0.2875000
NODE_3837_length_1208_cov_12.733995	948	1028	2	4	80	0.0500000
NODE_3837_length_1208_cov_12.733995	948	1028	6	31	80	0.3875000
NODE_3837_length_1208_cov_12.733995	948	1028	8	45	80	0.5625000
NODE_3838_length_1207_cov_20.461191	874	954	0	15	80	0.1875000
NODE_3838_length_1207_cov_20.461191	874	954	6	65	80	0.8125000
NODE_3838_length_1207_cov_20.461191	927	1007	0	68	80	0.8500000
NODE_3838_length_1207_cov_20.461191	927	1007	6	12	80	0.1500000
NODE_3846_length_1206_cov_59.851852	540	620	0	32	80	0.4000000
NODE_3846_length_1206_cov_59.851852	540	620	4	31	80	0.3875000
NODE_3846_length_1206_cov_59.851852	540	620	6	17	80	0.2125000
NODE_3846_length_1206_cov_59.851852	593	673	2	24	80	0.3000000
NODE_3846_length_1206_cov_59.851852	593	673	4	10	80	0.1250000
NODE_3846_length_1206_cov_59.851852	593	673	6	46	80	0.5750000
NODE_3846_length_1206_cov_59.851852	669	749	0	70	80	0.8750000
NODE_3846_length_1206_cov_59.851852	669	749	2	10	80	0.1250000
NODE_3846_length_1206_cov_59.851852	722	802	0	80	80	1.0000000
NODE_3847_length_1206_cov_23.752484	669	749	0	80	80	1.0000000
NODE_3847_length_1206_cov_23.752484	722	802	0	80	80	1.0000000
NODE_3848_length_1206_cov_21.226739	585	665	2	52	80	0.6500000
NODE_3848_length_1206_cov_21.226739	585	665	4	28	80	0.3500000
NODE_3848_length_1206_cov_21.226739	638	718	0	51	80	0.6375000
NODE_3848_length_1206_cov_21.226739	638	718	2	29	80	0.3625000
NODE_3855_length_1205_cov_23.990054	355	435	0	43	80	0.5375000
NODE_3855_length_1205_cov_23.990054	355	435	1	4	80	0.0500000
NODE_3855_length_1205_cov_23.990054	355	435	2	33	80	0.4125000
NODE_3855_length_1205_cov_23.990054	408	488	2	80	80	1.0000000
NODE_3856_length_1205_cov_10.473779	780	860	0	80	80	1.0000000
NODE_3856_length_1205_cov_10.473779	833	913	0	80	80	1.0000000
NODE_3863_length_1204_cov_19.396380	537	617	0	17	80	0.2125000
NODE_3863_length_1204_cov_19.396380	537	617	2	40	80	0.5000000
NODE_3863_length_1204_cov_19.396380	537	617	4	23	80	0.2875000
NODE_3863_length_1204_cov_19.396380	590	670	0	12	80	0.1500000
NODE_3863_length_1204_cov_19.396380	590	670	2	17	80	0.2125000
NODE_3863_length_1204_cov_19.396380	590	670	4	51	80	0.6375000
NODE_3864_length_1204_cov_17.716742	448	528	1	17	80	0.2125000
NODE_3864_length_1204_cov_17.716742	448	528	2	63	80	0.7875000
NODE_3864_length_1204_cov_17.716742	501	581	1	13	80	0.1625000
NODE_3864_length_1204_cov_17.716742	501	581	2	60	80	0.7500000
NODE_3864_length_1204_cov_17.716742	501	581	3	7	80	0.0875000
NODE_3865_length_1204_cov_15.206335	426	506	0	14	80	0.1750000
NODE_3865_length_1204_cov_15.206335	426	506	5	1	80	0.0125000
NODE_3865_length_1204_cov_15.206335	426	506	6	65	80	0.8125000
NODE_3865_length_1204_cov_15.206335	479	559	0	9	80	0.1125000
NODE_3865_length_1204_cov_15.206335	479	559	6	71	80	0.8875000
NODE_3866_length_1204_cov_14.097738	632	712	0	46	80	0.5750000
NODE_3866_length_1204_cov_14.097738	632	712	2	32	80	0.4000000
NODE_3866_length_1204_cov_14.097738	632	712	4	2	80	0.0250000
NODE_3866_length_1204_cov_14.097738	685	765	2	28	80	0.3500000
NODE_3866_length_1204_cov_14.097738	685	765	4	52	80	0.6500000
NODE_3867_length_1204_cov_11.971946	549	629	2	47	80	0.5875000
NODE_3867_length_1204_cov_11.971946	549	629	4	33	80	0.4125000
NODE_3867_length_1204_cov_11.971946	602	682	0	31	80	0.3875000
NODE_3867_length_1204_cov_11.971946	602	682	2	49	80	0.6125000
NODE_3867_length_1204_cov_11.971946	678	758	2	58	80	0.7250000
NODE_3867_length_1204_cov_11.971946	678	758	4	22	80	0.2750000
NODE_3867_length_1204_cov_11.971946	731	811	0	7	80	0.0875000
NODE_3867_length_1204_cov_11.971946	731	811	2	19	80	0.2375000
NODE_3867_length_1204_cov_11.971946	731	811	4	54	80	0.6750000
NODE_3868_length_1204_cov_11.665158	499	579	0	7	80	0.0875000
NODE_3868_length_1204_cov_11.665158	499	579	2	73	80	0.9125000
NODE_3868_length_1204_cov_11.665158	552	632	0	60	80	0.7500000
NODE_3868_length_1204_cov_11.665158	552	632	2	20	80	0.2500000
NODE_3869_length_1204_cov_7.028959	637	717	0	15	80	0.1875000
NODE_3869_length_1204_cov_7.028959	637	717	2	6	80	0.0750000
NODE_3869_length_1204_cov_7.028959	637	717	4	3	80	0.0375000
NODE_3869_length_1204_cov_7.028959	637	717	6	56	80	0.7000000
NODE_3869_length_1204_cov_7.028959	690	770	0	22	80	0.2750000
NODE_3869_length_1204_cov_7.028959	690	770	2	19	80	0.2375000
NODE_3869_length_1204_cov_7.028959	690	770	4	8	80	0.1000000
NODE_3869_length_1204_cov_7.028959	690	770	6	31	80	0.3875000
NODE_3870_length_1204_cov_4.677828	807	887	0	52	80	0.6500000
NODE_3870_length_1204_cov_4.677828	807	887	2	28	80	0.3500000
NODE_3870_length_1204_cov_4.677828	860	940	0	80	80	1.0000000
NODE_3873_length_1203_cov_46.789855	515	595	8	22	80	0.2750000
NODE_3873_length_1203_cov_46.789855	515	595	10	58	80	0.7250000
NODE_3873_length_1203_cov_46.789855	568	648	0	12	80	0.1500000
NODE_3873_length_1203_cov_46.789855	568	648	4	27	80	0.3375000
NODE_3873_length_1203_cov_46.789855	568	648	8	36	80	0.4500000
NODE_3873_length_1203_cov_46.789855	568	648	10	5	80	0.0625000
NODE_3873_length_1203_cov_46.789855	644	724	0	63	80	0.7875000
NODE_3873_length_1203_cov_46.789855	644	724	2	17	80	0.2125000
NODE_3873_length_1203_cov_46.789855	697	777	0	10	80	0.1250000
NODE_3873_length_1203_cov_46.789855	697	777	2	64	80	0.8000000
NODE_3873_length_1203_cov_46.789855	697	777	4	6	80	0.0750000
NODE_3874_length_1203_cov_44.029891	471	551	1	80	80	1.0000000
NODE_3874_length_1203_cov_44.029891	524	604	0	47	80	0.5875000
NODE_3874_length_1203_cov_44.029891	524	604	1	33	80	0.4125000
NODE_3874_length_1203_cov_44.029891	600	680	0	29	80	0.3625000
NODE_3874_length_1203_cov_44.029891	600	680	2	51	80	0.6375000
NODE_3874_length_1203_cov_44.029891	653	733	0	22	80	0.2750000
NODE_3874_length_1203_cov_44.029891	653	733	2	58	80	0.7250000
NODE_3875_length_1203_cov_23.790761	308	388	0	80	80	1.0000000
NODE_3875_length_1203_cov_23.790761	361	441	0	80	80	1.0000000
NODE_3875_length_1203_cov_23.790761	437	517	0	74	80	0.9250000
NODE_3875_length_1203_cov_23.790761	437	517	2	6	80	0.0750000
NODE_3875_length_1203_cov_23.790761	490	570	0	21	80	0.2625000
NODE_3875_length_1203_cov_23.790761	490	570	2	59	80	0.7375000
NODE_3876_length_1203_cov_19.498188	336	416	6	7	80	0.0875000
NODE_3876_length_1203_cov_19.498188	336	416	8	21	80	0.2625000
NODE_3876_length_1203_cov_19.498188	336	416	9	2	80	0.0250000
NODE_3876_length_1203_cov_19.498188	336	416	10	50	80	0.6250000
NODE_3876_length_1203_cov_19.498188	389	469	2	22	80	0.2750000
NODE_3876_length_1203_cov_19.498188	389	469	6	13	80	0.1625000
NODE_3876_length_1203_cov_19.498188	389	469	8	32	80	0.4000000
NODE_3876_length_1203_cov_19.498188	389	469	10	13	80	0.1625000
NODE_3877_length_1203_cov_10.996377	317	397	0	80	80	1.0000000
NODE_3877_length_1203_cov_10.996377	370	450	0	49	80	0.6125000
NODE_3877_length_1203_cov_10.996377	370	450	2	18	80	0.2250000
NODE_3877_length_1203_cov_10.996377	370	450	4	13	80	0.1625000
NODE_3878_length_1203_cov_5.747283	725	805	0	80	80	1.0000000
NODE_3878_length_1203_cov_5.747283	778	858	0	80	80	1.0000000
NODE_3881_length_1202_cov_39.333636	475	555	4	4	80	0.0500000
NODE_3881_length_1202_cov_39.333636	475	555	6	76	80	0.9500000
NODE_3881_length_1202_cov_39.333636	528	608	4	35	80	0.4375000
NODE_3881_length_1202_cov_39.333636	528	608	5	5	80	0.0625000
NODE_3881_length_1202_cov_39.333636	528	608	6	40	80	0.5000000
NODE_3881_length_1202_cov_39.333636	604	684	0	5	80	0.0625000
NODE_3881_length_1202_cov_39.333636	604	684	2	69	80	0.8625000
NODE_3881_length_1202_cov_39.333636	604	684	4	2	80	0.0250000
NODE_3881_length_1202_cov_39.333636	604	684	5	4	80	0.0500000
NODE_3881_length_1202_cov_39.333636	657	737	0	5	80	0.0625000
NODE_3881_length_1202_cov_39.333636	657	737	2	24	80	0.3000000
NODE_3881_length_1202_cov_39.333636	657	737	6	51	80	0.6375000
NODE_3882_length_1202_cov_17.556664	599	679	0	62	80	0.7750000
NODE_3882_length_1202_cov_17.556664	599	679	2	1	80	0.0125000
NODE_3882_length_1202_cov_17.556664	599	679	6	6	80	0.0750000
NODE_3882_length_1202_cov_17.556664	599	679	8	5	80	0.0625000
NODE_3882_length_1202_cov_17.556664	599	679	10	5	80	0.0625000
NODE_3882_length_1202_cov_17.556664	599	679	14	1	80	0.0125000
NODE_3882_length_1202_cov_17.556664	652	732	0	9	80	0.1125000
NODE_3882_length_1202_cov_17.556664	652	732	2	1	80	0.0125000
NODE_3882_length_1202_cov_17.556664	652	732	6	6	80	0.0750000
NODE_3882_length_1202_cov_17.556664	652	732	8	5	80	0.0625000
NODE_3882_length_1202_cov_17.556664	652	732	10	5	80	0.0625000
NODE_3882_length_1202_cov_17.556664	652	732	14	20	80	0.2500000
NODE_3882_length_1202_cov_17.556664	652	732	16	34	80	0.4250000
NODE_3883_length_1202_cov_12.338169	634	714	0	52	80	0.6500000
NODE_3883_length_1202_cov_12.338169	634	714	4	28	80	0.3500000
NODE_3883_length_1202_cov_12.338169	687	767	0	80	80	1.0000000
NODE_3884_length_1202_cov_11.800544	520	600	0	66	80	0.8250000
NODE_3884_length_1202_cov_11.800544	520	600	2	14	80	0.1750000
NODE_3884_length_1202_cov_11.800544	573	653	0	13	80	0.1625000
NODE_3884_length_1202_cov_11.800544	573	653	2	25	80	0.3125000
NODE_3884_length_1202_cov_11.800544	573	653	4	11	80	0.1375000
NODE_3884_length_1202_cov_11.800544	573	653	6	27	80	0.3375000
NODE_3884_length_1202_cov_11.800544	573	653	8	4	80	0.0500000
NODE_3887_length_1201_cov_12.161525	434	514	4	13	80	0.1625000
NODE_3887_length_1201_cov_12.161525	434	514	6	56	80	0.7000000
NODE_3887_length_1201_cov_12.161525	434	514	11	1	80	0.0125000
NODE_3887_length_1201_cov_12.161525	434	514	12	2	80	0.0250000
NODE_3887_length_1201_cov_12.161525	434	514	14	5	80	0.0625000
NODE_3887_length_1201_cov_12.161525	434	514	15	3	80	0.0375000
NODE_3887_length_1201_cov_12.161525	487	567	6	16	80	0.2000000
NODE_3887_length_1201_cov_12.161525	487	567	10	11	80	0.1375000
NODE_3887_length_1201_cov_12.161525	487	567	11	1	80	0.0125000
NODE_3887_length_1201_cov_12.161525	487	567	12	27	80	0.3375000
NODE_3887_length_1201_cov_12.161525	487	567	13	3	80	0.0375000
NODE_3887_length_1201_cov_12.161525	487	567	14	14	80	0.1750000
NODE_3887_length_1201_cov_12.161525	487	567	15	5	80	0.0625000
NODE_3887_length_1201_cov_12.161525	487	567	16	3	80	0.0375000
NODE_3888_length_1201_cov_12.046279	643	723	2	23	80	0.2875000
NODE_3888_length_1201_cov_12.046279	643	723	4	57	80	0.7125000
NODE_3888_length_1201_cov_12.046279	696	776	0	44	80	0.5500000
NODE_3888_length_1201_cov_12.046279	696	776	2	32	80	0.4000000
NODE_3888_length_1201_cov_12.046279	696	776	4	4	80	0.0500000
NODE_3891_length_1200_cov_76.694823	630	710	0	12	80	0.1500000
NODE_3891_length_1200_cov_76.694823	630	710	2	1	80	0.0125000
NODE_3891_length_1200_cov_76.694823	630	710	5	1	80	0.0125000
NODE_3891_length_1200_cov_76.694823	630	710	6	2	80	0.0250000
NODE_3891_length_1200_cov_76.694823	630	710	14	15	80	0.1875000
NODE_3891_length_1200_cov_76.694823	630	710	16	4	80	0.0500000
NODE_3891_length_1200_cov_76.694823	630	710	17	1	80	0.0125000
NODE_3891_length_1200_cov_76.694823	630	710	18	44	80	0.5500000
NODE_3891_length_1200_cov_76.694823	683	763	4	11	80	0.1375000
NODE_3891_length_1200_cov_76.694823	683	763	8	24	80	0.3000000
NODE_3891_length_1200_cov_76.694823	683	763	10	7	80	0.0875000
NODE_3891_length_1200_cov_76.694823	683	763	14	5	80	0.0625000
NODE_3891_length_1200_cov_76.694823	683	763	17	1	80	0.0125000
NODE_3891_length_1200_cov_76.694823	683	763	18	32	80	0.4000000
NODE_3891_length_1200_cov_76.694823	759	839	0	18	80	0.2250000
NODE_3891_length_1200_cov_76.694823	759	839	2	29	80	0.3625000
NODE_3891_length_1200_cov_76.694823	759	839	4	33	80	0.4125000
NODE_3891_length_1200_cov_76.694823	812	892	0	21	80	0.2625000
NODE_3891_length_1200_cov_76.694823	812	892	2	59	80	0.7375000
NODE_3892_length_1200_cov_16.881926	827	902	8	16	75	0.2133333
NODE_3892_length_1200_cov_16.881926	827	902	10	5	75	0.0666667
NODE_3892_length_1200_cov_16.881926	827	902	12	1	75	0.0133333
NODE_3892_length_1200_cov_16.881926	827	902	14	13	75	0.1733333
NODE_3892_length_1200_cov_16.881926	827	902	16	6	75	0.0800000
NODE_3892_length_1200_cov_16.881926	827	902	17	2	75	0.0266667
NODE_3892_length_1200_cov_16.881926	827	902	18	11	75	0.1466667
NODE_3892_length_1200_cov_16.881926	827	902	19	11	75	0.1466667
NODE_3892_length_1200_cov_16.881926	827	902	20	10	75	0.1333333
NODE_3892_length_1200_cov_16.881926	828	904	8	15	76	0.1973684
NODE_3892_length_1200_cov_16.881926	828	904	10	5	76	0.0657895
NODE_3892_length_1200_cov_16.881926	828	904	12	1	76	0.0131579
NODE_3892_length_1200_cov_16.881926	828	904	14	13	76	0.1710526
NODE_3892_length_1200_cov_16.881926	828	904	16	8	76	0.1052632
NODE_3892_length_1200_cov_16.881926	828	904	17	2	76	0.0263158
NODE_3892_length_1200_cov_16.881926	828	904	18	11	76	0.1447368
NODE_3892_length_1200_cov_16.881926	828	904	19	11	76	0.1447368
NODE_3892_length_1200_cov_16.881926	828	904	20	10	76	0.1315790
NODE_3892_length_1200_cov_16.881926	841	907	8	2	66	0.0303030
NODE_3892_length_1200_cov_16.881926	841	907	10	5	66	0.0757576
NODE_3892_length_1200_cov_16.881926	841	907	12	1	66	0.0151515
NODE_3892_length_1200_cov_16.881926	841	907	14	13	66	0.1969697
NODE_3892_length_1200_cov_16.881926	841	907	16	8	66	0.1212121
NODE_3892_length_1200_cov_16.881926	841	907	17	2	66	0.0303030
NODE_3892_length_1200_cov_16.881926	841	907	18	14	66	0.2121212
NODE_3892_length_1200_cov_16.881926	841	907	19	11	66	0.1666667
NODE_3892_length_1200_cov_16.881926	841	907	20	10	66	0.1515152
NODE_3892_length_1200_cov_16.881926	880	957	15	27	77	0.3506494
NODE_3892_length_1200_cov_16.881926	880	957	16	2	77	0.0259740
NODE_3892_length_1200_cov_16.881926	880	957	17	4	77	0.0519481
NODE_3892_length_1200_cov_16.881926	880	957	18	9	77	0.1168831
NODE_3892_length_1200_cov_16.881926	880	957	19	14	77	0.1818182
NODE_3892_length_1200_cov_16.881926	880	957	20	11	77	0.1428571
NODE_3892_length_1200_cov_16.881926	880	957	22	2	77	0.0259740
NODE_3892_length_1200_cov_16.881926	880	957	23	6	77	0.0779221
NODE_3892_length_1200_cov_16.881926	880	957	24	2	77	0.0259740
NODE_3892_length_1200_cov_16.881926	880	957	15	27	77	0.3506494
NODE_3892_length_1200_cov_16.881926	880	957	16	2	77	0.0259740
NODE_3892_length_1200_cov_16.881926	880	957	17	4	77	0.0519481
NODE_3892_length_1200_cov_16.881926	880	957	18	9	77	0.1168831
NODE_3892_length_1200_cov_16.881926	880	957	19	14	77	0.1818182
NODE_3892_length_1200_cov_16.881926	880	957	20	11	77	0.1428571
NODE_3892_length_1200_cov_16.881926	880	957	22	2	77	0.0259740
NODE_3892_length_1200_cov_16.881926	880	957	23	6	77	0.0779221
NODE_3892_length_1200_cov_16.881926	880	957	24	2	77	0.0259740
NODE_3892_length_1200_cov_16.881926	880	957	15	27	77	0.3506494
NODE_3892_length_1200_cov_16.881926	880	957	16	2	77	0.0259740
NODE_3892_length_1200_cov_16.881926	880	957	17	4	77	0.0519481
NODE_3892_length_1200_cov_16.881926	880	957	18	9	77	0.1168831
NODE_3892_length_1200_cov_16.881926	880	957	19	14	77	0.1818182
NODE_3892_length_1200_cov_16.881926	880	957	20	11	77	0.1428571
NODE_3892_length_1200_cov_16.881926	880	957	22	2	77	0.0259740
NODE_3892_length_1200_cov_16.881926	880	957	23	6	77	0.0779221
NODE_3892_length_1200_cov_16.881926	880	957	24	2	77	0.0259740
NODE_3893_length_1200_cov_15.374205	605	685	10	10	80	0.1250000
NODE_3893_length_1200_cov_15.374205	605	685	11	29	80	0.3625000
NODE_3893_length_1200_cov_15.374205	605	685	12	41	80	0.5125000
NODE_3893_length_1200_cov_15.374205	658	738	0	12	80	0.1500000
NODE_3893_length_1200_cov_15.374205	658	738	2	28	80	0.3500000
NODE_3893_length_1200_cov_15.374205	658	738	4	2	80	0.0250000
NODE_3893_length_1200_cov_15.374205	658	738	9	7	80	0.0875000
NODE_3893_length_1200_cov_15.374205	658	738	10	7	80	0.0875000
NODE_3893_length_1200_cov_15.374205	658	738	11	24	80	0.3000000
NODE_3894_length_1200_cov_12.953678	486	550	28	9	64	0.1406250
NODE_3894_length_1200_cov_12.953678	486	550	30	4	64	0.0625000
NODE_3894_length_1200_cov_12.953678	486	550	36	14	64	0.2187500
NODE_3894_length_1200_cov_12.953678	486	550	38	37	64	0.5781250
NODE_3899_length_1199_cov_14.843636	222	302	9	7	80	0.0875000
NODE_3899_length_1199_cov_14.843636	222	302	11	5	80	0.0625000
NODE_3899_length_1199_cov_14.843636	222	302	12	6	80	0.0750000
NODE_3899_length_1199_cov_14.843636	222	302	16	1	80	0.0125000
NODE_3899_length_1199_cov_14.843636	222	302	18	6	80	0.0750000
NODE_3899_length_1199_cov_14.843636	222	302	19	2	80	0.0250000
NODE_3899_length_1199_cov_14.843636	222	302	20	29	80	0.3625000
NODE_3899_length_1199_cov_14.843636	222	302	22	16	80	0.2000000
NODE_3899_length_1199_cov_14.843636	222	302	24	3	80	0.0375000
NODE_3899_length_1199_cov_14.843636	222	302	26	5	80	0.0625000
NODE_3899_length_1199_cov_14.843636	275	355	12	12	80	0.1500000
NODE_3899_length_1199_cov_14.843636	275	355	16	8	80	0.1000000
NODE_3899_length_1199_cov_14.843636	275	355	20	55	80	0.6875000
NODE_3899_length_1199_cov_14.843636	275	355	26	5	80	0.0625000
NODE_3900_length_1199_cov_12.005455	383	463	0	43	80	0.5375000
NODE_3900_length_1199_cov_12.005455	383	463	2	37	80	0.4625000
NODE_3900_length_1199_cov_12.005455	436	516	0	29	80	0.3625000
NODE_3900_length_1199_cov_12.005455	436	516	2	51	80	0.6375000
NODE_3900_length_1199_cov_12.005455	512	592	0	80	80	1.0000000
NODE_3900_length_1199_cov_12.005455	565	645	0	80	80	1.0000000
NODE_3902_length_1198_cov_36.830755	619	699	0	16	80	0.2000000
NODE_3902_length_1198_cov_36.830755	619	699	2	17	80	0.2125000
NODE_3902_length_1198_cov_36.830755	619	699	4	47	80	0.5875000
NODE_3902_length_1198_cov_36.830755	672	752	2	33	80	0.4125000
NODE_3902_length_1198_cov_36.830755	672	752	4	47	80	0.5875000
NODE_3903_length_1198_cov_22.864422	719	799	2	80	80	1.0000000
NODE_3903_length_1198_cov_22.864422	772	852	0	32	80	0.4000000
NODE_3903_length_1198_cov_22.864422	772	852	2	48	80	0.6000000
NODE_3904_length_1198_cov_17.619654	260	340	4	23	80	0.2875000
NODE_3904_length_1198_cov_17.619654	260	340	6	57	80	0.7125000
NODE_3904_length_1198_cov_17.619654	313	392	0	49	79	0.6202531
NODE_3904_length_1198_cov_17.619654	313	392	2	2	79	0.0253165
NODE_3904_length_1198_cov_17.619654	313	392	4	24	79	0.3037975
NODE_3904_length_1198_cov_17.619654	313	392	6	4	79	0.0506329
NODE_3905_length_1198_cov_10.148317	718	798	2	80	80	1.0000000
NODE_3905_length_1198_cov_10.148317	771	851	0	17	80	0.2125000
NODE_3905_length_1198_cov_10.148317	771	851	2	63	80	0.7875000
NODE_3906_length_1198_cov_6.733394	549	629	0	80	80	1.0000000
NODE_3906_length_1198_cov_6.733394	602	682	0	80	80	1.0000000
NODE_3912_length_1197_cov_27.653005	417	497	0	80	80	1.0000000
NODE_3912_length_1197_cov_27.653005	470	550	0	80	80	1.0000000
NODE_3912_length_1197_cov_27.653005	546	626	0	80	80	1.0000000
NODE_3912_length_1197_cov_27.653005	599	679	0	80	80	1.0000000
NODE_3913_length_1197_cov_14.653916	490	570	0	61	80	0.7625000
NODE_3913_length_1197_cov_14.653916	490	570	3	1	80	0.0125000
NODE_3913_length_1197_cov_14.653916	490	570	4	18	80	0.2250000
NODE_3913_length_1197_cov_14.653916	543	623	0	8	80	0.1000000
NODE_3913_length_1197_cov_14.653916	543	623	3	1	80	0.0125000
NODE_3913_length_1197_cov_14.653916	543	623	4	71	80	0.8875000
NODE_3921_length_1196_cov_26.169553	298	378	0	5	80	0.0625000
NODE_3921_length_1196_cov_26.169553	298	378	2	75	80	0.9375000
NODE_3921_length_1196_cov_26.169553	351	431	0	34	80	0.4250000
NODE_3921_length_1196_cov_26.169553	351	431	2	46	80	0.5750000
NODE_3921_length_1196_cov_26.169553	427	507	0	80	80	1.0000000
NODE_3921_length_1196_cov_26.169553	480	560	0	80	80	1.0000000
NODE_3922_length_1196_cov_21.755697	521	601	0	80	80	1.0000000
NODE_3922_length_1196_cov_21.755697	574	654	0	80	80	1.0000000
NODE_3922_length_1196_cov_21.755697	650	730	0	80	80	1.0000000
NODE_3922_length_1196_cov_21.755697	703	783	0	80	80	1.0000000
NODE_3923_length_1196_cov_5.966272	556	636	2	64	80	0.8000000
NODE_3923_length_1196_cov_5.966272	556	636	4	16	80	0.2000000
NODE_3923_length_1196_cov_5.966272	609	689	2	11	80	0.1375000
NODE_3923_length_1196_cov_5.966272	609	689	4	69	80	0.8625000
NODE_3927_length_1195_cov_69.056569	474	554	2	30	80	0.3750000
NODE_3927_length_1195_cov_69.056569	474	554	3	7	80	0.0875000
NODE_3927_length_1195_cov_69.056569	474	554	4	43	80	0.5375000
NODE_3927_length_1195_cov_69.056569	527	607	0	39	80	0.4875000
NODE_3927_length_1195_cov_69.056569	527	607	2	41	80	0.5125000
NODE_3927_length_1195_cov_69.056569	603	683	0	31	80	0.3875000
NODE_3927_length_1195_cov_69.056569	603	683	2	7	80	0.0875000
NODE_3927_length_1195_cov_69.056569	603	683	4	2	80	0.0250000
NODE_3927_length_1195_cov_69.056569	603	683	6	40	80	0.5000000
NODE_3927_length_1195_cov_69.056569	656	736	0	5	80	0.0625000
NODE_3927_length_1195_cov_69.056569	656	736	2	14	80	0.1750000
NODE_3927_length_1195_cov_69.056569	656	736	4	11	80	0.1375000
NODE_3927_length_1195_cov_69.056569	656	736	6	50	80	0.6250000
NODE_3928_length_1195_cov_65.062044	579	659	10	7	80	0.0875000
NODE_3928_length_1195_cov_65.062044	579	659	11	7	80	0.0875000
NODE_3928_length_1195_cov_65.062044	579	659	12	38	80	0.4750000
NODE_3928_length_1195_cov_65.062044	579	659	13	2	80	0.0250000
NODE_3928_length_1195_cov_65.062044	579	659	14	26	80	0.3250000
NODE_3928_length_1195_cov_65.062044	632	712	0	5	80	0.0625000
NODE_3928_length_1195_cov_65.062044	632	712	2	13	80	0.1625000
NODE_3928_length_1195_cov_65.062044	632	712	8	21	80	0.2625000
NODE_3928_length_1195_cov_65.062044	632	712	10	20	80	0.2500000
NODE_3928_length_1195_cov_65.062044	632	712	11	7	80	0.0875000
NODE_3928_length_1195_cov_65.062044	632	712	13	2	80	0.0250000
NODE_3928_length_1195_cov_65.062044	632	712	14	12	80	0.1500000
NODE_3928_length_1195_cov_65.062044	708	788	0	3	80	0.0375000
NODE_3928_length_1195_cov_65.062044	708	788	2	5	80	0.0625000
NODE_3928_length_1195_cov_65.062044	708	788	4	4	80	0.0500000
NODE_3928_length_1195_cov_65.062044	708	788	6	68	80	0.8500000
NODE_3928_length_1195_cov_65.062044	761	841	0	25	80	0.3125000
NODE_3928_length_1195_cov_65.062044	761	841	4	32	80	0.4000000
NODE_3928_length_1195_cov_65.062044	761	841	6	23	80	0.2875000
NODE_3929_length_1195_cov_23.187044	460	540	0	80	80	1.0000000
NODE_3929_length_1195_cov_23.187044	513	593	0	80	80	1.0000000
NODE_3930_length_1195_cov_18.983577	521	601	0	80	80	1.0000000
NODE_3930_length_1195_cov_18.983577	574	654	0	80	80	1.0000000
NODE_3931_length_1195_cov_14.119526	726	806	0	80	80	1.0000000
NODE_3931_length_1195_cov_14.119526	779	859	0	80	80	1.0000000
NODE_3931_length_1195_cov_14.119526	855	935	0	80	80	1.0000000
NODE_3931_length_1195_cov_14.119526	908	988	0	80	80	1.0000000
NODE_3932_length_1195_cov_13.805657	759	839	0	40	80	0.5000000
NODE_3932_length_1195_cov_13.805657	759	839	2	23	80	0.2875000
NODE_3932_length_1195_cov_13.805657	759	839	4	17	80	0.2125000
NODE_3932_length_1195_cov_13.805657	812	892	0	1	80	0.0125000
NODE_3932_length_1195_cov_13.805657	812	892	2	23	80	0.2875000
NODE_3932_length_1195_cov_13.805657	812	892	3	9	80	0.1125000
NODE_3932_length_1195_cov_13.805657	812	892	4	47	80	0.5875000
NODE_3938_length_1195_cov_1.969891	912	992	0	1	80	0.0125000
NODE_3938_length_1195_cov_1.969891	912	992	2	42	80	0.5250000
NODE_3938_length_1195_cov_1.969891	912	992	4	37	80	0.4625000
NODE_3938_length_1195_cov_1.969891	912	992	0	1	80	0.0125000
NODE_3938_length_1195_cov_1.969891	912	992	2	42	80	0.5250000
NODE_3938_length_1195_cov_1.969891	912	992	4	37	80	0.4625000
NODE_3941_length_1194_cov_40.157991	237	317	0	23	80	0.2875000
NODE_3941_length_1194_cov_40.157991	237	317	2	13	80	0.1625000
NODE_3941_length_1194_cov_40.157991	237	317	5	1	80	0.0125000
NODE_3941_length_1194_cov_40.157991	237	317	6	43	80	0.5375000
NODE_3941_length_1194_cov_40.157991	290	370	6	35	80	0.4375000
NODE_3941_length_1194_cov_40.157991	290	370	8	45	80	0.5625000
NODE_3946_length_1193_cov_34.295247	443	523	0	35	80	0.4375000
NODE_3946_length_1193_cov_34.295247	443	523	8	15	80	0.1875000
NODE_3946_length_1193_cov_34.295247	443	523	9	5	80	0.0625000
NODE_3946_length_1193_cov_34.295247	443	523	10	25	80	0.3125000
NODE_3946_length_1193_cov_34.295247	496	576	9	2	80	0.0250000
NODE_3946_length_1193_cov_34.295247	496	576	10	31	80	0.3875000
NODE_3946_length_1193_cov_34.295247	496	576	12	47	80	0.5875000
NODE_3947_length_1193_cov_16.930530	124	154	2	14	30	0.4666667
NODE_3947_length_1193_cov_16.930530	124	154	3	8	30	0.2666667
NODE_3947_length_1193_cov_16.930530	124	154	4	8	30	0.2666667
NODE_3947_length_1193_cov_16.930530	390	470	4	9	80	0.1125000
NODE_3947_length_1193_cov_16.930530	390	470	8	3	80	0.0375000
NODE_3947_length_1193_cov_16.930530	390	470	10	4	80	0.0500000
NODE_3947_length_1193_cov_16.930530	390	470	12	45	80	0.5625000
NODE_3947_length_1193_cov_16.930530	390	470	14	19	80	0.2375000
NODE_3947_length_1193_cov_16.930530	443	523	2	6	80	0.0750000
NODE_3947_length_1193_cov_16.930530	443	523	6	11	80	0.1375000
NODE_3947_length_1193_cov_16.930530	443	523	8	6	80	0.0750000
NODE_3947_length_1193_cov_16.930530	443	523	10	20	80	0.2500000
NODE_3947_length_1193_cov_16.930530	443	523	12	25	80	0.3125000
NODE_3947_length_1193_cov_16.930530	443	523	14	12	80	0.1500000
NODE_3949_length_1192_cov_26.803294	205	285	0	80	80	1.0000000
NODE_3949_length_1192_cov_26.803294	258	338	0	47	80	0.5875000
NODE_3949_length_1192_cov_26.803294	258	338	2	33	80	0.4125000
NODE_3949_length_1192_cov_26.803294	334	414	2	35	80	0.4375000
NODE_3949_length_1192_cov_26.803294	334	414	4	29	80	0.3625000
NODE_3949_length_1192_cov_26.803294	334	414	6	16	80	0.2000000
NODE_3949_length_1192_cov_26.803294	387	467	2	24	80	0.3000000
NODE_3949_length_1192_cov_26.803294	387	467	4	35	80	0.4375000
NODE_3949_length_1192_cov_26.803294	387	467	6	21	80	0.2625000
NODE_3950_length_1192_cov_23.228728	487	567	0	80	80	1.0000000
NODE_3950_length_1192_cov_23.228728	540	620	0	80	80	1.0000000
NODE_3950_length_1192_cov_23.228728	616	696	0	28	80	0.3500000
NODE_3950_length_1192_cov_23.228728	616	696	4	42	80	0.5250000
NODE_3950_length_1192_cov_23.228728	616	696	6	10	80	0.1250000
NODE_3950_length_1192_cov_23.228728	669	749	4	17	80	0.2125000
NODE_3950_length_1192_cov_23.228728	669	749	6	42	80	0.5250000
NODE_3950_length_1192_cov_23.228728	669	749	8	21	80	0.2625000
NODE_3951_length_1192_cov_18.314730	613	693	0	27	80	0.3375000
NODE_3951_length_1192_cov_18.314730	613	693	2	53	80	0.6625000
NODE_3951_length_1192_cov_18.314730	666	746	0	80	80	1.0000000
NODE_3951_length_1192_cov_18.314730	742	822	0	13	80	0.1625000
NODE_3951_length_1192_cov_18.314730	742	822	2	67	80	0.8375000
NODE_3951_length_1192_cov_18.314730	795	875	0	21	80	0.2625000
NODE_3951_length_1192_cov_18.314730	795	875	2	59	80	0.7375000
NODE_3952_length_1192_cov_14.888381	622	702	0	1	80	0.0125000
NODE_3952_length_1192_cov_14.888381	622	702	2	79	80	0.9875000
NODE_3952_length_1192_cov_14.888381	675	755	0	16	80	0.2000000
NODE_3952_length_1192_cov_14.888381	675	755	2	64	80	0.8000000
NODE_3952_length_1192_cov_14.888381	751	831	2	39	80	0.4875000
NODE_3952_length_1192_cov_14.888381	751	831	4	41	80	0.5125000
NODE_3952_length_1192_cov_14.888381	804	884	0	33	80	0.4125000
NODE_3952_length_1192_cov_14.888381	804	884	2	38	80	0.4750000
NODE_3952_length_1192_cov_14.888381	804	884	4	9	80	0.1125000
NODE_3953_length_1192_cov_9.995425	161	241	0	80	80	1.0000000
NODE_3953_length_1192_cov_9.995425	214	294	0	80	80	1.0000000
NODE_3954_length_1192_cov_5.078683	749	829	0	19	80	0.2375000
NODE_3954_length_1192_cov_5.078683	749	829	2	16	80	0.2000000
NODE_3954_length_1192_cov_5.078683	749	829	4	45	80	0.5625000
NODE_3954_length_1192_cov_5.078683	802	882	4	56	80	0.7000000
NODE_3954_length_1192_cov_5.078683	802	882	6	24	80	0.3000000
NODE_3960_length_1192_cov_0.614822	1046	1126	0	80	80	1.0000000
NODE_3961_length_1191_cov_55.466117	392	472	0	32	80	0.4000000
NODE_3961_length_1191_cov_55.466117	392	472	2	3	80	0.0375000
NODE_3961_length_1191_cov_55.466117	392	472	4	45	80	0.5625000
NODE_3961_length_1191_cov_55.466117	445	525	4	51	80	0.6375000
NODE_3961_length_1191_cov_55.466117	445	525	6	20	80	0.2500000
NODE_3961_length_1191_cov_55.466117	445	525	7	1	80	0.0125000
NODE_3961_length_1191_cov_55.466117	445	525	8	8	80	0.1000000
NODE_3961_length_1191_cov_55.466117	521	601	4	37	80	0.4625000
NODE_3961_length_1191_cov_55.466117	521	601	10	21	80	0.2625000
NODE_3961_length_1191_cov_55.466117	521	601	11	3	80	0.0375000
NODE_3961_length_1191_cov_55.466117	521	601	12	4	80	0.0500000
NODE_3961_length_1191_cov_55.466117	521	601	14	15	80	0.1875000
NODE_3961_length_1191_cov_55.466117	574	654	2	4	80	0.0500000
NODE_3961_length_1191_cov_55.466117	574	654	10	20	80	0.2500000
NODE_3961_length_1191_cov_55.466117	574	654	11	3	80	0.0375000
NODE_3961_length_1191_cov_55.466117	574	654	12	53	80	0.6625000
NODE_3963_length_1191_cov_20.677656	695	775	0	34	80	0.4250000
NODE_3963_length_1191_cov_20.677656	695	775	2	46	80	0.5750000
NODE_3963_length_1191_cov_20.677656	748	828	0	80	80	1.0000000
NODE_3964_length_1191_cov_9.074176	420	500	0	12	80	0.1500000
NODE_3964_length_1191_cov_9.074176	420	500	2	68	80	0.8500000
NODE_3964_length_1191_cov_9.074176	473	553	0	65	80	0.8125000
NODE_3964_length_1191_cov_9.074176	473	553	2	15	80	0.1875000
NODE_3968_length_1190_cov_40.916590	521	601	6	3	80	0.0375000
NODE_3968_length_1190_cov_40.916590	521	601	8	77	80	0.9625000
NODE_3968_length_1190_cov_40.916590	574	654	2	38	80	0.4750000
NODE_3968_length_1190_cov_40.916590	574	654	4	9	80	0.1125000
NODE_3968_length_1190_cov_40.916590	574	654	8	33	80	0.4125000
NODE_3968_length_1190_cov_40.916590	650	730	0	60	80	0.7500000
NODE_3968_length_1190_cov_40.916590	650	730	2	20	80	0.2500000
NODE_3968_length_1190_cov_40.916590	703	783	0	80	80	1.0000000
NODE_3969_length_1190_cov_20.715857	257	337	0	64	80	0.8000000
NODE_3969_length_1190_cov_20.715857	257	337	4	16	80	0.2000000
NODE_3969_length_1190_cov_20.715857	310	390	0	11	80	0.1375000
NODE_3969_length_1190_cov_20.715857	310	390	4	69	80	0.8625000
NODE_3970_length_1190_cov_19.724106	296	376	0	11	80	0.1375000
NODE_3970_length_1190_cov_19.724106	296	376	2	13	80	0.1625000
NODE_3970_length_1190_cov_19.724106	296	376	6	56	80	0.7000000
NODE_3970_length_1190_cov_19.724106	349	429	5	1	80	0.0125000
NODE_3970_length_1190_cov_19.724106	349	429	6	79	80	0.9875000
NODE_3973_length_1190_cov_2.698442	1022	1070	0	9	48	0.1875000
NODE_3973_length_1190_cov_2.698442	1022	1070	2	16	48	0.3333333
NODE_3973_length_1190_cov_2.698442	1022	1070	4	15	48	0.3125000
NODE_3973_length_1190_cov_2.698442	1022	1070	6	3	48	0.0625000
NODE_3973_length_1190_cov_2.698442	1022	1070	8	5	48	0.1041667
NODE_3973_length_1190_cov_2.698442	1075	1123	8	48	48	1.0000000
NODE_3977_length_1189_cov_29.193578	576	656	0	32	80	0.4000000
NODE_3977_length_1189_cov_29.193578	576	656	1	48	80	0.6000000
NODE_3977_length_1189_cov_29.193578	629	709	1	61	80	0.7625000
NODE_3977_length_1189_cov_29.193578	629	709	2	19	80	0.2375000
NODE_3978_length_1189_cov_13.484404	315	341	4	2	26	0.0769231
NODE_3978_length_1189_cov_13.484404	315	341	6	24	26	0.9230769
NODE_3978_length_1189_cov_13.484404	366	446	0	23	80	0.2875000
NODE_3978_length_1189_cov_13.484404	366	446	4	57	80	0.7125000
NODE_3984_length_1188_cov_19.278237	396	476	0	11	80	0.1375000
NODE_3984_length_1188_cov_19.278237	396	476	1	41	80	0.5125000
NODE_3984_length_1188_cov_19.278237	396	476	5	2	80	0.0250000
NODE_3984_length_1188_cov_19.278237	396	476	6	21	80	0.2625000
NODE_3984_length_1188_cov_19.278237	396	476	8	5	80	0.0625000
NODE_3984_length_1188_cov_19.278237	449	529	5	1	80	0.0125000
NODE_3984_length_1188_cov_19.278237	449	529	6	21	80	0.2625000
NODE_3984_length_1188_cov_19.278237	449	529	8	19	80	0.2375000
NODE_3984_length_1188_cov_19.278237	449	529	10	23	80	0.2875000
NODE_3984_length_1188_cov_19.278237	449	529	11	1	80	0.0125000
NODE_3984_length_1188_cov_19.278237	449	529	12	15	80	0.1875000
NODE_3990_length_1187_cov_63.185662	529	609	0	20	80	0.2500000
NODE_3990_length_1187_cov_63.185662	529	609	2	60	80	0.7500000
NODE_3990_length_1187_cov_63.185662	582	662	0	16	80	0.2000000
NODE_3990_length_1187_cov_63.185662	582	662	2	27	80	0.3375000
NODE_3990_length_1187_cov_63.185662	582	662	3	28	80	0.3500000
NODE_3990_length_1187_cov_63.185662	582	662	5	9	80	0.1125000
NODE_3990_length_1187_cov_63.185662	658	738	5	4	80	0.0500000
NODE_3990_length_1187_cov_63.185662	658	738	7	26	80	0.3250000
NODE_3990_length_1187_cov_63.185662	658	738	11	1	80	0.0125000
NODE_3990_length_1187_cov_63.185662	658	738	13	49	80	0.6125000
NODE_3990_length_1187_cov_63.185662	711	791	0	2	80	0.0250000
NODE_3990_length_1187_cov_63.185662	711	791	5	1	80	0.0125000
NODE_3990_length_1187_cov_63.185662	711	791	6	13	80	0.1625000
NODE_3990_length_1187_cov_63.185662	711	791	9	21	80	0.2625000
NODE_3990_length_1187_cov_63.185662	711	791	11	17	80	0.2125000
NODE_3990_length_1187_cov_63.185662	711	791	13	26	80	0.3250000
NODE_3991_length_1187_cov_36.926471	432	512	0	14	80	0.1750000
NODE_3991_length_1187_cov_36.926471	432	512	2	1	80	0.0125000
NODE_3991_length_1187_cov_36.926471	432	512	6	65	80	0.8125000
NODE_3991_length_1187_cov_36.926471	485	565	0	7	80	0.0875000
NODE_3991_length_1187_cov_36.926471	485	565	4	45	80	0.5625000
NODE_3991_length_1187_cov_36.926471	485	565	6	28	80	0.3500000
NODE_3991_length_1187_cov_36.926471	561	641	0	26	80	0.3250000
NODE_3991_length_1187_cov_36.926471	561	641	2	54	80	0.6750000
NODE_3991_length_1187_cov_36.926471	614	694	2	80	80	1.0000000
NODE_3992_length_1187_cov_20.383272	492	572	2	13	80	0.1625000
NODE_3992_length_1187_cov_20.383272	492	572	4	67	80	0.8375000
NODE_3992_length_1187_cov_20.383272	545	625	4	80	80	1.0000000
NODE_3993_length_1187_cov_17.941176	377	457	0	30	80	0.3750000
NODE_3993_length_1187_cov_17.941176	377	457	2	23	80	0.2875000
NODE_3993_length_1187_cov_17.941176	377	457	4	27	80	0.3375000
NODE_3993_length_1187_cov_17.941176	430	510	0	80	80	1.0000000
NODE_3993_length_1187_cov_17.941176	506	586	0	27	80	0.3375000
NODE_3993_length_1187_cov_17.941176	506	586	2	53	80	0.6625000
NODE_3993_length_1187_cov_17.941176	559	639	0	1	80	0.0125000
NODE_3993_length_1187_cov_17.941176	559	639	2	79	80	0.9875000
NODE_3997_length_1186_cov_59.606256	338	418	2	80	80	1.0000000
NODE_3997_length_1186_cov_59.606256	391	471	0	52	80	0.6500000
NODE_3997_length_1186_cov_59.606256	391	471	2	28	80	0.3500000
NODE_3997_length_1186_cov_59.606256	480	551	0	71	71	1.0000000
NODE_3997_length_1186_cov_59.606256	524	604	0	80	80	1.0000000
NODE_3998_length_1186_cov_34.937443	582	662	2	62	80	0.7750000
NODE_3998_length_1186_cov_34.937443	582	662	3	1	80	0.0125000
NODE_3998_length_1186_cov_34.937443	582	662	4	17	80	0.2125000
NODE_3998_length_1186_cov_34.937443	635	715	2	70	80	0.8750000
NODE_3998_length_1186_cov_34.937443	635	715	4	10	80	0.1250000
NODE_3998_length_1186_cov_34.937443	711	791	2	65	80	0.8125000
NODE_3998_length_1186_cov_34.937443	711	791	4	15	80	0.1875000
NODE_3998_length_1186_cov_34.937443	764	844	0	31	80	0.3875000
NODE_3998_length_1186_cov_34.937443	764	844	2	49	80	0.6125000
NODE_3999_length_1186_cov_29.840846	511	591	0	80	80	1.0000000
NODE_3999_length_1186_cov_29.840846	564	644	0	80	80	1.0000000
NODE_3999_length_1186_cov_29.840846	640	720	0	80	80	1.0000000
NODE_3999_length_1186_cov_29.840846	693	773	0	47	80	0.5875000
NODE_3999_length_1186_cov_29.840846	693	773	2	28	80	0.3500000
NODE_3999_length_1186_cov_29.840846	693	773	4	5	80	0.0625000
NODE_4000_length_1186_cov_13.108556	578	658	4	80	80	1.0000000
NODE_4000_length_1186_cov_13.108556	631	711	0	20	80	0.2500000
NODE_4000_length_1186_cov_13.108556	631	711	3	1	80	0.0125000
NODE_4000_length_1186_cov_13.108556	631	711	4	59	80	0.7375000
NODE_4001_length_1186_cov_12.867525	404	484	0	74	80	0.9250000
NODE_4001_length_1186_cov_12.867525	404	484	2	6	80	0.0750000
NODE_4001_length_1186_cov_12.867525	457	534	0	77	77	1.0000000
NODE_4001_length_1186_cov_12.867525	536	613	0	60	77	0.7792208
NODE_4001_length_1186_cov_12.867525	536	613	2	17	77	0.2207792
NODE_4001_length_1186_cov_12.867525	586	666	0	10	80	0.1250000
NODE_4001_length_1186_cov_12.867525	586	666	2	20	80	0.2500000
NODE_4001_length_1186_cov_12.867525	586	666	6	50	80	0.6250000
NODE_4002_length_1186_cov_12.135235	643	723	0	80	80	1.0000000
NODE_4002_length_1186_cov_12.135235	696	776	0	80	80	1.0000000
NODE_4012_length_1185_cov_36.974217	423	503	2	44	80	0.5500000
NODE_4012_length_1185_cov_36.974217	423	503	4	36	80	0.4500000
NODE_4012_length_1185_cov_36.974217	476	556	4	80	80	1.0000000
NODE_4013_length_1185_cov_28.410681	448	528	2	2	80	0.0250000
NODE_4013_length_1185_cov_28.410681	448	528	4	6	80	0.0750000
NODE_4013_length_1185_cov_28.410681	448	528	6	72	80	0.9000000
NODE_4013_length_1185_cov_28.410681	501	581	0	28	80	0.3500000
NODE_4013_length_1185_cov_28.410681	501	581	2	27	80	0.3375000
NODE_4013_length_1185_cov_28.410681	501	581	4	6	80	0.0750000
NODE_4013_length_1185_cov_28.410681	501	581	6	19	80	0.2375000
NODE_4014_length_1185_cov_19.768877	411	491	0	80	80	1.0000000
NODE_4014_length_1185_cov_19.768877	464	544	0	80	80	1.0000000
NODE_4014_length_1185_cov_19.768877	540	620	0	80	80	1.0000000
NODE_4014_length_1185_cov_19.768877	593	673	0	80	80	1.0000000
NODE_4015_length_1185_cov_14.490792	379	459	2	56	80	0.7000000
NODE_4015_length_1185_cov_14.490792	379	459	4	24	80	0.3000000
NODE_4015_length_1185_cov_14.490792	432	512	0	48	80	0.6000000
NODE_4015_length_1185_cov_14.490792	432	512	2	32	80	0.4000000
NODE_4016_length_1185_cov_13.686004	677	757	0	1	80	0.0125000
NODE_4016_length_1185_cov_13.686004	677	757	2	79	80	0.9875000
NODE_4016_length_1185_cov_13.686004	730	810	0	17	80	0.2125000
NODE_4016_length_1185_cov_13.686004	730	810	2	63	80	0.7875000
NODE_4017_length_1185_cov_12.362799	711	791	9	8	80	0.1000000
NODE_4017_length_1185_cov_12.362799	711	791	10	72	80	0.9000000
NODE_4017_length_1185_cov_12.362799	764	844	0	37	80	0.4625000
NODE_4017_length_1185_cov_12.362799	764	844	2	1	80	0.0125000
NODE_4017_length_1185_cov_12.362799	764	844	4	8	80	0.1000000
NODE_4017_length_1185_cov_12.362799	764	844	8	1	80	0.0125000
NODE_4017_length_1185_cov_12.362799	764	844	9	14	80	0.1750000
NODE_4017_length_1185_cov_12.362799	764	844	10	19	80	0.2375000
NODE_4024_length_1184_cov_30.061751	416	497	0	81	81	1.0000000
NODE_4024_length_1184_cov_30.061751	470	550	0	80	80	1.0000000
NODE_4024_length_1184_cov_30.061751	546	627	0	81	81	1.0000000
NODE_4024_length_1184_cov_30.061751	600	680	0	44	80	0.5500000
NODE_4024_length_1184_cov_30.061751	600	680	2	36	80	0.4500000
NODE_4025_length_1184_cov_19.544700	550	630	0	37	80	0.4625000
NODE_4025_length_1184_cov_19.544700	550	630	2	31	80	0.3875000
NODE_4025_length_1184_cov_19.544700	550	630	4	12	80	0.1500000
NODE_4025_length_1184_cov_19.544700	603	683	2	27	80	0.3375000
NODE_4025_length_1184_cov_19.544700	603	683	4	53	80	0.6625000
NODE_4025_length_1184_cov_19.544700	679	759	0	38	80	0.4750000
NODE_4025_length_1184_cov_19.544700	679	759	2	42	80	0.5250000
NODE_4025_length_1184_cov_19.544700	732	812	0	80	80	1.0000000
NODE_4026_length_1184_cov_9.129954	624	704	0	80	80	1.0000000
NODE_4026_length_1184_cov_9.129954	677	757	0	80	80	1.0000000
NODE_4031_length_1183_cov_17.260148	545	625	0	80	80	1.0000000
NODE_4031_length_1183_cov_17.260148	598	678	0	80	80	1.0000000
NODE_4031_length_1183_cov_17.260148	674	754	0	47	80	0.5875000
NODE_4031_length_1183_cov_17.260148	674	754	2	33	80	0.4125000
NODE_4031_length_1183_cov_17.260148	727	807	2	80	80	1.0000000
NODE_4032_length_1183_cov_9.777675	484	564	0	80	80	1.0000000
NODE_4032_length_1183_cov_9.777675	537	617	0	80	80	1.0000000
NODE_4033_length_1183_cov_6.847786	711	791	0	29	80	0.3625000
NODE_4033_length_1183_cov_6.847786	711	791	2	34	80	0.4250000
NODE_4033_length_1183_cov_6.847786	711	791	4	17	80	0.2125000
NODE_4033_length_1183_cov_6.847786	764	844	2	15	80	0.1875000
NODE_4033_length_1183_cov_6.847786	764	844	4	65	80	0.8125000
NODE_4033_length_1183_cov_6.847786	840	920	0	70	80	0.8750000
NODE_4033_length_1183_cov_6.847786	840	920	2	10	80	0.1250000
NODE_4033_length_1183_cov_6.847786	893	973	0	80	80	1.0000000
NODE_4035_length_1183_cov_2.680812	59	139	0	7	80	0.0875000
NODE_4035_length_1183_cov_2.680812	59	139	2	26	80	0.3250000
NODE_4035_length_1183_cov_2.680812	59	139	4	3	80	0.0375000
NODE_4035_length_1183_cov_2.680812	59	139	6	44	80	0.5500000
NODE_4040_length_1182_cov_64.600185	588	668	4	2	80	0.0250000
NODE_4040_length_1182_cov_64.600185	588	668	6	1	80	0.0125000
NODE_4040_length_1182_cov_64.600185	588	668	8	56	80	0.7000000
NODE_4040_length_1182_cov_64.600185	588	668	12	1	80	0.0125000
NODE_4040_length_1182_cov_64.600185	588	668	14	20	80	0.2500000
NODE_4040_length_1182_cov_64.600185	641	721	6	34	80	0.4250000
NODE_4040_length_1182_cov_64.600185	641	721	7	3	80	0.0375000
NODE_4040_length_1182_cov_64.600185	641	721	8	20	80	0.2500000
NODE_4040_length_1182_cov_64.600185	641	721	12	3	80	0.0375000
NODE_4040_length_1182_cov_64.600185	641	721	14	20	80	0.2500000
NODE_4040_length_1182_cov_64.600185	717	797	2	6	80	0.0750000
NODE_4040_length_1182_cov_64.600185	717	797	4	2	80	0.0250000
NODE_4040_length_1182_cov_64.600185	717	797	6	15	80	0.1875000
NODE_4040_length_1182_cov_64.600185	717	797	8	57	80	0.7125000
NODE_4040_length_1182_cov_64.600185	770	849	8	79	79	1.0000000
NODE_4041_length_1182_cov_18.584488	487	557	0	39	70	0.5571429
NODE_4041_length_1182_cov_18.584488	487	557	4	31	70	0.4428571
NODE_4041_length_1182_cov_18.584488	536	612	0	10	76	0.1315790
NODE_4041_length_1182_cov_18.584488	536	612	4	66	76	0.8684211
NODE_4041_length_1182_cov_18.584488	608	688	0	80	80	1.0000000
NODE_4041_length_1182_cov_18.584488	671	741	0	70	70	1.0000000
NODE_4042_length_1182_cov_18.075716	598	678	0	80	80	1.0000000
NODE_4042_length_1182_cov_18.075716	651	731	0	80	80	1.0000000
NODE_4042_length_1182_cov_18.075716	727	807	0	18	80	0.2250000
NODE_4042_length_1182_cov_18.075716	727	807	2	62	80	0.7750000
NODE_4042_length_1182_cov_18.075716	780	860	0	13	80	0.1625000
NODE_4042_length_1182_cov_18.075716	780	860	2	67	80	0.8375000
NODE_4043_length_1182_cov_8.716528	464	544	0	80	80	1.0000000
NODE_4043_length_1182_cov_8.716528	517	597	0	80	80	1.0000000
NODE_4044_length_1182_cov_4.109880	793	873	0	1	80	0.0125000
NODE_4044_length_1182_cov_4.109880	793	873	2	61	80	0.7625000
NODE_4044_length_1182_cov_4.109880	793	873	4	18	80	0.2250000
NODE_4044_length_1182_cov_4.109880	846	926	0	54	80	0.6750000
NODE_4044_length_1182_cov_4.109880	846	926	2	26	80	0.3250000
NODE_4045_length_1182_cov_3.433980	1052	1100	2	48	48	1.0000000
NODE_4050_length_1181_cov_13.856747	687	767	0	21	80	0.2625000
NODE_4050_length_1181_cov_13.856747	687	767	2	21	80	0.2625000
NODE_4050_length_1181_cov_13.856747	687	767	11	1	80	0.0125000
NODE_4050_length_1181_cov_13.856747	687	767	12	37	80	0.4625000
NODE_4050_length_1181_cov_13.856747	740	820	12	80	80	1.0000000
NODE_4051_length_1181_cov_8.239372	735	815	0	80	80	1.0000000
NODE_4059_length_1180_cov_46.345051	695	775	2	63	80	0.7875000
NODE_4059_length_1180_cov_46.345051	695	775	4	17	80	0.2125000
NODE_4059_length_1180_cov_46.345051	748	828	2	63	80	0.7875000
NODE_4059_length_1180_cov_46.345051	748	828	4	17	80	0.2125000
NODE_4066_length_1179_cov_93.272222	660	740	70	2	80	0.0250000
NODE_4066_length_1179_cov_93.272222	660	740	71	3	80	0.0375000
NODE_4066_length_1179_cov_93.272222	660	740	72	1	80	0.0125000
NODE_4066_length_1179_cov_93.272222	660	740	74	14	80	0.1750000
NODE_4066_length_1179_cov_93.272222	660	740	76	1	80	0.0125000
NODE_4066_length_1179_cov_93.272222	660	740	78	2	80	0.0250000
NODE_4066_length_1179_cov_93.272222	660	740	80	2	80	0.0250000
NODE_4066_length_1179_cov_93.272222	660	740	86	1	80	0.0125000
NODE_4066_length_1179_cov_93.272222	660	740	88	2	80	0.0250000
NODE_4066_length_1179_cov_93.272222	660	740	89	3	80	0.0375000
NODE_4066_length_1179_cov_93.272222	660	740	90	2	80	0.0250000
NODE_4066_length_1179_cov_93.272222	660	740	91	3	80	0.0375000
NODE_4066_length_1179_cov_93.272222	660	740	92	1	80	0.0125000
NODE_4066_length_1179_cov_93.272222	660	740	95	2	80	0.0250000
NODE_4066_length_1179_cov_93.272222	660	740	97	3	80	0.0375000
NODE_4066_length_1179_cov_93.272222	660	740	99	4	80	0.0500000
NODE_4066_length_1179_cov_93.272222	660	740	100	3	80	0.0375000
NODE_4066_length_1179_cov_93.272222	660	740	102	6	80	0.0750000
NODE_4066_length_1179_cov_93.272222	660	740	103	1	80	0.0125000
NODE_4066_length_1179_cov_93.272222	660	740	104	7	80	0.0875000
NODE_4066_length_1179_cov_93.272222	660	740	105	3	80	0.0375000
NODE_4066_length_1179_cov_93.272222	660	740	106	1	80	0.0125000
NODE_4066_length_1179_cov_93.272222	660	740	107	2	80	0.0250000
NODE_4066_length_1179_cov_93.272222	660	740	108	8	80	0.1000000
NODE_4066_length_1179_cov_93.272222	660	740	109	3	80	0.0375000
NODE_4066_length_1179_cov_93.272222	713	793	24	4	80	0.0500000
NODE_4066_length_1179_cov_93.272222	713	793	26	3	80	0.0375000
NODE_4066_length_1179_cov_93.272222	713	793	30	1	80	0.0125000
NODE_4066_length_1179_cov_93.272222	713	793	36	1	80	0.0125000
NODE_4066_length_1179_cov_93.272222	713	793	40	3	80	0.0375000
NODE_4066_length_1179_cov_93.272222	713	793	41	1	80	0.0125000
NODE_4066_length_1179_cov_93.272222	713	793	45	2	80	0.0250000
NODE_4066_length_1179_cov_93.272222	713	793	51	1	80	0.0125000
NODE_4066_length_1179_cov_93.272222	713	793	60	3	80	0.0375000
NODE_4066_length_1179_cov_93.272222	713	793	63	2	80	0.0250000
NODE_4066_length_1179_cov_93.272222	713	793	64	2	80	0.0250000
NODE_4066_length_1179_cov_93.272222	713	793	65	4	80	0.0500000
NODE_4066_length_1179_cov_93.272222	713	793	66	1	80	0.0125000
NODE_4066_length_1179_cov_93.272222	713	793	67	5	80	0.0625000
NODE_4066_length_1179_cov_93.272222	713	793	69	9	80	0.1125000
NODE_4066_length_1179_cov_93.272222	713	793	70	12	80	0.1500000
NODE_4066_length_1179_cov_93.272222	713	793	71	4	80	0.0500000
NODE_4066_length_1179_cov_93.272222	713	793	72	1	80	0.0125000
NODE_4066_length_1179_cov_93.272222	713	793	74	14	80	0.1750000
NODE_4066_length_1179_cov_93.272222	713	793	76	1	80	0.0125000
NODE_4066_length_1179_cov_93.272222	713	793	78	2	80	0.0250000
NODE_4066_length_1179_cov_93.272222	713	793	80	2	80	0.0250000
NODE_4066_length_1179_cov_93.272222	713	793	86	1	80	0.0125000
NODE_4066_length_1179_cov_93.272222	713	793	88	1	80	0.0125000
NODE_4067_length_1179_cov_55.355556	547	627	4	3	80	0.0375000
NODE_4067_length_1179_cov_55.355556	547	627	6	18	80	0.2250000
NODE_4067_length_1179_cov_55.355556	547	627	8	1	80	0.0125000
NODE_4067_length_1179_cov_55.355556	547	627	10	13	80	0.1625000
NODE_4067_length_1179_cov_55.355556	547	627	14	6	80	0.0750000
NODE_4067_length_1179_cov_55.355556	547	627	18	1	80	0.0125000
NODE_4067_length_1179_cov_55.355556	547	627	20	9	80	0.1125000
NODE_4067_length_1179_cov_55.355556	547	627	22	5	80	0.0625000
NODE_4067_length_1179_cov_55.355556	547	627	24	1	80	0.0125000
NODE_4067_length_1179_cov_55.355556	547	627	25	5	80	0.0625000
NODE_4067_length_1179_cov_55.355556	547	627	26	18	80	0.2250000
NODE_4067_length_1179_cov_55.355556	600	680	20	5	80	0.0625000
NODE_4067_length_1179_cov_55.355556	600	680	22	3	80	0.0375000
NODE_4067_length_1179_cov_55.355556	600	680	24	23	80	0.2875000
NODE_4067_length_1179_cov_55.355556	600	680	25	5	80	0.0625000
NODE_4067_length_1179_cov_55.355556	600	680	26	44	80	0.5500000
NODE_4068_length_1179_cov_29.712037	613	693	0	80	80	1.0000000
NODE_4068_length_1179_cov_29.712037	666	746	0	80	80	1.0000000
NODE_4069_length_1179_cov_26.767593	483	563	0	56	80	0.7000000
NODE_4069_length_1179_cov_26.767593	483	563	2	4	80	0.0500000
NODE_4069_length_1179_cov_26.767593	483	563	4	6	80	0.0750000
NODE_4069_length_1179_cov_26.767593	483	563	8	14	80	0.1750000
NODE_4069_length_1179_cov_26.767593	536	616	0	80	80	1.0000000
NODE_4069_length_1179_cov_26.767593	612	692	0	80	80	1.0000000
NODE_4069_length_1179_cov_26.767593	665	745	0	80	80	1.0000000
NODE_4070_length_1179_cov_22.249074	581	661	8	4	80	0.0500000
NODE_4070_length_1179_cov_22.249074	581	661	11	23	80	0.2875000
NODE_4070_length_1179_cov_22.249074	581	661	12	3	80	0.0375000
NODE_4070_length_1179_cov_22.249074	581	661	13	44	80	0.5500000
NODE_4070_length_1179_cov_22.249074	581	661	14	6	80	0.0750000
NODE_4070_length_1179_cov_22.249074	634	714	2	31	80	0.3875000
NODE_4070_length_1179_cov_22.249074	634	714	3	6	80	0.0750000
NODE_4070_length_1179_cov_22.249074	634	714	7	2	80	0.0250000
NODE_4070_length_1179_cov_22.249074	634	714	8	18	80	0.2250000
NODE_4070_length_1179_cov_22.249074	634	714	11	13	80	0.1625000
NODE_4070_length_1179_cov_22.249074	634	714	13	10	80	0.1250000
NODE_4071_length_1179_cov_16.538889	498	568	10	22	70	0.3142857
NODE_4071_length_1179_cov_16.538889	498	568	12	32	70	0.4571429
NODE_4071_length_1179_cov_16.538889	498	568	14	5	70	0.0714286
NODE_4071_length_1179_cov_16.538889	498	568	16	11	70	0.1571429
NODE_4072_length_1179_cov_15.442593	535	615	0	26	80	0.3250000
NODE_4072_length_1179_cov_15.442593	535	615	2	2	80	0.0250000
NODE_4072_length_1179_cov_15.442593	535	615	4	52	80	0.6500000
NODE_4072_length_1179_cov_15.442593	588	668	0	3	80	0.0375000
NODE_4072_length_1179_cov_15.442593	588	668	2	1	80	0.0125000
NODE_4072_length_1179_cov_15.442593	588	668	4	76	80	0.9500000
NODE_4076_length_1179_cov_2.419444	1108	1155	0	47	47	1.0000000
NODE_4078_length_1179_cov_1.009259	944	1024	0	52	80	0.6500000
NODE_4078_length_1179_cov_1.009259	944	1024	2	4	80	0.0500000
NODE_4078_length_1179_cov_1.009259	944	1024	8	24	80	0.3000000
NODE_4078_length_1179_cov_1.009259	997	1077	2	9	80	0.1125000
NODE_4078_length_1179_cov_1.009259	997	1077	8	71	80	0.8875000
NODE_4079_length_1178_cov_42.484708	423	503	0	80	80	1.0000000
NODE_4079_length_1178_cov_42.484708	476	556	0	52	80	0.6500000
NODE_4079_length_1178_cov_42.484708	476	556	6	28	80	0.3500000
NODE_4079_length_1178_cov_42.484708	552	632	4	3	80	0.0375000
NODE_4079_length_1178_cov_42.484708	552	632	6	23	80	0.2875000
NODE_4079_length_1178_cov_42.484708	552	632	8	48	80	0.6000000
NODE_4079_length_1178_cov_42.484708	552	632	9	1	80	0.0125000
NODE_4079_length_1178_cov_42.484708	552	632	10	5	80	0.0625000
NODE_4079_length_1178_cov_42.484708	605	685	4	39	80	0.4875000
NODE_4079_length_1178_cov_42.484708	605	685	5	5	80	0.0625000
NODE_4079_length_1178_cov_42.484708	605	685	6	12	80	0.1500000
NODE_4079_length_1178_cov_42.484708	605	685	8	18	80	0.2250000
NODE_4079_length_1178_cov_42.484708	605	685	9	1	80	0.0125000
NODE_4079_length_1178_cov_42.484708	605	685	10	5	80	0.0625000
NODE_4080_length_1178_cov_15.332715	215	295	0	43	80	0.5375000
NODE_4080_length_1178_cov_15.332715	215	295	2	37	80	0.4625000
NODE_4080_length_1178_cov_15.332715	268	348	0	80	80	1.0000000
NODE_4081_length_1178_cov_11.403151	527	607	0	80	80	1.0000000
NODE_4081_length_1178_cov_11.403151	580	660	0	80	80	1.0000000
NODE_4084_length_1177_cov_34.920223	369	449	0	80	80	1.0000000
NODE_4084_length_1177_cov_34.920223	422	502	0	80	80	1.0000000
NODE_4084_length_1177_cov_34.920223	498	578	0	58	80	0.7250000
NODE_4084_length_1177_cov_34.920223	498	578	4	22	80	0.2750000
NODE_4084_length_1177_cov_34.920223	551	631	0	5	80	0.0625000
NODE_4084_length_1177_cov_34.920223	551	631	4	75	80	0.9375000
NODE_4085_length_1177_cov_12.186456	481	561	0	76	80	0.9500000
NODE_4085_length_1177_cov_12.186456	481	561	2	4	80	0.0500000
NODE_4085_length_1177_cov_12.186456	534	614	0	23	80	0.2875000
NODE_4085_length_1177_cov_12.186456	534	614	2	57	80	0.7125000
NODE_4085_length_1177_cov_12.186456	610	690	0	59	80	0.7375000
NODE_4085_length_1177_cov_12.186456	610	690	2	21	80	0.2625000
NODE_4085_length_1177_cov_12.186456	663	743	0	80	80	1.0000000
NODE_4086_length_1177_cov_11.926716	443	523	0	60	80	0.7500000
NODE_4086_length_1177_cov_11.926716	443	523	2	2	80	0.0250000
NODE_4086_length_1177_cov_11.926716	443	523	4	2	80	0.0250000
NODE_4086_length_1177_cov_11.926716	443	523	6	16	80	0.2000000
NODE_4086_length_1177_cov_11.926716	496	578	0	7	82	0.0853659
NODE_4086_length_1177_cov_11.926716	496	578	2	2	82	0.0243902
NODE_4086_length_1177_cov_11.926716	496	578	4	2	82	0.0243902
NODE_4086_length_1177_cov_11.926716	496	578	6	37	82	0.4512195
NODE_4086_length_1177_cov_11.926716	496	578	8	34	82	0.4146341
NODE_4088_length_1177_cov_5.923933	358	438	0	80	80	1.0000000
NODE_4088_length_1177_cov_5.923933	411	491	0	80	80	1.0000000
NODE_4089_length_1177_cov_5.775510	760	840	2	13	80	0.1625000
NODE_4089_length_1177_cov_5.775510	760	840	4	8	80	0.1000000
NODE_4089_length_1177_cov_5.775510	760	840	5	1	80	0.0125000
NODE_4089_length_1177_cov_5.775510	760	840	7	2	80	0.0250000
NODE_4089_length_1177_cov_5.775510	760	840	8	10	80	0.1250000
NODE_4089_length_1177_cov_5.775510	760	840	9	27	80	0.3375000
NODE_4089_length_1177_cov_5.775510	760	840	10	19	80	0.2375000
NODE_4089_length_1177_cov_5.775510	813	893	5	13	80	0.1625000
NODE_4089_length_1177_cov_5.775510	813	893	7	28	80	0.3500000
NODE_4089_length_1177_cov_5.775510	813	893	8	10	80	0.1250000
NODE_4089_length_1177_cov_5.775510	813	893	9	15	80	0.1875000
NODE_4089_length_1177_cov_5.775510	813	893	10	14	80	0.1750000
NODE_4096_length_1176_cov_26.994429	377	457	0	80	80	1.0000000
NODE_4096_length_1176_cov_26.994429	430	510	0	80	80	1.0000000
NODE_4096_length_1176_cov_26.994429	506	586	0	80	80	1.0000000
NODE_4096_length_1176_cov_26.994429	559	639	0	80	80	1.0000000
NODE_4097_length_1176_cov_15.766945	531	611	0	12	80	0.1500000
NODE_4097_length_1176_cov_15.766945	531	611	2	20	80	0.2500000
NODE_4097_length_1176_cov_15.766945	531	611	4	48	80	0.6000000
NODE_4097_length_1176_cov_15.766945	584	664	0	10	80	0.1250000
NODE_4097_length_1176_cov_15.766945	584	664	2	33	80	0.4125000
NODE_4097_length_1176_cov_15.766945	584	664	4	37	80	0.4625000
NODE_4098_length_1176_cov_14.882080	628	708	4	18	80	0.2250000
NODE_4098_length_1176_cov_14.882080	628	708	6	62	80	0.7750000
NODE_4098_length_1176_cov_14.882080	681	761	2	2	80	0.0250000
NODE_4098_length_1176_cov_14.882080	681	761	4	38	80	0.4750000
NODE_4098_length_1176_cov_14.882080	681	761	6	40	80	0.5000000
NODE_4099_length_1176_cov_10.692665	392	472	0	66	80	0.8250000
NODE_4099_length_1176_cov_10.692665	392	472	2	14	80	0.1750000
NODE_4099_length_1176_cov_10.692665	445	525	0	80	80	1.0000000
NODE_4106_length_1175_cov_50.754647	526	606	0	80	80	1.0000000
NODE_4106_length_1175_cov_50.754647	579	659	0	80	80	1.0000000
NODE_4107_length_1175_cov_42.638476	327	407	0	79	80	0.9875000
NODE_4107_length_1175_cov_42.638476	327	407	2	1	80	0.0125000
NODE_4107_length_1175_cov_42.638476	380	460	0	26	80	0.3250000
NODE_4107_length_1175_cov_42.638476	380	460	2	15	80	0.1875000
NODE_4107_length_1175_cov_42.638476	380	460	4	35	80	0.4375000
NODE_4107_length_1175_cov_42.638476	380	460	8	4	80	0.0500000
NODE_4107_length_1175_cov_42.638476	456	536	6	41	80	0.5125000
NODE_4107_length_1175_cov_42.638476	456	536	7	9	80	0.1125000
NODE_4107_length_1175_cov_42.638476	456	536	8	30	80	0.3750000
NODE_4107_length_1175_cov_42.638476	509	589	2	25	80	0.3125000
NODE_4107_length_1175_cov_42.638476	509	589	6	55	80	0.6875000
NODE_4108_length_1175_cov_40.217472	437	517	0	7	80	0.0875000
NODE_4108_length_1175_cov_40.217472	437	517	2	73	80	0.9125000
NODE_4108_length_1175_cov_40.217472	490	570	0	12	80	0.1500000
NODE_4108_length_1175_cov_40.217472	490	570	2	68	80	0.8500000
NODE_4108_length_1175_cov_40.217472	566	646	0	80	80	1.0000000
NODE_4108_length_1175_cov_40.217472	619	699	0	80	80	1.0000000
NODE_4109_length_1175_cov_12.834572	775	855	0	25	80	0.3125000
NODE_4109_length_1175_cov_12.834572	775	855	2	10	80	0.1250000
NODE_4109_length_1175_cov_12.834572	775	855	4	45	80	0.5625000
NODE_4109_length_1175_cov_12.834572	828	908	0	18	80	0.2250000
NODE_4109_length_1175_cov_12.834572	828	908	2	13	80	0.1625000
NODE_4109_length_1175_cov_12.834572	828	908	4	49	80	0.6125000
NODE_4115_length_1174_cov_20.569302	433	513	0	47	80	0.5875000
NODE_4115_length_1174_cov_20.569302	433	513	2	33	80	0.4125000
NODE_4115_length_1174_cov_20.569302	486	566	0	55	80	0.6875000
NODE_4115_length_1174_cov_20.569302	486	566	2	24	80	0.3000000
NODE_4115_length_1174_cov_20.569302	486	566	4	1	80	0.0125000
NODE_4115_length_1174_cov_20.569302	562	642	2	4	80	0.0500000
NODE_4115_length_1174_cov_20.569302	562	642	4	76	80	0.9500000
NODE_4115_length_1174_cov_20.569302	615	695	0	46	80	0.5750000
NODE_4115_length_1174_cov_20.569302	615	695	2	8	80	0.1000000
NODE_4115_length_1174_cov_20.569302	615	695	4	26	80	0.3250000
NODE_4116_length_1174_cov_18.797209	578	658	0	80	80	1.0000000
NODE_4116_length_1174_cov_18.797209	631	711	0	80	80	1.0000000
NODE_4117_length_1174_cov_17.486512	589	669	0	19	80	0.2375000
NODE_4117_length_1174_cov_17.486512	589	669	2	61	80	0.7625000
NODE_4117_length_1174_cov_17.486512	642	722	0	20	80	0.2500000
NODE_4117_length_1174_cov_17.486512	642	722	2	60	80	0.7500000
NODE_4118_length_1174_cov_15.888372	570	650	0	80	80	1.0000000
NODE_4118_length_1174_cov_15.888372	623	703	0	80	80	1.0000000
NODE_4118_length_1174_cov_15.888372	699	779	0	80	80	1.0000000
NODE_4118_length_1174_cov_15.888372	752	832	0	80	80	1.0000000
NODE_4124_length_1174_cov_1.536744	1066	1115	0	44	49	0.8979592
NODE_4124_length_1174_cov_1.536744	1066	1115	2	5	49	0.1020408
NODE_4124_length_1174_cov_1.536744	1088	1168	0	80	80	1.0000000
NODE_4128_length_1173_cov_29.562384	455	535	0	60	80	0.7500000
NODE_4128_length_1173_cov_29.562384	455	535	2	20	80	0.2500000
NODE_4128_length_1173_cov_29.562384	508	588	0	7	80	0.0875000
NODE_4128_length_1173_cov_29.562384	508	588	2	73	80	0.9125000
NODE_4128_length_1173_cov_29.562384	584	664	0	73	80	0.9125000
NODE_4128_length_1173_cov_29.562384	584	664	2	7	80	0.0875000
NODE_4128_length_1173_cov_29.562384	637	717	0	80	80	1.0000000
NODE_4129_length_1173_cov_25.206704	395	475	0	17	80	0.2125000
NODE_4129_length_1173_cov_25.206704	395	475	2	63	80	0.7875000
NODE_4129_length_1173_cov_25.206704	448	528	0	70	80	0.8750000
NODE_4129_length_1173_cov_25.206704	448	528	2	10	80	0.1250000
NODE_4130_length_1173_cov_9.486965	693	773	0	12	80	0.1500000
NODE_4130_length_1173_cov_9.486965	693	773	2	68	80	0.8500000
NODE_4130_length_1173_cov_9.486965	746	826	0	65	80	0.8125000
NODE_4130_length_1173_cov_9.486965	746	826	2	15	80	0.1875000
NODE_4131_length_1173_cov_7.946927	201	281	0	42	80	0.5250000
NODE_4131_length_1173_cov_7.946927	201	281	1	11	80	0.1375000
NODE_4131_length_1173_cov_7.946927	201	281	2	23	80	0.2875000
NODE_4131_length_1173_cov_7.946927	201	281	4	4	80	0.0500000
NODE_4131_length_1173_cov_7.946927	254	334	0	10	80	0.1250000
NODE_4131_length_1173_cov_7.946927	254	334	2	42	80	0.5250000
NODE_4131_length_1173_cov_7.946927	254	334	4	28	80	0.3500000
NODE_4136_length_1172_cov_37.177074	527	607	2	4	80	0.0500000
NODE_4136_length_1172_cov_37.177074	527	607	4	70	80	0.8750000
NODE_4136_length_1172_cov_37.177074	527	607	6	6	80	0.0750000
NODE_4136_length_1172_cov_37.177074	580	660	2	57	80	0.7125000
NODE_4136_length_1172_cov_37.177074	580	660	4	23	80	0.2875000
NODE_4137_length_1172_cov_20.397018	677	757	0	80	80	1.0000000
NODE_4137_length_1172_cov_20.397018	730	810	0	80	80	1.0000000
NODE_4138_length_1172_cov_15.018639	460	540	0	80	80	1.0000000
NODE_4138_length_1172_cov_15.018639	513	593	0	80	80	1.0000000
NODE_4139_length_1172_cov_13.199441	622	702	0	80	80	1.0000000
NODE_4139_length_1172_cov_13.199441	675	755	0	61	80	0.7625000
NODE_4139_length_1172_cov_13.199441	675	755	8	5	80	0.0625000
NODE_4139_length_1172_cov_13.199441	675	755	9	10	80	0.1250000
NODE_4139_length_1172_cov_13.199441	675	755	10	4	80	0.0500000
NODE_4140_length_1172_cov_10.720410	499	579	0	25	80	0.3125000
NODE_4140_length_1172_cov_10.720410	499	579	2	55	80	0.6875000
NODE_4140_length_1172_cov_10.720410	552	632	0	78	80	0.9750000
NODE_4140_length_1172_cov_10.720410	552	632	2	2	80	0.0250000
NODE_4140_length_1172_cov_10.720410	628	708	0	80	80	1.0000000
NODE_4140_length_1172_cov_10.720410	681	761	0	80	80	1.0000000
NODE_4141_length_1172_cov_10.574091	951	1021	1	70	70	1.0000000
NODE_4142_length_1172_cov_9.204101	276	356	0	14	80	0.1750000
NODE_4142_length_1172_cov_9.204101	276	356	2	66	80	0.8250000
NODE_4142_length_1172_cov_9.204101	329	409	0	29	80	0.3625000
NODE_4142_length_1172_cov_9.204101	329	409	2	51	80	0.6375000
NODE_4148_length_1171_cov_13.311567	666	746	0	64	80	0.8000000
NODE_4148_length_1171_cov_13.311567	666	746	2	16	80	0.2000000
NODE_4148_length_1171_cov_13.311567	719	803	0	11	84	0.1309524
NODE_4148_length_1171_cov_13.311567	719	803	2	73	84	0.8690476
NODE_4149_length_1171_cov_9.154851	198	278	0	58	80	0.7250000
NODE_4149_length_1171_cov_9.154851	198	278	2	22	80	0.2750000
NODE_4149_length_1171_cov_9.154851	251	331	0	5	80	0.0625000
NODE_4149_length_1171_cov_9.154851	251	331	2	75	80	0.9375000
NODE_4157_length_1170_cov_65.480859	402	482	0	1	80	0.0125000
NODE_4157_length_1170_cov_65.480859	402	482	2	70	80	0.8750000
NODE_4157_length_1170_cov_65.480859	402	482	4	9	80	0.1125000
NODE_4157_length_1170_cov_65.480859	455	535	0	54	80	0.6750000
NODE_4157_length_1170_cov_65.480859	455	535	2	26	80	0.3250000
NODE_4158_length_1170_cov_35.283847	704	784	0	80	80	1.0000000
NODE_4158_length_1170_cov_35.283847	757	837	0	29	80	0.3625000
NODE_4158_length_1170_cov_35.283847	757	837	2	51	80	0.6375000
NODE_4159_length_1170_cov_23.600373	450	530	0	68	80	0.8500000
NODE_4159_length_1170_cov_23.600373	450	530	2	12	80	0.1500000
NODE_4159_length_1170_cov_23.600373	503	583	0	80	80	1.0000000
NODE_4159_length_1170_cov_23.600373	579	659	0	33	80	0.4125000
NODE_4159_length_1170_cov_23.600373	579	659	2	47	80	0.5875000
NODE_4159_length_1170_cov_23.600373	632	705	0	14	73	0.1917808
NODE_4159_length_1170_cov_23.600373	632	705	2	59	73	0.8082192
NODE_4160_length_1170_cov_19.783380	325	405	0	18	80	0.2250000
NODE_4160_length_1170_cov_19.783380	325	405	2	62	80	0.7750000
NODE_4160_length_1170_cov_19.783380	378	458	0	15	80	0.1875000
NODE_4160_length_1170_cov_19.783380	378	458	2	65	80	0.8125000
NODE_4168_length_1169_cov_61.689720	464	544	0	14	80	0.1750000
NODE_4168_length_1169_cov_61.689720	464	544	2	9	80	0.1125000
NODE_4168_length_1169_cov_61.689720	464	544	12	33	80	0.4125000
NODE_4168_length_1169_cov_61.689720	464	544	14	24	80	0.3000000
NODE_4168_length_1169_cov_61.689720	517	597	8	4	80	0.0500000
NODE_4168_length_1169_cov_61.689720	517	597	11	1	80	0.0125000
NODE_4168_length_1169_cov_61.689720	517	597	12	21	80	0.2625000
NODE_4168_length_1169_cov_61.689720	517	597	14	33	80	0.4125000
NODE_4168_length_1169_cov_61.689720	517	597	16	15	80	0.1875000
NODE_4168_length_1169_cov_61.689720	517	597	18	6	80	0.0750000
NODE_4168_length_1169_cov_61.689720	593	673	6	14	80	0.1750000
NODE_4168_length_1169_cov_61.689720	593	673	8	47	80	0.5875000
NODE_4168_length_1169_cov_61.689720	593	673	10	19	80	0.2375000
NODE_4168_length_1169_cov_61.689720	646	726	6	6	80	0.0750000
NODE_4168_length_1169_cov_61.689720	646	726	8	35	80	0.4375000
NODE_4168_length_1169_cov_61.689720	646	726	10	39	80	0.4875000
NODE_4169_length_1169_cov_55.247664	640	720	0	80	80	1.0000000
NODE_4169_length_1169_cov_55.247664	693	773	0	80	80	1.0000000
NODE_4170_length_1169_cov_39.016822	447	527	0	42	80	0.5250000
NODE_4170_length_1169_cov_39.016822	447	527	2	38	80	0.4750000
NODE_4170_length_1169_cov_39.016822	500	580	2	80	80	1.0000000
NODE_4170_length_1169_cov_39.016822	576	656	0	71	80	0.8875000
NODE_4170_length_1169_cov_39.016822	576	656	2	9	80	0.1125000
NODE_4170_length_1169_cov_39.016822	629	709	0	80	80	1.0000000
NODE_4171_length_1169_cov_35.383178	582	662	2	5	80	0.0625000
NODE_4171_length_1169_cov_35.383178	582	662	3	18	80	0.2250000
NODE_4171_length_1169_cov_35.383178	582	662	4	57	80	0.7125000
NODE_4171_length_1169_cov_35.383178	635	715	0	38	80	0.4750000
NODE_4171_length_1169_cov_35.383178	635	715	2	11	80	0.1375000
NODE_4171_length_1169_cov_35.383178	635	715	3	22	80	0.2750000
NODE_4171_length_1169_cov_35.383178	635	715	4	9	80	0.1125000
NODE_4173_length_1169_cov_12.010280	338	418	0	80	80	1.0000000
NODE_4173_length_1169_cov_12.010280	391	471	0	80	80	1.0000000
NODE_4175_length_1169_cov_4.172897	74	135	0	61	61	1.0000000
NODE_4175_length_1169_cov_4.172897	74	135	0	61	61	1.0000000
NODE_4175_length_1169_cov_4.172897	74	135	0	61	61	1.0000000
NODE_4183_length_1168_cov_27.350795	517	597	0	80	80	1.0000000
NODE_4183_length_1168_cov_27.350795	570	650	0	80	80	1.0000000
NODE_4183_length_1168_cov_27.350795	646	726	0	69	80	0.8625000
NODE_4183_length_1168_cov_27.350795	646	726	4	11	80	0.1375000
NODE_4183_length_1168_cov_27.350795	699	779	0	16	80	0.2000000
NODE_4183_length_1168_cov_27.350795	699	779	4	64	80	0.8000000
NODE_4184_length_1168_cov_25.777362	672	752	2	80	80	1.0000000
NODE_4184_length_1168_cov_25.777362	725	805	0	26	80	0.3250000
NODE_4184_length_1168_cov_25.777362	725	805	2	54	80	0.6750000
NODE_4185_length_1168_cov_25.295603	543	623	0	21	80	0.2625000
NODE_4185_length_1168_cov_25.295603	543	623	2	17	80	0.2125000
NODE_4185_length_1168_cov_25.295603	543	623	4	6	80	0.0750000
NODE_4185_length_1168_cov_25.295603	543	623	6	5	80	0.0625000
NODE_4185_length_1168_cov_25.295603	543	623	8	31	80	0.3875000
NODE_4185_length_1168_cov_25.295603	596	676	6	4	80	0.0500000
NODE_4185_length_1168_cov_25.295603	596	676	8	61	80	0.7625000
NODE_4185_length_1168_cov_25.295603	596	676	10	15	80	0.1875000
NODE_4185_length_1168_cov_25.295603	672	752	0	32	80	0.4000000
NODE_4185_length_1168_cov_25.295603	672	752	2	21	80	0.2625000
NODE_4185_length_1168_cov_25.295603	672	752	4	22	80	0.2750000
NODE_4185_length_1168_cov_25.295603	672	752	6	5	80	0.0625000
NODE_4185_length_1168_cov_25.295603	725	804	0	79	79	1.0000000
NODE_4186_length_1168_cov_20.202058	434	514	0	29	80	0.3625000
NODE_4186_length_1168_cov_20.202058	434	514	2	51	80	0.6375000
NODE_4186_length_1168_cov_20.202058	487	567	2	59	80	0.7375000
NODE_4186_length_1168_cov_20.202058	487	567	4	21	80	0.2625000
NODE_4187_length_1168_cov_16.787652	405	485	0	80	80	1.0000000
NODE_4187_length_1168_cov_16.787652	458	538	0	34	80	0.4250000
NODE_4187_length_1168_cov_16.787652	458	538	2	46	80	0.5750000
NODE_4188_length_1168_cov_10.079514	722	802	0	14	80	0.1750000
NODE_4188_length_1168_cov_10.079514	722	802	2	66	80	0.8250000
NODE_4188_length_1168_cov_10.079514	775	855	2	75	80	0.9375000
NODE_4188_length_1168_cov_10.079514	775	855	4	5	80	0.0625000
NODE_4198_length_1167_cov_27.961610	591	671	6	27	80	0.3375000
NODE_4198_length_1167_cov_27.961610	591	671	8	2	80	0.0250000
NODE_4198_length_1167_cov_27.961610	591	671	10	6	80	0.0750000
NODE_4198_length_1167_cov_27.961610	591	671	12	22	80	0.2750000
NODE_4198_length_1167_cov_27.961610	591	671	14	9	80	0.1125000
NODE_4198_length_1167_cov_27.961610	591	671	15	5	80	0.0625000
NODE_4198_length_1167_cov_27.961610	591	671	16	9	80	0.1125000
NODE_4198_length_1167_cov_27.961610	644	724	10	17	80	0.2125000
NODE_4198_length_1167_cov_27.961610	644	724	12	35	80	0.4375000
NODE_4198_length_1167_cov_27.961610	644	724	14	15	80	0.1875000
NODE_4198_length_1167_cov_27.961610	644	724	15	5	80	0.0625000
NODE_4198_length_1167_cov_27.961610	644	724	16	8	80	0.1000000
NODE_4199_length_1167_cov_12.393258	670	750	0	59	80	0.7375000
NODE_4199_length_1167_cov_12.393258	670	750	2	21	80	0.2625000
NODE_4199_length_1167_cov_12.393258	723	803	0	6	80	0.0750000
NODE_4199_length_1167_cov_12.393258	723	803	2	74	80	0.9250000
NODE_4200_length_1167_cov_11.189139	434	514	0	21	80	0.2625000
NODE_4200_length_1167_cov_11.189139	434	514	2	59	80	0.7375000
NODE_4200_length_1167_cov_11.189139	487	567	2	80	80	1.0000000
NODE_4201_length_1167_cov_7.998127	711	791	0	80	80	1.0000000
NODE_4201_length_1167_cov_7.998127	764	844	0	80	80	1.0000000
NODE_4206_length_1166_cov_313.815370	444	524	61	8	80	0.1000000
NODE_4206_length_1166_cov_313.815370	444	524	62	3	80	0.0375000
NODE_4206_length_1166_cov_313.815370	444	524	69	2	80	0.0250000
NODE_4206_length_1166_cov_313.815370	444	524	70	1	80	0.0125000
NODE_4206_length_1166_cov_313.815370	444	524	72	2	80	0.0250000
NODE_4206_length_1166_cov_313.815370	444	524	79	1	80	0.0125000
NODE_4206_length_1166_cov_313.815370	444	524	80	1	80	0.0125000
NODE_4206_length_1166_cov_313.815370	444	524	84	1	80	0.0125000
NODE_4206_length_1166_cov_313.815370	444	524	89	2	80	0.0250000
NODE_4206_length_1166_cov_313.815370	444	524	91	1	80	0.0125000
NODE_4206_length_1166_cov_313.815370	444	524	97	1	80	0.0125000
NODE_4206_length_1166_cov_313.815370	444	524	103	5	80	0.0625000
NODE_4206_length_1166_cov_313.815370	444	524	106	1	80	0.0125000
NODE_4206_length_1166_cov_313.815370	444	524	118	1	80	0.0125000
NODE_4206_length_1166_cov_313.815370	444	524	120	1	80	0.0125000
NODE_4206_length_1166_cov_313.815370	444	524	121	1	80	0.0125000
NODE_4206_length_1166_cov_313.815370	444	524	122	1	80	0.0125000
NODE_4206_length_1166_cov_313.815370	444	524	123	1	80	0.0125000
NODE_4206_length_1166_cov_313.815370	444	524	124	1	80	0.0125000
NODE_4206_length_1166_cov_313.815370	444	524	133	2	80	0.0250000
NODE_4206_length_1166_cov_313.815370	444	524	146	2	80	0.0250000
NODE_4206_length_1166_cov_313.815370	444	524	148	2	80	0.0250000
NODE_4206_length_1166_cov_313.815370	444	524	164	3	80	0.0375000
NODE_4206_length_1166_cov_313.815370	444	524	170	1	80	0.0125000
NODE_4206_length_1166_cov_313.815370	444	524	174	1	80	0.0125000
NODE_4206_length_1166_cov_313.815370	444	524	184	1	80	0.0125000
NODE_4206_length_1166_cov_313.815370	444	524	185	2	80	0.0250000
NODE_4206_length_1166_cov_313.815370	444	524	192	2	80	0.0250000
NODE_4206_length_1166_cov_313.815370	444	524	205	3	80	0.0375000
NODE_4206_length_1166_cov_313.815370	444	524	207	1	80	0.0125000
NODE_4206_length_1166_cov_313.815370	444	524	217	1	80	0.0125000
NODE_4206_length_1166_cov_313.815370	444	524	221	1	80	0.0125000
NODE_4206_length_1166_cov_313.815370	444	524	233	1	80	0.0125000
NODE_4206_length_1166_cov_313.815370	444	524	235	1	80	0.0125000
NODE_4206_length_1166_cov_313.815370	444	524	237	1	80	0.0125000
NODE_4206_length_1166_cov_313.815370	444	524	238	2	80	0.0250000
NODE_4206_length_1166_cov_313.815370	444	524	259	1	80	0.0125000
NODE_4206_length_1166_cov_313.815370	444	524	276	1	80	0.0125000
NODE_4206_length_1166_cov_313.815370	444	524	277	1	80	0.0125000
NODE_4206_length_1166_cov_313.815370	444	524	285	3	80	0.0375000
NODE_4206_length_1166_cov_313.815370	444	524	286	1	80	0.0125000
NODE_4206_length_1166_cov_313.815370	444	524	288	1	80	0.0125000
NODE_4206_length_1166_cov_313.815370	444	524	304	1	80	0.0125000
NODE_4206_length_1166_cov_313.815370	444	524	324	1	80	0.0125000
NODE_4206_length_1166_cov_313.815370	444	524	342	1	80	0.0125000
NODE_4206_length_1166_cov_313.815370	444	524	348	1	80	0.0125000
NODE_4206_length_1166_cov_313.815370	444	524	362	1	80	0.0125000
NODE_4206_length_1166_cov_313.815370	444	524	366	1	80	0.0125000
NODE_4206_length_1166_cov_313.815370	444	524	367	2	80	0.0250000
NODE_4206_length_1166_cov_313.815370	444	524	368	1	80	0.0125000
NODE_4206_length_1166_cov_313.815370	444	524	369	1	80	0.0125000
NODE_4206_length_1166_cov_313.815370	444	524	61	8	80	0.1000000
NODE_4206_length_1166_cov_313.815370	444	524	62	3	80	0.0375000
NODE_4206_length_1166_cov_313.815370	444	524	69	2	80	0.0250000
NODE_4206_length_1166_cov_313.815370	444	524	70	1	80	0.0125000
NODE_4206_length_1166_cov_313.815370	444	524	72	2	80	0.0250000
NODE_4206_length_1166_cov_313.815370	444	524	79	1	80	0.0125000
NODE_4206_length_1166_cov_313.815370	444	524	80	1	80	0.0125000
NODE_4206_length_1166_cov_313.815370	444	524	84	1	80	0.0125000
NODE_4206_length_1166_cov_313.815370	444	524	89	2	80	0.0250000
NODE_4206_length_1166_cov_313.815370	444	524	91	1	80	0.0125000
NODE_4206_length_1166_cov_313.815370	444	524	97	1	80	0.0125000
NODE_4206_length_1166_cov_313.815370	444	524	103	5	80	0.0625000
NODE_4206_length_1166_cov_313.815370	444	524	106	1	80	0.0125000
NODE_4206_length_1166_cov_313.815370	444	524	118	1	80	0.0125000
NODE_4206_length_1166_cov_313.815370	444	524	120	1	80	0.0125000
NODE_4206_length_1166_cov_313.815370	444	524	121	1	80	0.0125000
NODE_4206_length_1166_cov_313.815370	444	524	122	1	80	0.0125000
NODE_4206_length_1166_cov_313.815370	444	524	123	1	80	0.0125000
NODE_4206_length_1166_cov_313.815370	444	524	124	1	80	0.0125000
NODE_4206_length_1166_cov_313.815370	444	524	133	2	80	0.0250000
NODE_4206_length_1166_cov_313.815370	444	524	146	2	80	0.0250000
NODE_4206_length_1166_cov_313.815370	444	524	148	2	80	0.0250000
NODE_4206_length_1166_cov_313.815370	444	524	164	3	80	0.0375000
NODE_4206_length_1166_cov_313.815370	444	524	170	1	80	0.0125000
NODE_4206_length_1166_cov_313.815370	444	524	174	1	80	0.0125000
NODE_4206_length_1166_cov_313.815370	444	524	184	1	80	0.0125000
NODE_4206_length_1166_cov_313.815370	444	524	185	2	80	0.0250000
NODE_4206_length_1166_cov_313.815370	444	524	192	2	80	0.0250000
NODE_4206_length_1166_cov_313.815370	444	524	205	3	80	0.0375000
NODE_4206_length_1166_cov_313.815370	444	524	207	1	80	0.0125000
NODE_4206_length_1166_cov_313.815370	444	524	217	1	80	0.0125000
NODE_4206_length_1166_cov_313.815370	444	524	221	1	80	0.0125000
NODE_4206_length_1166_cov_313.815370	444	524	233	1	80	0.0125000
NODE_4206_length_1166_cov_313.815370	444	524	235	1	80	0.0125000
NODE_4206_length_1166_cov_313.815370	444	524	237	1	80	0.0125000
NODE_4206_length_1166_cov_313.815370	444	524	238	2	80	0.0250000
NODE_4206_length_1166_cov_313.815370	444	524	259	1	80	0.0125000
NODE_4206_length_1166_cov_313.815370	444	524	276	1	80	0.0125000
NODE_4206_length_1166_cov_313.815370	444	524	277	1	80	0.0125000
NODE_4206_length_1166_cov_313.815370	444	524	285	3	80	0.0375000
NODE_4206_length_1166_cov_313.815370	444	524	286	1	80	0.0125000
NODE_4206_length_1166_cov_313.815370	444	524	288	1	80	0.0125000
NODE_4206_length_1166_cov_313.815370	444	524	304	1	80	0.0125000
NODE_4206_length_1166_cov_313.815370	444	524	324	1	80	0.0125000
NODE_4206_length_1166_cov_313.815370	444	524	342	1	80	0.0125000
NODE_4206_length_1166_cov_313.815370	444	524	348	1	80	0.0125000
NODE_4206_length_1166_cov_313.815370	444	524	362	1	80	0.0125000
NODE_4206_length_1166_cov_313.815370	444	524	366	1	80	0.0125000
NODE_4206_length_1166_cov_313.815370	444	524	367	2	80	0.0250000
NODE_4206_length_1166_cov_313.815370	444	524	368	1	80	0.0125000
NODE_4206_length_1166_cov_313.815370	444	524	369	1	80	0.0125000
NODE_4206_length_1166_cov_313.815370	444	524	61	8	80	0.1000000
NODE_4206_length_1166_cov_313.815370	444	524	62	3	80	0.0375000
NODE_4206_length_1166_cov_313.815370	444	524	69	2	80	0.0250000
NODE_4206_length_1166_cov_313.815370	444	524	70	1	80	0.0125000
NODE_4206_length_1166_cov_313.815370	444	524	72	2	80	0.0250000
NODE_4206_length_1166_cov_313.815370	444	524	79	1	80	0.0125000
NODE_4206_length_1166_cov_313.815370	444	524	80	1	80	0.0125000
NODE_4206_length_1166_cov_313.815370	444	524	84	1	80	0.0125000
NODE_4206_length_1166_cov_313.815370	444	524	89	2	80	0.0250000
NODE_4206_length_1166_cov_313.815370	444	524	91	1	80	0.0125000
NODE_4206_length_1166_cov_313.815370	444	524	97	1	80	0.0125000
NODE_4206_length_1166_cov_313.815370	444	524	103	5	80	0.0625000
NODE_4206_length_1166_cov_313.815370	444	524	106	1	80	0.0125000
NODE_4206_length_1166_cov_313.815370	444	524	118	1	80	0.0125000
NODE_4206_length_1166_cov_313.815370	444	524	120	1	80	0.0125000
NODE_4206_length_1166_cov_313.815370	444	524	121	1	80	0.0125000
NODE_4206_length_1166_cov_313.815370	444	524	122	1	80	0.0125000
NODE_4206_length_1166_cov_313.815370	444	524	123	1	80	0.0125000
NODE_4206_length_1166_cov_313.815370	444	524	124	1	80	0.0125000
NODE_4206_length_1166_cov_313.815370	444	524	133	2	80	0.0250000
NODE_4206_length_1166_cov_313.815370	444	524	146	2	80	0.0250000
NODE_4206_length_1166_cov_313.815370	444	524	148	2	80	0.0250000
NODE_4206_length_1166_cov_313.815370	444	524	164	3	80	0.0375000
NODE_4206_length_1166_cov_313.815370	444	524	170	1	80	0.0125000
NODE_4206_length_1166_cov_313.815370	444	524	174	1	80	0.0125000
NODE_4206_length_1166_cov_313.815370	444	524	184	1	80	0.0125000
NODE_4206_length_1166_cov_313.815370	444	524	185	2	80	0.0250000
NODE_4206_length_1166_cov_313.815370	444	524	192	2	80	0.0250000
NODE_4206_length_1166_cov_313.815370	444	524	205	3	80	0.0375000
NODE_4206_length_1166_cov_313.815370	444	524	207	1	80	0.0125000
NODE_4206_length_1166_cov_313.815370	444	524	217	1	80	0.0125000
NODE_4206_length_1166_cov_313.815370	444	524	221	1	80	0.0125000
NODE_4206_length_1166_cov_313.815370	444	524	233	1	80	0.0125000
NODE_4206_length_1166_cov_313.815370	444	524	235	1	80	0.0125000
NODE_4206_length_1166_cov_313.815370	444	524	237	1	80	0.0125000
NODE_4206_length_1166_cov_313.815370	444	524	238	2	80	0.0250000
NODE_4206_length_1166_cov_313.815370	444	524	259	1	80	0.0125000
NODE_4206_length_1166_cov_313.815370	444	524	276	1	80	0.0125000
NODE_4206_length_1166_cov_313.815370	444	524	277	1	80	0.0125000
NODE_4206_length_1166_cov_313.815370	444	524	285	3	80	0.0375000
NODE_4206_length_1166_cov_313.815370	444	524	286	1	80	0.0125000
NODE_4206_length_1166_cov_313.815370	444	524	288	1	80	0.0125000
NODE_4206_length_1166_cov_313.815370	444	524	304	1	80	0.0125000
NODE_4206_length_1166_cov_313.815370	444	524	324	1	80	0.0125000
NODE_4206_length_1166_cov_313.815370	444	524	342	1	80	0.0125000
NODE_4206_length_1166_cov_313.815370	444	524	348	1	80	0.0125000
NODE_4206_length_1166_cov_313.815370	444	524	362	1	80	0.0125000
NODE_4206_length_1166_cov_313.815370	444	524	366	1	80	0.0125000
NODE_4206_length_1166_cov_313.815370	444	524	367	2	80	0.0250000
NODE_4206_length_1166_cov_313.815370	444	524	368	1	80	0.0125000
NODE_4206_length_1166_cov_313.815370	444	524	369	1	80	0.0125000
NODE_4206_length_1166_cov_313.815370	444	524	61	8	80	0.1000000
NODE_4206_length_1166_cov_313.815370	444	524	62	3	80	0.0375000
NODE_4206_length_1166_cov_313.815370	444	524	69	2	80	0.0250000
NODE_4206_length_1166_cov_313.815370	444	524	70	1	80	0.0125000
NODE_4206_length_1166_cov_313.815370	444	524	72	2	80	0.0250000
NODE_4206_length_1166_cov_313.815370	444	524	79	1	80	0.0125000
NODE_4206_length_1166_cov_313.815370	444	524	80	1	80	0.0125000
NODE_4206_length_1166_cov_313.815370	444	524	84	1	80	0.0125000
NODE_4206_length_1166_cov_313.815370	444	524	89	2	80	0.0250000
NODE_4206_length_1166_cov_313.815370	444	524	91	1	80	0.0125000
NODE_4206_length_1166_cov_313.815370	444	524	97	1	80	0.0125000
NODE_4206_length_1166_cov_313.815370	444	524	103	5	80	0.0625000
NODE_4206_length_1166_cov_313.815370	444	524	106	1	80	0.0125000
NODE_4206_length_1166_cov_313.815370	444	524	118	1	80	0.0125000
NODE_4206_length_1166_cov_313.815370	444	524	120	1	80	0.0125000
NODE_4206_length_1166_cov_313.815370	444	524	121	1	80	0.0125000
NODE_4206_length_1166_cov_313.815370	444	524	122	1	80	0.0125000
NODE_4206_length_1166_cov_313.815370	444	524	123	1	80	0.0125000
NODE_4206_length_1166_cov_313.815370	444	524	124	1	80	0.0125000
NODE_4206_length_1166_cov_313.815370	444	524	133	2	80	0.0250000
NODE_4206_length_1166_cov_313.815370	444	524	146	2	80	0.0250000
NODE_4206_length_1166_cov_313.815370	444	524	148	2	80	0.0250000
NODE_4206_length_1166_cov_313.815370	444	524	164	3	80	0.0375000
NODE_4206_length_1166_cov_313.815370	444	524	170	1	80	0.0125000
NODE_4206_length_1166_cov_313.815370	444	524	174	1	80	0.0125000
NODE_4206_length_1166_cov_313.815370	444	524	184	1	80	0.0125000
NODE_4206_length_1166_cov_313.815370	444	524	185	2	80	0.0250000
NODE_4206_length_1166_cov_313.815370	444	524	192	2	80	0.0250000
NODE_4206_length_1166_cov_313.815370	444	524	205	3	80	0.0375000
NODE_4206_length_1166_cov_313.815370	444	524	207	1	80	0.0125000
NODE_4206_length_1166_cov_313.815370	444	524	217	1	80	0.0125000
NODE_4206_length_1166_cov_313.815370	444	524	221	1	80	0.0125000
NODE_4206_length_1166_cov_313.815370	444	524	233	1	80	0.0125000
NODE_4206_length_1166_cov_313.815370	444	524	235	1	80	0.0125000
NODE_4206_length_1166_cov_313.815370	444	524	237	1	80	0.0125000
NODE_4206_length_1166_cov_313.815370	444	524	238	2	80	0.0250000
NODE_4206_length_1166_cov_313.815370	444	524	259	1	80	0.0125000
NODE_4206_length_1166_cov_313.815370	444	524	276	1	80	0.0125000
NODE_4206_length_1166_cov_313.815370	444	524	277	1	80	0.0125000
NODE_4206_length_1166_cov_313.815370	444	524	285	3	80	0.0375000
NODE_4206_length_1166_cov_313.815370	444	524	286	1	80	0.0125000
NODE_4206_length_1166_cov_313.815370	444	524	288	1	80	0.0125000
NODE_4206_length_1166_cov_313.815370	444	524	304	1	80	0.0125000
NODE_4206_length_1166_cov_313.815370	444	524	324	1	80	0.0125000
NODE_4206_length_1166_cov_313.815370	444	524	342	1	80	0.0125000
NODE_4206_length_1166_cov_313.815370	444	524	348	1	80	0.0125000
NODE_4206_length_1166_cov_313.815370	444	524	362	1	80	0.0125000
NODE_4206_length_1166_cov_313.815370	444	524	366	1	80	0.0125000
NODE_4206_length_1166_cov_313.815370	444	524	367	2	80	0.0250000
NODE_4206_length_1166_cov_313.815370	444	524	368	1	80	0.0125000
NODE_4206_length_1166_cov_313.815370	444	524	369	1	80	0.0125000
NODE_4206_length_1166_cov_313.815370	444	524	61	8	80	0.1000000
NODE_4206_length_1166_cov_313.815370	444	524	62	3	80	0.0375000
NODE_4206_length_1166_cov_313.815370	444	524	69	2	80	0.0250000
NODE_4206_length_1166_cov_313.815370	444	524	70	1	80	0.0125000
NODE_4206_length_1166_cov_313.815370	444	524	72	2	80	0.0250000
NODE_4206_length_1166_cov_313.815370	444	524	79	1	80	0.0125000
NODE_4206_length_1166_cov_313.815370	444	524	80	1	80	0.0125000
NODE_4206_length_1166_cov_313.815370	444	524	84	1	80	0.0125000
NODE_4206_length_1166_cov_313.815370	444	524	89	2	80	0.0250000
NODE_4206_length_1166_cov_313.815370	444	524	91	1	80	0.0125000
NODE_4206_length_1166_cov_313.815370	444	524	97	1	80	0.0125000
NODE_4206_length_1166_cov_313.815370	444	524	103	5	80	0.0625000
NODE_4206_length_1166_cov_313.815370	444	524	106	1	80	0.0125000
NODE_4206_length_1166_cov_313.815370	444	524	118	1	80	0.0125000
NODE_4206_length_1166_cov_313.815370	444	524	120	1	80	0.0125000
NODE_4206_length_1166_cov_313.815370	444	524	121	1	80	0.0125000
NODE_4206_length_1166_cov_313.815370	444	524	122	1	80	0.0125000
NODE_4206_length_1166_cov_313.815370	444	524	123	1	80	0.0125000
NODE_4206_length_1166_cov_313.815370	444	524	124	1	80	0.0125000
NODE_4206_length_1166_cov_313.815370	444	524	133	2	80	0.0250000
NODE_4206_length_1166_cov_313.815370	444	524	146	2	80	0.0250000
NODE_4206_length_1166_cov_313.815370	444	524	148	2	80	0.0250000
NODE_4206_length_1166_cov_313.815370	444	524	164	3	80	0.0375000
NODE_4206_length_1166_cov_313.815370	444	524	170	1	80	0.0125000
NODE_4206_length_1166_cov_313.815370	444	524	174	1	80	0.0125000
NODE_4206_length_1166_cov_313.815370	444	524	184	1	80	0.0125000
NODE_4206_length_1166_cov_313.815370	444	524	185	2	80	0.0250000
NODE_4206_length_1166_cov_313.815370	444	524	192	2	80	0.0250000
NODE_4206_length_1166_cov_313.815370	444	524	205	3	80	0.0375000
NODE_4206_length_1166_cov_313.815370	444	524	207	1	80	0.0125000
NODE_4206_length_1166_cov_313.815370	444	524	217	1	80	0.0125000
NODE_4206_length_1166_cov_313.815370	444	524	221	1	80	0.0125000
NODE_4206_length_1166_cov_313.815370	444	524	233	1	80	0.0125000
NODE_4206_length_1166_cov_313.815370	444	524	235	1	80	0.0125000
NODE_4206_length_1166_cov_313.815370	444	524	237	1	80	0.0125000
NODE_4206_length_1166_cov_313.815370	444	524	238	2	80	0.0250000
NODE_4206_length_1166_cov_313.815370	444	524	259	1	80	0.0125000
NODE_4206_length_1166_cov_313.815370	444	524	276	1	80	0.0125000
NODE_4206_length_1166_cov_313.815370	444	524	277	1	80	0.0125000
NODE_4206_length_1166_cov_313.815370	444	524	285	3	80	0.0375000
NODE_4206_length_1166_cov_313.815370	444	524	286	1	80	0.0125000
NODE_4206_length_1166_cov_313.815370	444	524	288	1	80	0.0125000
NODE_4206_length_1166_cov_313.815370	444	524	304	1	80	0.0125000
NODE_4206_length_1166_cov_313.815370	444	524	324	1	80	0.0125000
NODE_4206_length_1166_cov_313.815370	444	524	342	1	80	0.0125000
NODE_4206_length_1166_cov_313.815370	444	524	348	1	80	0.0125000
NODE_4206_length_1166_cov_313.815370	444	524	362	1	80	0.0125000
NODE_4206_length_1166_cov_313.815370	444	524	366	1	80	0.0125000
NODE_4206_length_1166_cov_313.815370	444	524	367	2	80	0.0250000
NODE_4206_length_1166_cov_313.815370	444	524	368	1	80	0.0125000
NODE_4206_length_1166_cov_313.815370	444	524	369	1	80	0.0125000
NODE_4206_length_1166_cov_313.815370	444	524	61	8	80	0.1000000
NODE_4206_length_1166_cov_313.815370	444	524	62	3	80	0.0375000
NODE_4206_length_1166_cov_313.815370	444	524	69	2	80	0.0250000
NODE_4206_length_1166_cov_313.815370	444	524	70	1	80	0.0125000
NODE_4206_length_1166_cov_313.815370	444	524	72	2	80	0.0250000
NODE_4206_length_1166_cov_313.815370	444	524	79	1	80	0.0125000
NODE_4206_length_1166_cov_313.815370	444	524	80	1	80	0.0125000
NODE_4206_length_1166_cov_313.815370	444	524	84	1	80	0.0125000
NODE_4206_length_1166_cov_313.815370	444	524	89	2	80	0.0250000
NODE_4206_length_1166_cov_313.815370	444	524	91	1	80	0.0125000
NODE_4206_length_1166_cov_313.815370	444	524	97	1	80	0.0125000
NODE_4206_length_1166_cov_313.815370	444	524	103	5	80	0.0625000
NODE_4206_length_1166_cov_313.815370	444	524	106	1	80	0.0125000
NODE_4206_length_1166_cov_313.815370	444	524	118	1	80	0.0125000
NODE_4206_length_1166_cov_313.815370	444	524	120	1	80	0.0125000
NODE_4206_length_1166_cov_313.815370	444	524	121	1	80	0.0125000
NODE_4206_length_1166_cov_313.815370	444	524	122	1	80	0.0125000
NODE_4206_length_1166_cov_313.815370	444	524	123	1	80	0.0125000
NODE_4206_length_1166_cov_313.815370	444	524	124	1	80	0.0125000
NODE_4206_length_1166_cov_313.815370	444	524	133	2	80	0.0250000
NODE_4206_length_1166_cov_313.815370	444	524	146	2	80	0.0250000
NODE_4206_length_1166_cov_313.815370	444	524	148	2	80	0.0250000
NODE_4206_length_1166_cov_313.815370	444	524	164	3	80	0.0375000
NODE_4206_length_1166_cov_313.815370	444	524	170	1	80	0.0125000
NODE_4206_length_1166_cov_313.815370	444	524	174	1	80	0.0125000
NODE_4206_length_1166_cov_313.815370	444	524	184	1	80	0.0125000
NODE_4206_length_1166_cov_313.815370	444	524	185	2	80	0.0250000
NODE_4206_length_1166_cov_313.815370	444	524	192	2	80	0.0250000
NODE_4206_length_1166_cov_313.815370	444	524	205	3	80	0.0375000
NODE_4206_length_1166_cov_313.815370	444	524	207	1	80	0.0125000
NODE_4206_length_1166_cov_313.815370	444	524	217	1	80	0.0125000
NODE_4206_length_1166_cov_313.815370	444	524	221	1	80	0.0125000
NODE_4206_length_1166_cov_313.815370	444	524	233	1	80	0.0125000
NODE_4206_length_1166_cov_313.815370	444	524	235	1	80	0.0125000
NODE_4206_length_1166_cov_313.815370	444	524	237	1	80	0.0125000
NODE_4206_length_1166_cov_313.815370	444	524	238	2	80	0.0250000
NODE_4206_length_1166_cov_313.815370	444	524	259	1	80	0.0125000
NODE_4206_length_1166_cov_313.815370	444	524	276	1	80	0.0125000
NODE_4206_length_1166_cov_313.815370	444	524	277	1	80	0.0125000
NODE_4206_length_1166_cov_313.815370	444	524	285	3	80	0.0375000
NODE_4206_length_1166_cov_313.815370	444	524	286	1	80	0.0125000
NODE_4206_length_1166_cov_313.815370	444	524	288	1	80	0.0125000
NODE_4206_length_1166_cov_313.815370	444	524	304	1	80	0.0125000
NODE_4206_length_1166_cov_313.815370	444	524	324	1	80	0.0125000
NODE_4206_length_1166_cov_313.815370	444	524	342	1	80	0.0125000
NODE_4206_length_1166_cov_313.815370	444	524	348	1	80	0.0125000
NODE_4206_length_1166_cov_313.815370	444	524	362	1	80	0.0125000
NODE_4206_length_1166_cov_313.815370	444	524	366	1	80	0.0125000
NODE_4206_length_1166_cov_313.815370	444	524	367	2	80	0.0250000
NODE_4206_length_1166_cov_313.815370	444	524	368	1	80	0.0125000
NODE_4206_length_1166_cov_313.815370	444	524	369	1	80	0.0125000
NODE_4206_length_1166_cov_313.815370	497	577	205	1	80	0.0125000
NODE_4206_length_1166_cov_313.815370	497	577	207	1	80	0.0125000
NODE_4206_length_1166_cov_313.815370	497	577	217	1	80	0.0125000
NODE_4206_length_1166_cov_313.815370	497	577	221	1	80	0.0125000
NODE_4206_length_1166_cov_313.815370	497	577	233	1	80	0.0125000
NODE_4206_length_1166_cov_313.815370	497	577	235	1	80	0.0125000
NODE_4206_length_1166_cov_313.815370	497	577	237	1	80	0.0125000
NODE_4206_length_1166_cov_313.815370	497	577	238	2	80	0.0250000
NODE_4206_length_1166_cov_313.815370	497	577	259	1	80	0.0125000
NODE_4206_length_1166_cov_313.815370	497	577	276	1	80	0.0125000
NODE_4206_length_1166_cov_313.815370	497	577	277	1	80	0.0125000
NODE_4206_length_1166_cov_313.815370	497	577	285	3	80	0.0375000
NODE_4206_length_1166_cov_313.815370	497	577	286	1	80	0.0125000
NODE_4206_length_1166_cov_313.815370	497	577	288	1	80	0.0125000
NODE_4206_length_1166_cov_313.815370	497	577	304	1	80	0.0125000
NODE_4206_length_1166_cov_313.815370	497	577	324	1	80	0.0125000
NODE_4206_length_1166_cov_313.815370	497	577	342	1	80	0.0125000
NODE_4206_length_1166_cov_313.815370	497	577	348	1	80	0.0125000
NODE_4206_length_1166_cov_313.815370	497	577	362	1	80	0.0125000
NODE_4206_length_1166_cov_313.815370	497	577	366	1	80	0.0125000
NODE_4206_length_1166_cov_313.815370	497	577	367	2	80	0.0250000
NODE_4206_length_1166_cov_313.815370	497	577	368	1	80	0.0125000
NODE_4206_length_1166_cov_313.815370	497	577	369	1	80	0.0125000
NODE_4206_length_1166_cov_313.815370	497	577	371	1	80	0.0125000
NODE_4206_length_1166_cov_313.815370	497	577	377	2	80	0.0250000
NODE_4206_length_1166_cov_313.815370	497	577	378	6	80	0.0750000
NODE_4206_length_1166_cov_313.815370	497	577	379	4	80	0.0500000
NODE_4206_length_1166_cov_313.815370	497	577	380	3	80	0.0375000
NODE_4206_length_1166_cov_313.815370	497	577	381	3	80	0.0375000
NODE_4206_length_1166_cov_313.815370	497	577	382	6	80	0.0750000
NODE_4206_length_1166_cov_313.815370	497	577	383	15	80	0.1875000
NODE_4206_length_1166_cov_313.815370	497	577	387	1	80	0.0125000
NODE_4206_length_1166_cov_313.815370	497	577	388	6	80	0.0750000
NODE_4206_length_1166_cov_313.815370	497	577	389	1	80	0.0125000
NODE_4206_length_1166_cov_313.815370	497	577	390	2	80	0.0250000
NODE_4206_length_1166_cov_313.815370	497	577	393	1	80	0.0125000
NODE_4206_length_1166_cov_313.815370	497	577	394	1	80	0.0125000
NODE_4206_length_1166_cov_313.815370	497	577	397	1	80	0.0125000
NODE_4206_length_1166_cov_313.815370	497	577	205	1	80	0.0125000
NODE_4206_length_1166_cov_313.815370	497	577	207	1	80	0.0125000
NODE_4206_length_1166_cov_313.815370	497	577	217	1	80	0.0125000
NODE_4206_length_1166_cov_313.815370	497	577	221	1	80	0.0125000
NODE_4206_length_1166_cov_313.815370	497	577	233	1	80	0.0125000
NODE_4206_length_1166_cov_313.815370	497	577	235	1	80	0.0125000
NODE_4206_length_1166_cov_313.815370	497	577	237	1	80	0.0125000
NODE_4206_length_1166_cov_313.815370	497	577	238	2	80	0.0250000
NODE_4206_length_1166_cov_313.815370	497	577	259	1	80	0.0125000
NODE_4206_length_1166_cov_313.815370	497	577	276	1	80	0.0125000
NODE_4206_length_1166_cov_313.815370	497	577	277	1	80	0.0125000
NODE_4206_length_1166_cov_313.815370	497	577	285	3	80	0.0375000
NODE_4206_length_1166_cov_313.815370	497	577	286	1	80	0.0125000
NODE_4206_length_1166_cov_313.815370	497	577	288	1	80	0.0125000
NODE_4206_length_1166_cov_313.815370	497	577	304	1	80	0.0125000
NODE_4206_length_1166_cov_313.815370	497	577	324	1	80	0.0125000
NODE_4206_length_1166_cov_313.815370	497	577	342	1	80	0.0125000
NODE_4206_length_1166_cov_313.815370	497	577	348	1	80	0.0125000
NODE_4206_length_1166_cov_313.815370	497	577	362	1	80	0.0125000
NODE_4206_length_1166_cov_313.815370	497	577	366	1	80	0.0125000
NODE_4206_length_1166_cov_313.815370	497	577	367	2	80	0.0250000
NODE_4206_length_1166_cov_313.815370	497	577	368	1	80	0.0125000
NODE_4206_length_1166_cov_313.815370	497	577	369	1	80	0.0125000
NODE_4206_length_1166_cov_313.815370	497	577	371	1	80	0.0125000
NODE_4206_length_1166_cov_313.815370	497	577	377	2	80	0.0250000
NODE_4206_length_1166_cov_313.815370	497	577	378	6	80	0.0750000
NODE_4206_length_1166_cov_313.815370	497	577	379	4	80	0.0500000
NODE_4206_length_1166_cov_313.815370	497	577	380	3	80	0.0375000
NODE_4206_length_1166_cov_313.815370	497	577	381	3	80	0.0375000
NODE_4206_length_1166_cov_313.815370	497	577	382	6	80	0.0750000
NODE_4206_length_1166_cov_313.815370	497	577	383	15	80	0.1875000
NODE_4206_length_1166_cov_313.815370	497	577	387	1	80	0.0125000
NODE_4206_length_1166_cov_313.815370	497	577	388	6	80	0.0750000
NODE_4206_length_1166_cov_313.815370	497	577	389	1	80	0.0125000
NODE_4206_length_1166_cov_313.815370	497	577	390	2	80	0.0250000
NODE_4206_length_1166_cov_313.815370	497	577	393	1	80	0.0125000
NODE_4206_length_1166_cov_313.815370	497	577	394	1	80	0.0125000
NODE_4206_length_1166_cov_313.815370	497	577	397	1	80	0.0125000
NODE_4206_length_1166_cov_313.815370	497	577	205	1	80	0.0125000
NODE_4206_length_1166_cov_313.815370	497	577	207	1	80	0.0125000
NODE_4206_length_1166_cov_313.815370	497	577	217	1	80	0.0125000
NODE_4206_length_1166_cov_313.815370	497	577	221	1	80	0.0125000
NODE_4206_length_1166_cov_313.815370	497	577	233	1	80	0.0125000
NODE_4206_length_1166_cov_313.815370	497	577	235	1	80	0.0125000
NODE_4206_length_1166_cov_313.815370	497	577	237	1	80	0.0125000
NODE_4206_length_1166_cov_313.815370	497	577	238	2	80	0.0250000
NODE_4206_length_1166_cov_313.815370	497	577	259	1	80	0.0125000
NODE_4206_length_1166_cov_313.815370	497	577	276	1	80	0.0125000
NODE_4206_length_1166_cov_313.815370	497	577	277	1	80	0.0125000
NODE_4206_length_1166_cov_313.815370	497	577	285	3	80	0.0375000
NODE_4206_length_1166_cov_313.815370	497	577	286	1	80	0.0125000
NODE_4206_length_1166_cov_313.815370	497	577	288	1	80	0.0125000
NODE_4206_length_1166_cov_313.815370	497	577	304	1	80	0.0125000
NODE_4206_length_1166_cov_313.815370	497	577	324	1	80	0.0125000
NODE_4206_length_1166_cov_313.815370	497	577	342	1	80	0.0125000
NODE_4206_length_1166_cov_313.815370	497	577	348	1	80	0.0125000
NODE_4206_length_1166_cov_313.815370	497	577	362	1	80	0.0125000
NODE_4206_length_1166_cov_313.815370	497	577	366	1	80	0.0125000
NODE_4206_length_1166_cov_313.815370	497	577	367	2	80	0.0250000
NODE_4206_length_1166_cov_313.815370	497	577	368	1	80	0.0125000
NODE_4206_length_1166_cov_313.815370	497	577	369	1	80	0.0125000
NODE_4206_length_1166_cov_313.815370	497	577	371	1	80	0.0125000
NODE_4206_length_1166_cov_313.815370	497	577	377	2	80	0.0250000
NODE_4206_length_1166_cov_313.815370	497	577	378	6	80	0.0750000
NODE_4206_length_1166_cov_313.815370	497	577	379	4	80	0.0500000
NODE_4206_length_1166_cov_313.815370	497	577	380	3	80	0.0375000
NODE_4206_length_1166_cov_313.815370	497	577	381	3	80	0.0375000
NODE_4206_length_1166_cov_313.815370	497	577	382	6	80	0.0750000
NODE_4206_length_1166_cov_313.815370	497	577	383	15	80	0.1875000
NODE_4206_length_1166_cov_313.815370	497	577	387	1	80	0.0125000
NODE_4206_length_1166_cov_313.815370	497	577	388	6	80	0.0750000
NODE_4206_length_1166_cov_313.815370	497	577	389	1	80	0.0125000
NODE_4206_length_1166_cov_313.815370	497	577	390	2	80	0.0250000
NODE_4206_length_1166_cov_313.815370	497	577	393	1	80	0.0125000
NODE_4206_length_1166_cov_313.815370	497	577	394	1	80	0.0125000
NODE_4206_length_1166_cov_313.815370	497	577	397	1	80	0.0125000
NODE_4206_length_1166_cov_313.815370	497	577	205	1	80	0.0125000
NODE_4206_length_1166_cov_313.815370	497	577	207	1	80	0.0125000
NODE_4206_length_1166_cov_313.815370	497	577	217	1	80	0.0125000
NODE_4206_length_1166_cov_313.815370	497	577	221	1	80	0.0125000
NODE_4206_length_1166_cov_313.815370	497	577	233	1	80	0.0125000
NODE_4206_length_1166_cov_313.815370	497	577	235	1	80	0.0125000
NODE_4206_length_1166_cov_313.815370	497	577	237	1	80	0.0125000
NODE_4206_length_1166_cov_313.815370	497	577	238	2	80	0.0250000
NODE_4206_length_1166_cov_313.815370	497	577	259	1	80	0.0125000
NODE_4206_length_1166_cov_313.815370	497	577	276	1	80	0.0125000
NODE_4206_length_1166_cov_313.815370	497	577	277	1	80	0.0125000
NODE_4206_length_1166_cov_313.815370	497	577	285	3	80	0.0375000
NODE_4206_length_1166_cov_313.815370	497	577	286	1	80	0.0125000
NODE_4206_length_1166_cov_313.815370	497	577	288	1	80	0.0125000
NODE_4206_length_1166_cov_313.815370	497	577	304	1	80	0.0125000
NODE_4206_length_1166_cov_313.815370	497	577	324	1	80	0.0125000
NODE_4206_length_1166_cov_313.815370	497	577	342	1	80	0.0125000
NODE_4206_length_1166_cov_313.815370	497	577	348	1	80	0.0125000
NODE_4206_length_1166_cov_313.815370	497	577	362	1	80	0.0125000
NODE_4206_length_1166_cov_313.815370	497	577	366	1	80	0.0125000
NODE_4206_length_1166_cov_313.815370	497	577	367	2	80	0.0250000
NODE_4206_length_1166_cov_313.815370	497	577	368	1	80	0.0125000
NODE_4206_length_1166_cov_313.815370	497	577	369	1	80	0.0125000
NODE_4206_length_1166_cov_313.815370	497	577	371	1	80	0.0125000
NODE_4206_length_1166_cov_313.815370	497	577	377	2	80	0.0250000
NODE_4206_length_1166_cov_313.815370	497	577	378	6	80	0.0750000
NODE_4206_length_1166_cov_313.815370	497	577	379	4	80	0.0500000
NODE_4206_length_1166_cov_313.815370	497	577	380	3	80	0.0375000
NODE_4206_length_1166_cov_313.815370	497	577	381	3	80	0.0375000
NODE_4206_length_1166_cov_313.815370	497	577	382	6	80	0.0750000
NODE_4206_length_1166_cov_313.815370	497	577	383	15	80	0.1875000
NODE_4206_length_1166_cov_313.815370	497	577	387	1	80	0.0125000
NODE_4206_length_1166_cov_313.815370	497	577	388	6	80	0.0750000
NODE_4206_length_1166_cov_313.815370	497	577	389	1	80	0.0125000
NODE_4206_length_1166_cov_313.815370	497	577	390	2	80	0.0250000
NODE_4206_length_1166_cov_313.815370	497	577	393	1	80	0.0125000
NODE_4206_length_1166_cov_313.815370	497	577	394	1	80	0.0125000
NODE_4206_length_1166_cov_313.815370	497	577	397	1	80	0.0125000
NODE_4206_length_1166_cov_313.815370	497	577	205	1	80	0.0125000
NODE_4206_length_1166_cov_313.815370	497	577	207	1	80	0.0125000
NODE_4206_length_1166_cov_313.815370	497	577	217	1	80	0.0125000
NODE_4206_length_1166_cov_313.815370	497	577	221	1	80	0.0125000
NODE_4206_length_1166_cov_313.815370	497	577	233	1	80	0.0125000
NODE_4206_length_1166_cov_313.815370	497	577	235	1	80	0.0125000
NODE_4206_length_1166_cov_313.815370	497	577	237	1	80	0.0125000
NODE_4206_length_1166_cov_313.815370	497	577	238	2	80	0.0250000
NODE_4206_length_1166_cov_313.815370	497	577	259	1	80	0.0125000
NODE_4206_length_1166_cov_313.815370	497	577	276	1	80	0.0125000
NODE_4206_length_1166_cov_313.815370	497	577	277	1	80	0.0125000
NODE_4206_length_1166_cov_313.815370	497	577	285	3	80	0.0375000
NODE_4206_length_1166_cov_313.815370	497	577	286	1	80	0.0125000
NODE_4206_length_1166_cov_313.815370	497	577	288	1	80	0.0125000
NODE_4206_length_1166_cov_313.815370	497	577	304	1	80	0.0125000
NODE_4206_length_1166_cov_313.815370	497	577	324	1	80	0.0125000
NODE_4206_length_1166_cov_313.815370	497	577	342	1	80	0.0125000
NODE_4206_length_1166_cov_313.815370	497	577	348	1	80	0.0125000
NODE_4206_length_1166_cov_313.815370	497	577	362	1	80	0.0125000
NODE_4206_length_1166_cov_313.815370	497	577	366	1	80	0.0125000
NODE_4206_length_1166_cov_313.815370	497	577	367	2	80	0.0250000
NODE_4206_length_1166_cov_313.815370	497	577	368	1	80	0.0125000
NODE_4206_length_1166_cov_313.815370	497	577	369	1	80	0.0125000
NODE_4206_length_1166_cov_313.815370	497	577	371	1	80	0.0125000
NODE_4206_length_1166_cov_313.815370	497	577	377	2	80	0.0250000
NODE_4206_length_1166_cov_313.815370	497	577	378	6	80	0.0750000
NODE_4206_length_1166_cov_313.815370	497	577	379	4	80	0.0500000
NODE_4206_length_1166_cov_313.815370	497	577	380	3	80	0.0375000
NODE_4206_length_1166_cov_313.815370	497	577	381	3	80	0.0375000
NODE_4206_length_1166_cov_313.815370	497	577	382	6	80	0.0750000
NODE_4206_length_1166_cov_313.815370	497	577	383	15	80	0.1875000
NODE_4206_length_1166_cov_313.815370	497	577	387	1	80	0.0125000
NODE_4206_length_1166_cov_313.815370	497	577	388	6	80	0.0750000
NODE_4206_length_1166_cov_313.815370	497	577	389	1	80	0.0125000
NODE_4206_length_1166_cov_313.815370	497	577	390	2	80	0.0250000
NODE_4206_length_1166_cov_313.815370	497	577	393	1	80	0.0125000
NODE_4206_length_1166_cov_313.815370	497	577	394	1	80	0.0125000
NODE_4206_length_1166_cov_313.815370	497	577	397	1	80	0.0125000
NODE_4206_length_1166_cov_313.815370	497	577	205	1	80	0.0125000
NODE_4206_length_1166_cov_313.815370	497	577	207	1	80	0.0125000
NODE_4206_length_1166_cov_313.815370	497	577	217	1	80	0.0125000
NODE_4206_length_1166_cov_313.815370	497	577	221	1	80	0.0125000
NODE_4206_length_1166_cov_313.815370	497	577	233	1	80	0.0125000
NODE_4206_length_1166_cov_313.815370	497	577	235	1	80	0.0125000
NODE_4206_length_1166_cov_313.815370	497	577	237	1	80	0.0125000
NODE_4206_length_1166_cov_313.815370	497	577	238	2	80	0.0250000
NODE_4206_length_1166_cov_313.815370	497	577	259	1	80	0.0125000
NODE_4206_length_1166_cov_313.815370	497	577	276	1	80	0.0125000
NODE_4206_length_1166_cov_313.815370	497	577	277	1	80	0.0125000
NODE_4206_length_1166_cov_313.815370	497	577	285	3	80	0.0375000
NODE_4206_length_1166_cov_313.815370	497	577	286	1	80	0.0125000
NODE_4206_length_1166_cov_313.815370	497	577	288	1	80	0.0125000
NODE_4206_length_1166_cov_313.815370	497	577	304	1	80	0.0125000
NODE_4206_length_1166_cov_313.815370	497	577	324	1	80	0.0125000
NODE_4206_length_1166_cov_313.815370	497	577	342	1	80	0.0125000
NODE_4206_length_1166_cov_313.815370	497	577	348	1	80	0.0125000
NODE_4206_length_1166_cov_313.815370	497	577	362	1	80	0.0125000
NODE_4206_length_1166_cov_313.815370	497	577	366	1	80	0.0125000
NODE_4206_length_1166_cov_313.815370	497	577	367	2	80	0.0250000
NODE_4206_length_1166_cov_313.815370	497	577	368	1	80	0.0125000
NODE_4206_length_1166_cov_313.815370	497	577	369	1	80	0.0125000
NODE_4206_length_1166_cov_313.815370	497	577	371	1	80	0.0125000
NODE_4206_length_1166_cov_313.815370	497	577	377	2	80	0.0250000
NODE_4206_length_1166_cov_313.815370	497	577	378	6	80	0.0750000
NODE_4206_length_1166_cov_313.815370	497	577	379	4	80	0.0500000
NODE_4206_length_1166_cov_313.815370	497	577	380	3	80	0.0375000
NODE_4206_length_1166_cov_313.815370	497	577	381	3	80	0.0375000
NODE_4206_length_1166_cov_313.815370	497	577	382	6	80	0.0750000
NODE_4206_length_1166_cov_313.815370	497	577	383	15	80	0.1875000
NODE_4206_length_1166_cov_313.815370	497	577	387	1	80	0.0125000
NODE_4206_length_1166_cov_313.815370	497	577	388	6	80	0.0750000
NODE_4206_length_1166_cov_313.815370	497	577	389	1	80	0.0125000
NODE_4206_length_1166_cov_313.815370	497	577	390	2	80	0.0250000
NODE_4206_length_1166_cov_313.815370	497	577	393	1	80	0.0125000
NODE_4206_length_1166_cov_313.815370	497	577	394	1	80	0.0125000
NODE_4206_length_1166_cov_313.815370	497	577	397	1	80	0.0125000
NODE_4206_length_1166_cov_313.815370	497	568	205	1	71	0.0140845
NODE_4206_length_1166_cov_313.815370	497	568	207	1	71	0.0140845
NODE_4206_length_1166_cov_313.815370	497	568	217	1	71	0.0140845
NODE_4206_length_1166_cov_313.815370	497	568	221	1	71	0.0140845
NODE_4206_length_1166_cov_313.815370	497	568	233	1	71	0.0140845
NODE_4206_length_1166_cov_313.815370	497	568	235	1	71	0.0140845
NODE_4206_length_1166_cov_313.815370	497	568	237	1	71	0.0140845
NODE_4206_length_1166_cov_313.815370	497	568	238	2	71	0.0281690
NODE_4206_length_1166_cov_313.815370	497	568	259	1	71	0.0140845
NODE_4206_length_1166_cov_313.815370	497	568	276	1	71	0.0140845
NODE_4206_length_1166_cov_313.815370	497	568	277	1	71	0.0140845
NODE_4206_length_1166_cov_313.815370	497	568	285	3	71	0.0422535
NODE_4206_length_1166_cov_313.815370	497	568	286	1	71	0.0140845
NODE_4206_length_1166_cov_313.815370	497	568	288	1	71	0.0140845
NODE_4206_length_1166_cov_313.815370	497	568	304	1	71	0.0140845
NODE_4206_length_1166_cov_313.815370	497	568	324	1	71	0.0140845
NODE_4206_length_1166_cov_313.815370	497	568	342	1	71	0.0140845
NODE_4206_length_1166_cov_313.815370	497	568	348	1	71	0.0140845
NODE_4206_length_1166_cov_313.815370	497	568	362	1	71	0.0140845
NODE_4206_length_1166_cov_313.815370	497	568	366	1	71	0.0140845
NODE_4206_length_1166_cov_313.815370	497	568	367	2	71	0.0281690
NODE_4206_length_1166_cov_313.815370	497	568	368	1	71	0.0140845
NODE_4206_length_1166_cov_313.815370	497	568	369	1	71	0.0140845
NODE_4206_length_1166_cov_313.815370	497	568	371	1	71	0.0140845
NODE_4206_length_1166_cov_313.815370	497	568	378	3	71	0.0422535
NODE_4206_length_1166_cov_313.815370	497	568	380	3	71	0.0422535
NODE_4206_length_1166_cov_313.815370	497	568	381	3	71	0.0422535
NODE_4206_length_1166_cov_313.815370	497	568	382	6	71	0.0845070
NODE_4206_length_1166_cov_313.815370	497	568	383	15	71	0.2112676
NODE_4206_length_1166_cov_313.815370	497	568	387	1	71	0.0140845
NODE_4206_length_1166_cov_313.815370	497	568	388	6	71	0.0845070
NODE_4206_length_1166_cov_313.815370	497	568	389	1	71	0.0140845
NODE_4206_length_1166_cov_313.815370	497	568	390	2	71	0.0281690
NODE_4206_length_1166_cov_313.815370	497	568	393	1	71	0.0140845
NODE_4206_length_1166_cov_313.815370	497	568	394	1	71	0.0140845
NODE_4206_length_1166_cov_313.815370	497	568	397	1	71	0.0140845
NODE_4206_length_1166_cov_313.815370	500	570	221	1	70	0.0142857
NODE_4206_length_1166_cov_313.815370	500	570	233	1	70	0.0142857
NODE_4206_length_1166_cov_313.815370	500	570	235	1	70	0.0142857
NODE_4206_length_1166_cov_313.815370	500	570	237	1	70	0.0142857
NODE_4206_length_1166_cov_313.815370	500	570	238	2	70	0.0285714
NODE_4206_length_1166_cov_313.815370	500	570	259	1	70	0.0142857
NODE_4206_length_1166_cov_313.815370	500	570	276	1	70	0.0142857
NODE_4206_length_1166_cov_313.815370	500	570	277	1	70	0.0142857
NODE_4206_length_1166_cov_313.815370	500	570	285	3	70	0.0428571
NODE_4206_length_1166_cov_313.815370	500	570	286	1	70	0.0142857
NODE_4206_length_1166_cov_313.815370	500	570	288	1	70	0.0142857
NODE_4206_length_1166_cov_313.815370	500	570	304	1	70	0.0142857
NODE_4206_length_1166_cov_313.815370	500	570	324	1	70	0.0142857
NODE_4206_length_1166_cov_313.815370	500	570	342	1	70	0.0142857
NODE_4206_length_1166_cov_313.815370	500	570	348	1	70	0.0142857
NODE_4206_length_1166_cov_313.815370	500	570	362	1	70	0.0142857
NODE_4206_length_1166_cov_313.815370	500	570	366	1	70	0.0142857
NODE_4206_length_1166_cov_313.815370	500	570	367	2	70	0.0285714
NODE_4206_length_1166_cov_313.815370	500	570	368	1	70	0.0142857
NODE_4206_length_1166_cov_313.815370	500	570	369	1	70	0.0142857
NODE_4206_length_1166_cov_313.815370	500	570	371	1	70	0.0142857
NODE_4206_length_1166_cov_313.815370	500	570	378	5	70	0.0714286
NODE_4206_length_1166_cov_313.815370	500	570	380	3	70	0.0428571
NODE_4206_length_1166_cov_313.815370	500	570	381	3	70	0.0428571
NODE_4206_length_1166_cov_313.815370	500	570	382	6	70	0.0857143
NODE_4206_length_1166_cov_313.815370	500	570	383	15	70	0.2142857
NODE_4206_length_1166_cov_313.815370	500	570	387	1	70	0.0142857
NODE_4206_length_1166_cov_313.815370	500	570	388	6	70	0.0857143
NODE_4206_length_1166_cov_313.815370	500	570	389	1	70	0.0142857
NODE_4206_length_1166_cov_313.815370	500	570	390	2	70	0.0285714
NODE_4206_length_1166_cov_313.815370	500	570	393	1	70	0.0142857
NODE_4206_length_1166_cov_313.815370	500	570	394	1	70	0.0142857
NODE_4206_length_1166_cov_313.815370	500	570	397	1	70	0.0142857
NODE_4206_length_1166_cov_313.815370	997	1077	2	3	80	0.0375000
NODE_4206_length_1166_cov_313.815370	997	1077	4	1	80	0.0125000
NODE_4206_length_1166_cov_313.815370	997	1077	11	1	80	0.0125000
NODE_4206_length_1166_cov_313.815370	997	1077	12	4	80	0.0500000
NODE_4206_length_1166_cov_313.815370	997	1077	16	19	80	0.2375000
NODE_4206_length_1166_cov_313.815370	997	1077	18	11	80	0.1375000
NODE_4206_length_1166_cov_313.815370	997	1077	30	6	80	0.0750000
NODE_4206_length_1166_cov_313.815370	997	1077	32	2	80	0.0250000
NODE_4206_length_1166_cov_313.815370	997	1077	34	33	80	0.4125000
NODE_4206_length_1166_cov_313.815370	1050	1130	8	5	80	0.0625000
NODE_4206_length_1166_cov_313.815370	1050	1130	10	3	80	0.0375000
NODE_4206_length_1166_cov_313.815370	1050	1130	12	4	80	0.0500000
NODE_4206_length_1166_cov_313.815370	1050	1130	24	31	80	0.3875000
NODE_4206_length_1166_cov_313.815370	1050	1130	30	1	80	0.0125000
NODE_4206_length_1166_cov_313.815370	1050	1130	32	1	80	0.0125000
NODE_4206_length_1166_cov_313.815370	1050	1130	34	35	80	0.4375000
NODE_4206_length_1166_cov_313.815370	1050	1130	8	5	80	0.0625000
NODE_4206_length_1166_cov_313.815370	1050	1130	10	3	80	0.0375000
NODE_4206_length_1166_cov_313.815370	1050	1130	12	4	80	0.0500000
NODE_4206_length_1166_cov_313.815370	1050	1130	24	31	80	0.3875000
NODE_4206_length_1166_cov_313.815370	1050	1130	30	1	80	0.0125000
NODE_4206_length_1166_cov_313.815370	1050	1130	32	1	80	0.0125000
NODE_4206_length_1166_cov_313.815370	1050	1130	34	35	80	0.4375000
NODE_4206_length_1166_cov_313.815370	1050	1121	12	3	71	0.0422535
NODE_4206_length_1166_cov_313.815370	1050	1121	24	31	71	0.4366197
NODE_4206_length_1166_cov_313.815370	1050	1121	30	1	71	0.0140845
NODE_4206_length_1166_cov_313.815370	1050	1121	32	1	71	0.0140845
NODE_4206_length_1166_cov_313.815370	1050	1121	34	35	71	0.4929577
NODE_4207_length_1166_cov_25.107779	561	641	4	16	80	0.2000000
NODE_4207_length_1166_cov_25.107779	561	641	6	64	80	0.8000000
NODE_4207_length_1166_cov_25.107779	614	694	0	27	80	0.3375000
NODE_4207_length_1166_cov_25.107779	614	694	2	1	80	0.0125000
NODE_4207_length_1166_cov_25.107779	614	694	6	52	80	0.6500000
NODE_4209_length_1166_cov_18.820056	325	405	0	80	80	1.0000000
NODE_4209_length_1166_cov_18.820056	378	458	0	80	80	1.0000000
NODE_4210_length_1166_cov_18.404873	676	756	0	16	80	0.2000000
NODE_4210_length_1166_cov_18.404873	676	756	2	59	80	0.7375000
NODE_4210_length_1166_cov_18.404873	676	756	4	5	80	0.0625000
NODE_4210_length_1166_cov_18.404873	729	809	2	25	80	0.3125000
NODE_4210_length_1166_cov_18.404873	729	809	4	55	80	0.6875000
NODE_4214_length_1166_cov_1.893158	0	71	0	71	71	1.0000000
NODE_4214_length_1166_cov_1.893158	44	99	0	55	55	1.0000000
NODE_4218_length_1165_cov_29.402439	497	577	0	75	80	0.9375000
NODE_4218_length_1165_cov_29.402439	497	577	2	5	80	0.0625000
NODE_4218_length_1165_cov_29.402439	550	630	0	22	80	0.2750000
NODE_4218_length_1165_cov_29.402439	550	630	2	58	80	0.7250000
NODE_4218_length_1165_cov_29.402439	626	706	0	47	80	0.5875000
NODE_4218_length_1165_cov_29.402439	626	706	2	33	80	0.4125000
NODE_4218_length_1165_cov_29.402439	679	759	0	80	80	1.0000000
NODE_4219_length_1165_cov_28.366792	663	743	0	55	80	0.6875000
NODE_4219_length_1165_cov_28.366792	663	743	2	25	80	0.3125000
NODE_4219_length_1165_cov_28.366792	716	796	0	2	80	0.0250000
NODE_4219_length_1165_cov_28.366792	716	796	2	78	80	0.9750000
NODE_4220_length_1165_cov_23.841463	631	711	0	29	80	0.3625000
NODE_4220_length_1165_cov_23.841463	631	711	2	51	80	0.6375000
NODE_4220_length_1165_cov_23.841463	684	765	2	55	81	0.6790124
NODE_4220_length_1165_cov_23.841463	684	765	4	26	81	0.3209876
NODE_4220_length_1165_cov_23.841463	761	841	2	39	80	0.4875000
NODE_4220_length_1165_cov_23.841463	761	841	4	41	80	0.5125000
NODE_4220_length_1165_cov_23.841463	814	894	2	58	80	0.7250000
NODE_4220_length_1165_cov_23.841463	814	894	4	22	80	0.2750000
NODE_4221_length_1165_cov_21.883677	482	562	4	80	80	1.0000000
NODE_4221_length_1165_cov_21.883677	535	615	0	31	80	0.3875000
NODE_4221_length_1165_cov_21.883677	535	615	2	3	80	0.0375000
NODE_4221_length_1165_cov_21.883677	535	615	4	46	80	0.5750000
NODE_4222_length_1165_cov_14.591932	295	375	0	80	80	1.0000000
NODE_4222_length_1165_cov_14.591932	348	428	0	80	80	1.0000000
NODE_4223_length_1165_cov_13.683865	502	582	0	80	80	1.0000000
NODE_4223_length_1165_cov_13.683865	555	635	0	80	80	1.0000000
NODE_4224_length_1165_cov_7.915572	383	463	2	80	80	1.0000000
NODE_4224_length_1165_cov_7.915572	436	516	0	39	80	0.4875000
NODE_4224_length_1165_cov_7.915572	436	516	2	41	80	0.5125000
NODE_4225_length_1165_cov_7.466229	552	632	2	13	80	0.1625000
NODE_4225_length_1165_cov_7.466229	552	632	4	44	80	0.5500000
NODE_4225_length_1165_cov_7.466229	552	632	7	1	80	0.0125000
NODE_4225_length_1165_cov_7.466229	552	632	8	10	80	0.1250000
NODE_4225_length_1165_cov_7.466229	552	632	10	3	80	0.0375000
NODE_4225_length_1165_cov_7.466229	552	632	11	9	80	0.1125000
NODE_4225_length_1165_cov_7.466229	605	685	4	4	80	0.0500000
NODE_4225_length_1165_cov_7.466229	605	685	7	1	80	0.0125000
NODE_4225_length_1165_cov_7.466229	605	685	8	12	80	0.1500000
NODE_4225_length_1165_cov_7.466229	605	685	10	54	80	0.6750000
NODE_4225_length_1165_cov_7.466229	605	685	11	9	80	0.1125000
NODE_4226_length_1165_cov_5.617261	676	756	0	80	80	1.0000000
NODE_4226_length_1165_cov_5.617261	729	809	0	49	80	0.6125000
NODE_4226_length_1165_cov_5.617261	729	809	2	31	80	0.3875000
NODE_4227_length_1165_cov_3.658537	554	602	2	3	48	0.0625000
NODE_4227_length_1165_cov_3.658537	554	602	4	13	48	0.2708333
NODE_4227_length_1165_cov_3.658537	554	602	6	32	48	0.6666667
NODE_4233_length_1164_cov_55.273239	459	539	0	23	80	0.2875000
NODE_4233_length_1164_cov_55.273239	459	539	4	57	80	0.7125000
NODE_4233_length_1164_cov_55.273239	512	592	0	37	80	0.4625000
NODE_4233_length_1164_cov_55.273239	512	592	2	8	80	0.1000000
NODE_4233_length_1164_cov_55.273239	512	592	4	35	80	0.4375000
NODE_4234_length_1164_cov_44.183099	571	651	0	80	80	1.0000000
NODE_4234_length_1164_cov_44.183099	624	704	0	80	80	1.0000000
NODE_4234_length_1164_cov_44.183099	700	780	0	19	80	0.2375000
NODE_4234_length_1164_cov_44.183099	700	780	2	61	80	0.7625000
NODE_4234_length_1164_cov_44.183099	753	833	0	38	80	0.4750000
NODE_4234_length_1164_cov_44.183099	753	833	2	42	80	0.5250000
NODE_4235_length_1164_cov_14.277934	1029	1109	11	12	80	0.1500000
NODE_4235_length_1164_cov_14.277934	1029	1109	13	7	80	0.0875000
NODE_4235_length_1164_cov_14.277934	1029	1109	14	20	80	0.2500000
NODE_4235_length_1164_cov_14.277934	1029	1109	15	2	80	0.0250000
NODE_4235_length_1164_cov_14.277934	1029	1109	17	1	80	0.0125000
NODE_4235_length_1164_cov_14.277934	1029	1109	19	5	80	0.0625000
NODE_4235_length_1164_cov_14.277934	1029	1109	20	33	80	0.4125000
NODE_4235_length_1164_cov_14.277934	1097	1162	0	5	65	0.0769231
NODE_4235_length_1164_cov_14.277934	1097	1162	2	1	65	0.0153846
NODE_4235_length_1164_cov_14.277934	1097	1162	4	3	65	0.0461538
NODE_4235_length_1164_cov_14.277934	1097	1162	6	24	65	0.3692308
NODE_4235_length_1164_cov_14.277934	1097	1162	8	14	65	0.2153846
NODE_4235_length_1164_cov_14.277934	1097	1162	10	2	65	0.0307692
NODE_4235_length_1164_cov_14.277934	1097	1162	14	16	65	0.2461538
NODE_4236_length_1164_cov_12.880751	415	495	0	50	80	0.6250000
NODE_4236_length_1164_cov_12.880751	415	495	2	26	80	0.3250000
NODE_4236_length_1164_cov_12.880751	415	495	4	4	80	0.0500000
NODE_4236_length_1164_cov_12.880751	468	548	2	25	80	0.3125000
NODE_4236_length_1164_cov_12.880751	468	548	4	55	80	0.6875000
NODE_4237_length_1164_cov_6.924883	415	495	0	80	80	1.0000000
NODE_4237_length_1164_cov_6.924883	468	548	0	80	80	1.0000000
NODE_4245_length_1163_cov_36.315789	458	538	0	80	80	1.0000000
NODE_4245_length_1163_cov_36.315789	511	591	0	74	80	0.9250000
NODE_4245_length_1163_cov_36.315789	511	591	6	6	80	0.0750000
NODE_4245_length_1163_cov_36.315789	587	667	6	4	80	0.0500000
NODE_4245_length_1163_cov_36.315789	587	667	17	1	80	0.0125000
NODE_4245_length_1163_cov_36.315789	587	667	18	75	80	0.9375000
NODE_4245_length_1163_cov_36.315789	640	720	12	52	80	0.6500000
NODE_4245_length_1163_cov_36.315789	640	720	18	28	80	0.3500000
NODE_4246_length_1163_cov_29.466165	542	622	3	5	80	0.0625000
NODE_4246_length_1163_cov_29.466165	542	622	4	40	80	0.5000000
NODE_4246_length_1163_cov_29.466165	542	622	5	3	80	0.0375000
NODE_4246_length_1163_cov_29.466165	542	622	6	32	80	0.4000000
NODE_4246_length_1163_cov_29.466165	595	675	2	8	80	0.1000000
NODE_4246_length_1163_cov_29.466165	595	675	4	72	80	0.9000000
NODE_4246_length_1163_cov_29.466165	671	751	1	38	80	0.4750000
NODE_4246_length_1163_cov_29.466165	671	751	2	15	80	0.1875000
NODE_4246_length_1163_cov_29.466165	671	751	3	8	80	0.1000000
NODE_4246_length_1163_cov_29.466165	671	751	4	18	80	0.2250000
NODE_4246_length_1163_cov_29.466165	671	751	5	1	80	0.0125000
NODE_4246_length_1163_cov_29.466165	724	804	3	8	80	0.1000000
NODE_4246_length_1163_cov_29.466165	724	804	4	71	80	0.8875000
NODE_4246_length_1163_cov_29.466165	724	804	5	1	80	0.0125000
NODE_4247_length_1163_cov_15.107143	668	748	0	80	80	1.0000000
NODE_4247_length_1163_cov_15.107143	721	801	0	80	80	1.0000000
NODE_4248_length_1163_cov_14.347744	540	620	0	80	80	1.0000000
NODE_4248_length_1163_cov_14.347744	593	673	0	80	80	1.0000000
NODE_4249_length_1163_cov_11.650376	354	434	0	80	80	1.0000000
NODE_4249_length_1163_cov_11.650376	407	487	0	80	80	1.0000000
NODE_4249_length_1163_cov_11.650376	738	818	0	2	80	0.0250000
NODE_4249_length_1163_cov_11.650376	738	818	2	74	80	0.9250000
NODE_4249_length_1163_cov_11.650376	738	818	4	4	80	0.0500000
NODE_4249_length_1163_cov_11.650376	791	871	2	44	80	0.5500000
NODE_4249_length_1163_cov_11.650376	791	871	4	36	80	0.4500000
NODE_4253_length_1162_cov_30.049859	359	439	0	16	80	0.2000000
NODE_4253_length_1162_cov_30.049859	359	439	2	64	80	0.8000000
NODE_4253_length_1162_cov_30.049859	412	492	0	14	80	0.1750000
NODE_4253_length_1162_cov_30.049859	412	492	2	66	80	0.8250000
NODE_4254_length_1162_cov_25.960489	440	520	0	80	80	1.0000000
NODE_4254_length_1162_cov_25.960489	493	573	0	63	80	0.7875000
NODE_4254_length_1162_cov_25.960489	493	573	2	17	80	0.2125000
NODE_4254_length_1162_cov_25.960489	569	649	0	8	80	0.1000000
NODE_4254_length_1162_cov_25.960489	569	649	2	72	80	0.9000000
NODE_4254_length_1162_cov_25.960489	622	702	0	61	80	0.7625000
NODE_4254_length_1162_cov_25.960489	622	702	2	19	80	0.2375000
NODE_4255_length_1162_cov_24.843838	523	603	2	14	80	0.1750000
NODE_4255_length_1162_cov_24.843838	523	603	3	40	80	0.5000000
NODE_4255_length_1162_cov_24.843838	523	603	7	26	80	0.3250000
NODE_4255_length_1162_cov_24.843838	576	656	3	1	80	0.0125000
NODE_4255_length_1162_cov_24.843838	576	656	5	41	80	0.5125000
NODE_4255_length_1162_cov_24.843838	576	656	7	38	80	0.4750000
NODE_4255_length_1162_cov_24.843838	652	732	3	1	80	0.0125000
NODE_4255_length_1162_cov_24.843838	652	732	4	6	80	0.0750000
NODE_4255_length_1162_cov_24.843838	652	732	5	50	80	0.6250000
NODE_4255_length_1162_cov_24.843838	652	732	6	17	80	0.2125000
NODE_4255_length_1162_cov_24.843838	652	732	8	6	80	0.0750000
NODE_4255_length_1162_cov_24.843838	705	785	3	32	80	0.4000000
NODE_4255_length_1162_cov_24.843838	705	785	5	48	80	0.6000000
NODE_4257_length_1162_cov_17.131703	302	382	0	80	80	1.0000000
NODE_4257_length_1162_cov_17.131703	355	435	0	80	80	1.0000000
NODE_4257_length_1162_cov_17.131703	431	511	0	80	80	1.0000000
NODE_4257_length_1162_cov_17.131703	484	564	0	80	80	1.0000000
NODE_4258_length_1162_cov_14.766698	630	710	0	80	80	1.0000000
NODE_4258_length_1162_cov_14.766698	683	763	0	80	80	1.0000000
NODE_4259_length_1162_cov_13.968015	423	503	2	80	80	1.0000000
NODE_4259_length_1162_cov_13.968015	476	556	0	50	80	0.6250000
NODE_4259_length_1162_cov_13.968015	476	556	2	30	80	0.3750000
NODE_4264_length_1162_cov_1.977422	855	926	0	71	71	1.0000000
NODE_4264_length_1162_cov_1.977422	908	977	0	69	69	1.0000000
NODE_4264_length_1162_cov_1.977422	908	977	0	69	69	1.0000000
NODE_4266_length_1161_cov_33.312618	456	536	0	28	80	0.3500000
NODE_4266_length_1161_cov_33.312618	456	536	2	29	80	0.3625000
NODE_4266_length_1161_cov_33.312618	456	536	4	15	80	0.1875000
NODE_4266_length_1161_cov_33.312618	456	536	6	8	80	0.1000000
NODE_4266_length_1161_cov_33.312618	509	587	2	4	78	0.0512821
NODE_4266_length_1161_cov_33.312618	509	587	4	15	78	0.1923077
NODE_4266_length_1161_cov_33.312618	509	587	6	59	78	0.7564102
NODE_4267_length_1161_cov_30.466102	594	674	0	12	80	0.1500000
NODE_4267_length_1161_cov_30.466102	594	674	2	15	80	0.1875000
NODE_4267_length_1161_cov_30.466102	594	674	4	53	80	0.6625000
NODE_4267_length_1161_cov_30.466102	647	727	4	58	80	0.7250000
NODE_4267_length_1161_cov_30.466102	647	727	6	22	80	0.2750000
NODE_4268_length_1161_cov_29.628060	426	506	0	19	80	0.2375000
NODE_4268_length_1161_cov_29.628060	426	506	2	35	80	0.4375000
NODE_4268_length_1161_cov_29.628060	426	506	4	26	80	0.3250000
NODE_4268_length_1161_cov_29.628060	479	559	0	72	80	0.9000000
NODE_4268_length_1161_cov_29.628060	479	559	2	8	80	0.1000000
NODE_4268_length_1161_cov_29.628060	603	683	0	40	80	0.5000000
NODE_4268_length_1161_cov_29.628060	603	683	2	40	80	0.5000000
NODE_4268_length_1161_cov_29.628060	656	736	2	57	80	0.7125000
NODE_4268_length_1161_cov_29.628060	656	736	4	23	80	0.2875000
NODE_4269_length_1161_cov_22.923729	492	572	0	13	80	0.1625000
NODE_4269_length_1161_cov_22.923729	492	572	1	67	80	0.8375000
NODE_4269_length_1161_cov_22.923729	545	625	0	22	80	0.2750000
NODE_4269_length_1161_cov_22.923729	545	625	1	14	80	0.1750000
NODE_4269_length_1161_cov_22.923729	545	625	2	6	80	0.0750000
NODE_4269_length_1161_cov_22.923729	545	625	3	38	80	0.4750000
NODE_4269_length_1161_cov_22.923729	621	701	1	49	80	0.6125000
NODE_4269_length_1161_cov_22.923729	621	701	3	31	80	0.3875000
NODE_4269_length_1161_cov_22.923729	674	754	0	17	80	0.2125000
NODE_4269_length_1161_cov_22.923729	674	754	1	63	80	0.7875000
NODE_4270_length_1161_cov_20.184557	480	560	0	80	80	1.0000000
NODE_4270_length_1161_cov_20.184557	533	613	0	80	80	1.0000000
NODE_4271_length_1161_cov_17.437853	375	455	0	9	80	0.1125000
NODE_4271_length_1161_cov_17.437853	375	455	2	71	80	0.8875000
NODE_4271_length_1161_cov_17.437853	428	508	0	61	80	0.7625000
NODE_4271_length_1161_cov_17.437853	428	508	2	19	80	0.2375000
NODE_4272_length_1161_cov_14.062147	375	455	0	34	80	0.4250000
NODE_4272_length_1161_cov_14.062147	375	455	2	12	80	0.1500000
NODE_4272_length_1161_cov_14.062147	375	455	4	6	80	0.0750000
NODE_4272_length_1161_cov_14.062147	375	455	6	28	80	0.3500000
NODE_4272_length_1161_cov_14.062147	428	508	6	47	80	0.5875000
NODE_4272_length_1161_cov_14.062147	428	508	8	33	80	0.4125000
NODE_4273_length_1161_cov_12.304143	381	461	0	4	80	0.0500000
NODE_4273_length_1161_cov_12.304143	381	461	3	1	80	0.0125000
NODE_4273_length_1161_cov_12.304143	381	461	4	75	80	0.9375000
NODE_4273_length_1161_cov_12.304143	434	514	0	11	80	0.1375000
NODE_4273_length_1161_cov_12.304143	434	514	4	69	80	0.8625000
NODE_4274_length_1161_cov_10.297552	598	678	0	13	80	0.1625000
NODE_4274_length_1161_cov_10.297552	598	678	2	67	80	0.8375000
NODE_4274_length_1161_cov_10.297552	651	731	0	30	80	0.3750000
NODE_4274_length_1161_cov_10.297552	651	731	2	50	80	0.6250000
NODE_4283_length_1160_cov_86.515551	613	693	1	45	80	0.5625000
NODE_4283_length_1160_cov_86.515551	613	693	3	35	80	0.4375000
NODE_4283_length_1160_cov_86.515551	666	746	3	28	80	0.3500000
NODE_4283_length_1160_cov_86.515551	666	746	9	25	80	0.3125000
NODE_4283_length_1160_cov_86.515551	666	746	10	16	80	0.2000000
NODE_4283_length_1160_cov_86.515551	666	746	11	2	80	0.0250000
NODE_4283_length_1160_cov_86.515551	666	746	12	9	80	0.1125000
NODE_4284_length_1160_cov_29.272385	526	606	2	4	80	0.0500000
NODE_4284_length_1160_cov_29.272385	526	606	4	11	80	0.1375000
NODE_4284_length_1160_cov_29.272385	526	606	6	23	80	0.2875000
NODE_4284_length_1160_cov_29.272385	526	606	8	42	80	0.5250000
NODE_4284_length_1160_cov_29.272385	579	659	0	7	80	0.0875000
NODE_4284_length_1160_cov_29.272385	579	659	2	21	80	0.2625000
NODE_4284_length_1160_cov_29.272385	579	659	4	10	80	0.1250000
NODE_4284_length_1160_cov_29.272385	579	659	6	4	80	0.0500000
NODE_4284_length_1160_cov_29.272385	579	659	8	38	80	0.4750000
NODE_4285_length_1160_cov_21.391140	767	847	6	41	80	0.5125000
NODE_4285_length_1160_cov_21.391140	767	847	9	1	80	0.0125000
NODE_4285_length_1160_cov_21.391140	767	847	10	38	80	0.4750000
NODE_4296_length_1159_cov_147.794340	911	991	242	1	80	0.0125000
NODE_4296_length_1159_cov_147.794340	911	991	246	1	80	0.0125000
NODE_4296_length_1159_cov_147.794340	911	991	255	1	80	0.0125000
NODE_4296_length_1159_cov_147.794340	911	991	262	1	80	0.0125000
NODE_4296_length_1159_cov_147.794340	911	991	266	2	80	0.0250000
NODE_4296_length_1159_cov_147.794340	911	991	272	1	80	0.0125000
NODE_4296_length_1159_cov_147.794340	911	991	276	1	80	0.0125000
NODE_4296_length_1159_cov_147.794340	911	991	278	1	80	0.0125000
NODE_4296_length_1159_cov_147.794340	911	991	279	1	80	0.0125000
NODE_4296_length_1159_cov_147.794340	911	991	282	3	80	0.0375000
NODE_4296_length_1159_cov_147.794340	911	991	283	2	80	0.0250000
NODE_4296_length_1159_cov_147.794340	911	991	285	2	80	0.0250000
NODE_4296_length_1159_cov_147.794340	911	991	286	1	80	0.0125000
NODE_4296_length_1159_cov_147.794340	911	991	288	1	80	0.0125000
NODE_4296_length_1159_cov_147.794340	911	991	290	3	80	0.0375000
NODE_4296_length_1159_cov_147.794340	911	991	291	2	80	0.0250000
NODE_4296_length_1159_cov_147.794340	911	991	292	2	80	0.0250000
NODE_4296_length_1159_cov_147.794340	911	991	298	1	80	0.0125000
NODE_4296_length_1159_cov_147.794340	911	991	299	1	80	0.0125000
NODE_4296_length_1159_cov_147.794340	911	991	306	2	80	0.0250000
NODE_4296_length_1159_cov_147.794340	911	991	312	2	80	0.0250000
NODE_4296_length_1159_cov_147.794340	911	991	313	1	80	0.0125000
NODE_4296_length_1159_cov_147.794340	911	991	315	1	80	0.0125000
NODE_4296_length_1159_cov_147.794340	911	991	316	1	80	0.0125000
NODE_4296_length_1159_cov_147.794340	911	991	317	1	80	0.0125000
NODE_4296_length_1159_cov_147.794340	911	991	320	2	80	0.0250000
NODE_4296_length_1159_cov_147.794340	911	991	321	1	80	0.0125000
NODE_4296_length_1159_cov_147.794340	911	991	324	1	80	0.0125000
NODE_4296_length_1159_cov_147.794340	911	991	328	2	80	0.0250000
NODE_4296_length_1159_cov_147.794340	911	991	330	1	80	0.0125000
NODE_4296_length_1159_cov_147.794340	911	991	332	2	80	0.0250000
NODE_4296_length_1159_cov_147.794340	911	991	336	4	80	0.0500000
NODE_4296_length_1159_cov_147.794340	911	991	337	1	80	0.0125000
NODE_4296_length_1159_cov_147.794340	911	991	340	1	80	0.0125000
NODE_4296_length_1159_cov_147.794340	911	991	341	2	80	0.0250000
NODE_4296_length_1159_cov_147.794340	911	991	343	2	80	0.0250000
NODE_4296_length_1159_cov_147.794340	911	991	344	1	80	0.0125000
NODE_4296_length_1159_cov_147.794340	911	991	346	2	80	0.0250000
NODE_4296_length_1159_cov_147.794340	911	991	348	1	80	0.0125000
NODE_4296_length_1159_cov_147.794340	911	991	349	1	80	0.0125000
NODE_4296_length_1159_cov_147.794340	911	991	351	3	80	0.0375000
NODE_4296_length_1159_cov_147.794340	911	991	352	2	80	0.0250000
NODE_4296_length_1159_cov_147.794340	911	991	353	1	80	0.0125000
NODE_4296_length_1159_cov_147.794340	911	991	354	3	80	0.0375000
NODE_4296_length_1159_cov_147.794340	911	991	355	2	80	0.0250000
NODE_4296_length_1159_cov_147.794340	911	991	357	2	80	0.0250000
NODE_4296_length_1159_cov_147.794340	911	991	360	1	80	0.0125000
NODE_4296_length_1159_cov_147.794340	911	991	363	3	80	0.0375000
NODE_4296_length_1159_cov_147.794340	911	991	367	1	80	0.0125000
NODE_4296_length_1159_cov_147.794340	911	991	369	2	80	0.0250000
NODE_4296_length_1159_cov_147.794340	964	1044	130	1	80	0.0125000
NODE_4296_length_1159_cov_147.794340	964	1044	132	2	80	0.0250000
NODE_4296_length_1159_cov_147.794340	964	1044	134	1	80	0.0125000
NODE_4296_length_1159_cov_147.794340	964	1044	138	2	80	0.0250000
NODE_4296_length_1159_cov_147.794340	964	1044	142	3	80	0.0375000
NODE_4296_length_1159_cov_147.794340	964	1044	149	2	80	0.0250000
NODE_4296_length_1159_cov_147.794340	964	1044	157	1	80	0.0125000
NODE_4296_length_1159_cov_147.794340	964	1044	161	1	80	0.0125000
NODE_4296_length_1159_cov_147.794340	964	1044	167	1	80	0.0125000
NODE_4296_length_1159_cov_147.794340	964	1044	171	1	80	0.0125000
NODE_4296_length_1159_cov_147.794340	964	1044	177	1	80	0.0125000
NODE_4296_length_1159_cov_147.794340	964	1044	179	1	80	0.0125000
NODE_4296_length_1159_cov_147.794340	964	1044	182	1	80	0.0125000
NODE_4296_length_1159_cov_147.794340	964	1044	184	1	80	0.0125000
NODE_4296_length_1159_cov_147.794340	964	1044	185	1	80	0.0125000
NODE_4296_length_1159_cov_147.794340	964	1044	187	1	80	0.0125000
NODE_4296_length_1159_cov_147.794340	964	1044	188	1	80	0.0125000
NODE_4296_length_1159_cov_147.794340	964	1044	190	3	80	0.0375000
NODE_4296_length_1159_cov_147.794340	964	1044	193	2	80	0.0250000
NODE_4296_length_1159_cov_147.794340	964	1044	195	1	80	0.0125000
NODE_4296_length_1159_cov_147.794340	964	1044	199	1	80	0.0125000
NODE_4296_length_1159_cov_147.794340	964	1044	200	1	80	0.0125000
NODE_4296_length_1159_cov_147.794340	964	1044	201	1	80	0.0125000
NODE_4296_length_1159_cov_147.794340	964	1044	210	4	80	0.0500000
NODE_4296_length_1159_cov_147.794340	964	1044	212	1	80	0.0125000
NODE_4296_length_1159_cov_147.794340	964	1044	214	1	80	0.0125000
NODE_4296_length_1159_cov_147.794340	964	1044	225	1	80	0.0125000
NODE_4296_length_1159_cov_147.794340	964	1044	235	1	80	0.0125000
NODE_4296_length_1159_cov_147.794340	964	1044	243	1	80	0.0125000
NODE_4296_length_1159_cov_147.794340	964	1044	253	1	80	0.0125000
NODE_4296_length_1159_cov_147.794340	964	1044	257	1	80	0.0125000
NODE_4296_length_1159_cov_147.794340	964	1044	263	1	80	0.0125000
NODE_4296_length_1159_cov_147.794340	964	1044	267	1	80	0.0125000
NODE_4296_length_1159_cov_147.794340	964	1044	277	2	80	0.0250000
NODE_4296_length_1159_cov_147.794340	964	1044	280	2	80	0.0250000
NODE_4296_length_1159_cov_147.794340	964	1044	286	1	80	0.0125000
NODE_4296_length_1159_cov_147.794340	964	1044	298	1	80	0.0125000
NODE_4296_length_1159_cov_147.794340	964	1044	300	1	80	0.0125000
NODE_4296_length_1159_cov_147.794340	964	1044	304	1	80	0.0125000
NODE_4296_length_1159_cov_147.794340	964	1044	306	2	80	0.0250000
NODE_4296_length_1159_cov_147.794340	964	1044	307	1	80	0.0125000
NODE_4296_length_1159_cov_147.794340	964	1044	313	1	80	0.0125000
NODE_4296_length_1159_cov_147.794340	964	1044	315	1	80	0.0125000
NODE_4296_length_1159_cov_147.794340	964	1044	317	1	80	0.0125000
NODE_4296_length_1159_cov_147.794340	964	1044	320	2	80	0.0250000
NODE_4296_length_1159_cov_147.794340	964	1044	321	1	80	0.0125000
NODE_4296_length_1159_cov_147.794340	964	1044	328	1	80	0.0125000
NODE_4296_length_1159_cov_147.794340	964	1044	330	1	80	0.0125000
NODE_4296_length_1159_cov_147.794340	964	1044	332	1	80	0.0125000
NODE_4296_length_1159_cov_147.794340	964	1044	336	1	80	0.0125000
NODE_4296_length_1159_cov_147.794340	964	1044	341	2	80	0.0250000
NODE_4296_length_1159_cov_147.794340	964	1044	343	1	80	0.0125000
NODE_4296_length_1159_cov_147.794340	964	1044	344	1	80	0.0125000
NODE_4296_length_1159_cov_147.794340	964	1044	346	2	80	0.0250000
NODE_4296_length_1159_cov_147.794340	964	1044	348	1	80	0.0125000
NODE_4296_length_1159_cov_147.794340	964	1044	349	1	80	0.0125000
NODE_4296_length_1159_cov_147.794340	964	1044	352	2	80	0.0250000
NODE_4296_length_1159_cov_147.794340	964	1044	354	2	80	0.0250000
NODE_4296_length_1159_cov_147.794340	964	1044	355	1	80	0.0125000
NODE_4296_length_1159_cov_147.794340	964	1044	360	1	80	0.0125000
NODE_4296_length_1159_cov_147.794340	964	1044	363	1	80	0.0125000
NODE_4297_length_1159_cov_57.566981	457	537	0	80	80	1.0000000
NODE_4297_length_1159_cov_57.566981	510	590	0	45	80	0.5625000
NODE_4297_length_1159_cov_57.566981	510	590	2	33	80	0.4125000
NODE_4297_length_1159_cov_57.566981	510	590	4	2	80	0.0250000
NODE_4297_length_1159_cov_57.566981	586	666	2	2	80	0.0250000
NODE_4297_length_1159_cov_57.566981	586	666	4	8	80	0.1000000
NODE_4297_length_1159_cov_57.566981	586	666	6	70	80	0.8750000
NODE_4297_length_1159_cov_57.566981	639	719	0	34	80	0.4250000
NODE_4297_length_1159_cov_57.566981	639	719	2	3	80	0.0375000
NODE_4297_length_1159_cov_57.566981	639	719	4	11	80	0.1375000
NODE_4297_length_1159_cov_57.566981	639	719	6	32	80	0.4000000
NODE_4298_length_1159_cov_44.053774	329	409	4	10	80	0.1250000
NODE_4298_length_1159_cov_44.053774	329	409	6	70	80	0.8750000
NODE_4298_length_1159_cov_44.053774	382	462	0	33	80	0.4125000
NODE_4298_length_1159_cov_44.053774	382	462	4	30	80	0.3750000
NODE_4298_length_1159_cov_44.053774	382	462	6	17	80	0.2125000
NODE_4298_length_1159_cov_44.053774	458	538	0	9	80	0.1125000
NODE_4298_length_1159_cov_44.053774	458	538	2	71	80	0.8875000
NODE_4298_length_1159_cov_44.053774	511	591	0	24	80	0.3000000
NODE_4298_length_1159_cov_44.053774	511	591	2	56	80	0.7000000
NODE_4299_length_1159_cov_40.194340	391	471	2	41	80	0.5125000
NODE_4299_length_1159_cov_40.194340	391	471	4	3	80	0.0375000
NODE_4299_length_1159_cov_40.194340	391	471	6	19	80	0.2375000
NODE_4299_length_1159_cov_40.194340	391	471	8	13	80	0.1625000
NODE_4299_length_1159_cov_40.194340	391	471	10	2	80	0.0250000
NODE_4299_length_1159_cov_40.194340	391	471	12	2	80	0.0250000
NODE_4299_length_1159_cov_40.194340	444	524	6	10	80	0.1250000
NODE_4299_length_1159_cov_40.194340	444	524	8	17	80	0.2125000
NODE_4299_length_1159_cov_40.194340	444	524	10	16	80	0.2000000
NODE_4299_length_1159_cov_40.194340	444	524	12	37	80	0.4625000
NODE_4301_length_1159_cov_25.919811	456	536	0	80	80	1.0000000
NODE_4301_length_1159_cov_25.919811	509	591	0	82	82	1.0000000
NODE_4302_length_1159_cov_18.306604	538	618	0	59	80	0.7375000
NODE_4302_length_1159_cov_18.306604	538	618	2	21	80	0.2625000
NODE_4302_length_1159_cov_18.306604	591	671	0	6	80	0.0750000
NODE_4302_length_1159_cov_18.306604	591	671	2	74	80	0.9250000
NODE_4303_length_1159_cov_14.457547	358	438	0	30	80	0.3750000
NODE_4303_length_1159_cov_14.457547	358	438	2	50	80	0.6250000
NODE_4303_length_1159_cov_14.457547	411	491	0	12	80	0.1500000
NODE_4303_length_1159_cov_14.457547	411	491	2	68	80	0.8500000
NODE_4304_length_1159_cov_11.566981	625	705	0	35	80	0.4375000
NODE_4304_length_1159_cov_11.566981	625	705	2	34	80	0.4250000
NODE_4304_length_1159_cov_11.566981	625	705	4	5	80	0.0625000
NODE_4304_length_1159_cov_11.566981	625	705	6	6	80	0.0750000
NODE_4304_length_1159_cov_11.566981	678	758	0	80	80	1.0000000
NODE_4305_length_1159_cov_9.927358	278	358	2	68	80	0.8500000
NODE_4305_length_1159_cov_9.927358	278	358	4	12	80	0.1500000
NODE_4305_length_1159_cov_9.927358	331	411	0	15	80	0.1875000
NODE_4305_length_1159_cov_9.927358	331	411	2	52	80	0.6500000
NODE_4305_length_1159_cov_9.927358	331	411	4	13	80	0.1625000
NODE_4314_length_1159_cov_1.568868	513	562	14	5	49	0.1020408
NODE_4314_length_1159_cov_1.568868	513	562	16	5	49	0.1020408
NODE_4314_length_1159_cov_1.568868	513	562	17	1	49	0.0204082
NODE_4314_length_1159_cov_1.568868	513	562	18	7	49	0.1428571
NODE_4314_length_1159_cov_1.568868	513	562	20	2	49	0.0408163
NODE_4314_length_1159_cov_1.568868	513	562	21	1	49	0.0204082
NODE_4314_length_1159_cov_1.568868	513	562	22	12	49	0.2448980
NODE_4314_length_1159_cov_1.568868	513	562	24	6	49	0.1224490
NODE_4314_length_1159_cov_1.568868	513	562	26	1	49	0.0204082
NODE_4314_length_1159_cov_1.568868	513	562	28	9	49	0.1836735
NODE_4316_length_1158_cov_33.529745	357	437	0	80	80	1.0000000
NODE_4316_length_1158_cov_33.529745	410	490	0	80	80	1.0000000
NODE_4316_length_1158_cov_33.529745	486	566	0	75	80	0.9375000
NODE_4316_length_1158_cov_33.529745	486	566	2	5	80	0.0625000
NODE_4316_length_1158_cov_33.529745	539	619	0	22	80	0.2750000
NODE_4316_length_1158_cov_33.529745	539	619	2	58	80	0.7250000
NODE_4317_length_1158_cov_31.368272	416	496	2	2	80	0.0250000
NODE_4317_length_1158_cov_31.368272	416	496	4	21	80	0.2625000
NODE_4317_length_1158_cov_31.368272	416	496	6	16	80	0.2000000
NODE_4317_length_1158_cov_31.368272	416	496	7	1	80	0.0125000
NODE_4317_length_1158_cov_31.368272	416	496	8	40	80	0.5000000
NODE_4317_length_1158_cov_31.368272	469	549	0	18	80	0.2250000
NODE_4317_length_1158_cov_31.368272	469	549	6	21	80	0.2625000
NODE_4317_length_1158_cov_31.368272	469	549	8	41	80	0.5125000
NODE_4317_length_1158_cov_31.368272	545	626	0	31	81	0.3827161
NODE_4317_length_1158_cov_31.368272	545	626	1	4	81	0.0493827
NODE_4317_length_1158_cov_31.368272	545	626	2	46	81	0.5679013
NODE_4317_length_1158_cov_31.368272	599	679	2	80	80	1.0000000
NODE_4318_length_1158_cov_31.240793	430	510	0	18	80	0.2250000
NODE_4318_length_1158_cov_31.240793	430	510	2	62	80	0.7750000
NODE_4318_length_1158_cov_31.240793	483	563	0	71	80	0.8875000
NODE_4318_length_1158_cov_31.240793	483	563	2	9	80	0.1125000
NODE_4318_length_1158_cov_31.240793	559	639	0	27	80	0.3375000
NODE_4318_length_1158_cov_31.240793	559	639	2	45	80	0.5625000
NODE_4318_length_1158_cov_31.240793	559	639	6	8	80	0.1000000
NODE_4318_length_1158_cov_31.240793	612	692	2	19	80	0.2375000
NODE_4318_length_1158_cov_31.240793	612	692	4	8	80	0.1000000
NODE_4318_length_1158_cov_31.240793	612	692	6	53	80	0.6625000
NODE_4319_length_1158_cov_29.216242	405	485	0	4	80	0.0500000
NODE_4319_length_1158_cov_29.216242	405	485	2	76	80	0.9500000
NODE_4319_length_1158_cov_29.216242	458	538	0	35	80	0.4375000
NODE_4319_length_1158_cov_29.216242	458	538	2	45	80	0.5625000
NODE_4320_length_1158_cov_25.245515	500	580	0	80	80	1.0000000
NODE_4320_length_1158_cov_25.245515	553	633	0	80	80	1.0000000
NODE_4320_length_1158_cov_25.245515	629	709	0	80	80	1.0000000
NODE_4320_length_1158_cov_25.245515	682	762	0	80	80	1.0000000
NODE_4321_length_1158_cov_16.566572	396	476	0	24	80	0.3000000
NODE_4321_length_1158_cov_16.566572	396	476	1	1	80	0.0125000
NODE_4321_length_1158_cov_16.566572	396	476	10	4	80	0.0500000
NODE_4321_length_1158_cov_16.566572	396	476	11	3	80	0.0375000
NODE_4321_length_1158_cov_16.566572	396	476	12	48	80	0.6000000
NODE_4321_length_1158_cov_16.566572	449	529	0	5	80	0.0625000
NODE_4321_length_1158_cov_16.566572	449	529	11	9	80	0.1125000
NODE_4321_length_1158_cov_16.566572	449	529	12	66	80	0.8250000
NODE_4322_length_1158_cov_13.092540	372	452	0	29	80	0.3625000
NODE_4322_length_1158_cov_13.092540	372	452	2	51	80	0.6375000
NODE_4322_length_1158_cov_13.092540	425	505	0	35	80	0.4375000
NODE_4322_length_1158_cov_13.092540	425	505	2	45	80	0.5625000
NODE_4322_length_1158_cov_13.092540	735	815	2	80	80	1.0000000
NODE_4322_length_1158_cov_13.092540	788	868	0	43	80	0.5375000
NODE_4322_length_1158_cov_13.092540	788	868	2	37	80	0.4625000
NODE_4323_length_1158_cov_7.408876	656	736	0	32	80	0.4000000
NODE_4323_length_1158_cov_7.408876	656	736	2	48	80	0.6000000
NODE_4323_length_1158_cov_7.408876	709	789	0	9	80	0.1125000
NODE_4323_length_1158_cov_7.408876	709	789	2	71	80	0.8875000
NODE_4324_length_1158_cov_6.242682	239	310	0	71	71	1.0000000
NODE_4325_length_1158_cov_6.043437	531	611	0	48	80	0.6000000
NODE_4325_length_1158_cov_6.043437	531	611	2	32	80	0.4000000
NODE_4325_length_1158_cov_6.043437	584	634	0	50	50	1.0000000
NODE_4326_length_1158_cov_5.855524	324	404	0	80	80	1.0000000
NODE_4326_length_1158_cov_5.855524	377	457	0	80	80	1.0000000
NODE_4329_length_1157_cov_32.233459	472	552	2	13	80	0.1625000
NODE_4329_length_1157_cov_32.233459	472	552	4	28	80	0.3500000
NODE_4329_length_1157_cov_32.233459	472	552	6	39	80	0.4875000
NODE_4329_length_1157_cov_32.233459	525	605	0	20	80	0.2500000
NODE_4329_length_1157_cov_32.233459	525	605	2	43	80	0.5375000
NODE_4329_length_1157_cov_32.233459	525	605	4	17	80	0.2125000
NODE_4329_length_1157_cov_32.233459	601	681	0	20	80	0.2500000
NODE_4329_length_1157_cov_32.233459	601	681	2	23	80	0.2875000
NODE_4329_length_1157_cov_32.233459	601	681	6	4	80	0.0500000
NODE_4329_length_1157_cov_32.233459	601	681	8	33	80	0.4125000
NODE_4329_length_1157_cov_32.233459	654	734	4	13	80	0.1625000
NODE_4329_length_1157_cov_32.233459	654	734	6	12	80	0.1500000
NODE_4329_length_1157_cov_32.233459	654	734	8	55	80	0.6875000
NODE_4330_length_1157_cov_6.438563	765	788	0	20	23	0.8695652
NODE_4330_length_1157_cov_6.438563	765	788	2	3	23	0.1304348
NODE_4332_length_1157_cov_4.068053	221	292	0	71	71	1.0000000
NODE_4333_length_1156_cov_46.381268	328	408	0	80	80	1.0000000
NODE_4333_length_1156_cov_46.381268	381	461	0	43	80	0.5375000
NODE_4333_length_1156_cov_46.381268	381	461	2	37	80	0.4625000
NODE_4333_length_1156_cov_46.381268	457	537	2	35	80	0.4375000
NODE_4333_length_1156_cov_46.381268	457	537	4	45	80	0.5625000
NODE_4333_length_1156_cov_46.381268	510	590	0	2	80	0.0250000
NODE_4333_length_1156_cov_46.381268	510	590	2	29	80	0.3625000
NODE_4333_length_1156_cov_46.381268	510	590	4	49	80	0.6125000
NODE_4334_length_1156_cov_32.198675	378	458	0	29	80	0.3625000
NODE_4334_length_1156_cov_32.198675	378	458	2	28	80	0.3500000
NODE_4334_length_1156_cov_32.198675	378	458	4	23	80	0.2875000
NODE_4334_length_1156_cov_32.198675	431	511	0	4	80	0.0500000
NODE_4334_length_1156_cov_32.198675	431	511	4	76	80	0.9500000
NODE_4334_length_1156_cov_32.198675	507	587	2	46	80	0.5750000
NODE_4334_length_1156_cov_32.198675	507	587	4	30	80	0.3750000
NODE_4334_length_1156_cov_32.198675	507	587	6	4	80	0.0500000
NODE_4334_length_1156_cov_32.198675	560	641	2	26	81	0.3209876
NODE_4334_length_1156_cov_32.198675	560	641	4	55	81	0.6790124
NODE_4335_length_1156_cov_12.683065	593	673	0	40	80	0.5000000
NODE_4335_length_1156_cov_12.683065	593	673	2	40	80	0.5000000
NODE_4335_length_1156_cov_12.683065	646	726	0	20	80	0.2500000
NODE_4335_length_1156_cov_12.683065	646	726	2	60	80	0.7500000
NODE_4336_length_1156_cov_9.287606	680	760	4	15	80	0.1875000
NODE_4336_length_1156_cov_9.287606	680	760	6	45	80	0.5625000
NODE_4336_length_1156_cov_9.287606	680	760	8	20	80	0.2500000
NODE_4336_length_1156_cov_9.287606	733	813	4	9	80	0.1125000
NODE_4336_length_1156_cov_9.287606	733	813	6	15	80	0.1875000
NODE_4336_length_1156_cov_9.287606	733	813	8	56	80	0.7000000
NODE_4339_length_1155_cov_19.570076	437	517	2	16	80	0.2000000
NODE_4339_length_1155_cov_19.570076	437	517	4	5	80	0.0625000
NODE_4339_length_1155_cov_19.570076	437	517	6	6	80	0.0750000
NODE_4339_length_1155_cov_19.570076	437	517	8	20	80	0.2500000
NODE_4339_length_1155_cov_19.570076	437	517	10	4	80	0.0500000
NODE_4339_length_1155_cov_19.570076	437	517	12	29	80	0.3625000
NODE_4339_length_1155_cov_19.570076	490	570	10	4	80	0.0500000
NODE_4339_length_1155_cov_19.570076	490	570	12	76	80	0.9500000
NODE_4340_length_1155_cov_18.666667	332	412	4	8	80	0.1000000
NODE_4340_length_1155_cov_18.666667	332	412	9	1	80	0.0125000
NODE_4340_length_1155_cov_18.666667	332	412	10	1	80	0.0125000
NODE_4340_length_1155_cov_18.666667	332	412	16	9	80	0.1125000
NODE_4340_length_1155_cov_18.666667	332	412	22	1	80	0.0125000
NODE_4340_length_1155_cov_18.666667	332	412	24	15	80	0.1875000
NODE_4340_length_1155_cov_18.666667	332	412	26	5	80	0.0625000
NODE_4340_length_1155_cov_18.666667	332	412	28	9	80	0.1125000
NODE_4340_length_1155_cov_18.666667	332	412	30	31	80	0.3875000
NODE_4340_length_1155_cov_18.666667	385	465	12	4	80	0.0500000
NODE_4340_length_1155_cov_18.666667	385	465	14	2	80	0.0250000
NODE_4340_length_1155_cov_18.666667	385	465	19	4	80	0.0500000
NODE_4340_length_1155_cov_18.666667	385	465	23	9	80	0.1125000
NODE_4340_length_1155_cov_18.666667	385	465	25	4	80	0.0500000
NODE_4340_length_1155_cov_18.666667	385	465	27	5	80	0.0625000
NODE_4340_length_1155_cov_18.666667	385	465	28	1	80	0.0125000
NODE_4340_length_1155_cov_18.666667	385	465	30	51	80	0.6375000
NODE_4346_length_1154_cov_61.769668	488	568	0	80	80	1.0000000
NODE_4346_length_1154_cov_61.769668	541	621	0	80	80	1.0000000
NODE_4347_length_1154_cov_50.909005	409	489	2	80	80	1.0000000
NODE_4347_length_1154_cov_50.909005	462	542	0	38	80	0.4750000
NODE_4347_length_1154_cov_50.909005	462	542	2	36	80	0.4500000
NODE_4347_length_1154_cov_50.909005	462	542	4	6	80	0.0750000
NODE_4347_length_1154_cov_50.909005	538	618	4	80	80	1.0000000
NODE_4347_length_1154_cov_50.909005	591	671	0	26	80	0.3250000
NODE_4347_length_1154_cov_50.909005	591	671	4	54	80	0.6750000
NODE_4348_length_1154_cov_28.941232	695	775	0	80	80	1.0000000
NODE_4348_length_1154_cov_28.941232	748	828	0	80	80	1.0000000
NODE_4349_length_1154_cov_13.765877	322	402	0	52	80	0.6500000
NODE_4349_length_1154_cov_13.765877	322	402	2	11	80	0.1375000
NODE_4349_length_1154_cov_13.765877	322	402	4	17	80	0.2125000
NODE_4349_length_1154_cov_13.765877	375	455	2	10	80	0.1250000
NODE_4349_length_1154_cov_13.765877	375	455	4	70	80	0.8750000
NODE_4351_length_1154_cov_5.930806	497	577	0	80	80	1.0000000
NODE_4351_length_1154_cov_5.930806	550	622	0	72	72	1.0000000
NODE_4357_length_1153_cov_65.486717	416	496	1	45	80	0.5625000
NODE_4357_length_1153_cov_65.486717	416	496	2	35	80	0.4375000
NODE_4357_length_1153_cov_65.486717	469	549	1	73	80	0.9125000
NODE_4357_length_1153_cov_65.486717	469	549	3	7	80	0.0875000
NODE_4357_length_1153_cov_65.486717	545	625	2	32	80	0.4000000
NODE_4357_length_1153_cov_65.486717	545	625	3	6	80	0.0750000
NODE_4357_length_1153_cov_65.486717	545	625	4	10	80	0.1250000
NODE_4357_length_1153_cov_65.486717	545	625	6	32	80	0.4000000
NODE_4357_length_1153_cov_65.486717	598	678	0	3	80	0.0375000
NODE_4357_length_1153_cov_65.486717	598	678	2	5	80	0.0625000
NODE_4357_length_1153_cov_65.486717	598	678	4	10	80	0.1250000
NODE_4357_length_1153_cov_65.486717	598	678	6	62	80	0.7750000
NODE_4358_length_1153_cov_50.733397	404	484	0	80	80	1.0000000
NODE_4358_length_1153_cov_50.733397	457	537	0	32	80	0.4000000
NODE_4358_length_1153_cov_50.733397	457	537	2	48	80	0.6000000
NODE_4358_length_1153_cov_50.733397	533	613	2	9	80	0.1125000
NODE_4358_length_1153_cov_50.733397	533	613	4	44	80	0.5500000
NODE_4358_length_1153_cov_50.733397	533	613	6	10	80	0.1250000
NODE_4358_length_1153_cov_50.733397	533	613	8	17	80	0.2125000
NODE_4358_length_1153_cov_50.733397	586	666	0	8	80	0.1000000
NODE_4358_length_1153_cov_50.733397	586	666	4	34	80	0.4250000
NODE_4358_length_1153_cov_50.733397	586	666	6	21	80	0.2625000
NODE_4358_length_1153_cov_50.733397	586	666	8	17	80	0.2125000
NODE_4359_length_1153_cov_26.131879	493	573	1	33	80	0.4125000
NODE_4359_length_1153_cov_26.131879	493	573	3	9	80	0.1125000
NODE_4359_length_1153_cov_26.131879	493	573	4	38	80	0.4750000
NODE_4359_length_1153_cov_26.131879	546	626	1	6	80	0.0750000
NODE_4359_length_1153_cov_26.131879	546	626	3	33	80	0.4125000
NODE_4359_length_1153_cov_26.131879	546	626	4	41	80	0.5125000
NODE_4360_length_1153_cov_10.195446	500	580	0	80	80	1.0000000
NODE_4360_length_1153_cov_10.195446	553	633	0	80	80	1.0000000
NODE_4361_length_1153_cov_8.286528	558	638	0	29	80	0.3625000
NODE_4361_length_1153_cov_8.286528	558	638	1	2	80	0.0250000
NODE_4361_length_1153_cov_8.286528	558	638	2	49	80	0.6125000
NODE_4361_length_1153_cov_8.286528	611	691	2	27	80	0.3375000
NODE_4361_length_1153_cov_8.286528	611	691	4	53	80	0.6625000
NODE_4368_length_1152_cov_19.800570	553	633	0	5	80	0.0625000
NODE_4368_length_1152_cov_19.800570	553	633	5	9	80	0.1125000
NODE_4368_length_1152_cov_19.800570	553	633	9	13	80	0.1625000
NODE_4368_length_1152_cov_19.800570	553	633	11	48	80	0.6000000
NODE_4368_length_1152_cov_19.800570	553	633	12	5	80	0.0625000
NODE_4368_length_1152_cov_19.800570	606	686	4	15	80	0.1875000
NODE_4368_length_1152_cov_19.800570	606	686	6	10	80	0.1250000
NODE_4368_length_1152_cov_19.800570	606	686	10	16	80	0.2000000
NODE_4368_length_1152_cov_19.800570	606	686	11	22	80	0.2750000
NODE_4368_length_1152_cov_19.800570	606	686	12	17	80	0.2125000
NODE_4369_length_1152_cov_19.365622	490	570	0	7	80	0.0875000
NODE_4369_length_1152_cov_19.365622	490	570	4	24	80	0.3000000
NODE_4369_length_1152_cov_19.365622	490	570	6	49	80	0.6125000
NODE_4369_length_1152_cov_19.365622	543	623	6	80	80	1.0000000
NODE_4370_length_1152_cov_18.654321	594	674	0	25	80	0.3125000
NODE_4370_length_1152_cov_18.654321	594	674	2	55	80	0.6875000
NODE_4370_length_1152_cov_18.654321	647	727	2	80	80	1.0000000
NODE_4371_length_1152_cov_18.075024	377	457	0	51	80	0.6375000
NODE_4371_length_1152_cov_18.075024	377	457	1	29	80	0.3625000
NODE_4371_length_1152_cov_18.075024	430	510	1	80	80	1.0000000
NODE_4371_length_1152_cov_18.075024	506	586	0	8	80	0.1000000
NODE_4371_length_1152_cov_18.075024	506	586	1	72	80	0.9000000
NODE_4371_length_1152_cov_18.075024	559	639	0	12	80	0.1500000
NODE_4371_length_1152_cov_18.075024	559	639	1	68	80	0.8500000
NODE_4373_length_1152_cov_16.047483	543	623	0	2	80	0.0250000
NODE_4373_length_1152_cov_16.047483	543	623	1	6	80	0.0750000
NODE_4373_length_1152_cov_16.047483	543	623	2	31	80	0.3875000
NODE_4373_length_1152_cov_16.047483	543	623	3	5	80	0.0625000
NODE_4373_length_1152_cov_16.047483	543	623	4	36	80	0.4500000
NODE_4373_length_1152_cov_16.047483	596	676	0	2	80	0.0250000
NODE_4373_length_1152_cov_16.047483	596	676	1	53	80	0.6625000
NODE_4373_length_1152_cov_16.047483	596	676	2	19	80	0.2375000
NODE_4373_length_1152_cov_16.047483	596	676	3	6	80	0.0750000
NODE_4373_length_1152_cov_16.047483	672	752	3	32	80	0.4000000
NODE_4373_length_1152_cov_16.047483	672	752	5	48	80	0.6000000
NODE_4373_length_1152_cov_16.047483	725	805	0	10	80	0.1250000
NODE_4373_length_1152_cov_16.047483	725	805	2	27	80	0.3375000
NODE_4373_length_1152_cov_16.047483	725	805	4	1	80	0.0125000
NODE_4373_length_1152_cov_16.047483	725	805	5	42	80	0.5250000
NODE_4374_length_1152_cov_13.981007	583	663	0	28	80	0.3500000
NODE_4374_length_1152_cov_13.981007	583	663	2	52	80	0.6500000
NODE_4374_length_1152_cov_13.981007	636	716	0	78	80	0.9750000
NODE_4374_length_1152_cov_13.981007	636	716	2	2	80	0.0250000
NODE_4380_length_1151_cov_30.469582	479	559	0	25	80	0.3125000
NODE_4380_length_1151_cov_30.469582	479	559	2	11	80	0.1375000
NODE_4380_length_1151_cov_30.469582	479	559	4	44	80	0.5500000
NODE_4380_length_1151_cov_30.469582	532	612	4	75	80	0.9375000
NODE_4380_length_1151_cov_30.469582	532	612	6	5	80	0.0625000
NODE_4381_length_1151_cov_26.650190	567	647	0	15	80	0.1875000
NODE_4381_length_1151_cov_26.650190	567	647	2	18	80	0.2250000
NODE_4381_length_1151_cov_26.650190	567	647	6	6	80	0.0750000
NODE_4381_length_1151_cov_26.650190	567	647	10	41	80	0.5125000
NODE_4381_length_1151_cov_26.650190	620	700	8	24	80	0.3000000
NODE_4381_length_1151_cov_26.650190	620	700	10	56	80	0.7000000
NODE_4382_length_1151_cov_26.375475	441	521	4	39	80	0.4875000
NODE_4382_length_1151_cov_26.375475	441	521	6	27	80	0.3375000
NODE_4382_length_1151_cov_26.375475	441	521	8	14	80	0.1750000
NODE_4382_length_1151_cov_26.375475	494	574	0	19	80	0.2375000
NODE_4382_length_1151_cov_26.375475	494	574	2	34	80	0.4250000
NODE_4382_length_1151_cov_26.375475	494	574	4	27	80	0.3375000
NODE_4382_length_1151_cov_26.375475	570	650	0	59	80	0.7375000
NODE_4382_length_1151_cov_26.375475	570	650	2	21	80	0.2625000
NODE_4382_length_1151_cov_26.375475	623	703	0	9	80	0.1125000
NODE_4382_length_1151_cov_26.375475	623	703	2	71	80	0.8875000
NODE_4383_length_1151_cov_23.614068	590	670	0	51	80	0.6375000
NODE_4383_length_1151_cov_23.614068	590	670	2	29	80	0.3625000
NODE_4383_length_1151_cov_23.614068	643	721	2	47	78	0.6025641
NODE_4383_length_1151_cov_23.614068	643	721	4	31	78	0.3974359
NODE_4384_length_1151_cov_18.693916	355	435	0	80	80	1.0000000
NODE_4384_length_1151_cov_18.693916	408	491	0	83	83	1.0000000
NODE_4385_length_1151_cov_16.093156	474	554	0	62	80	0.7750000
NODE_4385_length_1151_cov_16.093156	474	554	2	18	80	0.2250000
NODE_4385_length_1151_cov_16.093156	527	607	0	9	80	0.1125000
NODE_4385_length_1151_cov_16.093156	527	607	2	71	80	0.8875000
NODE_4386_length_1151_cov_13.782319	400	482	0	82	82	1.0000000
NODE_4386_length_1151_cov_13.782319	450	535	0	85	85	1.0000000
NODE_4392_length_1150_cov_38.601332	563	643	2	28	80	0.3500000
NODE_4392_length_1150_cov_38.601332	563	643	4	18	80	0.2250000
NODE_4392_length_1150_cov_38.601332	563	643	5	4	80	0.0500000
NODE_4392_length_1150_cov_38.601332	563	643	6	30	80	0.3750000
NODE_4392_length_1150_cov_38.601332	616	696	2	36	80	0.4500000
NODE_4392_length_1150_cov_38.601332	616	696	3	44	80	0.5500000
NODE_4392_length_1150_cov_38.601332	692	772	1	37	80	0.4625000
NODE_4392_length_1150_cov_38.601332	692	772	2	4	80	0.0500000
NODE_4392_length_1150_cov_38.601332	692	772	3	39	80	0.4875000
NODE_4392_length_1150_cov_38.601332	745	825	0	23	80	0.2875000
NODE_4392_length_1150_cov_38.601332	745	825	1	57	80	0.7125000
NODE_4393_length_1150_cov_15.741199	497	578	0	3	81	0.0370370
NODE_4393_length_1150_cov_15.741199	497	578	1	7	81	0.0864198
NODE_4393_length_1150_cov_15.741199	497	578	2	6	81	0.0740741
NODE_4393_length_1150_cov_15.741199	497	578	4	65	81	0.8024691
NODE_4393_length_1150_cov_15.741199	550	631	2	9	81	0.1111111
NODE_4393_length_1150_cov_15.741199	550	631	4	72	81	0.8888889
NODE_4394_length_1150_cov_11.132255	795	875	0	41	80	0.5125000
NODE_4394_length_1150_cov_11.132255	795	875	1	28	80	0.3500000
NODE_4394_length_1150_cov_11.132255	795	875	2	11	80	0.1375000
NODE_4394_length_1150_cov_11.132255	848	928	0	80	80	1.0000000
NODE_4395_length_1150_cov_9.253092	583	663	0	23	80	0.2875000
NODE_4395_length_1150_cov_9.253092	583	663	2	57	80	0.7125000
NODE_4395_length_1150_cov_9.253092	636	716	0	27	80	0.3375000
NODE_4395_length_1150_cov_9.253092	636	716	2	53	80	0.6625000
NODE_4398_length_1149_cov_17.289524	644	695	0	51	51	1.0000000
NODE_4399_length_1149_cov_13.805714	584	664	0	2	80	0.0250000
NODE_4399_length_1149_cov_13.805714	584	664	1	5	80	0.0625000
NODE_4399_length_1149_cov_13.805714	584	664	2	7	80	0.0875000
NODE_4399_length_1149_cov_13.805714	584	664	3	8	80	0.1000000
NODE_4399_length_1149_cov_13.805714	584	664	5	5	80	0.0625000
NODE_4399_length_1149_cov_13.805714	584	664	6	53	80	0.6625000
NODE_4399_length_1149_cov_13.805714	637	717	2	4	80	0.0500000
NODE_4399_length_1149_cov_13.805714	637	717	4	26	80	0.3250000
NODE_4399_length_1149_cov_13.805714	637	717	6	50	80	0.6250000
NODE_4399_length_1149_cov_13.805714	713	793	0	32	80	0.4000000
NODE_4399_length_1149_cov_13.805714	713	793	1	18	80	0.2250000
NODE_4399_length_1149_cov_13.805714	713	793	2	30	80	0.3750000
NODE_4399_length_1149_cov_13.805714	766	846	0	80	80	1.0000000
NODE_4407_length_1148_cov_27.674929	387	467	6	78	80	0.9750000
NODE_4407_length_1148_cov_27.674929	387	467	8	2	80	0.0250000
NODE_4407_length_1148_cov_27.674929	440	520	2	46	80	0.5750000
NODE_4407_length_1148_cov_27.674929	440	520	4	3	80	0.0375000
NODE_4407_length_1148_cov_27.674929	440	520	6	29	80	0.3625000
NODE_4407_length_1148_cov_27.674929	440	520	8	2	80	0.0250000
NODE_4408_length_1148_cov_13.275500	136	216	0	21	80	0.2625000
NODE_4408_length_1148_cov_13.275500	136	216	2	59	80	0.7375000
NODE_4408_length_1148_cov_13.275500	189	268	0	19	79	0.2405063
NODE_4408_length_1148_cov_13.275500	189	268	2	60	79	0.7594936
NODE_4409_length_1148_cov_10.613918	506	586	0	49	80	0.6125000
NODE_4409_length_1148_cov_10.613918	506	586	2	20	80	0.2500000
NODE_4409_length_1148_cov_10.613918	506	586	4	11	80	0.1375000
NODE_4409_length_1148_cov_10.613918	559	639	2	16	80	0.2000000
NODE_4409_length_1148_cov_10.613918	559	639	4	64	80	0.8000000
NODE_4415_length_1147_cov_33.543893	378	458	0	28	80	0.3500000
NODE_4415_length_1147_cov_33.543893	378	458	2	6	80	0.0750000
NODE_4415_length_1147_cov_33.543893	378	458	4	13	80	0.1625000
NODE_4415_length_1147_cov_33.543893	378	458	6	33	80	0.4125000
NODE_4415_length_1147_cov_33.543893	431	511	2	27	80	0.3375000
NODE_4415_length_1147_cov_33.543893	431	511	4	1	80	0.0125000
NODE_4415_length_1147_cov_33.543893	431	511	6	52	80	0.6500000
NODE_4416_length_1147_cov_26.858779	254	334	0	28	80	0.3500000
NODE_4416_length_1147_cov_26.858779	254	334	1	52	80	0.6500000
NODE_4416_length_1147_cov_26.858779	307	387	1	80	80	1.0000000
NODE_4416_length_1147_cov_26.858779	383	463	1	42	80	0.5250000
NODE_4416_length_1147_cov_26.858779	383	463	2	38	80	0.4750000
NODE_4416_length_1147_cov_26.858779	436	516	1	80	80	1.0000000
NODE_4417_length_1147_cov_24.227099	606	686	0	31	80	0.3875000
NODE_4417_length_1147_cov_24.227099	606	686	2	49	80	0.6125000
NODE_4417_length_1147_cov_24.227099	659	739	0	16	80	0.2000000
NODE_4417_length_1147_cov_24.227099	659	739	2	64	80	0.8000000
NODE_4417_length_1147_cov_24.227099	735	815	0	3	80	0.0375000
NODE_4417_length_1147_cov_24.227099	735	815	2	67	80	0.8375000
NODE_4417_length_1147_cov_24.227099	735	815	4	10	80	0.1250000
NODE_4417_length_1147_cov_24.227099	788	868	2	39	80	0.4875000
NODE_4417_length_1147_cov_24.227099	788	868	4	41	80	0.5125000
NODE_4418_length_1147_cov_16.559160	417	497	0	26	80	0.3250000
NODE_4418_length_1147_cov_16.559160	417	497	2	54	80	0.6750000
NODE_4418_length_1147_cov_16.559160	470	550	0	79	80	0.9875000
NODE_4418_length_1147_cov_16.559160	470	550	2	1	80	0.0125000
NODE_4428_length_1146_cov_52.393505	411	491	0	80	80	1.0000000
NODE_4428_length_1146_cov_52.393505	464	544	0	65	80	0.8125000
NODE_4428_length_1146_cov_52.393505	464	544	2	15	80	0.1875000
NODE_4428_length_1146_cov_52.393505	540	620	2	80	80	1.0000000
NODE_4428_length_1146_cov_52.393505	593	673	2	80	80	1.0000000
NODE_4429_length_1146_cov_46.364852	233	313	0	80	80	1.0000000
NODE_4429_length_1146_cov_46.364852	286	366	0	80	80	1.0000000
NODE_4430_length_1146_cov_26.159503	476	556	0	36	80	0.4500000
NODE_4430_length_1146_cov_26.159503	476	556	2	44	80	0.5500000
NODE_4430_length_1146_cov_26.159503	529	609	2	62	80	0.7750000
NODE_4430_length_1146_cov_26.159503	529	609	3	4	80	0.0500000
NODE_4430_length_1146_cov_26.159503	529	609	4	14	80	0.1750000
NODE_4430_length_1146_cov_26.159503	605	685	2	80	80	1.0000000
NODE_4430_length_1146_cov_26.159503	658	738	1	5	80	0.0625000
NODE_4430_length_1146_cov_26.159503	658	738	2	75	80	0.9375000
NODE_4431_length_1146_cov_14.210124	343	423	1	18	80	0.2250000
NODE_4431_length_1146_cov_14.210124	343	423	2	1	80	0.0125000
NODE_4431_length_1146_cov_14.210124	343	423	3	12	80	0.1500000
NODE_4431_length_1146_cov_14.210124	343	423	4	49	80	0.6125000
NODE_4431_length_1146_cov_14.210124	396	476	1	33	80	0.4125000
NODE_4431_length_1146_cov_14.210124	396	476	2	21	80	0.2625000
NODE_4431_length_1146_cov_14.210124	396	476	4	26	80	0.3250000
NODE_4432_length_1146_cov_13.479465	425	501	0	76	76	1.0000000
NODE_4432_length_1146_cov_13.479465	505	565	0	60	60	1.0000000
NODE_4432_length_1146_cov_13.479465	561	641	0	80	80	1.0000000
NODE_4432_length_1146_cov_13.479465	614	694	0	80	80	1.0000000
NODE_4438_length_1145_cov_49.566922	395	470	0	1	75	0.0133333
NODE_4438_length_1145_cov_49.566922	395	470	2	16	75	0.2133333
NODE_4438_length_1145_cov_49.566922	395	470	12	19	75	0.2533333
NODE_4438_length_1145_cov_49.566922	395	470	14	19	75	0.2533333
NODE_4438_length_1145_cov_49.566922	395	470	16	20	75	0.2666667
NODE_4438_length_1145_cov_49.566922	443	523	12	28	80	0.3500000
NODE_4438_length_1145_cov_49.566922	443	523	14	23	80	0.2875000
NODE_4438_length_1145_cov_49.566922	443	523	16	29	80	0.3625000
NODE_4439_length_1145_cov_38.191205	497	576	1	56	79	0.7088608
NODE_4439_length_1145_cov_38.191205	497	576	3	19	79	0.2405063
NODE_4439_length_1145_cov_38.191205	497	576	5	4	79	0.0506329
NODE_4439_length_1145_cov_38.191205	549	629	1	4	80	0.0500000
NODE_4439_length_1145_cov_38.191205	549	629	3	30	80	0.3750000
NODE_4439_length_1145_cov_38.191205	549	629	5	46	80	0.5750000
NODE_4440_length_1145_cov_26.929254	468	548	2	9	80	0.1125000
NODE_4440_length_1145_cov_26.929254	468	548	3	1	80	0.0125000
NODE_4440_length_1145_cov_26.929254	468	548	4	31	80	0.3875000
NODE_4440_length_1145_cov_26.929254	468	548	5	28	80	0.3500000
NODE_4440_length_1145_cov_26.929254	468	548	6	11	80	0.1375000
NODE_4440_length_1145_cov_26.929254	521	601	5	24	80	0.3000000
NODE_4440_length_1145_cov_26.929254	521	601	6	56	80	0.7000000
NODE_4441_length_1145_cov_20.121415	508	588	0	15	80	0.1875000
NODE_4441_length_1145_cov_20.121415	508	588	2	65	80	0.8125000
NODE_4441_length_1145_cov_20.121415	561	641	2	50	80	0.6250000
NODE_4441_length_1145_cov_20.121415	561	641	4	30	80	0.3750000
NODE_4442_length_1145_cov_11.753346	527	605	2	78	78	1.0000000
NODE_4442_length_1145_cov_11.753346	578	659	0	14	81	0.1728395
NODE_4442_length_1145_cov_11.753346	578	659	2	67	81	0.8271605
NODE_4443_length_1145_cov_9.571702	93	173	0	59	80	0.7375000
NODE_4443_length_1145_cov_9.571702	93	173	2	21	80	0.2625000
NODE_4443_length_1145_cov_9.571702	146	226	0	6	80	0.0750000
NODE_4443_length_1145_cov_9.571702	146	226	2	74	80	0.9250000
NODE_4455_length_1143_cov_42.255747	380	460	4	71	80	0.8875000
NODE_4455_length_1143_cov_42.255747	380	460	6	9	80	0.1125000
NODE_4455_length_1143_cov_42.255747	433	513	2	25	80	0.3125000
NODE_4455_length_1143_cov_42.255747	433	513	4	18	80	0.2250000
NODE_4455_length_1143_cov_42.255747	433	513	6	37	80	0.4625000
NODE_4455_length_1143_cov_42.255747	509	589	0	25	80	0.3125000
NODE_4455_length_1143_cov_42.255747	509	589	2	55	80	0.6875000
NODE_4455_length_1143_cov_42.255747	562	642	0	78	80	0.9750000
NODE_4455_length_1143_cov_42.255747	562	642	2	2	80	0.0250000
NODE_4456_length_1143_cov_22.076628	526	606	0	36	80	0.4500000
NODE_4456_length_1143_cov_22.076628	526	606	2	13	80	0.1625000
NODE_4456_length_1143_cov_22.076628	526	606	6	13	80	0.1625000
NODE_4456_length_1143_cov_22.076628	526	606	7	18	80	0.2250000
NODE_4456_length_1143_cov_22.076628	579	659	4	3	80	0.0375000
NODE_4456_length_1143_cov_22.076628	579	659	6	9	80	0.1125000
NODE_4456_length_1143_cov_22.076628	579	659	7	62	80	0.7750000
NODE_4456_length_1143_cov_22.076628	579	659	8	6	80	0.0750000
NODE_4457_length_1143_cov_19.106322	565	645	0	8	80	0.1000000
NODE_4457_length_1143_cov_19.106322	565	645	2	72	80	0.9000000
NODE_4457_length_1143_cov_19.106322	618	698	0	61	80	0.7625000
NODE_4457_length_1143_cov_19.106322	618	698	2	19	80	0.2375000
NODE_4458_length_1143_cov_16.223180	638	719	0	81	81	1.0000000
NODE_4458_length_1143_cov_16.223180	692	772	0	80	80	1.0000000
NODE_4459_length_1143_cov_13.961686	634	714	0	80	80	1.0000000
NODE_4459_length_1143_cov_13.961686	687	767	0	80	80	1.0000000
NODE_4459_length_1143_cov_13.961686	763	843	0	80	80	1.0000000
NODE_4459_length_1143_cov_13.961686	816	896	0	80	80	1.0000000
NODE_4460_length_1143_cov_12.782567	328	409	0	81	81	1.0000000
NODE_4460_length_1143_cov_12.782567	381	462	0	81	81	1.0000000
NODE_4460_length_1143_cov_12.782567	458	538	0	80	80	1.0000000
NODE_4460_length_1143_cov_12.782567	511	591	0	80	80	1.0000000
NODE_4461_length_1143_cov_8.287356	692	772	0	56	80	0.7000000
NODE_4461_length_1143_cov_8.287356	692	772	2	24	80	0.3000000
NODE_4461_length_1143_cov_8.287356	745	825	0	3	80	0.0375000
NODE_4461_length_1143_cov_8.287356	745	825	2	77	80	0.9625000
NODE_4463_length_1143_cov_2.197318	988	1057	8	5	69	0.0724638
NODE_4463_length_1143_cov_2.197318	988	1057	9	3	69	0.0434783
NODE_4463_length_1143_cov_2.197318	988	1057	10	14	69	0.2028985
NODE_4463_length_1143_cov_2.197318	988	1057	12	12	69	0.1739130
NODE_4463_length_1143_cov_2.197318	988	1057	14	35	69	0.5072464
NODE_4466_length_1142_cov_28.364334	613	693	5	12	80	0.1500000
NODE_4466_length_1142_cov_28.364334	613	693	7	18	80	0.2250000
NODE_4466_length_1142_cov_28.364334	613	693	8	27	80	0.3375000
NODE_4466_length_1142_cov_28.364334	613	693	9	9	80	0.1125000
NODE_4466_length_1142_cov_28.364334	613	693	11	14	80	0.1750000
NODE_4466_length_1142_cov_28.364334	666	746	4	41	80	0.5125000
NODE_4466_length_1142_cov_28.364334	666	746	7	4	80	0.0500000
NODE_4466_length_1142_cov_28.364334	666	746	8	7	80	0.0875000
NODE_4466_length_1142_cov_28.364334	666	746	9	9	80	0.1125000
NODE_4466_length_1142_cov_28.364334	666	746	10	2	80	0.0250000
NODE_4466_length_1142_cov_28.364334	666	746	11	17	80	0.2125000
NODE_4467_length_1142_cov_21.669223	518	598	0	80	80	1.0000000
NODE_4467_length_1142_cov_21.669223	571	651	0	80	80	1.0000000
NODE_4468_length_1142_cov_19.007670	411	491	0	30	80	0.3750000
NODE_4468_length_1142_cov_19.007670	411	491	2	50	80	0.6250000
NODE_4468_length_1142_cov_19.007670	464	544	0	29	80	0.3625000
NODE_4468_length_1142_cov_19.007670	464	544	2	51	80	0.6375000
NODE_4474_length_1141_cov_12.500960	17	97	2	6	80	0.0750000
NODE_4474_length_1141_cov_12.500960	17	97	6	2	80	0.0250000
NODE_4474_length_1141_cov_12.500960	17	97	8	4	80	0.0500000
NODE_4474_length_1141_cov_12.500960	17	97	12	10	80	0.1250000
NODE_4474_length_1141_cov_12.500960	17	97	14	28	80	0.3500000
NODE_4474_length_1141_cov_12.500960	17	97	16	30	80	0.3750000
NODE_4474_length_1141_cov_12.500960	17	97	2	6	80	0.0750000
NODE_4474_length_1141_cov_12.500960	17	97	6	2	80	0.0250000
NODE_4474_length_1141_cov_12.500960	17	97	8	4	80	0.0500000
NODE_4474_length_1141_cov_12.500960	17	97	12	10	80	0.1250000
NODE_4474_length_1141_cov_12.500960	17	97	14	28	80	0.3500000
NODE_4474_length_1141_cov_12.500960	17	97	16	30	80	0.3750000
NODE_4474_length_1141_cov_12.500960	17	97	2	6	80	0.0750000
NODE_4474_length_1141_cov_12.500960	17	97	6	2	80	0.0250000
NODE_4474_length_1141_cov_12.500960	17	97	8	4	80	0.0500000
NODE_4474_length_1141_cov_12.500960	17	97	12	10	80	0.1250000
NODE_4474_length_1141_cov_12.500960	17	97	14	28	80	0.3500000
NODE_4474_length_1141_cov_12.500960	17	97	16	30	80	0.3750000
NODE_4474_length_1141_cov_12.500960	17	97	2	6	80	0.0750000
NODE_4474_length_1141_cov_12.500960	17	97	6	2	80	0.0250000
NODE_4474_length_1141_cov_12.500960	17	97	8	4	80	0.0500000
NODE_4474_length_1141_cov_12.500960	17	97	12	10	80	0.1250000
NODE_4474_length_1141_cov_12.500960	17	97	14	28	80	0.3500000
NODE_4474_length_1141_cov_12.500960	17	97	16	30	80	0.3750000
NODE_4474_length_1141_cov_12.500960	70	132	2	5	62	0.0806452
NODE_4474_length_1141_cov_12.500960	70	132	6	2	62	0.0322581
NODE_4474_length_1141_cov_12.500960	70	132	10	1	62	0.0161290
NODE_4474_length_1141_cov_12.500960	70	132	12	10	62	0.1612903
NODE_4474_length_1141_cov_12.500960	70	132	14	1	62	0.0161290
NODE_4474_length_1141_cov_12.500960	70	132	16	43	62	0.6935484
NODE_4474_length_1141_cov_12.500960	70	132	2	5	62	0.0806452
NODE_4474_length_1141_cov_12.500960	70	132	6	2	62	0.0322581
NODE_4474_length_1141_cov_12.500960	70	132	10	1	62	0.0161290
NODE_4474_length_1141_cov_12.500960	70	132	12	10	62	0.1612903
NODE_4474_length_1141_cov_12.500960	70	132	14	1	62	0.0161290
NODE_4474_length_1141_cov_12.500960	70	132	16	43	62	0.6935484
NODE_4474_length_1141_cov_12.500960	70	132	2	5	62	0.0806452
NODE_4474_length_1141_cov_12.500960	70	132	6	2	62	0.0322581
NODE_4474_length_1141_cov_12.500960	70	132	10	1	62	0.0161290
NODE_4474_length_1141_cov_12.500960	70	132	12	10	62	0.1612903
NODE_4474_length_1141_cov_12.500960	70	132	14	1	62	0.0161290
NODE_4474_length_1141_cov_12.500960	70	132	16	43	62	0.6935484
NODE_4474_length_1141_cov_12.500960	70	132	2	5	62	0.0806452
NODE_4474_length_1141_cov_12.500960	70	132	6	2	62	0.0322581
NODE_4474_length_1141_cov_12.500960	70	132	10	1	62	0.0161290
NODE_4474_length_1141_cov_12.500960	70	132	12	10	62	0.1612903
NODE_4474_length_1141_cov_12.500960	70	132	14	1	62	0.0161290
NODE_4474_length_1141_cov_12.500960	70	132	16	43	62	0.6935484
NODE_4475_length_1141_cov_7.197697	54	134	0	4	80	0.0500000
NODE_4475_length_1141_cov_7.197697	54	134	2	76	80	0.9500000
NODE_4475_length_1141_cov_7.197697	107	187	0	37	80	0.4625000
NODE_4475_length_1141_cov_7.197697	107	187	2	43	80	0.5375000
NODE_4475_length_1141_cov_7.197697	573	653	2	45	80	0.5625000
NODE_4475_length_1141_cov_7.197697	573	653	4	34	80	0.4250000
NODE_4475_length_1141_cov_7.197697	573	653	6	1	80	0.0125000
NODE_4475_length_1141_cov_7.197697	626	707	4	41	81	0.5061728
NODE_4475_length_1141_cov_7.197697	626	707	6	40	81	0.4938272
NODE_4476_length_1141_cov_5.428023	411	491	0	54	80	0.6750000
NODE_4476_length_1141_cov_5.428023	411	491	2	26	80	0.3250000
NODE_4476_length_1141_cov_5.428023	464	544	0	80	80	1.0000000
NODE_4482_length_1140_cov_39.383285	451	531	0	3	80	0.0375000
NODE_4482_length_1140_cov_39.383285	451	531	2	4	80	0.0500000
NODE_4482_length_1140_cov_39.383285	451	531	4	17	80	0.2125000
NODE_4482_length_1140_cov_39.383285	451	531	6	13	80	0.1625000
NODE_4482_length_1140_cov_39.383285	451	531	10	43	80	0.5375000
NODE_4482_length_1140_cov_39.383285	504	584	4	4	80	0.0500000
NODE_4482_length_1140_cov_39.383285	504	584	6	26	80	0.3250000
NODE_4482_length_1140_cov_39.383285	504	584	8	2	80	0.0250000
NODE_4482_length_1140_cov_39.383285	504	584	10	48	80	0.6000000
NODE_4482_length_1140_cov_39.383285	580	660	0	58	80	0.7250000
NODE_4482_length_1140_cov_39.383285	580	660	4	22	80	0.2750000
NODE_4482_length_1140_cov_39.383285	633	713	0	80	80	1.0000000
NODE_4483_length_1140_cov_19.493756	543	623	2	39	80	0.4875000
NODE_4483_length_1140_cov_19.493756	543	623	4	41	80	0.5125000
NODE_4483_length_1140_cov_19.493756	596	676	0	9	80	0.1125000
NODE_4483_length_1140_cov_19.493756	596	676	2	22	80	0.2750000
NODE_4483_length_1140_cov_19.493756	596	676	4	49	80	0.6125000
NODE_4484_length_1140_cov_18.341018	347	427	0	80	80	1.0000000
NODE_4484_length_1140_cov_18.341018	400	480	0	80	80	1.0000000
NODE_4484_length_1140_cov_18.341018	476	556	0	59	80	0.7375000
NODE_4484_length_1140_cov_18.341018	476	556	2	2	80	0.0250000
NODE_4484_length_1140_cov_18.341018	476	556	4	19	80	0.2375000
NODE_4484_length_1140_cov_18.341018	529	609	0	6	80	0.0750000
NODE_4484_length_1140_cov_18.341018	529	609	2	2	80	0.0250000
NODE_4484_length_1140_cov_18.341018	529	609	4	72	80	0.9000000
NODE_4494_length_1139_cov_26.812500	410	490	2	80	80	1.0000000
NODE_4494_length_1139_cov_26.812500	463	543	0	46	80	0.5750000
NODE_4494_length_1139_cov_26.812500	463	543	2	34	80	0.4250000
NODE_4494_length_1139_cov_26.812500	539	619	0	80	80	1.0000000
NODE_4494_length_1139_cov_26.812500	592	672	0	80	80	1.0000000
NODE_4495_length_1139_cov_26.323077	308	388	0	80	80	1.0000000
NODE_4495_length_1139_cov_26.323077	361	441	0	80	80	1.0000000
NODE_4495_length_1139_cov_26.323077	437	517	0	80	80	1.0000000
NODE_4495_length_1139_cov_26.323077	490	570	0	48	80	0.6000000
NODE_4495_length_1139_cov_26.323077	490	570	2	25	80	0.3125000
NODE_4495_length_1139_cov_26.323077	490	570	4	7	80	0.0875000
NODE_4496_length_1139_cov_15.223077	530	610	2	23	80	0.2875000
NODE_4496_length_1139_cov_15.223077	530	610	4	57	80	0.7125000
NODE_4496_length_1139_cov_15.223077	583	663	0	35	80	0.4375000
NODE_4496_length_1139_cov_15.223077	583	663	2	26	80	0.3250000
NODE_4496_length_1139_cov_15.223077	583	663	4	19	80	0.2375000
NODE_4505_length_1138_cov_74.599615	480	560	2	48	80	0.6000000
NODE_4505_length_1138_cov_74.599615	480	560	4	32	80	0.4000000
NODE_4505_length_1138_cov_74.599615	533	613	4	49	80	0.6125000
NODE_4505_length_1138_cov_74.599615	533	613	8	5	80	0.0625000
NODE_4505_length_1138_cov_74.599615	533	613	11	12	80	0.1500000
NODE_4505_length_1138_cov_74.599615	533	613	12	14	80	0.1750000
NODE_4505_length_1138_cov_74.599615	609	689	10	11	80	0.1375000
NODE_4505_length_1138_cov_74.599615	609	689	11	13	80	0.1625000
NODE_4505_length_1138_cov_74.599615	609	689	12	24	80	0.3000000
NODE_4505_length_1138_cov_74.599615	609	689	14	32	80	0.4000000
NODE_4505_length_1138_cov_74.599615	662	742	4	5	80	0.0625000
NODE_4505_length_1138_cov_74.599615	662	742	8	5	80	0.0625000
NODE_4505_length_1138_cov_74.599615	662	742	12	67	80	0.8375000
NODE_4505_length_1138_cov_74.599615	662	742	14	3	80	0.0375000
NODE_4506_length_1138_cov_29.407122	559	639	0	80	80	1.0000000
NODE_4506_length_1138_cov_29.407122	612	692	0	80	80	1.0000000
NODE_4506_length_1138_cov_29.407122	688	768	0	24	80	0.3000000
NODE_4506_length_1138_cov_29.407122	688	768	1	1	80	0.0125000
NODE_4506_length_1138_cov_29.407122	688	768	2	55	80	0.6875000
NODE_4506_length_1138_cov_29.407122	741	821	2	80	80	1.0000000
NODE_4507_length_1138_cov_18.326275	454	534	0	80	80	1.0000000
NODE_4507_length_1138_cov_18.326275	507	587	0	80	80	1.0000000
NODE_4507_length_1138_cov_18.326275	583	663	0	25	80	0.3125000
NODE_4507_length_1138_cov_18.326275	583	663	2	55	80	0.6875000
NODE_4507_length_1138_cov_18.326275	636	716	0	18	80	0.2250000
NODE_4507_length_1138_cov_18.326275	636	716	2	62	80	0.7750000
NODE_4509_length_1138_cov_11.834456	291	371	0	80	80	1.0000000
NODE_4509_length_1138_cov_11.834456	344	424	0	80	80	1.0000000
NODE_4510_length_1138_cov_10.923003	318	398	0	21	80	0.2625000
NODE_4510_length_1138_cov_10.923003	318	398	2	42	80	0.5250000
NODE_4510_length_1138_cov_10.923003	318	398	4	17	80	0.2125000
NODE_4510_length_1138_cov_10.923003	371	451	2	10	80	0.1250000
NODE_4510_length_1138_cov_10.923003	371	451	4	70	80	0.8750000
NODE_4517_length_1137_cov_23.983622	470	550	0	80	80	1.0000000
NODE_4517_length_1137_cov_23.983622	523	603	0	80	80	1.0000000
NODE_4517_length_1137_cov_23.983622	599	679	0	36	80	0.4500000
NODE_4517_length_1137_cov_23.983622	599	679	2	44	80	0.5500000
NODE_4517_length_1137_cov_23.983622	652	732	0	42	80	0.5250000
NODE_4517_length_1137_cov_23.983622	652	732	2	38	80	0.4750000
NODE_4518_length_1137_cov_22.877649	405	485	0	47	80	0.5875000
NODE_4518_length_1137_cov_22.877649	405	485	2	33	80	0.4125000
NODE_4518_length_1137_cov_22.877649	458	538	2	27	80	0.3375000
NODE_4518_length_1137_cov_22.877649	458	538	3	4	80	0.0500000
NODE_4518_length_1137_cov_22.877649	458	538	4	39	80	0.4875000
NODE_4518_length_1137_cov_22.877649	458	538	6	10	80	0.1250000
NODE_4518_length_1137_cov_22.877649	534	614	2	36	80	0.4500000
NODE_4518_length_1137_cov_22.877649	534	614	4	44	80	0.5500000
NODE_4518_length_1137_cov_22.877649	587	667	0	29	80	0.3625000
NODE_4518_length_1137_cov_22.877649	587	667	1	4	80	0.0500000
NODE_4518_length_1137_cov_22.877649	587	667	2	47	80	0.5875000
NODE_4519_length_1137_cov_21.570328	383	463	0	80	80	1.0000000
NODE_4519_length_1137_cov_21.570328	436	516	0	27	80	0.3375000
NODE_4519_length_1137_cov_21.570328	436	516	2	53	80	0.6625000
NODE_4520_length_1137_cov_18.560694	665	745	0	14	80	0.1750000
NODE_4520_length_1137_cov_18.560694	665	745	2	66	80	0.8250000
NODE_4520_length_1137_cov_18.560694	718	798	0	67	80	0.8375000
NODE_4520_length_1137_cov_18.560694	718	798	2	13	80	0.1625000
NODE_4521_length_1137_cov_18.505780	557	637	0	80	80	1.0000000
NODE_4521_length_1137_cov_18.505780	610	690	0	80	80	1.0000000
NODE_4521_length_1137_cov_18.505780	686	766	0	80	80	1.0000000
NODE_4521_length_1137_cov_18.505780	739	819	0	80	80	1.0000000
NODE_4523_length_1137_cov_11.866089	313	393	2	80	80	1.0000000
NODE_4523_length_1137_cov_11.866089	366	446	0	48	80	0.6000000
NODE_4523_length_1137_cov_11.866089	366	446	2	32	80	0.4000000
NODE_4523_length_1137_cov_11.866089	442	522	0	80	80	1.0000000
NODE_4523_length_1137_cov_11.866089	495	575	0	80	80	1.0000000
NODE_4524_length_1137_cov_5.594412	144	224	0	80	80	1.0000000
NODE_4524_length_1137_cov_5.594412	197	277	0	80	80	1.0000000
NODE_4532_length_1136_cov_42.827387	445	525	0	2	80	0.0250000
NODE_4532_length_1136_cov_42.827387	445	525	2	78	80	0.9750000
NODE_4532_length_1136_cov_42.827387	498	578	0	55	80	0.6875000
NODE_4532_length_1136_cov_42.827387	498	578	2	25	80	0.3125000
NODE_4532_length_1136_cov_42.827387	574	654	0	80	80	1.0000000
NODE_4532_length_1136_cov_42.827387	627	707	0	80	80	1.0000000
NODE_4533_length_1136_cov_30.940212	534	614	2	6	80	0.0750000
NODE_4533_length_1136_cov_30.940212	534	614	4	56	80	0.7000000
NODE_4533_length_1136_cov_30.940212	534	614	6	18	80	0.2250000
NODE_4533_length_1136_cov_30.940212	587	667	2	41	80	0.5125000
NODE_4533_length_1136_cov_30.940212	587	667	4	36	80	0.4500000
NODE_4533_length_1136_cov_30.940212	587	667	6	3	80	0.0375000
NODE_4533_length_1136_cov_30.940212	663	743	0	39	80	0.4875000
NODE_4533_length_1136_cov_30.940212	663	743	2	16	80	0.2000000
NODE_4533_length_1136_cov_30.940212	663	743	6	25	80	0.3125000
NODE_4533_length_1136_cov_30.940212	716	796	2	2	80	0.0250000
NODE_4533_length_1136_cov_30.940212	716	796	6	78	80	0.9750000
NODE_4534_length_1136_cov_30.797493	557	637	0	4	80	0.0500000
NODE_4534_length_1136_cov_30.797493	557	637	2	2	80	0.0250000
NODE_4534_length_1136_cov_30.797493	557	637	9	5	80	0.0625000
NODE_4534_length_1136_cov_30.797493	557	637	10	3	80	0.0375000
NODE_4534_length_1136_cov_30.797493	557	637	11	66	80	0.8250000
NODE_4534_length_1136_cov_30.797493	610	691	2	30	81	0.3703704
NODE_4534_length_1136_cov_30.797493	610	691	5	20	81	0.2469136
NODE_4534_length_1136_cov_30.797493	610	691	11	31	81	0.3827161
NODE_4534_length_1136_cov_30.797493	687	767	0	23	80	0.2875000
NODE_4534_length_1136_cov_30.797493	687	767	1	3	80	0.0375000
NODE_4534_length_1136_cov_30.797493	687	767	2	54	80	0.6750000
NODE_4534_length_1136_cov_30.797493	740	820	0	9	80	0.1125000
NODE_4534_length_1136_cov_30.797493	740	820	2	66	80	0.8250000
NODE_4534_length_1136_cov_30.797493	740	820	3	5	80	0.0625000
NODE_4535_length_1136_cov_23.142719	704	784	0	27	80	0.3375000
NODE_4535_length_1136_cov_23.142719	704	784	2	29	80	0.3625000
NODE_4535_length_1136_cov_23.142719	704	784	4	24	80	0.3000000
NODE_4535_length_1136_cov_23.142719	757	837	2	50	80	0.6250000
NODE_4535_length_1136_cov_23.142719	757	837	4	30	80	0.3750000
NODE_4536_length_1136_cov_21.798457	570	651	0	81	81	1.0000000
NODE_4536_length_1136_cov_21.798457	624	704	0	80	80	1.0000000
NODE_4537_length_1136_cov_21.109932	460	532	0	72	72	1.0000000
NODE_4537_length_1136_cov_21.109932	505	585	0	80	80	1.0000000
NODE_4538_length_1136_cov_20.528447	19	99	3	1	80	0.0125000
NODE_4538_length_1136_cov_20.528447	19	99	4	3	80	0.0375000
NODE_4538_length_1136_cov_20.528447	19	99	6	3	80	0.0375000
NODE_4538_length_1136_cov_20.528447	19	99	7	1	80	0.0125000
NODE_4538_length_1136_cov_20.528447	19	99	9	14	80	0.1750000
NODE_4538_length_1136_cov_20.528447	19	99	11	17	80	0.2125000
NODE_4538_length_1136_cov_20.528447	19	99	13	5	80	0.0625000
NODE_4538_length_1136_cov_20.528447	19	99	15	3	80	0.0375000
NODE_4538_length_1136_cov_20.528447	19	99	19	15	80	0.1875000
NODE_4538_length_1136_cov_20.528447	19	99	21	18	80	0.2250000
NODE_4538_length_1136_cov_20.528447	19	99	3	1	80	0.0125000
NODE_4538_length_1136_cov_20.528447	19	99	4	3	80	0.0375000
NODE_4538_length_1136_cov_20.528447	19	99	6	3	80	0.0375000
NODE_4538_length_1136_cov_20.528447	19	99	7	1	80	0.0125000
NODE_4538_length_1136_cov_20.528447	19	99	9	14	80	0.1750000
NODE_4538_length_1136_cov_20.528447	19	99	11	17	80	0.2125000
NODE_4538_length_1136_cov_20.528447	19	99	13	5	80	0.0625000
NODE_4538_length_1136_cov_20.528447	19	99	15	3	80	0.0375000
NODE_4538_length_1136_cov_20.528447	19	99	19	15	80	0.1875000
NODE_4538_length_1136_cov_20.528447	19	99	21	18	80	0.2250000
NODE_4538_length_1136_cov_20.528447	28	99	9	13	71	0.1830986
NODE_4538_length_1136_cov_20.528447	28	99	11	17	71	0.2394366
NODE_4538_length_1136_cov_20.528447	28	99	13	5	71	0.0704225
NODE_4538_length_1136_cov_20.528447	28	99	15	3	71	0.0422535
NODE_4538_length_1136_cov_20.528447	28	99	19	15	71	0.2112676
NODE_4538_length_1136_cov_20.528447	28	99	21	18	71	0.2535211
NODE_4538_length_1136_cov_20.528447	877	912	0	35	35	1.0000000
NODE_4538_length_1136_cov_20.528447	879	921	0	42	42	1.0000000
NODE_4539_length_1136_cov_14.921890	657	737	0	40	80	0.5000000
NODE_4539_length_1136_cov_14.921890	657	737	2	40	80	0.5000000
NODE_4539_length_1136_cov_14.921890	710	790	2	80	80	1.0000000
NODE_4556_length_1135_cov_100.121622	454	534	2	15	80	0.1875000
NODE_4556_length_1135_cov_100.121622	454	534	3	3	80	0.0375000
NODE_4556_length_1135_cov_100.121622	454	534	4	52	80	0.6500000
NODE_4556_length_1135_cov_100.121622	454	534	6	10	80	0.1250000
NODE_4556_length_1135_cov_100.121622	507	587	4	19	80	0.2375000
NODE_4556_length_1135_cov_100.121622	507	587	6	61	80	0.7625000
NODE_4556_length_1135_cov_100.121622	583	663	2	1	80	0.0125000
NODE_4556_length_1135_cov_100.121622	583	663	3	2	80	0.0250000
NODE_4556_length_1135_cov_100.121622	583	663	4	2	80	0.0250000
NODE_4556_length_1135_cov_100.121622	583	663	5	1	80	0.0125000
NODE_4556_length_1135_cov_100.121622	583	663	6	74	80	0.9250000
NODE_4556_length_1135_cov_100.121622	636	719	4	48	83	0.5783132
NODE_4556_length_1135_cov_100.121622	636	719	6	35	83	0.4216867
NODE_4557_length_1135_cov_34.523166	313	393	0	45	80	0.5625000
NODE_4557_length_1135_cov_34.523166	313	393	2	35	80	0.4375000
NODE_4557_length_1135_cov_34.523166	366	446	0	5	80	0.0625000
NODE_4557_length_1135_cov_34.523166	366	446	2	75	80	0.9375000
NODE_4558_length_1135_cov_20.735521	484	564	0	63	80	0.7875000
NODE_4558_length_1135_cov_20.735521	484	564	2	17	80	0.2125000
NODE_4558_length_1135_cov_20.735521	537	617	0	80	80	1.0000000
NODE_4558_length_1135_cov_20.735521	613	693	0	50	80	0.6250000
NODE_4558_length_1135_cov_20.735521	613	693	2	30	80	0.3750000
NODE_4558_length_1135_cov_20.735521	666	746	2	80	80	1.0000000
NODE_4559_length_1135_cov_9.644788	620	700	0	80	80	1.0000000
NODE_4559_length_1135_cov_9.644788	673	753	0	50	80	0.6250000
NODE_4559_length_1135_cov_9.644788	673	753	2	30	80	0.3750000
NODE_4562_length_1135_cov_2.990347	349	429	0	68	80	0.8500000
NODE_4562_length_1135_cov_2.990347	349	429	2	12	80	0.1500000
NODE_4562_length_1135_cov_2.990347	402	482	0	15	80	0.1875000
NODE_4562_length_1135_cov_2.990347	402	482	2	24	80	0.3000000
NODE_4562_length_1135_cov_2.990347	402	482	4	17	80	0.2125000
NODE_4562_length_1135_cov_2.990347	402	482	7	1	80	0.0125000
NODE_4562_length_1135_cov_2.990347	402	482	8	5	80	0.0625000
NODE_4562_length_1135_cov_2.990347	402	482	9	18	80	0.2250000
NODE_4571_length_1134_cov_34.784541	478	558	0	9	80	0.1125000
NODE_4571_length_1134_cov_34.784541	478	558	2	71	80	0.8875000
NODE_4571_length_1134_cov_34.784541	531	611	0	19	80	0.2375000
NODE_4571_length_1134_cov_34.784541	531	611	2	61	80	0.7625000
NODE_4571_length_1134_cov_34.784541	607	687	0	1	80	0.0125000
NODE_4571_length_1134_cov_34.784541	607	687	2	77	80	0.9625000
NODE_4571_length_1134_cov_34.784541	607	687	4	2	80	0.0250000
NODE_4571_length_1134_cov_34.784541	660	740	2	25	80	0.3125000
NODE_4571_length_1134_cov_34.784541	660	740	4	42	80	0.5250000
NODE_4571_length_1134_cov_34.784541	660	740	6	13	80	0.1625000
NODE_4572_length_1134_cov_28.524638	511	591	0	41	80	0.5125000
NODE_4572_length_1134_cov_28.524638	511	591	2	16	80	0.2000000
NODE_4572_length_1134_cov_28.524638	511	591	4	23	80	0.2875000
NODE_4572_length_1134_cov_28.524638	564	644	2	4	80	0.0500000
NODE_4572_length_1134_cov_28.524638	564	644	4	71	80	0.8875000
NODE_4572_length_1134_cov_28.524638	564	644	6	5	80	0.0625000
NODE_4572_length_1134_cov_28.524638	640	720	2	66	80	0.8250000
NODE_4572_length_1134_cov_28.524638	640	720	4	9	80	0.1125000
NODE_4572_length_1134_cov_28.524638	640	720	6	5	80	0.0625000
NODE_4572_length_1134_cov_28.524638	693	773	0	15	80	0.1875000
NODE_4572_length_1134_cov_28.524638	693	773	2	65	80	0.8125000
NODE_4576_length_1134_cov_2.619324	606	686	0	80	80	1.0000000
NODE_4576_length_1134_cov_2.619324	659	739	0	80	80	1.0000000
NODE_4584_length_1133_cov_5.563830	292	372	0	80	80	1.0000000
NODE_4584_length_1133_cov_5.563830	345	425	0	80	80	1.0000000
NODE_4584_length_1133_cov_5.563830	904	966	1	6	62	0.0967742
NODE_4584_length_1133_cov_5.563830	904	966	3	12	62	0.1935484
NODE_4584_length_1133_cov_5.563830	904	966	5	3	62	0.0483871
NODE_4584_length_1133_cov_5.563830	904	966	7	41	62	0.6612903
NODE_4592_length_1132_cov_23.121007	485	565	0	80	80	1.0000000
NODE_4592_length_1132_cov_23.121007	538	618	0	80	80	1.0000000
NODE_4592_length_1132_cov_23.121007	618	664	0	46	46	1.0000000
NODE_4592_length_1132_cov_23.121007	700	751	0	51	51	1.0000000
NODE_4593_length_1132_cov_19.377541	595	675	0	59	80	0.7375000
NODE_4593_length_1132_cov_19.377541	595	675	2	21	80	0.2625000
NODE_4593_length_1132_cov_19.377541	648	728	0	32	80	0.4000000
NODE_4593_length_1132_cov_19.377541	648	728	4	48	80	0.6000000
NODE_4594_length_1132_cov_18.872217	363	443	0	13	80	0.1625000
NODE_4594_length_1132_cov_18.872217	363	443	2	60	80	0.7500000
NODE_4594_length_1132_cov_18.872217	363	443	4	7	80	0.0875000
NODE_4594_length_1132_cov_18.872217	416	496	2	20	80	0.2500000
NODE_4594_length_1132_cov_18.872217	416	496	4	51	80	0.6375000
NODE_4594_length_1132_cov_18.872217	416	496	6	9	80	0.1125000
NODE_4595_length_1132_cov_11.242982	474	554	2	17	80	0.2125000
NODE_4595_length_1132_cov_11.242982	474	554	4	63	80	0.7875000
NODE_4595_length_1132_cov_11.242982	527	607	0	48	80	0.6000000
NODE_4595_length_1132_cov_11.242982	527	607	2	18	80	0.2250000
NODE_4595_length_1132_cov_11.242982	527	607	4	14	80	0.1750000
NODE_4596_length_1132_cov_7.356244	354	434	0	80	80	1.0000000
NODE_4596_length_1132_cov_7.356244	407	487	0	80	80	1.0000000
NODE_4597_length_1132_cov_6.214908	269	349	0	80	80	1.0000000
NODE_4597_length_1132_cov_6.214908	322	402	0	80	80	1.0000000
NODE_4606_length_1131_cov_36.161822	478	558	0	80	80	1.0000000
NODE_4606_length_1131_cov_36.161822	531	611	0	80	80	1.0000000
NODE_4606_length_1131_cov_36.161822	607	687	0	24	80	0.3000000
NODE_4606_length_1131_cov_36.161822	607	687	2	12	80	0.1500000
NODE_4606_length_1131_cov_36.161822	607	687	4	3	80	0.0375000
NODE_4606_length_1131_cov_36.161822	607	687	6	1	80	0.0125000
NODE_4606_length_1131_cov_36.161822	607	687	8	40	80	0.5000000
NODE_4606_length_1131_cov_36.161822	660	740	6	2	80	0.0250000
NODE_4606_length_1131_cov_36.161822	660	740	8	78	80	0.9750000
NODE_4607_length_1131_cov_31.907946	390	470	0	80	80	1.0000000
NODE_4607_length_1131_cov_31.907946	443	523	0	80	80	1.0000000
NODE_4607_length_1131_cov_31.907946	519	599	0	49	80	0.6125000
NODE_4607_length_1131_cov_31.907946	519	599	2	31	80	0.3875000
NODE_4607_length_1131_cov_31.907946	572	652	0	7	80	0.0875000
NODE_4607_length_1131_cov_31.907946	572	652	2	73	80	0.9125000
NODE_4608_length_1131_cov_26.827519	464	544	4	25	80	0.3125000
NODE_4608_length_1131_cov_26.827519	464	544	8	2	80	0.0250000
NODE_4608_length_1131_cov_26.827519	464	544	12	53	80	0.6625000
NODE_4608_length_1131_cov_26.827519	517	597	3	6	80	0.0750000
NODE_4608_length_1131_cov_26.827519	517	597	7	7	80	0.0875000
NODE_4608_length_1131_cov_26.827519	517	597	11	15	80	0.1875000
NODE_4608_length_1131_cov_26.827519	517	597	12	52	80	0.6500000
NODE_4609_length_1131_cov_20.441860	555	635	0	7	80	0.0875000
NODE_4609_length_1131_cov_20.441860	555	635	4	73	80	0.9125000
NODE_4609_length_1131_cov_20.441860	608	688	0	60	80	0.7500000
NODE_4609_length_1131_cov_20.441860	608	688	4	20	80	0.2500000
NODE_4610_length_1131_cov_12.517442	420	500	0	20	80	0.2500000
NODE_4610_length_1131_cov_12.517442	420	500	4	60	80	0.7500000
NODE_4610_length_1131_cov_12.517442	473	553	4	80	80	1.0000000
NODE_4611_length_1131_cov_10.912791	429	509	0	80	80	1.0000000
NODE_4611_length_1131_cov_10.912791	482	562	0	80	80	1.0000000
NODE_4620_length_1130_cov_43.354995	742	822	0	59	80	0.7375000
NODE_4620_length_1130_cov_43.354995	742	822	2	21	80	0.2625000
NODE_4620_length_1130_cov_43.354995	795	875	0	80	80	1.0000000
NODE_4621_length_1130_cov_13.097963	642	722	0	73	80	0.9125000
NODE_4621_length_1130_cov_13.097963	642	722	4	7	80	0.0875000
NODE_4621_length_1130_cov_13.097963	695	775	0	20	80	0.2500000
NODE_4621_length_1130_cov_13.097963	695	775	2	1	80	0.0125000
NODE_4621_length_1130_cov_13.097963	695	775	4	59	80	0.7375000
NODE_4626_length_1129_cov_31.088350	396	476	2	30	80	0.3750000
NODE_4626_length_1129_cov_31.088350	396	476	4	43	80	0.5375000
NODE_4626_length_1129_cov_31.088350	396	476	5	2	80	0.0250000
NODE_4626_length_1129_cov_31.088350	396	476	6	5	80	0.0625000
NODE_4626_length_1129_cov_31.088350	449	529	4	80	80	1.0000000
NODE_4627_length_1129_cov_20.591262	450	530	0	24	80	0.3000000
NODE_4627_length_1129_cov_20.591262	450	530	2	56	80	0.7000000
NODE_4627_length_1129_cov_20.591262	503	583	2	80	80	1.0000000
NODE_4628_length_1129_cov_16.934951	261	341	0	80	80	1.0000000
NODE_4628_length_1129_cov_16.934951	314	394	0	80	80	1.0000000
NODE_4629_length_1129_cov_9.441748	665	738	0	73	73	1.0000000
NODE_4629_length_1129_cov_9.441748	711	791	0	80	80	1.0000000
NODE_4630_length_1129_cov_9.260194	658	738	1	63	80	0.7875000
NODE_4630_length_1129_cov_9.260194	658	738	2	17	80	0.2125000
NODE_4630_length_1129_cov_9.260194	711	791	0	15	80	0.1875000
NODE_4630_length_1129_cov_9.260194	711	791	1	65	80	0.8125000
NODE_4631_length_1129_cov_5.055340	759	839	0	21	80	0.2625000
NODE_4631_length_1129_cov_5.055340	759	839	2	59	80	0.7375000
NODE_4638_length_1128_cov_48.099125	588	668	0	1	80	0.0125000
NODE_4638_length_1128_cov_48.099125	588	668	2	6	80	0.0750000
NODE_4638_length_1128_cov_48.099125	588	668	4	5	80	0.0625000
NODE_4638_length_1128_cov_48.099125	588	668	6	8	80	0.1000000
NODE_4638_length_1128_cov_48.099125	588	668	8	60	80	0.7500000
NODE_4638_length_1128_cov_48.099125	641	721	0	54	80	0.6750000
NODE_4638_length_1128_cov_48.099125	641	721	2	6	80	0.0750000
NODE_4638_length_1128_cov_48.099125	641	721	4	5	80	0.0625000
NODE_4638_length_1128_cov_48.099125	641	721	6	8	80	0.1000000
NODE_4638_length_1128_cov_48.099125	641	721	8	7	80	0.0875000
NODE_4640_length_1128_cov_26.230321	455	535	8	80	80	1.0000000
NODE_4640_length_1128_cov_26.230321	508	588	0	15	80	0.1875000
NODE_4640_length_1128_cov_26.230321	508	588	2	12	80	0.1500000
NODE_4640_length_1128_cov_26.230321	508	588	6	23	80	0.2875000
NODE_4640_length_1128_cov_26.230321	508	588	8	30	80	0.3750000
NODE_4640_length_1128_cov_26.230321	584	664	2	9	80	0.1125000
NODE_4640_length_1128_cov_26.230321	584	664	3	1	80	0.0125000
NODE_4640_length_1128_cov_26.230321	584	664	4	12	80	0.1500000
NODE_4640_length_1128_cov_26.230321	584	664	10	10	80	0.1250000
NODE_4640_length_1128_cov_26.230321	584	664	14	48	80	0.6000000
NODE_4640_length_1128_cov_26.230321	637	718	10	4	81	0.0493827
NODE_4640_length_1128_cov_26.230321	637	718	12	39	81	0.4814815
NODE_4640_length_1128_cov_26.230321	637	718	14	38	81	0.4691358
NODE_4641_length_1128_cov_26.031098	594	674	2	49	80	0.6125000
NODE_4641_length_1128_cov_26.031098	594	674	4	17	80	0.2125000
NODE_4641_length_1128_cov_26.031098	594	674	6	14	80	0.1750000
NODE_4641_length_1128_cov_26.031098	647	727	4	69	80	0.8625000
NODE_4641_length_1128_cov_26.031098	647	727	6	11	80	0.1375000
NODE_4642_length_1128_cov_25.869776	465	538	0	60	73	0.8219178
NODE_4642_length_1128_cov_25.869776	465	538	2	13	73	0.1780822
NODE_4642_length_1128_cov_25.869776	601	674	0	73	73	1.0000000
NODE_4642_length_1128_cov_25.869776	647	723	0	76	76	1.0000000
NODE_4643_length_1128_cov_24.185617	350	430	0	80	80	1.0000000
NODE_4643_length_1128_cov_24.185617	403	483	0	80	80	1.0000000
NODE_4644_length_1128_cov_18.537415	335	415	0	80	80	1.0000000
NODE_4644_length_1128_cov_18.537415	388	468	0	80	80	1.0000000
NODE_4645_length_1128_cov_9.345967	690	770	0	80	80	1.0000000
NODE_4645_length_1128_cov_9.345967	743	823	0	80	80	1.0000000
NODE_4647_length_1128_cov_3.920311	675	725	0	50	50	1.0000000
NODE_4647_length_1128_cov_3.920311	698	778	0	80	80	1.0000000
NODE_4648_length_1128_cov_3.631681	613	693	0	80	80	1.0000000
NODE_4648_length_1128_cov_3.631681	666	746	0	80	80	1.0000000
NODE_4650_length_1128_cov_3.091351	519	599	0	80	80	1.0000000
NODE_4650_length_1128_cov_3.091351	572	652	0	80	80	1.0000000
NODE_4660_length_1127_cov_38.932879	405	485	0	45	80	0.5625000
NODE_4660_length_1127_cov_38.932879	405	485	2	35	80	0.4375000
NODE_4660_length_1127_cov_38.932879	458	538	0	57	80	0.7125000
NODE_4660_length_1127_cov_38.932879	458	538	2	23	80	0.2875000
NODE_4660_length_1127_cov_38.932879	534	614	2	63	80	0.7875000
NODE_4660_length_1127_cov_38.932879	534	614	4	17	80	0.2125000
NODE_4660_length_1127_cov_38.932879	587	667	0	24	80	0.3000000
NODE_4660_length_1127_cov_38.932879	587	667	2	56	80	0.7000000
NODE_4661_length_1127_cov_37.721790	236	316	3	9	80	0.1125000
NODE_4661_length_1127_cov_37.721790	236	316	4	33	80	0.4125000
NODE_4661_length_1127_cov_37.721790	236	316	5	38	80	0.4750000
NODE_4661_length_1127_cov_37.721790	289	369	1	39	80	0.4875000
NODE_4661_length_1127_cov_37.721790	289	369	3	11	80	0.1375000
NODE_4661_length_1127_cov_37.721790	289	369	5	30	80	0.3750000
NODE_4661_length_1127_cov_37.721790	365	445	5	14	80	0.1750000
NODE_4661_length_1127_cov_37.721790	365	445	6	30	80	0.3750000
NODE_4661_length_1127_cov_37.721790	365	445	7	26	80	0.3250000
NODE_4661_length_1127_cov_37.721790	365	445	8	10	80	0.1250000
NODE_4661_length_1127_cov_37.721790	418	498	3	4	80	0.0500000
NODE_4661_length_1127_cov_37.721790	418	498	7	75	80	0.9375000
NODE_4661_length_1127_cov_37.721790	418	498	8	1	80	0.0125000
NODE_4662_length_1127_cov_31.866732	444	523	3	13	79	0.1645570
NODE_4662_length_1127_cov_31.866732	444	523	4	34	79	0.4303797
NODE_4662_length_1127_cov_31.866732	444	523	5	17	79	0.2151899
NODE_4662_length_1127_cov_31.866732	444	523	6	15	79	0.1898734
NODE_4662_length_1127_cov_31.866732	496	576	3	13	80	0.1625000
NODE_4662_length_1127_cov_31.866732	496	576	5	67	80	0.8375000
NODE_4662_length_1127_cov_31.866732	572	652	0	44	80	0.5500000
NODE_4662_length_1127_cov_31.866732	572	652	2	10	80	0.1250000
NODE_4662_length_1127_cov_31.866732	572	652	4	7	80	0.0875000
NODE_4662_length_1127_cov_31.866732	572	652	5	19	80	0.2375000
NODE_4662_length_1127_cov_31.866732	625	705	0	80	80	1.0000000
NODE_4663_length_1127_cov_25.616732	430	510	0	80	80	1.0000000
NODE_4663_length_1127_cov_25.616732	483	563	0	80	80	1.0000000
NODE_4664_length_1127_cov_21.838521	338	418	2	7	80	0.0875000
NODE_4664_length_1127_cov_21.838521	338	418	4	73	80	0.9125000
NODE_4664_length_1127_cov_21.838521	391	471	0	40	80	0.5000000
NODE_4664_length_1127_cov_21.838521	391	471	2	16	80	0.2000000
NODE_4664_length_1127_cov_21.838521	391	471	4	24	80	0.3000000
NODE_4664_length_1127_cov_21.838521	467	547	0	9	80	0.1125000
NODE_4664_length_1127_cov_21.838521	467	547	2	3	80	0.0375000
NODE_4664_length_1127_cov_21.838521	467	547	4	29	80	0.3625000
NODE_4664_length_1127_cov_21.838521	467	547	6	5	80	0.0625000
NODE_4664_length_1127_cov_21.838521	467	547	10	4	80	0.0500000
NODE_4664_length_1127_cov_21.838521	467	547	12	19	80	0.2375000
NODE_4664_length_1127_cov_21.838521	467	547	14	11	80	0.1375000
NODE_4664_length_1127_cov_21.838521	520	600	12	16	80	0.2000000
NODE_4664_length_1127_cov_21.838521	520	600	14	22	80	0.2750000
NODE_4664_length_1127_cov_21.838521	520	600	18	8	80	0.1000000
NODE_4664_length_1127_cov_21.838521	520	600	19	2	80	0.0250000
NODE_4664_length_1127_cov_21.838521	520	600	20	32	80	0.4000000
NODE_4665_length_1127_cov_15.024319	711	800	4	31	89	0.3483146
NODE_4665_length_1127_cov_15.024319	711	800	6	19	89	0.2134831
NODE_4665_length_1127_cov_15.024319	711	800	10	17	89	0.1910112
NODE_4665_length_1127_cov_15.024319	711	800	12	17	89	0.1910112
NODE_4665_length_1127_cov_15.024319	711	800	14	5	89	0.0561798
NODE_4665_length_1127_cov_15.024319	773	853	10	70	80	0.8750000
NODE_4665_length_1127_cov_15.024319	773	853	12	5	80	0.0625000
NODE_4665_length_1127_cov_15.024319	773	853	14	5	80	0.0625000
NODE_4667_length_1127_cov_4.786965	386	466	0	38	80	0.4750000
NODE_4667_length_1127_cov_4.786965	386	466	1	18	80	0.2250000
NODE_4667_length_1127_cov_4.786965	386	466	2	24	80	0.3000000
NODE_4667_length_1127_cov_4.786965	439	519	0	80	80	1.0000000
NODE_4672_length_1126_cov_51.699124	448	528	0	80	80	1.0000000
NODE_4672_length_1126_cov_51.699124	501	581	0	27	80	0.3375000
NODE_4672_length_1126_cov_51.699124	501	581	2	3	80	0.0375000
NODE_4672_length_1126_cov_51.699124	501	581	4	1	80	0.0125000
NODE_4672_length_1126_cov_51.699124	501	581	8	49	80	0.6125000
NODE_4673_length_1126_cov_38.135346	427	507	0	80	80	1.0000000
NODE_4673_length_1126_cov_38.135346	480	560	0	80	80	1.0000000
NODE_4673_length_1126_cov_38.135346	556	638	0	44	82	0.5365854
NODE_4673_length_1126_cov_38.135346	556	638	4	10	82	0.1219512
NODE_4673_length_1126_cov_38.135346	556	638	6	28	82	0.3414634
NODE_4673_length_1126_cov_38.135346	611	691	2	2	80	0.0250000
NODE_4673_length_1126_cov_38.135346	611	691	6	78	80	0.9750000
NODE_4674_length_1126_cov_34.637780	23	97	2	4	74	0.0540541
NODE_4674_length_1126_cov_34.637780	23	97	8	5	74	0.0675676
NODE_4674_length_1126_cov_34.637780	23	97	10	5	74	0.0675676
NODE_4674_length_1126_cov_34.637780	23	97	16	2	74	0.0270270
NODE_4674_length_1126_cov_34.637780	23	97	18	1	74	0.0135135
NODE_4674_length_1126_cov_34.637780	23	97	20	7	74	0.0945946
NODE_4674_length_1126_cov_34.637780	23	97	22	50	74	0.6756757
NODE_4674_length_1126_cov_34.637780	146	226	28	5	80	0.0625000
NODE_4674_length_1126_cov_34.637780	146	226	30	1	80	0.0125000
NODE_4674_length_1126_cov_34.637780	146	226	31	3	80	0.0375000
NODE_4674_length_1126_cov_34.637780	146	226	32	10	80	0.1250000
NODE_4674_length_1126_cov_34.637780	146	226	33	1	80	0.0125000
NODE_4674_length_1126_cov_34.637780	146	226	34	9	80	0.1125000
NODE_4674_length_1126_cov_34.637780	146	226	35	9	80	0.1125000
NODE_4674_length_1126_cov_34.637780	146	226	36	10	80	0.1250000
NODE_4674_length_1126_cov_34.637780	146	226	37	3	80	0.0375000
NODE_4674_length_1126_cov_34.637780	146	226	38	2	80	0.0250000
NODE_4674_length_1126_cov_34.637780	146	226	39	3	80	0.0375000
NODE_4674_length_1126_cov_34.637780	146	226	40	2	80	0.0250000
NODE_4674_length_1126_cov_34.637780	146	226	41	10	80	0.1250000
NODE_4674_length_1126_cov_34.637780	146	226	42	2	80	0.0250000
NODE_4674_length_1126_cov_34.637780	146	226	43	9	80	0.1125000
NODE_4674_length_1126_cov_34.637780	146	226	44	1	80	0.0125000
NODE_4674_length_1126_cov_34.637780	146	226	28	5	80	0.0625000
NODE_4674_length_1126_cov_34.637780	146	226	30	1	80	0.0125000
NODE_4674_length_1126_cov_34.637780	146	226	31	3	80	0.0375000
NODE_4674_length_1126_cov_34.637780	146	226	32	10	80	0.1250000
NODE_4674_length_1126_cov_34.637780	146	226	33	1	80	0.0125000
NODE_4674_length_1126_cov_34.637780	146	226	34	9	80	0.1125000
NODE_4674_length_1126_cov_34.637780	146	226	35	9	80	0.1125000
NODE_4674_length_1126_cov_34.637780	146	226	36	10	80	0.1250000
NODE_4674_length_1126_cov_34.637780	146	226	37	3	80	0.0375000
NODE_4674_length_1126_cov_34.637780	146	226	38	2	80	0.0250000
NODE_4674_length_1126_cov_34.637780	146	226	39	3	80	0.0375000
NODE_4674_length_1126_cov_34.637780	146	226	40	2	80	0.0250000
NODE_4674_length_1126_cov_34.637780	146	226	41	10	80	0.1250000
NODE_4674_length_1126_cov_34.637780	146	226	42	2	80	0.0250000
NODE_4674_length_1126_cov_34.637780	146	226	43	9	80	0.1125000
NODE_4674_length_1126_cov_34.637780	146	226	44	1	80	0.0125000
NODE_4674_length_1126_cov_34.637780	146	208	28	5	62	0.0806452
NODE_4674_length_1126_cov_34.637780	146	208	30	1	62	0.0161290
NODE_4674_length_1126_cov_34.637780	146	208	31	3	62	0.0483871
NODE_4674_length_1126_cov_34.637780	146	208	33	1	62	0.0161290
NODE_4674_length_1126_cov_34.637780	146	208	34	1	62	0.0161290
NODE_4674_length_1126_cov_34.637780	146	208	35	9	62	0.1451613
NODE_4674_length_1126_cov_34.637780	146	208	36	10	62	0.1612903
NODE_4674_length_1126_cov_34.637780	146	208	37	3	62	0.0483871
NODE_4674_length_1126_cov_34.637780	146	208	38	2	62	0.0322581
NODE_4674_length_1126_cov_34.637780	146	208	39	3	62	0.0483871
NODE_4674_length_1126_cov_34.637780	146	208	40	2	62	0.0322581
NODE_4674_length_1126_cov_34.637780	146	208	41	10	62	0.1612903
NODE_4674_length_1126_cov_34.637780	146	208	42	2	62	0.0322581
NODE_4674_length_1126_cov_34.637780	146	208	43	9	62	0.1451613
NODE_4674_length_1126_cov_34.637780	146	208	44	1	62	0.0161290
NODE_4674_length_1126_cov_34.637780	146	217	28	5	71	0.0704225
NODE_4674_length_1126_cov_34.637780	146	217	30	1	71	0.0140845
NODE_4674_length_1126_cov_34.637780	146	217	31	3	71	0.0422535
NODE_4674_length_1126_cov_34.637780	146	217	32	1	71	0.0140845
NODE_4674_length_1126_cov_34.637780	146	217	33	1	71	0.0140845
NODE_4674_length_1126_cov_34.637780	146	217	34	9	71	0.1267606
NODE_4674_length_1126_cov_34.637780	146	217	35	9	71	0.1267606
NODE_4674_length_1126_cov_34.637780	146	217	36	10	71	0.1408451
NODE_4674_length_1126_cov_34.637780	146	217	37	3	71	0.0422535
NODE_4674_length_1126_cov_34.637780	146	217	38	2	71	0.0281690
NODE_4674_length_1126_cov_34.637780	146	217	39	3	71	0.0422535
NODE_4674_length_1126_cov_34.637780	146	217	40	2	71	0.0281690
NODE_4674_length_1126_cov_34.637780	146	217	41	10	71	0.1408451
NODE_4674_length_1126_cov_34.637780	146	217	42	2	71	0.0281690
NODE_4674_length_1126_cov_34.637780	146	217	43	9	71	0.1267606
NODE_4674_length_1126_cov_34.637780	146	217	44	1	71	0.0140845
NODE_4675_length_1126_cov_21.360273	595	675	0	3	80	0.0375000
NODE_4675_length_1126_cov_21.360273	595	675	2	77	80	0.9625000
NODE_4675_length_1126_cov_21.360273	648	728	0	56	80	0.7000000
NODE_4675_length_1126_cov_21.360273	648	728	2	24	80	0.3000000
NODE_4676_length_1126_cov_17.420643	422	502	2	56	80	0.7000000
NODE_4676_length_1126_cov_17.420643	422	502	4	24	80	0.3000000
NODE_4676_length_1126_cov_17.420643	475	555	0	37	80	0.4625000
NODE_4676_length_1126_cov_17.420643	475	555	2	43	80	0.5375000
NODE_4677_length_1126_cov_15.896787	383	463	0	80	80	1.0000000
NODE_4677_length_1126_cov_15.896787	436	516	0	80	80	1.0000000
NODE_4678_length_1126_cov_8.525803	174	254	0	80	80	1.0000000
NODE_4678_length_1126_cov_8.525803	227	307	0	80	80	1.0000000
NODE_4679_length_1126_cov_5.805258	463	543	0	80	80	1.0000000
NODE_4679_length_1126_cov_5.805258	516	596	0	80	80	1.0000000
NODE_4685_length_1126_cov_1.502434	6	86	0	80	80	1.0000000
NODE_4685_length_1126_cov_1.502434	59	108	0	49	49	1.0000000
NODE_4689_length_1125_cov_34.314815	405	485	4	20	80	0.2500000
NODE_4689_length_1125_cov_34.314815	405	485	6	1	80	0.0125000
NODE_4689_length_1125_cov_34.314815	405	485	8	59	80	0.7375000
NODE_4689_length_1125_cov_34.314815	458	538	0	18	80	0.2250000
NODE_4689_length_1125_cov_34.314815	458	538	4	2	80	0.0250000
NODE_4689_length_1125_cov_34.314815	458	538	6	34	80	0.4250000
NODE_4689_length_1125_cov_34.314815	458	538	8	26	80	0.3250000
NODE_4689_length_1125_cov_34.314815	534	614	0	80	80	1.0000000
NODE_4689_length_1125_cov_34.314815	587	667	0	80	80	1.0000000
NODE_4690_length_1125_cov_33.553606	458	538	0	80	80	1.0000000
NODE_4690_length_1125_cov_33.553606	511	591	0	80	80	1.0000000
NODE_4690_length_1125_cov_33.553606	587	667	0	6	80	0.0750000
NODE_4690_length_1125_cov_33.553606	587	667	2	74	80	0.9250000
NODE_4690_length_1125_cov_33.553606	640	720	0	50	80	0.6250000
NODE_4690_length_1125_cov_33.553606	640	720	2	30	80	0.3750000
NODE_4691_length_1125_cov_33.371345	408	488	0	69	80	0.8625000
NODE_4691_length_1125_cov_33.371345	408	488	2	11	80	0.1375000
NODE_4691_length_1125_cov_33.371345	461	541	0	24	80	0.3000000
NODE_4691_length_1125_cov_33.371345	461	541	2	56	80	0.7000000
NODE_4691_length_1125_cov_33.371345	537	617	0	48	80	0.6000000
NODE_4691_length_1125_cov_33.371345	537	617	2	10	80	0.1250000
NODE_4691_length_1125_cov_33.371345	537	617	3	3	80	0.0375000
NODE_4691_length_1125_cov_33.371345	537	617	4	19	80	0.2375000
NODE_4691_length_1125_cov_33.371345	590	670	2	13	80	0.1625000
NODE_4691_length_1125_cov_33.371345	590	670	3	3	80	0.0375000
NODE_4691_length_1125_cov_33.371345	590	670	4	64	80	0.8000000
NODE_4692_length_1125_cov_22.580897	279	359	0	80	80	1.0000000
NODE_4692_length_1125_cov_22.580897	332	412	0	80	80	1.0000000
NODE_4692_length_1125_cov_22.580897	408	488	0	80	80	1.0000000
NODE_4692_length_1125_cov_22.580897	461	541	0	80	80	1.0000000
NODE_4705_length_1124_cov_52.278049	616	696	2	11	80	0.1375000
NODE_4705_length_1124_cov_52.278049	616	696	4	10	80	0.1250000
NODE_4705_length_1124_cov_52.278049	616	696	7	1	80	0.0125000
NODE_4705_length_1124_cov_52.278049	616	696	8	58	80	0.7250000
NODE_4705_length_1124_cov_52.278049	669	749	0	10	80	0.1250000
NODE_4705_length_1124_cov_52.278049	669	749	2	54	80	0.6750000
NODE_4705_length_1124_cov_52.278049	669	749	4	4	80	0.0500000
NODE_4705_length_1124_cov_52.278049	669	749	7	1	80	0.0125000
NODE_4705_length_1124_cov_52.278049	669	749	8	11	80	0.1375000
NODE_4706_length_1124_cov_25.280000	444	524	0	80	80	1.0000000
NODE_4706_length_1124_cov_25.280000	497	577	0	80	80	1.0000000
NODE_4706_length_1124_cov_25.280000	573	653	0	27	80	0.3375000
NODE_4706_length_1124_cov_25.280000	573	653	2	53	80	0.6625000
NODE_4706_length_1124_cov_25.280000	626	706	0	21	80	0.2625000
NODE_4706_length_1124_cov_25.280000	626	706	2	59	80	0.7375000
NODE_4707_length_1124_cov_18.700488	114	194	0	7	80	0.0875000
NODE_4707_length_1124_cov_18.700488	114	194	2	73	80	0.9125000
NODE_4707_length_1124_cov_18.700488	167	247	0	42	80	0.5250000
NODE_4707_length_1124_cov_18.700488	167	247	2	38	80	0.4750000
NODE_4717_length_1123_cov_26.445312	388	468	0	17	80	0.2125000
NODE_4717_length_1123_cov_26.445312	388	468	2	9	80	0.1125000
NODE_4717_length_1123_cov_26.445312	388	468	4	4	80	0.0500000
NODE_4717_length_1123_cov_26.445312	388	468	6	50	80	0.6250000
NODE_4717_length_1123_cov_26.445312	441	521	0	70	80	0.8750000
NODE_4717_length_1123_cov_26.445312	441	521	2	9	80	0.1125000
NODE_4717_length_1123_cov_26.445312	441	521	4	1	80	0.0125000
NODE_4717_length_1123_cov_26.445312	517	597	0	80	80	1.0000000
NODE_4717_length_1123_cov_26.445312	570	650	0	80	80	1.0000000
NODE_4718_length_1123_cov_18.677734	522	602	2	80	80	1.0000000
NODE_4718_length_1123_cov_18.677734	575	655	0	49	80	0.6125000
NODE_4718_length_1123_cov_18.677734	575	655	1	1	80	0.0125000
NODE_4718_length_1123_cov_18.677734	575	655	2	30	80	0.3750000
NODE_4718_length_1123_cov_18.677734	651	731	0	33	80	0.4125000
NODE_4718_length_1123_cov_18.677734	651	731	2	47	80	0.5875000
NODE_4718_length_1123_cov_18.677734	704	784	0	28	80	0.3500000
NODE_4718_length_1123_cov_18.677734	704	784	2	52	80	0.6500000
NODE_4728_length_1122_cov_38.688172	295	375	0	57	80	0.7125000
NODE_4728_length_1122_cov_38.688172	295	375	2	23	80	0.2875000
NODE_4728_length_1122_cov_38.688172	348	428	0	15	80	0.1875000
NODE_4728_length_1122_cov_38.688172	348	428	2	65	80	0.8125000
NODE_4728_length_1122_cov_38.688172	424	504	0	80	80	1.0000000
NODE_4728_length_1122_cov_38.688172	477	557	0	80	80	1.0000000
NODE_4729_length_1122_cov_32.827957	232	312	0	80	80	1.0000000
NODE_4729_length_1122_cov_32.827957	285	365	0	68	80	0.8500000
NODE_4729_length_1122_cov_32.827957	285	365	3	1	80	0.0125000
NODE_4729_length_1122_cov_32.827957	285	365	4	11	80	0.1375000
NODE_4729_length_1122_cov_32.827957	361	441	4	10	80	0.1250000
NODE_4729_length_1122_cov_32.827957	361	441	6	19	80	0.2375000
NODE_4729_length_1122_cov_32.827957	361	441	8	51	80	0.6375000
NODE_4729_length_1122_cov_32.827957	414	494	0	5	80	0.0625000
NODE_4729_length_1122_cov_32.827957	414	494	2	34	80	0.4250000
NODE_4729_length_1122_cov_32.827957	414	494	4	1	80	0.0125000
NODE_4729_length_1122_cov_32.827957	414	494	8	40	80	0.5000000
NODE_4730_length_1122_cov_12.574780	396	476	0	28	80	0.3500000
NODE_4730_length_1122_cov_12.574780	396	476	2	52	80	0.6500000
NODE_4730_length_1122_cov_12.574780	449	529	0	80	80	1.0000000
NODE_4730_length_1122_cov_12.574780	525	605	0	80	80	1.0000000
NODE_4730_length_1122_cov_12.574780	578	658	0	80	80	1.0000000
NODE_4731_length_1122_cov_8.582600	586	666	0	14	80	0.1750000
NODE_4731_length_1122_cov_8.582600	586	666	2	66	80	0.8250000
NODE_4731_length_1122_cov_8.582600	639	719	0	37	80	0.4625000
NODE_4731_length_1122_cov_8.582600	639	719	2	43	80	0.5375000
NODE_4733_length_1122_cov_3.714565	284	364	0	80	80	1.0000000
NODE_4733_length_1122_cov_3.714565	337	417	0	80	80	1.0000000
NODE_4738_length_1122_cov_1.757576	25	87	0	62	62	1.0000000
NODE_4742_length_1121_cov_39.595890	507	587	0	9	80	0.1125000
NODE_4742_length_1121_cov_39.595890	507	587	2	10	80	0.1250000
NODE_4742_length_1121_cov_39.595890	507	587	3	10	80	0.1250000
NODE_4742_length_1121_cov_39.595890	507	587	4	47	80	0.5875000
NODE_4742_length_1121_cov_39.595890	507	587	5	4	80	0.0500000
NODE_4742_length_1121_cov_39.595890	560	640	0	62	80	0.7750000
NODE_4742_length_1121_cov_39.595890	560	640	2	10	80	0.1250000
NODE_4742_length_1121_cov_39.595890	560	640	4	8	80	0.1000000
NODE_4742_length_1121_cov_39.595890	636	716	0	58	80	0.7250000
NODE_4742_length_1121_cov_39.595890	636	716	1	22	80	0.2750000
NODE_4742_length_1121_cov_39.595890	689	769	0	5	80	0.0625000
NODE_4742_length_1121_cov_39.595890	689	769	1	75	80	0.9375000
NODE_4743_length_1121_cov_23.832681	525	605	0	20	80	0.2500000
NODE_4743_length_1121_cov_23.832681	525	605	2	32	80	0.4000000
NODE_4743_length_1121_cov_23.832681	525	605	4	3	80	0.0375000
NODE_4743_length_1121_cov_23.832681	525	605	6	14	80	0.1750000
NODE_4743_length_1121_cov_23.832681	525	605	8	11	80	0.1375000
NODE_4743_length_1121_cov_23.832681	578	658	2	4	80	0.0500000
NODE_4743_length_1121_cov_23.832681	578	658	4	7	80	0.0875000
NODE_4743_length_1121_cov_23.832681	578	658	6	48	80	0.6000000
NODE_4743_length_1121_cov_23.832681	578	658	8	21	80	0.2625000
NODE_4744_length_1121_cov_18.033268	1	42	0	41	41	1.0000000
NODE_4744_length_1121_cov_18.033268	671	751	0	13	80	0.1625000
NODE_4744_length_1121_cov_18.033268	671	751	2	67	80	0.8375000
NODE_4744_length_1121_cov_18.033268	724	804	0	66	80	0.8250000
NODE_4744_length_1121_cov_18.033268	724	804	2	14	80	0.1750000
NODE_4745_length_1121_cov_8.633072	610	690	0	4	80	0.0500000
NODE_4745_length_1121_cov_8.633072	610	690	1	7	80	0.0875000
NODE_4745_length_1121_cov_8.633072	610	690	2	69	80	0.8625000
NODE_4745_length_1121_cov_8.633072	663	743	0	57	80	0.7125000
NODE_4745_length_1121_cov_8.633072	663	743	1	7	80	0.0875000
NODE_4745_length_1121_cov_8.633072	663	743	2	16	80	0.2000000
NODE_4751_length_1120_cov_34.281097	377	457	0	80	80	1.0000000
NODE_4751_length_1120_cov_34.281097	430	510	0	80	80	1.0000000
NODE_4751_length_1120_cov_34.281097	506	586	0	80	80	1.0000000
NODE_4751_length_1120_cov_34.281097	559	639	0	78	80	0.9750000
NODE_4751_length_1120_cov_34.281097	559	639	2	2	80	0.0250000
NODE_4752_length_1120_cov_31.468168	401	481	0	80	80	1.0000000
NODE_4752_length_1120_cov_31.468168	454	534	0	80	80	1.0000000
NODE_4752_length_1120_cov_31.468168	530	610	0	80	80	1.0000000
NODE_4752_length_1120_cov_31.468168	583	663	0	80	80	1.0000000
NODE_4753_length_1120_cov_28.182174	418	498	2	80	80	1.0000000
NODE_4753_length_1120_cov_28.182174	471	551	0	18	80	0.2250000
NODE_4753_length_1120_cov_28.182174	471	551	2	62	80	0.7750000
NODE_4754_length_1120_cov_25.423115	405	485	0	80	80	1.0000000
NODE_4754_length_1120_cov_25.423115	458	538	0	80	80	1.0000000
NODE_4754_length_1120_cov_25.423115	534	614	0	25	80	0.3125000
NODE_4754_length_1120_cov_25.423115	534	614	4	14	80	0.1750000
NODE_4754_length_1120_cov_25.423115	534	614	6	31	80	0.3875000
NODE_4754_length_1120_cov_25.423115	534	614	8	10	80	0.1250000
NODE_4754_length_1120_cov_25.423115	587	667	6	38	80	0.4750000
NODE_4754_length_1120_cov_25.423115	587	667	8	42	80	0.5250000
NODE_4755_length_1120_cov_24.441724	589	662	6	12	73	0.1643836
NODE_4755_length_1120_cov_24.441724	589	662	9	36	73	0.4931507
NODE_4755_length_1120_cov_24.441724	589	662	10	25	73	0.3424658
NODE_4755_length_1120_cov_24.441724	636	716	0	33	80	0.4125000
NODE_4755_length_1120_cov_24.441724	636	716	4	1	80	0.0125000
NODE_4755_length_1120_cov_24.441724	636	716	5	10	80	0.1250000
NODE_4755_length_1120_cov_24.441724	636	716	9	36	80	0.4500000
NODE_4756_length_1120_cov_18.966699	406	486	0	68	80	0.8500000
NODE_4756_length_1120_cov_18.966699	406	486	2	12	80	0.1500000
NODE_4756_length_1120_cov_18.966699	459	539	0	43	80	0.5375000
NODE_4756_length_1120_cov_18.966699	459	539	2	37	80	0.4625000
NODE_4757_length_1120_cov_16.136141	508	588	0	80	80	1.0000000
NODE_4757_length_1120_cov_16.136141	561	641	0	80	80	1.0000000
NODE_4758_length_1120_cov_15.492654	460	540	0	80	80	1.0000000
NODE_4758_length_1120_cov_15.492654	460	540	0	80	80	1.0000000
NODE_4758_length_1120_cov_15.492654	513	593	0	80	80	1.0000000
NODE_4759_length_1120_cov_8.696376	646	726	0	80	80	1.0000000
NODE_4759_length_1120_cov_8.696376	699	779	0	80	80	1.0000000
NODE_4760_length_1120_cov_7.916748	304	384	0	28	80	0.3500000
NODE_4760_length_1120_cov_7.916748	304	384	2	52	80	0.6500000
NODE_4760_length_1120_cov_7.916748	357	437	0	37	80	0.4625000
NODE_4760_length_1120_cov_7.916748	357	437	2	43	80	0.5375000
NODE_4772_length_1119_cov_32.617647	425	505	0	43	80	0.5375000
NODE_4772_length_1119_cov_32.617647	425	505	4	37	80	0.4625000
NODE_4772_length_1119_cov_32.617647	478	558	4	80	80	1.0000000
NODE_4773_length_1119_cov_24.944118	455	535	2	51	80	0.6375000
NODE_4773_length_1119_cov_24.944118	455	535	4	29	80	0.3625000
NODE_4773_length_1119_cov_24.944118	508	588	0	45	80	0.5625000
NODE_4773_length_1119_cov_24.944118	508	588	2	35	80	0.4375000
NODE_4774_length_1119_cov_22.214706	614	694	2	9	80	0.1125000
NODE_4774_length_1119_cov_22.214706	614	694	7	1	80	0.0125000
NODE_4774_length_1119_cov_22.214706	614	694	8	17	80	0.2125000
NODE_4774_length_1119_cov_22.214706	614	694	9	1	80	0.0125000
NODE_4774_length_1119_cov_22.214706	614	694	10	9	80	0.1125000
NODE_4774_length_1119_cov_22.214706	614	694	14	11	80	0.1375000
NODE_4774_length_1119_cov_22.214706	614	694	16	9	80	0.1125000
NODE_4774_length_1119_cov_22.214706	614	694	20	23	80	0.2875000
NODE_4774_length_1119_cov_22.214706	667	747	6	4	80	0.0500000
NODE_4774_length_1119_cov_22.214706	667	747	10	13	80	0.1625000
NODE_4774_length_1119_cov_22.214706	667	747	16	6	80	0.0750000
NODE_4774_length_1119_cov_22.214706	667	747	17	1	80	0.0125000
NODE_4774_length_1119_cov_22.214706	667	747	18	12	80	0.1500000
NODE_4774_length_1119_cov_22.214706	667	747	20	44	80	0.5500000
NODE_4775_length_1119_cov_21.115686	431	511	0	80	80	1.0000000
NODE_4775_length_1119_cov_21.115686	484	564	0	80	80	1.0000000
NODE_4777_length_1119_cov_11.895098	565	645	6	33	80	0.4125000
NODE_4777_length_1119_cov_11.895098	565	645	8	17	80	0.2125000
NODE_4777_length_1119_cov_11.895098	565	645	12	30	80	0.3750000
NODE_4777_length_1119_cov_11.895098	618	698	6	28	80	0.3500000
NODE_4777_length_1119_cov_11.895098	618	698	10	17	80	0.2125000
NODE_4777_length_1119_cov_11.895098	618	698	12	35	80	0.4375000
NODE_4782_length_1119_cov_2.783333	37	99	2	5	62	0.0806452
NODE_4782_length_1119_cov_2.783333	37	99	8	20	62	0.3225806
NODE_4782_length_1119_cov_2.783333	37	99	10	8	62	0.1290323
NODE_4782_length_1119_cov_2.783333	37	99	14	29	62	0.4677419
NODE_4789_length_1118_cov_35.214917	555	635	0	80	80	1.0000000
NODE_4789_length_1118_cov_35.214917	608	688	0	80	80	1.0000000
NODE_4789_length_1118_cov_35.214917	684	764	0	37	80	0.4625000
NODE_4789_length_1118_cov_35.214917	684	764	4	2	80	0.0250000
NODE_4789_length_1118_cov_35.214917	684	764	6	41	80	0.5125000
NODE_4789_length_1118_cov_35.214917	737	817	6	58	80	0.7250000
NODE_4789_length_1118_cov_35.214917	737	817	8	22	80	0.2750000
NODE_4790_length_1118_cov_23.114818	602	682	0	80	80	1.0000000
NODE_4790_length_1118_cov_23.114818	655	735	0	80	80	1.0000000
NODE_4790_length_1118_cov_23.114818	731	811	0	16	80	0.2000000
NODE_4790_length_1118_cov_23.114818	731	811	4	14	80	0.1750000
NODE_4790_length_1118_cov_23.114818	731	811	6	39	80	0.4875000
NODE_4790_length_1118_cov_23.114818	731	811	8	1	80	0.0125000
NODE_4790_length_1118_cov_23.114818	731	811	10	10	80	0.1250000
NODE_4790_length_1118_cov_23.114818	784	864	6	56	80	0.7000000
NODE_4790_length_1118_cov_23.114818	784	864	8	1	80	0.0125000
NODE_4790_length_1118_cov_23.114818	784	864	10	23	80	0.2875000
NODE_4791_length_1118_cov_18.293425	388	463	0	75	75	1.0000000
NODE_4791_length_1118_cov_18.293425	436	516	0	66	80	0.8250000
NODE_4791_length_1118_cov_18.293425	436	516	2	14	80	0.1750000
NODE_4791_length_1118_cov_18.293425	512	592	2	28	80	0.3500000
NODE_4791_length_1118_cov_18.293425	512	592	4	52	80	0.6500000
NODE_4791_length_1118_cov_18.293425	565	645	3	15	80	0.1875000
NODE_4791_length_1118_cov_18.293425	565	645	4	61	80	0.7625000
NODE_4791_length_1118_cov_18.293425	565	645	5	2	80	0.0250000
NODE_4791_length_1118_cov_18.293425	565	645	7	2	80	0.0250000
NODE_4792_length_1118_cov_17.228656	480	560	0	80	80	1.0000000
NODE_4792_length_1118_cov_17.228656	533	613	0	80	80	1.0000000
NODE_4794_length_1118_cov_14.299313	468	548	0	80	80	1.0000000
NODE_4794_length_1118_cov_14.299313	521	601	0	80	80	1.0000000
NODE_4795_length_1118_cov_10.203140	306	386	0	41	80	0.5125000
NODE_4795_length_1118_cov_10.203140	306	386	1	1	80	0.0125000
NODE_4795_length_1118_cov_10.203140	306	386	2	21	80	0.2625000
NODE_4795_length_1118_cov_10.203140	306	386	3	17	80	0.2125000
NODE_4795_length_1118_cov_10.203140	359	439	2	10	80	0.1250000
NODE_4795_length_1118_cov_10.203140	359	439	3	24	80	0.3000000
NODE_4795_length_1118_cov_10.203140	359	439	4	46	80	0.5750000
NODE_4795_length_1118_cov_10.203140	435	515	2	17	80	0.2125000
NODE_4795_length_1118_cov_10.203140	435	515	3	1	80	0.0125000
NODE_4795_length_1118_cov_10.203140	435	515	4	62	80	0.7750000
NODE_4795_length_1118_cov_10.203140	488	568	2	17	80	0.2125000
NODE_4795_length_1118_cov_10.203140	488	568	3	1	80	0.0125000
NODE_4795_length_1118_cov_10.203140	488	568	4	34	80	0.4250000
NODE_4795_length_1118_cov_10.203140	488	568	5	24	80	0.3000000
NODE_4795_length_1118_cov_10.203140	488	568	6	4	80	0.0500000
NODE_4796_length_1118_cov_2.885182	471	551	0	80	80	1.0000000
NODE_4796_length_1118_cov_2.885182	524	604	0	80	80	1.0000000
NODE_4805_length_1117_cov_19.425344	541	621	0	14	80	0.1750000
NODE_4805_length_1117_cov_19.425344	541	621	4	7	80	0.0875000
NODE_4805_length_1117_cov_19.425344	541	621	6	59	80	0.7375000
NODE_4805_length_1117_cov_19.425344	594	674	0	3	80	0.0375000
NODE_4805_length_1117_cov_19.425344	594	674	2	22	80	0.2750000
NODE_4805_length_1117_cov_19.425344	594	674	6	55	80	0.6875000
NODE_4806_length_1117_cov_16.386051	385	465	0	80	80	1.0000000
NODE_4806_length_1117_cov_16.386051	438	518	0	80	80	1.0000000
NODE_4807_length_1117_cov_10.353635	294	374	4	30	80	0.3750000
NODE_4807_length_1117_cov_10.353635	294	374	6	5	80	0.0625000
NODE_4807_length_1117_cov_10.353635	294	374	8	45	80	0.5625000
NODE_4807_length_1117_cov_10.353635	347	427	2	14	80	0.1750000
NODE_4807_length_1117_cov_10.353635	347	427	4	6	80	0.0750000
NODE_4807_length_1117_cov_10.353635	347	427	6	10	80	0.1250000
NODE_4807_length_1117_cov_10.353635	347	427	8	50	80	0.6250000
NODE_4808_length_1117_cov_7.492141	417	497	0	80	80	1.0000000
NODE_4808_length_1117_cov_7.492141	470	550	0	80	80	1.0000000
NODE_4812_length_1117_cov_3.225933	666	728	0	62	62	1.0000000
NODE_4819_length_1116_cov_30.106195	457	537	0	58	80	0.7250000
NODE_4819_length_1116_cov_30.106195	457	537	2	22	80	0.2750000
NODE_4819_length_1116_cov_30.106195	510	590	0	80	80	1.0000000
NODE_4820_length_1116_cov_25.518191	831	911	0	57	80	0.7125000
NODE_4820_length_1116_cov_25.518191	831	911	2	23	80	0.2875000
NODE_4820_length_1116_cov_25.518191	884	964	0	80	80	1.0000000
NODE_4821_length_1116_cov_20.629302	500	580	4	15	80	0.1875000
NODE_4821_length_1116_cov_20.629302	500	580	6	61	80	0.7625000
NODE_4821_length_1116_cov_20.629302	500	580	8	4	80	0.0500000
NODE_4821_length_1116_cov_20.629302	553	633	0	27	80	0.3375000
NODE_4821_length_1116_cov_20.629302	553	633	2	20	80	0.2500000
NODE_4821_length_1116_cov_20.629302	553	633	4	21	80	0.2625000
NODE_4821_length_1116_cov_20.629302	553	633	6	12	80	0.1500000
NODE_4822_length_1116_cov_16.723697	345	425	0	80	80	1.0000000
NODE_4822_length_1116_cov_16.723697	398	478	0	80	80	1.0000000
NODE_4823_length_1116_cov_16.046214	735	815	2	78	80	0.9750000
NODE_4823_length_1116_cov_16.046214	735	815	4	2	80	0.0250000
NODE_4823_length_1116_cov_16.046214	788	868	0	12	80	0.1500000
NODE_4823_length_1116_cov_16.046214	788	868	2	68	80	0.8500000
NODE_4828_length_1116_cov_1.379548	800	880	2	56	80	0.7000000
NODE_4828_length_1116_cov_1.379548	800	880	4	24	80	0.3000000
NODE_4828_length_1116_cov_1.379548	853	933	2	68	80	0.8500000
NODE_4828_length_1116_cov_1.379548	853	933	4	12	80	0.1500000
NODE_4832_length_1115_cov_30.584646	549	629	10	39	80	0.4875000
NODE_4832_length_1115_cov_30.584646	549	629	12	28	80	0.3500000
NODE_4832_length_1115_cov_30.584646	549	629	14	13	80	0.1625000
NODE_4832_length_1115_cov_30.584646	602	682	2	4	80	0.0500000
NODE_4832_length_1115_cov_30.584646	602	682	4	18	80	0.2250000
NODE_4832_length_1115_cov_30.584646	602	682	6	8	80	0.1000000
NODE_4832_length_1115_cov_30.584646	602	682	10	2	80	0.0250000
NODE_4832_length_1115_cov_30.584646	602	682	11	1	80	0.0125000
NODE_4832_length_1115_cov_30.584646	602	682	12	30	80	0.3750000
NODE_4832_length_1115_cov_30.584646	602	682	14	17	80	0.2125000
NODE_4833_length_1115_cov_15.871063	454	534	0	68	80	0.8500000
NODE_4833_length_1115_cov_15.871063	454	534	2	12	80	0.1500000
NODE_4833_length_1115_cov_15.871063	507	587	0	38	80	0.4750000
NODE_4833_length_1115_cov_15.871063	507	587	4	42	80	0.5250000
NODE_4833_length_1115_cov_15.871063	583	663	0	2	80	0.0250000
NODE_4833_length_1115_cov_15.871063	583	663	2	8	80	0.1000000
NODE_4833_length_1115_cov_15.871063	583	663	4	70	80	0.8750000
NODE_4833_length_1115_cov_15.871063	636	716	0	55	80	0.6875000
NODE_4833_length_1115_cov_15.871063	636	716	2	8	80	0.1000000
NODE_4833_length_1115_cov_15.871063	636	716	4	17	80	0.2125000
NODE_4840_length_1114_cov_20.633498	1034	1114	0	18	80	0.2250000
NODE_4840_length_1114_cov_20.633498	1034	1114	4	15	80	0.1875000
NODE_4840_length_1114_cov_20.633498	1034	1114	6	2	80	0.0250000
NODE_4840_length_1114_cov_20.633498	1034	1114	8	6	80	0.0750000
NODE_4840_length_1114_cov_20.633498	1034	1114	9	3	80	0.0375000
NODE_4840_length_1114_cov_20.633498	1034	1114	10	36	80	0.4500000
NODE_4840_length_1114_cov_20.633498	1034	1114	0	18	80	0.2250000
NODE_4840_length_1114_cov_20.633498	1034	1114	4	15	80	0.1875000
NODE_4840_length_1114_cov_20.633498	1034	1114	6	2	80	0.0250000
NODE_4840_length_1114_cov_20.633498	1034	1114	8	6	80	0.0750000
NODE_4840_length_1114_cov_20.633498	1034	1114	9	3	80	0.0375000
NODE_4840_length_1114_cov_20.633498	1034	1114	10	36	80	0.4500000
NODE_4840_length_1114_cov_20.633498	1034	1114	0	18	80	0.2250000
NODE_4840_length_1114_cov_20.633498	1034	1114	4	15	80	0.1875000
NODE_4840_length_1114_cov_20.633498	1034	1114	6	2	80	0.0250000
NODE_4840_length_1114_cov_20.633498	1034	1114	8	6	80	0.0750000
NODE_4840_length_1114_cov_20.633498	1034	1114	9	3	80	0.0375000
NODE_4840_length_1114_cov_20.633498	1034	1114	10	36	80	0.4500000
NODE_4840_length_1114_cov_20.633498	1034	1114	0	18	80	0.2250000
NODE_4840_length_1114_cov_20.633498	1034	1114	4	15	80	0.1875000
NODE_4840_length_1114_cov_20.633498	1034	1114	6	2	80	0.0250000
NODE_4840_length_1114_cov_20.633498	1034	1114	8	6	80	0.0750000
NODE_4840_length_1114_cov_20.633498	1034	1114	9	3	80	0.0375000
NODE_4840_length_1114_cov_20.633498	1034	1114	10	36	80	0.4500000
NODE_4840_length_1114_cov_20.633498	1034	1114	0	18	80	0.2250000
NODE_4840_length_1114_cov_20.633498	1034	1114	4	15	80	0.1875000
NODE_4840_length_1114_cov_20.633498	1034	1114	6	2	80	0.0250000
NODE_4840_length_1114_cov_20.633498	1034	1114	8	6	80	0.0750000
NODE_4840_length_1114_cov_20.633498	1034	1114	9	3	80	0.0375000
NODE_4840_length_1114_cov_20.633498	1034	1114	10	36	80	0.4500000
NODE_4840_length_1114_cov_20.633498	1043	1114	0	18	71	0.2535211
NODE_4840_length_1114_cov_20.633498	1043	1114	4	15	71	0.2112676
NODE_4840_length_1114_cov_20.633498	1043	1114	6	2	71	0.0281690
NODE_4840_length_1114_cov_20.633498	1043	1114	8	6	71	0.0845070
NODE_4840_length_1114_cov_20.633498	1043	1114	9	3	71	0.0422535
NODE_4840_length_1114_cov_20.633498	1043	1114	10	27	71	0.3802817
NODE_4841_length_1114_cov_17.383251	516	601	0	85	85	1.0000000
NODE_4841_length_1114_cov_17.383251	574	653	0	79	79	1.0000000
NODE_4841_length_1114_cov_17.383251	649	729	0	80	80	1.0000000
NODE_4841_length_1114_cov_17.383251	702	782	0	80	80	1.0000000
NODE_4842_length_1114_cov_5.562562	563	643	0	4	80	0.0500000
NODE_4842_length_1114_cov_5.562562	563	643	2	76	80	0.9500000
NODE_4842_length_1114_cov_5.562562	616	696	0	47	80	0.5875000
NODE_4842_length_1114_cov_5.562562	616	696	2	33	80	0.4125000
NODE_4847_length_1113_cov_51.988166	343	423	7	4	80	0.0500000
NODE_4847_length_1113_cov_51.988166	343	423	9	5	80	0.0625000
NODE_4847_length_1113_cov_51.988166	343	423	11	7	80	0.0875000
NODE_4847_length_1113_cov_51.988166	343	423	13	1	80	0.0125000
NODE_4847_length_1113_cov_51.988166	343	423	15	10	80	0.1250000
NODE_4847_length_1113_cov_51.988166	343	423	16	53	80	0.6625000
NODE_4847_length_1113_cov_51.988166	396	476	0	20	80	0.2500000
NODE_4847_length_1113_cov_51.988166	396	476	4	9	80	0.1125000
NODE_4847_length_1113_cov_51.988166	396	476	6	18	80	0.2250000
NODE_4847_length_1113_cov_51.988166	396	476	8	5	80	0.0625000
NODE_4847_length_1113_cov_51.988166	396	476	11	4	80	0.0500000
NODE_4847_length_1113_cov_51.988166	396	476	13	1	80	0.0125000
NODE_4847_length_1113_cov_51.988166	396	476	16	23	80	0.2875000
NODE_4847_length_1113_cov_51.988166	472	552	0	21	80	0.2625000
NODE_4847_length_1113_cov_51.988166	472	552	2	59	80	0.7375000
NODE_4847_length_1113_cov_51.988166	525	605	0	41	80	0.5125000
NODE_4847_length_1113_cov_51.988166	525	605	2	39	80	0.4875000
NODE_4848_length_1113_cov_35.005917	359	439	0	80	80	1.0000000
NODE_4848_length_1113_cov_35.005917	412	492	0	80	80	1.0000000
NODE_4849_length_1113_cov_28.106509	570	650	0	46	80	0.5750000
NODE_4849_length_1113_cov_28.106509	570	650	2	34	80	0.4250000
NODE_4849_length_1113_cov_28.106509	623	703	2	80	80	1.0000000
NODE_4849_length_1113_cov_28.106509	699	779	2	47	80	0.5875000
NODE_4849_length_1113_cov_28.106509	699	779	4	7	80	0.0875000
NODE_4849_length_1113_cov_28.106509	699	779	6	12	80	0.1500000
NODE_4849_length_1113_cov_28.106509	699	779	9	14	80	0.1750000
NODE_4849_length_1113_cov_28.106509	752	832	4	1	80	0.0125000
NODE_4849_length_1113_cov_28.106509	752	832	5	2	80	0.0250000
NODE_4849_length_1113_cov_28.106509	752	832	6	40	80	0.5000000
NODE_4849_length_1113_cov_28.106509	752	832	7	21	80	0.2625000
NODE_4849_length_1113_cov_28.106509	752	832	9	16	80	0.2000000
NODE_4850_length_1113_cov_18.636095	512	592	0	80	80	1.0000000
NODE_4850_length_1113_cov_18.636095	565	645	0	29	80	0.3625000
NODE_4850_length_1113_cov_18.636095	565	645	2	51	80	0.6375000
NODE_4851_length_1113_cov_16.664694	352	432	0	79	80	0.9875000
NODE_4851_length_1113_cov_16.664694	352	432	4	1	80	0.0125000
NODE_4851_length_1113_cov_16.664694	405	485	0	80	80	1.0000000
NODE_4851_length_1113_cov_16.664694	481	561	0	13	80	0.1625000
NODE_4851_length_1113_cov_16.664694	481	561	2	5	80	0.0625000
NODE_4851_length_1113_cov_16.664694	481	561	4	62	80	0.7750000
NODE_4851_length_1113_cov_16.664694	534	614	0	35	80	0.4375000
NODE_4851_length_1113_cov_16.664694	534	614	2	10	80	0.1250000
NODE_4851_length_1113_cov_16.664694	534	614	4	35	80	0.4375000
NODE_4852_length_1113_cov_14.155819	454	512	2	51	58	0.8793104
NODE_4852_length_1113_cov_14.155819	454	512	4	7	58	0.1206897
NODE_4852_length_1113_cov_14.155819	511	575	0	36	64	0.5625000
NODE_4852_length_1113_cov_14.155819	511	575	2	28	64	0.4375000
NODE_4853_length_1113_cov_10.185404	494	574	0	80	80	1.0000000
NODE_4853_length_1113_cov_10.185404	547	627	0	80	80	1.0000000
NODE_4855_length_1113_cov_4.005917	700	780	0	60	80	0.7500000
NODE_4855_length_1113_cov_4.005917	700	780	2	20	80	0.2500000
NODE_4855_length_1113_cov_4.005917	753	833	0	80	80	1.0000000
NODE_4866_length_1112_cov_14.961500	427	507	1	3	80	0.0375000
NODE_4866_length_1112_cov_14.961500	427	507	2	39	80	0.4875000
NODE_4866_length_1112_cov_14.961500	427	507	3	38	80	0.4750000
NODE_4866_length_1112_cov_14.961500	480	560	2	32	80	0.4000000
NODE_4866_length_1112_cov_14.961500	480	560	3	28	80	0.3500000
NODE_4866_length_1112_cov_14.961500	480	560	6	20	80	0.2500000
NODE_4866_length_1112_cov_14.961500	556	636	0	5	80	0.0625000
NODE_4866_length_1112_cov_14.961500	556	636	4	48	80	0.6000000
NODE_4866_length_1112_cov_14.961500	556	636	6	27	80	0.3375000
NODE_4866_length_1112_cov_14.961500	609	689	0	58	80	0.7250000
NODE_4866_length_1112_cov_14.961500	609	689	4	22	80	0.2750000
NODE_4875_length_1112_cov_1.655479	45	123	0	78	78	1.0000000
NODE_4875_length_1112_cov_1.655479	98	166	0	66	68	0.9705882
NODE_4875_length_1112_cov_1.655479	98	166	2	2	68	0.0294118
NODE_4880_length_1111_cov_37.999012	473	553	0	80	80	1.0000000
NODE_4880_length_1111_cov_37.999012	526	606	0	29	80	0.3625000
NODE_4880_length_1111_cov_37.999012	526	606	2	8	80	0.1000000
NODE_4880_length_1111_cov_37.999012	526	606	3	1	80	0.0125000
NODE_4880_length_1111_cov_37.999012	526	606	4	42	80	0.5250000
NODE_4880_length_1111_cov_37.999012	602	682	0	9	80	0.1125000
NODE_4880_length_1111_cov_37.999012	602	682	2	33	80	0.4125000
NODE_4880_length_1111_cov_37.999012	602	682	4	38	80	0.4750000
NODE_4880_length_1111_cov_37.999012	655	735	0	62	80	0.7750000
NODE_4880_length_1111_cov_37.999012	655	735	2	18	80	0.2250000
NODE_4881_length_1111_cov_24.394269	644	724	0	10	80	0.1250000
NODE_4881_length_1111_cov_24.394269	644	724	2	48	80	0.6000000
NODE_4881_length_1111_cov_24.394269	644	724	7	13	80	0.1625000
NODE_4881_length_1111_cov_24.394269	644	724	9	5	80	0.0625000
NODE_4881_length_1111_cov_24.394269	644	724	13	4	80	0.0500000
NODE_4881_length_1111_cov_24.394269	697	777	2	5	80	0.0625000
NODE_4881_length_1111_cov_24.394269	697	777	7	13	80	0.1625000
NODE_4881_length_1111_cov_24.394269	697	777	9	5	80	0.0625000
NODE_4881_length_1111_cov_24.394269	697	777	13	20	80	0.2500000
NODE_4881_length_1111_cov_24.394269	697	777	14	37	80	0.4625000
NODE_4882_length_1111_cov_23.676877	374	454	2	11	80	0.1375000
NODE_4882_length_1111_cov_23.676877	374	454	4	58	80	0.7250000
NODE_4882_length_1111_cov_23.676877	374	454	6	11	80	0.1375000
NODE_4882_length_1111_cov_23.676877	427	507	0	4	80	0.0500000
NODE_4882_length_1111_cov_23.676877	427	507	2	33	80	0.4125000
NODE_4882_length_1111_cov_23.676877	427	507	4	43	80	0.5375000
NODE_4883_length_1111_cov_17.522727	383	463	4	9	80	0.1125000
NODE_4883_length_1111_cov_17.522727	383	463	6	18	80	0.2250000
NODE_4883_length_1111_cov_17.522727	383	463	8	34	80	0.4250000
NODE_4883_length_1111_cov_17.522727	383	463	10	19	80	0.2375000
NODE_4883_length_1111_cov_17.522727	436	516	2	9	80	0.1125000
NODE_4883_length_1111_cov_17.522727	436	516	6	19	80	0.2375000
NODE_4883_length_1111_cov_17.522727	436	516	8	8	80	0.1000000
NODE_4883_length_1111_cov_17.522727	436	516	10	44	80	0.5500000
NODE_4884_length_1111_cov_16.495059	388	468	0	6	80	0.0750000
NODE_4884_length_1111_cov_16.495059	388	468	8	74	80	0.9250000
NODE_4884_length_1111_cov_16.495059	441	521	0	22	80	0.2750000
NODE_4884_length_1111_cov_16.495059	441	521	8	58	80	0.7250000
NODE_4885_length_1111_cov_15.366601	555	635	2	14	80	0.1750000
NODE_4885_length_1111_cov_15.366601	555	635	4	66	80	0.8250000
NODE_4885_length_1111_cov_15.366601	608	688	0	28	80	0.3500000
NODE_4885_length_1111_cov_15.366601	608	688	2	10	80	0.1250000
NODE_4885_length_1111_cov_15.366601	608	688	4	42	80	0.5250000
NODE_4886_length_1111_cov_15.314229	809	889	0	7	80	0.0875000
NODE_4886_length_1111_cov_15.314229	809	889	2	17	80	0.2125000
NODE_4886_length_1111_cov_15.314229	809	889	4	56	80	0.7000000
NODE_4886_length_1111_cov_15.314229	862	942	0	26	80	0.3250000
NODE_4886_length_1111_cov_15.314229	862	942	2	20	80	0.2500000
NODE_4886_length_1111_cov_15.314229	862	942	4	34	80	0.4250000
NODE_4887_length_1111_cov_9.732213	443	523	0	3	80	0.0375000
NODE_4887_length_1111_cov_9.732213	443	523	2	31	80	0.3875000
NODE_4887_length_1111_cov_9.732213	443	523	4	46	80	0.5750000
NODE_4887_length_1111_cov_9.732213	496	576	0	11	80	0.1375000
NODE_4887_length_1111_cov_9.732213	496	576	2	55	80	0.6875000
NODE_4887_length_1111_cov_9.732213	496	576	4	14	80	0.1750000
NODE_4888_length_1111_cov_4.907115	606	686	0	17	80	0.2125000
NODE_4888_length_1111_cov_4.907115	606	686	2	63	80	0.7875000
NODE_4888_length_1111_cov_4.907115	659	739	0	70	80	0.8750000
NODE_4888_length_1111_cov_4.907115	659	739	2	10	80	0.1250000
NODE_4892_length_1110_cov_23.012859	453	533	0	62	80	0.7750000
NODE_4892_length_1110_cov_23.012859	453	533	4	18	80	0.2250000
NODE_4892_length_1110_cov_23.012859	506	586	0	9	80	0.1125000
NODE_4892_length_1110_cov_23.012859	506	586	4	71	80	0.8875000
NODE_4892_length_1110_cov_23.012859	582	662	0	39	80	0.4875000
NODE_4892_length_1110_cov_23.012859	582	662	2	19	80	0.2375000
NODE_4892_length_1110_cov_23.012859	582	662	4	22	80	0.2750000
NODE_4892_length_1110_cov_23.012859	635	715	0	8	80	0.1000000
NODE_4892_length_1110_cov_23.012859	635	715	2	33	80	0.4125000
NODE_4892_length_1110_cov_23.012859	635	715	4	39	80	0.4875000
NODE_4895_length_1110_cov_5.305638	754	834	0	80	80	1.0000000
NODE_4895_length_1110_cov_5.305638	807	887	0	43	80	0.5375000
NODE_4895_length_1110_cov_5.305638	807	887	1	13	80	0.1625000
NODE_4895_length_1110_cov_5.305638	807	887	2	24	80	0.3000000
NODE_4896_length_1110_cov_3.698318	642	685	0	43	43	1.0000000
NODE_4899_length_1110_cov_1.871414	15	86	0	59	71	0.8309859
NODE_4899_length_1110_cov_1.871414	15	86	2	2	71	0.0281690
NODE_4899_length_1110_cov_1.871414	15	86	6	10	71	0.1408451
NODE_4903_length_1109_cov_35.307921	413	493	0	16	80	0.2000000
NODE_4903_length_1109_cov_35.307921	413	493	2	64	80	0.8000000
NODE_4903_length_1109_cov_35.307921	466	546	0	18	80	0.2250000
NODE_4903_length_1109_cov_35.307921	466	546	2	62	80	0.7750000
NODE_4903_length_1109_cov_35.307921	542	622	0	80	80	1.0000000
NODE_4903_length_1109_cov_35.307921	595	675	0	80	80	1.0000000
NODE_4904_length_1109_cov_27.880198	501	581	0	80	80	1.0000000
NODE_4904_length_1109_cov_27.880198	554	634	0	80	80	1.0000000
NODE_4904_length_1109_cov_27.880198	630	710	0	80	80	1.0000000
NODE_4904_length_1109_cov_27.880198	683	763	0	80	80	1.0000000
NODE_4905_length_1109_cov_21.858416	571	651	0	76	80	0.9500000
NODE_4905_length_1109_cov_21.858416	571	651	2	4	80	0.0500000
NODE_4905_length_1109_cov_21.858416	624	704	0	80	80	1.0000000
NODE_4912_length_1108_cov_59.921705	386	466	2	29	80	0.3625000
NODE_4912_length_1108_cov_59.921705	386	466	6	43	80	0.5375000
NODE_4912_length_1108_cov_59.921705	386	466	8	8	80	0.1000000
NODE_4912_length_1108_cov_59.921705	439	519	6	39	80	0.4875000
NODE_4912_length_1108_cov_59.921705	439	519	7	13	80	0.1625000
NODE_4912_length_1108_cov_59.921705	439	519	8	28	80	0.3500000
NODE_4912_length_1108_cov_59.921705	515	595	0	3	80	0.0375000
NODE_4912_length_1108_cov_59.921705	515	595	2	37	80	0.4625000
NODE_4912_length_1108_cov_59.921705	515	595	6	40	80	0.5000000
NODE_4912_length_1108_cov_59.921705	568	648	0	3	80	0.0375000
NODE_4912_length_1108_cov_59.921705	568	648	2	77	80	0.9625000
NODE_4914_length_1108_cov_16.069376	513	593	0	80	80	1.0000000
NODE_4914_length_1108_cov_16.069376	566	646	0	80	80	1.0000000
NODE_4916_length_1108_cov_11.656095	333	413	0	17	80	0.2125000
NODE_4916_length_1108_cov_11.656095	333	413	2	44	80	0.5500000
NODE_4916_length_1108_cov_11.656095	333	413	4	16	80	0.2000000
NODE_4916_length_1108_cov_11.656095	333	413	6	3	80	0.0375000
NODE_4916_length_1108_cov_11.656095	386	466	2	8	80	0.1000000
NODE_4916_length_1108_cov_11.656095	386	466	4	16	80	0.2000000
NODE_4916_length_1108_cov_11.656095	386	466	6	52	80	0.6500000
NODE_4916_length_1108_cov_11.656095	386	466	8	4	80	0.0500000
NODE_4917_length_1108_cov_10.266601	431	511	0	11	80	0.1375000
NODE_4917_length_1108_cov_10.266601	431	511	2	18	80	0.2250000
NODE_4917_length_1108_cov_10.266601	431	511	4	3	80	0.0375000
NODE_4917_length_1108_cov_10.266601	431	511	6	48	80	0.6000000
NODE_4917_length_1108_cov_10.266601	484	564	0	27	80	0.3375000
NODE_4917_length_1108_cov_10.266601	484	564	2	3	80	0.0375000
NODE_4917_length_1108_cov_10.266601	484	564	4	26	80	0.3250000
NODE_4917_length_1108_cov_10.266601	484	564	6	24	80	0.3000000
NODE_4918_length_1108_cov_8.895937	635	715	0	80	80	1.0000000
NODE_4918_length_1108_cov_8.895937	688	768	0	80	80	1.0000000
NODE_4920_length_1108_cov_5.682854	577	657	2	80	80	1.0000000
NODE_4920_length_1108_cov_5.682854	630	710	0	52	80	0.6500000
NODE_4920_length_1108_cov_5.682854	630	710	2	28	80	0.3500000
NODE_4927_length_1107_cov_35.050595	423	503	2	19	80	0.2375000
NODE_4927_length_1107_cov_35.050595	423	503	6	41	80	0.5125000
NODE_4927_length_1107_cov_35.050595	423	503	8	20	80	0.2500000
NODE_4927_length_1107_cov_35.050595	476	556	4	11	80	0.1375000
NODE_4927_length_1107_cov_35.050595	476	556	6	10	80	0.1250000
NODE_4927_length_1107_cov_35.050595	476	556	8	56	80	0.7000000
NODE_4927_length_1107_cov_35.050595	476	556	10	3	80	0.0375000
NODE_4927_length_1107_cov_35.050595	552	632	2	66	80	0.8250000
NODE_4927_length_1107_cov_35.050595	552	632	4	14	80	0.1750000
NODE_4927_length_1107_cov_35.050595	605	685	0	4	80	0.0500000
NODE_4927_length_1107_cov_35.050595	605	685	2	76	80	0.9500000
NODE_4928_length_1107_cov_31.386905	422	502	0	80	80	1.0000000
NODE_4928_length_1107_cov_31.386905	475	555	0	27	80	0.3375000
NODE_4928_length_1107_cov_31.386905	475	555	2	53	80	0.6625000
NODE_4929_length_1107_cov_29.178571	577	657	4	3	80	0.0375000
NODE_4929_length_1107_cov_29.178571	577	657	6	11	80	0.1375000
NODE_4929_length_1107_cov_29.178571	577	657	10	66	80	0.8250000
NODE_4929_length_1107_cov_29.178571	630	710	0	25	80	0.3125000
NODE_4929_length_1107_cov_29.178571	630	710	2	3	80	0.0375000
NODE_4929_length_1107_cov_29.178571	630	710	6	36	80	0.4500000
NODE_4929_length_1107_cov_29.178571	630	710	10	16	80	0.2000000
NODE_4929_length_1107_cov_29.178571	934	1000	2	2	66	0.0303030
NODE_4929_length_1107_cov_29.178571	934	1000	4	26	66	0.3939394
NODE_4929_length_1107_cov_29.178571	934	1000	6	6	66	0.0909091
NODE_4929_length_1107_cov_29.178571	934	1000	8	31	66	0.4696970
NODE_4929_length_1107_cov_29.178571	934	1000	10	1	66	0.0151515
NODE_4929_length_1107_cov_29.178571	934	1005	2	2	71	0.0281690
NODE_4929_length_1107_cov_29.178571	934	1005	4	26	71	0.3661972
NODE_4929_length_1107_cov_29.178571	934	1005	6	6	71	0.0845070
NODE_4929_length_1107_cov_29.178571	934	1005	8	36	71	0.5070422
NODE_4929_length_1107_cov_29.178571	934	1005	10	1	71	0.0140845
NODE_4930_length_1107_cov_16.038690	574	654	0	78	80	0.9750000
NODE_4930_length_1107_cov_16.038690	574	654	2	2	80	0.0250000
NODE_4930_length_1107_cov_16.038690	627	707	0	25	80	0.3125000
NODE_4930_length_1107_cov_16.038690	627	707	2	55	80	0.6875000
NODE_4931_length_1107_cov_15.472222	78	158	115	2	80	0.0250000
NODE_4931_length_1107_cov_15.472222	78	158	116	1	80	0.0125000
NODE_4931_length_1107_cov_15.472222	78	158	119	2	80	0.0250000
NODE_4931_length_1107_cov_15.472222	78	158	121	1	80	0.0125000
NODE_4931_length_1107_cov_15.472222	78	158	125	2	80	0.0250000
NODE_4931_length_1107_cov_15.472222	78	158	127	1	80	0.0125000
NODE_4931_length_1107_cov_15.472222	78	158	129	2	80	0.0250000
NODE_4931_length_1107_cov_15.472222	78	158	134	1	80	0.0125000
NODE_4931_length_1107_cov_15.472222	78	158	139	1	80	0.0125000
NODE_4931_length_1107_cov_15.472222	78	158	140	4	80	0.0500000
NODE_4931_length_1107_cov_15.472222	78	158	142	2	80	0.0250000
NODE_4931_length_1107_cov_15.472222	78	158	144	2	80	0.0250000
NODE_4931_length_1107_cov_15.472222	78	158	146	2	80	0.0250000
NODE_4931_length_1107_cov_15.472222	78	158	148	1	80	0.0125000
NODE_4931_length_1107_cov_15.472222	78	158	152	1	80	0.0125000
NODE_4931_length_1107_cov_15.472222	78	158	156	2	80	0.0250000
NODE_4931_length_1107_cov_15.472222	78	158	158	2	80	0.0250000
NODE_4931_length_1107_cov_15.472222	78	158	166	6	80	0.0750000
NODE_4931_length_1107_cov_15.472222	78	158	168	2	80	0.0250000
NODE_4931_length_1107_cov_15.472222	78	158	169	1	80	0.0125000
NODE_4931_length_1107_cov_15.472222	78	158	171	1	80	0.0125000
NODE_4931_length_1107_cov_15.472222	78	158	179	4	80	0.0500000
NODE_4931_length_1107_cov_15.472222	78	158	181	1	80	0.0125000
NODE_4931_length_1107_cov_15.472222	78	158	185	2	80	0.0250000
NODE_4931_length_1107_cov_15.472222	78	158	188	1	80	0.0125000
NODE_4931_length_1107_cov_15.472222	78	158	192	1	80	0.0125000
NODE_4931_length_1107_cov_15.472222	78	158	196	1	80	0.0125000
NODE_4931_length_1107_cov_15.472222	78	158	198	4	80	0.0500000
NODE_4931_length_1107_cov_15.472222	78	158	200	2	80	0.0250000
NODE_4931_length_1107_cov_15.472222	78	158	202	1	80	0.0125000
NODE_4931_length_1107_cov_15.472222	78	158	204	2	80	0.0250000
NODE_4931_length_1107_cov_15.472222	78	158	206	1	80	0.0125000
NODE_4931_length_1107_cov_15.472222	78	158	212	1	80	0.0125000
NODE_4931_length_1107_cov_15.472222	78	158	214	15	80	0.1875000
NODE_4931_length_1107_cov_15.472222	78	158	216	5	80	0.0625000
NODE_4931_length_1107_cov_15.472222	131	194	12	2	63	0.0317460
NODE_4931_length_1107_cov_15.472222	131	194	14	2	63	0.0317460
NODE_4931_length_1107_cov_15.472222	131	194	16	2	63	0.0317460
NODE_4931_length_1107_cov_15.472222	131	194	18	4	63	0.0634921
NODE_4931_length_1107_cov_15.472222	131	194	20	1	63	0.0158730
NODE_4931_length_1107_cov_15.472222	131	194	24	1	63	0.0158730
NODE_4931_length_1107_cov_15.472222	131	194	28	2	63	0.0317460
NODE_4931_length_1107_cov_15.472222	131	194	29	1	63	0.0158730
NODE_4931_length_1107_cov_15.472222	131	194	35	1	63	0.0158730
NODE_4931_length_1107_cov_15.472222	131	194	37	2	63	0.0317460
NODE_4931_length_1107_cov_15.472222	131	194	41	1	63	0.0158730
NODE_4931_length_1107_cov_15.472222	131	194	43	1	63	0.0158730
NODE_4931_length_1107_cov_15.472222	131	194	51	1	63	0.0158730
NODE_4931_length_1107_cov_15.472222	131	194	52	1	63	0.0158730
NODE_4931_length_1107_cov_15.472222	131	194	72	3	63	0.0476190
NODE_4931_length_1107_cov_15.472222	131	194	76	1	63	0.0158730
NODE_4931_length_1107_cov_15.472222	131	194	78	1	63	0.0158730
NODE_4931_length_1107_cov_15.472222	131	194	86	1	63	0.0158730
NODE_4931_length_1107_cov_15.472222	131	194	89	1	63	0.0158730
NODE_4931_length_1107_cov_15.472222	131	194	98	2	63	0.0317460
NODE_4931_length_1107_cov_15.472222	131	194	106	1	63	0.0158730
NODE_4931_length_1107_cov_15.472222	131	194	107	3	63	0.0476190
NODE_4931_length_1107_cov_15.472222	131	194	113	1	63	0.0158730
NODE_4931_length_1107_cov_15.472222	131	194	115	2	63	0.0317460
NODE_4931_length_1107_cov_15.472222	131	194	116	1	63	0.0158730
NODE_4931_length_1107_cov_15.472222	131	194	119	2	63	0.0317460
NODE_4931_length_1107_cov_15.472222	131	194	121	1	63	0.0158730
NODE_4931_length_1107_cov_15.472222	131	194	125	2	63	0.0317460
NODE_4931_length_1107_cov_15.472222	131	194	127	1	63	0.0158730
NODE_4931_length_1107_cov_15.472222	131	194	129	2	63	0.0317460
NODE_4931_length_1107_cov_15.472222	131	194	134	1	63	0.0158730
NODE_4931_length_1107_cov_15.472222	131	194	139	1	63	0.0158730
NODE_4931_length_1107_cov_15.472222	131	194	140	4	63	0.0634921
NODE_4931_length_1107_cov_15.472222	131	194	142	2	63	0.0317460
NODE_4931_length_1107_cov_15.472222	131	194	144	2	63	0.0317460
NODE_4931_length_1107_cov_15.472222	131	194	146	2	63	0.0317460
NODE_4931_length_1107_cov_15.472222	131	194	148	1	63	0.0158730
NODE_4931_length_1107_cov_15.472222	131	194	152	1	63	0.0158730
NODE_4931_length_1107_cov_15.472222	131	194	156	2	63	0.0317460
NODE_4931_length_1107_cov_15.472222	952	995	4	24	43	0.5581396
NODE_4931_length_1107_cov_15.472222	952	995	6	3	43	0.0697674
NODE_4931_length_1107_cov_15.472222	952	995	8	16	43	0.3720930
NODE_4931_length_1107_cov_15.472222	968	1052	4	37	84	0.4404762
NODE_4931_length_1107_cov_15.472222	968	1052	6	3	84	0.0357143
NODE_4931_length_1107_cov_15.472222	968	1052	8	44	84	0.5238096
NODE_4932_length_1107_cov_13.911706	502	582	6	17	80	0.2125000
NODE_4932_length_1107_cov_13.911706	502	582	7	20	80	0.2500000
NODE_4932_length_1107_cov_13.911706	502	582	8	43	80	0.5375000
NODE_4932_length_1107_cov_13.911706	555	635	0	8	80	0.1000000
NODE_4932_length_1107_cov_13.911706	555	635	2	35	80	0.4375000
NODE_4932_length_1107_cov_13.911706	555	635	7	29	80	0.3625000
NODE_4932_length_1107_cov_13.911706	555	635	8	8	80	0.1000000
NODE_4933_length_1107_cov_11.701389	520	600	0	63	80	0.7875000
NODE_4933_length_1107_cov_11.701389	520	600	2	17	80	0.2125000
NODE_4933_length_1107_cov_11.701389	573	653	0	10	80	0.1250000
NODE_4933_length_1107_cov_11.701389	573	653	2	39	80	0.4875000
NODE_4933_length_1107_cov_11.701389	573	653	4	31	80	0.3875000
NODE_4944_length_1106_cov_59.617676	452	532	0	6	80	0.0750000
NODE_4944_length_1106_cov_59.617676	452	532	1	1	80	0.0125000
NODE_4944_length_1106_cov_59.617676	452	532	2	42	80	0.5250000
NODE_4944_length_1106_cov_59.617676	452	532	4	31	80	0.3875000
NODE_4944_length_1106_cov_59.617676	505	585	0	59	80	0.7375000
NODE_4944_length_1106_cov_59.617676	505	585	1	1	80	0.0125000
NODE_4944_length_1106_cov_59.617676	505	585	2	20	80	0.2500000
NODE_4944_length_1106_cov_59.617676	581	661	0	80	80	1.0000000
NODE_4944_length_1106_cov_59.617676	634	714	0	80	80	1.0000000
NODE_4945_length_1106_cov_40.808342	439	504	0	65	65	1.0000000
NODE_4945_length_1106_cov_40.808342	471	511	0	40	40	1.0000000
NODE_4945_length_1106_cov_40.808342	503	569	0	66	66	1.0000000
NODE_4945_length_1106_cov_40.808342	536	601	0	65	65	1.0000000
NODE_4945_length_1106_cov_40.808342	568	648	0	80	80	1.0000000
NODE_4945_length_1106_cov_40.808342	621	682	0	61	61	1.0000000
NODE_4946_length_1106_cov_23.186693	560	640	0	7	80	0.0875000
NODE_4946_length_1106_cov_23.186693	560	640	2	60	80	0.7500000
NODE_4946_length_1106_cov_23.186693	560	640	4	13	80	0.1625000
NODE_4946_length_1106_cov_23.186693	613	693	2	56	80	0.7000000
NODE_4946_length_1106_cov_23.186693	613	693	4	24	80	0.3000000
NODE_4947_length_1106_cov_14.570010	466	546	2	11	80	0.1375000
NODE_4947_length_1106_cov_14.570010	466	546	4	2	80	0.0250000
NODE_4947_length_1106_cov_14.570010	466	546	7	21	80	0.2625000
NODE_4947_length_1106_cov_14.570010	466	546	8	8	80	0.1000000
NODE_4947_length_1106_cov_14.570010	466	546	10	38	80	0.4750000
NODE_4947_length_1106_cov_14.570010	519	599	6	42	80	0.5250000
NODE_4947_length_1106_cov_14.570010	519	599	8	19	80	0.2375000
NODE_4947_length_1106_cov_14.570010	519	599	10	19	80	0.2375000
NODE_4948_length_1106_cov_14.039722	487	567	0	69	80	0.8625000
NODE_4948_length_1106_cov_14.039722	487	567	2	11	80	0.1375000
NODE_4948_length_1106_cov_14.039722	540	620	0	16	80	0.2000000
NODE_4948_length_1106_cov_14.039722	540	620	2	60	80	0.7500000
NODE_4948_length_1106_cov_14.039722	540	620	4	4	80	0.0500000
NODE_4949_length_1106_cov_8.872890	328	408	0	41	80	0.5125000
NODE_4949_length_1106_cov_8.872890	328	408	2	39	80	0.4875000
NODE_4949_length_1106_cov_8.872890	381	461	2	80	80	1.0000000
NODE_4950_length_1106_cov_7.157895	332	412	0	80	80	1.0000000
NODE_4950_length_1106_cov_7.157895	385	465	0	80	80	1.0000000
NODE_4951_length_1106_cov_6.530288	513	593	0	80	80	1.0000000
NODE_4951_length_1106_cov_6.530288	566	646	0	80	80	1.0000000
NODE_4959_length_1105_cov_28.126243	253	333	0	37	80	0.4625000
NODE_4959_length_1105_cov_28.126243	253	333	6	4	80	0.0500000
NODE_4959_length_1105_cov_28.126243	253	333	8	39	80	0.4875000
NODE_4959_length_1105_cov_28.126243	306	386	6	2	80	0.0250000
NODE_4959_length_1105_cov_28.126243	306	386	8	78	80	0.9750000
NODE_4960_length_1105_cov_24.994036	549	629	2	80	80	1.0000000
NODE_4960_length_1105_cov_24.994036	602	682	0	39	80	0.4875000
NODE_4960_length_1105_cov_24.994036	602	682	2	41	80	0.5125000
NODE_4961_length_1105_cov_17.635189	442	522	0	62	80	0.7750000
NODE_4961_length_1105_cov_17.635189	442	522	2	18	80	0.2250000
NODE_4961_length_1105_cov_17.635189	495	575	0	36	80	0.4500000
NODE_4961_length_1105_cov_17.635189	495	575	2	44	80	0.5500000
NODE_4963_length_1105_cov_10.114314	438	518	0	2	80	0.0250000
NODE_4963_length_1105_cov_10.114314	438	518	2	78	80	0.9750000
NODE_4963_length_1105_cov_10.114314	491	571	0	10	80	0.1250000
NODE_4963_length_1105_cov_10.114314	491	571	2	70	80	0.8750000
NODE_4964_length_1105_cov_8.403579	507	587	0	80	80	1.0000000
NODE_4964_length_1105_cov_8.403579	560	640	0	80	80	1.0000000
NODE_4966_length_1105_cov_6.682903	467	547	2	52	80	0.6500000
NODE_4966_length_1105_cov_6.682903	467	547	4	28	80	0.3500000
NODE_4966_length_1105_cov_6.682903	520	600	0	47	80	0.5875000
NODE_4966_length_1105_cov_6.682903	520	600	2	33	80	0.4125000
NODE_4966_length_1105_cov_6.682903	596	676	0	80	80	1.0000000
NODE_4966_length_1105_cov_6.682903	649	729	0	68	80	0.8500000
NODE_4966_length_1105_cov_6.682903	649	729	2	12	80	0.1500000
NODE_4974_length_1104_cov_27.599005	388	468	0	80	80	1.0000000
NODE_4974_length_1104_cov_27.599005	441	521	0	80	80	1.0000000
NODE_4984_length_1103_cov_2.787849	620	682	2	14	62	0.2258064
NODE_4984_length_1103_cov_2.787849	620	682	4	48	62	0.7741935
NODE_4986_length_1102_cov_34.484546	667	747	2	18	80	0.2250000
NODE_4986_length_1102_cov_34.484546	667	747	4	39	80	0.4875000
NODE_4986_length_1102_cov_34.484546	667	747	8	23	80	0.2875000
NODE_4986_length_1102_cov_34.484546	720	800	4	4	80	0.0500000
NODE_4986_length_1102_cov_34.484546	720	800	6	30	80	0.3750000
NODE_4986_length_1102_cov_34.484546	720	800	8	46	80	0.5750000
NODE_4987_length_1102_cov_17.631107	511	587	2	49	76	0.6447368
NODE_4987_length_1102_cov_17.631107	511	587	6	27	76	0.3552631
NODE_4987_length_1102_cov_17.631107	560	640	6	42	80	0.5250000
NODE_4987_length_1102_cov_17.631107	560	640	7	4	80	0.0500000
NODE_4987_length_1102_cov_17.631107	560	640	8	34	80	0.4250000
NODE_4998_length_1101_cov_35.638723	414	491	3	7	77	0.0909091
NODE_4998_length_1101_cov_35.638723	414	491	5	3	77	0.0389610
NODE_4998_length_1101_cov_35.638723	414	491	7	7	77	0.0909091
NODE_4998_length_1101_cov_35.638723	414	491	9	32	77	0.4155844
NODE_4998_length_1101_cov_35.638723	414	491	11	28	77	0.3636364
NODE_4998_length_1101_cov_35.638723	414	491	3	7	77	0.0909091
NODE_4998_length_1101_cov_35.638723	414	491	5	3	77	0.0389610
NODE_4998_length_1101_cov_35.638723	414	491	7	7	77	0.0909091
NODE_4998_length_1101_cov_35.638723	414	491	9	32	77	0.4155844
NODE_4998_length_1101_cov_35.638723	414	491	11	28	77	0.3636364
NODE_4998_length_1101_cov_35.638723	488	544	5	15	56	0.2678571
NODE_4998_length_1101_cov_35.638723	488	544	6	12	56	0.2142857
NODE_4998_length_1101_cov_35.638723	488	544	7	17	56	0.3035714
NODE_4998_length_1101_cov_35.638723	488	544	8	1	56	0.0178571
NODE_4998_length_1101_cov_35.638723	488	544	9	11	56	0.1964286
NODE_4998_length_1101_cov_35.638723	752	832	2	10	80	0.1250000
NODE_4998_length_1101_cov_35.638723	752	832	6	43	80	0.5375000
NODE_4998_length_1101_cov_35.638723	752	832	8	27	80	0.3375000
NODE_4998_length_1101_cov_35.638723	805	885	0	17	80	0.2125000
NODE_4998_length_1101_cov_35.638723	805	885	2	38	80	0.4750000
NODE_4998_length_1101_cov_35.638723	805	885	3	8	80	0.1000000
NODE_4998_length_1101_cov_35.638723	805	885	6	1	80	0.0125000
NODE_4998_length_1101_cov_35.638723	805	885	8	16	80	0.2000000
NODE_4998_length_1101_cov_35.638723	881	961	3	15	80	0.1875000
NODE_4998_length_1101_cov_35.638723	881	961	4	14	80	0.1750000
NODE_4998_length_1101_cov_35.638723	881	961	6	51	80	0.6375000
NODE_4998_length_1101_cov_35.638723	934	1014	4	28	80	0.3500000
NODE_4998_length_1101_cov_35.638723	934	1014	6	52	80	0.6500000
NODE_4999_length_1101_cov_28.366267	452	532	0	4	80	0.0500000
NODE_4999_length_1101_cov_28.366267	452	532	4	8	80	0.1000000
NODE_4999_length_1101_cov_28.366267	452	532	6	8	80	0.1000000
NODE_4999_length_1101_cov_28.366267	452	532	8	60	80	0.7500000
NODE_4999_length_1101_cov_28.366267	505	585	0	16	80	0.2000000
NODE_4999_length_1101_cov_28.366267	505	585	2	33	80	0.4125000
NODE_4999_length_1101_cov_28.366267	505	585	6	11	80	0.1375000
NODE_4999_length_1101_cov_28.366267	505	585	8	20	80	0.2500000
NODE_5000_length_1101_cov_24.513972	475	555	0	80	80	1.0000000
NODE_5000_length_1101_cov_24.513972	528	608	0	80	80	1.0000000
NODE_5001_length_1101_cov_22.315369	335	415	0	16	80	0.2000000
NODE_5001_length_1101_cov_22.315369	335	415	2	13	80	0.1625000
NODE_5001_length_1101_cov_22.315369	335	415	10	51	80	0.6375000
NODE_5001_length_1101_cov_22.315369	388	468	9	27	80	0.3375000
NODE_5001_length_1101_cov_22.315369	388	468	10	27	80	0.3375000
NODE_5001_length_1101_cov_22.315369	388	468	13	26	80	0.3250000
NODE_5001_length_1101_cov_22.315369	464	544	13	13	80	0.1625000
NODE_5001_length_1101_cov_22.315369	464	544	14	8	80	0.1000000
NODE_5001_length_1101_cov_22.315369	464	544	16	42	80	0.5250000
NODE_5001_length_1101_cov_22.315369	464	544	20	16	80	0.2000000
NODE_5001_length_1101_cov_22.315369	464	544	21	1	80	0.0125000
NODE_5001_length_1101_cov_22.315369	517	597	8	10	80	0.1250000
NODE_5001_length_1101_cov_22.315369	517	597	10	3	80	0.0375000
NODE_5001_length_1101_cov_22.315369	517	597	12	21	80	0.2625000
NODE_5001_length_1101_cov_22.315369	517	597	14	7	80	0.0875000
NODE_5001_length_1101_cov_22.315369	517	597	16	34	80	0.4250000
NODE_5001_length_1101_cov_22.315369	517	597	18	5	80	0.0625000
NODE_5002_length_1101_cov_22.070858	419	499	2	6	80	0.0750000
NODE_5002_length_1101_cov_22.070858	419	499	4	4	80	0.0500000
NODE_5002_length_1101_cov_22.070858	419	499	6	21	80	0.2625000
NODE_5002_length_1101_cov_22.070858	419	499	8	49	80	0.6125000
NODE_5002_length_1101_cov_22.070858	472	552	2	38	80	0.4750000
NODE_5002_length_1101_cov_22.070858	472	552	4	25	80	0.3125000
NODE_5002_length_1101_cov_22.070858	472	552	6	16	80	0.2000000
NODE_5002_length_1101_cov_22.070858	472	552	8	1	80	0.0125000
NODE_5002_length_1101_cov_22.070858	548	628	0	75	80	0.9375000
NODE_5002_length_1101_cov_22.070858	548	628	2	5	80	0.0625000
NODE_5002_length_1101_cov_22.070858	601	681	0	80	80	1.0000000
NODE_5003_length_1101_cov_18.821357	469	549	0	80	80	1.0000000
NODE_5003_length_1101_cov_18.821357	522	602	0	80	80	1.0000000
NODE_5004_length_1101_cov_17.151697	502	582	4	5	80	0.0625000
NODE_5004_length_1101_cov_17.151697	502	582	5	3	80	0.0375000
NODE_5004_length_1101_cov_17.151697	502	582	6	20	80	0.2500000
NODE_5004_length_1101_cov_17.151697	502	582	8	13	80	0.1625000
NODE_5004_length_1101_cov_17.151697	502	582	9	25	80	0.3125000
NODE_5004_length_1101_cov_17.151697	502	582	10	14	80	0.1750000
NODE_5004_length_1101_cov_17.151697	555	635	6	8	80	0.1000000
NODE_5004_length_1101_cov_17.151697	555	635	8	58	80	0.7250000
NODE_5004_length_1101_cov_17.151697	555	635	9	14	80	0.1750000
NODE_5005_length_1101_cov_8.371257	968	1048	3	1	80	0.0125000
NODE_5005_length_1101_cov_8.371257	968	1048	15	1	80	0.0125000
NODE_5005_length_1101_cov_8.371257	968	1048	17	2	80	0.0250000
NODE_5005_length_1101_cov_8.371257	968	1048	22	9	80	0.1125000
NODE_5005_length_1101_cov_8.371257	968	1048	24	2	80	0.0250000
NODE_5005_length_1101_cov_8.371257	968	1048	28	2	80	0.0250000
NODE_5005_length_1101_cov_8.371257	968	1048	34	11	80	0.1375000
NODE_5005_length_1101_cov_8.371257	968	1048	36	52	80	0.6500000
NODE_5010_length_1100_cov_42.528472	582	662	2	42	80	0.5250000
NODE_5010_length_1100_cov_42.528472	582	662	4	38	80	0.4750000
NODE_5010_length_1100_cov_42.528472	635	715	0	1	80	0.0125000
NODE_5010_length_1100_cov_42.528472	635	715	2	50	80	0.6250000
NODE_5010_length_1100_cov_42.528472	635	715	4	29	80	0.3625000
NODE_5010_length_1100_cov_42.528472	711	791	4	80	80	1.0000000
NODE_5010_length_1100_cov_42.528472	764	844	0	24	80	0.3000000
NODE_5010_length_1100_cov_42.528472	764	844	4	56	80	0.7000000
NODE_5011_length_1100_cov_40.883117	324	404	2	38	80	0.4750000
NODE_5011_length_1100_cov_40.883117	324	404	4	42	80	0.5250000
NODE_5011_length_1100_cov_40.883117	377	457	0	14	80	0.1750000
NODE_5011_length_1100_cov_40.883117	377	457	1	1	80	0.0125000
NODE_5011_length_1100_cov_40.883117	377	457	2	65	80	0.8125000
NODE_5011_length_1100_cov_40.883117	453	533	2	4	80	0.0500000
NODE_5011_length_1100_cov_40.883117	453	533	3	7	80	0.0875000
NODE_5011_length_1100_cov_40.883117	453	533	4	69	80	0.8625000
NODE_5011_length_1100_cov_40.883117	506	586	2	47	80	0.5875000
NODE_5011_length_1100_cov_40.883117	506	586	4	33	80	0.4125000
NODE_5012_length_1100_cov_23.160839	524	604	0	27	80	0.3375000
NODE_5012_length_1100_cov_23.160839	524	604	2	53	80	0.6625000
NODE_5012_length_1100_cov_23.160839	577	657	0	27	80	0.3375000
NODE_5012_length_1100_cov_23.160839	577	657	2	53	80	0.6625000
NODE_5012_length_1100_cov_23.160839	653	733	0	12	80	0.1500000
NODE_5012_length_1100_cov_23.160839	653	733	2	68	80	0.8500000
NODE_5012_length_1100_cov_23.160839	706	786	0	24	80	0.3000000
NODE_5012_length_1100_cov_23.160839	706	786	2	56	80	0.7000000
NODE_5013_length_1100_cov_22.200799	485	565	0	80	80	1.0000000
NODE_5013_length_1100_cov_22.200799	538	618	0	80	80	1.0000000
NODE_5013_length_1100_cov_22.200799	614	694	0	65	80	0.8125000
NODE_5013_length_1100_cov_22.200799	614	694	2	15	80	0.1875000
NODE_5013_length_1100_cov_22.200799	667	745	0	12	78	0.1538462
NODE_5013_length_1100_cov_22.200799	667	745	2	66	78	0.8461539
NODE_5014_length_1100_cov_15.353646	472	552	0	9	80	0.1125000
NODE_5014_length_1100_cov_15.353646	472	552	2	2	80	0.0250000
NODE_5014_length_1100_cov_15.353646	472	552	4	69	80	0.8625000
NODE_5014_length_1100_cov_15.353646	525	605	0	15	80	0.1875000
NODE_5014_length_1100_cov_15.353646	525	605	2	14	80	0.1750000
NODE_5014_length_1100_cov_15.353646	525	605	4	51	80	0.6375000
NODE_5015_length_1100_cov_14.584416	673	753	0	80	80	1.0000000
NODE_5015_length_1100_cov_14.584416	726	806	0	80	80	1.0000000
NODE_5029_length_1099_cov_85.893000	464	544	8	32	80	0.4000000
NODE_5029_length_1099_cov_85.893000	464	544	11	10	80	0.1250000
NODE_5029_length_1099_cov_85.893000	464	544	12	19	80	0.2375000
NODE_5029_length_1099_cov_85.893000	464	544	14	19	80	0.2375000
NODE_5029_length_1099_cov_85.893000	517	597	4	25	80	0.3125000
NODE_5029_length_1099_cov_85.893000	517	597	6	8	80	0.1000000
NODE_5029_length_1099_cov_85.893000	517	597	10	16	80	0.2000000
NODE_5029_length_1099_cov_85.893000	517	597	11	14	80	0.1750000
NODE_5029_length_1099_cov_85.893000	517	597	12	17	80	0.2125000
NODE_5029_length_1099_cov_85.893000	593	673	0	74	80	0.9250000
NODE_5029_length_1099_cov_85.893000	593	673	4	6	80	0.0750000
NODE_5029_length_1099_cov_85.893000	646	726	0	80	80	1.0000000
NODE_5030_length_1099_cov_45.874000	521	601	0	80	80	1.0000000
NODE_5030_length_1099_cov_45.874000	574	654	0	80	80	1.0000000
NODE_5030_length_1099_cov_45.874000	650	730	0	41	80	0.5125000
NODE_5030_length_1099_cov_45.874000	650	730	4	39	80	0.4875000
NODE_5030_length_1099_cov_45.874000	703	783	4	27	80	0.3375000
NODE_5030_length_1099_cov_45.874000	703	783	6	13	80	0.1625000
NODE_5030_length_1099_cov_45.874000	703	783	8	40	80	0.5000000
NODE_5031_length_1099_cov_25.192000	526	606	0	26	80	0.3250000
NODE_5031_length_1099_cov_25.192000	526	606	2	54	80	0.6750000
NODE_5031_length_1099_cov_25.192000	579	659	2	77	80	0.9625000
NODE_5031_length_1099_cov_25.192000	579	659	4	3	80	0.0375000
NODE_5032_length_1099_cov_11.846000	565	645	0	46	80	0.5750000
NODE_5032_length_1099_cov_11.846000	565	645	2	34	80	0.4250000
NODE_5032_length_1099_cov_11.846000	618	698	0	3	80	0.0375000
NODE_5032_length_1099_cov_11.846000	618	698	2	77	80	0.9625000
NODE_5033_length_1099_cov_9.527000	495	575	12	32	80	0.4000000
NODE_5033_length_1099_cov_9.527000	495	575	14	48	80	0.6000000
NODE_5033_length_1099_cov_9.527000	548	628	0	7	80	0.0875000
NODE_5033_length_1099_cov_9.527000	548	628	2	2	80	0.0250000
NODE_5033_length_1099_cov_9.527000	548	628	4	14	80	0.1750000
NODE_5033_length_1099_cov_9.527000	548	628	6	13	80	0.1625000
NODE_5033_length_1099_cov_9.527000	548	628	8	14	80	0.1750000
NODE_5033_length_1099_cov_9.527000	548	628	10	1	80	0.0125000
NODE_5033_length_1099_cov_9.527000	548	628	12	16	80	0.2000000
NODE_5033_length_1099_cov_9.527000	548	628	14	13	80	0.1625000
NODE_5034_length_1099_cov_8.993000	464	544	0	80	80	1.0000000
NODE_5034_length_1099_cov_8.993000	517	597	0	80	80	1.0000000
NODE_5039_length_1099_cov_2.286000	273	353	2	49	80	0.6125000
NODE_5039_length_1099_cov_2.286000	273	353	4	31	80	0.3875000
NODE_5045_length_1098_cov_44.988989	360	440	0	80	80	1.0000000
NODE_5045_length_1098_cov_44.988989	413	493	0	80	80	1.0000000
NODE_5046_length_1098_cov_35.192192	452	532	4	58	80	0.7250000
NODE_5046_length_1098_cov_35.192192	452	532	6	22	80	0.2750000
NODE_5046_length_1098_cov_35.192192	505	585	0	22	80	0.2750000
NODE_5046_length_1098_cov_35.192192	505	585	2	16	80	0.2000000
NODE_5046_length_1098_cov_35.192192	505	585	4	30	80	0.3750000
NODE_5046_length_1098_cov_35.192192	505	585	6	12	80	0.1500000
NODE_5046_length_1098_cov_35.192192	581	661	0	52	80	0.6500000
NODE_5046_length_1098_cov_35.192192	581	661	2	9	80	0.1125000
NODE_5046_length_1098_cov_35.192192	581	661	6	19	80	0.2375000
NODE_5046_length_1098_cov_35.192192	634	714	2	8	80	0.1000000
NODE_5046_length_1098_cov_35.192192	634	714	6	72	80	0.9000000
NODE_5047_length_1098_cov_28.743744	449	529	0	1	80	0.0125000
NODE_5047_length_1098_cov_28.743744	449	529	4	23	80	0.2875000
NODE_5047_length_1098_cov_28.743744	449	529	6	34	80	0.4250000
NODE_5047_length_1098_cov_28.743744	449	529	8	22	80	0.2750000
NODE_5047_length_1098_cov_28.743744	502	582	0	54	80	0.6750000
NODE_5047_length_1098_cov_28.743744	502	582	4	23	80	0.2875000
NODE_5047_length_1098_cov_28.743744	502	582	6	3	80	0.0375000
NODE_5047_length_1098_cov_28.743744	578	658	0	21	80	0.2625000
NODE_5047_length_1098_cov_28.743744	578	658	4	39	80	0.4875000
NODE_5047_length_1098_cov_28.743744	578	658	6	1	80	0.0125000
NODE_5047_length_1098_cov_28.743744	578	658	10	1	80	0.0125000
NODE_5047_length_1098_cov_28.743744	578	658	14	4	80	0.0500000
NODE_5047_length_1098_cov_28.743744	578	658	16	14	80	0.1750000
NODE_5047_length_1098_cov_28.743744	631	711	4	7	80	0.0875000
NODE_5047_length_1098_cov_28.743744	631	711	6	1	80	0.0125000
NODE_5047_length_1098_cov_28.743744	631	711	10	1	80	0.0125000
NODE_5047_length_1098_cov_28.743744	631	711	14	4	80	0.0500000
NODE_5047_length_1098_cov_28.743744	631	711	16	67	80	0.8375000
NODE_5048_length_1098_cov_28.230230	477	557	0	21	80	0.2625000
NODE_5048_length_1098_cov_28.230230	477	557	2	59	80	0.7375000
NODE_5048_length_1098_cov_28.230230	530	610	2	74	80	0.9250000
NODE_5048_length_1098_cov_28.230230	530	610	4	6	80	0.0750000
NODE_5048_length_1098_cov_28.230230	606	686	2	61	80	0.7625000
NODE_5048_length_1098_cov_28.230230	606	686	4	19	80	0.2375000
NODE_5048_length_1098_cov_28.230230	659	739	2	44	80	0.5500000
NODE_5048_length_1098_cov_28.230230	659	739	4	36	80	0.4500000
NODE_5049_length_1098_cov_26.131131	494	574	0	80	80	1.0000000
NODE_5049_length_1098_cov_26.131131	547	627	0	36	80	0.4500000
NODE_5049_length_1098_cov_26.131131	547	627	2	44	80	0.5500000
NODE_5050_length_1098_cov_21.355355	599	679	4	9	80	0.1125000
NODE_5050_length_1098_cov_21.355355	599	679	8	34	80	0.4250000
NODE_5050_length_1098_cov_21.355355	599	679	10	26	80	0.3250000
NODE_5050_length_1098_cov_21.355355	599	679	12	11	80	0.1375000
NODE_5050_length_1098_cov_21.355355	652	732	0	32	80	0.4000000
NODE_5050_length_1098_cov_21.355355	652	732	2	5	80	0.0625000
NODE_5050_length_1098_cov_21.355355	652	732	4	25	80	0.3125000
NODE_5050_length_1098_cov_21.355355	652	732	8	18	80	0.2250000
NODE_5051_length_1098_cov_17.087087	541	621	0	80	80	1.0000000
NODE_5051_length_1098_cov_17.087087	594	674	0	80	80	1.0000000
NODE_5051_length_1098_cov_17.087087	670	750	0	69	80	0.8625000
NODE_5051_length_1098_cov_17.087087	670	750	4	11	80	0.1375000
NODE_5051_length_1098_cov_17.087087	723	803	0	16	80	0.2000000
NODE_5051_length_1098_cov_17.087087	723	803	4	64	80	0.8000000
NODE_5052_length_1098_cov_15.455455	545	625	0	36	80	0.4500000
NODE_5052_length_1098_cov_15.455455	545	625	2	44	80	0.5500000
NODE_5052_length_1098_cov_15.455455	598	678	0	80	80	1.0000000
NODE_5052_length_1098_cov_15.455455	674	754	0	80	80	1.0000000
NODE_5052_length_1098_cov_15.455455	727	807	0	80	80	1.0000000
NODE_5054_length_1097_cov_37.103206	438	518	2	80	80	1.0000000
NODE_5054_length_1097_cov_37.103206	491	571	0	49	80	0.6125000
NODE_5054_length_1097_cov_37.103206	491	571	2	31	80	0.3875000
NODE_5054_length_1097_cov_37.103206	567	647	0	18	80	0.2250000
NODE_5054_length_1097_cov_37.103206	567	647	4	62	80	0.7750000
NODE_5054_length_1097_cov_37.103206	620	700	4	79	80	0.9875000
NODE_5054_length_1097_cov_37.103206	620	700	6	1	80	0.0125000
NODE_5055_length_1097_cov_32.624248	501	581	0	1	80	0.0125000
NODE_5055_length_1097_cov_32.624248	501	581	2	79	80	0.9875000
NODE_5055_length_1097_cov_32.624248	554	634	0	54	80	0.6750000
NODE_5055_length_1097_cov_32.624248	554	634	2	26	80	0.3250000
NODE_5056_length_1097_cov_25.240481	401	480	0	37	79	0.4683544
NODE_5056_length_1097_cov_25.240481	401	480	2	18	79	0.2278481
NODE_5056_length_1097_cov_25.240481	401	480	4	24	79	0.3037975
NODE_5056_length_1097_cov_25.240481	453	533	2	3	80	0.0375000
NODE_5056_length_1097_cov_25.240481	453	533	4	77	80	0.9625000
NODE_5056_length_1097_cov_25.240481	529	609	0	54	80	0.6750000
NODE_5056_length_1097_cov_25.240481	529	609	2	8	80	0.1000000
NODE_5056_length_1097_cov_25.240481	529	609	4	18	80	0.2250000
NODE_5056_length_1097_cov_25.240481	582	662	0	80	80	1.0000000
NODE_5057_length_1097_cov_21.221443	484	564	0	80	80	1.0000000
NODE_5057_length_1097_cov_21.221443	537	617	0	80	80	1.0000000
NODE_5057_length_1097_cov_21.221443	613	693	0	48	80	0.6000000
NODE_5057_length_1097_cov_21.221443	613	693	2	32	80	0.4000000
NODE_5057_length_1097_cov_21.221443	666	746	0	8	80	0.1000000
NODE_5057_length_1097_cov_21.221443	666	746	2	72	80	0.9000000
NODE_5058_length_1097_cov_20.968938	515	595	0	80	80	1.0000000
NODE_5058_length_1097_cov_20.968938	568	648	0	80	80	1.0000000
NODE_5059_length_1097_cov_13.136273	697	779	2	45	82	0.5487805
NODE_5059_length_1097_cov_13.136273	697	779	4	37	82	0.4512195
NODE_5059_length_1097_cov_13.136273	752	832	0	49	80	0.6125000
NODE_5059_length_1097_cov_13.136273	752	832	2	31	80	0.3875000
NODE_5060_length_1097_cov_6.376754	442	522	0	12	80	0.1500000
NODE_5060_length_1097_cov_6.376754	442	522	2	35	80	0.4375000
NODE_5060_length_1097_cov_6.376754	442	522	3	4	80	0.0500000
NODE_5060_length_1097_cov_6.376754	442	522	5	12	80	0.1500000
NODE_5060_length_1097_cov_6.376754	442	522	7	1	80	0.0125000
NODE_5060_length_1097_cov_6.376754	442	522	11	6	80	0.0750000
NODE_5060_length_1097_cov_6.376754	442	522	13	1	80	0.0125000
NODE_5060_length_1097_cov_6.376754	442	522	14	5	80	0.0625000
NODE_5060_length_1097_cov_6.376754	442	522	18	4	80	0.0500000
NODE_5060_length_1097_cov_6.376754	495	575	5	10	80	0.1250000
NODE_5060_length_1097_cov_6.376754	495	575	7	1	80	0.0125000
NODE_5060_length_1097_cov_6.376754	495	575	11	6	80	0.0750000
NODE_5060_length_1097_cov_6.376754	495	575	13	1	80	0.0125000
NODE_5060_length_1097_cov_6.376754	495	575	14	5	80	0.0625000
NODE_5060_length_1097_cov_6.376754	495	575	18	57	80	0.7125000
NODE_5061_length_1097_cov_6.068136	299	379	0	80	80	1.0000000
NODE_5061_length_1097_cov_6.068136	352	432	0	80	80	1.0000000
NODE_5072_length_1096_cov_55.816449	430	510	0	7	80	0.0875000
NODE_5072_length_1096_cov_55.816449	430	510	2	73	80	0.9125000
NODE_5072_length_1096_cov_55.816449	483	563	2	28	80	0.3500000
NODE_5072_length_1096_cov_55.816449	483	563	4	44	80	0.5500000
NODE_5072_length_1096_cov_55.816449	483	563	6	8	80	0.1000000
NODE_5072_length_1096_cov_55.816449	559	639	5	24	80	0.3000000
NODE_5072_length_1096_cov_55.816449	559	639	6	16	80	0.2000000
NODE_5072_length_1096_cov_55.816449	559	639	8	40	80	0.5000000
NODE_5072_length_1096_cov_55.816449	612	692	4	32	80	0.4000000
NODE_5072_length_1096_cov_55.816449	612	692	5	45	80	0.5625000
NODE_5072_length_1096_cov_55.816449	612	692	6	3	80	0.0375000
NODE_5073_length_1096_cov_24.672016	431	511	0	80	80	1.0000000
NODE_5073_length_1096_cov_24.672016	484	564	0	80	80	1.0000000
NODE_5073_length_1096_cov_24.672016	560	640	0	20	80	0.2500000
NODE_5073_length_1096_cov_24.672016	560	640	2	60	80	0.7500000
NODE_5073_length_1096_cov_24.672016	613	693	2	80	80	1.0000000
NODE_5074_length_1096_cov_22.980943	372	452	2	80	80	1.0000000
NODE_5074_length_1096_cov_22.980943	425	505	0	53	80	0.6625000
NODE_5074_length_1096_cov_22.980943	425	505	2	27	80	0.3375000
NODE_5075_length_1096_cov_16.649950	486	566	2	18	80	0.2250000
NODE_5075_length_1096_cov_16.649950	486	566	4	60	80	0.7500000
NODE_5075_length_1096_cov_16.649950	486	566	6	2	80	0.0250000
NODE_5075_length_1096_cov_16.649950	539	619	0	9	80	0.1125000
NODE_5075_length_1096_cov_16.649950	539	619	2	62	80	0.7750000
NODE_5075_length_1096_cov_16.649950	539	619	4	9	80	0.1125000
NODE_5076_length_1096_cov_16.433300	443	523	0	31	80	0.3875000
NODE_5076_length_1096_cov_16.433300	443	523	2	49	80	0.6125000
NODE_5076_length_1096_cov_16.433300	496	576	0	80	80	1.0000000
NODE_5076_length_1096_cov_16.433300	886	966	0	80	80	1.0000000
NODE_5076_length_1096_cov_16.433300	939	1018	0	58	79	0.7341772
NODE_5076_length_1096_cov_16.433300	939	1018	2	21	79	0.2658228
NODE_5077_length_1096_cov_13.398195	670	750	0	8	80	0.1000000
NODE_5077_length_1096_cov_13.398195	670	750	4	72	80	0.9000000
NODE_5077_length_1096_cov_13.398195	723	803	0	28	80	0.3500000
NODE_5077_length_1096_cov_13.398195	723	803	4	52	80	0.6500000
NODE_5080_length_1095_cov_25.390562	520	600	0	80	80	1.0000000
NODE_5080_length_1095_cov_25.390562	573	653	0	80	80	1.0000000
NODE_5080_length_1095_cov_25.390562	649	729	0	80	80	1.0000000
NODE_5080_length_1095_cov_25.390562	702	782	0	80	80	1.0000000
NODE_5081_length_1095_cov_13.832329	549	629	0	80	80	1.0000000
NODE_5081_length_1095_cov_13.832329	602	682	0	80	80	1.0000000
NODE_5082_length_1095_cov_13.017068	497	577	0	40	80	0.5000000
NODE_5082_length_1095_cov_13.017068	497	577	2	40	80	0.5000000
NODE_5082_length_1095_cov_13.017068	550	630	2	51	80	0.6375000
NODE_5082_length_1095_cov_13.017068	550	630	4	29	80	0.3625000
NODE_5083_length_1095_cov_7.640562	627	707	0	80	80	1.0000000
NODE_5083_length_1095_cov_7.640562	680	760	0	80	80	1.0000000
NODE_5085_length_1095_cov_4.664659	307	387	0	80	80	1.0000000
NODE_5089_length_1094_cov_35.850251	409	489	0	4	80	0.0500000
NODE_5089_length_1094_cov_35.850251	409	489	2	40	80	0.5000000
NODE_5089_length_1094_cov_35.850251	409	489	4	36	80	0.4500000
NODE_5089_length_1094_cov_35.850251	462	542	0	49	80	0.6125000
NODE_5089_length_1094_cov_35.850251	462	542	1	7	80	0.0875000
NODE_5089_length_1094_cov_35.850251	462	542	2	23	80	0.2875000
NODE_5089_length_1094_cov_35.850251	462	542	3	1	80	0.0125000
NODE_5089_length_1094_cov_35.850251	538	618	1	3	80	0.0375000
NODE_5089_length_1094_cov_35.850251	538	618	3	77	80	0.9625000
NODE_5089_length_1094_cov_35.850251	591	671	1	15	80	0.1875000
NODE_5089_length_1094_cov_35.850251	591	671	2	17	80	0.2125000
NODE_5089_length_1094_cov_35.850251	591	671	3	48	80	0.6000000
NODE_5090_length_1094_cov_27.197990	462	542	0	45	80	0.5625000
NODE_5090_length_1094_cov_27.197990	462	542	3	1	80	0.0125000
NODE_5090_length_1094_cov_27.197990	462	542	4	34	80	0.4250000
NODE_5090_length_1094_cov_27.197990	515	595	4	80	80	1.0000000
NODE_5091_length_1094_cov_19.282412	451	531	6	10	80	0.1250000
NODE_5091_length_1094_cov_19.282412	451	531	8	10	80	0.1250000
NODE_5091_length_1094_cov_19.282412	451	531	10	7	80	0.0875000
NODE_5091_length_1094_cov_19.282412	451	531	12	11	80	0.1375000
NODE_5091_length_1094_cov_19.282412	451	531	14	3	80	0.0375000
NODE_5091_length_1094_cov_19.282412	451	531	19	1	80	0.0125000
NODE_5091_length_1094_cov_19.282412	451	531	20	38	80	0.4750000
NODE_5091_length_1094_cov_19.282412	504	584	8	18	80	0.2250000
NODE_5091_length_1094_cov_19.282412	504	584	10	14	80	0.1750000
NODE_5091_length_1094_cov_19.282412	504	584	14	12	80	0.1500000
NODE_5091_length_1094_cov_19.282412	504	584	20	36	80	0.4500000
NODE_5092_length_1094_cov_16.084422	558	614	0	56	56	1.0000000
NODE_5092_length_1094_cov_16.084422	587	667	0	63	80	0.7875000
NODE_5092_length_1094_cov_16.084422	587	667	2	17	80	0.2125000
NODE_5093_length_1094_cov_11.335678	384	464	10	2	80	0.0250000
NODE_5093_length_1094_cov_11.335678	384	464	12	44	80	0.5500000
NODE_5093_length_1094_cov_11.335678	384	464	18	16	80	0.2000000
NODE_5093_length_1094_cov_11.335678	384	464	19	1	80	0.0125000
NODE_5093_length_1094_cov_11.335678	384	464	20	17	80	0.2125000
NODE_5093_length_1094_cov_11.335678	437	517	0	12	80	0.1500000
NODE_5093_length_1094_cov_11.335678	437	517	7	2	80	0.0250000
NODE_5093_length_1094_cov_11.335678	437	517	8	18	80	0.2250000
NODE_5093_length_1094_cov_11.335678	437	517	10	10	80	0.1250000
NODE_5093_length_1094_cov_11.335678	437	517	12	38	80	0.4750000
NODE_5094_length_1094_cov_10.767839	396	476	0	60	80	0.7500000
NODE_5094_length_1094_cov_10.767839	396	476	2	20	80	0.2500000
NODE_5094_length_1094_cov_10.767839	449	529	0	7	80	0.0875000
NODE_5094_length_1094_cov_10.767839	449	529	2	53	80	0.6625000
NODE_5094_length_1094_cov_10.767839	449	529	4	20	80	0.2500000
NODE_5095_length_1094_cov_9.527638	579	659	0	8	80	0.1000000
NODE_5095_length_1094_cov_9.527638	579	659	2	8	80	0.1000000
NODE_5095_length_1094_cov_9.527638	579	659	6	64	80	0.8000000
NODE_5095_length_1094_cov_9.527638	632	712	0	25	80	0.3125000
NODE_5095_length_1094_cov_9.527638	632	712	2	7	80	0.0875000
NODE_5095_length_1094_cov_9.527638	632	712	6	48	80	0.6000000
NODE_5096_length_1094_cov_9.166834	527	607	0	80	80	1.0000000
NODE_5096_length_1094_cov_9.166834	580	660	0	28	80	0.3500000
NODE_5096_length_1094_cov_9.166834	580	660	1	34	80	0.4250000
NODE_5096_length_1094_cov_9.166834	580	660	2	18	80	0.2250000
NODE_5097_length_1094_cov_5.632161	708	768	0	22	60	0.3666667
NODE_5097_length_1094_cov_5.632161	708	768	2	11	60	0.1833333
NODE_5097_length_1094_cov_5.632161	708	768	4	27	60	0.4500000
NODE_5097_length_1094_cov_5.632161	761	821	4	32	60	0.5333334
NODE_5097_length_1094_cov_5.632161	761	821	6	28	60	0.4666667
NODE_5108_length_1093_cov_28.531187	374	454	6	4	80	0.0500000
NODE_5108_length_1093_cov_28.531187	374	454	8	57	80	0.7125000
NODE_5108_length_1093_cov_28.531187	374	454	10	19	80	0.2375000
NODE_5108_length_1093_cov_28.531187	427	507	2	22	80	0.2750000
NODE_5108_length_1093_cov_28.531187	427	507	8	53	80	0.6625000
NODE_5108_length_1093_cov_28.531187	427	507	10	5	80	0.0625000
NODE_5109_length_1093_cov_22.744467	516	596	1	55	80	0.6875000
NODE_5109_length_1093_cov_22.744467	516	596	2	9	80	0.1125000
NODE_5109_length_1093_cov_22.744467	516	596	3	16	80	0.2000000
NODE_5109_length_1093_cov_22.744467	569	649	1	11	80	0.1375000
NODE_5109_length_1093_cov_22.744467	569	649	2	39	80	0.4875000
NODE_5109_length_1093_cov_22.744467	569	649	3	30	80	0.3750000
NODE_5109_length_1093_cov_22.744467	645	725	0	18	80	0.2250000
NODE_5109_length_1093_cov_22.744467	645	725	2	62	80	0.7750000
NODE_5109_length_1093_cov_22.744467	698	778	0	71	80	0.8875000
NODE_5109_length_1093_cov_22.744467	698	778	2	9	80	0.1125000
NODE_5110_length_1093_cov_11.637827	282	362	0	22	80	0.2750000
NODE_5110_length_1093_cov_11.637827	282	362	2	16	80	0.2000000
NODE_5110_length_1093_cov_11.637827	282	362	4	42	80	0.5250000
NODE_5110_length_1093_cov_11.637827	335	415	0	3	80	0.0375000
NODE_5110_length_1093_cov_11.637827	335	415	2	42	80	0.5250000
NODE_5110_length_1093_cov_11.637827	335	415	4	35	80	0.4375000
NODE_5111_length_1093_cov_9.047284	660	740	0	21	80	0.2625000
NODE_5111_length_1093_cov_9.047284	660	740	2	59	80	0.7375000
NODE_5111_length_1093_cov_9.047284	713	793	0	74	80	0.9250000
NODE_5111_length_1093_cov_9.047284	713	793	2	6	80	0.0750000
NODE_5112_length_1093_cov_6.857143	658	738	0	13	80	0.1625000
NODE_5112_length_1093_cov_6.857143	658	738	2	67	80	0.8375000
NODE_5112_length_1093_cov_6.857143	711	791	2	66	80	0.8250000
NODE_5112_length_1093_cov_6.857143	711	791	4	14	80	0.1750000
NODE_5113_length_1093_cov_5.311871	587	667	0	80	80	1.0000000
NODE_5113_length_1093_cov_5.311871	640	720	0	80	80	1.0000000
NODE_5118_length_1092_cov_105.542800	682	768	84	1	86	0.0116279
NODE_5118_length_1092_cov_105.542800	682	768	86	1	86	0.0116279
NODE_5118_length_1092_cov_105.542800	682	768	88	2	86	0.0232558
NODE_5118_length_1092_cov_105.542800	682	768	90	2	86	0.0232558
NODE_5118_length_1092_cov_105.542800	682	768	92	1	86	0.0116279
NODE_5118_length_1092_cov_105.542800	682	768	96	1	86	0.0116279
NODE_5118_length_1092_cov_105.542800	682	768	103	1	86	0.0116279
NODE_5118_length_1092_cov_105.542800	682	768	113	1	86	0.0116279
NODE_5118_length_1092_cov_105.542800	682	768	114	1	86	0.0116279
NODE_5118_length_1092_cov_105.542800	682	768	120	1	86	0.0116279
NODE_5118_length_1092_cov_105.542800	682	768	136	1	86	0.0116279
NODE_5118_length_1092_cov_105.542800	682	768	142	1	86	0.0116279
NODE_5118_length_1092_cov_105.542800	682	768	151	1	86	0.0116279
NODE_5118_length_1092_cov_105.542800	682	768	166	1	86	0.0116279
NODE_5118_length_1092_cov_105.542800	682	768	178	1	86	0.0116279
NODE_5118_length_1092_cov_105.542800	682	768	180	2	86	0.0232558
NODE_5118_length_1092_cov_105.542800	682	768	181	1	86	0.0116279
NODE_5118_length_1092_cov_105.542800	682	768	190	1	86	0.0116279
NODE_5118_length_1092_cov_105.542800	682	768	195	1	86	0.0116279
NODE_5118_length_1092_cov_105.542800	682	768	200	1	86	0.0116279
NODE_5118_length_1092_cov_105.542800	682	768	201	1	86	0.0116279
NODE_5118_length_1092_cov_105.542800	682	768	208	1	86	0.0116279
NODE_5118_length_1092_cov_105.542800	682	768	210	1	86	0.0116279
NODE_5118_length_1092_cov_105.542800	682	768	214	1	86	0.0116279
NODE_5118_length_1092_cov_105.542800	682	768	236	1	86	0.0116279
NODE_5118_length_1092_cov_105.542800	682	768	248	1	86	0.0116279
NODE_5118_length_1092_cov_105.542800	682	768	251	1	86	0.0116279
NODE_5118_length_1092_cov_105.542800	682	768	257	1	86	0.0116279
NODE_5118_length_1092_cov_105.542800	682	768	263	1	86	0.0116279
NODE_5118_length_1092_cov_105.542800	682	768	265	1	86	0.0116279
NODE_5118_length_1092_cov_105.542800	682	768	271	1	86	0.0116279
NODE_5118_length_1092_cov_105.542800	682	768	281	1	86	0.0116279
NODE_5118_length_1092_cov_105.542800	682	768	282	1	86	0.0116279
NODE_5118_length_1092_cov_105.542800	682	768	284	2	86	0.0232558
NODE_5118_length_1092_cov_105.542800	682	768	288	1	86	0.0116279
NODE_5118_length_1092_cov_105.542800	682	768	296	1	86	0.0116279
NODE_5118_length_1092_cov_105.542800	682	768	301	1	86	0.0116279
NODE_5118_length_1092_cov_105.542800	682	768	306	2	86	0.0232558
NODE_5118_length_1092_cov_105.542800	682	768	333	1	86	0.0116279
NODE_5118_length_1092_cov_105.542800	682	768	334	1	86	0.0116279
NODE_5118_length_1092_cov_105.542800	682	768	335	1	86	0.0116279
NODE_5118_length_1092_cov_105.542800	682	768	338	1	86	0.0116279
NODE_5118_length_1092_cov_105.542800	682	768	339	1	86	0.0116279
NODE_5118_length_1092_cov_105.542800	682	768	345	1	86	0.0116279
NODE_5118_length_1092_cov_105.542800	682	768	350	2	86	0.0232558
NODE_5118_length_1092_cov_105.542800	682	768	352	1	86	0.0116279
NODE_5118_length_1092_cov_105.542800	682	768	355	1	86	0.0116279
NODE_5118_length_1092_cov_105.542800	682	768	361	2	86	0.0232558
NODE_5118_length_1092_cov_105.542800	682	768	365	1	86	0.0116279
NODE_5118_length_1092_cov_105.542800	682	768	367	1	86	0.0116279
NODE_5118_length_1092_cov_105.542800	682	768	368	3	86	0.0348837
NODE_5118_length_1092_cov_105.542800	682	768	369	4	86	0.0465116
NODE_5118_length_1092_cov_105.542800	682	768	370	6	86	0.0697674
NODE_5118_length_1092_cov_105.542800	682	768	371	3	86	0.0348837
NODE_5118_length_1092_cov_105.542800	682	768	372	5	86	0.0581395
NODE_5118_length_1092_cov_105.542800	682	768	373	2	86	0.0232558
NODE_5118_length_1092_cov_105.542800	682	768	374	3	86	0.0348837
NODE_5118_length_1092_cov_105.542800	682	768	375	1	86	0.0116279
NODE_5118_length_1092_cov_105.542800	682	768	376	2	86	0.0232558
NODE_5118_length_1092_cov_105.542800	745	807	219	1	62	0.0161290
NODE_5118_length_1092_cov_105.542800	745	807	221	1	62	0.0161290
NODE_5118_length_1092_cov_105.542800	745	807	224	1	62	0.0161290
NODE_5118_length_1092_cov_105.542800	745	807	234	1	62	0.0161290
NODE_5118_length_1092_cov_105.542800	745	807	250	2	62	0.0322581
NODE_5118_length_1092_cov_105.542800	745	807	254	1	62	0.0161290
NODE_5118_length_1092_cov_105.542800	745	807	266	2	62	0.0322581
NODE_5118_length_1092_cov_105.542800	745	807	272	1	62	0.0161290
NODE_5118_length_1092_cov_105.542800	745	807	277	1	62	0.0161290
NODE_5118_length_1092_cov_105.542800	745	807	293	1	62	0.0161290
NODE_5118_length_1092_cov_105.542800	745	807	295	2	62	0.0322581
NODE_5118_length_1092_cov_105.542800	745	807	303	1	62	0.0161290
NODE_5118_length_1092_cov_105.542800	745	807	305	1	62	0.0161290
NODE_5118_length_1092_cov_105.542800	745	807	307	1	62	0.0161290
NODE_5118_length_1092_cov_105.542800	745	807	309	2	62	0.0322581
NODE_5118_length_1092_cov_105.542800	745	807	314	1	62	0.0161290
NODE_5118_length_1092_cov_105.542800	745	807	315	3	62	0.0483871
NODE_5118_length_1092_cov_105.542800	745	807	323	1	62	0.0161290
NODE_5118_length_1092_cov_105.542800	745	807	325	1	62	0.0161290
NODE_5118_length_1092_cov_105.542800	745	807	331	1	62	0.0161290
NODE_5118_length_1092_cov_105.542800	745	807	332	1	62	0.0161290
NODE_5118_length_1092_cov_105.542800	745	807	336	2	62	0.0322581
NODE_5118_length_1092_cov_105.542800	745	807	347	1	62	0.0161290
NODE_5118_length_1092_cov_105.542800	745	807	348	2	62	0.0322581
NODE_5118_length_1092_cov_105.542800	745	807	350	2	62	0.0322581
NODE_5118_length_1092_cov_105.542800	745	807	351	2	62	0.0322581
NODE_5118_length_1092_cov_105.542800	745	807	353	1	62	0.0161290
NODE_5118_length_1092_cov_105.542800	745	807	361	1	62	0.0161290
NODE_5118_length_1092_cov_105.542800	745	807	362	1	62	0.0161290
NODE_5118_length_1092_cov_105.542800	745	807	368	2	62	0.0322581
NODE_5118_length_1092_cov_105.542800	745	807	369	4	62	0.0645161
NODE_5118_length_1092_cov_105.542800	745	807	370	2	62	0.0322581
NODE_5118_length_1092_cov_105.542800	745	807	371	2	62	0.0322581
NODE_5118_length_1092_cov_105.542800	745	807	372	5	62	0.0806452
NODE_5118_length_1092_cov_105.542800	745	807	373	2	62	0.0322581
NODE_5118_length_1092_cov_105.542800	745	807	374	3	62	0.0483871
NODE_5118_length_1092_cov_105.542800	745	807	375	1	62	0.0161290
NODE_5118_length_1092_cov_105.542800	745	807	376	2	62	0.0322581
NODE_5119_length_1092_cov_30.957704	610	690	2	14	80	0.1750000
NODE_5119_length_1092_cov_30.957704	610	690	4	66	80	0.8250000
NODE_5119_length_1092_cov_30.957704	663	743	0	27	80	0.3375000
NODE_5119_length_1092_cov_30.957704	663	743	1	3	80	0.0375000
NODE_5119_length_1092_cov_30.957704	663	743	2	37	80	0.4625000
NODE_5119_length_1092_cov_30.957704	663	743	4	13	80	0.1625000
NODE_5121_length_1092_cov_16.737160	725	805	2	56	80	0.7000000
NODE_5121_length_1092_cov_16.737160	725	805	6	24	80	0.3000000
NODE_5121_length_1092_cov_16.737160	778	858	0	16	80	0.2000000
NODE_5121_length_1092_cov_16.737160	778	858	2	3	80	0.0375000
NODE_5121_length_1092_cov_16.737160	778	858	4	12	80	0.1500000
NODE_5121_length_1092_cov_16.737160	778	858	6	49	80	0.6125000
NODE_5123_length_1092_cov_11.193353	335	415	0	80	80	1.0000000
NODE_5123_length_1092_cov_11.193353	388	468	0	80	80	1.0000000
NODE_5124_length_1092_cov_9.348439	489	569	0	80	80	1.0000000
NODE_5124_length_1092_cov_9.348439	542	622	0	78	80	0.9750000
NODE_5124_length_1092_cov_9.348439	542	622	2	2	80	0.0250000
NODE_5125_length_1092_cov_7.533736	243	323	0	11	80	0.1375000
NODE_5125_length_1092_cov_7.533736	243	323	2	50	80	0.6250000
NODE_5125_length_1092_cov_7.533736	243	323	4	19	80	0.2375000
NODE_5125_length_1092_cov_7.533736	296	376	0	64	80	0.8000000
NODE_5125_length_1092_cov_7.533736	296	376	2	16	80	0.2000000
NODE_5126_length_1092_cov_6.968781	470	550	0	80	80	1.0000000
NODE_5126_length_1092_cov_6.968781	523	603	0	38	80	0.4750000
NODE_5126_length_1092_cov_6.968781	523	603	2	42	80	0.5250000
NODE_5134_length_1091_cov_54.234879	417	497	0	6	80	0.0750000
NODE_5134_length_1091_cov_54.234879	417	497	2	16	80	0.2000000
NODE_5134_length_1091_cov_54.234879	417	497	4	10	80	0.1250000
NODE_5134_length_1091_cov_54.234879	417	497	6	4	80	0.0500000
NODE_5134_length_1091_cov_54.234879	417	497	8	44	80	0.5500000
NODE_5134_length_1091_cov_54.234879	470	550	2	8	80	0.1000000
NODE_5134_length_1091_cov_54.234879	470	550	4	17	80	0.2125000
NODE_5134_length_1091_cov_54.234879	470	550	6	13	80	0.1625000
NODE_5134_length_1091_cov_54.234879	470	550	8	42	80	0.5250000
NODE_5134_length_1091_cov_54.234879	546	626	0	33	80	0.4125000
NODE_5134_length_1091_cov_54.234879	546	626	2	14	80	0.1750000
NODE_5134_length_1091_cov_54.234879	546	626	4	23	80	0.2875000
NODE_5134_length_1091_cov_54.234879	546	626	6	10	80	0.1250000
NODE_5134_length_1091_cov_54.234879	599	679	4	34	80	0.4250000
NODE_5134_length_1091_cov_54.234879	599	679	6	46	80	0.5750000
NODE_5135_length_1091_cov_35.045363	384	464	0	8	80	0.1000000
NODE_5135_length_1091_cov_35.045363	384	464	4	72	80	0.9000000
NODE_5135_length_1091_cov_35.045363	437	517	2	18	80	0.2250000
NODE_5135_length_1091_cov_35.045363	437	517	4	42	80	0.5250000
NODE_5135_length_1091_cov_35.045363	437	517	6	20	80	0.2500000
NODE_5135_length_1091_cov_35.045363	513	593	2	3	80	0.0375000
NODE_5135_length_1091_cov_35.045363	513	593	4	77	80	0.9625000
NODE_5135_length_1091_cov_35.045363	566	646	0	9	80	0.1125000
NODE_5135_length_1091_cov_35.045363	566	646	2	47	80	0.5875000
NODE_5135_length_1091_cov_35.045363	566	646	4	24	80	0.3000000
NODE_5136_length_1091_cov_28.490927	329	409	0	80	80	1.0000000
NODE_5136_length_1091_cov_28.490927	382	462	0	58	80	0.7250000
NODE_5136_length_1091_cov_28.490927	382	462	2	22	80	0.2750000
NODE_5136_length_1091_cov_28.490927	618	698	0	15	80	0.1875000
NODE_5136_length_1091_cov_28.490927	618	698	2	65	80	0.8125000
NODE_5136_length_1091_cov_28.490927	671	751	0	13	80	0.1625000
NODE_5136_length_1091_cov_28.490927	671	751	2	67	80	0.8375000
NODE_5137_length_1091_cov_23.733871	514	594	2	18	80	0.2250000
NODE_5137_length_1091_cov_23.733871	514	594	4	1	80	0.0125000
NODE_5137_length_1091_cov_23.733871	514	594	6	4	80	0.0500000
NODE_5137_length_1091_cov_23.733871	514	594	12	11	80	0.1375000
NODE_5137_length_1091_cov_23.733871	514	594	14	15	80	0.1875000
NODE_5137_length_1091_cov_23.733871	514	594	16	31	80	0.3875000
NODE_5137_length_1091_cov_23.733871	567	647	8	9	80	0.1125000
NODE_5137_length_1091_cov_23.733871	567	647	10	28	80	0.3500000
NODE_5137_length_1091_cov_23.733871	567	647	12	3	80	0.0375000
NODE_5137_length_1091_cov_23.733871	567	647	14	17	80	0.2125000
NODE_5137_length_1091_cov_23.733871	567	647	16	23	80	0.2875000
NODE_5138_length_1091_cov_13.065524	444	524	2	8	80	0.1000000
NODE_5138_length_1091_cov_13.065524	444	524	4	72	80	0.9000000
NODE_5138_length_1091_cov_13.065524	497	577	0	9	80	0.1125000
NODE_5138_length_1091_cov_13.065524	497	577	2	19	80	0.2375000
NODE_5138_length_1091_cov_13.065524	497	577	4	52	80	0.6500000
NODE_5139_length_1091_cov_10.961694	582	646	0	13	64	0.2031250
NODE_5139_length_1091_cov_10.961694	582	646	2	5	64	0.0781250
NODE_5139_length_1091_cov_10.961694	582	646	4	4	64	0.0625000
NODE_5139_length_1091_cov_10.961694	582	646	6	42	64	0.6562500
NODE_5140_length_1091_cov_8.166331	299	379	1	2	80	0.0250000
NODE_5140_length_1091_cov_8.166331	299	379	2	13	80	0.1625000
NODE_5140_length_1091_cov_8.166331	299	379	3	10	80	0.1250000
NODE_5140_length_1091_cov_8.166331	299	379	6	55	80	0.6875000
NODE_5140_length_1091_cov_8.166331	352	432	1	2	80	0.0250000
NODE_5140_length_1091_cov_8.166331	352	432	2	30	80	0.3750000
NODE_5140_length_1091_cov_8.166331	352	432	3	46	80	0.5750000
NODE_5140_length_1091_cov_8.166331	352	432	6	2	80	0.0250000
NODE_5141_length_1091_cov_7.006048	617	697	0	80	80	1.0000000
NODE_5141_length_1091_cov_7.006048	670	750	0	80	80	1.0000000
NODE_5151_length_1090_cov_73.781029	352	432	0	2	80	0.0250000
NODE_5151_length_1090_cov_73.781029	352	432	2	20	80	0.2500000
NODE_5151_length_1090_cov_73.781029	352	432	4	6	80	0.0750000
NODE_5151_length_1090_cov_73.781029	352	432	6	11	80	0.1375000
NODE_5151_length_1090_cov_73.781029	352	432	8	41	80	0.5125000
NODE_5151_length_1090_cov_73.781029	405	485	0	55	80	0.6875000
NODE_5151_length_1090_cov_73.781029	405	485	2	20	80	0.2500000
NODE_5151_length_1090_cov_73.781029	405	485	4	5	80	0.0625000
NODE_5151_length_1090_cov_73.781029	481	567	0	86	86	1.0000000
NODE_5151_length_1090_cov_73.781029	540	620	0	80	80	1.0000000
NODE_5152_length_1090_cov_42.394551	530	610	0	48	80	0.6000000
NODE_5152_length_1090_cov_42.394551	530	610	4	32	80	0.4000000
NODE_5152_length_1090_cov_42.394551	583	663	0	5	80	0.0625000
NODE_5152_length_1090_cov_42.394551	583	663	4	75	80	0.9375000
NODE_5153_length_1090_cov_37.643794	436	516	0	28	80	0.3500000
NODE_5153_length_1090_cov_37.643794	436	516	2	52	80	0.6500000
NODE_5153_length_1090_cov_37.643794	489	569	0	7	80	0.0875000
NODE_5153_length_1090_cov_37.643794	489	569	2	49	80	0.6125000
NODE_5153_length_1090_cov_37.643794	489	569	6	24	80	0.3000000
NODE_5153_length_1090_cov_37.643794	565	645	6	56	80	0.7000000
NODE_5153_length_1090_cov_37.643794	565	645	8	16	80	0.2000000
NODE_5153_length_1090_cov_37.643794	565	645	10	8	80	0.1000000
NODE_5153_length_1090_cov_37.643794	618	698	4	29	80	0.3625000
NODE_5153_length_1090_cov_37.643794	618	698	6	3	80	0.0375000
NODE_5153_length_1090_cov_37.643794	618	698	8	16	80	0.2000000
NODE_5153_length_1090_cov_37.643794	618	698	10	32	80	0.4000000
NODE_5154_length_1090_cov_32.876892	487	567	2	58	80	0.7250000
NODE_5154_length_1090_cov_32.876892	487	567	4	22	80	0.2750000
NODE_5154_length_1090_cov_32.876892	540	620	0	25	80	0.3125000
NODE_5154_length_1090_cov_32.876892	540	620	2	39	80	0.4875000
NODE_5154_length_1090_cov_32.876892	540	620	4	16	80	0.2000000
NODE_5155_length_1090_cov_25.373360	486	566	0	34	80	0.4250000
NODE_5155_length_1090_cov_25.373360	486	566	2	46	80	0.5750000
NODE_5155_length_1090_cov_25.373360	539	619	2	80	80	1.0000000
NODE_5156_length_1090_cov_21.290616	422	502	0	24	80	0.3000000
NODE_5156_length_1090_cov_21.290616	422	502	2	11	80	0.1375000
NODE_5156_length_1090_cov_21.290616	422	502	4	45	80	0.5625000
NODE_5156_length_1090_cov_21.290616	475	555	2	30	80	0.3750000
NODE_5156_length_1090_cov_21.290616	475	555	4	50	80	0.6250000
NODE_5156_length_1090_cov_21.290616	551	631	0	70	80	0.8750000
NODE_5156_length_1090_cov_21.290616	551	631	2	10	80	0.1250000
NODE_5156_length_1090_cov_21.290616	604	684	0	23	80	0.2875000
NODE_5156_length_1090_cov_21.290616	604	684	2	57	80	0.7125000
NODE_5157_length_1090_cov_16.040363	666	746	0	80	80	1.0000000
NODE_5157_length_1090_cov_16.040363	719	799	0	80	80	1.0000000
NODE_5158_length_1090_cov_14.826438	393	473	0	26	80	0.3250000
NODE_5158_length_1090_cov_14.826438	393	473	2	54	80	0.6750000
NODE_5158_length_1090_cov_14.826438	446	526	0	33	80	0.4125000
NODE_5158_length_1090_cov_14.826438	446	526	2	47	80	0.5875000
NODE_5159_length_1090_cov_13.721493	498	578	0	40	80	0.5000000
NODE_5159_length_1090_cov_13.721493	498	578	2	40	80	0.5000000
NODE_5159_length_1090_cov_13.721493	551	631	0	17	80	0.2125000
NODE_5159_length_1090_cov_13.721493	551	631	2	63	80	0.7875000
NODE_5160_length_1090_cov_12.365288	386	467	0	33	81	0.4074074
NODE_5160_length_1090_cov_12.365288	386	467	4	29	81	0.3580247
NODE_5160_length_1090_cov_12.365288	386	467	6	19	81	0.2345679
NODE_5160_length_1090_cov_12.365288	440	520	4	8	80	0.1000000
NODE_5160_length_1090_cov_12.365288	440	520	6	72	80	0.9000000
NODE_5160_length_1090_cov_12.365288	516	596	2	46	80	0.5750000
NODE_5160_length_1090_cov_12.365288	516	596	3	6	80	0.0750000
NODE_5160_length_1090_cov_12.365288	516	596	4	3	80	0.0375000
NODE_5160_length_1090_cov_12.365288	516	596	6	7	80	0.0875000
NODE_5160_length_1090_cov_12.365288	516	596	7	7	80	0.0875000
NODE_5160_length_1090_cov_12.365288	516	596	8	11	80	0.1375000
NODE_5160_length_1090_cov_12.365288	569	649	2	80	80	1.0000000
NODE_5161_length_1090_cov_5.348133	0	80	3	1	80	0.0125000
NODE_5161_length_1090_cov_5.348133	0	80	4	8	80	0.1000000
NODE_5161_length_1090_cov_5.348133	0	80	9	8	80	0.1000000
NODE_5161_length_1090_cov_5.348133	0	80	11	1	80	0.0125000
NODE_5161_length_1090_cov_5.348133	0	80	15	1	80	0.0125000
NODE_5161_length_1090_cov_5.348133	0	80	17	9	80	0.1125000
NODE_5161_length_1090_cov_5.348133	0	80	19	12	80	0.1500000
NODE_5161_length_1090_cov_5.348133	0	80	21	1	80	0.0125000
NODE_5161_length_1090_cov_5.348133	0	80	23	4	80	0.0500000
NODE_5161_length_1090_cov_5.348133	0	80	30	4	80	0.0500000
NODE_5161_length_1090_cov_5.348133	0	80	34	1	80	0.0125000
NODE_5161_length_1090_cov_5.348133	0	80	36	1	80	0.0125000
NODE_5161_length_1090_cov_5.348133	0	80	40	1	80	0.0125000
NODE_5161_length_1090_cov_5.348133	0	80	42	1	80	0.0125000
NODE_5161_length_1090_cov_5.348133	0	80	47	2	80	0.0250000
NODE_5161_length_1090_cov_5.348133	0	80	49	6	80	0.0750000
NODE_5161_length_1090_cov_5.348133	0	80	51	11	80	0.1375000
NODE_5161_length_1090_cov_5.348133	0	80	53	5	80	0.0625000
NODE_5161_length_1090_cov_5.348133	0	80	55	3	80	0.0375000
NODE_5161_length_1090_cov_5.348133	53	99	47	2	46	0.0434783
NODE_5161_length_1090_cov_5.348133	53	99	49	6	46	0.1304348
NODE_5161_length_1090_cov_5.348133	53	99	51	11	46	0.2391304
NODE_5161_length_1090_cov_5.348133	53	99	53	5	46	0.1086956
NODE_5161_length_1090_cov_5.348133	53	99	55	6	46	0.1304348
NODE_5161_length_1090_cov_5.348133	53	99	57	1	46	0.0217391
NODE_5161_length_1090_cov_5.348133	53	99	60	3	46	0.0652174
NODE_5161_length_1090_cov_5.348133	53	99	62	1	46	0.0217391
NODE_5161_length_1090_cov_5.348133	53	99	64	4	46	0.0869565
NODE_5161_length_1090_cov_5.348133	53	99	70	7	46	0.1521739
NODE_5163_length_1090_cov_3.598385	300	340	33	1	40	0.0250000
NODE_5163_length_1090_cov_3.598385	300	340	34	1	40	0.0250000
NODE_5163_length_1090_cov_3.598385	300	340	36	1	40	0.0250000
NODE_5163_length_1090_cov_3.598385	300	340	38	3	40	0.0750000
NODE_5163_length_1090_cov_3.598385	300	340	39	2	40	0.0500000
NODE_5163_length_1090_cov_3.598385	300	340	40	1	40	0.0250000
NODE_5163_length_1090_cov_3.598385	300	340	42	1	40	0.0250000
NODE_5163_length_1090_cov_3.598385	300	340	43	1	40	0.0250000
NODE_5163_length_1090_cov_3.598385	300	340	46	4	40	0.1000000
NODE_5163_length_1090_cov_3.598385	300	340	48	8	40	0.2000000
NODE_5163_length_1090_cov_3.598385	300	340	50	2	40	0.0500000
NODE_5163_length_1090_cov_3.598385	300	340	59	1	40	0.0250000
NODE_5163_length_1090_cov_3.598385	300	340	62	1	40	0.0250000
NODE_5163_length_1090_cov_3.598385	300	340	64	1	40	0.0250000
NODE_5163_length_1090_cov_3.598385	300	340	65	1	40	0.0250000
NODE_5163_length_1090_cov_3.598385	300	340	66	5	40	0.1250000
NODE_5163_length_1090_cov_3.598385	300	340	68	4	40	0.1000000
NODE_5163_length_1090_cov_3.598385	300	340	70	2	40	0.0500000
NODE_5170_length_1089_cov_55.374747	515	594	2	48	79	0.6075949
NODE_5170_length_1089_cov_55.374747	515	594	4	31	79	0.3924051
NODE_5170_length_1089_cov_55.374747	567	647	0	20	80	0.2500000
NODE_5170_length_1089_cov_55.374747	567	647	2	57	80	0.7125000
NODE_5170_length_1089_cov_55.374747	567	647	4	3	80	0.0375000
NODE_5170_length_1089_cov_55.374747	643	723	0	23	80	0.2875000
NODE_5170_length_1089_cov_55.374747	643	723	2	3	80	0.0375000
NODE_5170_length_1089_cov_55.374747	643	723	4	54	80	0.6750000
NODE_5170_length_1089_cov_55.374747	696	776	0	26	80	0.3250000
NODE_5170_length_1089_cov_55.374747	696	776	2	20	80	0.2500000
NODE_5170_length_1089_cov_55.374747	696	776	4	34	80	0.4250000
NODE_5171_length_1089_cov_38.506061	458	538	0	21	80	0.2625000
NODE_5171_length_1089_cov_38.506061	458	538	2	59	80	0.7375000
NODE_5171_length_1089_cov_38.506061	511	591	0	67	80	0.8375000
NODE_5171_length_1089_cov_38.506061	511	591	2	13	80	0.1625000
NODE_5171_length_1089_cov_38.506061	587	667	0	80	80	1.0000000
NODE_5171_length_1089_cov_38.506061	640	720	0	80	80	1.0000000
NODE_5172_length_1089_cov_22.657576	379	459	4	13	80	0.1625000
NODE_5172_length_1089_cov_22.657576	379	459	6	67	80	0.8375000
NODE_5172_length_1089_cov_22.657576	432	512	2	21	80	0.2625000
NODE_5172_length_1089_cov_22.657576	432	512	4	15	80	0.1875000
NODE_5172_length_1089_cov_22.657576	432	512	6	44	80	0.5500000
NODE_5173_length_1089_cov_21.180808	547	627	2	6	80	0.0750000
NODE_5173_length_1089_cov_21.180808	547	627	4	74	80	0.9250000
NODE_5173_length_1089_cov_21.180808	600	680	2	48	80	0.6000000
NODE_5173_length_1089_cov_21.180808	600	680	4	32	80	0.4000000
NODE_5174_length_1089_cov_18.713131	431	511	0	80	80	1.0000000
NODE_5174_length_1089_cov_18.713131	484	564	0	80	80	1.0000000
NODE_5174_length_1089_cov_18.713131	560	640	0	80	80	1.0000000
NODE_5174_length_1089_cov_18.713131	613	693	0	80	80	1.0000000
NODE_5175_length_1089_cov_17.382828	376	456	0	4	80	0.0500000
NODE_5175_length_1089_cov_17.382828	376	456	4	76	80	0.9500000
NODE_5175_length_1089_cov_17.382828	429	509	0	57	80	0.7125000
NODE_5175_length_1089_cov_17.382828	429	509	4	23	80	0.2875000
NODE_5175_length_1089_cov_17.382828	505	585	0	80	80	1.0000000
NODE_5175_length_1089_cov_17.382828	558	638	0	80	80	1.0000000
NODE_5176_length_1089_cov_14.540404	610	690	8	17	80	0.2125000
NODE_5176_length_1089_cov_14.540404	610	690	10	63	80	0.7875000
NODE_5176_length_1089_cov_14.540404	663	743	0	42	80	0.5250000
NODE_5176_length_1089_cov_14.540404	663	743	8	28	80	0.3500000
NODE_5176_length_1089_cov_14.540404	663	743	10	10	80	0.1250000
NODE_5182_length_1088_cov_10.603640	504	584	1	31	80	0.3875000
NODE_5182_length_1088_cov_10.603640	504	584	8	38	80	0.4750000
NODE_5182_length_1088_cov_10.603640	504	584	9	11	80	0.1375000
NODE_5182_length_1088_cov_10.603640	557	632	0	3	75	0.0400000
NODE_5182_length_1088_cov_10.603640	557	632	8	72	75	0.9600000
NODE_5194_length_1088_cov_0.759353	0	59	0	59	59	1.0000000
NODE_5194_length_1088_cov_0.759353	32	97	0	65	65	1.0000000
NODE_5195_length_1087_cov_51.676113	457	537	0	35	80	0.4375000
NODE_5195_length_1087_cov_51.676113	457	537	2	45	80	0.5625000
NODE_5195_length_1087_cov_51.676113	510	590	0	80	80	1.0000000
NODE_5195_length_1087_cov_51.676113	586	666	0	80	80	1.0000000
NODE_5195_length_1087_cov_51.676113	639	719	0	80	80	1.0000000
NODE_5196_length_1087_cov_47.144737	214	276	21	4	62	0.0645161
NODE_5196_length_1087_cov_47.144737	214	276	23	2	62	0.0322581
NODE_5196_length_1087_cov_47.144737	214	276	25	4	62	0.0645161
NODE_5196_length_1087_cov_47.144737	214	276	27	2	62	0.0322581
NODE_5196_length_1087_cov_47.144737	214	276	31	3	62	0.0483871
NODE_5196_length_1087_cov_47.144737	214	276	41	5	62	0.0806452
NODE_5196_length_1087_cov_47.144737	214	276	43	6	62	0.0967742
NODE_5196_length_1087_cov_47.144737	214	276	45	2	62	0.0322581
NODE_5196_length_1087_cov_47.144737	214	276	47	1	62	0.0161290
NODE_5196_length_1087_cov_47.144737	214	276	49	7	62	0.1129032
NODE_5196_length_1087_cov_47.144737	214	276	51	2	62	0.0322581
NODE_5196_length_1087_cov_47.144737	214	276	53	6	62	0.0967742
NODE_5196_length_1087_cov_47.144737	214	276	57	1	62	0.0161290
NODE_5196_length_1087_cov_47.144737	214	276	59	1	62	0.0161290
NODE_5196_length_1087_cov_47.144737	214	276	61	2	62	0.0322581
NODE_5196_length_1087_cov_47.144737	214	276	63	4	62	0.0645161
NODE_5196_length_1087_cov_47.144737	214	276	64	5	62	0.0806452
NODE_5196_length_1087_cov_47.144737	214	276	66	5	62	0.0806452
NODE_5196_length_1087_cov_47.144737	630	710	0	8	80	0.1000000
NODE_5196_length_1087_cov_47.144737	630	710	2	21	80	0.2625000
NODE_5196_length_1087_cov_47.144737	630	710	6	32	80	0.4000000
NODE_5196_length_1087_cov_47.144737	630	710	7	1	80	0.0125000
NODE_5196_length_1087_cov_47.144737	630	710	8	18	80	0.2250000
NODE_5196_length_1087_cov_47.144737	683	763	0	61	80	0.7625000
NODE_5196_length_1087_cov_47.144737	683	763	2	19	80	0.2375000
NODE_5197_length_1087_cov_46.633603	871	951	2	7	80	0.0875000
NODE_5197_length_1087_cov_46.633603	871	951	4	5	80	0.0625000
NODE_5197_length_1087_cov_46.633603	871	951	6	68	80	0.8500000
NODE_5197_length_1087_cov_46.633603	924	999	0	16	75	0.2133333
NODE_5197_length_1087_cov_46.633603	924	999	2	22	75	0.2933333
NODE_5197_length_1087_cov_46.633603	924	999	6	37	75	0.4933333
NODE_5198_length_1087_cov_30.577935	528	608	0	4	80	0.0500000
NODE_5198_length_1087_cov_30.577935	528	608	4	8	80	0.1000000
NODE_5198_length_1087_cov_30.577935	528	608	8	68	80	0.8500000
NODE_5198_length_1087_cov_30.577935	581	661	0	57	80	0.7125000
NODE_5198_length_1087_cov_30.577935	581	661	4	8	80	0.1000000
NODE_5198_length_1087_cov_30.577935	581	661	8	15	80	0.1875000
NODE_5199_length_1087_cov_30.205466	515	591	2	31	76	0.4078947
NODE_5199_length_1087_cov_30.205466	515	591	4	43	76	0.5657895
NODE_5199_length_1087_cov_30.205466	515	591	5	1	76	0.0131579
NODE_5199_length_1087_cov_30.205466	515	591	6	1	76	0.0131579
NODE_5199_length_1087_cov_30.205466	564	644	2	30	80	0.3750000
NODE_5199_length_1087_cov_30.205466	564	644	4	26	80	0.3250000
NODE_5199_length_1087_cov_30.205466	564	644	6	24	80	0.3000000
NODE_5200_length_1087_cov_29.595142	568	648	2	80	80	1.0000000
NODE_5200_length_1087_cov_29.595142	621	701	0	53	80	0.6625000
NODE_5200_length_1087_cov_29.595142	621	701	2	27	80	0.3375000
NODE_5201_length_1087_cov_11.600202	374	454	3	5	80	0.0625000
NODE_5201_length_1087_cov_11.600202	374	454	5	55	80	0.6875000
NODE_5201_length_1087_cov_11.600202	374	454	9	1	80	0.0125000
NODE_5201_length_1087_cov_11.600202	374	454	11	7	80	0.0875000
NODE_5201_length_1087_cov_11.600202	374	454	12	2	80	0.0250000
NODE_5201_length_1087_cov_11.600202	374	454	14	10	80	0.1250000
NODE_5201_length_1087_cov_11.600202	427	507	5	7	80	0.0875000
NODE_5201_length_1087_cov_11.600202	427	507	9	1	80	0.0125000
NODE_5201_length_1087_cov_11.600202	427	507	10	14	80	0.1750000
NODE_5201_length_1087_cov_11.600202	427	507	11	7	80	0.0875000
NODE_5201_length_1087_cov_11.600202	427	507	12	2	80	0.0250000
NODE_5201_length_1087_cov_11.600202	427	507	14	49	80	0.6125000
NODE_5202_length_1087_cov_7.746964	436	516	6	46	80	0.5750000
NODE_5202_length_1087_cov_7.746964	436	516	8	34	80	0.4250000
NODE_5202_length_1087_cov_7.746964	489	569	0	7	80	0.0875000
NODE_5202_length_1087_cov_7.746964	489	569	2	12	80	0.1500000
NODE_5202_length_1087_cov_7.746964	489	569	4	18	80	0.2250000
NODE_5202_length_1087_cov_7.746964	489	569	6	43	80	0.5375000
NODE_5211_length_1086_cov_35.748734	406	486	2	8	80	0.1000000
NODE_5211_length_1086_cov_35.748734	406	486	3	1	80	0.0125000
NODE_5211_length_1086_cov_35.748734	406	486	4	15	80	0.1875000
NODE_5211_length_1086_cov_35.748734	406	486	6	56	80	0.7000000
NODE_5211_length_1086_cov_35.748734	459	539	0	43	80	0.5375000
NODE_5211_length_1086_cov_35.748734	459	539	2	18	80	0.2250000
NODE_5211_length_1086_cov_35.748734	459	539	3	1	80	0.0125000
NODE_5211_length_1086_cov_35.748734	459	539	4	15	80	0.1875000
NODE_5211_length_1086_cov_35.748734	459	539	6	3	80	0.0375000
NODE_5212_length_1086_cov_18.445795	325	405	0	42	80	0.5250000
NODE_5212_length_1086_cov_18.445795	325	405	1	38	80	0.4750000
NODE_5212_length_1086_cov_18.445795	378	458	1	80	80	1.0000000
NODE_5213_length_1086_cov_16.878419	528	608	0	80	80	1.0000000
NODE_5213_length_1086_cov_16.878419	581	661	0	80	80	1.0000000
NODE_5214_length_1086_cov_10.700101	498	578	0	80	80	1.0000000
NODE_5214_length_1086_cov_10.700101	551	631	0	29	80	0.3625000
NODE_5214_length_1086_cov_10.700101	551	631	2	51	80	0.6375000
NODE_5215_length_1086_cov_10.656535	277	357	0	36	80	0.4500000
NODE_5215_length_1086_cov_10.656535	277	357	2	44	80	0.5500000
NODE_5215_length_1086_cov_10.656535	330	410	0	53	80	0.6625000
NODE_5215_length_1086_cov_10.656535	330	410	2	27	80	0.3375000
NODE_5216_length_1086_cov_6.873354	374	454	0	41	80	0.5125000
NODE_5216_length_1086_cov_6.873354	374	454	4	39	80	0.4875000
NODE_5216_length_1086_cov_6.873354	427	507	4	80	80	1.0000000
NODE_5217_length_1086_cov_5.225937	869	949	0	24	80	0.3000000
NODE_5217_length_1086_cov_5.225937	869	949	2	56	80	0.7000000
NODE_5217_length_1086_cov_5.225937	922	1002	0	35	80	0.4375000
NODE_5217_length_1086_cov_5.225937	922	1002	2	45	80	0.5625000
NODE_5229_length_1085_cov_30.599391	515	595	0	17	80	0.2125000
NODE_5229_length_1085_cov_30.599391	515	595	4	63	80	0.7875000
NODE_5229_length_1085_cov_30.599391	568	648	0	26	80	0.3250000
NODE_5229_length_1085_cov_30.599391	568	648	4	54	80	0.6750000
NODE_5231_length_1085_cov_13.723124	558	638	0	39	80	0.4875000
NODE_5231_length_1085_cov_13.723124	558	638	2	9	80	0.1125000
NODE_5231_length_1085_cov_13.723124	558	638	4	32	80	0.4000000
NODE_5231_length_1085_cov_13.723124	611	691	2	9	80	0.1125000
NODE_5231_length_1085_cov_13.723124	611	691	4	71	80	0.8875000
NODE_5232_length_1085_cov_12.481744	576	656	0	80	80	1.0000000
NODE_5232_length_1085_cov_12.481744	629	709	0	80	80	1.0000000
NODE_5233_length_1085_cov_11.570994	553	633	0	80	80	1.0000000
NODE_5233_length_1085_cov_11.570994	606	686	0	80	80	1.0000000
NODE_5234_length_1085_cov_10.730223	273	353	0	34	80	0.4250000
NODE_5234_length_1085_cov_10.730223	273	353	2	46	80	0.5750000
NODE_5234_length_1085_cov_10.730223	326	406	2	61	80	0.7625000
NODE_5234_length_1085_cov_10.730223	326	406	4	14	80	0.1750000
NODE_5234_length_1085_cov_10.730223	326	406	6	5	80	0.0625000
NODE_5234_length_1085_cov_10.730223	402	482	4	5	80	0.0625000
NODE_5234_length_1085_cov_10.730223	402	482	6	22	80	0.2750000
NODE_5234_length_1085_cov_10.730223	402	482	8	9	80	0.1125000
NODE_5234_length_1085_cov_10.730223	402	482	10	44	80	0.5500000
NODE_5234_length_1085_cov_10.730223	455	535	0	5	80	0.0625000
NODE_5234_length_1085_cov_10.730223	455	535	2	14	80	0.1750000
NODE_5234_length_1085_cov_10.730223	455	535	4	1	80	0.0125000
NODE_5234_length_1085_cov_10.730223	455	535	8	9	80	0.1125000
NODE_5234_length_1085_cov_10.730223	455	535	10	51	80	0.6375000
NODE_5234_length_1085_cov_10.730223	832	908	12	1	76	0.0131579
NODE_5234_length_1085_cov_10.730223	832	908	14	5	76	0.0657895
NODE_5234_length_1085_cov_10.730223	832	908	18	2	76	0.0263158
NODE_5234_length_1085_cov_10.730223	832	908	20	5	76	0.0657895
NODE_5234_length_1085_cov_10.730223	832	908	22	16	76	0.2105263
NODE_5234_length_1085_cov_10.730223	832	908	26	1	76	0.0131579
NODE_5234_length_1085_cov_10.730223	832	908	28	1	76	0.0131579
NODE_5234_length_1085_cov_10.730223	832	908	30	1	76	0.0131579
NODE_5234_length_1085_cov_10.730223	832	908	34	3	76	0.0394737
NODE_5234_length_1085_cov_10.730223	832	908	36	1	76	0.0131579
NODE_5234_length_1085_cov_10.730223	832	908	38	4	76	0.0526316
NODE_5234_length_1085_cov_10.730223	832	908	39	12	76	0.1578947
NODE_5234_length_1085_cov_10.730223	832	908	40	24	76	0.3157895
NODE_5236_length_1085_cov_8.309331	400	480	0	80	80	1.0000000
NODE_5236_length_1085_cov_8.309331	453	533	0	80	80	1.0000000
NODE_5248_length_1084_cov_60.255838	446	524	3	78	78	1.0000000
NODE_5248_length_1084_cov_60.255838	497	577	1	23	80	0.2875000
NODE_5248_length_1084_cov_60.255838	497	577	2	7	80	0.0875000
NODE_5248_length_1084_cov_60.255838	497	577	3	50	80	0.6250000
NODE_5249_length_1084_cov_33.332995	445	525	0	14	80	0.1750000
NODE_5249_length_1084_cov_33.332995	445	525	4	3	80	0.0375000
NODE_5249_length_1084_cov_33.332995	445	525	8	63	80	0.7875000
NODE_5249_length_1084_cov_33.332995	498	578	2	14	80	0.1750000
NODE_5249_length_1084_cov_33.332995	498	578	4	5	80	0.0625000
NODE_5249_length_1084_cov_33.332995	498	578	8	61	80	0.7625000
NODE_5250_length_1084_cov_11.004061	757	837	0	31	80	0.3875000
NODE_5250_length_1084_cov_11.004061	757	837	2	49	80	0.6125000
NODE_5250_length_1084_cov_11.004061	810	890	0	80	80	1.0000000
NODE_5258_length_1083_cov_42.182927	451	531	0	80	80	1.0000000
NODE_5258_length_1083_cov_42.182927	504	584	0	58	80	0.7250000
NODE_5258_length_1083_cov_42.182927	504	584	1	3	80	0.0375000
NODE_5258_length_1083_cov_42.182927	504	584	2	19	80	0.2375000
NODE_5258_length_1083_cov_42.182927	580	660	2	80	80	1.0000000
NODE_5258_length_1083_cov_42.182927	633	713	1	1	80	0.0125000
NODE_5258_length_1083_cov_42.182927	633	713	2	79	80	0.9875000
NODE_5259_length_1083_cov_41.163618	275	355	0	80	80	1.0000000
NODE_5259_length_1083_cov_41.163618	328	408	0	45	80	0.5625000
NODE_5259_length_1083_cov_41.163618	328	408	4	25	80	0.3125000
NODE_5259_length_1083_cov_41.163618	328	408	6	10	80	0.1250000
NODE_5259_length_1083_cov_41.163618	404	484	6	31	80	0.3875000
NODE_5259_length_1083_cov_41.163618	404	484	8	49	80	0.6125000
NODE_5259_length_1083_cov_41.163618	457	537	2	22	80	0.2750000
NODE_5259_length_1083_cov_41.163618	457	537	6	33	80	0.4125000
NODE_5259_length_1083_cov_41.163618	457	537	8	25	80	0.3125000
NODE_5260_length_1083_cov_39.798780	527	607	0	45	80	0.5625000
NODE_5260_length_1083_cov_39.798780	527	607	2	19	80	0.2375000
NODE_5260_length_1083_cov_39.798780	527	607	4	16	80	0.2000000
NODE_5260_length_1083_cov_39.798780	580	660	2	11	80	0.1375000
NODE_5260_length_1083_cov_39.798780	580	660	4	21	80	0.2625000
NODE_5260_length_1083_cov_39.798780	580	660	6	20	80	0.2500000
NODE_5260_length_1083_cov_39.798780	580	660	7	1	80	0.0125000
NODE_5260_length_1083_cov_39.798780	580	660	12	14	80	0.1750000
NODE_5260_length_1083_cov_39.798780	580	660	16	13	80	0.1625000
NODE_5261_length_1083_cov_34.261179	475	555	10	7	80	0.0875000
NODE_5261_length_1083_cov_34.261179	475	555	14	18	80	0.2250000
NODE_5261_length_1083_cov_34.261179	475	555	16	37	80	0.4625000
NODE_5261_length_1083_cov_34.261179	475	555	18	18	80	0.2250000
NODE_5261_length_1083_cov_34.261179	528	608	4	5	80	0.0625000
NODE_5261_length_1083_cov_34.261179	528	608	6	6	80	0.0750000
NODE_5261_length_1083_cov_34.261179	528	608	8	3	80	0.0375000
NODE_5261_length_1083_cov_34.261179	528	608	14	38	80	0.4750000
NODE_5261_length_1083_cov_34.261179	528	608	16	12	80	0.1500000
NODE_5261_length_1083_cov_34.261179	528	608	18	16	80	0.2000000
NODE_5262_length_1083_cov_33.573171	486	566	2	80	80	1.0000000
NODE_5262_length_1083_cov_33.573171	539	619	2	30	80	0.3750000
NODE_5262_length_1083_cov_33.573171	539	619	4	22	80	0.2750000
NODE_5262_length_1083_cov_33.573171	539	619	6	28	80	0.3500000
NODE_5262_length_1083_cov_33.573171	615	695	4	9	80	0.1125000
NODE_5262_length_1083_cov_33.573171	615	695	6	18	80	0.2250000
NODE_5262_length_1083_cov_33.573171	615	695	8	6	80	0.0750000
NODE_5262_length_1083_cov_33.573171	615	695	10	15	80	0.1875000
NODE_5262_length_1083_cov_33.573171	615	695	12	32	80	0.4000000
NODE_5262_length_1083_cov_33.573171	668	748	4	29	80	0.3625000
NODE_5262_length_1083_cov_33.573171	668	748	6	1	80	0.0125000
NODE_5262_length_1083_cov_33.573171	668	748	8	6	80	0.0750000
NODE_5262_length_1083_cov_33.573171	668	748	10	15	80	0.1875000
NODE_5262_length_1083_cov_33.573171	668	748	12	29	80	0.3625000
NODE_5263_length_1083_cov_33.091463	452	532	6	33	80	0.4125000
NODE_5263_length_1083_cov_33.091463	452	532	13	39	80	0.4875000
NODE_5263_length_1083_cov_33.091463	452	532	14	8	80	0.1000000
NODE_5263_length_1083_cov_33.091463	505	585	7	29	80	0.3625000
NODE_5263_length_1083_cov_33.091463	505	585	13	43	80	0.5375000
NODE_5263_length_1083_cov_33.091463	505	585	14	8	80	0.1000000
NODE_5264_length_1083_cov_30.982724	550	630	2	80	80	1.0000000
NODE_5264_length_1083_cov_30.982724	603	683	0	27	80	0.3375000
NODE_5264_length_1083_cov_30.982724	603	683	2	53	80	0.6625000
NODE_5265_length_1083_cov_18.819106	586	666	1	1	80	0.0125000
NODE_5265_length_1083_cov_18.819106	586	666	2	18	80	0.2250000
NODE_5265_length_1083_cov_18.819106	586	666	4	23	80	0.2875000
NODE_5265_length_1083_cov_18.819106	586	666	6	38	80	0.4750000
NODE_5265_length_1083_cov_18.819106	639	719	2	6	80	0.0750000
NODE_5265_length_1083_cov_18.819106	639	719	4	34	80	0.4250000
NODE_5265_length_1083_cov_18.819106	639	719	5	4	80	0.0500000
NODE_5265_length_1083_cov_18.819106	639	719	6	36	80	0.4500000
NODE_5266_length_1083_cov_17.278455	408	488	0	80	80	1.0000000
NODE_5266_length_1083_cov_17.278455	461	541	0	80	80	1.0000000
NODE_5267_length_1083_cov_13.862805	481	561	0	19	80	0.2375000
NODE_5267_length_1083_cov_13.862805	481	561	2	30	80	0.3750000
NODE_5267_length_1083_cov_13.862805	481	561	8	31	80	0.3875000
NODE_5267_length_1083_cov_13.862805	534	614	8	53	80	0.6625000
NODE_5267_length_1083_cov_13.862805	534	614	10	27	80	0.3375000
NODE_5268_length_1083_cov_13.083333	522	602	12	55	80	0.6875000
NODE_5268_length_1083_cov_13.083333	522	602	14	3	80	0.0375000
NODE_5268_length_1083_cov_13.083333	522	602	15	5	80	0.0625000
NODE_5268_length_1083_cov_13.083333	522	602	16	17	80	0.2125000
NODE_5268_length_1083_cov_13.083333	575	655	4	20	80	0.2500000
NODE_5268_length_1083_cov_13.083333	575	655	10	13	80	0.1625000
NODE_5268_length_1083_cov_13.083333	575	655	12	2	80	0.0250000
NODE_5268_length_1083_cov_13.083333	575	655	14	3	80	0.0375000
NODE_5268_length_1083_cov_13.083333	575	655	15	5	80	0.0625000
NODE_5268_length_1083_cov_13.083333	575	655	16	37	80	0.4625000
NODE_5269_length_1083_cov_11.824187	242	322	0	80	80	1.0000000
NODE_5269_length_1083_cov_11.824187	295	375	0	80	80	1.0000000
NODE_5271_length_1083_cov_3.025407	359	439	0	8	80	0.1000000
NODE_5271_length_1083_cov_3.025407	359	439	2	46	80	0.5750000
NODE_5271_length_1083_cov_3.025407	359	439	4	26	80	0.3250000
NODE_5271_length_1083_cov_3.025407	412	489	0	4	77	0.0519481
NODE_5271_length_1083_cov_3.025407	412	489	2	51	77	0.6623377
NODE_5271_length_1083_cov_3.025407	412	489	4	22	77	0.2857143
NODE_5277_length_1082_cov_34.664293	461	541	0	13	80	0.1625000
NODE_5277_length_1082_cov_34.664293	461	541	1	67	80	0.8375000
NODE_5277_length_1082_cov_34.664293	514	594	0	66	80	0.8250000
NODE_5277_length_1082_cov_34.664293	514	594	1	14	80	0.1750000
NODE_5278_length_1082_cov_17.422177	406	486	0	11	80	0.1375000
NODE_5278_length_1082_cov_17.422177	406	486	2	13	80	0.1625000
NODE_5278_length_1082_cov_17.422177	406	486	4	56	80	0.7000000
NODE_5278_length_1082_cov_17.422177	459	539	0	27	80	0.3375000
NODE_5278_length_1082_cov_17.422177	459	539	2	1	80	0.0125000
NODE_5278_length_1082_cov_17.422177	459	539	4	52	80	0.6500000
NODE_5279_length_1082_cov_15.906409	442	522	2	8	80	0.1000000
NODE_5279_length_1082_cov_15.906409	442	522	4	60	80	0.7500000
NODE_5279_length_1082_cov_15.906409	442	522	6	12	80	0.1500000
NODE_5279_length_1082_cov_15.906409	495	575	2	8	80	0.1000000
NODE_5279_length_1082_cov_15.906409	495	575	4	35	80	0.4375000
NODE_5279_length_1082_cov_15.906409	495	575	6	37	80	0.4625000
NODE_5280_length_1082_cov_13.703967	324	404	2	13	80	0.1625000
NODE_5280_length_1082_cov_13.703967	324	404	4	34	80	0.4250000
NODE_5280_length_1082_cov_13.703967	324	404	6	33	80	0.4125000
NODE_5280_length_1082_cov_13.703967	377	457	0	12	80	0.1500000
NODE_5280_length_1082_cov_13.703967	377	457	2	1	80	0.0125000
NODE_5280_length_1082_cov_13.703967	377	457	4	42	80	0.5250000
NODE_5280_length_1082_cov_13.703967	377	457	6	25	80	0.3125000
NODE_5281_length_1082_cov_6.478128	159	205	0	32	46	0.6956522
NODE_5281_length_1082_cov_6.478128	159	205	2	14	46	0.3043478
NODE_5281_length_1082_cov_6.478128	203	283	0	26	80	0.3250000
NODE_5281_length_1082_cov_6.478128	203	283	2	14	80	0.1750000
NODE_5281_length_1082_cov_6.478128	203	283	4	14	80	0.1750000
NODE_5281_length_1082_cov_6.478128	203	283	6	26	80	0.3250000
NODE_5281_length_1082_cov_6.478128	256	336	0	4	80	0.0500000
NODE_5281_length_1082_cov_6.478128	256	336	2	10	80	0.1250000
NODE_5281_length_1082_cov_6.478128	256	336	4	1	80	0.0125000
NODE_5281_length_1082_cov_6.478128	256	336	6	65	80	0.8125000
NODE_5281_length_1082_cov_6.478128	861	941	1	35	80	0.4375000
NODE_5281_length_1082_cov_6.478128	861	941	3	45	80	0.5625000
NODE_5282_length_1082_cov_4.218718	982	1062	78	1	80	0.0125000
NODE_5282_length_1082_cov_4.218718	982	1062	79	1	80	0.0125000
NODE_5282_length_1082_cov_4.218718	982	1062	91	1	80	0.0125000
NODE_5282_length_1082_cov_4.218718	982	1062	94	1	80	0.0125000
NODE_5282_length_1082_cov_4.218718	982	1062	98	1	80	0.0125000
NODE_5282_length_1082_cov_4.218718	982	1062	99	1	80	0.0125000
NODE_5282_length_1082_cov_4.218718	982	1062	103	1	80	0.0125000
NODE_5282_length_1082_cov_4.218718	982	1062	109	1	80	0.0125000
NODE_5282_length_1082_cov_4.218718	982	1062	111	1	80	0.0125000
NODE_5282_length_1082_cov_4.218718	982	1062	113	3	80	0.0375000
NODE_5282_length_1082_cov_4.218718	982	1062	121	1	80	0.0125000
NODE_5282_length_1082_cov_4.218718	982	1062	123	1	80	0.0125000
NODE_5282_length_1082_cov_4.218718	982	1062	127	2	80	0.0250000
NODE_5282_length_1082_cov_4.218718	982	1062	135	1	80	0.0125000
NODE_5282_length_1082_cov_4.218718	982	1062	144	1	80	0.0125000
NODE_5282_length_1082_cov_4.218718	982	1062	146	1	80	0.0125000
NODE_5282_length_1082_cov_4.218718	982	1062	150	1	80	0.0125000
NODE_5282_length_1082_cov_4.218718	982	1062	154	1	80	0.0125000
NODE_5282_length_1082_cov_4.218718	982	1062	168	1	80	0.0125000
NODE_5282_length_1082_cov_4.218718	982	1062	171	1	80	0.0125000
NODE_5282_length_1082_cov_4.218718	982	1062	175	1	80	0.0125000
NODE_5282_length_1082_cov_4.218718	982	1062	179	1	80	0.0125000
NODE_5282_length_1082_cov_4.218718	982	1062	188	2	80	0.0250000
NODE_5282_length_1082_cov_4.218718	982	1062	190	1	80	0.0125000
NODE_5282_length_1082_cov_4.218718	982	1062	192	4	80	0.0500000
NODE_5282_length_1082_cov_4.218718	982	1062	194	2	80	0.0250000
NODE_5282_length_1082_cov_4.218718	982	1062	196	1	80	0.0125000
NODE_5282_length_1082_cov_4.218718	982	1062	198	1	80	0.0125000
NODE_5282_length_1082_cov_4.218718	982	1062	206	2	80	0.0250000
NODE_5282_length_1082_cov_4.218718	982	1062	212	1	80	0.0125000
NODE_5282_length_1082_cov_4.218718	982	1062	214	1	80	0.0125000
NODE_5282_length_1082_cov_4.218718	982	1062	220	3	80	0.0375000
NODE_5282_length_1082_cov_4.218718	982	1062	222	2	80	0.0250000
NODE_5282_length_1082_cov_4.218718	982	1062	224	1	80	0.0125000
NODE_5282_length_1082_cov_4.218718	982	1062	226	1	80	0.0125000
NODE_5282_length_1082_cov_4.218718	982	1062	228	5	80	0.0625000
NODE_5282_length_1082_cov_4.218718	982	1062	233	2	80	0.0250000
NODE_5282_length_1082_cov_4.218718	982	1062	239	1	80	0.0125000
NODE_5282_length_1082_cov_4.218718	982	1062	241	1	80	0.0125000
NODE_5282_length_1082_cov_4.218718	982	1062	247	1	80	0.0125000
NODE_5282_length_1082_cov_4.218718	982	1062	249	2	80	0.0250000
NODE_5282_length_1082_cov_4.218718	982	1062	251	2	80	0.0250000
NODE_5282_length_1082_cov_4.218718	982	1062	258	1	80	0.0125000
NODE_5282_length_1082_cov_4.218718	982	1062	268	1	80	0.0125000
NODE_5282_length_1082_cov_4.218718	982	1062	274	5	80	0.0625000
NODE_5282_length_1082_cov_4.218718	982	1062	277	1	80	0.0125000
NODE_5282_length_1082_cov_4.218718	982	1062	279	5	80	0.0625000
NODE_5282_length_1082_cov_4.218718	982	1062	280	1	80	0.0125000
NODE_5282_length_1082_cov_4.218718	982	1062	282	1	80	0.0125000
NODE_5282_length_1082_cov_4.218718	982	1062	283	2	80	0.0250000
NODE_5282_length_1082_cov_4.218718	982	1062	287	1	80	0.0125000
NODE_5282_length_1082_cov_4.218718	982	1062	289	1	80	0.0125000
NODE_5291_length_1081_cov_45.308554	510	590	2	20	80	0.2500000
NODE_5291_length_1081_cov_45.308554	510	590	4	27	80	0.3375000
NODE_5291_length_1081_cov_45.308554	510	590	6	33	80	0.4125000
NODE_5291_length_1081_cov_45.308554	563	643	2	9	80	0.1125000
NODE_5291_length_1081_cov_45.308554	563	643	4	47	80	0.5875000
NODE_5291_length_1081_cov_45.308554	563	643	6	24	80	0.3000000
NODE_5292_length_1081_cov_39.581466	476	556	0	2	80	0.0250000
NODE_5292_length_1081_cov_39.581466	476	556	4	78	80	0.9750000
NODE_5292_length_1081_cov_39.581466	529	609	0	51	80	0.6375000
NODE_5292_length_1081_cov_39.581466	529	609	2	4	80	0.0500000
NODE_5292_length_1081_cov_39.581466	529	609	4	25	80	0.3125000
NODE_5292_length_1081_cov_39.581466	605	685	2	16	80	0.2000000
NODE_5292_length_1081_cov_39.581466	605	685	4	41	80	0.5125000
NODE_5292_length_1081_cov_39.581466	605	685	6	23	80	0.2875000
NODE_5292_length_1081_cov_39.581466	658	738	4	4	80	0.0500000
NODE_5292_length_1081_cov_39.581466	658	738	6	76	80	0.9500000
NODE_5293_length_1081_cov_39.457230	373	453	1	68	80	0.8500000
NODE_5293_length_1081_cov_39.457230	373	453	2	12	80	0.1500000
NODE_5293_length_1081_cov_39.457230	426	506	1	80	80	1.0000000
NODE_5294_length_1081_cov_20.415479	376	451	0	75	75	1.0000000
NODE_5294_length_1081_cov_20.415479	436	511	0	75	75	1.0000000
NODE_5294_length_1081_cov_20.415479	496	571	0	73	75	0.9733334
NODE_5294_length_1081_cov_20.415479	496	571	2	2	75	0.0266667
NODE_5294_length_1081_cov_20.415479	544	624	0	25	80	0.3125000
NODE_5294_length_1081_cov_20.415479	544	624	2	55	80	0.6875000
NODE_5295_length_1081_cov_19.985743	378	458	0	1	80	0.0125000
NODE_5295_length_1081_cov_19.985743	378	458	2	73	80	0.9125000
NODE_5295_length_1081_cov_19.985743	378	458	4	6	80	0.0750000
NODE_5295_length_1081_cov_19.985743	431	511	0	54	80	0.6750000
NODE_5295_length_1081_cov_19.985743	431	511	2	26	80	0.3250000
NODE_5295_length_1081_cov_19.985743	507	587	0	80	80	1.0000000
NODE_5295_length_1081_cov_19.985743	560	640	0	80	80	1.0000000
NODE_5296_length_1081_cov_12.658859	468	548	2	40	80	0.5000000
NODE_5296_length_1081_cov_12.658859	468	548	4	40	80	0.5000000
NODE_5296_length_1081_cov_12.658859	521	601	2	80	80	1.0000000
NODE_5299_length_1081_cov_2.586558	7	44	0	37	37	1.0000000
NODE_5304_length_1080_cov_27.857288	261	341	0	15	80	0.1875000
NODE_5304_length_1080_cov_27.857288	261	341	2	19	80	0.2375000
NODE_5304_length_1080_cov_27.857288	261	341	4	46	80	0.5750000
NODE_5304_length_1080_cov_27.857288	314	394	0	19	80	0.2375000
NODE_5304_length_1080_cov_27.857288	314	394	2	35	80	0.4375000
NODE_5304_length_1080_cov_27.857288	314	394	4	26	80	0.3250000
NODE_5305_length_1080_cov_24.258919	321	401	0	35	80	0.4375000
NODE_5305_length_1080_cov_24.258919	321	401	2	12	80	0.1500000
NODE_5305_length_1080_cov_24.258919	321	401	4	33	80	0.4125000
NODE_5305_length_1080_cov_24.258919	374	454	0	4	80	0.0500000
NODE_5305_length_1080_cov_24.258919	374	454	2	25	80	0.3125000
NODE_5305_length_1080_cov_24.258919	374	454	4	51	80	0.6375000
NODE_5305_length_1080_cov_24.258919	450	530	0	17	80	0.2125000
NODE_5305_length_1080_cov_24.258919	450	530	2	63	80	0.7875000
NODE_5305_length_1080_cov_24.258919	503	583	0	51	80	0.6375000
NODE_5305_length_1080_cov_24.258919	503	583	2	29	80	0.3625000
NODE_5306_length_1080_cov_22.589195	446	526	0	80	80	1.0000000
NODE_5306_length_1080_cov_22.589195	499	579	0	80	80	1.0000000
NODE_5306_length_1080_cov_22.589195	575	655	0	69	80	0.8625000
NODE_5306_length_1080_cov_22.589195	575	655	1	1	80	0.0125000
NODE_5306_length_1080_cov_22.589195	575	655	2	10	80	0.1250000
NODE_5306_length_1080_cov_22.589195	628	708	0	16	80	0.2000000
NODE_5306_length_1080_cov_22.589195	628	708	1	1	80	0.0125000
NODE_5306_length_1080_cov_22.589195	628	708	2	16	80	0.2000000
NODE_5306_length_1080_cov_22.589195	628	708	4	47	80	0.5875000
NODE_5307_length_1080_cov_15.544343	599	679	0	80	80	1.0000000
NODE_5307_length_1080_cov_15.544343	652	732	0	80	80	1.0000000
NODE_5308_length_1080_cov_10.416922	321	401	0	10	80	0.1250000
NODE_5308_length_1080_cov_10.416922	321	401	2	70	80	0.8750000
NODE_5308_length_1080_cov_10.416922	374	454	2	44	80	0.5500000
NODE_5308_length_1080_cov_10.416922	374	454	4	36	80	0.4500000
NODE_5315_length_1079_cov_55.352041	367	447	2	28	80	0.3500000
NODE_5315_length_1079_cov_55.352041	367	447	4	52	80	0.6500000
NODE_5315_length_1079_cov_55.352041	420	500	0	14	80	0.1750000
NODE_5315_length_1079_cov_55.352041	420	500	2	62	80	0.7750000
NODE_5315_length_1079_cov_55.352041	420	500	4	4	80	0.0500000
NODE_5315_length_1079_cov_55.352041	496	576	0	21	80	0.2625000
NODE_5315_length_1079_cov_55.352041	496	576	2	59	80	0.7375000
NODE_5315_length_1079_cov_55.352041	549	629	0	12	80	0.1500000
NODE_5315_length_1079_cov_55.352041	549	629	2	68	80	0.8500000
NODE_5316_length_1079_cov_46.879592	444	524	2	5	80	0.0625000
NODE_5316_length_1079_cov_46.879592	444	524	4	61	80	0.7625000
NODE_5316_length_1079_cov_46.879592	444	524	6	2	80	0.0250000
NODE_5316_length_1079_cov_46.879592	444	524	8	2	80	0.0250000
NODE_5316_length_1079_cov_46.879592	444	524	10	10	80	0.1250000
NODE_5316_length_1079_cov_46.879592	497	577	4	60	80	0.7500000
NODE_5316_length_1079_cov_46.879592	497	577	6	20	80	0.2500000
NODE_5316_length_1079_cov_46.879592	573	652	6	56	79	0.7088608
NODE_5316_length_1079_cov_46.879592	573	652	8	23	79	0.2911392
NODE_5316_length_1079_cov_46.879592	625	703	0	40	78	0.5128205
NODE_5316_length_1079_cov_46.879592	625	703	2	3	78	0.0384615
NODE_5316_length_1079_cov_46.879592	625	703	4	7	78	0.0897436
NODE_5316_length_1079_cov_46.879592	625	703	6	28	78	0.3589744
NODE_5317_length_1079_cov_13.708163	611	691	0	52	80	0.6500000
NODE_5317_length_1079_cov_13.708163	611	691	2	28	80	0.3500000
NODE_5317_length_1079_cov_13.708163	664	744	0	17	80	0.2125000
NODE_5317_length_1079_cov_13.708163	664	744	2	63	80	0.7875000
NODE_5318_length_1079_cov_8.632653	416	496	0	80	80	1.0000000
NODE_5318_length_1079_cov_8.632653	469	549	0	80	80	1.0000000
NODE_5325_length_1078_cov_27.804903	357	437	2	6	80	0.0750000
NODE_5325_length_1078_cov_27.804903	357	437	4	3	80	0.0375000
NODE_5325_length_1078_cov_27.804903	357	437	6	10	80	0.1250000
NODE_5325_length_1078_cov_27.804903	357	437	10	27	80	0.3375000
NODE_5325_length_1078_cov_27.804903	357	437	14	9	80	0.1125000
NODE_5325_length_1078_cov_27.804903	357	437	20	25	80	0.3125000
NODE_5325_length_1078_cov_27.804903	410	490	14	16	80	0.2000000
NODE_5325_length_1078_cov_27.804903	410	490	16	18	80	0.2250000
NODE_5325_length_1078_cov_27.804903	410	490	18	16	80	0.2000000
NODE_5325_length_1078_cov_27.804903	410	490	20	30	80	0.3750000
NODE_5326_length_1078_cov_26.071502	459	539	0	80	80	1.0000000
NODE_5326_length_1078_cov_26.071502	512	592	0	80	80	1.0000000
NODE_5326_length_1078_cov_26.071502	588	668	0	4	80	0.0500000
NODE_5326_length_1078_cov_26.071502	588	668	2	62	80	0.7750000
NODE_5326_length_1078_cov_26.071502	588	668	4	14	80	0.1750000
NODE_5326_length_1078_cov_26.071502	641	718	2	63	77	0.8181818
NODE_5326_length_1078_cov_26.071502	641	718	4	14	77	0.1818182
NODE_5327_length_1078_cov_14.985700	495	575	0	80	80	1.0000000
NODE_5327_length_1078_cov_14.985700	548	628	0	80	80	1.0000000
NODE_5333_length_1077_cov_23.876278	546	626	0	23	80	0.2875000
NODE_5333_length_1077_cov_23.876278	546	626	2	57	80	0.7125000
NODE_5333_length_1077_cov_23.876278	599	679	0	15	80	0.1875000
NODE_5333_length_1077_cov_23.876278	599	679	2	65	80	0.8125000
NODE_5334_length_1077_cov_16.067485	532	612	3	31	80	0.3875000
NODE_5334_length_1077_cov_16.067485	532	612	5	8	80	0.1000000
NODE_5334_length_1077_cov_16.067485	532	612	6	29	80	0.3625000
NODE_5334_length_1077_cov_16.067485	532	612	10	12	80	0.1500000
NODE_5334_length_1077_cov_16.067485	585	665	4	13	80	0.1625000
NODE_5334_length_1077_cov_16.067485	585	665	6	20	80	0.2500000
NODE_5334_length_1077_cov_16.067485	585	665	7	11	80	0.1375000
NODE_5334_length_1077_cov_16.067485	585	665	9	11	80	0.1375000
NODE_5334_length_1077_cov_16.067485	585	665	10	25	80	0.3125000
NODE_5335_length_1077_cov_14.568507	556	636	0	80	80	1.0000000
NODE_5335_length_1077_cov_14.568507	609	689	0	80	80	1.0000000
NODE_5336_length_1077_cov_9.507157	496	576	0	80	80	1.0000000
NODE_5336_length_1077_cov_9.507157	549	629	0	36	80	0.4500000
NODE_5336_length_1077_cov_9.507157	549	629	2	44	80	0.5500000
NODE_5342_length_1077_cov_1.781186	252	274	0	22	22	1.0000000
NODE_5345_length_1076_cov_20.592631	534	614	0	10	80	0.1250000
NODE_5345_length_1076_cov_20.592631	534	614	2	70	80	0.8750000
NODE_5345_length_1076_cov_20.592631	587	667	0	16	80	0.2000000
NODE_5345_length_1076_cov_20.592631	587	667	2	64	80	0.8000000
NODE_5346_length_1076_cov_14.788127	427	507	1	17	80	0.2125000
NODE_5346_length_1076_cov_14.788127	427	507	2	63	80	0.7875000
NODE_5346_length_1076_cov_14.788127	480	560	1	11	80	0.1375000
NODE_5346_length_1076_cov_14.788127	480	560	2	69	80	0.8625000
NODE_5348_length_1076_cov_6.306039	883	961	0	24	78	0.3076923
NODE_5348_length_1076_cov_6.306039	883	961	2	54	78	0.6923077
NODE_5348_length_1076_cov_6.306039	936	1014	0	22	78	0.2820513
NODE_5348_length_1076_cov_6.306039	936	1014	2	56	78	0.7179487
NODE_5357_length_1075_cov_37.941598	550	630	6	4	80	0.0500000
NODE_5357_length_1075_cov_37.941598	550	630	8	38	80	0.4750000
NODE_5357_length_1075_cov_37.941598	550	630	9	19	80	0.2375000
NODE_5357_length_1075_cov_37.941598	550	630	10	19	80	0.2375000
NODE_5357_length_1075_cov_37.941598	603	685	2	31	82	0.3780488
NODE_5357_length_1075_cov_37.941598	603	685	6	6	82	0.0731707
NODE_5357_length_1075_cov_37.941598	603	685	8	29	82	0.3536585
NODE_5357_length_1075_cov_37.941598	603	685	9	15	82	0.1829268
NODE_5357_length_1075_cov_37.941598	603	685	10	1	82	0.0121951
NODE_5357_length_1075_cov_37.941598	681	761	0	26	80	0.3250000
NODE_5357_length_1075_cov_37.941598	681	761	1	4	80	0.0500000
NODE_5357_length_1075_cov_37.941598	681	761	2	50	80	0.6250000
NODE_5357_length_1075_cov_37.941598	734	814	0	34	80	0.4250000
NODE_5357_length_1075_cov_37.941598	734	814	1	1	80	0.0125000
NODE_5357_length_1075_cov_37.941598	734	814	2	45	80	0.5625000
NODE_5358_length_1075_cov_32.224385	397	477	0	80	80	1.0000000
NODE_5358_length_1075_cov_32.224385	450	530	0	80	80	1.0000000
NODE_5359_length_1075_cov_9.626025	440	520	0	60	80	0.7500000
NODE_5359_length_1075_cov_9.626025	440	520	2	20	80	0.2500000
NODE_5359_length_1075_cov_9.626025	493	573	0	7	80	0.0875000
NODE_5359_length_1075_cov_9.626025	493	573	2	37	80	0.4625000
NODE_5359_length_1075_cov_9.626025	493	573	3	1	80	0.0125000
NODE_5359_length_1075_cov_9.626025	493	573	4	35	80	0.4375000
NODE_5362_length_1075_cov_2.926230	38	99	0	61	61	1.0000000
NODE_5372_length_1074_cov_19.034872	568	648	2	66	80	0.8250000
NODE_5372_length_1074_cov_19.034872	568	648	4	14	80	0.1750000
NODE_5372_length_1074_cov_19.034872	621	701	0	22	80	0.2750000
NODE_5372_length_1074_cov_19.034872	621	701	2	58	80	0.7250000
NODE_5372_length_1074_cov_19.034872	697	777	0	80	80	1.0000000
NODE_5372_length_1074_cov_19.034872	750	830	0	80	80	1.0000000
NODE_5373_length_1074_cov_9.450256	577	657	0	19	80	0.2375000
NODE_5373_length_1074_cov_9.450256	577	657	4	61	80	0.7625000
NODE_5373_length_1074_cov_9.450256	630	710	4	80	80	1.0000000
NODE_5374_length_1074_cov_9.155897	526	606	0	80	80	1.0000000
NODE_5374_length_1074_cov_9.155897	579	659	0	80	80	1.0000000
NODE_5374_length_1074_cov_9.155897	655	735	0	79	80	0.9875000
NODE_5374_length_1074_cov_9.155897	655	735	2	1	80	0.0125000
NODE_5374_length_1074_cov_9.155897	708	788	0	39	80	0.4875000
NODE_5374_length_1074_cov_9.155897	708	788	2	41	80	0.5125000
NODE_5375_length_1074_cov_4.600000	606	686	0	80	80	1.0000000
NODE_5375_length_1074_cov_4.600000	659	739	0	80	80	1.0000000
NODE_5376_length_1074_cov_4.328205	32	112	10	1	80	0.0125000
NODE_5376_length_1074_cov_4.328205	32	112	12	1	80	0.0125000
NODE_5376_length_1074_cov_4.328205	32	112	16	1	80	0.0125000
NODE_5376_length_1074_cov_4.328205	32	112	17	6	80	0.0750000
NODE_5376_length_1074_cov_4.328205	32	112	19	11	80	0.1375000
NODE_5376_length_1074_cov_4.328205	32	112	21	4	80	0.0500000
NODE_5376_length_1074_cov_4.328205	32	112	23	2	80	0.0250000
NODE_5376_length_1074_cov_4.328205	32	112	25	1	80	0.0125000
NODE_5376_length_1074_cov_4.328205	32	112	27	2	80	0.0250000
NODE_5376_length_1074_cov_4.328205	32	112	29	19	80	0.2375000
NODE_5376_length_1074_cov_4.328205	32	112	31	7	80	0.0875000
NODE_5376_length_1074_cov_4.328205	32	112	33	5	80	0.0625000
NODE_5376_length_1074_cov_4.328205	32	112	35	20	80	0.2500000
NODE_5380_length_1073_cov_60.012320	448	528	0	2	80	0.0250000
NODE_5380_length_1073_cov_60.012320	448	528	2	78	80	0.9750000
NODE_5380_length_1073_cov_60.012320	501	581	0	43	80	0.5375000
NODE_5380_length_1073_cov_60.012320	501	581	2	37	80	0.4625000
NODE_5382_length_1073_cov_26.415811	529	609	4	31	80	0.3875000
NODE_5382_length_1073_cov_26.415811	529	609	6	29	80	0.3625000
NODE_5382_length_1073_cov_26.415811	529	609	8	20	80	0.2500000
NODE_5382_length_1073_cov_26.415811	582	662	2	4	80	0.0500000
NODE_5382_length_1073_cov_26.415811	582	662	4	34	80	0.4250000
NODE_5382_length_1073_cov_26.415811	582	662	6	42	80	0.5250000
NODE_5383_length_1073_cov_19.062628	571	651	4	31	80	0.3875000
NODE_5383_length_1073_cov_19.062628	571	651	5	4	80	0.0500000
NODE_5383_length_1073_cov_19.062628	571	651	7	19	80	0.2375000
NODE_5383_length_1073_cov_19.062628	571	651	8	26	80	0.3250000
NODE_5383_length_1073_cov_19.062628	624	704	2	2	80	0.0250000
NODE_5383_length_1073_cov_19.062628	624	704	4	37	80	0.4625000
NODE_5383_length_1073_cov_19.062628	624	704	5	4	80	0.0500000
NODE_5383_length_1073_cov_19.062628	624	704	6	26	80	0.3250000
NODE_5383_length_1073_cov_19.062628	624	704	7	11	80	0.1375000
NODE_5384_length_1073_cov_18.536961	447	527	2	46	80	0.5750000
NODE_5384_length_1073_cov_18.536961	447	527	4	34	80	0.4250000
NODE_5384_length_1073_cov_18.536961	500	580	0	19	80	0.2375000
NODE_5384_length_1073_cov_18.536961	500	580	2	61	80	0.7625000
NODE_5384_length_1073_cov_18.536961	576	656	0	4	80	0.0500000
NODE_5384_length_1073_cov_18.536961	576	656	2	76	80	0.9500000
NODE_5384_length_1073_cov_18.536961	629	709	0	3	80	0.0375000
NODE_5384_length_1073_cov_18.536961	629	709	2	77	80	0.9625000
NODE_5385_length_1073_cov_15.318275	712	792	2	10	80	0.1250000
NODE_5385_length_1073_cov_15.318275	712	792	4	70	80	0.8750000
NODE_5385_length_1073_cov_15.318275	765	845	0	35	80	0.4375000
NODE_5385_length_1073_cov_15.318275	765	845	2	3	80	0.0375000
NODE_5385_length_1073_cov_15.318275	765	845	4	42	80	0.5250000
NODE_5386_length_1073_cov_8.376797	287	367	1	80	80	1.0000000
NODE_5386_length_1073_cov_8.376797	340	420	0	32	80	0.4000000
NODE_5386_length_1073_cov_8.376797	340	420	1	48	80	0.6000000
NODE_5387_length_1073_cov_5.749487	257	337	0	80	80	1.0000000
NODE_5387_length_1073_cov_5.749487	310	390	0	80	80	1.0000000
NODE_5388_length_1073_cov_5.156057	408	444	0	36	36	1.0000000
NODE_5390_length_1073_cov_3.019507	1	69	0	68	68	1.0000000
NODE_5390_length_1073_cov_3.019507	42	122	0	80	80	1.0000000
NODE_5399_length_1072_cov_62.729702	351	431	2	7	80	0.0875000
NODE_5399_length_1072_cov_62.729702	351	431	3	24	80	0.3000000
NODE_5399_length_1072_cov_62.729702	351	431	4	43	80	0.5375000
NODE_5399_length_1072_cov_62.729702	351	431	6	6	80	0.0750000
NODE_5399_length_1072_cov_62.729702	404	484	4	27	80	0.3375000
NODE_5399_length_1072_cov_62.729702	404	484	6	22	80	0.2750000
NODE_5399_length_1072_cov_62.729702	404	484	8	31	80	0.3875000
NODE_5399_length_1072_cov_62.729702	480	560	0	28	80	0.3500000
NODE_5399_length_1072_cov_62.729702	480	560	1	24	80	0.3000000
NODE_5399_length_1072_cov_62.729702	480	560	2	11	80	0.1375000
NODE_5399_length_1072_cov_62.729702	480	560	4	17	80	0.2125000
NODE_5399_length_1072_cov_62.729702	533	613	0	80	80	1.0000000
NODE_5400_length_1072_cov_34.045221	430	510	2	9	80	0.1125000
NODE_5400_length_1072_cov_34.045221	430	510	4	35	80	0.4375000
NODE_5400_length_1072_cov_34.045221	430	510	6	12	80	0.1500000
NODE_5400_length_1072_cov_34.045221	430	510	8	24	80	0.3000000
NODE_5400_length_1072_cov_34.045221	483	563	2	3	80	0.0375000
NODE_5400_length_1072_cov_34.045221	483	563	6	24	80	0.3000000
NODE_5400_length_1072_cov_34.045221	483	563	8	53	80	0.6625000
NODE_5401_length_1072_cov_34.006166	342	423	4	14	81	0.1728395
NODE_5401_length_1072_cov_34.006166	342	423	6	67	81	0.8271605
NODE_5401_length_1072_cov_34.006166	396	476	0	16	80	0.2000000
NODE_5401_length_1072_cov_34.006166	396	476	2	17	80	0.2125000
NODE_5401_length_1072_cov_34.006166	396	476	4	21	80	0.2625000
NODE_5401_length_1072_cov_34.006166	396	476	6	26	80	0.3250000
NODE_5401_length_1072_cov_34.006166	472	552	0	7	80	0.0875000
NODE_5401_length_1072_cov_34.006166	472	552	2	73	80	0.9125000
NODE_5401_length_1072_cov_34.006166	525	605	0	43	80	0.5375000
NODE_5401_length_1072_cov_34.006166	525	605	2	37	80	0.4625000
NODE_5403_length_1072_cov_21.852004	300	380	0	52	80	0.6500000
NODE_5403_length_1072_cov_21.852004	300	380	2	4	80	0.0500000
NODE_5403_length_1072_cov_21.852004	300	380	4	19	80	0.2375000
NODE_5403_length_1072_cov_21.852004	300	380	6	5	80	0.0625000
NODE_5403_length_1072_cov_21.852004	353	433	2	3	80	0.0375000
NODE_5403_length_1072_cov_21.852004	353	433	4	20	80	0.2500000
NODE_5403_length_1072_cov_21.852004	353	433	6	57	80	0.7125000
NODE_5404_length_1072_cov_21.532374	476	556	2	7	80	0.0875000
NODE_5404_length_1072_cov_21.532374	476	556	4	25	80	0.3125000
NODE_5404_length_1072_cov_21.532374	476	556	6	48	80	0.6000000
NODE_5404_length_1072_cov_21.532374	529	609	2	4	80	0.0500000
NODE_5404_length_1072_cov_21.532374	529	609	4	39	80	0.4875000
NODE_5404_length_1072_cov_21.532374	529	609	6	37	80	0.4625000
NODE_5405_length_1072_cov_17.018499	415	495	0	68	80	0.8500000
NODE_5405_length_1072_cov_17.018499	415	495	2	12	80	0.1500000
NODE_5405_length_1072_cov_17.018499	468	548	0	80	80	1.0000000
NODE_5410_length_1072_cov_3.302158	388	449	1	35	61	0.5737705
NODE_5410_length_1072_cov_3.302158	388	449	2	3	61	0.0491803
NODE_5410_length_1072_cov_3.302158	388	449	3	23	61	0.3770492
NODE_5410_length_1072_cov_3.302158	422	502	1	80	80	1.0000000
NODE_5414_length_1072_cov_1.773895	114	176	1	7	62	0.1129032
NODE_5414_length_1072_cov_1.773895	114	176	2	9	62	0.1451613
NODE_5414_length_1072_cov_1.773895	114	176	4	46	62	0.7419355
NODE_5417_length_1071_cov_27.565844	312	392	0	4	80	0.0500000
NODE_5417_length_1071_cov_27.565844	312	392	4	55	80	0.6875000
NODE_5417_length_1071_cov_27.565844	312	392	6	21	80	0.2625000
NODE_5417_length_1071_cov_27.565844	365	445	0	10	80	0.1250000
NODE_5417_length_1071_cov_27.565844	365	445	2	22	80	0.2750000
NODE_5417_length_1071_cov_27.565844	365	445	4	6	80	0.0750000
NODE_5417_length_1071_cov_27.565844	365	445	6	42	80	0.5250000
NODE_5419_length_1071_cov_12.666667	480	560	0	77	80	0.9625000
NODE_5419_length_1071_cov_12.666667	480	560	2	3	80	0.0375000
NODE_5419_length_1071_cov_12.666667	533	613	0	24	80	0.3000000
NODE_5419_length_1071_cov_12.666667	533	613	2	56	80	0.7000000
NODE_5421_length_1071_cov_8.942387	418	498	0	80	80	1.0000000
NODE_5421_length_1071_cov_8.942387	471	551	0	80	80	1.0000000
NODE_5427_length_1070_cov_39.255407	591	671	0	80	80	1.0000000
NODE_5427_length_1070_cov_39.255407	644	724	0	80	80	1.0000000
NODE_5428_length_1070_cov_21.903193	430	510	0	80	80	1.0000000
NODE_5428_length_1070_cov_21.903193	483	563	0	80	80	1.0000000
NODE_5428_length_1070_cov_21.903193	559	639	0	55	80	0.6875000
NODE_5428_length_1070_cov_21.903193	559	639	2	2	80	0.0250000
NODE_5428_length_1070_cov_21.903193	559	639	4	23	80	0.2875000
NODE_5428_length_1070_cov_21.903193	612	692	0	2	80	0.0250000
NODE_5428_length_1070_cov_21.903193	612	692	2	2	80	0.0250000
NODE_5428_length_1070_cov_21.903193	612	692	4	76	80	0.9500000
NODE_5429_length_1070_cov_8.963955	871	900	0	2	29	0.0689655
NODE_5429_length_1070_cov_8.963955	871	900	4	1	29	0.0344828
NODE_5429_length_1070_cov_8.963955	871	900	8	2	29	0.0689655
NODE_5429_length_1070_cov_8.963955	871	900	25	1	29	0.0344828
NODE_5429_length_1070_cov_8.963955	871	900	27	1	29	0.0344828
NODE_5429_length_1070_cov_8.963955	871	900	29	1	29	0.0344828
NODE_5429_length_1070_cov_8.963955	871	900	37	2	29	0.0689655
NODE_5429_length_1070_cov_8.963955	871	900	41	3	29	0.1034483
NODE_5429_length_1070_cov_8.963955	871	900	44	1	29	0.0344828
NODE_5429_length_1070_cov_8.963955	871	900	45	5	29	0.1724138
NODE_5429_length_1070_cov_8.963955	871	900	47	4	29	0.1379310
NODE_5429_length_1070_cov_8.963955	871	900	49	1	29	0.0344828
NODE_5429_length_1070_cov_8.963955	871	900	50	1	29	0.0344828
NODE_5429_length_1070_cov_8.963955	871	900	56	1	29	0.0344828
NODE_5429_length_1070_cov_8.963955	871	900	58	1	29	0.0344828
NODE_5429_length_1070_cov_8.963955	871	900	62	1	29	0.0344828
NODE_5429_length_1070_cov_8.963955	871	900	63	1	29	0.0344828
NODE_5429_length_1070_cov_8.963955	873	953	4	1	80	0.0125000
NODE_5429_length_1070_cov_8.963955	873	953	8	2	80	0.0250000
NODE_5429_length_1070_cov_8.963955	873	953	25	1	80	0.0125000
NODE_5429_length_1070_cov_8.963955	873	953	27	1	80	0.0125000
NODE_5429_length_1070_cov_8.963955	873	953	29	1	80	0.0125000
NODE_5429_length_1070_cov_8.963955	873	953	37	2	80	0.0250000
NODE_5429_length_1070_cov_8.963955	873	953	41	3	80	0.0375000
NODE_5429_length_1070_cov_8.963955	873	953	44	1	80	0.0125000
NODE_5429_length_1070_cov_8.963955	873	953	45	5	80	0.0625000
NODE_5429_length_1070_cov_8.963955	873	953	47	4	80	0.0500000
NODE_5429_length_1070_cov_8.963955	873	953	49	1	80	0.0125000
NODE_5429_length_1070_cov_8.963955	873	953	50	1	80	0.0125000
NODE_5429_length_1070_cov_8.963955	873	953	56	1	80	0.0125000
NODE_5429_length_1070_cov_8.963955	873	953	58	1	80	0.0125000
NODE_5429_length_1070_cov_8.963955	873	953	62	1	80	0.0125000
NODE_5429_length_1070_cov_8.963955	873	953	63	2	80	0.0250000
NODE_5429_length_1070_cov_8.963955	873	953	70	1	80	0.0125000
NODE_5429_length_1070_cov_8.963955	873	953	73	2	80	0.0250000
NODE_5429_length_1070_cov_8.963955	873	953	77	1	80	0.0125000
NODE_5429_length_1070_cov_8.963955	873	953	81	1	80	0.0125000
NODE_5429_length_1070_cov_8.963955	873	953	85	2	80	0.0250000
NODE_5429_length_1070_cov_8.963955	873	953	90	1	80	0.0125000
NODE_5429_length_1070_cov_8.963955	873	953	94	5	80	0.0625000
NODE_5429_length_1070_cov_8.963955	873	953	96	2	80	0.0250000
NODE_5429_length_1070_cov_8.963955	873	953	98	1	80	0.0125000
NODE_5429_length_1070_cov_8.963955	873	953	102	2	80	0.0250000
NODE_5429_length_1070_cov_8.963955	873	953	106	4	80	0.0500000
NODE_5429_length_1070_cov_8.963955	873	953	108	1	80	0.0125000
NODE_5429_length_1070_cov_8.963955	873	953	109	1	80	0.0125000
NODE_5429_length_1070_cov_8.963955	873	953	111	1	80	0.0125000
NODE_5429_length_1070_cov_8.963955	873	953	112	3	80	0.0375000
NODE_5429_length_1070_cov_8.963955	873	953	114	5	80	0.0625000
NODE_5429_length_1070_cov_8.963955	873	953	116	2	80	0.0250000
NODE_5429_length_1070_cov_8.963955	873	953	119	1	80	0.0125000
NODE_5429_length_1070_cov_8.963955	873	953	122	16	80	0.2000000
NODE_5433_length_1070_cov_1.659114	1027	1046	0	19	19	1.0000000
NODE_5439_length_1069_cov_40.277320	451	531	2	4	80	0.0500000
NODE_5439_length_1069_cov_40.277320	451	531	4	10	80	0.1250000
NODE_5439_length_1069_cov_40.277320	451	531	6	1	80	0.0125000
NODE_5439_length_1069_cov_40.277320	451	531	9	4	80	0.0500000
NODE_5439_length_1069_cov_40.277320	451	531	13	8	80	0.1000000
NODE_5439_length_1069_cov_40.277320	451	531	14	6	80	0.0750000
NODE_5439_length_1069_cov_40.277320	451	531	16	8	80	0.1000000
NODE_5439_length_1069_cov_40.277320	451	531	18	3	80	0.0375000
NODE_5439_length_1069_cov_40.277320	451	531	20	36	80	0.4500000
NODE_5439_length_1069_cov_40.277320	504	584	2	4	80	0.0500000
NODE_5439_length_1069_cov_40.277320	504	584	6	3	80	0.0375000
NODE_5439_length_1069_cov_40.277320	504	584	8	4	80	0.0500000
NODE_5439_length_1069_cov_40.277320	504	584	10	11	80	0.1375000
NODE_5439_length_1069_cov_40.277320	504	584	12	1	80	0.0125000
NODE_5439_length_1069_cov_40.277320	504	584	16	23	80	0.2875000
NODE_5439_length_1069_cov_40.277320	504	584	18	5	80	0.0625000
NODE_5439_length_1069_cov_40.277320	504	584	20	29	80	0.3625000
NODE_5440_length_1069_cov_23.571134	274	354	0	80	80	1.0000000
NODE_5440_length_1069_cov_23.571134	327	407	0	80	80	1.0000000
NODE_5441_length_1069_cov_22.436082	185	265	0	80	80	1.0000000
NODE_5441_length_1069_cov_22.436082	238	318	0	80	80	1.0000000
NODE_5442_length_1069_cov_18.207216	436	516	0	35	80	0.4375000
NODE_5442_length_1069_cov_18.207216	436	516	2	2	80	0.0250000
NODE_5442_length_1069_cov_18.207216	436	516	4	9	80	0.1125000
NODE_5442_length_1069_cov_18.207216	436	516	6	9	80	0.1125000
NODE_5442_length_1069_cov_18.207216	436	516	8	10	80	0.1250000
NODE_5442_length_1069_cov_18.207216	436	516	12	7	80	0.0875000
NODE_5442_length_1069_cov_18.207216	436	516	13	6	80	0.0750000
NODE_5442_length_1069_cov_18.207216	436	516	14	2	80	0.0250000
NODE_5442_length_1069_cov_18.207216	489	569	6	2	80	0.0250000
NODE_5442_length_1069_cov_18.207216	489	569	8	10	80	0.1250000
NODE_5442_length_1069_cov_18.207216	489	569	12	28	80	0.3500000
NODE_5442_length_1069_cov_18.207216	489	569	13	6	80	0.0750000
NODE_5442_length_1069_cov_18.207216	489	569	14	9	80	0.1125000
NODE_5442_length_1069_cov_18.207216	489	569	16	25	80	0.3125000
NODE_5443_length_1069_cov_17.601031	596	676	0	35	80	0.4375000
NODE_5443_length_1069_cov_17.601031	596	676	4	14	80	0.1750000
NODE_5443_length_1069_cov_17.601031	596	676	6	31	80	0.3875000
NODE_5443_length_1069_cov_17.601031	649	729	2	15	80	0.1875000
NODE_5443_length_1069_cov_17.601031	649	729	6	65	80	0.8125000
NODE_5444_length_1069_cov_16.318557	353	433	0	8	80	0.1000000
NODE_5444_length_1069_cov_16.318557	353	433	2	9	80	0.1125000
NODE_5444_length_1069_cov_16.318557	353	433	4	63	80	0.7875000
NODE_5444_length_1069_cov_16.318557	406	486	0	61	80	0.7625000
NODE_5444_length_1069_cov_16.318557	406	486	2	9	80	0.1125000
NODE_5444_length_1069_cov_16.318557	406	486	4	10	80	0.1250000
NODE_5444_length_1069_cov_16.318557	482	562	0	80	80	1.0000000
NODE_5444_length_1069_cov_16.318557	535	615	0	80	80	1.0000000
NODE_5445_length_1069_cov_13.349485	471	551	4	80	80	1.0000000
NODE_5445_length_1069_cov_13.349485	524	604	2	37	80	0.4625000
NODE_5445_length_1069_cov_13.349485	524	604	4	29	80	0.3625000
NODE_5445_length_1069_cov_13.349485	524	604	6	14	80	0.1750000
NODE_5446_length_1069_cov_13.050515	314	394	0	80	80	1.0000000
NODE_5446_length_1069_cov_13.050515	367	447	0	80	80	1.0000000
NODE_5447_length_1069_cov_12.818557	240	320	2	80	80	1.0000000
NODE_5447_length_1069_cov_12.818557	293	373	0	12	80	0.1500000
NODE_5447_length_1069_cov_12.818557	293	373	2	68	80	0.8500000
NODE_5448_length_1069_cov_11.985567	554	634	0	80	80	1.0000000
NODE_5448_length_1069_cov_11.985567	607	687	0	80	80	1.0000000
NODE_5449_length_1069_cov_10.812371	366	446	0	49	80	0.6125000
NODE_5449_length_1069_cov_10.812371	366	446	2	31	80	0.3875000
NODE_5449_length_1069_cov_10.812371	419	499	2	80	80	1.0000000
NODE_5450_length_1069_cov_7.729897	482	562	2	9	80	0.1125000
NODE_5450_length_1069_cov_7.729897	482	562	4	12	80	0.1500000
NODE_5450_length_1069_cov_7.729897	482	562	6	59	80	0.7375000
NODE_5450_length_1069_cov_7.729897	535	615	0	14	80	0.1750000
NODE_5450_length_1069_cov_7.729897	535	615	2	21	80	0.2625000
NODE_5450_length_1069_cov_7.729897	535	615	4	23	80	0.2875000
NODE_5450_length_1069_cov_7.729897	535	615	6	22	80	0.2750000
NODE_5456_length_1068_cov_31.692466	314	394	0	48	80	0.6000000
NODE_5456_length_1068_cov_31.692466	314	394	2	32	80	0.4000000
NODE_5456_length_1068_cov_31.692466	367	447	0	80	80	1.0000000
NODE_5456_length_1068_cov_31.692466	443	523	0	80	80	1.0000000
NODE_5456_length_1068_cov_31.692466	496	576	0	80	80	1.0000000
NODE_5457_length_1068_cov_29.579979	347	427	2	5	80	0.0625000
NODE_5457_length_1068_cov_29.579979	347	427	4	23	80	0.2875000
NODE_5457_length_1068_cov_29.579979	347	427	8	52	80	0.6500000
NODE_5457_length_1068_cov_29.579979	400	480	4	14	80	0.1750000
NODE_5457_length_1068_cov_29.579979	400	480	6	22	80	0.2750000
NODE_5457_length_1068_cov_29.579979	400	480	8	44	80	0.5500000
NODE_5459_length_1068_cov_23.020640	476	556	2	7	80	0.0875000
NODE_5459_length_1068_cov_23.020640	476	556	4	17	80	0.2125000
NODE_5459_length_1068_cov_23.020640	476	556	6	47	80	0.5875000
NODE_5459_length_1068_cov_23.020640	476	556	10	9	80	0.1125000
NODE_5459_length_1068_cov_23.020640	529	609	6	24	80	0.3000000
NODE_5459_length_1068_cov_23.020640	529	609	8	2	80	0.0250000
NODE_5459_length_1068_cov_23.020640	529	609	10	23	80	0.2875000
NODE_5459_length_1068_cov_23.020640	529	609	11	19	80	0.2375000
NODE_5459_length_1068_cov_23.020640	529	609	12	12	80	0.1500000
NODE_5460_length_1068_cov_15.272446	546	626	0	68	80	0.8500000
NODE_5460_length_1068_cov_15.272446	546	626	2	12	80	0.1500000
NODE_5460_length_1068_cov_15.272446	599	679	0	15	80	0.1875000
NODE_5460_length_1068_cov_15.272446	599	679	2	65	80	0.8125000
NODE_5461_length_1068_cov_13.557276	674	754	0	21	80	0.2625000
NODE_5461_length_1068_cov_13.557276	674	754	2	59	80	0.7375000
NODE_5461_length_1068_cov_13.557276	727	807	0	74	80	0.9250000
NODE_5461_length_1068_cov_13.557276	727	807	2	6	80	0.0750000
NODE_5479_length_1067_cov_48.282025	429	509	0	80	80	1.0000000
NODE_5479_length_1067_cov_48.282025	482	562	0	80	80	1.0000000
NODE_5480_length_1067_cov_41.111570	460	540	4	20	80	0.2500000
NODE_5480_length_1067_cov_41.111570	460	540	6	35	80	0.4375000
NODE_5480_length_1067_cov_41.111570	460	540	8	25	80	0.3125000
NODE_5480_length_1067_cov_41.111570	513	593	2	35	80	0.4375000
NODE_5480_length_1067_cov_41.111570	513	593	6	5	80	0.0625000
NODE_5480_length_1067_cov_41.111570	513	593	8	40	80	0.5000000
NODE_5481_length_1067_cov_39.109504	295	375	0	80	80	1.0000000
NODE_5481_length_1067_cov_39.109504	348	428	0	45	80	0.5625000
NODE_5481_length_1067_cov_39.109504	348	428	2	35	80	0.4375000
NODE_5481_length_1067_cov_39.109504	424	504	2	17	80	0.2125000
NODE_5481_length_1067_cov_39.109504	424	504	4	61	80	0.7625000
NODE_5481_length_1067_cov_39.109504	424	504	6	2	80	0.0250000
NODE_5481_length_1067_cov_39.109504	477	557	2	40	80	0.5000000
NODE_5481_length_1067_cov_39.109504	477	557	4	40	80	0.5000000
NODE_5482_length_1067_cov_35.426653	252	332	8	63	80	0.7875000
NODE_5482_length_1067_cov_35.426653	252	332	10	1	80	0.0125000
NODE_5482_length_1067_cov_35.426653	252	332	12	16	80	0.2000000
NODE_5482_length_1067_cov_35.426653	305	385	4	51	80	0.6375000
NODE_5482_length_1067_cov_35.426653	305	385	8	12	80	0.1500000
NODE_5482_length_1067_cov_35.426653	305	385	10	1	80	0.0125000
NODE_5482_length_1067_cov_35.426653	305	385	12	16	80	0.2000000
NODE_5483_length_1067_cov_29.467975	412	492	0	31	80	0.3875000
NODE_5483_length_1067_cov_29.467975	412	492	2	26	80	0.3250000
NODE_5483_length_1067_cov_29.467975	412	492	4	23	80	0.2875000
NODE_5483_length_1067_cov_29.467975	465	545	2	12	80	0.1500000
NODE_5483_length_1067_cov_29.467975	465	545	4	68	80	0.8500000
NODE_5484_length_1067_cov_20.738636	579	645	12	5	66	0.0757576
NODE_5484_length_1067_cov_20.738636	579	645	14	9	66	0.1363636
NODE_5484_length_1067_cov_20.738636	579	645	16	10	66	0.1515152
NODE_5484_length_1067_cov_20.738636	579	645	18	1	66	0.0151515
NODE_5484_length_1067_cov_20.738636	579	645	20	3	66	0.0454545
NODE_5484_length_1067_cov_20.738636	579	645	26	1	66	0.0151515
NODE_5484_length_1067_cov_20.738636	579	645	32	1	66	0.0151515
NODE_5484_length_1067_cov_20.738636	579	645	36	1	66	0.0151515
NODE_5484_length_1067_cov_20.738636	579	645	37	8	66	0.1212121
NODE_5484_length_1067_cov_20.738636	579	645	41	2	66	0.0303030
NODE_5484_length_1067_cov_20.738636	579	645	42	1	66	0.0151515
NODE_5484_length_1067_cov_20.738636	579	645	43	4	66	0.0606061
NODE_5484_length_1067_cov_20.738636	579	645	44	3	66	0.0454545
NODE_5484_length_1067_cov_20.738636	579	645	50	12	66	0.1818182
NODE_5484_length_1067_cov_20.738636	579	645	52	5	66	0.0757576
NODE_5484_length_1067_cov_20.738636	618	698	41	2	80	0.0250000
NODE_5484_length_1067_cov_20.738636	618	698	42	1	80	0.0125000
NODE_5484_length_1067_cov_20.738636	618	698	43	4	80	0.0500000
NODE_5484_length_1067_cov_20.738636	618	698	44	3	80	0.0375000
NODE_5484_length_1067_cov_20.738636	618	698	50	12	80	0.1500000
NODE_5484_length_1067_cov_20.738636	618	698	52	9	80	0.1125000
NODE_5484_length_1067_cov_20.738636	618	698	54	2	80	0.0250000
NODE_5484_length_1067_cov_20.738636	618	698	55	1	80	0.0125000
NODE_5484_length_1067_cov_20.738636	618	698	58	1	80	0.0125000
NODE_5484_length_1067_cov_20.738636	618	698	60	4	80	0.0500000
NODE_5484_length_1067_cov_20.738636	618	698	64	1	80	0.0125000
NODE_5484_length_1067_cov_20.738636	618	698	65	1	80	0.0125000
NODE_5484_length_1067_cov_20.738636	618	698	66	13	80	0.1625000
NODE_5484_length_1067_cov_20.738636	618	698	68	3	80	0.0375000
NODE_5484_length_1067_cov_20.738636	618	698	70	2	80	0.0250000
NODE_5484_length_1067_cov_20.738636	618	698	72	6	80	0.0750000
NODE_5484_length_1067_cov_20.738636	618	698	73	2	80	0.0250000
NODE_5484_length_1067_cov_20.738636	618	698	74	6	80	0.0750000
NODE_5484_length_1067_cov_20.738636	618	698	75	3	80	0.0375000
NODE_5484_length_1067_cov_20.738636	618	698	77	4	80	0.0500000
NODE_5485_length_1067_cov_15.280992	538	617	0	20	79	0.2531646
NODE_5485_length_1067_cov_15.280992	538	617	4	3	79	0.0379747
NODE_5485_length_1067_cov_15.280992	538	617	6	56	79	0.7088608
NODE_5485_length_1067_cov_15.280992	590	670	4	9	80	0.1125000
NODE_5485_length_1067_cov_15.280992	590	670	6	71	80	0.8875000
NODE_5486_length_1067_cov_13.708678	478	558	2	68	80	0.8500000
NODE_5486_length_1067_cov_13.708678	478	558	4	12	80	0.1500000
NODE_5486_length_1067_cov_13.708678	531	611	0	2	80	0.0250000
NODE_5486_length_1067_cov_13.708678	531	611	2	78	80	0.9750000
NODE_5488_length_1067_cov_9.070248	625	705	2	40	80	0.5000000
NODE_5488_length_1067_cov_9.070248	625	705	4	30	80	0.3750000
NODE_5488_length_1067_cov_9.070248	625	705	5	10	80	0.1250000
NODE_5488_length_1067_cov_9.070248	678	758	2	19	80	0.2375000
NODE_5488_length_1067_cov_9.070248	678	758	3	48	80	0.6000000
NODE_5488_length_1067_cov_9.070248	678	758	4	13	80	0.1625000
NODE_5494_length_1067_cov_1.946281	765	812	0	47	47	1.0000000
NODE_5501_length_1066_cov_54.227508	395	475	4	31	80	0.3875000
NODE_5501_length_1066_cov_54.227508	395	475	6	17	80	0.2125000
NODE_5501_length_1066_cov_54.227508	395	475	8	3	80	0.0375000
NODE_5501_length_1066_cov_54.227508	395	475	10	29	80	0.3625000
NODE_5501_length_1066_cov_54.227508	448	528	4	16	80	0.2000000
NODE_5501_length_1066_cov_54.227508	448	528	6	37	80	0.4625000
NODE_5501_length_1066_cov_54.227508	448	528	10	27	80	0.3375000
NODE_5502_length_1066_cov_33.501551	357	437	2	33	80	0.4125000
NODE_5502_length_1066_cov_33.501551	357	437	4	1	80	0.0125000
NODE_5502_length_1066_cov_33.501551	357	437	7	4	80	0.0500000
NODE_5502_length_1066_cov_33.501551	357	437	9	19	80	0.2375000
NODE_5502_length_1066_cov_33.501551	357	437	10	16	80	0.2000000
NODE_5502_length_1066_cov_33.501551	357	437	16	4	80	0.0500000
NODE_5502_length_1066_cov_33.501551	357	437	18	3	80	0.0375000
NODE_5502_length_1066_cov_33.501551	410	490	9	4	80	0.0500000
NODE_5502_length_1066_cov_33.501551	410	490	10	16	80	0.2000000
NODE_5502_length_1066_cov_33.501551	410	490	16	5	80	0.0625000
NODE_5502_length_1066_cov_33.501551	410	490	18	54	80	0.6750000
NODE_5502_length_1066_cov_33.501551	410	490	20	1	80	0.0125000
NODE_5503_length_1066_cov_33.115822	397	477	4	18	80	0.2250000
NODE_5503_length_1066_cov_33.115822	397	477	9	7	80	0.0875000
NODE_5503_length_1066_cov_33.115822	397	477	10	39	80	0.4875000
NODE_5503_length_1066_cov_33.115822	397	477	12	6	80	0.0750000
NODE_5503_length_1066_cov_33.115822	397	477	14	10	80	0.1250000
NODE_5503_length_1066_cov_33.115822	450	530	4	8	80	0.1000000
NODE_5503_length_1066_cov_33.115822	450	530	9	52	80	0.6500000
NODE_5503_length_1066_cov_33.115822	450	530	10	10	80	0.1250000
NODE_5503_length_1066_cov_33.115822	450	530	14	10	80	0.1250000
NODE_5504_length_1066_cov_26.517063	215	285	199	2	70	0.0285714
NODE_5504_length_1066_cov_26.517063	215	285	201	4	70	0.0571429
NODE_5504_length_1066_cov_26.517063	215	285	203	3	70	0.0428571
NODE_5504_length_1066_cov_26.517063	215	285	204	1	70	0.0142857
NODE_5504_length_1066_cov_26.517063	215	285	205	3	70	0.0428571
NODE_5504_length_1066_cov_26.517063	215	285	207	4	70	0.0571429
NODE_5504_length_1066_cov_26.517063	215	285	219	2	70	0.0285714
NODE_5504_length_1066_cov_26.517063	215	285	225	1	70	0.0142857
NODE_5504_length_1066_cov_26.517063	215	285	226	1	70	0.0142857
NODE_5504_length_1066_cov_26.517063	215	285	227	2	70	0.0285714
NODE_5504_length_1066_cov_26.517063	215	285	229	3	70	0.0428571
NODE_5504_length_1066_cov_26.517063	215	285	232	1	70	0.0142857
NODE_5504_length_1066_cov_26.517063	215	285	233	1	70	0.0142857
NODE_5504_length_1066_cov_26.517063	215	285	237	2	70	0.0285714
NODE_5504_length_1066_cov_26.517063	215	285	238	1	70	0.0142857
NODE_5504_length_1066_cov_26.517063	215	285	241	1	70	0.0142857
NODE_5504_length_1066_cov_26.517063	215	285	242	2	70	0.0285714
NODE_5504_length_1066_cov_26.517063	215	285	243	1	70	0.0142857
NODE_5504_length_1066_cov_26.517063	215	285	244	3	70	0.0428571
NODE_5504_length_1066_cov_26.517063	215	285	248	1	70	0.0142857
NODE_5504_length_1066_cov_26.517063	215	285	251	2	70	0.0285714
NODE_5504_length_1066_cov_26.517063	215	285	254	2	70	0.0285714
NODE_5504_length_1066_cov_26.517063	215	285	255	1	70	0.0142857
NODE_5504_length_1066_cov_26.517063	215	285	256	3	70	0.0428571
NODE_5504_length_1066_cov_26.517063	215	285	257	1	70	0.0142857
NODE_5504_length_1066_cov_26.517063	215	285	259	4	70	0.0571429
NODE_5504_length_1066_cov_26.517063	215	285	260	1	70	0.0142857
NODE_5504_length_1066_cov_26.517063	215	285	262	6	70	0.0857143
NODE_5504_length_1066_cov_26.517063	215	285	263	1	70	0.0142857
NODE_5504_length_1066_cov_26.517063	215	285	266	2	70	0.0285714
NODE_5504_length_1066_cov_26.517063	215	285	268	1	70	0.0142857
NODE_5504_length_1066_cov_26.517063	215	285	269	1	70	0.0142857
NODE_5504_length_1066_cov_26.517063	215	285	271	1	70	0.0142857
NODE_5504_length_1066_cov_26.517063	215	285	274	2	70	0.0285714
NODE_5504_length_1066_cov_26.517063	215	285	275	1	70	0.0142857
NODE_5504_length_1066_cov_26.517063	215	285	278	1	70	0.0142857
NODE_5504_length_1066_cov_26.517063	215	285	280	1	70	0.0142857
NODE_5505_length_1066_cov_16.906929	526	606	0	22	80	0.2750000
NODE_5505_length_1066_cov_16.906929	526	606	2	58	80	0.7250000
NODE_5505_length_1066_cov_16.906929	579	659	0	32	80	0.4000000
NODE_5505_length_1066_cov_16.906929	579	659	2	48	80	0.6000000
NODE_5506_length_1066_cov_16.190279	298	378	0	74	80	0.9250000
NODE_5506_length_1066_cov_16.190279	298	378	2	6	80	0.0750000
NODE_5506_length_1066_cov_16.190279	351	432	0	21	81	0.2592593
NODE_5506_length_1066_cov_16.190279	351	432	2	60	81	0.7407407
NODE_5507_length_1066_cov_15.444674	582	662	4	17	80	0.2125000
NODE_5507_length_1066_cov_15.444674	582	662	6	1	80	0.0125000
NODE_5507_length_1066_cov_15.444674	582	662	12	6	80	0.0750000
NODE_5507_length_1066_cov_15.444674	582	662	14	22	80	0.2750000
NODE_5507_length_1066_cov_15.444674	582	662	16	20	80	0.2500000
NODE_5507_length_1066_cov_15.444674	582	662	18	13	80	0.1625000
NODE_5507_length_1066_cov_15.444674	582	662	20	1	80	0.0125000
NODE_5507_length_1066_cov_15.444674	635	715	0	6	80	0.0750000
NODE_5507_length_1066_cov_15.444674	635	715	2	43	80	0.5375000
NODE_5507_length_1066_cov_15.444674	635	715	4	21	80	0.2625000
NODE_5507_length_1066_cov_15.444674	635	715	6	1	80	0.0125000
NODE_5507_length_1066_cov_15.444674	635	715	12	6	80	0.0750000
NODE_5507_length_1066_cov_15.444674	635	715	14	3	80	0.0375000
NODE_5516_length_1065_cov_51.693582	480	560	4	8	80	0.1000000
NODE_5516_length_1065_cov_51.693582	480	560	5	72	80	0.9000000
NODE_5516_length_1065_cov_51.693582	533	613	1	11	80	0.1375000
NODE_5516_length_1065_cov_51.693582	533	613	2	14	80	0.1750000
NODE_5516_length_1065_cov_51.693582	533	613	3	26	80	0.3250000
NODE_5516_length_1065_cov_51.693582	533	613	4	5	80	0.0625000
NODE_5516_length_1065_cov_51.693582	533	613	5	24	80	0.3000000
NODE_5517_length_1065_cov_33.428571	422	502	0	54	80	0.6750000
NODE_5517_length_1065_cov_33.428571	422	502	2	12	80	0.1500000
NODE_5517_length_1065_cov_33.428571	422	502	3	4	80	0.0500000
NODE_5517_length_1065_cov_33.428571	422	502	4	10	80	0.1250000
NODE_5517_length_1065_cov_33.428571	422	502	0	54	80	0.6750000
NODE_5517_length_1065_cov_33.428571	422	502	2	12	80	0.1500000
NODE_5517_length_1065_cov_33.428571	422	502	3	4	80	0.0500000
NODE_5517_length_1065_cov_33.428571	422	502	4	10	80	0.1250000
NODE_5517_length_1065_cov_33.428571	422	502	0	54	80	0.6750000
NODE_5517_length_1065_cov_33.428571	422	502	2	12	80	0.1500000
NODE_5517_length_1065_cov_33.428571	422	502	3	4	80	0.0500000
NODE_5517_length_1065_cov_33.428571	422	502	4	10	80	0.1250000
NODE_5517_length_1065_cov_33.428571	475	555	0	17	80	0.2125000
NODE_5517_length_1065_cov_33.428571	475	555	4	24	80	0.3000000
NODE_5517_length_1065_cov_33.428571	475	555	8	11	80	0.1375000
NODE_5517_length_1065_cov_33.428571	475	555	10	8	80	0.1000000
NODE_5517_length_1065_cov_33.428571	475	555	12	8	80	0.1000000
NODE_5517_length_1065_cov_33.428571	475	555	14	12	80	0.1500000
NODE_5517_length_1065_cov_33.428571	475	555	0	17	80	0.2125000
NODE_5517_length_1065_cov_33.428571	475	555	4	24	80	0.3000000
NODE_5517_length_1065_cov_33.428571	475	555	8	11	80	0.1375000
NODE_5517_length_1065_cov_33.428571	475	555	10	8	80	0.1000000
NODE_5517_length_1065_cov_33.428571	475	555	12	8	80	0.1000000
NODE_5517_length_1065_cov_33.428571	475	555	14	12	80	0.1500000
NODE_5517_length_1065_cov_33.428571	551	631	14	5	80	0.0625000
NODE_5517_length_1065_cov_33.428571	551	631	16	2	80	0.0250000
NODE_5517_length_1065_cov_33.428571	551	631	20	5	80	0.0625000
NODE_5517_length_1065_cov_33.428571	551	631	22	6	80	0.0750000
NODE_5517_length_1065_cov_33.428571	551	631	24	60	80	0.7500000
NODE_5517_length_1065_cov_33.428571	551	631	25	1	80	0.0125000
NODE_5517_length_1065_cov_33.428571	551	631	26	1	80	0.0125000
NODE_5517_length_1065_cov_33.428571	551	631	14	5	80	0.0625000
NODE_5517_length_1065_cov_33.428571	551	631	16	2	80	0.0250000
NODE_5517_length_1065_cov_33.428571	551	631	20	5	80	0.0625000
NODE_5517_length_1065_cov_33.428571	551	631	22	6	80	0.0750000
NODE_5517_length_1065_cov_33.428571	551	631	24	60	80	0.7500000
NODE_5517_length_1065_cov_33.428571	551	631	25	1	80	0.0125000
NODE_5517_length_1065_cov_33.428571	551	631	26	1	80	0.0125000
NODE_5517_length_1065_cov_33.428571	551	572	14	5	21	0.2380952
NODE_5517_length_1065_cov_33.428571	551	572	16	2	21	0.0952381
NODE_5517_length_1065_cov_33.428571	551	572	24	14	21	0.6666667
NODE_5517_length_1065_cov_33.428571	604	666	19	1	62	0.0161290
NODE_5517_length_1065_cov_33.428571	604	666	20	4	62	0.0645161
NODE_5517_length_1065_cov_33.428571	604	666	22	29	62	0.4677419
NODE_5517_length_1065_cov_33.428571	604	666	24	25	62	0.4032258
NODE_5517_length_1065_cov_33.428571	604	666	25	3	62	0.0483871
NODE_5517_length_1065_cov_33.428571	604	684	18	5	80	0.0625000
NODE_5517_length_1065_cov_33.428571	604	684	19	1	80	0.0125000
NODE_5517_length_1065_cov_33.428571	604	684	20	17	80	0.2125000
NODE_5517_length_1065_cov_33.428571	604	684	22	29	80	0.3625000
NODE_5517_length_1065_cov_33.428571	604	684	24	25	80	0.3125000
NODE_5517_length_1065_cov_33.428571	604	684	25	3	80	0.0375000
NODE_5518_length_1065_cov_31.874741	255	335	4	17	80	0.2125000
NODE_5518_length_1065_cov_31.874741	255	335	6	9	80	0.1125000
NODE_5518_length_1065_cov_31.874741	255	335	8	25	80	0.3125000
NODE_5518_length_1065_cov_31.874741	255	335	10	29	80	0.3625000
NODE_5518_length_1065_cov_31.874741	308	388	4	9	80	0.1125000
NODE_5518_length_1065_cov_31.874741	308	388	6	20	80	0.2500000
NODE_5518_length_1065_cov_31.874741	308	388	10	51	80	0.6375000
NODE_5519_length_1065_cov_21.762940	234	314	0	13	80	0.1625000
NODE_5519_length_1065_cov_21.762940	234	314	2	67	80	0.8375000
NODE_5519_length_1065_cov_21.762940	287	367	0	31	80	0.3875000
NODE_5519_length_1065_cov_21.762940	287	367	2	49	80	0.6125000
NODE_5520_length_1065_cov_19.947205	447	527	0	80	80	1.0000000
NODE_5520_length_1065_cov_19.947205	500	580	0	80	80	1.0000000
NODE_5521_length_1065_cov_14.590062	343	423	0	80	80	1.0000000
NODE_5521_length_1065_cov_14.590062	396	476	0	36	80	0.4500000
NODE_5521_length_1065_cov_14.590062	396	476	2	44	80	0.5500000
NODE_5522_length_1065_cov_13.232919	243	323	16	30	80	0.3750000
NODE_5522_length_1065_cov_13.232919	243	323	18	10	80	0.1250000
NODE_5522_length_1065_cov_13.232919	243	323	20	40	80	0.5000000
NODE_5522_length_1065_cov_13.232919	296	376	0	6	80	0.0750000
NODE_5522_length_1065_cov_13.232919	296	376	2	13	80	0.1625000
NODE_5522_length_1065_cov_13.232919	296	376	4	2	80	0.0250000
NODE_5522_length_1065_cov_13.232919	296	376	7	1	80	0.0125000
NODE_5522_length_1065_cov_13.232919	296	376	8	12	80	0.1500000
NODE_5522_length_1065_cov_13.232919	296	376	12	6	80	0.0750000
NODE_5522_length_1065_cov_13.232919	296	376	16	19	80	0.2375000
NODE_5522_length_1065_cov_13.232919	296	376	20	21	80	0.2625000
NODE_5523_length_1065_cov_10.670807	481	561	0	80	80	1.0000000
NODE_5523_length_1065_cov_10.670807	534	614	0	80	80	1.0000000
NODE_5524_length_1065_cov_10.473085	496	576	0	68	80	0.8500000
NODE_5524_length_1065_cov_10.473085	496	576	2	12	80	0.1500000
NODE_5524_length_1065_cov_10.473085	549	629	0	80	80	1.0000000
NODE_5525_length_1065_cov_9.711180	286	360	0	74	74	1.0000000
NODE_5525_length_1065_cov_9.711180	339	419	0	34	80	0.4250000
NODE_5525_length_1065_cov_9.711180	339	419	1	46	80	0.5750000
NODE_5534_length_1064_cov_59.929534	457	537	2	30	80	0.3750000
NODE_5534_length_1064_cov_59.929534	457	537	7	26	80	0.3250000
NODE_5534_length_1064_cov_59.929534	457	537	8	10	80	0.1250000
NODE_5534_length_1064_cov_59.929534	457	537	9	5	80	0.0625000
NODE_5534_length_1064_cov_59.929534	457	537	10	9	80	0.1125000
NODE_5534_length_1064_cov_59.929534	510	590	0	41	80	0.5125000
NODE_5534_length_1064_cov_59.929534	510	590	2	39	80	0.4875000
NODE_5534_length_1064_cov_59.929534	586	666	0	22	80	0.2750000
NODE_5534_length_1064_cov_59.929534	586	666	2	58	80	0.7250000
NODE_5534_length_1064_cov_59.929534	639	719	0	64	80	0.8000000
NODE_5534_length_1064_cov_59.929534	639	719	2	16	80	0.2000000
NODE_5535_length_1064_cov_36.480829	367	447	0	7	80	0.0875000
NODE_5535_length_1064_cov_36.480829	367	447	2	57	80	0.7125000
NODE_5535_length_1064_cov_36.480829	367	447	4	16	80	0.2000000
NODE_5535_length_1064_cov_36.480829	420	500	0	7	80	0.0875000
NODE_5535_length_1064_cov_36.480829	420	500	2	11	80	0.1375000
NODE_5535_length_1064_cov_36.480829	420	500	4	62	80	0.7750000
NODE_5535_length_1064_cov_36.480829	496	576	0	41	80	0.5125000
NODE_5535_length_1064_cov_36.480829	496	576	2	34	80	0.4250000
NODE_5535_length_1064_cov_36.480829	496	576	4	5	80	0.0625000
NODE_5535_length_1064_cov_36.480829	549	629	0	7	80	0.0875000
NODE_5535_length_1064_cov_36.480829	549	629	2	73	80	0.9125000
NODE_5536_length_1064_cov_32.307772	547	627	0	4	80	0.0500000
NODE_5536_length_1064_cov_32.307772	547	627	2	33	80	0.4125000
NODE_5536_length_1064_cov_32.307772	547	627	4	3	80	0.0375000
NODE_5536_length_1064_cov_32.307772	547	627	6	5	80	0.0625000
NODE_5536_length_1064_cov_32.307772	547	627	8	35	80	0.4375000
NODE_5536_length_1064_cov_32.307772	600	680	4	10	80	0.1250000
NODE_5536_length_1064_cov_32.307772	600	680	6	16	80	0.2000000
NODE_5536_length_1064_cov_32.307772	600	680	8	54	80	0.6750000
NODE_5537_length_1064_cov_25.255959	462	542	0	16	80	0.2000000
NODE_5537_length_1064_cov_25.255959	462	542	2	64	80	0.8000000
NODE_5537_length_1064_cov_25.255959	515	595	0	13	80	0.1625000
NODE_5537_length_1064_cov_25.255959	515	595	2	67	80	0.8375000
NODE_5537_length_1064_cov_25.255959	591	671	0	9	80	0.1125000
NODE_5537_length_1064_cov_25.255959	591	671	2	59	80	0.7375000
NODE_5537_length_1064_cov_25.255959	591	671	4	12	80	0.1500000
NODE_5537_length_1064_cov_25.255959	644	724	0	2	80	0.0250000
NODE_5537_length_1064_cov_25.255959	644	724	2	44	80	0.5500000
NODE_5537_length_1064_cov_25.255959	644	724	4	34	80	0.4250000
NODE_5538_length_1064_cov_23.053886	343	423	0	80	80	1.0000000
NODE_5538_length_1064_cov_23.053886	396	476	0	80	80	1.0000000
NODE_5538_length_1064_cov_23.053886	472	552	0	80	80	1.0000000
NODE_5538_length_1064_cov_23.053886	525	605	0	80	80	1.0000000
NODE_5539_length_1064_cov_22.018653	479	559	0	80	80	1.0000000
NODE_5539_length_1064_cov_22.018653	532	612	0	80	80	1.0000000
NODE_5540_length_1064_cov_12.868394	424	504	0	64	80	0.8000000
NODE_5540_length_1064_cov_12.868394	424	504	2	16	80	0.2000000
NODE_5540_length_1064_cov_12.868394	477	557	0	11	80	0.1375000
NODE_5540_length_1064_cov_12.868394	477	557	2	69	80	0.8625000
NODE_5541_length_1064_cov_10.098446	467	547	0	2	80	0.0250000
NODE_5541_length_1064_cov_10.098446	467	547	2	67	80	0.8375000
NODE_5541_length_1064_cov_10.098446	467	547	4	11	80	0.1375000
NODE_5541_length_1064_cov_10.098446	520	600	2	23	80	0.2875000
NODE_5541_length_1064_cov_10.098446	520	600	4	57	80	0.7125000
NODE_5543_length_1064_cov_2.925389	173	245	2	6	72	0.0833333
NODE_5543_length_1064_cov_2.925389	173	245	8	23	72	0.3194444
NODE_5543_length_1064_cov_2.925389	173	245	12	3	72	0.0416667
NODE_5543_length_1064_cov_2.925389	173	245	13	6	72	0.0833333
NODE_5543_length_1064_cov_2.925389	173	245	14	12	72	0.1666667
NODE_5543_length_1064_cov_2.925389	173	245	18	1	72	0.0138889
NODE_5543_length_1064_cov_2.925389	173	245	22	4	72	0.0555556
NODE_5543_length_1064_cov_2.925389	173	245	24	2	72	0.0277778
NODE_5543_length_1064_cov_2.925389	173	245	26	7	72	0.0972222
NODE_5543_length_1064_cov_2.925389	173	245	28	2	72	0.0277778
NODE_5543_length_1064_cov_2.925389	173	245	34	6	72	0.0833333
NODE_5551_length_1063_cov_104.615145	504	584	0	80	80	1.0000000
NODE_5551_length_1063_cov_104.615145	557	637	0	30	80	0.3750000
NODE_5551_length_1063_cov_104.615145	557	637	1	13	80	0.1625000
NODE_5551_length_1063_cov_104.615145	557	637	3	1	80	0.0125000
NODE_5551_length_1063_cov_104.615145	557	637	4	36	80	0.4500000
NODE_5552_length_1063_cov_36.515560	482	562	0	21	80	0.2625000
NODE_5552_length_1063_cov_36.515560	482	562	2	59	80	0.7375000
NODE_5552_length_1063_cov_36.515560	535	615	0	74	80	0.9250000
NODE_5552_length_1063_cov_36.515560	535	615	2	6	80	0.0750000
NODE_5552_length_1063_cov_36.515560	611	691	0	4	80	0.0500000
NODE_5552_length_1063_cov_36.515560	611	691	2	18	80	0.2250000
NODE_5552_length_1063_cov_36.515560	611	691	12	49	80	0.6125000
NODE_5552_length_1063_cov_36.515560	611	691	14	9	80	0.1125000
NODE_5552_length_1063_cov_36.515560	664	744	2	22	80	0.2750000
NODE_5552_length_1063_cov_36.515560	664	744	8	23	80	0.2875000
NODE_5552_length_1063_cov_36.515560	664	744	10	6	80	0.0750000
NODE_5552_length_1063_cov_36.515560	664	744	12	18	80	0.2250000
NODE_5552_length_1063_cov_36.515560	664	744	14	11	80	0.1375000
NODE_5553_length_1063_cov_30.700207	470	550	7	42	80	0.5250000
NODE_5553_length_1063_cov_30.700207	470	550	9	38	80	0.4750000
NODE_5553_length_1063_cov_30.700207	523	603	4	16	80	0.2000000
NODE_5553_length_1063_cov_30.700207	523	603	5	28	80	0.3500000
NODE_5553_length_1063_cov_30.700207	523	603	7	15	80	0.1875000
NODE_5553_length_1063_cov_30.700207	523	603	9	16	80	0.2000000
NODE_5553_length_1063_cov_30.700207	523	603	11	5	80	0.0625000
NODE_5553_length_1063_cov_30.700207	599	679	4	31	80	0.3875000
NODE_5553_length_1063_cov_30.700207	599	679	6	1	80	0.0125000
NODE_5553_length_1063_cov_30.700207	599	679	8	6	80	0.0750000
NODE_5553_length_1063_cov_30.700207	599	679	9	16	80	0.2000000
NODE_5553_length_1063_cov_30.700207	599	679	11	25	80	0.3125000
NODE_5553_length_1063_cov_30.700207	599	679	13	1	80	0.0125000
NODE_5553_length_1063_cov_30.700207	652	732	7	29	80	0.3625000
NODE_5553_length_1063_cov_30.700207	652	732	9	36	80	0.4500000
NODE_5553_length_1063_cov_30.700207	652	732	11	14	80	0.1750000
NODE_5553_length_1063_cov_30.700207	652	732	13	1	80	0.0125000
NODE_5554_length_1063_cov_24.552905	362	442	0	53	80	0.6625000
NODE_5554_length_1063_cov_24.552905	362	442	4	27	80	0.3375000
NODE_5554_length_1063_cov_24.552905	415	495	4	27	80	0.3375000
NODE_5554_length_1063_cov_24.552905	415	495	6	38	80	0.4750000
NODE_5554_length_1063_cov_24.552905	415	495	8	15	80	0.1875000
NODE_5555_length_1063_cov_21.985477	407	487	0	80	80	1.0000000
NODE_5555_length_1063_cov_21.985477	460	540	0	80	80	1.0000000
NODE_5555_length_1063_cov_21.985477	536	616	0	19	80	0.2375000
NODE_5555_length_1063_cov_21.985477	536	616	2	13	80	0.1625000
NODE_5555_length_1063_cov_21.985477	536	616	4	48	80	0.6000000
NODE_5555_length_1063_cov_21.985477	589	670	0	10	81	0.1234568
NODE_5555_length_1063_cov_21.985477	589	670	2	24	81	0.2962963
NODE_5555_length_1063_cov_21.985477	589	670	4	47	81	0.5802469
NODE_5557_length_1063_cov_15.400415	685	765	0	80	80	1.0000000
NODE_5557_length_1063_cov_15.400415	738	818	0	80	80	1.0000000
NODE_5558_length_1063_cov_13.282158	510	590	0	80	80	1.0000000
NODE_5558_length_1063_cov_13.282158	563	643	0	80	80	1.0000000
NODE_5559_length_1063_cov_12.970954	417	495	0	78	78	1.0000000
NODE_5559_length_1063_cov_12.970954	468	548	0	80	80	1.0000000
NODE_5560_length_1063_cov_7.917012	639	719	0	9	80	0.1125000
NODE_5560_length_1063_cov_7.917012	639	719	6	41	80	0.5125000
NODE_5560_length_1063_cov_7.917012	639	719	7	11	80	0.1375000
NODE_5560_length_1063_cov_7.917012	639	719	8	19	80	0.2375000
NODE_5560_length_1063_cov_7.917012	692	772	2	31	80	0.3875000
NODE_5560_length_1063_cov_7.917012	692	772	7	33	80	0.4125000
NODE_5560_length_1063_cov_7.917012	692	772	8	16	80	0.2000000
NODE_5569_length_1063_cov_1.695021	893	947	6	25	54	0.4629630
NODE_5569_length_1063_cov_1.695021	893	947	8	29	54	0.5370370
NODE_5574_length_1062_cov_43.399792	272	352	0	80	80	1.0000000
NODE_5574_length_1062_cov_43.399792	325	405	0	80	80	1.0000000
NODE_5576_length_1062_cov_19.778816	401	481	5	9	80	0.1125000
NODE_5576_length_1062_cov_19.778816	401	481	7	12	80	0.1500000
NODE_5576_length_1062_cov_19.778816	401	481	9	4	80	0.0500000
NODE_5576_length_1062_cov_19.778816	401	481	10	55	80	0.6875000
NODE_5576_length_1062_cov_19.778816	454	534	0	20	80	0.2500000
NODE_5576_length_1062_cov_19.778816	454	534	2	29	80	0.3625000
NODE_5576_length_1062_cov_19.778816	454	534	5	13	80	0.1625000
NODE_5576_length_1062_cov_19.778816	454	534	7	12	80	0.1500000
NODE_5576_length_1062_cov_19.778816	454	534	9	1	80	0.0125000
NODE_5576_length_1062_cov_19.778816	454	534	10	5	80	0.0625000
NODE_5577_length_1062_cov_16.034268	628	708	0	40	80	0.5000000
NODE_5577_length_1062_cov_16.034268	628	708	2	40	80	0.5000000
NODE_5577_length_1062_cov_16.034268	681	761	2	80	80	1.0000000
NODE_5578_length_1062_cov_13.346833	623	703	0	80	80	1.0000000
NODE_5578_length_1062_cov_13.346833	676	756	0	80	80	1.0000000
NODE_5579_length_1062_cov_9.886812	670	750	2	2	80	0.0250000
NODE_5579_length_1062_cov_9.886812	670	750	4	17	80	0.2125000
NODE_5579_length_1062_cov_9.886812	670	750	6	61	80	0.7625000
NODE_5579_length_1062_cov_9.886812	723	803	2	33	80	0.4125000
NODE_5579_length_1062_cov_9.886812	723	803	4	1	80	0.0125000
NODE_5579_length_1062_cov_9.886812	723	803	6	46	80	0.5750000
NODE_5580_length_1062_cov_9.078920	525	604	0	79	79	1.0000000
NODE_5580_length_1062_cov_9.078920	577	657	0	80	80	1.0000000
NODE_5581_length_1062_cov_8.934579	203	283	0	80	80	1.0000000
NODE_5581_length_1062_cov_8.934579	256	336	0	80	80	1.0000000
NODE_5588_length_1061_cov_22.637214	418	498	0	31	80	0.3875000
NODE_5588_length_1061_cov_22.637214	418	498	2	16	80	0.2000000
NODE_5588_length_1061_cov_22.637214	418	498	4	33	80	0.4125000
NODE_5588_length_1061_cov_22.637214	471	551	0	80	80	1.0000000
NODE_5589_length_1061_cov_22.338877	479	559	0	31	80	0.3875000
NODE_5589_length_1061_cov_22.338877	479	559	1	49	80	0.6125000
NODE_5589_length_1061_cov_22.338877	532	612	0	80	80	1.0000000
NODE_5597_length_1060_cov_31.595213	394	473	4	12	79	0.1518987
NODE_5597_length_1060_cov_31.595213	394	473	6	66	79	0.8354430
NODE_5597_length_1060_cov_31.595213	394	473	8	1	79	0.0126582
NODE_5597_length_1060_cov_31.595213	446	526	0	7	80	0.0875000
NODE_5597_length_1060_cov_31.595213	446	526	4	15	80	0.1875000
NODE_5597_length_1060_cov_31.595213	446	526	6	58	80	0.7250000
NODE_5597_length_1060_cov_31.595213	522	602	0	18	80	0.2250000
NODE_5597_length_1060_cov_31.595213	522	602	4	28	80	0.3500000
NODE_5597_length_1060_cov_31.595213	522	602	6	34	80	0.4250000
NODE_5597_length_1060_cov_31.595213	575	655	2	46	80	0.5750000
NODE_5597_length_1060_cov_31.595213	575	655	6	34	80	0.4250000
NODE_5598_length_1060_cov_26.136316	486	566	0	3	80	0.0375000
NODE_5598_length_1060_cov_26.136316	486	566	2	77	80	0.9625000
NODE_5598_length_1060_cov_26.136316	539	619	0	31	80	0.3875000
NODE_5598_length_1060_cov_26.136316	539	619	2	49	80	0.6125000
NODE_5598_length_1060_cov_26.136316	615	695	0	6	80	0.0750000
NODE_5598_length_1060_cov_26.136316	615	695	2	44	80	0.5500000
NODE_5598_length_1060_cov_26.136316	615	695	4	30	80	0.3750000
NODE_5598_length_1060_cov_26.136316	668	748	0	8	80	0.1000000
NODE_5598_length_1060_cov_26.136316	668	748	2	60	80	0.7500000
NODE_5598_length_1060_cov_26.136316	668	748	4	12	80	0.1500000
NODE_5599_length_1060_cov_25.329865	370	450	0	80	80	1.0000000
NODE_5599_length_1060_cov_25.329865	423	503	0	65	80	0.8125000
NODE_5599_length_1060_cov_25.329865	423	503	2	6	80	0.0750000
NODE_5599_length_1060_cov_25.329865	423	503	4	9	80	0.1125000
NODE_5600_length_1060_cov_16.881374	539	611	0	51	72	0.7083333
NODE_5600_length_1060_cov_16.881374	539	611	1	4	72	0.0555556
NODE_5600_length_1060_cov_16.881374	539	611	2	17	72	0.2361111
NODE_5601_length_1060_cov_14.789802	406	486	0	38	80	0.4750000
NODE_5601_length_1060_cov_14.789802	406	486	2	42	80	0.5250000
NODE_5601_length_1060_cov_14.789802	459	539	2	80	80	1.0000000
NODE_5603_length_1060_cov_5.900104	517	597	0	80	80	1.0000000
NODE_5603_length_1060_cov_5.900104	570	650	0	80	80	1.0000000
NODE_5611_length_1059_cov_16.630208	412	492	6	80	80	1.0000000
NODE_5611_length_1059_cov_16.630208	465	552	0	36	87	0.4137931
NODE_5611_length_1059_cov_16.630208	465	552	2	1	87	0.0114943
NODE_5611_length_1059_cov_16.630208	465	552	3	17	87	0.1954023
NODE_5611_length_1059_cov_16.630208	465	552	4	1	87	0.0114943
NODE_5611_length_1059_cov_16.630208	465	552	6	32	87	0.3678161
NODE_5611_length_1059_cov_16.630208	548	628	0	80	80	1.0000000
NODE_5611_length_1059_cov_16.630208	601	681	0	80	80	1.0000000
NODE_5621_length_1058_cov_60.155370	395	475	2	78	80	0.9750000
NODE_5621_length_1058_cov_60.155370	395	475	4	2	80	0.0250000
NODE_5621_length_1058_cov_60.155370	448	528	2	45	80	0.5625000
NODE_5621_length_1058_cov_60.155370	448	528	4	35	80	0.4375000
NODE_5621_length_1058_cov_60.155370	524	604	4	44	80	0.5500000
NODE_5621_length_1058_cov_60.155370	524	604	6	12	80	0.1500000
NODE_5621_length_1058_cov_60.155370	524	604	12	9	80	0.1125000
NODE_5621_length_1058_cov_60.155370	524	604	14	15	80	0.1875000
NODE_5621_length_1058_cov_60.155370	577	657	4	2	80	0.0250000
NODE_5621_length_1058_cov_60.155370	577	657	6	1	80	0.0125000
NODE_5621_length_1058_cov_60.155370	577	657	10	35	80	0.4375000
NODE_5621_length_1058_cov_60.155370	577	657	12	10	80	0.1250000
NODE_5621_length_1058_cov_60.155370	577	657	14	32	80	0.4000000
NODE_5622_length_1058_cov_31.253389	475	555	14	35	80	0.4375000
NODE_5622_length_1058_cov_31.253389	475	555	18	10	80	0.1250000
NODE_5622_length_1058_cov_31.253389	475	555	20	4	80	0.0500000
NODE_5622_length_1058_cov_31.253389	475	555	22	5	80	0.0625000
NODE_5622_length_1058_cov_31.253389	475	555	23	1	80	0.0125000
NODE_5622_length_1058_cov_31.253389	475	555	24	8	80	0.1000000
NODE_5622_length_1058_cov_31.253389	475	555	26	17	80	0.2125000
NODE_5622_length_1058_cov_31.253389	475	555	14	35	80	0.4375000
NODE_5622_length_1058_cov_31.253389	475	555	18	10	80	0.1250000
NODE_5622_length_1058_cov_31.253389	475	555	20	4	80	0.0500000
NODE_5622_length_1058_cov_31.253389	475	555	22	5	80	0.0625000
NODE_5622_length_1058_cov_31.253389	475	555	23	1	80	0.0125000
NODE_5622_length_1058_cov_31.253389	475	555	24	8	80	0.1000000
NODE_5622_length_1058_cov_31.253389	475	555	26	17	80	0.2125000
NODE_5622_length_1058_cov_31.253389	528	608	8	48	80	0.6000000
NODE_5622_length_1058_cov_31.253389	528	608	10	4	80	0.0500000
NODE_5622_length_1058_cov_31.253389	528	608	14	28	80	0.3500000
NODE_5622_length_1058_cov_31.253389	533	608	8	48	75	0.6400000
NODE_5622_length_1058_cov_31.253389	533	608	10	4	75	0.0533333
NODE_5622_length_1058_cov_31.253389	533	608	14	23	75	0.3066667
NODE_5623_length_1058_cov_24.520334	264	344	0	80	80	1.0000000
NODE_5623_length_1058_cov_24.520334	317	397	0	80	80	1.0000000
NODE_5624_length_1058_cov_24.211679	297	377	6	31	80	0.3875000
NODE_5624_length_1058_cov_24.211679	297	377	8	49	80	0.6125000
NODE_5624_length_1058_cov_24.211679	350	430	0	2	80	0.0250000
NODE_5624_length_1058_cov_24.211679	350	430	2	4	80	0.0500000
NODE_5624_length_1058_cov_24.211679	350	430	8	74	80	0.9250000
NODE_5625_length_1058_cov_18.100104	454	534	0	24	80	0.3000000
NODE_5625_length_1058_cov_18.100104	454	534	4	56	80	0.7000000
NODE_5625_length_1058_cov_18.100104	507	587	4	80	80	1.0000000
NODE_5626_length_1058_cov_11.645464	476	556	0	80	80	1.0000000
NODE_5626_length_1058_cov_11.645464	529	609	0	80	80	1.0000000
NODE_5627_length_1058_cov_9.953076	621	712	0	91	91	1.0000000
NODE_5627_length_1058_cov_9.953076	685	765	0	80	80	1.0000000
NODE_5628_length_1058_cov_6.294056	819	899	4	26	80	0.3250000
NODE_5628_length_1058_cov_6.294056	819	899	6	54	80	0.6750000
NODE_5628_length_1058_cov_6.294056	875	952	2	43	77	0.5584416
NODE_5628_length_1058_cov_6.294056	875	952	4	11	77	0.1428571
NODE_5628_length_1058_cov_6.294056	875	952	6	23	77	0.2987013
NODE_5637_length_1057_cov_43.191023	413	493	0	80	80	1.0000000
NODE_5637_length_1057_cov_43.191023	466	546	0	80	80	1.0000000
NODE_5637_length_1057_cov_43.191023	542	622	0	80	80	1.0000000
NODE_5637_length_1057_cov_43.191023	595	675	0	80	80	1.0000000
NODE_5638_length_1057_cov_27.387265	486	566	2	13	80	0.1625000
NODE_5638_length_1057_cov_27.387265	486	566	4	67	80	0.8375000
NODE_5638_length_1057_cov_27.387265	539	619	0	11	80	0.1375000
NODE_5638_length_1057_cov_27.387265	539	619	2	22	80	0.2750000
NODE_5638_length_1057_cov_27.387265	539	619	4	47	80	0.5875000
NODE_5639_length_1057_cov_16.489562	416	496	0	20	80	0.2500000
NODE_5639_length_1057_cov_16.489562	416	496	2	60	80	0.7500000
NODE_5639_length_1057_cov_16.489562	469	549	2	80	80	1.0000000
NODE_5640_length_1057_cov_13.605428	631	711	0	7	80	0.0875000
NODE_5640_length_1057_cov_13.605428	631	711	4	10	80	0.1250000
NODE_5640_length_1057_cov_13.605428	631	711	5	11	80	0.1375000
NODE_5640_length_1057_cov_13.605428	631	711	7	52	80	0.6500000
NODE_5640_length_1057_cov_13.605428	684	764	2	21	80	0.2625000
NODE_5640_length_1057_cov_13.605428	684	764	5	10	80	0.1250000
NODE_5640_length_1057_cov_13.605428	684	764	6	11	80	0.1375000
NODE_5640_length_1057_cov_13.605428	684	764	7	38	80	0.4750000
NODE_5641_length_1057_cov_12.768267	518	598	0	80	80	1.0000000
NODE_5641_length_1057_cov_12.768267	571	651	0	80	80	1.0000000
NODE_5644_length_1057_cov_7.692067	706	786	0	80	80	1.0000000
NODE_5644_length_1057_cov_7.692067	759	839	0	80	80	1.0000000
NODE_5645_length_1057_cov_6.697286	561	641	0	80	80	1.0000000
NODE_5645_length_1057_cov_6.697286	614	694	0	80	80	1.0000000
NODE_5654_length_1056_cov_57.539185	462	542	18	14	80	0.1750000
NODE_5654_length_1056_cov_57.539185	462	542	20	21	80	0.2625000
NODE_5654_length_1056_cov_57.539185	462	542	22	36	80	0.4500000
NODE_5654_length_1056_cov_57.539185	462	542	24	9	80	0.1125000
NODE_5654_length_1056_cov_57.539185	515	595	7	15	80	0.1875000
NODE_5654_length_1056_cov_57.539185	515	595	8	16	80	0.2000000
NODE_5654_length_1056_cov_57.539185	515	595	14	8	80	0.1000000
NODE_5654_length_1056_cov_57.539185	515	595	16	9	80	0.1125000
NODE_5654_length_1056_cov_57.539185	515	595	18	18	80	0.2250000
NODE_5654_length_1056_cov_57.539185	515	595	20	5	80	0.0625000
NODE_5654_length_1056_cov_57.539185	515	595	22	9	80	0.1125000
NODE_5655_length_1056_cov_35.751306	421	501	0	62	80	0.7750000
NODE_5655_length_1056_cov_35.751306	421	501	4	2	80	0.0250000
NODE_5655_length_1056_cov_35.751306	421	501	11	1	80	0.0125000
NODE_5655_length_1056_cov_35.751306	421	501	12	15	80	0.1875000
NODE_5655_length_1056_cov_35.751306	474	554	0	9	80	0.1125000
NODE_5655_length_1056_cov_35.751306	474	554	4	2	80	0.0250000
NODE_5655_length_1056_cov_35.751306	474	554	11	1	80	0.0125000
NODE_5655_length_1056_cov_35.751306	474	554	12	42	80	0.5250000
NODE_5655_length_1056_cov_35.751306	474	554	14	26	80	0.3250000
NODE_5656_length_1056_cov_29.749216	415	490	0	43	75	0.5733333
NODE_5656_length_1056_cov_29.749216	415	490	2	32	75	0.4266667
NODE_5656_length_1056_cov_29.749216	416	495	0	42	79	0.5316456
NODE_5656_length_1056_cov_29.749216	416	495	2	37	79	0.4683544
NODE_5656_length_1056_cov_29.749216	448	495	0	10	47	0.2127660
NODE_5656_length_1056_cov_29.749216	448	495	2	37	47	0.7872341
NODE_5656_length_1056_cov_29.749216	468	548	2	80	80	1.0000000
NODE_5656_length_1056_cov_29.749216	468	548	2	80	80	1.0000000
NODE_5656_length_1056_cov_29.749216	468	548	2	80	80	1.0000000
NODE_5657_length_1056_cov_25.342738	297	377	0	80	80	1.0000000
NODE_5657_length_1056_cov_25.342738	350	430	0	56	80	0.7000000
NODE_5657_length_1056_cov_25.342738	350	430	2	24	80	0.3000000
NODE_5657_length_1056_cov_25.342738	426	506	0	16	80	0.2000000
NODE_5657_length_1056_cov_25.342738	426	506	2	64	80	0.8000000
NODE_5657_length_1056_cov_25.342738	479	559	0	69	80	0.8625000
NODE_5657_length_1056_cov_25.342738	479	559	2	11	80	0.1375000
NODE_5658_length_1056_cov_24.094044	535	615	6	13	80	0.1625000
NODE_5658_length_1056_cov_24.094044	535	615	8	67	80	0.8375000
NODE_5658_length_1056_cov_24.094044	588	668	0	2	80	0.0250000
NODE_5658_length_1056_cov_24.094044	588	668	2	30	80	0.3750000
NODE_5658_length_1056_cov_24.094044	588	668	4	17	80	0.2125000
NODE_5658_length_1056_cov_24.094044	588	668	6	17	80	0.2125000
NODE_5658_length_1056_cov_24.094044	588	668	8	14	80	0.1750000
NODE_5659_length_1056_cov_20.700104	570	650	4	4	80	0.0500000
NODE_5659_length_1056_cov_20.700104	570	650	6	57	80	0.7125000
NODE_5659_length_1056_cov_20.700104	570	650	8	13	80	0.1625000
NODE_5659_length_1056_cov_20.700104	570	650	12	6	80	0.0750000
NODE_5659_length_1056_cov_20.700104	623	703	6	8	80	0.1000000
NODE_5659_length_1056_cov_20.700104	623	703	8	13	80	0.1625000
NODE_5659_length_1056_cov_20.700104	623	703	10	25	80	0.3125000
NODE_5659_length_1056_cov_20.700104	623	703	12	34	80	0.4250000
NODE_5660_length_1056_cov_14.215256	349	429	0	13	80	0.1625000
NODE_5660_length_1056_cov_14.215256	349	429	2	67	80	0.8375000
NODE_5660_length_1056_cov_14.215256	402	482	2	78	80	0.9750000
NODE_5660_length_1056_cov_14.215256	402	482	4	2	80	0.0250000
NODE_5660_length_1056_cov_14.215256	478	558	2	7	80	0.0875000
NODE_5660_length_1056_cov_14.215256	478	558	4	12	80	0.1500000
NODE_5660_length_1056_cov_14.215256	478	558	7	20	80	0.2500000
NODE_5660_length_1056_cov_14.215256	478	558	9	41	80	0.5125000
NODE_5660_length_1056_cov_14.215256	531	611	6	25	80	0.3125000
NODE_5660_length_1056_cov_14.215256	531	611	7	9	80	0.1125000
NODE_5660_length_1056_cov_14.215256	531	611	8	28	80	0.3500000
NODE_5660_length_1056_cov_14.215256	531	611	9	18	80	0.2250000
NODE_5661_length_1056_cov_13.782654	563	643	0	80	80	1.0000000
NODE_5661_length_1056_cov_13.782654	616	696	0	80	80	1.0000000
NODE_5663_length_1056_cov_9.298851	373	453	4	3	80	0.0375000
NODE_5663_length_1056_cov_9.298851	373	453	6	13	80	0.1625000
NODE_5663_length_1056_cov_9.298851	373	453	8	5	80	0.0625000
NODE_5663_length_1056_cov_9.298851	373	453	10	59	80	0.7375000
NODE_5663_length_1056_cov_9.298851	426	503	2	43	77	0.5584416
NODE_5663_length_1056_cov_9.298851	426	503	4	3	77	0.0389610
NODE_5663_length_1056_cov_9.298851	426	503	6	18	77	0.2337662
NODE_5663_length_1056_cov_9.298851	426	503	8	5	77	0.0649351
NODE_5663_length_1056_cov_9.298851	426	503	10	8	77	0.1038961
NODE_5665_length_1056_cov_6.157785	396	476	0	80	80	1.0000000
NODE_5665_length_1056_cov_6.157785	449	529	0	80	80	1.0000000
NODE_5666_length_1056_cov_6.034483	287	367	0	80	80	1.0000000
NODE_5666_length_1056_cov_6.034483	340	420	0	80	80	1.0000000
NODE_5667_length_1056_cov_3.259143	371	410	0	39	39	1.0000000
NODE_5667_length_1056_cov_3.259143	424	463	2	39	39	1.0000000
NODE_5668_length_1056_cov_2.362591	234	314	0	11	80	0.1375000
NODE_5668_length_1056_cov_2.362591	234	314	2	3	80	0.0375000
NODE_5668_length_1056_cov_2.362591	234	314	4	3	80	0.0375000
NODE_5668_length_1056_cov_2.362591	234	314	6	19	80	0.2375000
NODE_5668_length_1056_cov_2.362591	234	314	8	44	80	0.5500000
NODE_5672_length_1055_cov_36.460251	468	548	2	53	80	0.6625000
NODE_5672_length_1055_cov_36.460251	468	548	4	26	80	0.3250000
NODE_5672_length_1055_cov_36.460251	468	548	6	1	80	0.0125000
NODE_5672_length_1055_cov_36.460251	521	601	4	79	80	0.9875000
NODE_5672_length_1055_cov_36.460251	521	601	6	1	80	0.0125000
NODE_5673_length_1055_cov_31.235356	502	582	2	33	80	0.4125000
NODE_5673_length_1055_cov_31.235356	502	582	3	33	80	0.4125000
NODE_5673_length_1055_cov_31.235356	502	582	4	14	80	0.1750000
NODE_5673_length_1055_cov_31.235356	555	635	1	18	80	0.2250000
NODE_5673_length_1055_cov_31.235356	555	635	2	9	80	0.1125000
NODE_5673_length_1055_cov_31.235356	555	635	3	53	80	0.6625000
NODE_5674_length_1055_cov_23.330544	403	483	0	13	80	0.1625000
NODE_5674_length_1055_cov_23.330544	403	483	2	17	80	0.2125000
NODE_5674_length_1055_cov_23.330544	403	483	4	50	80	0.6250000
NODE_5674_length_1055_cov_23.330544	456	536	0	66	80	0.8250000
NODE_5674_length_1055_cov_23.330544	456	536	2	14	80	0.1750000
NODE_5674_length_1055_cov_23.330544	532	612	0	23	80	0.2875000
NODE_5674_length_1055_cov_23.330544	532	612	2	57	80	0.7125000
NODE_5674_length_1055_cov_23.330544	585	665	0	30	80	0.3750000
NODE_5674_length_1055_cov_23.330544	585	665	2	50	80	0.6250000
NODE_5675_length_1055_cov_19.541841	321	401	6	71	80	0.8875000
NODE_5675_length_1055_cov_19.541841	321	401	10	9	80	0.1125000
NODE_5675_length_1055_cov_19.541841	374	454	4	42	80	0.5250000
NODE_5675_length_1055_cov_19.541841	374	454	6	18	80	0.2250000
NODE_5675_length_1055_cov_19.541841	374	454	10	20	80	0.2500000
NODE_5676_length_1055_cov_15.744770	525	605	0	26	80	0.3250000
NODE_5676_length_1055_cov_15.744770	525	605	2	54	80	0.6750000
NODE_5676_length_1055_cov_15.744770	578	658	0	35	80	0.4375000
NODE_5676_length_1055_cov_15.744770	578	658	2	45	80	0.5625000
NODE_5677_length_1055_cov_10.729079	335	415	0	57	80	0.7125000
NODE_5677_length_1055_cov_10.729079	335	415	4	23	80	0.2875000
NODE_5677_length_1055_cov_10.729079	388	468	0	10	80	0.1250000
NODE_5677_length_1055_cov_10.729079	388	468	3	2	80	0.0250000
NODE_5677_length_1055_cov_10.729079	388	468	4	68	80	0.8500000
NODE_5678_length_1055_cov_7.525105	575	655	0	80	80	1.0000000
NODE_5678_length_1055_cov_7.525105	628	708	0	80	80	1.0000000
NODE_5688_length_1054_cov_45.920419	371	451	0	22	80	0.2750000
NODE_5688_length_1054_cov_45.920419	371	451	2	12	80	0.1500000
NODE_5688_length_1054_cov_45.920419	371	451	4	46	80	0.5750000
NODE_5688_length_1054_cov_45.920419	424	505	2	30	81	0.3703704
NODE_5688_length_1054_cov_45.920419	424	505	4	51	81	0.6296296
NODE_5689_length_1054_cov_30.545550	499	578	0	14	79	0.1772152
NODE_5689_length_1054_cov_30.545550	499	578	2	65	79	0.8227848
NODE_5689_length_1054_cov_30.545550	552	631	0	59	79	0.7468355
NODE_5689_length_1054_cov_30.545550	552	631	2	20	79	0.2531646
NODE_5689_length_1054_cov_30.545550	627	707	2	52	80	0.6500000
NODE_5689_length_1054_cov_30.545550	627	707	4	28	80	0.3500000
NODE_5689_length_1054_cov_30.545550	680	760	2	55	80	0.6875000
NODE_5689_length_1054_cov_30.545550	680	760	4	25	80	0.3125000
NODE_5690_length_1054_cov_16.606283	347	427	2	41	80	0.5125000
NODE_5690_length_1054_cov_16.606283	347	427	4	33	80	0.4125000
NODE_5690_length_1054_cov_16.606283	347	427	6	6	80	0.0750000
NODE_5690_length_1054_cov_16.606283	400	480	2	16	80	0.2000000
NODE_5690_length_1054_cov_16.606283	400	480	4	39	80	0.4875000
NODE_5690_length_1054_cov_16.606283	400	480	6	25	80	0.3125000
NODE_5691_length_1054_cov_11.637696	244	316	0	72	72	1.0000000
NODE_5691_length_1054_cov_11.637696	312	392	0	54	80	0.6750000
NODE_5691_length_1054_cov_11.637696	312	392	2	9	80	0.1125000
NODE_5691_length_1054_cov_11.637696	312	392	4	17	80	0.2125000
NODE_5691_length_1054_cov_11.637696	365	445	0	1	80	0.0125000
NODE_5691_length_1054_cov_11.637696	365	445	2	9	80	0.1125000
NODE_5691_length_1054_cov_11.637696	365	445	4	70	80	0.8750000
NODE_5692_length_1054_cov_10.381152	493	573	0	80	80	1.0000000
NODE_5692_length_1054_cov_10.381152	546	626	0	80	80	1.0000000
NODE_5703_length_1053_cov_57.660377	445	527	4	27	82	0.3292683
NODE_5703_length_1053_cov_57.660377	445	527	5	7	82	0.0853659
NODE_5703_length_1053_cov_57.660377	445	527	6	48	82	0.5853658
NODE_5703_length_1053_cov_57.660377	500	580	2	36	80	0.4500000
NODE_5703_length_1053_cov_57.660377	500	580	6	44	80	0.5500000
NODE_5704_length_1053_cov_33.518868	329	409	0	80	80	1.0000000
NODE_5704_length_1053_cov_33.518868	382	462	0	80	80	1.0000000
NODE_5704_length_1053_cov_33.518868	458	538	0	80	80	1.0000000
NODE_5704_length_1053_cov_33.518868	511	591	0	80	80	1.0000000
NODE_5705_length_1053_cov_32.412998	375	455	0	80	80	1.0000000
NODE_5705_length_1053_cov_32.412998	428	508	0	80	80	1.0000000
NODE_5705_length_1053_cov_32.412998	504	584	0	80	80	1.0000000
NODE_5705_length_1053_cov_32.412998	557	637	0	80	80	1.0000000
NODE_5706_length_1053_cov_26.545073	456	536	0	28	80	0.3500000
NODE_5706_length_1053_cov_26.545073	456	536	2	52	80	0.6500000
NODE_5706_length_1053_cov_26.545073	509	589	0	80	80	1.0000000
NODE_5706_length_1053_cov_26.545073	585	665	0	80	80	1.0000000
NODE_5706_length_1053_cov_26.545073	638	718	0	80	80	1.0000000
NODE_5707_length_1053_cov_20.346960	543	623	0	80	80	1.0000000
NODE_5707_length_1053_cov_20.346960	596	677	0	81	81	1.0000000
NODE_5708_length_1053_cov_11.655136	393	473	0	80	80	1.0000000
NODE_5708_length_1053_cov_11.655136	446	526	0	80	80	1.0000000
NODE_5710_length_1053_cov_4.771488	84	149	0	1	65	0.0153846
NODE_5710_length_1053_cov_4.771488	84	149	2	2	65	0.0307692
NODE_5710_length_1053_cov_4.771488	84	149	4	20	65	0.3076923
NODE_5710_length_1053_cov_4.771488	84	149	6	5	65	0.0769231
NODE_5710_length_1053_cov_4.771488	84	149	8	1	65	0.0153846
NODE_5710_length_1053_cov_4.771488	84	149	10	14	65	0.2153846
NODE_5710_length_1053_cov_4.771488	84	149	12	22	65	0.3384615
NODE_5718_length_1052_cov_18.469045	448	528	0	80	80	1.0000000
NODE_5718_length_1052_cov_18.469045	501	581	0	38	80	0.4750000
NODE_5718_length_1052_cov_18.469045	501	581	2	42	80	0.5250000
NODE_5719_length_1052_cov_13.136411	425	505	0	80	80	1.0000000
NODE_5719_length_1052_cov_13.136411	478	558	0	72	80	0.9000000
NODE_5719_length_1052_cov_13.136411	478	558	2	8	80	0.1000000
NODE_5722_length_1052_cov_3.082896	607	687	0	80	80	1.0000000
NODE_5722_length_1052_cov_3.082896	660	740	0	80	80	1.0000000
NODE_5729_length_1051_cov_34.868697	472	552	6	80	80	1.0000000
NODE_5729_length_1051_cov_34.868697	525	605	0	27	80	0.3375000
NODE_5729_length_1051_cov_34.868697	525	605	6	53	80	0.6625000
NODE_5730_length_1051_cov_19.446429	549	629	0	73	80	0.9125000
NODE_5730_length_1051_cov_19.446429	549	629	2	4	80	0.0500000
NODE_5730_length_1051_cov_19.446429	549	629	4	3	80	0.0375000
NODE_5730_length_1051_cov_19.446429	602	682	0	20	80	0.2500000
NODE_5730_length_1051_cov_19.446429	602	682	2	4	80	0.0500000
NODE_5730_length_1051_cov_19.446429	602	682	4	25	80	0.3125000
NODE_5730_length_1051_cov_19.446429	602	682	5	1	80	0.0125000
NODE_5730_length_1051_cov_19.446429	602	682	6	30	80	0.3750000
NODE_5731_length_1051_cov_4.022059	600	680	2	36	80	0.4500000
NODE_5731_length_1051_cov_4.022059	600	680	6	44	80	0.5500000
NODE_5736_length_1050_cov_31.556257	429	509	0	80	80	1.0000000
NODE_5736_length_1050_cov_31.556257	482	562	0	80	80	1.0000000
NODE_5736_length_1050_cov_31.556257	558	638	0	80	80	1.0000000
NODE_5736_length_1050_cov_31.556257	611	691	0	80	80	1.0000000
NODE_5737_length_1050_cov_16.337539	398	478	0	23	80	0.2875000
NODE_5737_length_1050_cov_16.337539	398	478	2	57	80	0.7125000
NODE_5737_length_1050_cov_16.337539	451	531	2	80	80	1.0000000
NODE_5738_length_1050_cov_13.290221	507	587	0	24	80	0.3000000
NODE_5738_length_1050_cov_13.290221	507	587	4	56	80	0.7000000
NODE_5738_length_1050_cov_13.290221	560	640	0	1	80	0.0125000
NODE_5738_length_1050_cov_13.290221	560	640	2	17	80	0.2125000
NODE_5738_length_1050_cov_13.290221	560	640	4	62	80	0.7750000
NODE_5739_length_1050_cov_11.389064	532	612	2	3	80	0.0375000
NODE_5739_length_1050_cov_11.389064	532	612	8	43	80	0.5375000
NODE_5739_length_1050_cov_11.389064	532	612	10	34	80	0.4250000
NODE_5739_length_1050_cov_11.389064	585	665	0	35	80	0.4375000
NODE_5739_length_1050_cov_11.389064	585	665	8	45	80	0.5625000
NODE_5740_length_1050_cov_11.091483	259	321	0	62	62	1.0000000
NODE_5740_length_1050_cov_11.091483	294	374	0	80	80	1.0000000
NODE_5740_length_1050_cov_11.091483	370	450	0	80	80	1.0000000
NODE_5740_length_1050_cov_11.091483	423	503	0	80	80	1.0000000
NODE_5742_length_1050_cov_2.201893	928	990	0	10	62	0.1612903
NODE_5742_length_1050_cov_2.201893	928	990	2	52	62	0.8387097
NODE_5742_length_1050_cov_2.201893	981	1043	0	6	62	0.0967742
NODE_5742_length_1050_cov_2.201893	981	1043	2	56	62	0.9032258
NODE_5748_length_1050_cov_1.241851	935	990	36	2	55	0.0363636
NODE_5748_length_1050_cov_1.241851	935	990	42	1	55	0.0181818
NODE_5748_length_1050_cov_1.241851	935	990	45	1	55	0.0181818
NODE_5748_length_1050_cov_1.241851	935	990	49	1	55	0.0181818
NODE_5748_length_1050_cov_1.241851	935	990	50	1	55	0.0181818
NODE_5748_length_1050_cov_1.241851	935	990	54	1	55	0.0181818
NODE_5748_length_1050_cov_1.241851	935	990	58	2	55	0.0363636
NODE_5748_length_1050_cov_1.241851	935	990	60	1	55	0.0181818
NODE_5748_length_1050_cov_1.241851	935	990	62	1	55	0.0181818
NODE_5748_length_1050_cov_1.241851	935	990	70	1	55	0.0181818
NODE_5748_length_1050_cov_1.241851	935	990	72	3	55	0.0545455
NODE_5748_length_1050_cov_1.241851	935	990	74	1	55	0.0181818
NODE_5748_length_1050_cov_1.241851	935	990	80	1	55	0.0181818
NODE_5748_length_1050_cov_1.241851	935	990	84	1	55	0.0181818
NODE_5748_length_1050_cov_1.241851	935	990	86	2	55	0.0363636
NODE_5748_length_1050_cov_1.241851	935	990	90	2	55	0.0363636
NODE_5748_length_1050_cov_1.241851	935	990	92	9	55	0.1636364
NODE_5748_length_1050_cov_1.241851	935	990	96	3	55	0.0545455
NODE_5748_length_1050_cov_1.241851	935	990	99	3	55	0.0545455
NODE_5748_length_1050_cov_1.241851	935	990	101	4	55	0.0727273
NODE_5748_length_1050_cov_1.241851	935	990	105	6	55	0.1090909
NODE_5748_length_1050_cov_1.241851	935	990	107	8	55	0.1454545
NODE_5748_length_1050_cov_1.241851	956	1036	69	2	80	0.0250000
NODE_5748_length_1050_cov_1.241851	956	1036	73	1	80	0.0125000
NODE_5748_length_1050_cov_1.241851	956	1036	75	1	80	0.0125000
NODE_5748_length_1050_cov_1.241851	956	1036	79	4	80	0.0500000
NODE_5748_length_1050_cov_1.241851	956	1036	90	1	80	0.0125000
NODE_5748_length_1050_cov_1.241851	956	1036	92	11	80	0.1375000
NODE_5748_length_1050_cov_1.241851	956	1036	96	4	80	0.0500000
NODE_5748_length_1050_cov_1.241851	956	1036	99	3	80	0.0375000
NODE_5748_length_1050_cov_1.241851	956	1036	100	3	80	0.0375000
NODE_5748_length_1050_cov_1.241851	956	1036	101	4	80	0.0500000
NODE_5748_length_1050_cov_1.241851	956	1036	102	1	80	0.0125000
NODE_5748_length_1050_cov_1.241851	956	1036	104	7	80	0.0875000
NODE_5748_length_1050_cov_1.241851	956	1036	105	6	80	0.0750000
NODE_5748_length_1050_cov_1.241851	956	1036	107	14	80	0.1750000
NODE_5748_length_1050_cov_1.241851	956	1036	108	11	80	0.1375000
NODE_5748_length_1050_cov_1.241851	956	1036	110	7	80	0.0875000
NODE_5752_length_1049_cov_28.174737	446	526	0	40	80	0.5000000
NODE_5752_length_1049_cov_28.174737	446	526	2	40	80	0.5000000
NODE_5752_length_1049_cov_28.174737	499	579	0	16	80	0.2000000
NODE_5752_length_1049_cov_28.174737	499	579	2	64	80	0.8000000
NODE_5753_length_1049_cov_23.186316	389	469	0	80	80	1.0000000
NODE_5753_length_1049_cov_23.186316	442	522	0	80	80	1.0000000
NODE_5753_length_1049_cov_23.186316	518	595	0	77	77	1.0000000
NODE_5753_length_1049_cov_23.186316	568	648	0	80	80	1.0000000
NODE_5754_length_1049_cov_21.097895	532	612	0	43	80	0.5375000
NODE_5754_length_1049_cov_21.097895	532	612	2	37	80	0.4625000
NODE_5754_length_1049_cov_21.097895	585	665	0	80	80	1.0000000
NODE_5755_length_1049_cov_18.964211	375	466	2	23	91	0.2527473
NODE_5755_length_1049_cov_18.964211	375	466	3	26	91	0.2857143
NODE_5755_length_1049_cov_18.964211	375	466	4	42	91	0.4615385
NODE_5755_length_1049_cov_18.964211	439	519	1	49	80	0.6125000
NODE_5755_length_1049_cov_18.964211	439	519	2	6	80	0.0750000
NODE_5755_length_1049_cov_18.964211	439	519	3	25	80	0.3125000
NODE_5755_length_1049_cov_18.964211	515	595	0	7	80	0.0875000
NODE_5755_length_1049_cov_18.964211	515	595	1	73	80	0.9125000
NODE_5755_length_1049_cov_18.964211	568	648	0	60	80	0.7500000
NODE_5755_length_1049_cov_18.964211	568	648	1	20	80	0.2500000
NODE_5756_length_1049_cov_18.075789	437	517	0	13	80	0.1625000
NODE_5756_length_1049_cov_18.075789	437	517	2	67	80	0.8375000
NODE_5756_length_1049_cov_18.075789	490	570	0	17	80	0.2125000
NODE_5756_length_1049_cov_18.075789	490	570	2	30	80	0.3750000
NODE_5756_length_1049_cov_18.075789	490	570	4	33	80	0.4125000
NODE_5756_length_1049_cov_18.075789	566	644	2	8	78	0.1025641
NODE_5756_length_1049_cov_18.075789	566	644	4	54	78	0.6923077
NODE_5756_length_1049_cov_18.075789	566	644	6	16	78	0.2051282
NODE_5756_length_1049_cov_18.075789	620	695	0	11	75	0.1466667
NODE_5756_length_1049_cov_18.075789	620	695	2	48	75	0.6400000
NODE_5756_length_1049_cov_18.075789	620	695	4	16	75	0.2133333
NODE_5757_length_1049_cov_16.194737	569	650	2	52	81	0.6419753
NODE_5757_length_1049_cov_16.194737	569	650	4	29	81	0.3580247
NODE_5757_length_1049_cov_16.194737	623	703	0	41	80	0.5125000
NODE_5757_length_1049_cov_16.194737	623	703	2	39	80	0.4875000
NODE_5757_length_1049_cov_16.194737	699	779	0	80	80	1.0000000
NODE_5757_length_1049_cov_16.194737	752	832	0	80	80	1.0000000
NODE_5759_length_1049_cov_6.323158	588	668	0	80	80	1.0000000
NODE_5759_length_1049_cov_6.323158	641	721	0	80	80	1.0000000
NODE_5770_length_1048_cov_73.887250	535	615	2	43	80	0.5375000
NODE_5770_length_1048_cov_73.887250	535	615	4	11	80	0.1375000
NODE_5770_length_1048_cov_73.887250	535	615	6	26	80	0.3250000
NODE_5770_length_1048_cov_73.887250	588	668	4	6	80	0.0750000
NODE_5770_length_1048_cov_73.887250	588	668	6	74	80	0.9250000
NODE_5770_length_1048_cov_73.887250	664	744	0	59	80	0.7375000
NODE_5770_length_1048_cov_73.887250	664	744	4	9	80	0.1125000
NODE_5770_length_1048_cov_73.887250	664	744	6	12	80	0.1500000
NODE_5770_length_1048_cov_73.887250	717	797	0	80	80	1.0000000
NODE_5770_length_1048_cov_73.887250	899	979	0	80	80	1.0000000
NODE_5771_length_1048_cov_48.242360	407	487	0	80	80	1.0000000
NODE_5771_length_1048_cov_48.242360	460	540	0	69	80	0.8625000
NODE_5771_length_1048_cov_48.242360	460	540	2	11	80	0.1375000
NODE_5771_length_1048_cov_48.242360	536	616	2	63	80	0.7875000
NODE_5771_length_1048_cov_48.242360	536	616	4	17	80	0.2125000
NODE_5771_length_1048_cov_48.242360	589	669	0	25	80	0.3125000
NODE_5771_length_1048_cov_48.242360	589	669	2	55	80	0.6875000
NODE_5772_length_1048_cov_38.430980	352	432	4	16	80	0.2000000
NODE_5772_length_1048_cov_38.430980	352	432	5	34	80	0.4250000
NODE_5772_length_1048_cov_38.430980	352	432	6	30	80	0.3750000
NODE_5772_length_1048_cov_38.430980	405	485	1	2	80	0.0250000
NODE_5772_length_1048_cov_38.430980	405	485	2	5	80	0.0625000
NODE_5772_length_1048_cov_38.430980	405	485	3	26	80	0.3250000
NODE_5772_length_1048_cov_38.430980	405	485	5	47	80	0.5875000
NODE_5773_length_1048_cov_28.179136	548	628	0	15	80	0.1875000
NODE_5773_length_1048_cov_28.179136	548	628	2	65	80	0.8125000
NODE_5773_length_1048_cov_28.179136	601	681	0	42	80	0.5250000
NODE_5773_length_1048_cov_28.179136	601	681	2	38	80	0.4750000
NODE_5773_length_1048_cov_28.179136	677	757	2	35	80	0.4375000
NODE_5773_length_1048_cov_28.179136	677	757	6	1	80	0.0125000
NODE_5773_length_1048_cov_28.179136	677	757	10	44	80	0.5500000
NODE_5773_length_1048_cov_28.179136	730	810	8	50	80	0.6250000
NODE_5773_length_1048_cov_28.179136	730	810	10	30	80	0.3750000
NODE_5774_length_1048_cov_22.985248	409	489	2	64	80	0.8000000
NODE_5774_length_1048_cov_22.985248	409	489	4	16	80	0.2000000
NODE_5774_length_1048_cov_22.985248	462	542	2	50	80	0.6250000
NODE_5774_length_1048_cov_22.985248	462	542	4	30	80	0.3750000
NODE_5774_length_1048_cov_22.985248	538	618	0	34	80	0.4250000
NODE_5774_length_1048_cov_22.985248	538	618	2	46	80	0.5750000
NODE_5774_length_1048_cov_22.985248	591	671	0	78	80	0.9750000
NODE_5774_length_1048_cov_22.985248	591	671	2	2	80	0.0250000
NODE_5775_length_1048_cov_17.883035	500	580	0	10	80	0.1250000
NODE_5775_length_1048_cov_17.883035	500	580	4	12	80	0.1500000
NODE_5775_length_1048_cov_17.883035	500	580	7	2	80	0.0250000
NODE_5775_length_1048_cov_17.883035	500	580	8	56	80	0.7000000
NODE_5775_length_1048_cov_17.883035	553	633	0	3	80	0.0375000
NODE_5775_length_1048_cov_17.883035	553	633	3	1	80	0.0125000
NODE_5775_length_1048_cov_17.883035	553	633	4	37	80	0.4625000
NODE_5775_length_1048_cov_17.883035	553	633	8	39	80	0.4875000
NODE_5776_length_1048_cov_17.444679	377	457	3	62	80	0.7750000
NODE_5776_length_1048_cov_17.444679	377	457	5	18	80	0.2250000
NODE_5776_length_1048_cov_17.444679	430	510	2	11	80	0.1375000
NODE_5776_length_1048_cov_17.444679	430	510	3	9	80	0.1125000
NODE_5776_length_1048_cov_17.444679	430	510	4	35	80	0.4375000
NODE_5776_length_1048_cov_17.444679	430	510	5	25	80	0.3125000
NODE_5777_length_1048_cov_13.387777	518	598	0	29	80	0.3625000
NODE_5777_length_1048_cov_13.387777	518	598	2	51	80	0.6375000
NODE_5777_length_1048_cov_13.387777	571	651	2	80	80	1.0000000
NODE_5778_length_1048_cov_12.934668	716	796	2	80	80	1.0000000
NODE_5778_length_1048_cov_12.934668	769	849	0	41	80	0.5125000
NODE_5778_length_1048_cov_12.934668	769	849	2	39	80	0.4875000
NODE_5778_length_1048_cov_12.934668	845	925	0	80	80	1.0000000
NODE_5778_length_1048_cov_12.934668	898	975	0	77	77	1.0000000
NODE_5779_length_1048_cov_12.712329	330	410	0	80	80	1.0000000
NODE_5779_length_1048_cov_12.712329	384	463	0	79	79	1.0000000
NODE_5779_length_1048_cov_12.712329	459	539	0	43	80	0.5375000
NODE_5779_length_1048_cov_12.712329	459	539	2	32	80	0.4000000
NODE_5779_length_1048_cov_12.712329	459	539	4	5	80	0.0625000
NODE_5779_length_1048_cov_12.712329	512	592	2	22	80	0.2750000
NODE_5779_length_1048_cov_12.712329	512	592	4	58	80	0.7250000
NODE_5780_length_1048_cov_9.232877	305	355	0	50	50	1.0000000
NODE_5786_length_1047_cov_79.917722	540	620	0	80	80	1.0000000
NODE_5786_length_1047_cov_79.917722	593	673	0	50	80	0.6250000
NODE_5786_length_1047_cov_79.917722	593	673	2	30	80	0.3750000
NODE_5787_length_1047_cov_28.527426	582	662	2	24	80	0.3000000
NODE_5787_length_1047_cov_28.527426	582	662	6	4	80	0.0500000
NODE_5787_length_1047_cov_28.527426	582	662	8	14	80	0.1750000
NODE_5787_length_1047_cov_28.527426	582	662	10	38	80	0.4750000
NODE_5787_length_1047_cov_28.527426	635	715	2	19	80	0.2375000
NODE_5787_length_1047_cov_28.527426	635	715	6	9	80	0.1125000
NODE_5787_length_1047_cov_28.527426	635	715	8	26	80	0.3250000
NODE_5787_length_1047_cov_28.527426	635	715	10	26	80	0.3250000
NODE_5788_length_1047_cov_26.068565	372	452	6	17	80	0.2125000
NODE_5788_length_1047_cov_26.068565	372	452	8	63	80	0.7875000
NODE_5788_length_1047_cov_26.068565	425	505	0	30	80	0.3750000
NODE_5788_length_1047_cov_26.068565	425	505	2	4	80	0.0500000
NODE_5788_length_1047_cov_26.068565	425	505	4	13	80	0.1625000
NODE_5788_length_1047_cov_26.068565	425	505	8	33	80	0.4125000
NODE_5789_length_1047_cov_25.946203	424	504	0	80	80	1.0000000
NODE_5789_length_1047_cov_25.946203	477	557	0	80	80	1.0000000
NODE_5790_length_1047_cov_19.255274	458	538	0	80	80	1.0000000
NODE_5790_length_1047_cov_19.255274	511	591	0	27	80	0.3375000
NODE_5790_length_1047_cov_19.255274	511	591	4	53	80	0.6625000
NODE_5791_length_1047_cov_16.618143	467	547	0	80	80	1.0000000
NODE_5791_length_1047_cov_16.618143	520	600	0	80	80	1.0000000
NODE_5792_length_1047_cov_14.246835	643	723	2	80	80	1.0000000
NODE_5792_length_1047_cov_14.246835	696	776	0	18	80	0.2250000
NODE_5792_length_1047_cov_14.246835	696	776	1	4	80	0.0500000
NODE_5792_length_1047_cov_14.246835	696	776	2	58	80	0.7250000
NODE_5793_length_1047_cov_9.869198	414	494	0	70	80	0.8750000
NODE_5793_length_1047_cov_9.869198	414	494	2	10	80	0.1250000
NODE_5793_length_1047_cov_9.869198	467	547	0	80	80	1.0000000
NODE_5794_length_1047_cov_8.513713	300	380	0	80	80	1.0000000
NODE_5794_length_1047_cov_8.513713	353	433	0	80	80	1.0000000
NODE_5795_length_1047_cov_7.412447	442	522	0	80	80	1.0000000
NODE_5795_length_1047_cov_7.412447	495	575	0	80	80	1.0000000
NODE_5803_length_1046_cov_41.392819	587	667	0	55	80	0.6875000
NODE_5803_length_1046_cov_41.392819	587	667	1	25	80	0.3125000
NODE_5803_length_1046_cov_41.392819	640	720	0	2	80	0.0250000
NODE_5803_length_1046_cov_41.392819	640	720	1	49	80	0.6125000
NODE_5803_length_1046_cov_41.392819	640	720	3	29	80	0.3625000
NODE_5804_length_1046_cov_30.317846	382	462	16	80	80	1.0000000
NODE_5804_length_1046_cov_30.317846	435	515	16	80	80	1.0000000
NODE_5805_length_1046_cov_28.184794	346	426	10	25	80	0.3125000
NODE_5805_length_1046_cov_28.184794	346	426	12	36	80	0.4500000
NODE_5805_length_1046_cov_28.184794	346	426	14	19	80	0.2375000
NODE_5805_length_1046_cov_28.184794	399	479	2	5	80	0.0625000
NODE_5805_length_1046_cov_28.184794	399	479	6	30	80	0.3750000
NODE_5805_length_1046_cov_28.184794	399	479	8	14	80	0.1750000
NODE_5805_length_1046_cov_28.184794	399	479	10	6	80	0.0750000
NODE_5805_length_1046_cov_28.184794	399	479	12	6	80	0.0750000
NODE_5805_length_1046_cov_28.184794	399	479	14	19	80	0.2375000
NODE_5806_length_1046_cov_24.595565	501	581	0	59	80	0.7375000
NODE_5806_length_1046_cov_24.595565	501	581	2	21	80	0.2625000
NODE_5806_length_1046_cov_24.595565	554	634	0	6	80	0.0750000
NODE_5806_length_1046_cov_24.595565	554	634	2	74	80	0.9250000
NODE_5807_length_1046_cov_17.958817	447	527	0	11	80	0.1375000
NODE_5807_length_1046_cov_17.958817	447	527	2	4	80	0.0500000
NODE_5807_length_1046_cov_17.958817	447	527	4	65	80	0.8125000
NODE_5807_length_1046_cov_17.958817	500	580	0	26	80	0.3250000
NODE_5807_length_1046_cov_17.958817	500	580	2	17	80	0.2125000
NODE_5807_length_1046_cov_17.958817	500	580	4	37	80	0.4625000
NODE_5808_length_1046_cov_15.494192	385	465	1	11	80	0.1375000
NODE_5808_length_1046_cov_15.494192	385	465	2	66	80	0.8250000
NODE_5808_length_1046_cov_15.494192	385	465	3	3	80	0.0375000
NODE_5808_length_1046_cov_15.494192	438	518	0	1	80	0.0125000
NODE_5808_length_1046_cov_15.494192	438	518	1	11	80	0.1375000
NODE_5808_length_1046_cov_15.494192	438	518	2	27	80	0.3375000
NODE_5808_length_1046_cov_15.494192	438	518	3	41	80	0.5125000
NODE_5809_length_1046_cov_12.639916	554	634	2	7	80	0.0875000
NODE_5809_length_1046_cov_12.639916	554	634	4	8	80	0.1000000
NODE_5809_length_1046_cov_12.639916	554	634	6	20	80	0.2500000
NODE_5809_length_1046_cov_12.639916	554	634	8	45	80	0.5625000
NODE_5809_length_1046_cov_12.639916	607	687	0	12	80	0.1500000
NODE_5809_length_1046_cov_12.639916	607	687	4	4	80	0.0500000
NODE_5809_length_1046_cov_12.639916	607	687	6	42	80	0.5250000
NODE_5809_length_1046_cov_12.639916	607	687	8	22	80	0.2750000
NODE_5810_length_1046_cov_11.238648	471	551	0	29	80	0.3625000
NODE_5810_length_1046_cov_11.238648	471	551	2	10	80	0.1250000
NODE_5810_length_1046_cov_11.238648	471	551	5	41	80	0.5125000
NODE_5810_length_1046_cov_11.238648	524	604	5	46	80	0.5750000
NODE_5810_length_1046_cov_11.238648	524	604	6	6	80	0.0750000
NODE_5810_length_1046_cov_11.238648	524	604	7	1	80	0.0125000
NODE_5810_length_1046_cov_11.238648	524	604	8	27	80	0.3375000
NODE_5811_length_1046_cov_10.744456	459	539	0	80	80	1.0000000
NODE_5811_length_1046_cov_10.744456	512	592	0	80	80	1.0000000
NODE_5812_length_1046_cov_8.689546	302	382	0	80	80	1.0000000
NODE_5812_length_1046_cov_8.689546	355	435	0	80	80	1.0000000
NODE_5823_length_1045_cov_75.975687	359	440	2	50	81	0.6172839
NODE_5823_length_1045_cov_75.975687	359	440	4	31	81	0.3827161
NODE_5823_length_1045_cov_75.975687	412	493	0	15	81	0.1851852
NODE_5823_length_1045_cov_75.975687	412	493	2	55	81	0.6790124
NODE_5823_length_1045_cov_75.975687	412	493	4	11	81	0.1358025
NODE_5823_length_1045_cov_75.975687	489	569	0	64	80	0.8000000
NODE_5823_length_1045_cov_75.975687	489	569	2	16	80	0.2000000
NODE_5823_length_1045_cov_75.975687	542	622	0	11	80	0.1375000
NODE_5823_length_1045_cov_75.975687	542	622	2	69	80	0.8625000
NODE_5824_length_1045_cov_54.419662	434	514	0	3	80	0.0375000
NODE_5824_length_1045_cov_54.419662	434	514	2	49	80	0.6125000
NODE_5824_length_1045_cov_54.419662	434	514	4	28	80	0.3500000
NODE_5824_length_1045_cov_54.419662	487	567	2	22	80	0.2750000
NODE_5824_length_1045_cov_54.419662	487	567	4	58	80	0.7250000
NODE_5824_length_1045_cov_54.419662	563	639	0	66	76	0.8684211
NODE_5824_length_1045_cov_54.419662	563	639	2	10	76	0.1315790
NODE_5824_length_1045_cov_54.419662	616	696	0	80	80	1.0000000
NODE_5825_length_1045_cov_23.188161	395	475	0	46	80	0.5750000
NODE_5825_length_1045_cov_23.188161	395	475	1	34	80	0.4250000
NODE_5825_length_1045_cov_23.188161	448	528	1	80	80	1.0000000
NODE_5826_length_1045_cov_19.686047	571	651	0	8	80	0.1000000
NODE_5826_length_1045_cov_19.686047	571	651	2	72	80	0.9000000
NODE_5826_length_1045_cov_19.686047	624	704	0	61	80	0.7625000
NODE_5826_length_1045_cov_19.686047	624	704	2	19	80	0.2375000
NODE_5827_length_1045_cov_19.378436	478	558	0	30	80	0.3750000
NODE_5827_length_1045_cov_19.378436	478	558	2	9	80	0.1125000
NODE_5827_length_1045_cov_19.378436	478	558	4	14	80	0.1750000
NODE_5827_length_1045_cov_19.378436	478	558	6	27	80	0.3375000
NODE_5827_length_1045_cov_19.378436	531	611	0	13	80	0.1625000
NODE_5827_length_1045_cov_19.378436	531	611	2	1	80	0.0125000
NODE_5827_length_1045_cov_19.378436	531	611	4	1	80	0.0125000
NODE_5827_length_1045_cov_19.378436	531	611	6	65	80	0.8125000
NODE_5828_length_1045_cov_17.601480	359	439	0	57	80	0.7125000
NODE_5828_length_1045_cov_17.601480	359	439	2	23	80	0.2875000
NODE_5828_length_1045_cov_17.601480	412	492	0	80	80	1.0000000
NODE_5829_length_1045_cov_17.372093	633	713	0	80	80	1.0000000
NODE_5829_length_1045_cov_17.372093	686	766	0	80	80	1.0000000
NODE_5830_length_1045_cov_14.828753	433	513	0	3	80	0.0375000
NODE_5830_length_1045_cov_14.828753	433	513	2	77	80	0.9625000
NODE_5830_length_1045_cov_14.828753	486	566	0	50	80	0.6250000
NODE_5830_length_1045_cov_14.828753	486	566	2	30	80	0.3750000
NODE_5831_length_1045_cov_11.673362	664	744	2	29	80	0.3625000
NODE_5831_length_1045_cov_11.673362	664	744	4	51	80	0.6375000
NODE_5831_length_1045_cov_11.673362	717	797	0	23	80	0.2875000
NODE_5831_length_1045_cov_11.673362	717	797	2	37	80	0.4625000
NODE_5831_length_1045_cov_11.673362	717	797	4	20	80	0.2500000
NODE_5843_length_1044_cov_42.600000	344	424	0	8	80	0.1000000
NODE_5843_length_1044_cov_42.600000	344	424	2	72	80	0.9000000
NODE_5843_length_1044_cov_42.600000	397	477	0	38	80	0.4750000
NODE_5843_length_1044_cov_42.600000	397	477	2	42	80	0.5250000
NODE_5844_length_1044_cov_27.653968	454	534	0	16	80	0.2000000
NODE_5844_length_1044_cov_27.653968	454	534	6	9	80	0.1125000
NODE_5844_length_1044_cov_27.653968	454	534	12	55	80	0.6875000
NODE_5844_length_1044_cov_27.653968	507	587	6	4	80	0.0500000
NODE_5844_length_1044_cov_27.653968	507	587	12	76	80	0.9500000
NODE_5845_length_1044_cov_24.561905	297	375	0	78	78	1.0000000
NODE_5845_length_1044_cov_24.561905	348	428	0	80	80	1.0000000
NODE_5845_length_1044_cov_24.561905	424	504	0	80	80	1.0000000
NODE_5845_length_1044_cov_24.561905	477	557	0	80	80	1.0000000
NODE_5846_length_1044_cov_23.720635	294	374	0	62	80	0.7750000
NODE_5846_length_1044_cov_23.720635	294	374	1	3	80	0.0375000
NODE_5846_length_1044_cov_23.720635	294	374	2	15	80	0.1875000
NODE_5846_length_1044_cov_23.720635	347	427	0	9	80	0.1125000
NODE_5846_length_1044_cov_23.720635	347	427	1	3	80	0.0375000
NODE_5846_length_1044_cov_23.720635	347	427	2	66	80	0.8250000
NODE_5846_length_1044_cov_23.720635	347	427	4	2	80	0.0250000
NODE_5846_length_1044_cov_23.720635	423	503	2	2	80	0.0250000
NODE_5846_length_1044_cov_23.720635	423	503	4	22	80	0.2750000
NODE_5846_length_1044_cov_23.720635	423	503	6	56	80	0.7000000
NODE_5846_length_1044_cov_23.720635	476	556	0	18	80	0.2250000
NODE_5846_length_1044_cov_23.720635	476	556	2	19	80	0.2375000
NODE_5846_length_1044_cov_23.720635	476	556	4	10	80	0.1250000
NODE_5846_length_1044_cov_23.720635	476	556	5	3	80	0.0375000
NODE_5846_length_1044_cov_23.720635	476	556	6	30	80	0.3750000
NODE_5847_length_1044_cov_20.871958	462	542	2	42	80	0.5250000
NODE_5847_length_1044_cov_20.871958	462	542	4	21	80	0.2625000
NODE_5847_length_1044_cov_20.871958	462	542	6	17	80	0.2125000
NODE_5847_length_1044_cov_20.871958	515	595	0	27	80	0.3375000
NODE_5847_length_1044_cov_20.871958	515	595	4	46	80	0.5750000
NODE_5847_length_1044_cov_20.871958	515	595	6	7	80	0.0875000
NODE_5847_length_1044_cov_20.871958	591	671	0	80	80	1.0000000
NODE_5847_length_1044_cov_20.871958	644	724	0	80	80	1.0000000
NODE_5848_length_1044_cov_18.596825	433	513	0	80	80	1.0000000
NODE_5848_length_1044_cov_18.596825	486	566	0	80	80	1.0000000
NODE_5849_length_1044_cov_16.102646	414	494	0	25	80	0.3125000
NODE_5849_length_1044_cov_16.102646	414	494	2	55	80	0.6875000
NODE_5849_length_1044_cov_16.102646	467	547	0	1	80	0.0125000
NODE_5849_length_1044_cov_16.102646	467	547	2	79	80	0.9875000
NODE_5850_length_1044_cov_12.156614	578	658	0	80	80	1.0000000
NODE_5850_length_1044_cov_12.156614	631	711	0	80	80	1.0000000
NODE_5851_length_1044_cov_10.661376	506	586	0	80	80	1.0000000
NODE_5851_length_1044_cov_10.661376	559	639	0	80	80	1.0000000
NODE_5852_length_1044_cov_9.534392	461	541	0	51	80	0.6375000
NODE_5852_length_1044_cov_9.534392	461	541	2	29	80	0.3625000
NODE_5852_length_1044_cov_9.534392	514	594	0	56	80	0.7000000
NODE_5852_length_1044_cov_9.534392	514	594	2	24	80	0.3000000
NODE_5853_length_1044_cov_5.517460	434	514	0	80	80	1.0000000
NODE_5853_length_1044_cov_5.517460	487	567	0	65	80	0.8125000
NODE_5853_length_1044_cov_5.517460	487	567	2	15	80	0.1875000
NODE_5856_length_1044_cov_1.502646	769	845	0	76	76	1.0000000
NODE_5860_length_1043_cov_42.288136	452	532	2	14	80	0.1750000
NODE_5860_length_1043_cov_42.288136	452	532	4	22	80	0.2750000
NODE_5860_length_1043_cov_42.288136	452	532	5	1	80	0.0125000
NODE_5860_length_1043_cov_42.288136	452	532	6	2	80	0.0250000
NODE_5860_length_1043_cov_42.288136	452	532	8	41	80	0.5125000
NODE_5860_length_1043_cov_42.288136	505	585	0	14	80	0.1750000
NODE_5860_length_1043_cov_42.288136	505	585	2	53	80	0.6625000
NODE_5860_length_1043_cov_42.288136	505	585	4	13	80	0.1625000
NODE_5861_length_1043_cov_25.987288	350	430	4	35	80	0.4375000
NODE_5861_length_1043_cov_25.987288	350	430	8	16	80	0.2000000
NODE_5861_length_1043_cov_25.987288	350	430	11	1	80	0.0125000
NODE_5861_length_1043_cov_25.987288	350	430	16	6	80	0.0750000
NODE_5861_length_1043_cov_25.987288	350	430	19	21	80	0.2625000
NODE_5861_length_1043_cov_25.987288	350	430	20	1	80	0.0125000
NODE_5861_length_1043_cov_25.987288	403	483	16	5	80	0.0625000
NODE_5861_length_1043_cov_25.987288	403	483	19	25	80	0.3125000
NODE_5861_length_1043_cov_25.987288	403	483	20	26	80	0.3250000
NODE_5861_length_1043_cov_25.987288	403	483	21	10	80	0.1250000
NODE_5861_length_1043_cov_25.987288	403	483	22	8	80	0.1000000
NODE_5861_length_1043_cov_25.987288	403	483	23	6	80	0.0750000
NODE_5861_length_1043_cov_25.987288	479	559	16	27	80	0.3375000
NODE_5861_length_1043_cov_25.987288	479	559	18	15	80	0.1875000
NODE_5861_length_1043_cov_25.987288	479	559	19	13	80	0.1625000
NODE_5861_length_1043_cov_25.987288	479	559	20	14	80	0.1750000
NODE_5861_length_1043_cov_25.987288	479	559	22	11	80	0.1375000
NODE_5861_length_1043_cov_25.987288	532	612	8	1	80	0.0125000
NODE_5861_length_1043_cov_25.987288	532	612	9	4	80	0.0500000
NODE_5861_length_1043_cov_25.987288	532	612	12	3	80	0.0375000
NODE_5861_length_1043_cov_25.987288	532	612	13	21	80	0.2625000
NODE_5861_length_1043_cov_25.987288	532	612	15	4	80	0.0500000
NODE_5861_length_1043_cov_25.987288	532	612	16	21	80	0.2625000
NODE_5861_length_1043_cov_25.987288	532	612	18	6	80	0.0750000
NODE_5861_length_1043_cov_25.987288	532	612	19	7	80	0.0875000
NODE_5861_length_1043_cov_25.987288	532	612	20	3	80	0.0375000
NODE_5861_length_1043_cov_25.987288	532	612	22	10	80	0.1250000
NODE_5862_length_1043_cov_20.838983	561	641	0	66	80	0.8250000
NODE_5862_length_1043_cov_20.838983	561	641	2	14	80	0.1750000
NODE_5862_length_1043_cov_20.838983	614	694	0	13	80	0.1625000
NODE_5862_length_1043_cov_20.838983	614	694	2	67	80	0.8375000
NODE_5863_length_1043_cov_20.312500	489	569	0	69	80	0.8625000
NODE_5863_length_1043_cov_20.312500	489	569	2	11	80	0.1375000
NODE_5863_length_1043_cov_20.312500	542	622	0	80	80	1.0000000
NODE_5864_length_1043_cov_16.320975	569	649	2	61	80	0.7625000
NODE_5864_length_1043_cov_16.320975	569	649	4	14	80	0.1750000
NODE_5864_length_1043_cov_16.320975	569	649	6	5	80	0.0625000
NODE_5864_length_1043_cov_16.320975	622	702	2	66	80	0.8250000
NODE_5864_length_1043_cov_16.320975	622	702	4	14	80	0.1750000
NODE_5865_length_1043_cov_11.176907	521	601	0	80	80	1.0000000
NODE_5865_length_1043_cov_11.176907	574	654	0	80	80	1.0000000
NODE_5866_length_1043_cov_8.146186	530	596	0	66	66	1.0000000
NODE_5866_length_1043_cov_8.146186	569	649	0	80	80	1.0000000
NODE_5868_length_1043_cov_5.347458	646	726	0	80	80	1.0000000
NODE_5868_length_1043_cov_5.347458	699	779	0	80	80	1.0000000
NODE_5879_length_1042_cov_242.728526	820	900	102	1	80	0.0125000
NODE_5879_length_1042_cov_242.728526	820	900	103	1	80	0.0125000
NODE_5879_length_1042_cov_242.728526	820	900	104	1	80	0.0125000
NODE_5879_length_1042_cov_242.728526	820	900	106	4	80	0.0500000
NODE_5879_length_1042_cov_242.728526	820	900	109	1	80	0.0125000
NODE_5879_length_1042_cov_242.728526	820	900	116	2	80	0.0250000
NODE_5879_length_1042_cov_242.728526	820	900	120	1	80	0.0125000
NODE_5879_length_1042_cov_242.728526	820	900	128	1	80	0.0125000
NODE_5879_length_1042_cov_242.728526	820	900	130	1	80	0.0125000
NODE_5879_length_1042_cov_242.728526	820	900	132	1	80	0.0125000
NODE_5879_length_1042_cov_242.728526	820	900	142	1	80	0.0125000
NODE_5879_length_1042_cov_242.728526	820	900	150	3	80	0.0375000
NODE_5879_length_1042_cov_242.728526	820	900	151	1	80	0.0125000
NODE_5879_length_1042_cov_242.728526	820	900	152	7	80	0.0875000
NODE_5879_length_1042_cov_242.728526	820	900	153	8	80	0.1000000
NODE_5879_length_1042_cov_242.728526	820	900	154	2	80	0.0250000
NODE_5879_length_1042_cov_242.728526	820	900	155	3	80	0.0375000
NODE_5879_length_1042_cov_242.728526	820	900	156	2	80	0.0250000
NODE_5879_length_1042_cov_242.728526	820	900	157	1	80	0.0125000
NODE_5879_length_1042_cov_242.728526	820	900	159	3	80	0.0375000
NODE_5879_length_1042_cov_242.728526	820	900	170	1	80	0.0125000
NODE_5879_length_1042_cov_242.728526	820	900	174	4	80	0.0500000
NODE_5879_length_1042_cov_242.728526	820	900	182	1	80	0.0125000
NODE_5879_length_1042_cov_242.728526	820	900	183	2	80	0.0250000
NODE_5879_length_1042_cov_242.728526	820	900	185	3	80	0.0375000
NODE_5879_length_1042_cov_242.728526	820	900	187	1	80	0.0125000
NODE_5879_length_1042_cov_242.728526	820	900	188	2	80	0.0250000
NODE_5879_length_1042_cov_242.728526	820	900	189	1	80	0.0125000
NODE_5879_length_1042_cov_242.728526	820	900	191	1	80	0.0125000
NODE_5879_length_1042_cov_242.728526	820	900	192	1	80	0.0125000
NODE_5879_length_1042_cov_242.728526	820	900	194	2	80	0.0250000
NODE_5879_length_1042_cov_242.728526	820	900	196	1	80	0.0125000
NODE_5879_length_1042_cov_242.728526	820	900	198	1	80	0.0125000
NODE_5879_length_1042_cov_242.728526	820	900	206	1	80	0.0125000
NODE_5879_length_1042_cov_242.728526	820	900	207	1	80	0.0125000
NODE_5879_length_1042_cov_242.728526	820	900	209	2	80	0.0250000
NODE_5879_length_1042_cov_242.728526	820	900	211	2	80	0.0250000
NODE_5879_length_1042_cov_242.728526	820	900	213	6	80	0.0750000
NODE_5879_length_1042_cov_242.728526	820	900	215	2	80	0.0250000
NODE_5879_length_1042_cov_242.728526	873	903	185	3	30	0.1000000
NODE_5879_length_1042_cov_242.728526	873	903	187	1	30	0.0333333
NODE_5879_length_1042_cov_242.728526	873	903	188	2	30	0.0666667
NODE_5879_length_1042_cov_242.728526	873	903	189	1	30	0.0333333
NODE_5879_length_1042_cov_242.728526	873	903	191	1	30	0.0333333
NODE_5879_length_1042_cov_242.728526	873	903	192	1	30	0.0333333
NODE_5879_length_1042_cov_242.728526	873	903	194	2	30	0.0666667
NODE_5879_length_1042_cov_242.728526	873	903	196	1	30	0.0333333
NODE_5879_length_1042_cov_242.728526	873	903	198	1	30	0.0333333
NODE_5879_length_1042_cov_242.728526	873	903	206	1	30	0.0333333
NODE_5879_length_1042_cov_242.728526	873	903	207	1	30	0.0333333
NODE_5879_length_1042_cov_242.728526	873	903	209	2	30	0.0666667
NODE_5879_length_1042_cov_242.728526	873	903	211	2	30	0.0666667
NODE_5879_length_1042_cov_242.728526	873	903	213	9	30	0.3000000
NODE_5879_length_1042_cov_242.728526	873	903	215	2	30	0.0666667
NODE_5880_length_1042_cov_63.214210	355	435	2	27	80	0.3375000
NODE_5880_length_1042_cov_63.214210	355	435	8	12	80	0.1500000
NODE_5880_length_1042_cov_63.214210	355	435	9	13	80	0.1625000
NODE_5880_length_1042_cov_63.214210	355	435	13	11	80	0.1375000
NODE_5880_length_1042_cov_63.214210	355	435	15	7	80	0.0875000
NODE_5880_length_1042_cov_63.214210	355	435	16	2	80	0.0250000
NODE_5880_length_1042_cov_63.214210	355	435	17	8	80	0.1000000
NODE_5880_length_1042_cov_63.214210	408	488	13	10	80	0.1250000
NODE_5880_length_1042_cov_63.214210	408	488	14	11	80	0.1375000
NODE_5880_length_1042_cov_63.214210	408	488	15	9	80	0.1125000
NODE_5880_length_1042_cov_63.214210	408	488	16	7	80	0.0875000
NODE_5880_length_1042_cov_63.214210	408	488	17	43	80	0.5375000
NODE_5881_length_1042_cov_29.581124	497	577	2	80	80	1.0000000
NODE_5881_length_1042_cov_29.581124	550	630	0	15	80	0.1875000
NODE_5881_length_1042_cov_29.581124	550	630	2	65	80	0.8125000
NODE_5882_length_1042_cov_23.861082	519	599	1	24	80	0.3000000
NODE_5882_length_1042_cov_23.861082	519	599	2	21	80	0.2625000
NODE_5882_length_1042_cov_23.861082	519	599	3	35	80	0.4375000
NODE_5882_length_1042_cov_23.861082	572	652	0	35	80	0.4375000
NODE_5882_length_1042_cov_23.861082	572	652	2	39	80	0.4875000
NODE_5882_length_1042_cov_23.861082	572	652	3	6	80	0.0750000
NODE_5882_length_1042_cov_23.861082	648	728	0	80	80	1.0000000
NODE_5882_length_1042_cov_23.861082	701	781	0	41	80	0.5125000
NODE_5882_length_1042_cov_23.861082	701	781	2	39	80	0.4875000
NODE_5883_length_1042_cov_22.247084	555	635	0	80	80	1.0000000
NODE_5883_length_1042_cov_22.247084	608	688	0	47	80	0.5875000
NODE_5883_length_1042_cov_22.247084	608	688	1	10	80	0.1250000
NODE_5883_length_1042_cov_22.247084	608	688	3	2	80	0.0250000
NODE_5883_length_1042_cov_22.247084	608	688	4	21	80	0.2625000
NODE_5884_length_1042_cov_22.117709	335	415	2	80	80	1.0000000
NODE_5884_length_1042_cov_22.117709	388	468	0	52	80	0.6500000
NODE_5884_length_1042_cov_22.117709	388	468	2	28	80	0.3500000
NODE_5884_length_1042_cov_22.117709	464	544	0	7	80	0.0875000
NODE_5884_length_1042_cov_22.117709	464	544	2	73	80	0.9125000
NODE_5884_length_1042_cov_22.117709	517	597	0	12	80	0.1500000
NODE_5884_length_1042_cov_22.117709	517	597	2	68	80	0.8500000
NODE_5885_length_1042_cov_16.831389	27	97	4	39	70	0.5571429
NODE_5885_length_1042_cov_16.831389	27	97	8	3	70	0.0428571
NODE_5885_length_1042_cov_16.831389	27	97	10	28	70	0.4000000
NODE_5885_length_1042_cov_16.831389	372	452	0	16	80	0.2000000
NODE_5885_length_1042_cov_16.831389	372	452	6	18	80	0.2250000
NODE_5885_length_1042_cov_16.831389	372	452	8	46	80	0.5750000
NODE_5885_length_1042_cov_16.831389	425	505	2	21	80	0.2625000
NODE_5885_length_1042_cov_16.831389	425	505	4	11	80	0.1375000
NODE_5885_length_1042_cov_16.831389	425	505	8	48	80	0.6000000
NODE_5886_length_1042_cov_16.662778	416	496	0	4	80	0.0500000
NODE_5886_length_1042_cov_16.662778	416	496	6	76	80	0.9500000
NODE_5886_length_1042_cov_16.662778	469	549	0	57	80	0.7125000
NODE_5886_length_1042_cov_16.662778	469	549	6	23	80	0.2875000
NODE_5887_length_1042_cov_9.474019	361	441	2	39	80	0.4875000
NODE_5887_length_1042_cov_9.474019	361	441	6	1	80	0.0125000
NODE_5887_length_1042_cov_9.474019	361	441	8	31	80	0.3875000
NODE_5887_length_1042_cov_9.474019	361	441	10	9	80	0.1125000
NODE_5887_length_1042_cov_9.474019	414	494	8	32	80	0.4000000
NODE_5887_length_1042_cov_9.474019	414	494	10	48	80	0.6000000
NODE_5888_length_1042_cov_6.725345	356	419	0	63	63	1.0000000
NODE_5888_length_1042_cov_6.725345	392	472	0	80	80	1.0000000
NODE_5896_length_1041_cov_42.960722	335	415	0	61	80	0.7625000
NODE_5896_length_1041_cov_42.960722	335	415	1	18	80	0.2250000
NODE_5896_length_1041_cov_42.960722	335	415	3	1	80	0.0125000
NODE_5896_length_1041_cov_42.960722	388	468	0	8	80	0.1000000
NODE_5896_length_1041_cov_42.960722	388	468	1	18	80	0.2250000
NODE_5896_length_1041_cov_42.960722	388	468	3	41	80	0.5125000
NODE_5896_length_1041_cov_42.960722	388	468	5	1	80	0.0125000
NODE_5896_length_1041_cov_42.960722	388	468	6	12	80	0.1500000
NODE_5896_length_1041_cov_42.960722	464	544	6	79	80	0.9875000
NODE_5896_length_1041_cov_42.960722	464	544	8	1	80	0.0125000
NODE_5896_length_1041_cov_42.960722	517	597	1	9	80	0.1125000
NODE_5896_length_1041_cov_42.960722	517	597	3	35	80	0.4375000
NODE_5896_length_1041_cov_42.960722	517	597	5	7	80	0.0875000
NODE_5896_length_1041_cov_42.960722	517	597	6	29	80	0.3625000
NODE_5897_length_1041_cov_37.331210	513	593	9	15	80	0.1875000
NODE_5897_length_1041_cov_37.331210	513	593	11	3	80	0.0375000
NODE_5897_length_1041_cov_37.331210	513	593	14	1	80	0.0125000
NODE_5897_length_1041_cov_37.331210	513	593	15	10	80	0.1250000
NODE_5897_length_1041_cov_37.331210	513	593	16	7	80	0.0875000
NODE_5897_length_1041_cov_37.331210	513	593	17	35	80	0.4375000
NODE_5897_length_1041_cov_37.331210	513	593	18	9	80	0.1125000
NODE_5897_length_1041_cov_37.331210	566	646	0	4	80	0.0500000
NODE_5897_length_1041_cov_37.331210	566	646	2	6	80	0.0750000
NODE_5897_length_1041_cov_37.331210	566	646	6	25	80	0.3125000
NODE_5897_length_1041_cov_37.331210	566	646	12	3	80	0.0375000
NODE_5897_length_1041_cov_37.331210	566	646	14	16	80	0.2000000
NODE_5897_length_1041_cov_37.331210	566	646	16	7	80	0.0875000
NODE_5897_length_1041_cov_37.331210	566	646	17	10	80	0.1250000
NODE_5897_length_1041_cov_37.331210	566	646	18	9	80	0.1125000
NODE_5897_length_1041_cov_37.331210	642	722	0	80	80	1.0000000
NODE_5897_length_1041_cov_37.331210	695	775	0	80	80	1.0000000
NODE_5898_length_1041_cov_36.477707	455	535	2	26	80	0.3250000
NODE_5898_length_1041_cov_36.477707	455	535	4	27	80	0.3375000
NODE_5898_length_1041_cov_36.477707	455	535	5	18	80	0.2250000
NODE_5898_length_1041_cov_36.477707	455	535	6	9	80	0.1125000
NODE_5898_length_1041_cov_36.477707	508	588	0	20	80	0.2500000
NODE_5898_length_1041_cov_36.477707	508	588	1	17	80	0.2125000
NODE_5898_length_1041_cov_36.477707	508	588	2	42	80	0.5250000
NODE_5898_length_1041_cov_36.477707	508	588	6	1	80	0.0125000
NODE_5898_length_1041_cov_36.477707	584	664	0	7	80	0.0875000
NODE_5898_length_1041_cov_36.477707	584	664	2	73	80	0.9125000
NODE_5898_length_1041_cov_36.477707	637	717	0	38	80	0.4750000
NODE_5898_length_1041_cov_36.477707	637	717	2	42	80	0.5250000
NODE_5898_length_1041_cov_36.477707	753	799	0	46	46	1.0000000
NODE_5899_length_1041_cov_19.286624	468	548	0	22	80	0.2750000
NODE_5899_length_1041_cov_19.286624	468	548	2	58	80	0.7250000
NODE_5899_length_1041_cov_19.286624	521	601	0	20	80	0.2500000
NODE_5899_length_1041_cov_19.286624	521	601	2	60	80	0.7500000
NODE_5900_length_1041_cov_17.072187	578	658	0	7	80	0.0875000
NODE_5900_length_1041_cov_17.072187	578	658	2	73	80	0.9125000
NODE_5900_length_1041_cov_17.072187	631	711	0	60	80	0.7500000
NODE_5900_length_1041_cov_17.072187	631	711	2	20	80	0.2500000
NODE_5901_length_1041_cov_11.887473	437	517	0	22	80	0.2750000
NODE_5901_length_1041_cov_11.887473	437	517	2	58	80	0.7250000
NODE_5901_length_1041_cov_11.887473	490	570	0	6	80	0.0750000
NODE_5901_length_1041_cov_11.887473	490	570	2	74	80	0.9250000
NODE_5902_length_1041_cov_6.957537	354	434	0	49	80	0.6125000
NODE_5902_length_1041_cov_6.957537	354	434	4	31	80	0.3875000
NODE_5902_length_1041_cov_6.957537	407	487	4	80	80	1.0000000
NODE_5913_length_1040_cov_34.618491	478	558	0	80	80	1.0000000
NODE_5913_length_1040_cov_34.618491	531	611	0	80	80	1.0000000
NODE_5914_length_1040_cov_33.061637	485	565	4	80	80	1.0000000
NODE_5914_length_1040_cov_33.061637	538	618	0	39	80	0.4875000
NODE_5914_length_1040_cov_33.061637	538	618	4	41	80	0.5125000
NODE_5915_length_1040_cov_27.818278	402	482	6	11	80	0.1375000
NODE_5915_length_1040_cov_27.818278	402	482	8	6	80	0.0750000
NODE_5915_length_1040_cov_27.818278	402	482	10	9	80	0.1125000
NODE_5915_length_1040_cov_27.818278	402	482	12	40	80	0.5000000
NODE_5915_length_1040_cov_27.818278	402	482	14	14	80	0.1750000
NODE_5915_length_1040_cov_27.818278	455	535	2	23	80	0.2875000
NODE_5915_length_1040_cov_27.818278	455	535	4	2	80	0.0250000
NODE_5915_length_1040_cov_27.818278	455	535	6	23	80	0.2875000
NODE_5915_length_1040_cov_27.818278	455	535	8	2	80	0.0250000
NODE_5915_length_1040_cov_27.818278	455	535	12	30	80	0.3750000
NODE_5916_length_1040_cov_17.933050	487	567	0	80	80	1.0000000
NODE_5916_length_1040_cov_17.933050	540	620	0	80	80	1.0000000
NODE_5917_length_1040_cov_14.327311	237	317	6	31	80	0.3875000
NODE_5917_length_1040_cov_14.327311	237	317	8	49	80	0.6125000
NODE_5917_length_1040_cov_14.327311	290	370	4	3	80	0.0375000
NODE_5917_length_1040_cov_14.327311	290	370	5	24	80	0.3000000
NODE_5917_length_1040_cov_14.327311	290	370	8	53	80	0.6625000
NODE_5917_length_1040_cov_14.327311	366	446	2	8	80	0.1000000
NODE_5917_length_1040_cov_14.327311	366	446	4	20	80	0.2500000
NODE_5917_length_1040_cov_14.327311	366	446	5	4	80	0.0500000
NODE_5917_length_1040_cov_14.327311	366	446	6	33	80	0.4125000
NODE_5917_length_1040_cov_14.327311	366	446	7	15	80	0.1875000
NODE_5917_length_1040_cov_14.327311	419	499	0	4	80	0.0500000
NODE_5917_length_1040_cov_14.327311	419	499	2	57	80	0.7125000
NODE_5917_length_1040_cov_14.327311	419	499	4	19	80	0.2375000
NODE_5918_length_1040_cov_11.910733	369	449	4	17	80	0.2125000
NODE_5918_length_1040_cov_11.910733	369	449	6	63	80	0.7875000
NODE_5918_length_1040_cov_11.910733	422	502	0	17	80	0.2125000
NODE_5918_length_1040_cov_11.910733	422	502	2	15	80	0.1875000
NODE_5918_length_1040_cov_11.910733	422	502	6	48	80	0.6000000
NODE_5919_length_1040_cov_11.521785	355	435	0	80	80	1.0000000
NODE_5919_length_1040_cov_11.521785	408	488	0	80	80	1.0000000
NODE_5920_length_1040_cov_9.573858	632	712	2	20	80	0.2500000
NODE_5920_length_1040_cov_9.573858	632	712	6	3	80	0.0375000
NODE_5920_length_1040_cov_9.573858	632	712	8	57	80	0.7125000
NODE_5920_length_1040_cov_9.573858	685	765	0	15	80	0.1875000
NODE_5920_length_1040_cov_9.573858	685	765	2	2	80	0.0250000
NODE_5920_length_1040_cov_9.573858	685	765	4	7	80	0.0875000
NODE_5920_length_1040_cov_9.573858	685	765	8	56	80	0.7000000
NODE_5921_length_1040_cov_8.148778	349	429	0	49	80	0.6125000
NODE_5921_length_1040_cov_8.148778	349	429	2	31	80	0.3875000
NODE_5921_length_1040_cov_8.148778	402	482	2	80	80	1.0000000
NODE_5922_length_1040_cov_7.927736	282	362	6	80	80	1.0000000
NODE_5922_length_1040_cov_7.927736	335	415	0	43	80	0.5375000
NODE_5922_length_1040_cov_7.927736	335	415	6	37	80	0.4625000
NODE_5927_length_1040_cov_2.317747	2	78	2	76	76	1.0000000
NODE_5934_length_1039_cov_40.150000	487	567	0	80	80	1.0000000
NODE_5934_length_1039_cov_40.150000	540	620	0	28	80	0.3500000
NODE_5934_length_1039_cov_40.150000	540	620	2	52	80	0.6500000
NODE_5934_length_1039_cov_40.150000	616	696	2	39	80	0.4875000
NODE_5934_length_1039_cov_40.150000	616	696	4	2	80	0.0250000
NODE_5934_length_1039_cov_40.150000	616	696	6	39	80	0.4875000
NODE_5934_length_1039_cov_40.150000	669	739	2	13	70	0.1857143
NODE_5934_length_1039_cov_40.150000	669	739	4	16	70	0.2285714
NODE_5934_length_1039_cov_40.150000	669	739	6	41	70	0.5857143
NODE_5935_length_1039_cov_37.940426	175	255	4	22	80	0.2750000
NODE_5935_length_1039_cov_37.940426	175	255	6	9	80	0.1125000
NODE_5935_length_1039_cov_37.940426	175	255	8	15	80	0.1875000
NODE_5935_length_1039_cov_37.940426	175	255	14	34	80	0.4250000
NODE_5935_length_1039_cov_37.940426	228	308	6	14	80	0.1750000
NODE_5935_length_1039_cov_37.940426	228	308	7	2	80	0.0250000
NODE_5935_length_1039_cov_37.940426	228	308	9	1	80	0.0125000
NODE_5935_length_1039_cov_37.940426	228	308	11	15	80	0.1875000
NODE_5935_length_1039_cov_37.940426	228	308	12	19	80	0.2375000
NODE_5935_length_1039_cov_37.940426	228	308	14	29	80	0.3625000
NODE_5935_length_1039_cov_37.940426	304	384	0	22	80	0.2750000
NODE_5935_length_1039_cov_37.940426	304	384	6	58	80	0.7250000
NODE_5935_length_1039_cov_37.940426	357	437	0	75	80	0.9375000
NODE_5935_length_1039_cov_37.940426	357	437	6	5	80	0.0625000
NODE_5936_length_1039_cov_24.567021	371	451	0	56	80	0.7000000
NODE_5936_length_1039_cov_24.567021	371	451	2	24	80	0.3000000
NODE_5936_length_1039_cov_24.567021	424	504	0	3	80	0.0375000
NODE_5936_length_1039_cov_24.567021	424	504	2	77	80	0.9625000
NODE_5937_length_1039_cov_15.790426	293	373	0	7	80	0.0875000
NODE_5937_length_1039_cov_15.790426	293	373	2	55	80	0.6875000
NODE_5937_length_1039_cov_15.790426	293	373	4	18	80	0.2250000
NODE_5937_length_1039_cov_15.790426	346	426	0	4	80	0.0500000
NODE_5937_length_1039_cov_15.790426	346	426	2	5	80	0.0625000
NODE_5937_length_1039_cov_15.790426	346	426	4	71	80	0.8875000
NODE_5938_length_1039_cov_14.670213	591	671	0	80	80	1.0000000
NODE_5938_length_1039_cov_14.670213	644	724	0	80	80	1.0000000
NODE_5939_length_1039_cov_11.568085	439	519	0	80	80	1.0000000
NODE_5939_length_1039_cov_11.568085	492	571	0	79	79	1.0000000
NODE_5947_length_1038_cov_17.191693	549	629	0	25	80	0.3125000
NODE_5947_length_1038_cov_17.191693	549	629	2	33	80	0.4125000
NODE_5947_length_1038_cov_17.191693	549	629	4	22	80	0.2750000
NODE_5947_length_1038_cov_17.191693	602	682	0	5	80	0.0625000
NODE_5947_length_1038_cov_17.191693	602	682	4	75	80	0.9375000
NODE_5948_length_1038_cov_13.520767	516	596	0	80	80	1.0000000
NODE_5948_length_1038_cov_13.520767	569	649	0	80	80	1.0000000
NODE_5949_length_1038_cov_10.541001	487	567	0	80	80	1.0000000
NODE_5949_length_1038_cov_10.541001	540	620	0	80	80	1.0000000
NODE_5950_length_1038_cov_8.826411	432	512	0	80	80	1.0000000
NODE_5950_length_1038_cov_8.826411	485	565	0	80	80	1.0000000
NODE_5952_length_1038_cov_2.587859	673	753	0	80	80	1.0000000
NODE_5952_length_1038_cov_2.587859	726	806	0	80	80	1.0000000
NODE_5963_length_1037_cov_66.968017	402	482	4	23	80	0.2875000
NODE_5963_length_1037_cov_66.968017	402	482	6	53	80	0.6625000
NODE_5963_length_1037_cov_66.968017	402	482	8	4	80	0.0500000
NODE_5963_length_1037_cov_66.968017	455	535	2	29	80	0.3625000
NODE_5963_length_1037_cov_66.968017	455	535	4	23	80	0.2875000
NODE_5963_length_1037_cov_66.968017	455	535	6	24	80	0.3000000
NODE_5963_length_1037_cov_66.968017	455	535	8	4	80	0.0500000
NODE_5964_length_1037_cov_53.639659	527	607	2	37	80	0.4625000
NODE_5964_length_1037_cov_53.639659	527	607	4	5	80	0.0625000
NODE_5964_length_1037_cov_53.639659	527	607	8	17	80	0.2125000
NODE_5964_length_1037_cov_53.639659	527	607	10	21	80	0.2625000
NODE_5964_length_1037_cov_53.639659	580	660	6	7	80	0.0875000
NODE_5964_length_1037_cov_53.639659	580	660	8	21	80	0.2625000
NODE_5964_length_1037_cov_53.639659	580	660	10	52	80	0.6500000
NODE_5965_length_1037_cov_45.353945	542	622	0	80	80	1.0000000
NODE_5965_length_1037_cov_45.353945	595	675	0	80	80	1.0000000
NODE_5966_length_1037_cov_31.078891	356	436	12	5	80	0.0625000
NODE_5966_length_1037_cov_31.078891	356	436	14	3	80	0.0375000
NODE_5966_length_1037_cov_31.078891	356	436	16	53	80	0.6625000
NODE_5966_length_1037_cov_31.078891	356	436	18	19	80	0.2375000
NODE_5966_length_1037_cov_31.078891	409	489	2	40	80	0.5000000
NODE_5966_length_1037_cov_31.078891	409	489	6	3	80	0.0375000
NODE_5966_length_1037_cov_31.078891	409	489	12	15	80	0.1875000
NODE_5966_length_1037_cov_31.078891	409	489	14	3	80	0.0375000
NODE_5966_length_1037_cov_31.078891	409	489	16	19	80	0.2375000
NODE_5967_length_1037_cov_25.453092	421	501	15	5	80	0.0625000
NODE_5967_length_1037_cov_25.453092	421	501	17	13	80	0.1625000
NODE_5967_length_1037_cov_25.453092	421	501	21	23	80	0.2875000
NODE_5967_length_1037_cov_25.453092	421	501	23	3	80	0.0375000
NODE_5967_length_1037_cov_25.453092	421	501	24	19	80	0.2375000
NODE_5967_length_1037_cov_25.453092	421	501	26	17	80	0.2125000
NODE_5967_length_1037_cov_25.453092	474	554	0	14	80	0.1750000
NODE_5967_length_1037_cov_25.453092	474	554	12	1	80	0.0125000
NODE_5967_length_1037_cov_25.453092	474	554	13	11	80	0.1375000
NODE_5967_length_1037_cov_25.453092	474	554	15	32	80	0.4000000
NODE_5967_length_1037_cov_25.453092	474	554	17	13	80	0.1625000
NODE_5967_length_1037_cov_25.453092	474	554	21	9	80	0.1125000
NODE_5967_length_1037_cov_25.453092	550	573	0	10	23	0.4347826
NODE_5967_length_1037_cov_25.453092	550	573	2	12	23	0.5217391
NODE_5967_length_1037_cov_25.453092	550	573	4	1	23	0.0434783
NODE_5968_length_1037_cov_13.740938	348	428	0	80	80	1.0000000
NODE_5968_length_1037_cov_13.740938	401	481	0	80	80	1.0000000
NODE_5969_length_1037_cov_12.632196	564	644	2	15	80	0.1875000
NODE_5969_length_1037_cov_12.632196	564	644	4	65	80	0.8125000
NODE_5969_length_1037_cov_12.632196	617	697	0	30	80	0.3750000
NODE_5969_length_1037_cov_12.632196	617	697	2	38	80	0.4750000
NODE_5969_length_1037_cov_12.632196	617	697	4	12	80	0.1500000
NODE_5970_length_1037_cov_8.904051	640	720	0	7	80	0.0875000
NODE_5970_length_1037_cov_8.904051	640	720	2	73	80	0.9125000
NODE_5970_length_1037_cov_8.904051	693	773	0	57	80	0.7125000
NODE_5970_length_1037_cov_8.904051	693	773	2	23	80	0.2875000
NODE_5978_length_1037_cov_1.859275	31	91	2	60	60	1.0000000
NODE_5986_length_1036_cov_52.270011	493	573	0	80	80	1.0000000
NODE_5986_length_1036_cov_52.270011	546	626	0	80	80	1.0000000
NODE_5987_length_1036_cov_24.080043	369	449	0	15	80	0.1875000
NODE_5987_length_1036_cov_24.080043	369	449	2	26	80	0.3250000
NODE_5987_length_1036_cov_24.080043	369	449	4	39	80	0.4875000
NODE_5987_length_1036_cov_24.080043	422	502	2	21	80	0.2625000
NODE_5987_length_1036_cov_24.080043	422	502	4	59	80	0.7375000
NODE_5988_length_1036_cov_20.533618	513	593	0	60	80	0.7500000
NODE_5988_length_1036_cov_20.533618	513	593	2	20	80	0.2500000
NODE_5988_length_1036_cov_20.533618	566	645	0	7	79	0.0886076
NODE_5988_length_1036_cov_20.533618	566	645	2	72	79	0.9113924
NODE_5988_length_1036_cov_20.533618	648	728	0	12	80	0.1500000
NODE_5988_length_1036_cov_20.533618	648	728	2	2	80	0.0250000
NODE_5988_length_1036_cov_20.533618	648	728	4	30	80	0.3750000
NODE_5988_length_1036_cov_20.533618	648	728	6	36	80	0.4500000
NODE_5988_length_1036_cov_20.533618	701	781	6	80	80	1.0000000
NODE_5989_length_1036_cov_19.715048	467	547	5	7	80	0.0875000
NODE_5989_length_1036_cov_19.715048	467	547	6	1	80	0.0125000
NODE_5989_length_1036_cov_19.715048	467	547	7	3	80	0.0375000
NODE_5989_length_1036_cov_19.715048	467	547	8	69	80	0.8625000
NODE_5989_length_1036_cov_19.715048	520	600	6	19	80	0.2375000
NODE_5989_length_1036_cov_19.715048	520	600	8	59	80	0.7375000
NODE_5989_length_1036_cov_19.715048	520	600	9	1	80	0.0125000
NODE_5989_length_1036_cov_19.715048	520	600	10	1	80	0.0125000
NODE_5990_length_1036_cov_19.452508	399	479	0	26	80	0.3250000
NODE_5990_length_1036_cov_19.452508	399	479	2	54	80	0.6750000
NODE_5990_length_1036_cov_19.452508	452	532	0	1	80	0.0125000
NODE_5990_length_1036_cov_19.452508	452	532	2	79	80	0.9875000
NODE_5990_length_1036_cov_19.452508	528	608	0	39	80	0.4875000
NODE_5990_length_1036_cov_19.452508	528	608	2	41	80	0.5125000
NODE_5990_length_1036_cov_19.452508	581	661	2	80	80	1.0000000
NODE_5991_length_1036_cov_13.840982	635	715	2	18	80	0.2250000
NODE_5991_length_1036_cov_13.840982	635	715	4	62	80	0.7750000
NODE_5991_length_1036_cov_13.840982	688	768	0	52	80	0.6500000
NODE_5991_length_1036_cov_13.840982	688	768	2	19	80	0.2375000
NODE_5991_length_1036_cov_13.840982	688	768	4	9	80	0.1125000
NODE_5992_length_1036_cov_6.913554	424	504	0	37	80	0.4625000
NODE_5992_length_1036_cov_6.913554	424	504	2	1	80	0.0125000
NODE_5992_length_1036_cov_6.913554	424	504	3	2	80	0.0250000
NODE_5992_length_1036_cov_6.913554	424	504	4	40	80	0.5000000
NODE_5992_length_1036_cov_6.913554	477	557	4	80	80	1.0000000
NODE_5993_length_1036_cov_5.880470	436	516	2	80	80	1.0000000
NODE_5993_length_1036_cov_5.880470	489	569	0	44	80	0.5500000
NODE_5993_length_1036_cov_5.880470	489	569	2	36	80	0.4500000
NODE_5994_length_1036_cov_4.638207	531	611	0	1	80	0.0125000
NODE_5994_length_1036_cov_4.638207	531	611	1	16	80	0.2000000
NODE_5994_length_1036_cov_4.638207	531	611	2	63	80	0.7875000
NODE_5994_length_1036_cov_4.638207	584	664	2	80	80	1.0000000
NODE_5998_length_1036_cov_1.293490	19	69	0	35	50	0.7000000
NODE_5998_length_1036_cov_1.293490	19	69	2	15	50	0.3000000
NODE_6001_length_1035_cov_31.941239	590	670	0	74	80	0.9250000
NODE_6001_length_1035_cov_31.941239	590	670	2	6	80	0.0750000
NODE_6001_length_1035_cov_31.941239	643	723	0	21	80	0.2625000
NODE_6001_length_1035_cov_31.941239	643	723	2	8	80	0.1000000
NODE_6001_length_1035_cov_31.941239	643	723	4	51	80	0.6375000
NODE_6002_length_1035_cov_14.917735	396	476	0	80	80	1.0000000
NODE_6002_length_1035_cov_14.917735	449	529	0	80	80	1.0000000
NODE_6003_length_1035_cov_12.552350	467	547	0	39	80	0.4875000
NODE_6003_length_1035_cov_12.552350	467	547	2	41	80	0.5125000
NODE_6003_length_1035_cov_12.552350	520	600	0	18	80	0.2250000
NODE_6003_length_1035_cov_12.552350	520	600	2	62	80	0.7750000
NODE_6004_length_1035_cov_12.050214	40	103	0	36	63	0.5714286
NODE_6004_length_1035_cov_12.050214	40	103	2	16	63	0.2539683
NODE_6004_length_1035_cov_12.050214	40	103	4	5	63	0.0793651
NODE_6004_length_1035_cov_12.050214	40	103	6	3	63	0.0476190
NODE_6004_length_1035_cov_12.050214	40	103	8	3	63	0.0476190
NODE_6004_length_1035_cov_12.050214	138	219	2	3	81	0.0370370
NODE_6004_length_1035_cov_12.050214	138	219	6	4	81	0.0493827
NODE_6004_length_1035_cov_12.050214	138	219	10	7	81	0.0864198
NODE_6004_length_1035_cov_12.050214	138	219	12	21	81	0.2592593
NODE_6004_length_1035_cov_12.050214	138	219	14	46	81	0.5679013
NODE_6005_length_1035_cov_7.020299	350	430	0	40	80	0.5000000
NODE_6005_length_1035_cov_7.020299	350	430	2	40	80	0.5000000
NODE_6005_length_1035_cov_7.020299	403	483	0	25	80	0.3125000
NODE_6005_length_1035_cov_7.020299	403	483	2	55	80	0.6875000
NODE_6006_length_1035_cov_4.726496	531	611	0	53	80	0.6625000
NODE_6006_length_1035_cov_4.726496	531	611	2	27	80	0.3375000
NODE_6006_length_1035_cov_4.726496	584	664	2	80	80	1.0000000
NODE_6018_length_1034_cov_26.810695	322	402	0	80	80	1.0000000
NODE_6018_length_1034_cov_26.810695	375	455	0	80	80	1.0000000
NODE_6018_length_1034_cov_26.810695	451	531	0	57	80	0.7125000
NODE_6018_length_1034_cov_26.810695	451	531	2	23	80	0.2875000
NODE_6018_length_1034_cov_26.810695	504	584	0	4	80	0.0500000
NODE_6018_length_1034_cov_26.810695	504	584	2	76	80	0.9500000
NODE_6032_length_1033_cov_42.574946	462	542	0	22	80	0.2750000
NODE_6032_length_1033_cov_42.574946	462	542	2	1	80	0.0125000
NODE_6032_length_1033_cov_42.574946	462	542	4	26	80	0.3250000
NODE_6032_length_1033_cov_42.574946	462	542	6	7	80	0.0875000
NODE_6032_length_1033_cov_42.574946	462	542	8	24	80	0.3000000
NODE_6032_length_1033_cov_42.574946	515	595	2	3	80	0.0375000
NODE_6032_length_1033_cov_42.574946	515	595	4	10	80	0.1250000
NODE_6032_length_1033_cov_42.574946	515	595	6	12	80	0.1500000
NODE_6032_length_1033_cov_42.574946	515	595	8	55	80	0.6875000
NODE_6033_length_1033_cov_17.073876	464	544	1	80	80	1.0000000
NODE_6033_length_1033_cov_17.073876	517	597	1	59	80	0.7375000
NODE_6033_length_1033_cov_17.073876	517	597	2	21	80	0.2625000
NODE_6034_length_1033_cov_15.791221	309	386	0	67	77	0.8701299
NODE_6034_length_1033_cov_15.791221	309	386	2	10	77	0.1298701
NODE_6034_length_1033_cov_15.791221	359	439	0	80	80	1.0000000
NODE_6035_length_1033_cov_11.340471	437	517	0	80	80	1.0000000
NODE_6035_length_1033_cov_11.340471	490	570	0	80	80	1.0000000
NODE_6045_length_1032_cov_56.511254	466	546	0	7	80	0.0875000
NODE_6045_length_1032_cov_56.511254	466	546	2	5	80	0.0625000
NODE_6045_length_1032_cov_56.511254	466	546	4	20	80	0.2500000
NODE_6045_length_1032_cov_56.511254	466	546	5	10	80	0.1250000
NODE_6045_length_1032_cov_56.511254	466	546	6	38	80	0.4750000
NODE_6045_length_1032_cov_56.511254	519	599	4	44	80	0.5500000
NODE_6045_length_1032_cov_56.511254	519	599	6	36	80	0.4500000
NODE_6046_length_1032_cov_20.752412	479	559	2	20	80	0.2500000
NODE_6046_length_1032_cov_20.752412	479	559	8	11	80	0.1375000
NODE_6046_length_1032_cov_20.752412	479	559	10	49	80	0.6125000
NODE_6046_length_1032_cov_20.752412	532	612	0	18	80	0.2250000
NODE_6046_length_1032_cov_20.752412	532	612	2	8	80	0.1000000
NODE_6046_length_1032_cov_20.752412	532	612	7	1	80	0.0125000
NODE_6046_length_1032_cov_20.752412	532	612	8	28	80	0.3500000
NODE_6046_length_1032_cov_20.752412	532	612	10	25	80	0.3125000
NODE_6047_length_1032_cov_8.166131	257	337	0	80	80	1.0000000
NODE_6047_length_1032_cov_8.166131	310	390	0	29	80	0.3625000
NODE_6047_length_1032_cov_8.166131	310	390	2	51	80	0.6375000
NODE_6048_length_1032_cov_7.991426	277	357	0	24	80	0.3000000
NODE_6048_length_1032_cov_7.991426	277	357	2	5	80	0.0625000
NODE_6048_length_1032_cov_7.991426	277	357	4	51	80	0.6375000
NODE_6048_length_1032_cov_7.991426	330	410	0	6	80	0.0750000
NODE_6048_length_1032_cov_7.991426	330	410	2	24	80	0.3000000
NODE_6048_length_1032_cov_7.991426	330	410	4	50	80	0.6250000
NODE_6049_length_1032_cov_5.276527	371	451	0	21	80	0.2625000
NODE_6049_length_1032_cov_5.276527	371	451	2	59	80	0.7375000
NODE_6049_length_1032_cov_5.276527	424	504	0	74	80	0.9250000
NODE_6049_length_1032_cov_5.276527	424	504	2	6	80	0.0750000
NODE_6055_length_1031_cov_71.154506	586	654	18	2	68	0.0294118
NODE_6055_length_1031_cov_71.154506	586	654	20	28	68	0.4117647
NODE_6055_length_1031_cov_71.154506	586	654	22	37	68	0.5441176
NODE_6055_length_1031_cov_71.154506	586	654	24	1	68	0.0147059
NODE_6055_length_1031_cov_71.154506	616	696	14	16	80	0.2000000
NODE_6055_length_1031_cov_71.154506	616	696	16	14	80	0.1750000
NODE_6055_length_1031_cov_71.154506	616	696	22	41	80	0.5125000
NODE_6055_length_1031_cov_71.154506	616	696	24	9	80	0.1125000
NODE_6055_length_1031_cov_71.154506	669	749	0	4	80	0.0500000
NODE_6055_length_1031_cov_71.154506	669	749	2	35	80	0.4375000
NODE_6055_length_1031_cov_71.154506	669	749	5	1	80	0.0125000
NODE_6055_length_1031_cov_71.154506	669	749	6	1	80	0.0125000
NODE_6055_length_1031_cov_71.154506	669	749	8	3	80	0.0375000
NODE_6055_length_1031_cov_71.154506	669	749	11	9	80	0.1125000
NODE_6055_length_1031_cov_71.154506	669	749	14	16	80	0.2000000
NODE_6055_length_1031_cov_71.154506	669	749	16	11	80	0.1375000
NODE_6056_length_1031_cov_70.221030	409	489	0	7	80	0.0875000
NODE_6056_length_1031_cov_70.221030	409	489	2	8	80	0.1000000
NODE_6056_length_1031_cov_70.221030	409	489	4	16	80	0.2000000
NODE_6056_length_1031_cov_70.221030	409	489	5	29	80	0.3625000
NODE_6056_length_1031_cov_70.221030	409	489	7	4	80	0.0500000
NODE_6056_length_1031_cov_70.221030	409	489	12	11	80	0.1375000
NODE_6056_length_1031_cov_70.221030	409	489	13	5	80	0.0625000
NODE_6056_length_1031_cov_70.221030	462	542	5	7	80	0.0875000
NODE_6056_length_1031_cov_70.221030	462	542	7	4	80	0.0500000
NODE_6056_length_1031_cov_70.221030	462	542	10	5	80	0.0625000
NODE_6056_length_1031_cov_70.221030	462	542	12	25	80	0.3125000
NODE_6056_length_1031_cov_70.221030	462	542	13	18	80	0.2250000
NODE_6056_length_1031_cov_70.221030	462	542	14	2	80	0.0250000
NODE_6056_length_1031_cov_70.221030	462	542	15	19	80	0.2375000
NODE_6056_length_1031_cov_70.221030	538	618	2	10	80	0.1250000
NODE_6056_length_1031_cov_70.221030	538	618	4	11	80	0.1375000
NODE_6056_length_1031_cov_70.221030	538	618	10	26	80	0.3250000
NODE_6056_length_1031_cov_70.221030	538	618	12	33	80	0.4125000
NODE_6056_length_1031_cov_70.221030	591	671	0	38	80	0.4750000
NODE_6056_length_1031_cov_70.221030	591	671	2	25	80	0.3125000
NODE_6056_length_1031_cov_70.221030	591	671	4	11	80	0.1375000
NODE_6056_length_1031_cov_70.221030	591	671	10	6	80	0.0750000
NODE_6057_length_1031_cov_43.618026	462	542	2	41	80	0.5125000
NODE_6057_length_1031_cov_43.618026	462	542	6	31	80	0.3875000
NODE_6057_length_1031_cov_43.618026	462	542	7	1	80	0.0125000
NODE_6057_length_1031_cov_43.618026	462	542	8	7	80	0.0875000
NODE_6057_length_1031_cov_43.618026	515	595	6	80	80	1.0000000
NODE_6058_length_1031_cov_43.581545	303	383	0	24	80	0.3000000
NODE_6058_length_1031_cov_43.581545	303	383	2	56	80	0.7000000
NODE_6058_length_1031_cov_43.581545	356	436	0	77	80	0.9625000
NODE_6058_length_1031_cov_43.581545	356	436	2	3	80	0.0375000
NODE_6058_length_1031_cov_43.581545	432	512	0	80	80	1.0000000
NODE_6058_length_1031_cov_43.581545	485	565	0	80	80	1.0000000
NODE_6059_length_1031_cov_22.310086	382	462	2	46	80	0.5750000
NODE_6059_length_1031_cov_22.310086	382	462	4	8	80	0.1000000
NODE_6059_length_1031_cov_22.310086	382	462	6	16	80	0.2000000
NODE_6059_length_1031_cov_22.310086	382	462	8	10	80	0.1250000
NODE_6059_length_1031_cov_22.310086	435	515	4	1	80	0.0125000
NODE_6059_length_1031_cov_22.310086	435	515	6	69	80	0.8625000
NODE_6059_length_1031_cov_22.310086	435	515	8	10	80	0.1250000
NODE_6060_length_1031_cov_11.547210	481	561	0	80	80	1.0000000
NODE_6060_length_1031_cov_11.547210	534	614	0	80	80	1.0000000
NODE_6066_length_1030_cov_54.380236	363	443	0	80	80	1.0000000
NODE_6066_length_1030_cov_54.380236	416	496	0	35	80	0.4375000
NODE_6066_length_1030_cov_54.380236	416	496	2	13	80	0.1625000
NODE_6066_length_1030_cov_54.380236	416	496	6	32	80	0.4000000
NODE_6066_length_1030_cov_54.380236	492	572	4	26	80	0.3250000
NODE_6066_length_1030_cov_54.380236	492	572	6	54	80	0.6750000
NODE_6066_length_1030_cov_54.380236	545	625	0	21	80	0.2625000
NODE_6066_length_1030_cov_54.380236	545	625	4	58	80	0.7250000
NODE_6066_length_1030_cov_54.380236	545	625	6	1	80	0.0125000
NODE_6067_length_1030_cov_45.040816	334	414	0	80	80	1.0000000
NODE_6067_length_1030_cov_45.040816	387	467	0	53	80	0.6625000
NODE_6067_length_1030_cov_45.040816	387	467	4	27	80	0.3375000
NODE_6067_length_1030_cov_45.040816	463	543	4	29	80	0.3625000
NODE_6067_length_1030_cov_45.040816	463	543	6	51	80	0.6375000
NODE_6067_length_1030_cov_45.040816	516	596	4	21	80	0.2625000
NODE_6067_length_1030_cov_45.040816	516	596	6	30	80	0.3750000
NODE_6067_length_1030_cov_45.040816	516	596	8	29	80	0.3625000
NODE_6068_length_1030_cov_20.491944	511	591	2	4	80	0.0500000
NODE_6068_length_1030_cov_20.491944	511	591	4	21	80	0.2625000
NODE_6068_length_1030_cov_20.491944	511	591	6	55	80	0.6875000
NODE_6068_length_1030_cov_20.491944	564	644	0	29	80	0.3625000
NODE_6068_length_1030_cov_20.491944	564	644	4	45	80	0.5625000
NODE_6068_length_1030_cov_20.491944	564	644	6	6	80	0.0750000
NODE_6069_length_1030_cov_17.253491	524	604	0	80	80	1.0000000
NODE_6069_length_1030_cov_17.253491	577	657	0	80	80	1.0000000
NODE_6070_length_1030_cov_14.337272	564	644	2	79	80	0.9875000
NODE_6070_length_1030_cov_14.337272	564	644	3	1	80	0.0125000
NODE_6070_length_1030_cov_14.337272	617	697	2	80	80	1.0000000
NODE_6071_length_1030_cov_5.742213	474	554	4	80	80	1.0000000
NODE_6071_length_1030_cov_5.742213	527	607	0	35	80	0.4375000
NODE_6071_length_1030_cov_5.742213	527	607	4	45	80	0.5625000
NODE_6073_length_1030_cov_5.208378	978	1030	0	23	52	0.4423077
NODE_6073_length_1030_cov_5.208378	978	1030	2	20	52	0.3846154
NODE_6073_length_1030_cov_5.208378	978	1030	4	5	52	0.0961538
NODE_6073_length_1030_cov_5.208378	978	1030	6	4	52	0.0769231
NODE_6077_length_1030_cov_2.146079	979	1010	0	31	31	1.0000000
NODE_6083_length_1029_cov_236.527957	584	666	30	9	82	0.1097561
NODE_6083_length_1029_cov_236.527957	584	666	40	1	82	0.0121951
NODE_6083_length_1029_cov_236.527957	584	666	42	10	82	0.1219512
NODE_6083_length_1029_cov_236.527957	584	666	45	7	82	0.0853659
NODE_6083_length_1029_cov_236.527957	584	666	47	1	82	0.0121951
NODE_6083_length_1029_cov_236.527957	584	666	49	3	82	0.0365854
NODE_6083_length_1029_cov_236.527957	584	666	51	2	82	0.0243902
NODE_6083_length_1029_cov_236.527957	584	666	52	4	82	0.0487805
NODE_6083_length_1029_cov_236.527957	584	666	53	15	82	0.1829268
NODE_6083_length_1029_cov_236.527957	584	666	54	3	82	0.0365854
NODE_6083_length_1029_cov_236.527957	584	666	55	4	82	0.0487805
NODE_6083_length_1029_cov_236.527957	584	666	56	11	82	0.1341463
NODE_6083_length_1029_cov_236.527957	584	666	57	1	82	0.0121951
NODE_6083_length_1029_cov_236.527957	584	666	58	9	82	0.1097561
NODE_6083_length_1029_cov_236.527957	584	666	59	1	82	0.0121951
NODE_6083_length_1029_cov_236.527957	584	666	60	1	82	0.0121951
NODE_6083_length_1029_cov_236.527957	639	702	29	6	63	0.0952381
NODE_6083_length_1029_cov_236.527957	639	702	33	9	63	0.1428571
NODE_6083_length_1029_cov_236.527957	639	702	35	4	63	0.0634921
NODE_6083_length_1029_cov_236.527957	639	702	37	1	63	0.0158730
NODE_6083_length_1029_cov_236.527957	639	702	39	3	63	0.0476190
NODE_6083_length_1029_cov_236.527957	639	702	41	1	63	0.0158730
NODE_6083_length_1029_cov_236.527957	639	702	43	1	63	0.0158730
NODE_6083_length_1029_cov_236.527957	639	702	45	4	63	0.0634921
NODE_6083_length_1029_cov_236.527957	639	702	47	2	63	0.0317460
NODE_6083_length_1029_cov_236.527957	639	702	49	8	63	0.1269841
NODE_6083_length_1029_cov_236.527957	639	702	51	1	63	0.0158730
NODE_6083_length_1029_cov_236.527957	639	702	53	15	63	0.2380952
NODE_6083_length_1029_cov_236.527957	639	702	55	4	63	0.0634921
NODE_6083_length_1029_cov_236.527957	639	702	57	1	63	0.0158730
NODE_6083_length_1029_cov_236.527957	639	702	58	1	63	0.0158730
NODE_6083_length_1029_cov_236.527957	639	702	59	1	63	0.0158730
NODE_6083_length_1029_cov_236.527957	639	702	60	1	63	0.0158730
NODE_6084_length_1029_cov_41.650538	364	444	0	80	80	1.0000000
NODE_6084_length_1029_cov_41.650538	417	497	0	80	80	1.0000000
NODE_6084_length_1029_cov_41.650538	493	573	0	80	80	1.0000000
NODE_6084_length_1029_cov_41.650538	546	626	0	80	80	1.0000000
NODE_6085_length_1029_cov_34.940860	314	360	0	46	46	1.0000000
NODE_6085_length_1029_cov_34.940860	371	451	0	80	80	1.0000000
NODE_6085_length_1029_cov_34.940860	424	502	0	66	78	0.8461539
NODE_6085_length_1029_cov_34.940860	424	502	1	4	78	0.0512821
NODE_6085_length_1029_cov_34.940860	424	502	2	8	78	0.1025641
NODE_6086_length_1029_cov_28.752688	255	335	0	80	80	1.0000000
NODE_6086_length_1029_cov_28.752688	308	388	0	80	80	1.0000000
NODE_6086_length_1029_cov_28.752688	384	464	0	71	80	0.8875000
NODE_6086_length_1029_cov_28.752688	384	464	2	9	80	0.1125000
NODE_6086_length_1029_cov_28.752688	437	517	0	18	80	0.2250000
NODE_6086_length_1029_cov_28.752688	437	517	2	62	80	0.7750000
NODE_6087_length_1029_cov_28.523656	409	489	4	41	80	0.5125000
NODE_6087_length_1029_cov_28.523656	409	489	6	20	80	0.2500000
NODE_6087_length_1029_cov_28.523656	409	489	8	19	80	0.2375000
NODE_6087_length_1029_cov_28.523656	462	542	2	26	80	0.3250000
NODE_6087_length_1029_cov_28.523656	462	542	4	37	80	0.4625000
NODE_6087_length_1029_cov_28.523656	462	542	8	17	80	0.2125000
NODE_6088_length_1029_cov_28.283871	281	361	0	54	80	0.6750000
NODE_6088_length_1029_cov_28.283871	281	361	4	26	80	0.3250000
NODE_6088_length_1029_cov_28.283871	334	414	0	1	80	0.0125000
NODE_6088_length_1029_cov_28.283871	334	414	4	79	80	0.9875000
NODE_6088_length_1029_cov_28.283871	410	490	0	27	80	0.3375000
NODE_6088_length_1029_cov_28.283871	410	490	2	2	80	0.0250000
NODE_6088_length_1029_cov_28.283871	410	490	4	42	80	0.5250000
NODE_6088_length_1029_cov_28.283871	410	490	8	9	80	0.1125000
NODE_6088_length_1029_cov_28.283871	463	546	4	18	83	0.2168675
NODE_6088_length_1029_cov_28.283871	463	546	8	65	83	0.7831326
NODE_6089_length_1029_cov_26.883871	434	514	2	6	80	0.0750000
NODE_6089_length_1029_cov_26.883871	434	514	4	44	80	0.5500000
NODE_6089_length_1029_cov_26.883871	434	514	6	30	80	0.3750000
NODE_6089_length_1029_cov_26.883871	487	567	0	24	80	0.3000000
NODE_6089_length_1029_cov_26.883871	487	567	2	35	80	0.4375000
NODE_6089_length_1029_cov_26.883871	487	567	4	10	80	0.1250000
NODE_6089_length_1029_cov_26.883871	487	567	6	11	80	0.1375000
NODE_6090_length_1029_cov_23.552688	305	385	0	46	80	0.5750000
NODE_6090_length_1029_cov_23.552688	305	385	2	34	80	0.4250000
NODE_6090_length_1029_cov_23.552688	358	438	0	1	80	0.0125000
NODE_6090_length_1029_cov_23.552688	358	438	2	79	80	0.9875000
NODE_6090_length_1029_cov_23.552688	434	514	0	77	80	0.9625000
NODE_6090_length_1029_cov_23.552688	434	514	2	3	80	0.0375000
NODE_6090_length_1029_cov_23.552688	487	567	0	49	80	0.6125000
NODE_6090_length_1029_cov_23.552688	487	567	2	31	80	0.3875000
NODE_6091_length_1029_cov_22.520430	434	514	10	2	80	0.0250000
NODE_6091_length_1029_cov_22.520430	434	514	13	4	80	0.0500000
NODE_6091_length_1029_cov_22.520430	434	514	16	11	80	0.1375000
NODE_6091_length_1029_cov_22.520430	434	514	18	63	80	0.7875000
NODE_6091_length_1029_cov_22.520430	487	567	0	6	80	0.0750000
NODE_6091_length_1029_cov_22.520430	487	567	3	11	80	0.1375000
NODE_6091_length_1029_cov_22.520430	487	567	5	25	80	0.3125000
NODE_6091_length_1029_cov_22.520430	487	567	8	5	80	0.0625000
NODE_6091_length_1029_cov_22.520430	487	567	10	8	80	0.1000000
NODE_6091_length_1029_cov_22.520430	487	567	13	4	80	0.0500000
NODE_6091_length_1029_cov_22.520430	487	567	16	11	80	0.1375000
NODE_6091_length_1029_cov_22.520430	487	567	18	10	80	0.1250000
NODE_6092_length_1029_cov_21.924731	335	415	0	32	80	0.4000000
NODE_6092_length_1029_cov_21.924731	335	415	1	48	80	0.6000000
NODE_6092_length_1029_cov_21.924731	388	468	1	80	80	1.0000000
NODE_6093_length_1029_cov_17.101075	501	581	2	46	80	0.5750000
NODE_6093_length_1029_cov_17.101075	501	581	4	34	80	0.4250000
NODE_6093_length_1029_cov_17.101075	554	634	0	28	80	0.3500000
NODE_6093_length_1029_cov_17.101075	554	634	2	52	80	0.6500000
NODE_6093_length_1029_cov_17.101075	630	710	0	30	80	0.3750000
NODE_6093_length_1029_cov_17.101075	630	710	2	50	80	0.6250000
NODE_6093_length_1029_cov_17.101075	683	755	2	72	72	1.0000000
NODE_6094_length_1029_cov_14.052688	405	485	0	26	80	0.3250000
NODE_6094_length_1029_cov_14.052688	405	485	2	20	80	0.2500000
NODE_6094_length_1029_cov_14.052688	405	485	4	34	80	0.4250000
NODE_6094_length_1029_cov_14.052688	458	538	0	2	80	0.0250000
NODE_6094_length_1029_cov_14.052688	458	538	2	24	80	0.3000000
NODE_6094_length_1029_cov_14.052688	458	538	4	54	80	0.6750000
NODE_6095_length_1029_cov_11.119355	291	369	6	24	78	0.3076923
NODE_6095_length_1029_cov_11.119355	291	369	8	1	78	0.0128205
NODE_6095_length_1029_cov_11.119355	291	369	10	22	78	0.2820513
NODE_6095_length_1029_cov_11.119355	291	369	18	6	78	0.0769231
NODE_6095_length_1029_cov_11.119355	291	369	20	25	78	0.3205128
NODE_6095_length_1029_cov_11.119355	342	422	10	11	80	0.1375000
NODE_6095_length_1029_cov_11.119355	342	422	12	13	80	0.1625000
NODE_6095_length_1029_cov_11.119355	342	422	16	6	80	0.0750000
NODE_6095_length_1029_cov_11.119355	342	422	18	29	80	0.3625000
NODE_6095_length_1029_cov_11.119355	342	422	20	21	80	0.2625000
NODE_6097_length_1029_cov_3.850538	231	311	0	80	80	1.0000000
NODE_6097_length_1029_cov_3.850538	284	364	0	80	80	1.0000000
NODE_6104_length_1028_cov_19.625404	495	575	0	80	80	1.0000000
NODE_6104_length_1028_cov_19.625404	548	628	0	80	80	1.0000000
NODE_6105_length_1028_cov_17.497309	533	613	0	80	80	1.0000000
NODE_6105_length_1028_cov_17.497309	586	666	0	47	80	0.5875000
NODE_6105_length_1028_cov_17.497309	586	666	2	33	80	0.4125000
NODE_6106_length_1028_cov_16.528525	497	577	0	59	80	0.7375000
NODE_6106_length_1028_cov_16.528525	497	577	2	21	80	0.2625000
NODE_6106_length_1028_cov_16.528525	550	630	0	6	80	0.0750000
NODE_6106_length_1028_cov_16.528525	550	630	2	74	80	0.9250000
NODE_6107_length_1028_cov_10.212056	463	543	0	36	80	0.4500000
NODE_6107_length_1028_cov_10.212056	463	543	2	44	80	0.5500000
NODE_6107_length_1028_cov_10.212056	516	596	0	1	80	0.0125000
NODE_6107_length_1028_cov_10.212056	516	596	2	79	80	0.9875000
NODE_6108_length_1028_cov_10.131324	399	479	0	80	80	1.0000000
NODE_6108_length_1028_cov_10.131324	452	532	0	80	80	1.0000000
NODE_6109_length_1028_cov_9.773950	482	562	0	80	80	1.0000000
NODE_6109_length_1028_cov_9.773950	535	615	0	80	80	1.0000000
NODE_6110_length_1028_cov_8.079656	399	479	0	45	80	0.5625000
NODE_6110_length_1028_cov_8.079656	399	479	2	35	80	0.4375000
NODE_6110_length_1028_cov_8.079656	452	532	0	80	80	1.0000000
NODE_6111_length_1028_cov_7.092573	439	519	0	47	80	0.5875000
NODE_6111_length_1028_cov_7.092573	439	519	2	33	80	0.4125000
NODE_6111_length_1028_cov_7.092573	492	572	2	80	80	1.0000000
NODE_6112_length_1028_cov_4.727664	416	488	0	72	72	1.0000000
NODE_6112_length_1028_cov_4.727664	461	541	0	80	80	1.0000000
NODE_6125_length_1027_cov_51.341595	399	479	0	80	80	1.0000000
NODE_6125_length_1027_cov_51.341595	452	532	0	80	80	1.0000000
NODE_6125_length_1027_cov_51.341595	528	608	0	38	80	0.4750000
NODE_6125_length_1027_cov_51.341595	528	608	2	42	80	0.5250000
NODE_6125_length_1027_cov_51.341595	581	661	2	80	80	1.0000000
NODE_6126_length_1027_cov_45.613147	347	427	0	74	80	0.9250000
NODE_6126_length_1027_cov_45.613147	347	427	2	6	80	0.0750000
NODE_6126_length_1027_cov_45.613147	400	480	0	21	80	0.2625000
NODE_6126_length_1027_cov_45.613147	400	480	2	45	80	0.5625000
NODE_6126_length_1027_cov_45.613147	400	480	6	14	80	0.1750000
NODE_6126_length_1027_cov_45.613147	476	556	4	3	80	0.0375000
NODE_6126_length_1027_cov_45.613147	476	556	6	77	80	0.9625000
NODE_6126_length_1027_cov_45.613147	529	609	0	42	80	0.5250000
NODE_6126_length_1027_cov_45.613147	529	609	2	5	80	0.0625000
NODE_6126_length_1027_cov_45.613147	529	609	4	9	80	0.1125000
NODE_6126_length_1027_cov_45.613147	529	609	6	24	80	0.3000000
NODE_6127_length_1027_cov_35.435345	431	511	19	3	80	0.0375000
NODE_6127_length_1027_cov_35.435345	431	511	20	4	80	0.0500000
NODE_6127_length_1027_cov_35.435345	431	511	22	19	80	0.2375000
NODE_6127_length_1027_cov_35.435345	431	511	26	7	80	0.0875000
NODE_6127_length_1027_cov_35.435345	431	511	28	2	80	0.0250000
NODE_6127_length_1027_cov_35.435345	431	511	30	1	80	0.0125000
NODE_6127_length_1027_cov_35.435345	431	511	31	13	80	0.1625000
NODE_6127_length_1027_cov_35.435345	431	511	33	9	80	0.1125000
NODE_6127_length_1027_cov_35.435345	431	511	34	2	80	0.0250000
NODE_6127_length_1027_cov_35.435345	431	511	35	20	80	0.2500000
NODE_6127_length_1027_cov_35.435345	484	564	6	2	80	0.0250000
NODE_6127_length_1027_cov_35.435345	484	564	10	4	80	0.0500000
NODE_6127_length_1027_cov_35.435345	484	564	19	7	80	0.0875000
NODE_6127_length_1027_cov_35.435345	484	564	22	1	80	0.0125000
NODE_6127_length_1027_cov_35.435345	484	564	23	6	80	0.0750000
NODE_6127_length_1027_cov_35.435345	484	564	30	1	80	0.0125000
NODE_6127_length_1027_cov_35.435345	484	564	31	45	80	0.5625000
NODE_6127_length_1027_cov_35.435345	484	564	33	9	80	0.1125000
NODE_6127_length_1027_cov_35.435345	484	564	35	5	80	0.0625000
NODE_6135_length_1026_cov_39.737864	374	454	0	80	80	1.0000000
NODE_6135_length_1026_cov_39.737864	427	509	0	82	82	1.0000000
NODE_6135_length_1026_cov_39.737864	505	585	0	80	80	1.0000000
NODE_6135_length_1026_cov_39.737864	558	638	0	80	80	1.0000000
NODE_6136_length_1026_cov_26.400216	423	503	4	28	80	0.3500000
NODE_6136_length_1026_cov_26.400216	423	503	6	52	80	0.6500000
NODE_6136_length_1026_cov_26.400216	476	556	0	41	80	0.5125000
NODE_6136_length_1026_cov_26.400216	476	556	4	39	80	0.4875000
NODE_6137_length_1026_cov_25.325782	477	557	2	80	80	1.0000000
NODE_6137_length_1026_cov_25.325782	530	610	0	24	80	0.3000000
NODE_6137_length_1026_cov_25.325782	530	610	1	13	80	0.1625000
NODE_6137_length_1026_cov_25.325782	530	610	2	43	80	0.5375000
NODE_6137_length_1026_cov_25.325782	606	686	0	6	80	0.0750000
NODE_6137_length_1026_cov_25.325782	606	686	2	74	80	0.9250000
NODE_6137_length_1026_cov_25.325782	659	739	0	41	80	0.5125000
NODE_6137_length_1026_cov_25.325782	659	739	2	39	80	0.4875000
NODE_6138_length_1026_cov_22.218986	408	488	2	31	80	0.3875000
NODE_6138_length_1026_cov_22.218986	408	488	4	49	80	0.6125000
NODE_6138_length_1026_cov_22.218986	461	541	0	4	80	0.0500000
NODE_6138_length_1026_cov_22.218986	461	541	2	76	80	0.9500000
NODE_6138_length_1026_cov_22.218986	537	617	0	80	80	1.0000000
NODE_6138_length_1026_cov_22.218986	590	670	0	80	80	1.0000000
NODE_6139_length_1026_cov_15.640777	450	530	2	80	80	1.0000000
NODE_6139_length_1026_cov_15.640777	503	583	0	35	80	0.4375000
NODE_6139_length_1026_cov_15.640777	503	583	2	45	80	0.5625000
NODE_6140_length_1026_cov_12.062567	165	245	0	69	80	0.8625000
NODE_6140_length_1026_cov_12.062567	165	245	3	11	80	0.1375000
NODE_6140_length_1026_cov_12.062567	218	298	0	16	80	0.2000000
NODE_6140_length_1026_cov_12.062567	218	298	3	13	80	0.1625000
NODE_6140_length_1026_cov_12.062567	218	298	5	18	80	0.2250000
NODE_6140_length_1026_cov_12.062567	218	298	8	33	80	0.4125000
NODE_6142_length_1026_cov_5.002157	335	415	0	80	80	1.0000000
NODE_6142_length_1026_cov_5.002157	388	468	0	80	80	1.0000000
NODE_6155_length_1025_cov_52.053996	366	446	0	39	80	0.4875000
NODE_6155_length_1025_cov_52.053996	366	446	2	22	80	0.2750000
NODE_6155_length_1025_cov_52.053996	366	446	4	19	80	0.2375000
NODE_6155_length_1025_cov_52.053996	419	499	0	8	80	0.1000000
NODE_6155_length_1025_cov_52.053996	419	499	4	72	80	0.9000000
NODE_6155_length_1025_cov_52.053996	495	575	2	47	80	0.5875000
NODE_6155_length_1025_cov_52.053996	495	575	4	14	80	0.1750000
NODE_6155_length_1025_cov_52.053996	495	575	5	12	80	0.1500000
NODE_6155_length_1025_cov_52.053996	495	575	6	7	80	0.0875000
NODE_6155_length_1025_cov_52.053996	548	628	0	42	80	0.5250000
NODE_6155_length_1025_cov_52.053996	548	628	2	38	80	0.4750000
NODE_6156_length_1025_cov_35.980562	318	375	2	57	57	1.0000000
NODE_6156_length_1025_cov_35.980562	348	428	2	54	80	0.6750000
NODE_6156_length_1025_cov_35.980562	348	428	4	8	80	0.1000000
NODE_6156_length_1025_cov_35.980562	348	428	6	2	80	0.0250000
NODE_6156_length_1025_cov_35.980562	348	428	7	1	80	0.0125000
NODE_6156_length_1025_cov_35.980562	348	428	8	15	80	0.1875000
NODE_6156_length_1025_cov_35.980562	425	482	6	39	57	0.6842105
NODE_6156_length_1025_cov_35.980562	425	482	7	16	57	0.2807018
NODE_6156_length_1025_cov_35.980562	425	482	8	2	57	0.0350877
NODE_6156_length_1025_cov_35.980562	455	521	0	2	66	0.0303030
NODE_6156_length_1025_cov_35.980562	455	521	2	16	66	0.2424242
NODE_6156_length_1025_cov_35.980562	455	521	4	1	66	0.0151515
NODE_6156_length_1025_cov_35.980562	455	521	6	47	66	0.7121212
NODE_6157_length_1025_cov_26.954644	607	687	0	46	80	0.5750000
NODE_6157_length_1025_cov_26.954644	607	687	2	34	80	0.4250000
NODE_6157_length_1025_cov_26.954644	660	740	2	80	80	1.0000000
NODE_6158_length_1025_cov_20.576674	428	508	4	80	80	1.0000000
NODE_6158_length_1025_cov_20.576674	481	561	0	43	80	0.5375000
NODE_6158_length_1025_cov_20.576674	481	561	4	37	80	0.4625000
NODE_6159_length_1025_cov_15.525918	415	495	4	42	80	0.5250000
NODE_6159_length_1025_cov_15.525918	415	495	5	38	80	0.4750000
NODE_6159_length_1025_cov_15.525918	468	548	5	80	80	1.0000000
NODE_6160_length_1025_cov_7.044276	240	320	0	80	80	1.0000000
NODE_6161_length_1025_cov_6.688985	334	414	0	80	80	1.0000000
NODE_6161_length_1025_cov_6.688985	387	467	0	80	80	1.0000000
NODE_6170_length_1024_cov_28.681081	264	344	0	80	80	1.0000000
NODE_6170_length_1024_cov_28.681081	317	397	0	80	80	1.0000000
NODE_6170_length_1024_cov_28.681081	393	477	0	84	84	1.0000000
NODE_6171_length_1024_cov_17.922162	324	404	0	14	80	0.1750000
NODE_6171_length_1024_cov_17.922162	324	404	2	4	80	0.0500000
NODE_6171_length_1024_cov_17.922162	324	404	4	26	80	0.3250000
NODE_6171_length_1024_cov_17.922162	324	404	6	36	80	0.4500000
NODE_6171_length_1024_cov_17.922162	377	457	0	21	80	0.2625000
NODE_6171_length_1024_cov_17.922162	377	457	4	58	80	0.7250000
NODE_6171_length_1024_cov_17.922162	377	457	6	1	80	0.0125000
NODE_6173_length_1024_cov_12.018378	368	448	5	29	80	0.3625000
NODE_6173_length_1024_cov_12.018378	368	448	6	9	80	0.1125000
NODE_6173_length_1024_cov_12.018378	368	448	7	18	80	0.2250000
NODE_6173_length_1024_cov_12.018378	368	448	8	1	80	0.0125000
NODE_6173_length_1024_cov_12.018378	368	448	10	2	80	0.0250000
NODE_6173_length_1024_cov_12.018378	368	448	11	1	80	0.0125000
NODE_6173_length_1024_cov_12.018378	368	448	12	8	80	0.1000000
NODE_6173_length_1024_cov_12.018378	368	448	13	12	80	0.1500000
NODE_6173_length_1024_cov_12.018378	421	501	4	30	80	0.3750000
NODE_6173_length_1024_cov_12.018378	421	501	7	3	80	0.0375000
NODE_6173_length_1024_cov_12.018378	421	501	8	1	80	0.0125000
NODE_6173_length_1024_cov_12.018378	421	501	10	2	80	0.0250000
NODE_6173_length_1024_cov_12.018378	421	501	11	1	80	0.0125000
NODE_6173_length_1024_cov_12.018378	421	501	12	8	80	0.1000000
NODE_6173_length_1024_cov_12.018378	421	501	13	35	80	0.4375000
NODE_6174_length_1024_cov_8.800000	517	597	2	80	80	1.0000000
NODE_6174_length_1024_cov_8.800000	570	650	0	14	80	0.1750000
NODE_6174_length_1024_cov_8.800000	570	650	2	66	80	0.8250000
NODE_6175_length_1024_cov_6.207568	318	398	0	80	80	1.0000000
NODE_6175_length_1024_cov_6.207568	371	451	0	80	80	1.0000000
NODE_6178_length_1024_cov_2.468108	274	324	0	50	50	1.0000000
NODE_6178_length_1024_cov_2.468108	274	322	0	48	48	1.0000000
NODE_6178_length_1024_cov_2.468108	274	324	0	50	50	1.0000000
NODE_6178_length_1024_cov_2.468108	274	323	0	49	49	1.0000000
NODE_6178_length_1024_cov_2.468108	274	322	0	48	48	1.0000000
NODE_6185_length_1023_cov_100.366883	441	521	9	5	80	0.0625000
NODE_6185_length_1023_cov_100.366883	441	521	10	26	80	0.3250000
NODE_6185_length_1023_cov_100.366883	441	521	12	31	80	0.3875000
NODE_6185_length_1023_cov_100.366883	441	521	14	18	80	0.2250000
NODE_6185_length_1023_cov_100.366883	494	574	2	32	80	0.4000000
NODE_6185_length_1023_cov_100.366883	494	574	4	6	80	0.0750000
NODE_6185_length_1023_cov_100.366883	494	574	9	20	80	0.2500000
NODE_6185_length_1023_cov_100.366883	494	574	12	4	80	0.0500000
NODE_6185_length_1023_cov_100.366883	494	574	14	18	80	0.2250000
NODE_6186_length_1023_cov_64.271645	349	429	0	80	80	1.0000000
NODE_6186_length_1023_cov_64.271645	402	482	0	80	80	1.0000000
NODE_6186_length_1023_cov_64.271645	478	558	0	12	80	0.1500000
NODE_6186_length_1023_cov_64.271645	478	558	2	23	80	0.2875000
NODE_6186_length_1023_cov_64.271645	478	558	4	36	80	0.4500000
NODE_6186_length_1023_cov_64.271645	478	558	6	9	80	0.1125000
NODE_6186_length_1023_cov_64.271645	531	611	4	51	80	0.6375000
NODE_6186_length_1023_cov_64.271645	531	611	6	29	80	0.3625000
NODE_6187_length_1023_cov_32.695887	318	398	0	80	80	1.0000000
NODE_6187_length_1023_cov_32.695887	371	451	0	80	80	1.0000000
NODE_6187_length_1023_cov_32.695887	447	527	0	80	80	1.0000000
NODE_6187_length_1023_cov_32.695887	500	580	0	80	80	1.0000000
NODE_6188_length_1023_cov_16.244589	601	681	0	15	80	0.1875000
NODE_6188_length_1023_cov_16.244589	601	681	2	5	80	0.0625000
NODE_6188_length_1023_cov_16.244589	601	681	4	10	80	0.1250000
NODE_6188_length_1023_cov_16.244589	601	681	6	6	80	0.0750000
NODE_6188_length_1023_cov_16.244589	601	681	8	44	80	0.5500000
NODE_6188_length_1023_cov_16.244589	654	734	0	5	80	0.0625000
NODE_6188_length_1023_cov_16.244589	654	734	2	9	80	0.1125000
NODE_6188_length_1023_cov_16.244589	654	734	4	9	80	0.1125000
NODE_6188_length_1023_cov_16.244589	654	734	8	57	80	0.7125000
NODE_6189_length_1023_cov_15.876623	371	451	1	80	80	1.0000000
NODE_6189_length_1023_cov_15.876623	424	504	0	25	80	0.3125000
NODE_6189_length_1023_cov_15.876623	424	504	1	55	80	0.6875000
NODE_6189_length_1023_cov_15.876623	500	580	0	35	80	0.4375000
NODE_6189_length_1023_cov_15.876623	500	580	4	4	80	0.0500000
NODE_6189_length_1023_cov_15.876623	500	580	6	41	80	0.5125000
NODE_6189_length_1023_cov_15.876623	553	633	3	1	80	0.0125000
NODE_6189_length_1023_cov_15.876623	553	633	4	14	80	0.1750000
NODE_6189_length_1023_cov_15.876623	553	633	6	41	80	0.5125000
NODE_6189_length_1023_cov_15.876623	553	633	7	24	80	0.3000000
NODE_6190_length_1023_cov_14.678571	555	635	0	57	80	0.7125000
NODE_6190_length_1023_cov_14.678571	555	635	2	15	80	0.1875000
NODE_6190_length_1023_cov_14.678571	555	635	4	8	80	0.1000000
NODE_6190_length_1023_cov_14.678571	608	688	0	4	80	0.0500000
NODE_6190_length_1023_cov_14.678571	608	688	2	17	80	0.2125000
NODE_6190_length_1023_cov_14.678571	608	688	4	59	80	0.7375000
NODE_6191_length_1023_cov_14.443723	406	486	0	73	80	0.9125000
NODE_6191_length_1023_cov_14.443723	406	486	2	7	80	0.0875000
NODE_6191_length_1023_cov_14.443723	459	539	0	20	80	0.2500000
NODE_6191_length_1023_cov_14.443723	459	539	2	60	80	0.7500000
NODE_6192_length_1023_cov_10.984848	590	670	2	80	80	1.0000000
NODE_6192_length_1023_cov_10.984848	643	723	0	25	80	0.3125000
NODE_6192_length_1023_cov_10.984848	643	723	1	2	80	0.0250000
NODE_6192_length_1023_cov_10.984848	643	723	2	53	80	0.6625000
NODE_6202_length_1022_cov_42.952329	555	636	0	10	81	0.1234568
NODE_6202_length_1022_cov_42.952329	555	636	4	50	81	0.6172839
NODE_6202_length_1022_cov_42.952329	555	636	5	1	81	0.0123457
NODE_6202_length_1022_cov_42.952329	555	636	6	20	81	0.2469136
NODE_6202_length_1022_cov_42.952329	609	689	4	12	80	0.1500000
NODE_6202_length_1022_cov_42.952329	609	689	5	1	80	0.0125000
NODE_6202_length_1022_cov_42.952329	609	689	6	46	80	0.5750000
NODE_6202_length_1022_cov_42.952329	609	689	8	21	80	0.2625000
NODE_6202_length_1022_cov_42.952329	685	765	4	80	80	1.0000000
NODE_6202_length_1022_cov_42.952329	738	818	0	16	80	0.2000000
NODE_6202_length_1022_cov_42.952329	738	818	2	36	80	0.4500000
NODE_6202_length_1022_cov_42.952329	738	818	3	1	80	0.0125000
NODE_6202_length_1022_cov_42.952329	738	818	4	27	80	0.3375000
NODE_6203_length_1022_cov_29.949079	510	590	0	32	80	0.4000000
NODE_6203_length_1022_cov_29.949079	510	590	4	10	80	0.1250000
NODE_6203_length_1022_cov_29.949079	510	590	6	38	80	0.4750000
NODE_6203_length_1022_cov_29.949079	563	643	0	35	80	0.4375000
NODE_6203_length_1022_cov_29.949079	563	643	2	3	80	0.0375000
NODE_6203_length_1022_cov_29.949079	563	643	6	42	80	0.5250000
NODE_6204_length_1022_cov_7.672806	461	541	0	80	80	1.0000000
NODE_6204_length_1022_cov_7.672806	514	594	0	80	80	1.0000000
NODE_6213_length_1021_cov_47.379610	341	421	2	68	80	0.8500000
NODE_6213_length_1021_cov_47.379610	341	421	4	12	80	0.1500000
NODE_6213_length_1021_cov_47.379610	394	474	2	72	80	0.9000000
NODE_6213_length_1021_cov_47.379610	394	474	4	8	80	0.1000000
NODE_6213_length_1021_cov_47.379610	470	550	0	16	80	0.2000000
NODE_6213_length_1021_cov_47.379610	470	550	1	1	80	0.0125000
NODE_6213_length_1021_cov_47.379610	470	550	2	63	80	0.7875000
NODE_6213_length_1021_cov_47.379610	523	603	0	69	80	0.8625000
NODE_6213_length_1021_cov_47.379610	523	603	1	1	80	0.0125000
NODE_6213_length_1021_cov_47.379610	523	603	2	10	80	0.1250000
NODE_6214_length_1021_cov_33.255965	588	668	0	10	80	0.1250000
NODE_6214_length_1021_cov_33.255965	588	668	1	1	80	0.0125000
NODE_6214_length_1021_cov_33.255965	588	668	2	3	80	0.0375000
NODE_6214_length_1021_cov_33.255965	588	668	3	11	80	0.1375000
NODE_6214_length_1021_cov_33.255965	588	668	4	55	80	0.6875000
NODE_6214_length_1021_cov_33.255965	641	721	0	63	80	0.7875000
NODE_6214_length_1021_cov_33.255965	641	721	1	1	80	0.0125000
NODE_6214_length_1021_cov_33.255965	641	721	2	3	80	0.0375000
NODE_6214_length_1021_cov_33.255965	641	721	3	11	80	0.1375000
NODE_6214_length_1021_cov_33.255965	641	721	4	2	80	0.0250000
NODE_6227_length_1020_cov_24.565689	485	565	0	80	80	1.0000000
NODE_6227_length_1020_cov_24.565689	538	618	0	80	80	1.0000000
NODE_6228_length_1020_cov_20.825190	395	475	2	22	80	0.2750000
NODE_6228_length_1020_cov_20.825190	395	475	4	58	80	0.7250000
NODE_6228_length_1020_cov_20.825190	448	528	0	17	80	0.2125000
NODE_6228_length_1020_cov_20.825190	448	528	2	42	80	0.5250000
NODE_6228_length_1020_cov_20.825190	448	528	4	21	80	0.2625000
NODE_6229_length_1020_cov_20.305103	285	365	0	18	80	0.2250000
NODE_6229_length_1020_cov_20.305103	285	365	2	62	80	0.7750000
NODE_6229_length_1020_cov_20.305103	338	418	2	80	80	1.0000000
NODE_6229_length_1020_cov_20.305103	414	494	0	9	80	0.1125000
NODE_6229_length_1020_cov_20.305103	414	494	2	50	80	0.6250000
NODE_6229_length_1020_cov_20.305103	414	494	4	21	80	0.2625000
NODE_6229_length_1020_cov_20.305103	467	548	2	6	81	0.0740741
NODE_6229_length_1020_cov_20.305103	467	548	4	75	81	0.9259259
NODE_6230_length_1020_cov_17.919653	408	488	0	6	80	0.0750000
NODE_6230_length_1020_cov_17.919653	408	488	2	40	80	0.5000000
NODE_6230_length_1020_cov_17.919653	408	488	4	9	80	0.1125000
NODE_6230_length_1020_cov_17.919653	408	488	6	25	80	0.3125000
NODE_6230_length_1020_cov_17.919653	461	541	2	14	80	0.1750000
NODE_6230_length_1020_cov_17.919653	461	541	4	17	80	0.2125000
NODE_6230_length_1020_cov_17.919653	461	541	6	49	80	0.6125000
NODE_6231_length_1020_cov_13.972856	436	516	0	14	80	0.1750000
NODE_6231_length_1020_cov_13.972856	436	516	2	66	80	0.8250000
NODE_6231_length_1020_cov_13.972856	489	569	0	65	80	0.8125000
NODE_6231_length_1020_cov_13.972856	489	569	2	15	80	0.1875000
NODE_6232_length_1020_cov_10.472313	407	487	0	43	80	0.5375000
NODE_6232_length_1020_cov_10.472313	407	487	2	37	80	0.4625000
NODE_6232_length_1020_cov_10.472313	460	540	2	47	80	0.5875000
NODE_6232_length_1020_cov_10.472313	460	540	4	33	80	0.4125000
NODE_6235_length_1020_cov_3.707926	821	901	2	7	80	0.0875000
NODE_6235_length_1020_cov_3.707926	821	901	4	24	80	0.3000000
NODE_6235_length_1020_cov_3.707926	821	901	6	49	80	0.6125000
NODE_6235_length_1020_cov_3.707926	874	954	0	9	80	0.1125000
NODE_6235_length_1020_cov_3.707926	874	954	2	30	80	0.3750000
NODE_6235_length_1020_cov_3.707926	874	954	4	10	80	0.1250000
NODE_6235_length_1020_cov_3.707926	874	954	6	31	80	0.3875000
NODE_6238_length_1020_cov_2.648208	0	70	0	70	70	1.0000000
NODE_6238_length_1020_cov_2.648208	43	88	0	45	45	1.0000000
NODE_6248_length_1019_cov_30.164130	476	556	4	23	80	0.2875000
NODE_6248_length_1019_cov_30.164130	476	556	6	11	80	0.1375000
NODE_6248_length_1019_cov_30.164130	476	556	8	33	80	0.4125000
NODE_6248_length_1019_cov_30.164130	476	556	10	13	80	0.1625000
NODE_6248_length_1019_cov_30.164130	529	609	2	4	80	0.0500000
NODE_6248_length_1019_cov_30.164130	529	609	4	14	80	0.1750000
NODE_6248_length_1019_cov_30.164130	529	609	6	8	80	0.1000000
NODE_6248_length_1019_cov_30.164130	529	609	8	43	80	0.5375000
NODE_6248_length_1019_cov_30.164130	529	609	10	11	80	0.1375000
NODE_6248_length_1019_cov_30.164130	605	685	0	58	80	0.7250000
NODE_6248_length_1019_cov_30.164130	605	685	2	22	80	0.2750000
NODE_6248_length_1019_cov_30.164130	658	738	0	17	80	0.2125000
NODE_6248_length_1019_cov_30.164130	658	738	2	63	80	0.7875000
NODE_6249_length_1019_cov_22.845652	343	423	0	80	80	1.0000000
NODE_6249_length_1019_cov_22.845652	396	476	0	80	80	1.0000000
NODE_6249_length_1019_cov_22.845652	472	552	0	80	80	1.0000000
NODE_6249_length_1019_cov_22.845652	525	605	0	80	80	1.0000000
NODE_6250_length_1019_cov_8.098913	523	601	0	7	78	0.0897436
NODE_6250_length_1019_cov_8.098913	523	601	2	24	78	0.3076923
NODE_6250_length_1019_cov_8.098913	523	601	4	47	78	0.6025641
NODE_6250_length_1019_cov_8.098913	574	654	4	80	80	1.0000000
NODE_6251_length_1019_cov_7.896739	423	503	0	80	80	1.0000000
NODE_6251_length_1019_cov_7.896739	476	556	0	80	80	1.0000000
NODE_6252_length_1019_cov_4.597826	625	696	9	13	71	0.1830986
NODE_6252_length_1019_cov_4.597826	625	696	10	3	71	0.0422535
NODE_6252_length_1019_cov_4.597826	625	696	13	14	71	0.1971831
NODE_6252_length_1019_cov_4.597826	625	696	14	1	71	0.0140845
NODE_6252_length_1019_cov_4.597826	625	696	16	1	71	0.0140845
NODE_6252_length_1019_cov_4.597826	625	696	18	35	71	0.4929577
NODE_6252_length_1019_cov_4.597826	625	696	20	4	71	0.0563380
NODE_6263_length_1019_cov_1.139130	89	165	4	7	76	0.0921053
NODE_6263_length_1019_cov_1.139130	89	165	6	2	76	0.0263158
NODE_6263_length_1019_cov_1.139130	89	165	7	1	76	0.0131579
NODE_6263_length_1019_cov_1.139130	89	165	8	60	76	0.7894737
NODE_6263_length_1019_cov_1.139130	89	165	10	6	76	0.0789474
NODE_6265_length_1018_cov_33.494015	212	292	4	9	80	0.1125000
NODE_6265_length_1018_cov_33.494015	212	292	8	3	80	0.0375000
NODE_6265_length_1018_cov_33.494015	212	292	10	16	80	0.2000000
NODE_6265_length_1018_cov_33.494015	212	292	12	38	80	0.4750000
NODE_6265_length_1018_cov_33.494015	212	292	14	14	80	0.1750000
NODE_6265_length_1018_cov_33.494015	265	345	0	13	80	0.1625000
NODE_6265_length_1018_cov_33.494015	265	345	2	25	80	0.3125000
NODE_6265_length_1018_cov_33.494015	265	345	4	24	80	0.3000000
NODE_6265_length_1018_cov_33.494015	265	345	8	3	80	0.0375000
NODE_6265_length_1018_cov_33.494015	265	345	10	15	80	0.1875000
NODE_6266_length_1018_cov_22.776931	372	452	0	80	80	1.0000000
NODE_6266_length_1018_cov_22.776931	425	505	0	80	80	1.0000000
NODE_6268_length_1018_cov_8.486398	404	484	0	22	80	0.2750000
NODE_6268_length_1018_cov_8.486398	404	484	2	58	80	0.7250000
NODE_6268_length_1018_cov_8.486398	457	537	0	75	80	0.9375000
NODE_6268_length_1018_cov_8.486398	457	537	2	5	80	0.0625000
NODE_6270_length_1018_cov_7.737758	357	437	0	80	80	1.0000000
NODE_6270_length_1018_cov_7.737758	410	490	0	80	80	1.0000000
NODE_6286_length_1017_cov_207.523965	0	41	4	6	41	0.1463415
NODE_6286_length_1017_cov_207.523965	0	41	6	8	41	0.1951219
NODE_6286_length_1017_cov_207.523965	0	41	8	4	41	0.0975610
NODE_6286_length_1017_cov_207.523965	0	41	12	10	41	0.2439024
NODE_6286_length_1017_cov_207.523965	0	41	16	2	41	0.0487805
NODE_6286_length_1017_cov_207.523965	0	41	18	3	41	0.0731707
NODE_6286_length_1017_cov_207.523965	0	41	20	6	41	0.1463415
NODE_6286_length_1017_cov_207.523965	0	41	22	1	41	0.0243902
NODE_6286_length_1017_cov_207.523965	0	41	26	1	41	0.0243902
NODE_6286_length_1017_cov_207.523965	14	94	8	4	80	0.0500000
NODE_6286_length_1017_cov_207.523965	14	94	12	10	80	0.1250000
NODE_6286_length_1017_cov_207.523965	14	94	16	2	80	0.0250000
NODE_6286_length_1017_cov_207.523965	14	94	18	3	80	0.0375000
NODE_6286_length_1017_cov_207.523965	14	94	20	6	80	0.0750000
NODE_6286_length_1017_cov_207.523965	14	94	22	1	80	0.0125000
NODE_6286_length_1017_cov_207.523965	14	94	26	1	80	0.0125000
NODE_6286_length_1017_cov_207.523965	14	94	30	2	80	0.0250000
NODE_6286_length_1017_cov_207.523965	14	94	32	8	80	0.1000000
NODE_6286_length_1017_cov_207.523965	14	94	34	16	80	0.2000000
NODE_6286_length_1017_cov_207.523965	14	94	36	9	80	0.1125000
NODE_6286_length_1017_cov_207.523965	14	94	38	8	80	0.1000000
NODE_6286_length_1017_cov_207.523965	14	94	40	6	80	0.0750000
NODE_6286_length_1017_cov_207.523965	14	94	42	4	80	0.0500000
NODE_6287_length_1017_cov_18.824619	490	570	2	44	80	0.5500000
NODE_6287_length_1017_cov_18.824619	490	570	4	36	80	0.4500000
NODE_6287_length_1017_cov_18.824619	543	623	2	64	80	0.8000000
NODE_6287_length_1017_cov_18.824619	543	623	4	16	80	0.2000000
NODE_6288_length_1017_cov_14.794118	428	508	0	80	80	1.0000000
NODE_6288_length_1017_cov_14.794118	481	561	0	80	80	1.0000000
NODE_6288_length_1017_cov_14.794118	557	637	0	80	80	1.0000000
NODE_6288_length_1017_cov_14.794118	610	690	0	80	80	1.0000000
NODE_6297_length_1016_cov_22.267176	577	657	0	33	80	0.4125000
NODE_6297_length_1016_cov_22.267176	577	657	2	47	80	0.5875000
NODE_6297_length_1016_cov_22.267176	630	710	2	80	80	1.0000000
NODE_6298_length_1016_cov_21.134133	625	705	2	16	80	0.2000000
NODE_6298_length_1016_cov_21.134133	625	705	4	64	80	0.8000000
NODE_6298_length_1016_cov_21.134133	678	758	0	51	80	0.6375000
NODE_6298_length_1016_cov_21.134133	678	758	2	18	80	0.2250000
NODE_6298_length_1016_cov_21.134133	678	758	4	11	80	0.1375000
NODE_6299_length_1016_cov_20.392585	504	584	0	80	80	1.0000000
NODE_6299_length_1016_cov_20.392585	557	637	0	80	80	1.0000000
NODE_6299_length_1016_cov_20.392585	633	713	0	20	80	0.2500000
NODE_6299_length_1016_cov_20.392585	633	713	6	60	80	0.7500000
NODE_6299_length_1016_cov_20.392585	686	766	6	80	80	1.0000000
NODE_6300_length_1016_cov_16.917121	524	604	2	80	80	1.0000000
NODE_6300_length_1016_cov_16.917121	577	657	0	50	80	0.6250000
NODE_6300_length_1016_cov_16.917121	577	657	2	30	80	0.3750000
NODE_6301_length_1016_cov_8.243184	438	518	0	80	80	1.0000000
NODE_6301_length_1016_cov_8.243184	491	571	0	80	80	1.0000000
NODE_6301_length_1016_cov_8.243184	567	647	0	80	80	1.0000000
NODE_6301_length_1016_cov_8.243184	620	700	0	80	80	1.0000000
NODE_6302_length_1016_cov_8.141767	166	256	8	4	90	0.0444444
NODE_6302_length_1016_cov_8.141767	166	256	10	8	90	0.0888889
NODE_6302_length_1016_cov_8.141767	166	256	16	9	90	0.1000000
NODE_6302_length_1016_cov_8.141767	166	256	18	9	90	0.1000000
NODE_6302_length_1016_cov_8.141767	166	256	20	23	90	0.2555556
NODE_6302_length_1016_cov_8.141767	166	256	22	36	90	0.4000000
NODE_6302_length_1016_cov_8.141767	166	256	24	1	90	0.0111111
NODE_6303_length_1016_cov_7.466739	576	656	0	80	80	1.0000000
NODE_6303_length_1016_cov_7.466739	629	709	0	80	80	1.0000000
NODE_6318_length_1015_cov_24.680131	459	539	0	19	80	0.2375000
NODE_6318_length_1015_cov_24.680131	459	539	2	61	80	0.7625000
NODE_6318_length_1015_cov_24.680131	512	592	0	27	80	0.3375000
NODE_6318_length_1015_cov_24.680131	512	592	2	53	80	0.6625000
NODE_6318_length_1015_cov_24.680131	588	668	0	31	80	0.3875000
NODE_6318_length_1015_cov_24.680131	588	668	2	49	80	0.6125000
NODE_6318_length_1015_cov_24.680131	641	721	0	26	80	0.3250000
NODE_6318_length_1015_cov_24.680131	641	721	2	54	80	0.6750000
NODE_6319_length_1015_cov_23.198690	407	487	0	34	80	0.4250000
NODE_6319_length_1015_cov_23.198690	407	487	2	46	80	0.5750000
NODE_6319_length_1015_cov_23.198690	460	540	0	45	80	0.5625000
NODE_6319_length_1015_cov_23.198690	460	540	2	35	80	0.4375000
NODE_6319_length_1015_cov_23.198690	536	616	0	80	80	1.0000000
NODE_6319_length_1015_cov_23.198690	589	669	0	80	80	1.0000000
NODE_6320_length_1015_cov_22.544760	490	570	2	80	80	1.0000000
NODE_6320_length_1015_cov_22.544760	543	623	0	46	80	0.5750000
NODE_6320_length_1015_cov_22.544760	543	623	2	34	80	0.4250000
NODE_6321_length_1015_cov_17.994541	510	590	1	27	80	0.3375000
NODE_6321_length_1015_cov_17.994541	510	590	4	5	80	0.0625000
NODE_6321_length_1015_cov_17.994541	510	590	6	2	80	0.0250000
NODE_6321_length_1015_cov_17.994541	510	590	7	34	80	0.4250000
NODE_6321_length_1015_cov_17.994541	510	590	8	12	80	0.1500000
NODE_6321_length_1015_cov_17.994541	563	643	1	1	80	0.0125000
NODE_6321_length_1015_cov_17.994541	563	643	2	2	80	0.0250000
NODE_6321_length_1015_cov_17.994541	563	643	4	5	80	0.0625000
NODE_6321_length_1015_cov_17.994541	563	643	7	15	80	0.1875000
NODE_6321_length_1015_cov_17.994541	563	643	8	57	80	0.7125000
NODE_6322_length_1015_cov_16.594978	437	517	4	2	80	0.0250000
NODE_6322_length_1015_cov_16.594978	437	517	6	42	80	0.5250000
NODE_6322_length_1015_cov_16.594978	437	517	8	20	80	0.2500000
NODE_6322_length_1015_cov_16.594978	437	517	9	1	80	0.0125000
NODE_6322_length_1015_cov_16.594978	437	517	10	15	80	0.1875000
NODE_6322_length_1015_cov_16.594978	490	570	4	55	80	0.6875000
NODE_6322_length_1015_cov_16.594978	490	570	6	9	80	0.1125000
NODE_6322_length_1015_cov_16.594978	490	570	9	1	80	0.0125000
NODE_6322_length_1015_cov_16.594978	490	570	10	15	80	0.1875000
NODE_6323_length_1015_cov_14.000000	505	585	0	80	80	1.0000000
NODE_6323_length_1015_cov_14.000000	558	638	0	80	80	1.0000000
NODE_6324_length_1015_cov_9.978166	345	425	0	80	80	1.0000000
NODE_6324_length_1015_cov_9.978166	398	478	0	80	80	1.0000000
NODE_6325_length_1015_cov_6.844978	393	473	2	24	80	0.3000000
NODE_6325_length_1015_cov_6.844978	393	473	3	9	80	0.1125000
NODE_6325_length_1015_cov_6.844978	393	473	4	37	80	0.4625000
NODE_6325_length_1015_cov_6.844978	393	473	6	10	80	0.1250000
NODE_6325_length_1015_cov_6.844978	446	526	2	3	80	0.0375000
NODE_6325_length_1015_cov_6.844978	446	526	4	76	80	0.9500000
NODE_6325_length_1015_cov_6.844978	446	526	6	1	80	0.0125000
NODE_6337_length_1014_cov_95.709290	259	335	0	76	76	1.0000000
NODE_6337_length_1014_cov_95.709290	310	390	0	50	80	0.6250000
NODE_6337_length_1014_cov_95.709290	310	390	1	30	80	0.3750000
NODE_6337_length_1014_cov_95.709290	386	466	1	15	80	0.1875000
NODE_6337_length_1014_cov_95.709290	386	466	2	25	80	0.3125000
NODE_6337_length_1014_cov_95.709290	386	466	4	40	80	0.5000000
NODE_6337_length_1014_cov_95.709290	439	519	1	9	80	0.1125000
NODE_6337_length_1014_cov_95.709290	439	519	2	18	80	0.2250000
NODE_6337_length_1014_cov_95.709290	439	519	4	53	80	0.6625000
NODE_6338_length_1014_cov_67.918033	182	262	0	19	80	0.2375000
NODE_6338_length_1014_cov_67.918033	182	262	6	18	80	0.2250000
NODE_6338_length_1014_cov_67.918033	182	262	10	43	80	0.5375000
NODE_6338_length_1014_cov_67.918033	235	315	0	6	80	0.0750000
NODE_6338_length_1014_cov_67.918033	235	315	6	19	80	0.2375000
NODE_6338_length_1014_cov_67.918033	235	315	10	55	80	0.6875000
NODE_6338_length_1014_cov_67.918033	311	391	0	40	80	0.5000000
NODE_6338_length_1014_cov_67.918033	311	391	2	40	80	0.5000000
NODE_6338_length_1014_cov_67.918033	364	444	2	80	80	1.0000000
NODE_6339_length_1014_cov_44.802186	418	498	0	45	80	0.5625000
NODE_6339_length_1014_cov_44.802186	418	498	2	35	80	0.4375000
NODE_6339_length_1014_cov_44.802186	471	551	2	80	80	1.0000000
NODE_6340_length_1014_cov_36.349727	369	449	0	80	80	1.0000000
NODE_6340_length_1014_cov_36.349727	422	502	0	78	80	0.9750000
NODE_6340_length_1014_cov_36.349727	422	502	2	2	80	0.0250000
NODE_6340_length_1014_cov_36.349727	498	578	0	2	80	0.0250000
NODE_6340_length_1014_cov_36.349727	498	578	2	32	80	0.4000000
NODE_6340_length_1014_cov_36.349727	498	578	4	46	80	0.5750000
NODE_6340_length_1014_cov_36.349727	551	631	0	21	80	0.2625000
NODE_6340_length_1014_cov_36.349727	551	631	2	37	80	0.4625000
NODE_6340_length_1014_cov_36.349727	551	631	4	22	80	0.2750000
NODE_6341_length_1014_cov_35.547541	363	441	0	78	78	1.0000000
NODE_6341_length_1014_cov_35.547541	416	494	0	78	78	1.0000000
NODE_6342_length_1014_cov_32.266667	428	508	0	21	80	0.2625000
NODE_6342_length_1014_cov_32.266667	428	508	2	59	80	0.7375000
NODE_6342_length_1014_cov_32.266667	481	561	0	74	80	0.9250000
NODE_6342_length_1014_cov_32.266667	481	561	2	6	80	0.0750000
NODE_6343_length_1014_cov_28.493989	480	560	0	24	80	0.3000000
NODE_6343_length_1014_cov_28.493989	480	560	2	56	80	0.7000000
NODE_6343_length_1014_cov_28.493989	533	613	0	12	80	0.1500000
NODE_6343_length_1014_cov_28.493989	533	613	2	68	80	0.8500000
NODE_6343_length_1014_cov_28.493989	609	689	2	29	80	0.3625000
NODE_6343_length_1014_cov_28.493989	609	689	4	51	80	0.6375000
NODE_6343_length_1014_cov_28.493989	662	742	0	27	80	0.3375000
NODE_6343_length_1014_cov_28.493989	662	742	2	4	80	0.0500000
NODE_6343_length_1014_cov_28.493989	662	742	4	49	80	0.6125000
NODE_6344_length_1014_cov_25.171585	500	580	2	10	80	0.1250000
NODE_6344_length_1014_cov_25.171585	500	580	4	67	80	0.8375000
NODE_6344_length_1014_cov_25.171585	500	580	6	3	80	0.0375000
NODE_6344_length_1014_cov_25.171585	553	633	0	29	80	0.3625000
NODE_6344_length_1014_cov_25.171585	553	633	2	34	80	0.4250000
NODE_6344_length_1014_cov_25.171585	553	633	4	17	80	0.2125000
NODE_6345_length_1014_cov_22.437158	534	614	0	9	80	0.1125000
NODE_6345_length_1014_cov_22.437158	534	614	2	3	80	0.0375000
NODE_6345_length_1014_cov_22.437158	534	614	6	22	80	0.2750000
NODE_6345_length_1014_cov_22.437158	534	614	8	46	80	0.5750000
NODE_6345_length_1014_cov_22.437158	587	667	4	18	80	0.2250000
NODE_6345_length_1014_cov_22.437158	587	667	6	31	80	0.3875000
NODE_6345_length_1014_cov_22.437158	587	667	8	31	80	0.3875000
NODE_6346_length_1014_cov_19.238251	379	459	0	80	80	1.0000000
NODE_6346_length_1014_cov_19.238251	432	512	0	80	80	1.0000000
NODE_6346_length_1014_cov_19.238251	508	585	0	61	77	0.7922078
NODE_6346_length_1014_cov_19.238251	508	585	3	16	77	0.2077922
NODE_6346_length_1014_cov_19.238251	558	638	0	11	80	0.1375000
NODE_6346_length_1014_cov_19.238251	558	638	3	53	80	0.6625000
NODE_6346_length_1014_cov_19.238251	558	638	4	16	80	0.2000000
NODE_6347_length_1014_cov_15.926776	594	674	2	14	80	0.1750000
NODE_6347_length_1014_cov_15.926776	594	674	4	13	80	0.1625000
NODE_6347_length_1014_cov_15.926776	594	674	5	1	80	0.0125000
NODE_6347_length_1014_cov_15.926776	594	674	6	52	80	0.6500000
NODE_6347_length_1014_cov_15.926776	647	727	4	19	80	0.2375000
NODE_6347_length_1014_cov_15.926776	647	727	6	61	80	0.7625000
NODE_6348_length_1014_cov_8.691803	285	365	0	18	80	0.2250000
NODE_6348_length_1014_cov_8.691803	285	365	2	62	80	0.7750000
NODE_6348_length_1014_cov_8.691803	338	418	2	80	80	1.0000000
NODE_6349_length_1014_cov_7.959563	531	611	2	17	80	0.2125000
NODE_6349_length_1014_cov_7.959563	531	611	4	63	80	0.7875000
NODE_6349_length_1014_cov_7.959563	584	664	0	4	80	0.0500000
NODE_6349_length_1014_cov_7.959563	584	664	2	6	80	0.0750000
NODE_6349_length_1014_cov_7.959563	584	664	3	11	80	0.1375000
NODE_6349_length_1014_cov_7.959563	584	664	4	59	80	0.7375000
NODE_6351_length_1014_cov_7.608743	298	378	0	80	80	1.0000000
NODE_6351_length_1014_cov_7.608743	351	431	0	80	80	1.0000000
NODE_6352_length_1014_cov_6.209836	321	401	0	37	80	0.4625000
NODE_6352_length_1014_cov_6.209836	321	401	4	43	80	0.5375000
NODE_6352_length_1014_cov_6.209836	374	454	4	51	80	0.6375000
NODE_6352_length_1014_cov_6.209836	374	454	8	29	80	0.3625000
NODE_6364_length_1013_cov_32.695842	423	503	0	80	80	1.0000000
NODE_6364_length_1013_cov_32.695842	476	556	0	80	80	1.0000000
NODE_6364_length_1013_cov_32.695842	552	632	0	43	80	0.5375000
NODE_6364_length_1013_cov_32.695842	552	632	4	3	80	0.0375000
NODE_6364_length_1013_cov_32.695842	552	632	16	34	80	0.4250000
NODE_6364_length_1013_cov_32.695842	605	685	12	14	80	0.1750000
NODE_6364_length_1013_cov_32.695842	605	685	16	66	80	0.8250000
NODE_6365_length_1013_cov_21.935449	424	503	0	79	79	1.0000000
NODE_6365_length_1013_cov_21.935449	476	556	0	80	80	1.0000000
NODE_6366_length_1013_cov_17.532823	440	520	0	80	80	1.0000000
NODE_6366_length_1013_cov_17.532823	493	573	0	80	80	1.0000000
NODE_6367_length_1013_cov_14.555799	478	558	0	80	80	1.0000000
NODE_6367_length_1013_cov_14.555799	531	611	0	80	80	1.0000000
NODE_6368_length_1013_cov_13.142232	476	556	6	11	80	0.1375000
NODE_6368_length_1013_cov_13.142232	476	556	8	28	80	0.3500000
NODE_6368_length_1013_cov_13.142232	476	556	10	41	80	0.5125000
NODE_6368_length_1013_cov_13.142232	529	609	0	25	80	0.3125000
NODE_6368_length_1013_cov_13.142232	529	609	2	4	80	0.0500000
NODE_6368_length_1013_cov_13.142232	529	609	4	1	80	0.0125000
NODE_6368_length_1013_cov_13.142232	529	609	6	4	80	0.0500000
NODE_6368_length_1013_cov_13.142232	529	609	7	2	80	0.0250000
NODE_6368_length_1013_cov_13.142232	529	609	8	38	80	0.4750000
NODE_6368_length_1013_cov_13.142232	529	609	10	6	80	0.0750000
NODE_6369_length_1013_cov_7.756018	538	618	0	2	80	0.0250000
NODE_6369_length_1013_cov_7.756018	538	618	2	78	80	0.9750000
NODE_6369_length_1013_cov_7.756018	591	671	0	55	80	0.6875000
NODE_6369_length_1013_cov_7.756018	591	671	2	25	80	0.3125000
NODE_6371_length_1013_cov_4.368709	550	630	8	6	80	0.0750000
NODE_6371_length_1013_cov_4.368709	550	630	10	74	80	0.9250000
NODE_6371_length_1013_cov_4.368709	603	683	2	36	80	0.4500000
NODE_6371_length_1013_cov_4.368709	603	683	4	1	80	0.0125000
NODE_6371_length_1013_cov_4.368709	603	683	6	8	80	0.1000000
NODE_6371_length_1013_cov_4.368709	603	683	10	35	80	0.4375000
NODE_6380_length_1012_cov_91.547645	378	458	0	80	80	1.0000000
NODE_6380_length_1012_cov_91.547645	431	511	0	80	80	1.0000000
NODE_6380_length_1012_cov_91.547645	507	587	0	20	80	0.2500000
NODE_6380_length_1012_cov_91.547645	507	587	2	60	80	0.7500000
NODE_6380_length_1012_cov_91.547645	560	640	0	24	80	0.3000000
NODE_6380_length_1012_cov_91.547645	560	640	2	56	80	0.7000000
NODE_6381_length_1012_cov_64.409639	345	425	1	14	80	0.1750000
NODE_6381_length_1012_cov_64.409639	345	425	2	20	80	0.2500000
NODE_6381_length_1012_cov_64.409639	345	425	4	46	80	0.5750000
NODE_6381_length_1012_cov_64.409639	398	478	1	12	80	0.1500000
NODE_6381_length_1012_cov_64.409639	398	478	2	7	80	0.0875000
NODE_6381_length_1012_cov_64.409639	398	478	4	61	80	0.7625000
NODE_6382_length_1012_cov_63.035049	438	518	0	31	80	0.3875000
NODE_6382_length_1012_cov_63.035049	438	518	2	10	80	0.1250000
NODE_6382_length_1012_cov_63.035049	438	518	9	1	80	0.0125000
NODE_6382_length_1012_cov_63.035049	438	518	10	28	80	0.3500000
NODE_6382_length_1012_cov_63.035049	438	518	12	10	80	0.1250000
NODE_6382_length_1012_cov_63.035049	491	571	6	3	80	0.0375000
NODE_6382_length_1012_cov_63.035049	491	571	8	8	80	0.1000000
NODE_6382_length_1012_cov_63.035049	491	571	10	18	80	0.2250000
NODE_6382_length_1012_cov_63.035049	491	571	12	45	80	0.5625000
NODE_6382_length_1012_cov_63.035049	491	571	13	1	80	0.0125000
NODE_6382_length_1012_cov_63.035049	491	571	14	5	80	0.0625000
NODE_6383_length_1012_cov_53.686747	276	356	0	26	80	0.3250000
NODE_6383_length_1012_cov_53.686747	276	356	2	54	80	0.6750000
NODE_6383_length_1012_cov_53.686747	329	409	0	79	80	0.9875000
NODE_6383_length_1012_cov_53.686747	329	409	2	1	80	0.0125000
NODE_6383_length_1012_cov_53.686747	405	485	0	35	80	0.4375000
NODE_6383_length_1012_cov_53.686747	405	485	2	45	80	0.5625000
NODE_6383_length_1012_cov_53.686747	458	538	2	80	80	1.0000000
NODE_6384_length_1012_cov_35.861993	453	533	0	80	80	1.0000000
NODE_6384_length_1012_cov_35.861993	506	581	0	75	75	1.0000000
NODE_6385_length_1012_cov_16.125958	510	590	0	2	80	0.0250000
NODE_6385_length_1012_cov_16.125958	510	590	2	42	80	0.5250000
NODE_6385_length_1012_cov_16.125958	510	590	4	36	80	0.4500000
NODE_6385_length_1012_cov_16.125958	563	643	0	20	80	0.2500000
NODE_6385_length_1012_cov_16.125958	563	643	2	14	80	0.1750000
NODE_6385_length_1012_cov_16.125958	563	643	4	46	80	0.5750000
NODE_6386_length_1012_cov_15.395400	501	581	0	80	80	1.0000000
NODE_6386_length_1012_cov_15.395400	554	634	0	80	80	1.0000000
NODE_6388_length_1012_cov_6.409639	528	608	0	80	80	1.0000000
NODE_6388_length_1012_cov_6.409639	581	661	0	80	80	1.0000000
NODE_6398_length_1011_cov_53.032895	515	595	4	37	80	0.4625000
NODE_6398_length_1011_cov_53.032895	515	595	6	43	80	0.5375000
NODE_6398_length_1011_cov_53.032895	568	648	0	23	80	0.2875000
NODE_6398_length_1011_cov_53.032895	568	648	4	57	80	0.7125000
NODE_6399_length_1011_cov_25.838816	366	446	0	9	80	0.1125000
NODE_6399_length_1011_cov_25.838816	366	446	4	71	80	0.8875000
NODE_6399_length_1011_cov_25.838816	419	499	0	62	80	0.7750000
NODE_6399_length_1011_cov_25.838816	419	499	4	18	80	0.2250000
NODE_6400_length_1011_cov_22.734649	426	506	0	80	80	1.0000000
NODE_6400_length_1011_cov_22.734649	479	559	0	80	80	1.0000000
NODE_6400_length_1011_cov_22.734649	555	636	0	43	81	0.5308642
NODE_6400_length_1011_cov_22.734649	555	636	4	38	81	0.4691358
NODE_6400_length_1011_cov_22.734649	609	689	4	80	80	1.0000000
NODE_6401_length_1011_cov_18.127193	389	469	0	56	80	0.7000000
NODE_6401_length_1011_cov_18.127193	389	469	2	24	80	0.3000000
NODE_6401_length_1011_cov_18.127193	442	520	0	3	78	0.0384615
NODE_6401_length_1011_cov_18.127193	442	520	2	57	78	0.7307692
NODE_6401_length_1011_cov_18.127193	442	520	4	10	78	0.1282051
NODE_6401_length_1011_cov_18.127193	442	520	6	8	78	0.1025641
NODE_6401_length_1011_cov_18.127193	516	596	4	24	80	0.3000000
NODE_6401_length_1011_cov_18.127193	516	596	6	36	80	0.4500000
NODE_6401_length_1011_cov_18.127193	516	596	8	20	80	0.2500000
NODE_6401_length_1011_cov_18.127193	569	649	4	60	80	0.7500000
NODE_6401_length_1011_cov_18.127193	569	649	8	20	80	0.2500000
NODE_6402_length_1011_cov_12.709430	309	389	0	55	80	0.6875000
NODE_6402_length_1011_cov_12.709430	309	389	1	8	80	0.1000000
NODE_6402_length_1011_cov_12.709430	309	389	2	17	80	0.2125000
NODE_6402_length_1011_cov_12.709430	362	442	0	2	80	0.0250000
NODE_6402_length_1011_cov_12.709430	362	442	1	8	80	0.1000000
NODE_6402_length_1011_cov_12.709430	362	442	2	70	80	0.8750000
NODE_6403_length_1011_cov_8.731360	441	521	0	80	80	1.0000000
NODE_6403_length_1011_cov_8.731360	494	574	0	80	80	1.0000000
NODE_6405_length_1011_cov_7.212719	219	299	2	21	80	0.2625000
NODE_6405_length_1011_cov_7.212719	219	299	3	1	80	0.0125000
NODE_6405_length_1011_cov_7.212719	219	299	4	51	80	0.6375000
NODE_6405_length_1011_cov_7.212719	219	299	6	7	80	0.0875000
NODE_6408_length_1011_cov_3.569079	173	253	0	26	80	0.3250000
NODE_6408_length_1011_cov_3.569079	173	253	2	54	80	0.6750000
NODE_6408_length_1011_cov_3.569079	226	306	0	26	80	0.3250000
NODE_6408_length_1011_cov_3.569079	226	306	2	54	80	0.6750000
NODE_6409_length_1011_cov_1.703947	779	851	8	1	72	0.0138889
NODE_6409_length_1011_cov_1.703947	779	851	12	1	72	0.0138889
NODE_6409_length_1011_cov_1.703947	779	851	16	4	72	0.0555556
NODE_6409_length_1011_cov_1.703947	779	851	18	3	72	0.0416667
NODE_6409_length_1011_cov_1.703947	779	851	20	4	72	0.0555556
NODE_6409_length_1011_cov_1.703947	779	851	22	5	72	0.0694444
NODE_6409_length_1011_cov_1.703947	779	851	23	5	72	0.0694444
NODE_6409_length_1011_cov_1.703947	779	851	24	1	72	0.0138889
NODE_6409_length_1011_cov_1.703947	779	851	26	3	72	0.0416667
NODE_6409_length_1011_cov_1.703947	779	851	27	2	72	0.0277778
NODE_6409_length_1011_cov_1.703947	779	851	29	1	72	0.0138889
NODE_6409_length_1011_cov_1.703947	779	851	30	9	72	0.1250000
NODE_6409_length_1011_cov_1.703947	779	851	32	8	72	0.1111111
NODE_6409_length_1011_cov_1.703947	779	851	33	3	72	0.0416667
NODE_6409_length_1011_cov_1.703947	779	851	34	4	72	0.0555556
NODE_6409_length_1011_cov_1.703947	779	851	36	12	72	0.1666667
NODE_6409_length_1011_cov_1.703947	779	851	38	6	72	0.0833333
NODE_6416_length_1010_cov_51.841932	335	415	0	22	80	0.2750000
NODE_6416_length_1010_cov_51.841932	335	415	4	58	80	0.7250000
NODE_6416_length_1010_cov_51.841932	388	468	0	2	80	0.0250000
NODE_6416_length_1010_cov_51.841932	388	468	4	78	80	0.9750000
NODE_6417_length_1010_cov_35.860593	576	656	1	51	80	0.6375000
NODE_6417_length_1010_cov_35.860593	576	656	2	29	80	0.3625000
NODE_6417_length_1010_cov_35.860593	629	709	1	3	80	0.0375000
NODE_6417_length_1010_cov_35.860593	629	709	2	77	80	0.9625000
NODE_6418_length_1010_cov_30.043908	509	589	0	2	80	0.0250000
NODE_6418_length_1010_cov_30.043908	509	589	2	78	80	0.9750000
NODE_6418_length_1010_cov_30.043908	562	642	0	37	80	0.4625000
NODE_6418_length_1010_cov_30.043908	562	642	2	43	80	0.5375000
NODE_6418_length_1010_cov_30.043908	638	718	0	80	80	1.0000000
NODE_6418_length_1010_cov_30.043908	691	771	0	80	80	1.0000000
NODE_6420_length_1010_cov_15.156970	364	444	0	26	80	0.3250000
NODE_6420_length_1010_cov_15.156970	364	444	2	54	80	0.6750000
NODE_6420_length_1010_cov_15.156970	417	497	0	79	80	0.9875000
NODE_6420_length_1010_cov_15.156970	417	497	2	1	80	0.0125000
NODE_6421_length_1010_cov_13.546652	385	465	0	80	80	1.0000000
NODE_6421_length_1010_cov_13.546652	438	518	0	80	80	1.0000000
NODE_6422_length_1010_cov_13.317234	480	560	0	80	80	1.0000000
NODE_6422_length_1010_cov_13.317234	533	613	0	80	80	1.0000000
NODE_6423_length_1010_cov_12.900110	427	507	0	80	80	1.0000000
NODE_6423_length_1010_cov_12.900110	480	560	0	80	80	1.0000000
NODE_6424_length_1010_cov_11.423710	631	711	2	6	80	0.0750000
NODE_6424_length_1010_cov_11.423710	631	711	4	74	80	0.9250000
NODE_6424_length_1010_cov_11.423710	684	764	0	42	80	0.5250000
NODE_6424_length_1010_cov_11.423710	684	764	2	8	80	0.1000000
NODE_6424_length_1010_cov_11.423710	684	764	4	30	80	0.3750000
NODE_6425_length_1010_cov_11.256861	492	572	0	50	80	0.6250000
NODE_6425_length_1010_cov_11.256861	492	572	2	30	80	0.3750000
NODE_6425_length_1010_cov_11.256861	545	625	2	80	80	1.0000000
NODE_6426_length_1010_cov_11.000000	455	535	0	80	80	1.0000000
NODE_6426_length_1010_cov_11.000000	508	588	0	80	80	1.0000000
NODE_6428_length_1010_cov_4.990121	476	556	2	41	80	0.5125000
NODE_6428_length_1010_cov_4.990121	476	556	4	38	80	0.4750000
NODE_6428_length_1010_cov_4.990121	476	556	6	1	80	0.0125000
NODE_6428_length_1010_cov_4.990121	529	609	2	23	80	0.2875000
NODE_6428_length_1010_cov_4.990121	529	609	3	28	80	0.3500000
NODE_6428_length_1010_cov_4.990121	529	609	4	23	80	0.2875000
NODE_6428_length_1010_cov_4.990121	529	609	6	6	80	0.0750000
NODE_6430_length_1010_cov_4.892426	476	556	0	80	80	1.0000000
NODE_6430_length_1010_cov_4.892426	529	609	0	80	80	1.0000000
NODE_6431_length_1010_cov_3.624588	157	196	0	39	39	1.0000000
NODE_6435_length_1010_cov_1.440176	1	58	0	57	57	1.0000000
NODE_6436_length_1009_cov_44.626374	288	362	0	74	74	1.0000000
NODE_6436_length_1009_cov_44.626374	335	415	0	80	80	1.0000000
NODE_6436_length_1009_cov_44.626374	411	491	0	62	80	0.7750000
NODE_6436_length_1009_cov_44.626374	411	491	2	18	80	0.2250000
NODE_6436_length_1009_cov_44.626374	464	544	0	9	80	0.1125000
NODE_6436_length_1009_cov_44.626374	464	544	2	71	80	0.8875000
NODE_6437_length_1009_cov_31.828571	412	492	4	51	80	0.6375000
NODE_6437_length_1009_cov_31.828571	412	492	6	29	80	0.3625000
NODE_6437_length_1009_cov_31.828571	465	545	0	16	80	0.2000000
NODE_6437_length_1009_cov_31.828571	465	545	2	13	80	0.1625000
NODE_6437_length_1009_cov_31.828571	465	545	4	43	80	0.5375000
NODE_6437_length_1009_cov_31.828571	465	545	6	8	80	0.1000000
NODE_6438_length_1009_cov_28.539560	571	651	0	66	80	0.8250000
NODE_6438_length_1009_cov_28.539560	571	651	2	14	80	0.1750000
NODE_6438_length_1009_cov_28.539560	624	704	0	80	80	1.0000000
NODE_6439_length_1009_cov_20.281319	577	657	6	1	80	0.0125000
NODE_6439_length_1009_cov_20.281319	577	657	12	7	80	0.0875000
NODE_6439_length_1009_cov_20.281319	577	657	14	1	80	0.0125000
NODE_6439_length_1009_cov_20.281319	577	657	16	34	80	0.4250000
NODE_6439_length_1009_cov_20.281319	577	657	18	37	80	0.4625000
NODE_6439_length_1009_cov_20.281319	630	710	4	7	80	0.0875000
NODE_6439_length_1009_cov_20.281319	630	710	6	36	80	0.4500000
NODE_6439_length_1009_cov_20.281319	630	710	8	11	80	0.1375000
NODE_6439_length_1009_cov_20.281319	630	710	16	6	80	0.0750000
NODE_6439_length_1009_cov_20.281319	630	710	18	20	80	0.2500000
NODE_6440_length_1009_cov_18.649451	430	510	0	80	80	1.0000000
NODE_6440_length_1009_cov_18.649451	483	563	0	80	80	1.0000000
NODE_6442_length_1009_cov_3.767033	647	727	0	18	80	0.2250000
NODE_6442_length_1009_cov_3.767033	647	727	2	62	80	0.7750000
NODE_6442_length_1009_cov_3.767033	700	780	0	35	80	0.4375000
NODE_6442_length_1009_cov_3.767033	700	780	2	9	80	0.1125000
NODE_6442_length_1009_cov_3.767033	700	780	3	1	80	0.0125000
NODE_6442_length_1009_cov_3.767033	700	780	4	35	80	0.4375000
NODE_6443_length_1009_cov_2.903297	36	63	0	27	27	1.0000000
NODE_6451_length_1008_cov_44.825083	399	479	0	5	80	0.0625000
NODE_6451_length_1008_cov_44.825083	399	479	1	2	80	0.0250000
NODE_6451_length_1008_cov_44.825083	399	479	4	34	80	0.4250000
NODE_6451_length_1008_cov_44.825083	399	479	5	6	80	0.0750000
NODE_6451_length_1008_cov_44.825083	399	479	7	30	80	0.3750000
NODE_6451_length_1008_cov_44.825083	399	479	8	3	80	0.0375000
NODE_6451_length_1008_cov_44.825083	452	532	4	2	80	0.0250000
NODE_6451_length_1008_cov_44.825083	452	532	7	24	80	0.3000000
NODE_6451_length_1008_cov_44.825083	452	532	8	54	80	0.6750000
NODE_6452_length_1008_cov_41.030803	280	360	0	41	80	0.5125000
NODE_6452_length_1008_cov_41.030803	280	360	2	19	80	0.2375000
NODE_6452_length_1008_cov_41.030803	280	360	4	20	80	0.2500000
NODE_6452_length_1008_cov_41.030803	333	413	0	80	80	1.0000000
NODE_6452_length_1008_cov_41.030803	409	489	0	24	80	0.3000000
NODE_6452_length_1008_cov_41.030803	409	489	2	56	80	0.7000000
NODE_6452_length_1008_cov_41.030803	462	542	2	80	80	1.0000000
NODE_6453_length_1008_cov_39.377338	311	391	2	34	80	0.4250000
NODE_6453_length_1008_cov_39.377338	311	391	4	46	80	0.5750000
NODE_6453_length_1008_cov_39.377338	364	444	0	10	80	0.1250000
NODE_6453_length_1008_cov_39.377338	364	444	2	45	80	0.5625000
NODE_6453_length_1008_cov_39.377338	364	444	4	25	80	0.3125000
NODE_6453_length_1008_cov_39.377338	440	520	0	80	80	1.0000000
NODE_6453_length_1008_cov_39.377338	493	573	0	51	80	0.6375000
NODE_6453_length_1008_cov_39.377338	493	573	2	29	80	0.3625000
NODE_6454_length_1008_cov_27.836084	405	485	2	34	80	0.4250000
NODE_6454_length_1008_cov_27.836084	405	485	4	46	80	0.5750000
NODE_6454_length_1008_cov_27.836084	458	538	0	21	80	0.2625000
NODE_6454_length_1008_cov_27.836084	458	538	2	59	80	0.7375000
NODE_6454_length_1008_cov_27.836084	534	614	0	80	80	1.0000000
NODE_6454_length_1008_cov_27.836084	587	667	0	80	80	1.0000000
NODE_6455_length_1008_cov_24.741474	485	565	2	3	80	0.0375000
NODE_6455_length_1008_cov_24.741474	485	565	4	29	80	0.3625000
NODE_6455_length_1008_cov_24.741474	485	565	6	48	80	0.6000000
NODE_6455_length_1008_cov_24.741474	538	618	0	6	80	0.0750000
NODE_6455_length_1008_cov_24.741474	538	618	2	12	80	0.1500000
NODE_6455_length_1008_cov_24.741474	538	618	4	22	80	0.2750000
NODE_6455_length_1008_cov_24.741474	538	618	6	40	80	0.5000000
NODE_6456_length_1008_cov_20.278328	401	481	2	3	80	0.0375000
NODE_6456_length_1008_cov_20.278328	401	481	4	3	80	0.0375000
NODE_6456_length_1008_cov_20.278328	401	481	6	55	80	0.6875000
NODE_6456_length_1008_cov_20.278328	401	481	8	19	80	0.2375000
NODE_6456_length_1008_cov_20.278328	454	534	0	2	80	0.0250000
NODE_6456_length_1008_cov_20.278328	454	534	2	33	80	0.4125000
NODE_6456_length_1008_cov_20.278328	454	534	4	13	80	0.1625000
NODE_6456_length_1008_cov_20.278328	454	534	6	21	80	0.2625000
NODE_6456_length_1008_cov_20.278328	454	534	8	11	80	0.1375000
NODE_6457_length_1008_cov_6.071507	460	540	0	9	80	0.1125000
NODE_6457_length_1008_cov_6.071507	460	540	2	71	80	0.8875000
NODE_6457_length_1008_cov_6.071507	513	593	0	13	80	0.1625000
NODE_6457_length_1008_cov_6.071507	513	593	2	67	80	0.8375000
NODE_6466_length_1008_cov_1.798680	0	64	0	17	64	0.2656250
NODE_6466_length_1008_cov_1.798680	0	64	2	1	64	0.0156250
NODE_6466_length_1008_cov_1.798680	0	64	4	46	64	0.7187500
NODE_6466_length_1008_cov_1.798680	37	104	4	63	67	0.9402985
NODE_6466_length_1008_cov_1.798680	37	104	6	4	67	0.0597015
NODE_6473_length_1007_cov_27.011013	294	371	0	77	77	1.0000000
NODE_6473_length_1007_cov_27.011013	347	424	0	77	77	1.0000000
NODE_6474_length_1007_cov_24.668502	369	449	0	44	80	0.5500000
NODE_6474_length_1007_cov_24.668502	369	449	2	36	80	0.4500000
NODE_6474_length_1007_cov_24.668502	422	502	0	80	80	1.0000000
NODE_6474_length_1007_cov_24.668502	498	578	0	20	80	0.2500000
NODE_6474_length_1007_cov_24.668502	498	578	2	47	80	0.5875000
NODE_6474_length_1007_cov_24.668502	498	578	4	13	80	0.1625000
NODE_6474_length_1007_cov_24.668502	551	631	2	22	80	0.2750000
NODE_6474_length_1007_cov_24.668502	551	631	4	58	80	0.7250000
NODE_6475_length_1007_cov_21.729075	454	534	4	24	80	0.3000000
NODE_6475_length_1007_cov_21.729075	454	534	6	29	80	0.3625000
NODE_6475_length_1007_cov_21.729075	454	534	8	27	80	0.3375000
NODE_6475_length_1007_cov_21.729075	507	587	0	8	80	0.1000000
NODE_6475_length_1007_cov_21.729075	507	587	2	22	80	0.2750000
NODE_6475_length_1007_cov_21.729075	507	587	4	39	80	0.4875000
NODE_6475_length_1007_cov_21.729075	507	587	6	4	80	0.0500000
NODE_6475_length_1007_cov_21.729075	507	587	8	7	80	0.0875000
NODE_6475_length_1007_cov_21.729075	583	663	2	80	80	1.0000000
NODE_6475_length_1007_cov_21.729075	636	716	0	11	80	0.1375000
NODE_6475_length_1007_cov_21.729075	636	716	2	69	80	0.8625000
NODE_6476_length_1007_cov_14.515419	400	480	0	23	80	0.2875000
NODE_6476_length_1007_cov_14.515419	400	480	4	57	80	0.7125000
NODE_6476_length_1007_cov_14.515419	453	533	0	18	80	0.2250000
NODE_6476_length_1007_cov_14.515419	453	533	4	62	80	0.7750000
NODE_6477_length_1007_cov_13.685022	376	456	0	46	80	0.5750000
NODE_6477_length_1007_cov_13.685022	376	456	4	23	80	0.2875000
NODE_6477_length_1007_cov_13.685022	376	456	8	11	80	0.1375000
NODE_6477_length_1007_cov_13.685022	429	509	4	16	80	0.2000000
NODE_6477_length_1007_cov_13.685022	429	509	8	64	80	0.8000000
NODE_6478_length_1007_cov_9.189427	438	518	0	26	80	0.3250000
NODE_6478_length_1007_cov_9.189427	438	518	2	54	80	0.6750000
NODE_6478_length_1007_cov_9.189427	491	571	2	80	80	1.0000000
NODE_6491_length_1006_cov_59.773980	379	459	1	7	80	0.0875000
NODE_6491_length_1006_cov_59.773980	379	459	3	17	80	0.2125000
NODE_6491_length_1006_cov_59.773980	379	459	5	10	80	0.1250000
NODE_6491_length_1006_cov_59.773980	379	459	10	23	80	0.2875000
NODE_6491_length_1006_cov_59.773980	379	459	11	1	80	0.0125000
NODE_6491_length_1006_cov_59.773980	379	459	12	22	80	0.2750000
NODE_6491_length_1006_cov_59.773980	432	512	2	3	80	0.0375000
NODE_6491_length_1006_cov_59.773980	432	512	3	5	80	0.0625000
NODE_6491_length_1006_cov_59.773980	432	512	10	35	80	0.4375000
NODE_6491_length_1006_cov_59.773980	432	512	12	37	80	0.4625000
NODE_6491_length_1006_cov_59.773980	508	588	1	34	80	0.4250000
NODE_6491_length_1006_cov_59.773980	508	588	3	46	80	0.5750000
NODE_6491_length_1006_cov_59.773980	561	641	1	80	80	1.0000000
NODE_6492_length_1006_cov_34.762955	482	562	0	11	80	0.1375000
NODE_6492_length_1006_cov_34.762955	482	562	4	69	80	0.8625000
NODE_6492_length_1006_cov_34.762955	535	615	0	21	80	0.2625000
NODE_6492_length_1006_cov_34.762955	535	615	4	59	80	0.7375000
NODE_6493_length_1006_cov_21.776185	516	596	0	15	80	0.1875000
NODE_6493_length_1006_cov_21.776185	516	596	2	65	80	0.8125000
NODE_6493_length_1006_cov_21.776185	569	649	0	32	80	0.4000000
NODE_6493_length_1006_cov_21.776185	569	649	2	48	80	0.6000000
NODE_6494_length_1006_cov_19.690187	371	451	0	75	80	0.9375000
NODE_6494_length_1006_cov_19.690187	371	451	2	5	80	0.0625000
NODE_6494_length_1006_cov_19.690187	424	504	0	80	80	1.0000000
NODE_6495_length_1006_cov_19.299890	495	575	0	80	80	1.0000000
NODE_6495_length_1006_cov_19.299890	548	628	0	80	80	1.0000000
NODE_6496_length_1006_cov_13.187431	245	325	4	80	80	1.0000000
NODE_6496_length_1006_cov_13.187431	298	378	0	15	80	0.1875000
NODE_6496_length_1006_cov_13.187431	298	378	4	65	80	0.8125000
NODE_6497_length_1006_cov_12.862183	383	463	0	7	80	0.0875000
NODE_6497_length_1006_cov_12.862183	383	463	5	73	80	0.9125000
NODE_6497_length_1006_cov_12.862183	436	516	0	60	80	0.7500000
NODE_6497_length_1006_cov_12.862183	436	516	5	20	80	0.2500000
NODE_6498_length_1006_cov_10.986770	762	842	2	80	80	1.0000000
NODE_6498_length_1006_cov_10.986770	815	895	0	53	80	0.6625000
NODE_6498_length_1006_cov_10.986770	815	895	2	27	80	0.3375000
NODE_6499_length_1006_cov_8.633958	314	394	2	34	80	0.4250000
NODE_6499_length_1006_cov_8.633958	314	394	4	46	80	0.5750000
NODE_6499_length_1006_cov_8.633958	367	447	0	6	80	0.0750000
NODE_6499_length_1006_cov_8.633958	367	447	2	33	80	0.4125000
NODE_6499_length_1006_cov_8.633958	367	447	4	41	80	0.5125000
NODE_6515_length_1005_cov_80.271523	509	589	21	15	80	0.1875000
NODE_6515_length_1005_cov_80.271523	509	589	25	3	80	0.0375000
NODE_6515_length_1005_cov_80.271523	509	589	27	2	80	0.0250000
NODE_6515_length_1005_cov_80.271523	509	589	31	19	80	0.2375000
NODE_6515_length_1005_cov_80.271523	509	589	39	29	80	0.3625000
NODE_6515_length_1005_cov_80.271523	509	589	40	12	80	0.1500000
NODE_6515_length_1005_cov_80.271523	562	642	8	1	80	0.0125000
NODE_6515_length_1005_cov_80.271523	562	642	11	1	80	0.0125000
NODE_6515_length_1005_cov_80.271523	562	642	12	9	80	0.1125000
NODE_6515_length_1005_cov_80.271523	562	642	14	2	80	0.0250000
NODE_6515_length_1005_cov_80.271523	562	642	16	3	80	0.0375000
NODE_6515_length_1005_cov_80.271523	562	642	18	11	80	0.1375000
NODE_6515_length_1005_cov_80.271523	562	642	20	4	80	0.0500000
NODE_6515_length_1005_cov_80.271523	562	642	36	20	80	0.2500000
NODE_6515_length_1005_cov_80.271523	562	642	39	15	80	0.1875000
NODE_6515_length_1005_cov_80.271523	562	642	40	14	80	0.1750000
NODE_6516_length_1005_cov_45.008830	357	437	0	4	80	0.0500000
NODE_6516_length_1005_cov_45.008830	357	437	2	76	80	0.9500000
NODE_6516_length_1005_cov_45.008830	410	490	0	4	80	0.0500000
NODE_6516_length_1005_cov_45.008830	410	490	2	76	80	0.9500000
NODE_6517_length_1005_cov_36.636865	567	647	0	80	80	1.0000000
NODE_6517_length_1005_cov_36.636865	620	700	0	80	80	1.0000000
NODE_6518_length_1005_cov_21.222958	389	409	4	20	20	1.0000000
NODE_6518_length_1005_cov_21.222958	451	519	6	27	68	0.3970588
NODE_6518_length_1005_cov_21.222958	451	519	8	15	68	0.2205882
NODE_6518_length_1005_cov_21.222958	451	519	10	26	68	0.3823529
NODE_6518_length_1005_cov_21.222958	515	595	4	43	80	0.5375000
NODE_6518_length_1005_cov_21.222958	515	595	6	29	80	0.3625000
NODE_6518_length_1005_cov_21.222958	515	595	8	8	80	0.1000000
NODE_6518_length_1005_cov_21.222958	568	648	4	3	80	0.0375000
NODE_6518_length_1005_cov_21.222958	568	648	6	64	80	0.8000000
NODE_6518_length_1005_cov_21.222958	568	648	9	1	80	0.0125000
NODE_6518_length_1005_cov_21.222958	568	648	10	12	80	0.1500000
NODE_6520_length_1005_cov_14.278146	480	560	0	9	80	0.1125000
NODE_6520_length_1005_cov_14.278146	480	560	2	11	80	0.1375000
NODE_6520_length_1005_cov_14.278146	480	560	3	1	80	0.0125000
NODE_6520_length_1005_cov_14.278146	480	560	4	59	80	0.7375000
NODE_6520_length_1005_cov_14.278146	533	613	2	14	80	0.1750000
NODE_6520_length_1005_cov_14.278146	533	613	4	66	80	0.8250000
NODE_6521_length_1005_cov_13.215232	511	591	0	80	80	1.0000000
NODE_6521_length_1005_cov_13.215232	564	644	0	80	80	1.0000000
NODE_6523_length_1005_cov_5.579470	534	614	0	53	80	0.6625000
NODE_6523_length_1005_cov_5.579470	534	614	2	27	80	0.3375000
NODE_6523_length_1005_cov_5.579470	587	667	0	80	80	1.0000000
NODE_6536_length_1004_cov_45.470718	343	423	0	80	80	1.0000000
NODE_6536_length_1004_cov_45.470718	396	476	0	80	80	1.0000000
NODE_6536_length_1004_cov_45.470718	472	552	0	17	80	0.2125000
NODE_6536_length_1004_cov_45.470718	472	552	2	63	80	0.7875000
NODE_6536_length_1004_cov_45.470718	525	605	0	11	80	0.1375000
NODE_6536_length_1004_cov_45.470718	525	605	2	69	80	0.8625000
NODE_6537_length_1004_cov_34.565746	419	499	12	9	80	0.1125000
NODE_6537_length_1004_cov_34.565746	419	499	14	19	80	0.2375000
NODE_6537_length_1004_cov_34.565746	419	499	22	26	80	0.3250000
NODE_6537_length_1004_cov_34.565746	419	499	24	26	80	0.3250000
NODE_6537_length_1004_cov_34.565746	472	552	12	2	80	0.0250000
NODE_6537_length_1004_cov_34.565746	472	552	18	26	80	0.3250000
NODE_6537_length_1004_cov_34.565746	472	552	22	1	80	0.0125000
NODE_6537_length_1004_cov_34.565746	472	552	24	51	80	0.6375000
NODE_6538_length_1004_cov_28.710497	385	465	2	15	80	0.1875000
NODE_6538_length_1004_cov_28.710497	385	465	4	65	80	0.8125000
NODE_6538_length_1004_cov_28.710497	438	518	0	25	80	0.3125000
NODE_6538_length_1004_cov_28.710497	438	518	2	5	80	0.0625000
NODE_6538_length_1004_cov_28.710497	438	518	4	50	80	0.6250000
NODE_6538_length_1004_cov_28.710497	514	594	0	80	80	1.0000000
NODE_6538_length_1004_cov_28.710497	567	647	0	80	80	1.0000000
NODE_6539_length_1004_cov_12.745856	432	512	0	2	80	0.0250000
NODE_6539_length_1004_cov_12.745856	432	512	2	33	80	0.4125000
NODE_6539_length_1004_cov_12.745856	432	512	6	25	80	0.3125000
NODE_6539_length_1004_cov_12.745856	432	512	8	20	80	0.2500000
NODE_6539_length_1004_cov_12.745856	485	565	6	38	80	0.4750000
NODE_6539_length_1004_cov_12.745856	485	565	8	42	80	0.5250000
NODE_6550_length_1003_cov_47.014381	383	463	0	47	80	0.5875000
NODE_6550_length_1003_cov_47.014381	383	463	2	33	80	0.4125000
NODE_6550_length_1003_cov_47.014381	436	516	2	39	80	0.4875000
NODE_6550_length_1003_cov_47.014381	436	516	4	41	80	0.5125000
NODE_6550_length_1003_cov_47.014381	512	592	4	22	80	0.2750000
NODE_6550_length_1003_cov_47.014381	512	592	6	31	80	0.3875000
NODE_6550_length_1003_cov_47.014381	512	592	8	27	80	0.3375000
NODE_6550_length_1003_cov_47.014381	565	645	4	64	80	0.8000000
NODE_6550_length_1003_cov_47.014381	565	645	6	16	80	0.2000000
NODE_6551_length_1003_cov_35.329646	372	452	6	35	80	0.4375000
NODE_6551_length_1003_cov_35.329646	372	452	8	12	80	0.1500000
NODE_6551_length_1003_cov_35.329646	372	452	12	2	80	0.0250000
NODE_6551_length_1003_cov_35.329646	372	452	16	23	80	0.2875000
NODE_6551_length_1003_cov_35.329646	372	452	18	8	80	0.1000000
NODE_6551_length_1003_cov_35.329646	425	505	4	6	80	0.0750000
NODE_6551_length_1003_cov_35.329646	425	505	10	2	80	0.0250000
NODE_6551_length_1003_cov_35.329646	425	505	12	23	80	0.2875000
NODE_6551_length_1003_cov_35.329646	425	505	16	45	80	0.5625000
NODE_6551_length_1003_cov_35.329646	425	505	18	4	80	0.0500000
NODE_6552_length_1003_cov_32.721239	357	437	6	29	80	0.3625000
NODE_6552_length_1003_cov_32.721239	357	437	8	7	80	0.0875000
NODE_6552_length_1003_cov_32.721239	357	437	12	44	80	0.5500000
NODE_6552_length_1003_cov_32.721239	410	490	0	2	80	0.0250000
NODE_6552_length_1003_cov_32.721239	410	490	10	6	80	0.0750000
NODE_6552_length_1003_cov_32.721239	410	490	12	72	80	0.9000000
NODE_6553_length_1003_cov_23.758850	467	547	0	80	80	1.0000000
NODE_6553_length_1003_cov_23.758850	520	600	0	80	80	1.0000000
NODE_6554_length_1003_cov_19.939159	240	320	0	34	80	0.4250000
NODE_6554_length_1003_cov_19.939159	240	320	4	46	80	0.5750000
NODE_6554_length_1003_cov_19.939159	293	373	0	26	80	0.3250000
NODE_6554_length_1003_cov_19.939159	293	373	4	54	80	0.6750000
NODE_6555_length_1003_cov_16.618363	524	604	0	80	80	1.0000000
NODE_6555_length_1003_cov_16.618363	577	657	0	80	80	1.0000000
NODE_6555_length_1003_cov_16.618363	653	733	0	80	80	1.0000000
NODE_6555_length_1003_cov_16.618363	706	786	0	80	80	1.0000000
NODE_6556_length_1003_cov_13.863938	537	617	0	70	80	0.8750000
NODE_6556_length_1003_cov_13.863938	537	617	2	3	80	0.0375000
NODE_6556_length_1003_cov_13.863938	537	617	4	7	80	0.0875000
NODE_6556_length_1003_cov_13.863938	590	670	0	17	80	0.2125000
NODE_6556_length_1003_cov_13.863938	590	670	2	3	80	0.0375000
NODE_6556_length_1003_cov_13.863938	590	670	4	60	80	0.7500000
NODE_6557_length_1003_cov_12.363938	529	609	1	32	80	0.4000000
NODE_6557_length_1003_cov_12.363938	529	609	2	48	80	0.6000000
NODE_6557_length_1003_cov_12.363938	582	662	0	11	80	0.1375000
NODE_6557_length_1003_cov_12.363938	582	662	1	46	80	0.5750000
NODE_6557_length_1003_cov_12.363938	582	662	2	23	80	0.2875000
NODE_6567_length_1002_cov_65.513843	387	467	2	35	80	0.4375000
NODE_6567_length_1002_cov_65.513843	387	467	8	1	80	0.0125000
NODE_6567_length_1002_cov_65.513843	387	467	12	44	80	0.5500000
NODE_6567_length_1002_cov_65.513843	440	520	12	67	80	0.8375000
NODE_6567_length_1002_cov_65.513843	440	520	14	13	80	0.1625000
NODE_6567_length_1002_cov_65.513843	516	596	2	29	80	0.3625000
NODE_6567_length_1002_cov_65.513843	516	596	4	24	80	0.3000000
NODE_6567_length_1002_cov_65.513843	516	596	8	17	80	0.2125000
NODE_6567_length_1002_cov_65.513843	516	596	12	7	80	0.0875000
NODE_6567_length_1002_cov_65.513843	516	596	14	3	80	0.0375000
NODE_6567_length_1002_cov_65.513843	569	649	0	27	80	0.3375000
NODE_6567_length_1002_cov_65.513843	569	649	2	53	80	0.6625000
NODE_6568_length_1002_cov_41.995570	408	488	4	1	80	0.0125000
NODE_6568_length_1002_cov_41.995570	408	488	6	12	80	0.1500000
NODE_6568_length_1002_cov_41.995570	408	488	7	1	80	0.0125000
NODE_6568_length_1002_cov_41.995570	408	488	8	1	80	0.0125000
NODE_6568_length_1002_cov_41.995570	408	488	10	7	80	0.0875000
NODE_6568_length_1002_cov_41.995570	408	488	12	1	80	0.0125000
NODE_6568_length_1002_cov_41.995570	408	488	14	57	80	0.7125000
NODE_6568_length_1002_cov_41.995570	461	541	0	16	80	0.2000000
NODE_6568_length_1002_cov_41.995570	461	541	2	36	80	0.4500000
NODE_6568_length_1002_cov_41.995570	461	541	4	2	80	0.0250000
NODE_6568_length_1002_cov_41.995570	461	541	6	12	80	0.1500000
NODE_6568_length_1002_cov_41.995570	461	541	7	1	80	0.0125000
NODE_6568_length_1002_cov_41.995570	461	541	8	1	80	0.0125000
NODE_6568_length_1002_cov_41.995570	461	541	10	7	80	0.0875000
NODE_6568_length_1002_cov_41.995570	461	541	12	1	80	0.0125000
NODE_6568_length_1002_cov_41.995570	461	541	14	4	80	0.0500000
NODE_6569_length_1002_cov_19.966777	401	481	0	14	80	0.1750000
NODE_6569_length_1002_cov_19.966777	401	481	2	30	80	0.3750000
NODE_6569_length_1002_cov_19.966777	401	481	4	36	80	0.4500000
NODE_6569_length_1002_cov_19.966777	454	534	2	35	80	0.4375000
NODE_6569_length_1002_cov_19.966777	454	534	4	45	80	0.5625000
NODE_6570_length_1002_cov_19.539313	334	414	0	80	80	1.0000000
NODE_6570_length_1002_cov_19.539313	335	414	0	79	79	1.0000000
NODE_6570_length_1002_cov_19.539313	387	467	0	80	80	1.0000000
NODE_6570_length_1002_cov_19.539313	387	467	0	80	80	1.0000000
NODE_6570_length_1002_cov_19.539313	396	467	0	71	71	1.0000000
NODE_6570_length_1002_cov_19.539313	463	543	0	80	80	1.0000000
NODE_6570_length_1002_cov_19.539313	516	596	0	80	80	1.0000000
NODE_6571_length_1002_cov_17.780731	631	711	0	80	80	1.0000000
NODE_6571_length_1002_cov_17.780731	684	764	0	80	80	1.0000000
NODE_6572_length_1002_cov_17.590255	0	58	0	58	58	1.0000000
NODE_6572_length_1002_cov_17.590255	31	77	0	46	46	1.0000000
NODE_6573_length_1002_cov_17.105205	522	602	0	34	80	0.4250000
NODE_6573_length_1002_cov_17.105205	522	602	2	46	80	0.5750000
NODE_6573_length_1002_cov_17.105205	575	655	2	80	80	1.0000000
NODE_6574_length_1002_cov_11.954596	480	560	0	62	80	0.7750000
NODE_6574_length_1002_cov_11.954596	480	560	2	18	80	0.2250000
NODE_6574_length_1002_cov_11.954596	533	613	0	9	80	0.1125000
NODE_6574_length_1002_cov_11.954596	533	613	2	71	80	0.8875000
NODE_6575_length_1002_cov_11.823920	471	551	0	80	80	1.0000000
NODE_6575_length_1002_cov_11.823920	524	614	0	90	90	1.0000000
NODE_6577_length_1002_cov_6.596899	422	502	0	15	80	0.1875000
NODE_6577_length_1002_cov_6.596899	422	502	2	2	80	0.0250000
NODE_6577_length_1002_cov_6.596899	422	502	6	63	80	0.7875000
NODE_6577_length_1002_cov_6.596899	475	555	0	68	80	0.8500000
NODE_6577_length_1002_cov_6.596899	475	555	2	2	80	0.0250000
NODE_6577_length_1002_cov_6.596899	475	555	6	10	80	0.1250000
NODE_6588_length_1002_cov_2.102990	29	110	4	10	81	0.1234568
NODE_6588_length_1002_cov_2.102990	29	110	6	4	81	0.0493827
NODE_6588_length_1002_cov_2.102990	29	110	8	6	81	0.0740741
NODE_6588_length_1002_cov_2.102990	29	110	10	1	81	0.0123457
NODE_6588_length_1002_cov_2.102990	29	110	12	33	81	0.4074074
NODE_6588_length_1002_cov_2.102990	29	110	14	27	81	0.3333333
NODE_6596_length_1001_cov_41.914634	549	629	0	80	80	1.0000000
NODE_6596_length_1001_cov_41.914634	602	682	0	80	80	1.0000000
NODE_6597_length_1001_cov_30.378049	306	386	0	40	80	0.5000000
NODE_6597_length_1001_cov_30.378049	306	386	2	40	80	0.5000000
NODE_6597_length_1001_cov_30.378049	359	439	2	74	80	0.9250000
NODE_6597_length_1001_cov_30.378049	359	439	4	6	80	0.0750000
NODE_6597_length_1001_cov_30.378049	369	439	2	64	70	0.9142857
NODE_6597_length_1001_cov_30.378049	369	439	4	6	70	0.0857143
NODE_6597_length_1001_cov_30.378049	435	515	4	80	80	1.0000000
NODE_6597_length_1001_cov_30.378049	488	568	0	11	80	0.1375000
NODE_6597_length_1001_cov_30.378049	488	568	2	13	80	0.1625000
NODE_6597_length_1001_cov_30.378049	488	568	4	56	80	0.7000000
NODE_6598_length_1001_cov_22.517738	536	616	0	80	80	1.0000000
NODE_6598_length_1001_cov_22.517738	589	670	0	81	81	1.0000000
NODE_6599_length_1001_cov_17.996674	414	456	0	42	42	1.0000000
NODE_6599_length_1001_cov_17.996674	429	509	0	80	80	1.0000000
NODE_6599_length_1001_cov_17.996674	505	585	0	66	80	0.8250000
NODE_6599_length_1001_cov_17.996674	505	585	1	4	80	0.0500000
NODE_6599_length_1001_cov_17.996674	505	585	2	10	80	0.1250000
NODE_6599_length_1001_cov_17.996674	558	638	0	13	80	0.1625000
NODE_6599_length_1001_cov_17.996674	558	638	1	4	80	0.0500000
NODE_6599_length_1001_cov_17.996674	558	638	2	63	80	0.7875000
NODE_6600_length_1001_cov_16.798226	422	502	0	56	80	0.7000000
NODE_6600_length_1001_cov_16.798226	422	502	2	24	80	0.3000000
NODE_6600_length_1001_cov_16.798226	475	555	0	3	80	0.0375000
NODE_6600_length_1001_cov_16.798226	475	555	2	77	80	0.9625000
NODE_6600_length_1001_cov_16.798226	551	631	0	66	80	0.8250000
NODE_6600_length_1001_cov_16.798226	551	631	2	14	80	0.1750000
NODE_6600_length_1001_cov_16.798226	604	684	0	80	80	1.0000000
NODE_6601_length_1001_cov_12.778271	348	428	0	80	80	1.0000000
NODE_6601_length_1001_cov_12.778271	401	481	0	80	80	1.0000000
NODE_6602_length_1001_cov_12.305987	255	335	0	80	80	1.0000000
NODE_6602_length_1001_cov_12.305987	308	388	0	80	80	1.0000000
NODE_6603_length_1001_cov_11.955654	485	569	0	84	84	1.0000000
NODE_6603_length_1001_cov_11.955654	542	622	0	60	80	0.7500000
NODE_6603_length_1001_cov_11.955654	542	622	2	20	80	0.2500000
NODE_6604_length_1001_cov_10.156319	587	667	0	80	80	1.0000000
NODE_6604_length_1001_cov_10.156319	640	720	0	80	80	1.0000000
NODE_6605_length_1001_cov_9.754989	377	457	0	12	80	0.1500000
NODE_6605_length_1001_cov_9.754989	377	457	2	68	80	0.8500000
NODE_6605_length_1001_cov_9.754989	430	510	0	65	80	0.8125000
NODE_6605_length_1001_cov_9.754989	430	510	2	15	80	0.1875000
NODE_6607_length_1001_cov_4.616408	408	488	0	80	80	1.0000000
NODE_6607_length_1001_cov_4.616408	461	541	0	80	80	1.0000000
NODE_6616_length_1000_cov_55.578246	393	473	0	80	80	1.0000000
NODE_6616_length_1000_cov_55.578246	446	526	0	80	80	1.0000000
NODE_6616_length_1000_cov_55.578246	522	598	0	5	76	0.0657895
NODE_6616_length_1000_cov_55.578246	522	598	2	71	76	0.9342105
NODE_6616_length_1000_cov_55.578246	575	649	0	3	74	0.0405405
NODE_6616_length_1000_cov_55.578246	575	649	2	71	74	0.9594595
NODE_6617_length_1000_cov_51.534961	432	512	2	39	80	0.4875000
NODE_6617_length_1000_cov_51.534961	432	512	6	16	80	0.2000000
NODE_6617_length_1000_cov_51.534961	432	512	8	25	80	0.3125000
NODE_6617_length_1000_cov_51.534961	485	565	4	2	80	0.0250000
NODE_6617_length_1000_cov_51.534961	485	565	6	28	80	0.3500000
NODE_6617_length_1000_cov_51.534961	485	565	8	50	80	0.6250000
NODE_6617_length_1000_cov_51.534961	561	641	4	6	80	0.0750000
NODE_6617_length_1000_cov_51.534961	561	641	6	12	80	0.1500000
NODE_6617_length_1000_cov_51.534961	561	641	8	62	80	0.7750000
NODE_6617_length_1000_cov_51.534961	614	694	2	13	80	0.1625000
NODE_6617_length_1000_cov_51.534961	614	694	4	15	80	0.1875000
NODE_6617_length_1000_cov_51.534961	614	694	6	19	80	0.2375000
NODE_6617_length_1000_cov_51.534961	614	694	8	33	80	0.4125000
NODE_6618_length_1000_cov_39.011099	186	266	2	2	80	0.0250000
NODE_6618_length_1000_cov_39.011099	186	266	3	8	80	0.1000000
NODE_6618_length_1000_cov_39.011099	186	266	4	16	80	0.2000000
NODE_6618_length_1000_cov_39.011099	186	266	5	48	80	0.6000000
NODE_6618_length_1000_cov_39.011099	186	266	6	6	80	0.0750000
NODE_6618_length_1000_cov_39.011099	239	319	1	44	80	0.5500000
NODE_6618_length_1000_cov_39.011099	239	319	3	17	80	0.2125000
NODE_6618_length_1000_cov_39.011099	239	319	5	19	80	0.2375000
NODE_6619_length_1000_cov_19.897891	451	531	0	80	80	1.0000000
NODE_6619_length_1000_cov_19.897891	504	584	0	80	80	1.0000000
NODE_6619_length_1000_cov_19.897891	580	660	0	17	80	0.2125000
NODE_6619_length_1000_cov_19.897891	580	660	2	5	80	0.0625000
NODE_6619_length_1000_cov_19.897891	580	660	4	58	80	0.7250000
NODE_6619_length_1000_cov_19.897891	633	713	0	22	80	0.2750000
NODE_6619_length_1000_cov_19.897891	633	713	2	6	80	0.0750000
NODE_6619_length_1000_cov_19.897891	633	713	4	52	80	0.6500000
NODE_6620_length_1000_cov_13.349612	324	404	0	5	80	0.0625000
NODE_6620_length_1000_cov_13.349612	324	404	2	75	80	0.9375000
NODE_6620_length_1000_cov_13.349612	377	457	0	9	80	0.1125000
NODE_6620_length_1000_cov_13.349612	377	457	2	36	80	0.4500000
NODE_6620_length_1000_cov_13.349612	377	457	4	35	80	0.4375000
NODE_6621_length_1000_cov_11.463929	382	462	0	80	80	1.0000000
NODE_6621_length_1000_cov_11.463929	435	515	0	80	80	1.0000000
NODE_6622_length_1000_cov_9.675916	625	705	0	78	80	0.9750000
NODE_6622_length_1000_cov_9.675916	625	705	2	2	80	0.0250000
NODE_6622_length_1000_cov_9.675916	678	758	0	60	80	0.7500000
NODE_6622_length_1000_cov_9.675916	678	758	2	20	80	0.2500000
NODE_6623_length_1000_cov_7.051054	358	438	0	11	80	0.1375000
NODE_6623_length_1000_cov_7.051054	358	438	2	69	80	0.8625000
NODE_6623_length_1000_cov_7.051054	411	491	0	42	80	0.5250000
NODE_6623_length_1000_cov_7.051054	411	491	2	38	80	0.4750000
NODE_6626_length_1000_cov_3.652608	203	265	2	4	62	0.0645161
NODE_6626_length_1000_cov_3.652608	203	265	4	48	62	0.7741935
NODE_6626_length_1000_cov_3.652608	203	265	6	10	62	0.1612903
NODE_6639_length_999_cov_47.442222	604	684	2	17	80	0.2125000
NODE_6639_length_999_cov_47.442222	604	684	4	63	80	0.7875000
NODE_6639_length_999_cov_47.442222	657	723	2	14	66	0.2121212
NODE_6639_length_999_cov_47.442222	657	723	4	52	66	0.7878788
NODE_6640_length_999_cov_33.055556	458	540	2	36	82	0.4390244
NODE_6640_length_999_cov_33.055556	458	540	4	3	82	0.0365854
NODE_6640_length_999_cov_33.055556	458	540	6	10	82	0.1219512
NODE_6640_length_999_cov_33.055556	458	540	8	33	82	0.4024390
NODE_6640_length_999_cov_33.055556	513	593	4	5	80	0.0625000
NODE_6640_length_999_cov_33.055556	513	593	6	42	80	0.5250000
NODE_6640_length_999_cov_33.055556	513	593	8	33	80	0.4125000
NODE_6641_length_999_cov_22.755556	493	573	4	74	80	0.9250000
NODE_6641_length_999_cov_22.755556	493	573	6	6	80	0.0750000
NODE_6641_length_999_cov_22.755556	546	626	2	3	80	0.0375000
NODE_6641_length_999_cov_22.755556	546	626	4	77	80	0.9625000
NODE_6642_length_999_cov_21.842222	359	439	0	80	80	1.0000000
NODE_6642_length_999_cov_21.842222	412	492	0	80	80	1.0000000
NODE_6643_length_999_cov_20.006667	361	441	0	66	80	0.8250000
NODE_6643_length_999_cov_20.006667	361	441	2	14	80	0.1750000
NODE_6643_length_999_cov_20.006667	414	494	0	13	80	0.1625000
NODE_6643_length_999_cov_20.006667	414	494	2	17	80	0.2125000
NODE_6643_length_999_cov_20.006667	414	494	4	12	80	0.1500000
NODE_6643_length_999_cov_20.006667	414	494	6	38	80	0.4750000
NODE_6643_length_999_cov_20.006667	490	570	2	10	80	0.1250000
NODE_6643_length_999_cov_20.006667	490	570	4	57	80	0.7125000
NODE_6643_length_999_cov_20.006667	490	570	6	13	80	0.1625000
NODE_6643_length_999_cov_20.006667	543	623	0	38	80	0.4750000
NODE_6643_length_999_cov_20.006667	543	623	2	1	80	0.0125000
NODE_6643_length_999_cov_20.006667	543	623	4	41	80	0.5125000
NODE_6645_length_999_cov_16.794444	438	518	0	80	80	1.0000000
NODE_6645_length_999_cov_16.794444	491	571	0	80	80	1.0000000
NODE_6646_length_999_cov_15.146667	464	544	2	80	80	1.0000000
NODE_6646_length_999_cov_15.146667	517	597	2	43	80	0.5375000
NODE_6646_length_999_cov_15.146667	517	597	4	13	80	0.1625000
NODE_6646_length_999_cov_15.146667	517	597	5	23	80	0.2875000
NODE_6646_length_999_cov_15.146667	517	597	6	1	80	0.0125000
NODE_6648_length_999_cov_8.771111	361	441	0	80	80	1.0000000
NODE_6648_length_999_cov_8.771111	414	492	0	38	78	0.4871795
NODE_6648_length_999_cov_8.771111	414	492	2	40	78	0.5128205
NODE_6649_length_999_cov_5.171111	417	497	0	80	80	1.0000000
NODE_6649_length_999_cov_5.171111	470	550	0	41	80	0.5125000
NODE_6649_length_999_cov_5.171111	470	550	2	39	80	0.4875000
NODE_6650_length_999_cov_2.854444	35	101	2	62	66	0.9393939
NODE_6650_length_999_cov_2.854444	35	101	4	2	66	0.0303030
NODE_6650_length_999_cov_2.854444	35	101	6	2	66	0.0303030
NODE_6657_length_998_cov_30.697442	404	484	0	80	80	1.0000000
NODE_6657_length_998_cov_30.697442	457	537	0	80	80	1.0000000
NODE_6657_length_998_cov_30.697442	533	613	0	80	80	1.0000000
NODE_6657_length_998_cov_30.697442	586	666	0	80	80	1.0000000
NODE_6658_length_998_cov_23.703003	235	315	0	4	80	0.0500000
NODE_6658_length_998_cov_23.703003	235	315	1	1	80	0.0125000
NODE_6658_length_998_cov_23.703003	235	315	2	23	80	0.2875000
NODE_6658_length_998_cov_23.703003	235	315	6	35	80	0.4375000
NODE_6658_length_998_cov_23.703003	235	315	8	17	80	0.2125000
NODE_6658_length_998_cov_23.703003	288	368	2	18	80	0.2250000
NODE_6658_length_998_cov_23.703003	288	368	6	31	80	0.3875000
NODE_6658_length_998_cov_23.703003	288	368	8	31	80	0.3875000
NODE_6659_length_998_cov_22.692992	531	611	2	80	80	1.0000000
NODE_6659_length_998_cov_22.692992	584	664	0	17	80	0.2125000
NODE_6659_length_998_cov_22.692992	584	664	2	63	80	0.7875000
NODE_6660_length_998_cov_11.152392	514	594	0	8	80	0.1000000
NODE_6660_length_998_cov_11.152392	514	594	2	72	80	0.9000000
NODE_6660_length_998_cov_11.152392	567	640	0	54	73	0.7397260
NODE_6660_length_998_cov_11.152392	567	640	2	19	73	0.2602740
NODE_6660_length_998_cov_11.152392	636	716	0	80	80	1.0000000
NODE_6660_length_998_cov_11.152392	689	769	0	80	80	1.0000000
NODE_6661_length_998_cov_10.061179	422	502	0	8	80	0.1000000
NODE_6661_length_998_cov_10.061179	422	502	2	1	80	0.0125000
NODE_6661_length_998_cov_10.061179	422	502	4	49	80	0.6125000
NODE_6661_length_998_cov_10.061179	422	502	6	22	80	0.2750000
NODE_6661_length_998_cov_10.061179	475	555	4	8	80	0.1000000
NODE_6661_length_998_cov_10.061179	475	555	6	72	80	0.9000000
NODE_6662_length_998_cov_7.126808	353	430	0	77	77	1.0000000
NODE_6662_length_998_cov_7.126808	403	483	0	80	80	1.0000000
NODE_6669_length_997_cov_48.518931	445	525	0	31	80	0.3875000
NODE_6669_length_997_cov_48.518931	445	525	3	5	80	0.0625000
NODE_6669_length_997_cov_48.518931	445	525	5	44	80	0.5500000
NODE_6669_length_997_cov_48.518931	498	578	4	4	80	0.0500000
NODE_6669_length_997_cov_48.518931	498	578	5	41	80	0.5125000
NODE_6669_length_997_cov_48.518931	498	578	6	35	80	0.4375000
NODE_6670_length_997_cov_36.721604	400	480	5	3	80	0.0375000
NODE_6670_length_997_cov_36.721604	400	480	6	77	80	0.9625000
NODE_6670_length_997_cov_36.721604	453	533	0	30	80	0.3750000
NODE_6670_length_997_cov_36.721604	453	533	6	50	80	0.6250000
NODE_6671_length_997_cov_22.646993	328	408	0	25	80	0.3125000
NODE_6671_length_997_cov_22.646993	328	408	4	13	80	0.1625000
NODE_6671_length_997_cov_22.646993	328	408	8	42	80	0.5250000
NODE_6671_length_997_cov_22.646993	381	461	6	13	80	0.1625000
NODE_6671_length_997_cov_22.646993	381	461	8	61	80	0.7625000
NODE_6671_length_997_cov_22.646993	381	461	10	6	80	0.0750000
NODE_6672_length_997_cov_19.709354	420	500	0	80	80	1.0000000
NODE_6672_length_997_cov_19.709354	473	553	0	80	80	1.0000000
NODE_6672_length_997_cov_19.709354	549	629	0	80	80	1.0000000
NODE_6672_length_997_cov_19.709354	602	682	0	80	80	1.0000000
NODE_6673_length_997_cov_17.947661	465	545	0	55	80	0.6875000
NODE_6673_length_997_cov_17.947661	465	545	2	25	80	0.3125000
NODE_6673_length_997_cov_17.947661	518	598	0	80	80	1.0000000
NODE_6673_length_997_cov_17.947661	594	674	0	15	80	0.1875000
NODE_6673_length_997_cov_17.947661	594	674	2	65	80	0.8125000
NODE_6673_length_997_cov_17.947661	647	727	0	30	80	0.3750000
NODE_6673_length_997_cov_17.947661	647	727	2	50	80	0.6250000
NODE_6674_length_997_cov_14.718263	388	468	0	14	80	0.1750000
NODE_6674_length_997_cov_14.718263	388	468	1	66	80	0.8250000
NODE_6674_length_997_cov_14.718263	441	521	1	27	80	0.3375000
NODE_6674_length_997_cov_14.718263	441	521	3	28	80	0.3500000
NODE_6674_length_997_cov_14.718263	441	521	5	20	80	0.2500000
NODE_6674_length_997_cov_14.718263	441	521	6	5	80	0.0625000
NODE_6675_length_997_cov_7.114699	307	387	0	49	80	0.6125000
NODE_6675_length_997_cov_7.114699	307	387	4	5	80	0.0625000
NODE_6675_length_997_cov_7.114699	307	387	6	26	80	0.3250000
NODE_6675_length_997_cov_7.114699	360	440	4	8	80	0.1000000
NODE_6675_length_997_cov_7.114699	360	440	6	72	80	0.9000000
NODE_6694_length_996_cov_59.568562	387	467	0	79	80	0.9875000
NODE_6694_length_996_cov_59.568562	387	467	2	1	80	0.0125000
NODE_6694_length_996_cov_59.568562	440	520	0	26	80	0.3250000
NODE_6694_length_996_cov_59.568562	440	520	2	54	80	0.6750000
NODE_6695_length_996_cov_32.462653	503	583	4	6	80	0.0750000
NODE_6695_length_996_cov_32.462653	503	583	8	19	80	0.2375000
NODE_6695_length_996_cov_32.462653	503	583	10	20	80	0.2500000
NODE_6695_length_996_cov_32.462653	503	583	12	35	80	0.4375000
NODE_6695_length_996_cov_32.462653	556	636	8	20	80	0.2500000
NODE_6695_length_996_cov_32.462653	556	636	10	18	80	0.2250000
NODE_6695_length_996_cov_32.462653	556	636	12	42	80	0.5250000
NODE_6696_length_996_cov_23.312152	571	651	2	80	80	1.0000000
NODE_6696_length_996_cov_23.312152	624	704	0	33	80	0.4125000
NODE_6696_length_996_cov_23.312152	624	704	2	47	80	0.5875000
NODE_6697_length_996_cov_20.979933	533	613	6	10	80	0.1250000
NODE_6697_length_996_cov_20.979933	533	613	8	70	80	0.8750000
NODE_6697_length_996_cov_20.979933	586	666	0	35	80	0.4375000
NODE_6697_length_996_cov_20.979933	586	666	3	1	80	0.0125000
NODE_6697_length_996_cov_20.979933	586	666	4	6	80	0.0750000
NODE_6697_length_996_cov_20.979933	586	666	5	1	80	0.0125000
NODE_6697_length_996_cov_20.979933	586	666	8	37	80	0.4625000
NODE_6698_length_996_cov_17.865106	535	615	0	40	80	0.5000000
NODE_6698_length_996_cov_17.865106	535	615	2	40	80	0.5000000
NODE_6698_length_996_cov_17.865106	588	668	2	60	80	0.7500000
NODE_6698_length_996_cov_17.865106	588	668	4	20	80	0.2500000
NODE_6699_length_996_cov_10.297659	499	579	6	6	80	0.0750000
NODE_6699_length_996_cov_10.297659	499	579	12	14	80	0.1750000
NODE_6699_length_996_cov_10.297659	499	579	16	1	80	0.0125000
NODE_6699_length_996_cov_10.297659	499	579	21	2	80	0.0250000
NODE_6699_length_996_cov_10.297659	499	579	22	57	80	0.7125000
NODE_6699_length_996_cov_10.297659	552	630	0	15	78	0.1923077
NODE_6699_length_996_cov_10.297659	552	630	10	3	78	0.0384615
NODE_6699_length_996_cov_10.297659	552	630	16	34	78	0.4358974
NODE_6699_length_996_cov_10.297659	552	630	22	26	78	0.3333333
NODE_6702_length_996_cov_3.205128	499	555	0	31	56	0.5535714
NODE_6702_length_996_cov_3.205128	499	555	2	25	56	0.4464286
NODE_6707_length_995_cov_26.131696	543	623	12	26	80	0.3250000
NODE_6707_length_995_cov_26.131696	543	623	14	40	80	0.5000000
NODE_6707_length_995_cov_26.131696	543	623	16	14	80	0.1750000
NODE_6707_length_995_cov_26.131696	596	676	0	51	80	0.6375000
NODE_6707_length_995_cov_26.131696	596	676	4	1	80	0.0125000
NODE_6707_length_995_cov_26.131696	596	676	12	27	80	0.3375000
NODE_6707_length_995_cov_26.131696	596	676	14	1	80	0.0125000
NODE_6708_length_995_cov_20.262277	457	537	6	23	80	0.2875000
NODE_6708_length_995_cov_20.262277	457	537	8	39	80	0.4875000
NODE_6708_length_995_cov_20.262277	457	537	10	18	80	0.2250000
NODE_6708_length_995_cov_20.262277	510	590	0	16	80	0.2000000
NODE_6708_length_995_cov_20.262277	510	590	2	23	80	0.2875000
NODE_6708_length_995_cov_20.262277	510	590	4	8	80	0.1000000
NODE_6708_length_995_cov_20.262277	510	590	6	14	80	0.1750000
NODE_6708_length_995_cov_20.262277	510	590	8	11	80	0.1375000
NODE_6708_length_995_cov_20.262277	510	590	10	8	80	0.1000000
NODE_6709_length_995_cov_19.382812	457	537	0	57	80	0.7125000
NODE_6709_length_995_cov_19.382812	457	537	2	23	80	0.2875000
NODE_6709_length_995_cov_19.382812	510	590	0	4	80	0.0500000
NODE_6709_length_995_cov_19.382812	510	590	2	76	80	0.9500000
NODE_6710_length_995_cov_19.034598	453	533	0	80	80	1.0000000
NODE_6710_length_995_cov_19.034598	506	586	0	80	80	1.0000000
NODE_6711_length_995_cov_9.734375	222	323	0	101	101	1.0000000
NODE_6711_length_995_cov_9.734375	296	376	0	80	80	1.0000000
NODE_6723_length_994_cov_74.678212	362	442	0	5	80	0.0625000
NODE_6723_length_994_cov_74.678212	362	442	2	14	80	0.1750000
NODE_6723_length_994_cov_74.678212	362	442	4	35	80	0.4375000
NODE_6723_length_994_cov_74.678212	362	442	5	6	80	0.0750000
NODE_6723_length_994_cov_74.678212	362	442	6	20	80	0.2500000
NODE_6723_length_994_cov_74.678212	415	495	0	38	80	0.4750000
NODE_6723_length_994_cov_74.678212	415	495	2	34	80	0.4250000
NODE_6723_length_994_cov_74.678212	415	495	4	8	80	0.1000000
NODE_6723_length_994_cov_74.678212	491	571	2	43	80	0.5375000
NODE_6723_length_994_cov_74.678212	491	571	4	37	80	0.4625000
NODE_6723_length_994_cov_74.678212	544	624	0	48	80	0.6000000
NODE_6723_length_994_cov_74.678212	544	624	2	26	80	0.3250000
NODE_6723_length_994_cov_74.678212	544	624	4	6	80	0.0750000
NODE_6724_length_994_cov_26.045810	442	522	0	49	80	0.6125000
NODE_6724_length_994_cov_26.045810	442	522	2	31	80	0.3875000
NODE_6724_length_994_cov_26.045810	495	575	2	80	80	1.0000000
NODE_6725_length_994_cov_25.240223	504	584	4	2	80	0.0250000
NODE_6725_length_994_cov_25.240223	504	584	8	35	80	0.4375000
NODE_6725_length_994_cov_25.240223	504	584	10	43	80	0.5375000
NODE_6725_length_994_cov_25.240223	557	637	0	36	80	0.4500000
NODE_6725_length_994_cov_25.240223	557	637	2	3	80	0.0375000
NODE_6725_length_994_cov_25.240223	557	637	4	16	80	0.2000000
NODE_6725_length_994_cov_25.240223	557	637	8	13	80	0.1625000
NODE_6725_length_994_cov_25.240223	557	637	10	12	80	0.1500000
NODE_6726_length_994_cov_24.615642	422	502	0	80	80	1.0000000
NODE_6726_length_994_cov_24.615642	475	555	0	80	80	1.0000000
NODE_6726_length_994_cov_24.615642	551	631	0	22	80	0.2750000
NODE_6726_length_994_cov_24.615642	551	631	1	27	80	0.3375000
NODE_6726_length_994_cov_24.615642	551	631	2	31	80	0.3875000
NODE_6726_length_994_cov_24.615642	604	684	2	80	80	1.0000000
NODE_6727_length_994_cov_22.593296	323	403	0	80	80	1.0000000
NODE_6727_length_994_cov_22.593296	376	456	0	80	80	1.0000000
NODE_6727_length_994_cov_22.593296	452	532	0	80	80	1.0000000
NODE_6727_length_994_cov_22.593296	505	585	0	80	80	1.0000000
NODE_6728_length_994_cov_6.985475	0	58	0	58	58	1.0000000
NODE_6728_length_994_cov_6.985475	15	95	0	80	80	1.0000000
NODE_6728_length_994_cov_6.985475	68	148	0	80	80	1.0000000
NODE_6740_length_993_cov_56.321029	266	346	0	80	80	1.0000000
NODE_6740_length_993_cov_56.321029	319	399	0	80	80	1.0000000
NODE_6740_length_993_cov_56.321029	400	470	0	70	70	1.0000000
NODE_6740_length_993_cov_56.321029	443	523	0	80	80	1.0000000
NODE_6741_length_993_cov_44.695749	385	465	0	80	80	1.0000000
NODE_6741_length_993_cov_44.695749	438	518	0	80	80	1.0000000
NODE_6742_length_993_cov_40.574944	417	497	0	11	80	0.1375000
NODE_6742_length_993_cov_40.574944	417	497	2	27	80	0.3375000
NODE_6742_length_993_cov_40.574944	417	497	4	42	80	0.5250000
NODE_6742_length_993_cov_40.574944	470	550	0	64	80	0.8000000
NODE_6742_length_993_cov_40.574944	470	550	2	16	80	0.2000000
NODE_6742_length_993_cov_40.574944	546	628	0	34	82	0.4146341
NODE_6742_length_993_cov_40.574944	546	628	3	1	82	0.0121951
NODE_6742_length_993_cov_40.574944	546	628	10	47	82	0.5731707
NODE_6742_length_993_cov_40.574944	601	681	10	34	80	0.4250000
NODE_6742_length_993_cov_40.574944	601	681	12	46	80	0.5750000
NODE_6743_length_993_cov_39.817673	3	83	0	15	80	0.1875000
NODE_6743_length_993_cov_39.817673	3	83	2	1	80	0.0125000
NODE_6743_length_993_cov_39.817673	3	83	6	64	80	0.8000000
NODE_6744_length_993_cov_30.128635	477	557	2	13	80	0.1625000
NODE_6744_length_993_cov_30.128635	477	557	4	5	80	0.0625000
NODE_6744_length_993_cov_30.128635	477	557	6	35	80	0.4375000
NODE_6744_length_993_cov_30.128635	477	557	8	27	80	0.3375000
NODE_6744_length_993_cov_30.128635	530	610	0	1	80	0.0125000
NODE_6744_length_993_cov_30.128635	530	610	2	19	80	0.2375000
NODE_6744_length_993_cov_30.128635	530	610	4	1	80	0.0125000
NODE_6744_length_993_cov_30.128635	530	610	6	3	80	0.0375000
NODE_6744_length_993_cov_30.128635	530	610	8	56	80	0.7000000
NODE_6745_length_993_cov_17.435123	573	653	0	80	80	1.0000000
NODE_6745_length_993_cov_17.435123	626	706	0	80	80	1.0000000
NODE_6746_length_993_cov_13.074944	483	563	0	6	80	0.0750000
NODE_6746_length_993_cov_13.074944	483	563	2	74	80	0.9250000
NODE_6746_length_993_cov_13.074944	536	616	0	15	80	0.1875000
NODE_6746_length_993_cov_13.074944	536	616	2	65	80	0.8125000
NODE_6747_length_993_cov_10.190157	500	580	0	2	80	0.0250000
NODE_6747_length_993_cov_10.190157	500	580	2	47	80	0.5875000
NODE_6747_length_993_cov_10.190157	500	580	6	31	80	0.3875000
NODE_6747_length_993_cov_10.190157	553	633	4	34	80	0.4250000
NODE_6747_length_993_cov_10.190157	553	633	5	4	80	0.0500000
NODE_6747_length_993_cov_10.190157	553	633	6	42	80	0.5250000
NODE_6756_length_993_cov_0.909396	16	73	0	57	57	1.0000000
NODE_6757_length_992_cov_36.119821	354	434	0	80	80	1.0000000
NODE_6757_length_992_cov_36.119821	407	487	0	80	80	1.0000000
NODE_6757_length_992_cov_36.119821	483	563	0	50	80	0.6250000
NODE_6757_length_992_cov_36.119821	483	563	2	23	80	0.2875000
NODE_6757_length_992_cov_36.119821	483	563	4	7	80	0.0875000
NODE_6757_length_992_cov_36.119821	536	616	2	20	80	0.2500000
NODE_6757_length_992_cov_36.119821	536	616	4	60	80	0.7500000
NODE_6758_length_992_cov_34.802912	443	523	0	11	80	0.1375000
NODE_6758_length_992_cov_34.802912	443	523	1	2	80	0.0250000
NODE_6758_length_992_cov_34.802912	443	523	3	67	80	0.8375000
NODE_6758_length_992_cov_34.802912	496	576	1	6	80	0.0750000
NODE_6758_length_992_cov_34.802912	496	576	2	14	80	0.1750000
NODE_6758_length_992_cov_34.802912	496	576	3	60	80	0.7500000
NODE_6759_length_992_cov_33.047032	381	461	0	22	80	0.2750000
NODE_6759_length_992_cov_33.047032	381	461	2	58	80	0.7250000
NODE_6759_length_992_cov_33.047032	434	514	0	75	80	0.9375000
NODE_6759_length_992_cov_33.047032	434	514	2	5	80	0.0625000
NODE_6759_length_992_cov_33.047032	510	590	0	80	80	1.0000000
NODE_6759_length_992_cov_33.047032	563	643	0	80	80	1.0000000
NODE_6760_length_992_cov_23.543113	435	515	2	35	80	0.4375000
NODE_6760_length_992_cov_23.543113	435	515	6	35	80	0.4375000
NODE_6760_length_992_cov_23.543113	435	515	8	10	80	0.1250000
NODE_6760_length_992_cov_23.543113	488	568	0	1	80	0.0125000
NODE_6760_length_992_cov_23.543113	488	568	5	1	80	0.0125000
NODE_6760_length_992_cov_23.543113	488	568	6	78	80	0.9750000
NODE_6761_length_992_cov_22.608063	440	520	0	80	80	1.0000000
NODE_6761_length_992_cov_22.608063	493	573	0	62	80	0.7750000
NODE_6761_length_992_cov_22.608063	493	573	2	18	80	0.2250000
NODE_6762_length_992_cov_21.427772	216	296	0	80	80	1.0000000
NODE_6762_length_992_cov_21.427772	269	349	0	80	80	1.0000000
NODE_6763_length_992_cov_20.010078	312	392	0	14	80	0.1750000
NODE_6763_length_992_cov_20.010078	312	392	1	3	80	0.0375000
NODE_6763_length_992_cov_20.010078	312	392	2	63	80	0.7875000
NODE_6763_length_992_cov_20.010078	365	445	2	80	80	1.0000000
NODE_6764_length_992_cov_16.524076	465	545	0	80	80	1.0000000
NODE_6764_length_992_cov_16.524076	518	598	0	80	80	1.0000000
NODE_6765_length_992_cov_16.266517	396	476	0	55	80	0.6875000
NODE_6765_length_992_cov_16.266517	396	476	2	25	80	0.3125000
NODE_6765_length_992_cov_16.266517	449	529	0	10	80	0.1250000
NODE_6765_length_992_cov_16.266517	449	529	2	70	80	0.8750000
NODE_6766_length_992_cov_16.146697	272	352	0	18	80	0.2250000
NODE_6766_length_992_cov_16.146697	272	352	2	62	80	0.7750000
NODE_6766_length_992_cov_16.146697	325	405	2	80	80	1.0000000
NODE_6767_length_992_cov_15.212766	354	434	0	80	80	1.0000000
NODE_6767_length_992_cov_15.212766	407	487	0	80	80	1.0000000
NODE_6767_length_992_cov_15.212766	483	563	0	11	80	0.1375000
NODE_6767_length_992_cov_15.212766	483	563	4	24	80	0.3000000
NODE_6767_length_992_cov_15.212766	483	563	8	10	80	0.1250000
NODE_6767_length_992_cov_15.212766	483	563	10	35	80	0.4375000
NODE_6767_length_992_cov_15.212766	536	616	10	39	80	0.4875000
NODE_6767_length_992_cov_15.212766	536	616	12	11	80	0.1375000
NODE_6767_length_992_cov_15.212766	536	616	14	30	80	0.3750000
NODE_6781_length_991_cov_48.582960	451	531	0	42	80	0.5250000
NODE_6781_length_991_cov_48.582960	451	531	8	38	80	0.4750000
NODE_6781_length_991_cov_48.582960	504	584	7	32	80	0.4000000
NODE_6781_length_991_cov_48.582960	504	584	8	47	80	0.5875000
NODE_6781_length_991_cov_48.582960	504	584	9	1	80	0.0125000
NODE_6782_length_991_cov_25.891256	340	420	0	80	80	1.0000000
NODE_6782_length_991_cov_25.891256	393	473	0	80	80	1.0000000
NODE_6782_length_991_cov_25.891256	469	549	0	80	80	1.0000000
NODE_6782_length_991_cov_25.891256	522	602	0	80	80	1.0000000
NODE_6783_length_991_cov_25.392377	377	457	0	19	80	0.2375000
NODE_6783_length_991_cov_25.392377	377	457	2	11	80	0.1375000
NODE_6783_length_991_cov_25.392377	377	457	4	6	80	0.0750000
NODE_6783_length_991_cov_25.392377	377	457	6	33	80	0.4125000
NODE_6783_length_991_cov_25.392377	377	457	8	9	80	0.1125000
NODE_6783_length_991_cov_25.392377	377	457	10	2	80	0.0250000
NODE_6783_length_991_cov_25.392377	430	510	4	2	80	0.0250000
NODE_6783_length_991_cov_25.392377	430	510	6	40	80	0.5000000
NODE_6783_length_991_cov_25.392377	430	510	7	3	80	0.0375000
NODE_6783_length_991_cov_25.392377	430	510	8	9	80	0.1125000
NODE_6783_length_991_cov_25.392377	430	510	9	12	80	0.1500000
NODE_6783_length_991_cov_25.392377	430	510	10	14	80	0.1750000
NODE_6783_length_991_cov_25.392377	506	586	2	30	80	0.3750000
NODE_6783_length_991_cov_25.392377	506	586	4	48	80	0.6000000
NODE_6783_length_991_cov_25.392377	506	586	6	2	80	0.0250000
NODE_6783_length_991_cov_25.392377	559	639	2	80	80	1.0000000
NODE_6784_length_991_cov_22.210762	421	501	0	22	80	0.2750000
NODE_6784_length_991_cov_22.210762	421	501	13	1	80	0.0125000
NODE_6784_length_991_cov_22.210762	421	501	14	35	80	0.4375000
NODE_6784_length_991_cov_22.210762	421	501	16	22	80	0.2750000
NODE_6784_length_991_cov_22.210762	474	554	14	22	80	0.2750000
NODE_6784_length_991_cov_22.210762	474	554	16	58	80	0.7250000
NODE_6785_length_991_cov_18.008969	366	446	0	80	80	1.0000000
NODE_6785_length_991_cov_18.008969	419	499	0	80	80	1.0000000
NODE_6785_length_991_cov_18.008969	495	575	0	80	80	1.0000000
NODE_6785_length_991_cov_18.008969	548	629	0	81	81	1.0000000
NODE_6786_length_991_cov_14.727578	426	506	4	10	80	0.1250000
NODE_6786_length_991_cov_14.727578	426	506	6	3	80	0.0375000
NODE_6786_length_991_cov_14.727578	426	506	8	3	80	0.0375000
NODE_6786_length_991_cov_14.727578	426	506	10	12	80	0.1500000
NODE_6786_length_991_cov_14.727578	426	506	12	16	80	0.2000000
NODE_6786_length_991_cov_14.727578	426	506	14	8	80	0.1000000
NODE_6786_length_991_cov_14.727578	426	506	16	14	80	0.1750000
NODE_6786_length_991_cov_14.727578	426	506	17	8	80	0.1000000
NODE_6786_length_991_cov_14.727578	426	506	19	6	80	0.0750000
NODE_6786_length_991_cov_14.727578	479	559	4	4	80	0.0500000
NODE_6786_length_991_cov_14.727578	479	559	6	1	80	0.0125000
NODE_6786_length_991_cov_14.727578	479	559	10	1	80	0.0125000
NODE_6786_length_991_cov_14.727578	479	559	12	8	80	0.1000000
NODE_6786_length_991_cov_14.727578	479	559	13	15	80	0.1875000
NODE_6786_length_991_cov_14.727578	479	559	14	2	80	0.0250000
NODE_6786_length_991_cov_14.727578	479	559	15	19	80	0.2375000
NODE_6786_length_991_cov_14.727578	479	559	16	13	80	0.1625000
NODE_6786_length_991_cov_14.727578	479	559	17	11	80	0.1375000
NODE_6786_length_991_cov_14.727578	479	559	19	6	80	0.0750000
NODE_6787_length_991_cov_13.081839	240	320	0	80	80	1.0000000
NODE_6787_length_991_cov_13.081839	293	373	0	80	80	1.0000000
NODE_6788_length_991_cov_12.693946	425	505	0	76	80	0.9500000
NODE_6788_length_991_cov_12.693946	425	505	2	4	80	0.0500000
NODE_6788_length_991_cov_12.693946	478	558	0	23	80	0.2875000
NODE_6788_length_991_cov_12.693946	478	558	2	57	80	0.7125000
NODE_6789_length_991_cov_9.647982	436	516	0	43	80	0.5375000
NODE_6789_length_991_cov_9.647982	436	516	2	37	80	0.4625000
NODE_6789_length_991_cov_9.647982	489	569	0	20	80	0.2500000
NODE_6789_length_991_cov_9.647982	489	569	2	60	80	0.7500000
NODE_6790_length_991_cov_5.176009	538	618	2	80	80	1.0000000
NODE_6790_length_991_cov_5.176009	591	671	0	48	80	0.6000000
NODE_6790_length_991_cov_5.176009	591	671	2	32	80	0.4000000
NODE_6801_length_990_cov_39.386083	402	482	0	80	80	1.0000000
NODE_6801_length_990_cov_39.386083	455	535	0	80	80	1.0000000
NODE_6802_length_990_cov_35.993266	321	401	0	80	80	1.0000000
NODE_6802_length_990_cov_35.993266	374	454	0	80	80	1.0000000
NODE_6802_length_990_cov_35.993266	450	530	0	80	80	1.0000000
NODE_6802_length_990_cov_35.993266	503	583	0	80	80	1.0000000
NODE_6803_length_990_cov_24.445567	588	668	4	1	80	0.0125000
NODE_6803_length_990_cov_24.445567	588	668	6	79	80	0.9875000
NODE_6803_length_990_cov_24.445567	641	721	0	38	80	0.4750000
NODE_6803_length_990_cov_24.445567	641	721	4	16	80	0.2000000
NODE_6803_length_990_cov_24.445567	641	721	6	26	80	0.3250000
NODE_6805_length_990_cov_22.378227	430	510	0	80	80	1.0000000
NODE_6805_length_990_cov_22.378227	483	563	0	80	80	1.0000000
NODE_6806_length_990_cov_20.150393	408	488	2	17	80	0.2125000
NODE_6806_length_990_cov_20.150393	408	488	4	62	80	0.7750000
NODE_6806_length_990_cov_20.150393	408	488	6	1	80	0.0125000
NODE_6806_length_990_cov_20.150393	461	541	2	70	80	0.8750000
NODE_6806_length_990_cov_20.150393	461	541	4	9	80	0.1125000
NODE_6806_length_990_cov_20.150393	461	541	6	1	80	0.0125000
NODE_6807_length_990_cov_18.154882	434	514	8	50	80	0.6250000
NODE_6807_length_990_cov_18.154882	434	514	12	30	80	0.3750000
NODE_6807_length_990_cov_18.154882	487	567	4	39	80	0.4875000
NODE_6807_length_990_cov_18.154882	487	567	12	41	80	0.5125000
NODE_6808_length_990_cov_17.250281	329	409	0	80	80	1.0000000
NODE_6808_length_990_cov_17.250281	382	462	0	69	80	0.8625000
NODE_6808_length_990_cov_17.250281	382	462	2	1	80	0.0125000
NODE_6808_length_990_cov_17.250281	382	462	4	10	80	0.1250000
NODE_6808_length_990_cov_17.250281	458	538	2	15	80	0.1875000
NODE_6808_length_990_cov_17.250281	458	538	4	65	80	0.8125000
NODE_6808_length_990_cov_17.250281	511	591	0	11	80	0.1375000
NODE_6808_length_990_cov_17.250281	511	591	2	57	80	0.7125000
NODE_6808_length_990_cov_17.250281	511	591	4	12	80	0.1500000
NODE_6809_length_990_cov_14.977553	448	528	0	80	80	1.0000000
NODE_6809_length_990_cov_14.977553	501	581	0	80	80	1.0000000
NODE_6810_length_990_cov_13.846240	482	562	2	80	80	1.0000000
NODE_6810_length_990_cov_13.846240	535	615	0	18	80	0.2250000
NODE_6810_length_990_cov_13.846240	535	615	2	62	80	0.7750000
NODE_6821_length_990_cov_0.978676	79	151	0	6	72	0.0833333
NODE_6821_length_990_cov_0.978676	79	151	2	9	72	0.1250000
NODE_6821_length_990_cov_0.978676	79	151	4	57	72	0.7916667
NODE_6821_length_990_cov_0.978676	82	152	0	7	70	0.1000000
NODE_6821_length_990_cov_0.978676	82	152	2	9	70	0.1285714
NODE_6821_length_990_cov_0.978676	82	152	4	54	70	0.7714286
NODE_6823_length_989_cov_45.902247	47	127	12	1	80	0.0125000
NODE_6823_length_989_cov_45.902247	47	127	20	1	80	0.0125000
NODE_6823_length_989_cov_45.902247	47	127	26	1	80	0.0125000
NODE_6823_length_989_cov_45.902247	47	127	28	1	80	0.0125000
NODE_6823_length_989_cov_45.902247	47	127	30	4	80	0.0500000
NODE_6823_length_989_cov_45.902247	47	127	36	2	80	0.0250000
NODE_6823_length_989_cov_45.902247	47	127	40	1	80	0.0125000
NODE_6823_length_989_cov_45.902247	47	127	42	4	80	0.0500000
NODE_6823_length_989_cov_45.902247	47	127	46	1	80	0.0125000
NODE_6823_length_989_cov_45.902247	47	127	48	1	80	0.0125000
NODE_6823_length_989_cov_45.902247	47	127	50	2	80	0.0250000
NODE_6823_length_989_cov_45.902247	47	127	52	2	80	0.0250000
NODE_6823_length_989_cov_45.902247	47	127	54	1	80	0.0125000
NODE_6823_length_989_cov_45.902247	47	127	60	2	80	0.0250000
NODE_6823_length_989_cov_45.902247	47	127	62	56	80	0.7000000
NODE_6823_length_989_cov_45.902247	330	410	0	69	80	0.8625000
NODE_6823_length_989_cov_45.902247	330	410	2	11	80	0.1375000
NODE_6823_length_989_cov_45.902247	383	463	0	16	80	0.2000000
NODE_6823_length_989_cov_45.902247	383	463	2	64	80	0.8000000
NODE_6824_length_989_cov_35.430337	412	492	0	7	80	0.0875000
NODE_6824_length_989_cov_35.430337	412	492	2	30	80	0.3750000
NODE_6824_length_989_cov_35.430337	412	492	4	43	80	0.5375000
NODE_6824_length_989_cov_35.430337	465	545	2	57	80	0.7125000
NODE_6824_length_989_cov_35.430337	465	545	4	23	80	0.2875000
NODE_6825_length_989_cov_30.124719	477	557	2	8	80	0.1000000
NODE_6825_length_989_cov_30.124719	477	557	4	72	80	0.9000000
NODE_6825_length_989_cov_30.124719	530	610	0	27	80	0.3375000
NODE_6825_length_989_cov_30.124719	530	610	2	8	80	0.1000000
NODE_6825_length_989_cov_30.124719	530	610	4	45	80	0.5625000
NODE_6826_length_989_cov_29.347191	447	527	0	80	80	1.0000000
NODE_6826_length_989_cov_29.347191	500	580	0	80	80	1.0000000
NODE_6826_length_989_cov_29.347191	576	656	0	80	80	1.0000000
NODE_6826_length_989_cov_29.347191	629	709	0	80	80	1.0000000
NODE_6827_length_989_cov_27.886517	245	325	2	16	80	0.2000000
NODE_6827_length_989_cov_27.886517	245	325	4	64	80	0.8000000
NODE_6827_length_989_cov_27.886517	298	378	0	6	80	0.0750000
NODE_6827_length_989_cov_27.886517	298	378	2	52	80	0.6500000
NODE_6827_length_989_cov_27.886517	298	378	4	22	80	0.2750000
NODE_6827_length_989_cov_27.886517	374	454	0	24	80	0.3000000
NODE_6827_length_989_cov_27.886517	374	454	2	56	80	0.7000000
NODE_6827_length_989_cov_27.886517	427	507	0	24	80	0.3000000
NODE_6827_length_989_cov_27.886517	427	507	2	56	80	0.7000000
NODE_6828_length_989_cov_27.515730	393	473	2	19	80	0.2375000
NODE_6828_length_989_cov_27.515730	393	473	3	5	80	0.0625000
NODE_6828_length_989_cov_27.515730	393	473	4	56	80	0.7000000
NODE_6828_length_989_cov_27.515730	446	526	2	72	80	0.9000000
NODE_6828_length_989_cov_27.515730	446	526	4	8	80	0.1000000
NODE_6828_length_989_cov_27.515730	522	602	0	54	80	0.6750000
NODE_6828_length_989_cov_27.515730	522	602	1	7	80	0.0875000
NODE_6828_length_989_cov_27.515730	522	602	2	19	80	0.2375000
NODE_6828_length_989_cov_27.515730	575	655	0	80	80	1.0000000
NODE_6829_length_989_cov_23.844944	312	392	1	13	80	0.1625000
NODE_6829_length_989_cov_23.844944	312	392	2	18	80	0.2250000
NODE_6829_length_989_cov_23.844944	312	392	5	40	80	0.5000000
NODE_6829_length_989_cov_23.844944	312	392	7	9	80	0.1125000
NODE_6829_length_989_cov_23.844944	365	445	1	10	80	0.1250000
NODE_6829_length_989_cov_23.844944	365	445	2	70	80	0.8750000
NODE_6830_length_989_cov_23.131461	475	555	0	80	80	1.0000000
NODE_6830_length_989_cov_23.131461	528	608	0	80	80	1.0000000
NODE_6831_length_989_cov_20.189888	500	580	0	46	80	0.5750000
NODE_6831_length_989_cov_20.189888	500	580	2	34	80	0.4250000
NODE_6831_length_989_cov_20.189888	553	633	0	35	80	0.4375000
NODE_6831_length_989_cov_20.189888	553	633	2	45	80	0.5625000
NODE_6832_length_989_cov_18.429213	190	270	0	80	80	1.0000000
NODE_6832_length_989_cov_18.429213	258	323	0	58	65	0.8923077
NODE_6832_length_989_cov_18.429213	258	323	2	7	65	0.1076923
NODE_6832_length_989_cov_18.429213	319	399	2	79	80	0.9875000
NODE_6832_length_989_cov_18.429213	319	399	4	1	80	0.0125000
NODE_6832_length_989_cov_18.429213	372	412	2	26	40	0.6500000
NODE_6832_length_989_cov_18.429213	372	412	4	14	40	0.3500000
NODE_6833_length_989_cov_10.307865	433	513	0	80	80	1.0000000
NODE_6833_length_989_cov_10.307865	486	570	0	84	84	1.0000000
NODE_6833_length_989_cov_10.307865	566	642	0	49	76	0.6447368
NODE_6833_length_989_cov_10.307865	566	642	2	7	76	0.0921053
NODE_6833_length_989_cov_10.307865	566	642	5	1	76	0.0131579
NODE_6833_length_989_cov_10.307865	566	642	6	19	76	0.2500000
NODE_6833_length_989_cov_10.307865	615	695	2	7	80	0.0875000
NODE_6833_length_989_cov_10.307865	615	695	5	1	80	0.0125000
NODE_6833_length_989_cov_10.307865	615	695	6	23	80	0.2875000
NODE_6833_length_989_cov_10.307865	615	695	8	10	80	0.1250000
NODE_6833_length_989_cov_10.307865	615	695	9	23	80	0.2875000
NODE_6833_length_989_cov_10.307865	615	695	10	16	80	0.2000000
NODE_6834_length_989_cov_8.941573	528	608	0	80	80	1.0000000
NODE_6834_length_989_cov_8.941573	581	661	0	80	80	1.0000000
NODE_6835_length_989_cov_5.132584	459	524	0	65	65	1.0000000
NODE_6838_length_989_cov_2.540449	703	783	0	80	80	1.0000000
NODE_6845_length_988_cov_52.168729	361	441	0	58	80	0.7250000
NODE_6845_length_988_cov_52.168729	361	441	2	22	80	0.2750000
NODE_6845_length_988_cov_52.168729	414	494	0	80	80	1.0000000
NODE_6845_length_988_cov_52.168729	490	570	0	6	80	0.0750000
NODE_6845_length_988_cov_52.168729	490	570	2	13	80	0.1625000
NODE_6845_length_988_cov_52.168729	490	570	6	61	80	0.7625000
NODE_6845_length_988_cov_52.168729	543	623	4	29	80	0.3625000
NODE_6845_length_988_cov_52.168729	543	623	6	51	80	0.6375000
NODE_6846_length_988_cov_36.733408	390	470	0	39	80	0.4875000
NODE_6846_length_988_cov_36.733408	390	470	2	28	80	0.3500000
NODE_6846_length_988_cov_36.733408	390	470	6	13	80	0.1625000
NODE_6846_length_988_cov_36.733408	443	523	2	14	80	0.1750000
NODE_6846_length_988_cov_36.733408	443	523	6	25	80	0.3125000
NODE_6846_length_988_cov_36.733408	443	523	8	38	80	0.4750000
NODE_6846_length_988_cov_36.733408	443	523	10	3	80	0.0375000
NODE_6847_length_988_cov_36.221597	478	558	0	80	80	1.0000000
NODE_6847_length_988_cov_36.221597	531	611	0	80	80	1.0000000
NODE_6848_length_988_cov_25.895388	389	469	2	80	80	1.0000000
NODE_6848_length_988_cov_25.895388	442	522	2	46	80	0.5750000
NODE_6848_length_988_cov_25.895388	442	522	4	34	80	0.4250000
NODE_6848_length_988_cov_25.895388	518	598	2	49	80	0.6125000
NODE_6848_length_988_cov_25.895388	518	598	4	31	80	0.3875000
NODE_6848_length_988_cov_25.895388	571	651	0	15	80	0.1875000
NODE_6848_length_988_cov_25.895388	571	651	2	65	80	0.8125000
NODE_6849_length_988_cov_20.250844	423	503	0	31	80	0.3875000
NODE_6849_length_988_cov_20.250844	423	503	2	20	80	0.2500000
NODE_6849_length_988_cov_20.250844	423	503	6	29	80	0.3625000
NODE_6849_length_988_cov_20.250844	476	556	6	79	80	0.9875000
NODE_6849_length_988_cov_20.250844	476	556	8	1	80	0.0125000
NODE_6850_length_988_cov_15.812148	474	554	0	65	80	0.8125000
NODE_6850_length_988_cov_15.812148	474	554	2	15	80	0.1875000
NODE_6850_length_988_cov_15.812148	527	607	0	12	80	0.1500000
NODE_6850_length_988_cov_15.812148	527	607	2	68	80	0.8500000
NODE_6851_length_988_cov_15.082115	435	517	0	82	82	1.0000000
NODE_6851_length_988_cov_15.082115	490	570	0	80	80	1.0000000
NODE_6852_length_988_cov_14.697413	467	547	2	2	80	0.0250000
NODE_6852_length_988_cov_14.697413	467	547	4	19	80	0.2375000
NODE_6852_length_988_cov_14.697413	467	547	9	1	80	0.0125000
NODE_6852_length_988_cov_14.697413	467	547	10	18	80	0.2250000
NODE_6852_length_988_cov_14.697413	467	547	12	40	80	0.5000000
NODE_6852_length_988_cov_14.697413	520	600	8	9	80	0.1125000
NODE_6852_length_988_cov_14.697413	520	600	10	44	80	0.5500000
NODE_6852_length_988_cov_14.697413	520	600	12	27	80	0.3375000
NODE_6853_length_988_cov_7.730034	562	642	0	80	80	1.0000000
NODE_6853_length_988_cov_7.730034	615	695	0	80	80	1.0000000
NODE_6862_length_987_cov_42.784910	383	476	2	17	93	0.1827957
NODE_6862_length_987_cov_42.784910	383	476	4	69	93	0.7419355
NODE_6862_length_987_cov_42.784910	383	476	6	7	93	0.0752688
NODE_6862_length_987_cov_42.784910	449	529	4	79	80	0.9875000
NODE_6862_length_987_cov_42.784910	449	529	6	1	80	0.0125000
NODE_6863_length_987_cov_39.716216	290	370	0	80	80	1.0000000
NODE_6863_length_987_cov_39.716216	343	423	0	50	80	0.6250000
NODE_6863_length_987_cov_39.716216	343	423	2	30	80	0.3750000
NODE_6863_length_987_cov_39.716216	419	499	0	17	80	0.2125000
NODE_6863_length_987_cov_39.716216	419	499	2	63	80	0.7875000
NODE_6863_length_987_cov_39.716216	472	552	0	70	80	0.8750000
NODE_6863_length_987_cov_39.716216	472	552	2	10	80	0.1250000
NODE_6864_length_987_cov_28.171171	406	486	0	80	80	1.0000000
NODE_6864_length_987_cov_28.171171	459	539	0	80	80	1.0000000
NODE_6864_length_987_cov_28.171171	535	615	0	80	80	1.0000000
NODE_6864_length_987_cov_28.171171	588	668	0	80	80	1.0000000
NODE_6865_length_987_cov_23.627252	331	411	0	1	80	0.0125000
NODE_6865_length_987_cov_23.627252	331	411	4	62	80	0.7750000
NODE_6865_length_987_cov_23.627252	331	411	6	17	80	0.2125000
NODE_6865_length_987_cov_23.627252	384	464	0	54	80	0.6750000
NODE_6865_length_987_cov_23.627252	384	464	4	26	80	0.3250000
NODE_6866_length_987_cov_18.797297	437	517	0	37	80	0.4625000
NODE_6866_length_987_cov_18.797297	437	517	2	43	80	0.5375000
NODE_6866_length_987_cov_18.797297	490	570	2	80	80	1.0000000
NODE_6867_length_987_cov_15.628378	369	449	2	18	80	0.2250000
NODE_6867_length_987_cov_15.628378	369	449	4	42	80	0.5250000
NODE_6867_length_987_cov_15.628378	369	449	6	20	80	0.2500000
NODE_6867_length_987_cov_15.628378	422	502	2	8	80	0.1000000
NODE_6867_length_987_cov_15.628378	422	502	4	21	80	0.2625000
NODE_6867_length_987_cov_15.628378	422	502	6	51	80	0.6375000
NODE_6868_length_987_cov_15.439189	438	518	0	68	80	0.8500000
NODE_6868_length_987_cov_15.439189	438	518	2	12	80	0.1500000
NODE_6868_length_987_cov_15.439189	491	571	0	15	80	0.1875000
NODE_6868_length_987_cov_15.439189	491	571	2	19	80	0.2375000
NODE_6868_length_987_cov_15.439189	491	571	4	46	80	0.5750000
NODE_6869_length_987_cov_14.343468	506	586	0	36	80	0.4500000
NODE_6869_length_987_cov_14.343468	506	586	1	44	80	0.5500000
NODE_6869_length_987_cov_14.343468	559	639	0	9	80	0.1125000
NODE_6869_length_987_cov_14.343468	559	639	1	71	80	0.8875000
NODE_6870_length_987_cov_13.515766	475	555	0	43	80	0.5375000
NODE_6870_length_987_cov_13.515766	475	555	2	37	80	0.4625000
NODE_6870_length_987_cov_13.515766	528	608	2	80	80	1.0000000
NODE_6871_length_987_cov_9.521396	408	482	0	57	74	0.7702703
NODE_6871_length_987_cov_9.521396	408	482	2	17	74	0.2297297
NODE_6871_length_987_cov_9.521396	455	535	0	52	80	0.6500000
NODE_6871_length_987_cov_9.521396	455	535	2	28	80	0.3500000
NODE_6872_length_987_cov_9.054054	440	520	4	24	80	0.3000000
NODE_6872_length_987_cov_9.054054	440	520	8	11	80	0.1375000
NODE_6872_length_987_cov_9.054054	440	520	9	45	80	0.5625000
NODE_6872_length_987_cov_9.054054	493	573	8	1	80	0.0125000
NODE_6872_length_987_cov_9.054054	493	573	9	55	80	0.6875000
NODE_6872_length_987_cov_9.054054	493	573	12	15	80	0.1875000
NODE_6872_length_987_cov_9.054054	493	573	13	9	80	0.1125000
NODE_6875_length_987_cov_5.378378	509	589	0	80	80	1.0000000
NODE_6875_length_987_cov_5.378378	562	642	0	80	80	1.0000000
NODE_6889_length_986_cov_36.937993	327	407	0	8	80	0.1000000
NODE_6889_length_986_cov_36.937993	327	407	2	72	80	0.9000000
NODE_6889_length_986_cov_36.937993	380	460	0	61	80	0.7625000
NODE_6889_length_986_cov_36.937993	380	460	2	19	80	0.2375000
NODE_6889_length_986_cov_36.937993	456	536	0	80	80	1.0000000
NODE_6889_length_986_cov_36.937993	509	589	0	80	80	1.0000000
NODE_6890_length_986_cov_35.130778	325	405	6	29	80	0.3625000
NODE_6890_length_986_cov_35.130778	325	405	8	51	80	0.6375000
NODE_6890_length_986_cov_35.130778	378	458	2	36	80	0.4500000
NODE_6890_length_986_cov_35.130778	378	458	4	9	80	0.1125000
NODE_6890_length_986_cov_35.130778	378	458	6	12	80	0.1500000
NODE_6890_length_986_cov_35.130778	378	458	8	23	80	0.2875000
NODE_6890_length_986_cov_35.130778	454	534	0	74	80	0.9250000
NODE_6890_length_986_cov_35.130778	454	534	2	6	80	0.0750000
NODE_6890_length_986_cov_35.130778	507	587	0	80	80	1.0000000
NODE_6891_length_986_cov_24.037204	602	682	0	80	80	1.0000000
NODE_6891_length_986_cov_24.037204	655	735	0	80	80	1.0000000
NODE_6891_length_986_cov_24.037204	731	811	0	80	80	1.0000000
NODE_6891_length_986_cov_24.037204	784	864	0	80	80	1.0000000
NODE_6892_length_986_cov_20.591883	395	475	4	10	80	0.1250000
NODE_6892_length_986_cov_20.591883	395	475	5	2	80	0.0250000
NODE_6892_length_986_cov_20.591883	395	475	6	68	80	0.8500000
NODE_6892_length_986_cov_20.591883	448	528	0	17	80	0.2125000
NODE_6892_length_986_cov_20.591883	448	528	2	28	80	0.3500000
NODE_6892_length_986_cov_20.591883	448	528	4	10	80	0.1250000
NODE_6892_length_986_cov_20.591883	448	528	5	2	80	0.0250000
NODE_6892_length_986_cov_20.591883	448	528	6	23	80	0.2875000
NODE_6893_length_986_cov_16.815107	389	469	0	27	80	0.3375000
NODE_6893_length_986_cov_16.815107	389	469	4	6	80	0.0750000
NODE_6893_length_986_cov_16.815107	389	469	6	8	80	0.1000000
NODE_6893_length_986_cov_16.815107	389	469	8	39	80	0.4875000
NODE_6893_length_986_cov_16.815107	442	522	0	80	80	1.0000000
NODE_6894_length_986_cov_11.021421	474	554	0	80	80	1.0000000
NODE_6894_length_986_cov_11.021421	527	607	0	80	80	1.0000000
NODE_6905_length_985_cov_41.707675	443	523	0	30	80	0.3750000
NODE_6905_length_985_cov_41.707675	443	523	1	17	80	0.2125000
NODE_6905_length_985_cov_41.707675	443	523	2	33	80	0.4125000
NODE_6905_length_985_cov_41.707675	496	576	2	80	80	1.0000000
NODE_6911_length_984_cov_64.531073	412	481	0	40	69	0.5797101
NODE_6911_length_984_cov_64.531073	412	481	2	29	69	0.4202898
NODE_6911_length_984_cov_64.531073	454	534	0	2	80	0.0250000
NODE_6911_length_984_cov_64.531073	454	534	2	78	80	0.9750000
NODE_6911_length_984_cov_64.531073	475	555	0	23	80	0.2875000
NODE_6911_length_984_cov_64.531073	475	555	2	57	80	0.7125000
NODE_6911_length_984_cov_64.531073	528	608	0	76	80	0.9500000
NODE_6911_length_984_cov_64.531073	528	608	2	4	80	0.0500000
NODE_6911_length_984_cov_64.531073	549	629	0	80	80	1.0000000
NODE_6912_length_984_cov_28.832768	430	510	0	21	80	0.2625000
NODE_6912_length_984_cov_28.832768	430	510	4	19	80	0.2375000
NODE_6912_length_984_cov_28.832768	430	510	8	9	80	0.1125000
NODE_6912_length_984_cov_28.832768	430	510	9	19	80	0.2375000
NODE_6912_length_984_cov_28.832768	430	510	11	12	80	0.1500000
NODE_6912_length_984_cov_28.832768	483	563	8	10	80	0.1250000
NODE_6912_length_984_cov_28.832768	483	563	9	15	80	0.1875000
NODE_6912_length_984_cov_28.832768	483	563	11	39	80	0.4875000
NODE_6912_length_984_cov_28.832768	483	563	12	16	80	0.2000000
NODE_6913_length_984_cov_27.247458	203	283	0	54	80	0.6750000
NODE_6913_length_984_cov_27.247458	203	283	2	26	80	0.3250000
NODE_6913_length_984_cov_27.247458	256	336	0	80	80	1.0000000
NODE_6913_length_984_cov_27.247458	332	412	0	80	80	1.0000000
NODE_6913_length_984_cov_27.247458	385	465	0	80	80	1.0000000
NODE_6914_length_984_cov_25.944633	483	563	0	19	80	0.2375000
NODE_6914_length_984_cov_25.944633	483	563	2	61	80	0.7625000
NODE_6914_length_984_cov_25.944633	536	616	2	36	80	0.4500000
NODE_6914_length_984_cov_25.944633	536	616	4	44	80	0.5500000
NODE_6915_length_984_cov_16.611299	351	431	0	80	80	1.0000000
NODE_6915_length_984_cov_16.611299	404	484	0	80	80	1.0000000
NODE_6917_length_984_cov_6.414689	415	495	2	15	80	0.1875000
NODE_6917_length_984_cov_6.414689	415	495	4	65	80	0.8125000
NODE_6917_length_984_cov_6.414689	468	548	0	23	80	0.2875000
NODE_6917_length_984_cov_6.414689	468	548	2	31	80	0.3875000
NODE_6917_length_984_cov_6.414689	468	548	4	26	80	0.3250000
NODE_6918_length_984_cov_4.720904	494	574	0	80	80	1.0000000
NODE_6918_length_984_cov_4.720904	547	627	0	80	80	1.0000000
NODE_6927_length_984_cov_1.333333	922	971	3	7	49	0.1428571
NODE_6927_length_984_cov_1.333333	922	971	5	11	49	0.2244898
NODE_6927_length_984_cov_1.333333	922	971	7	31	49	0.6326531
NODE_6931_length_983_cov_34.566742	466	546	4	21	80	0.2625000
NODE_6931_length_983_cov_34.566742	466	546	6	33	80	0.4125000
NODE_6931_length_983_cov_34.566742	466	546	8	2	80	0.0250000
NODE_6931_length_983_cov_34.566742	466	546	10	24	80	0.3000000
NODE_6931_length_983_cov_34.566742	519	599	4	24	80	0.3000000
NODE_6931_length_983_cov_34.566742	519	599	6	31	80	0.3875000
NODE_6931_length_983_cov_34.566742	519	599	8	2	80	0.0250000
NODE_6931_length_983_cov_34.566742	519	599	10	23	80	0.2875000
NODE_6932_length_983_cov_26.011312	449	529	2	67	80	0.8375000
NODE_6932_length_983_cov_26.011312	449	529	4	13	80	0.1625000
NODE_6932_length_983_cov_26.011312	502	582	2	67	80	0.8375000
NODE_6932_length_983_cov_26.011312	502	582	4	13	80	0.1625000
NODE_6932_length_983_cov_26.011312	578	658	0	66	80	0.8250000
NODE_6932_length_983_cov_26.011312	578	658	2	14	80	0.1750000
NODE_6932_length_983_cov_26.011312	631	711	0	80	80	1.0000000
NODE_6933_length_983_cov_24.694570	539	619	0	80	80	1.0000000
NODE_6933_length_983_cov_24.694570	592	672	0	80	80	1.0000000
NODE_6934_length_983_cov_22.214932	395	475	0	80	80	1.0000000
NODE_6934_length_983_cov_22.214932	448	528	0	80	80	1.0000000
NODE_6935_length_983_cov_19.132353	377	457	0	80	80	1.0000000
NODE_6935_length_983_cov_19.132353	430	510	0	80	80	1.0000000
NODE_6936_length_983_cov_16.875566	419	499	0	23	80	0.2875000
NODE_6936_length_983_cov_16.875566	419	499	2	54	80	0.6750000
NODE_6936_length_983_cov_16.875566	419	499	3	1	80	0.0125000
NODE_6936_length_983_cov_16.875566	419	499	4	2	80	0.0250000
NODE_6936_length_983_cov_16.875566	472	552	2	28	80	0.3500000
NODE_6936_length_983_cov_16.875566	472	552	3	1	80	0.0125000
NODE_6936_length_983_cov_16.875566	472	552	4	51	80	0.6375000
NODE_6936_length_983_cov_16.875566	548	628	2	6	80	0.0750000
NODE_6936_length_983_cov_16.875566	548	628	4	59	80	0.7375000
NODE_6936_length_983_cov_16.875566	548	628	6	15	80	0.1875000
NODE_6936_length_983_cov_16.875566	601	681	4	46	80	0.5750000
NODE_6936_length_983_cov_16.875566	601	681	5	1	80	0.0125000
NODE_6936_length_983_cov_16.875566	601	681	6	33	80	0.4125000
NODE_6937_length_983_cov_7.240950	487	567	0	80	80	1.0000000
NODE_6937_length_983_cov_7.240950	540	620	0	80	80	1.0000000
NODE_6949_length_982_cov_30.750849	357	437	2	20	80	0.2500000
NODE_6949_length_982_cov_30.750849	357	437	4	13	80	0.1625000
NODE_6949_length_982_cov_30.750849	357	437	6	47	80	0.5875000
NODE_6949_length_982_cov_30.750849	410	490	4	66	80	0.8250000
NODE_6949_length_982_cov_30.750849	410	490	6	14	80	0.1750000
NODE_6950_length_982_cov_29.901472	516	596	0	17	80	0.2125000
NODE_6950_length_982_cov_29.901472	516	596	2	63	80	0.7875000
NODE_6950_length_982_cov_29.901472	569	649	0	38	80	0.4750000
NODE_6950_length_982_cov_29.901472	569	649	2	42	80	0.5250000
NODE_6951_length_982_cov_18.251416	356	436	2	36	80	0.4500000
NODE_6951_length_982_cov_18.251416	356	436	3	1	80	0.0125000
NODE_6951_length_982_cov_18.251416	356	436	4	43	80	0.5375000
NODE_6951_length_982_cov_18.251416	409	489	2	47	80	0.5875000
NODE_6951_length_982_cov_18.251416	409	489	3	1	80	0.0125000
NODE_6951_length_982_cov_18.251416	409	489	4	19	80	0.2375000
NODE_6951_length_982_cov_18.251416	409	489	6	13	80	0.1625000
NODE_6951_length_982_cov_18.251416	485	565	2	18	80	0.2250000
NODE_6951_length_982_cov_18.251416	485	565	4	27	80	0.3375000
NODE_6951_length_982_cov_18.251416	485	565	6	35	80	0.4375000
NODE_6951_length_982_cov_18.251416	538	618	2	61	80	0.7625000
NODE_6951_length_982_cov_18.251416	538	618	4	19	80	0.2375000
NODE_6952_length_982_cov_13.840317	608	688	4	44	80	0.5500000
NODE_6952_length_982_cov_13.840317	608	688	6	36	80	0.4500000
NODE_6952_length_982_cov_13.840317	661	741	0	12	80	0.1500000
NODE_6952_length_982_cov_13.840317	661	741	4	68	80	0.8500000
NODE_6953_length_982_cov_13.227633	317	397	4	35	80	0.4375000
NODE_6953_length_982_cov_13.227633	317	397	6	45	80	0.5625000
NODE_6953_length_982_cov_13.227633	370	450	0	49	80	0.6125000
NODE_6953_length_982_cov_13.227633	370	450	4	31	80	0.3875000
NODE_6954_length_982_cov_10.918460	209	289	0	80	80	1.0000000
NODE_6954_length_982_cov_10.918460	262	342	0	80	80	1.0000000
NODE_6956_length_982_cov_7.210646	216	296	0	47	80	0.5875000
NODE_6956_length_982_cov_7.210646	216	296	2	29	80	0.3625000
NODE_6956_length_982_cov_7.210646	216	296	4	4	80	0.0500000
NODE_6956_length_982_cov_7.210646	269	349	0	15	80	0.1875000
NODE_6956_length_982_cov_7.210646	269	349	2	29	80	0.3625000
NODE_6956_length_982_cov_7.210646	269	349	4	36	80	0.4500000
NODE_6973_length_981_cov_55.260771	410	490	2	21	80	0.2625000
NODE_6973_length_981_cov_55.260771	410	490	4	59	80	0.7375000
NODE_6973_length_981_cov_55.260771	463	543	0	14	80	0.1750000
NODE_6973_length_981_cov_55.260771	463	543	2	26	80	0.3250000
NODE_6973_length_981_cov_55.260771	463	543	4	40	80	0.5000000
NODE_6973_length_981_cov_55.260771	539	619	0	6	80	0.0750000
NODE_6973_length_981_cov_55.260771	539	619	6	74	80	0.9250000
NODE_6973_length_981_cov_55.260771	592	672	0	32	80	0.4000000
NODE_6973_length_981_cov_55.260771	592	672	6	48	80	0.6000000
NODE_6974_length_981_cov_33.287982	362	441	0	79	79	1.0000000
NODE_6974_length_981_cov_33.287982	414	495	0	51	81	0.6296296
NODE_6974_length_981_cov_33.287982	414	495	2	30	81	0.3703704
NODE_6974_length_981_cov_33.287982	491	571	2	56	80	0.7000000
NODE_6974_length_981_cov_33.287982	491	571	4	24	80	0.3000000
NODE_6974_length_981_cov_33.287982	544	624	2	52	80	0.6500000
NODE_6974_length_981_cov_33.287982	544	624	4	28	80	0.3500000
NODE_6975_length_981_cov_33.121315	269	349	0	80	80	1.0000000
NODE_6975_length_981_cov_33.121315	322	402	0	80	80	1.0000000
NODE_6975_length_981_cov_33.121315	398	478	0	64	80	0.8000000
NODE_6975_length_981_cov_33.121315	398	478	2	16	80	0.2000000
NODE_6975_length_981_cov_33.121315	451	531	0	11	80	0.1375000
NODE_6975_length_981_cov_33.121315	451	531	2	69	80	0.8625000
NODE_6976_length_981_cov_26.732426	397	477	2	20	80	0.2500000
NODE_6976_length_981_cov_26.732426	397	477	3	2	80	0.0250000
NODE_6976_length_981_cov_26.732426	397	477	4	3	80	0.0375000
NODE_6976_length_981_cov_26.732426	397	477	5	6	80	0.0750000
NODE_6976_length_981_cov_26.732426	397	477	6	49	80	0.6125000
NODE_6976_length_981_cov_26.732426	450	530	0	24	80	0.3000000
NODE_6976_length_981_cov_26.732426	450	530	2	49	80	0.6125000
NODE_6976_length_981_cov_26.732426	450	530	3	2	80	0.0250000
NODE_6976_length_981_cov_26.732426	450	530	5	5	80	0.0625000
NODE_6977_length_981_cov_24.304989	390	470	0	9	80	0.1125000
NODE_6977_length_981_cov_24.304989	390	470	2	49	80	0.6125000
NODE_6977_length_981_cov_24.304989	390	470	4	2	80	0.0250000
NODE_6977_length_981_cov_24.304989	390	470	6	6	80	0.0750000
NODE_6977_length_981_cov_24.304989	390	470	10	14	80	0.1750000
NODE_6977_length_981_cov_24.304989	443	523	2	5	80	0.0625000
NODE_6977_length_981_cov_24.304989	443	523	4	2	80	0.0250000
NODE_6977_length_981_cov_24.304989	443	523	6	6	80	0.0750000
NODE_6977_length_981_cov_24.304989	443	523	8	5	80	0.0625000
NODE_6977_length_981_cov_24.304989	443	523	10	62	80	0.7750000
NODE_6978_length_981_cov_10.485261	363	443	0	1	80	0.0125000
NODE_6978_length_981_cov_10.485261	363	443	2	79	80	0.9875000
NODE_6978_length_981_cov_10.485261	416	496	2	80	80	1.0000000
NODE_6980_length_981_cov_5.328798	821	885	4	28	64	0.4375000
NODE_6980_length_981_cov_5.328798	821	885	6	2	64	0.0312500
NODE_6980_length_981_cov_5.328798	821	885	8	6	64	0.0937500
NODE_6980_length_981_cov_5.328798	821	885	10	11	64	0.1718750
NODE_6980_length_981_cov_5.328798	821	885	12	16	64	0.2500000
NODE_6980_length_981_cov_5.328798	821	885	14	1	64	0.0156250
NODE_6980_length_981_cov_5.328798	847	884	4	27	37	0.7297297
NODE_6980_length_981_cov_5.328798	847	884	6	2	37	0.0540541
NODE_6980_length_981_cov_5.328798	847	884	8	6	37	0.1621622
NODE_6980_length_981_cov_5.328798	847	884	10	2	37	0.0540541
NODE_6998_length_980_cov_40.710556	329	409	0	77	80	0.9625000
NODE_6998_length_980_cov_40.710556	329	409	5	3	80	0.0375000
NODE_6998_length_980_cov_40.710556	382	462	0	24	80	0.3000000
NODE_6998_length_980_cov_40.710556	382	462	5	46	80	0.5750000
NODE_6998_length_980_cov_40.710556	382	462	6	10	80	0.1250000
NODE_6998_length_980_cov_40.710556	458	538	6	32	80	0.4000000
NODE_6998_length_980_cov_40.710556	458	538	8	48	80	0.6000000
NODE_6998_length_980_cov_40.710556	511	591	0	14	80	0.1750000
NODE_6998_length_980_cov_40.710556	511	591	2	27	80	0.3375000
NODE_6998_length_980_cov_40.710556	511	591	8	39	80	0.4875000
NODE_6999_length_980_cov_37.634506	666	746	0	66	80	0.8250000
NODE_6999_length_980_cov_37.634506	666	746	2	14	80	0.1750000
NODE_6999_length_980_cov_37.634506	719	799	0	47	80	0.5875000
NODE_6999_length_980_cov_37.634506	719	799	2	33	80	0.4125000
NODE_7000_length_980_cov_36.261067	331	411	2	11	80	0.1375000
NODE_7000_length_980_cov_36.261067	331	411	6	69	80	0.8625000
NODE_7000_length_980_cov_36.261067	384	453	6	55	69	0.7971014
NODE_7000_length_980_cov_36.261067	384	453	7	2	69	0.0289855
NODE_7000_length_980_cov_36.261067	384	453	8	12	69	0.1739130
NODE_7000_length_980_cov_36.261067	465	545	2	39	80	0.4875000
NODE_7000_length_980_cov_36.261067	465	545	4	25	80	0.3125000
NODE_7000_length_980_cov_36.261067	465	545	6	16	80	0.2000000
NODE_7000_length_980_cov_36.261067	518	598	2	30	80	0.3750000
NODE_7000_length_980_cov_36.261067	518	598	3	2	80	0.0250000
NODE_7000_length_980_cov_36.261067	518	598	4	48	80	0.6000000
NODE_7001_length_980_cov_28.514188	430	510	3	21	80	0.2625000
NODE_7001_length_980_cov_28.514188	430	510	5	59	80	0.7375000
NODE_7001_length_980_cov_28.514188	483	563	3	6	80	0.0750000
NODE_7001_length_980_cov_28.514188	483	563	5	66	80	0.8250000
NODE_7001_length_980_cov_28.514188	483	563	6	1	80	0.0125000
NODE_7001_length_980_cov_28.514188	483	563	7	7	80	0.0875000
NODE_7002_length_980_cov_25.205448	497	577	0	51	80	0.6375000
NODE_7002_length_980_cov_25.205448	497	577	4	29	80	0.3625000
NODE_7002_length_980_cov_25.205448	550	630	4	80	80	1.0000000
NODE_7003_length_980_cov_24.321226	417	497	0	80	80	1.0000000
NODE_7003_length_980_cov_24.321226	470	550	0	80	80	1.0000000
NODE_7004_length_980_cov_20.460840	388	468	0	14	80	0.1750000
NODE_7004_length_980_cov_20.460840	388	468	2	13	80	0.1625000
NODE_7004_length_980_cov_20.460840	388	468	4	53	80	0.6625000
NODE_7004_length_980_cov_20.460840	441	521	4	80	80	1.0000000
NODE_7005_length_980_cov_19.969353	486	566	0	80	80	1.0000000
NODE_7005_length_980_cov_19.969353	539	619	0	80	80	1.0000000
NODE_7006_length_980_cov_13.736663	350	430	0	39	80	0.4875000
NODE_7006_length_980_cov_13.736663	350	430	2	41	80	0.5125000
NODE_7006_length_980_cov_13.736663	403	483	2	80	80	1.0000000
NODE_7006_length_980_cov_13.736663	479	559	0	5	80	0.0625000
NODE_7006_length_980_cov_13.736663	479	559	2	9	80	0.1125000
NODE_7006_length_980_cov_13.736663	479	559	4	66	80	0.8250000
NODE_7006_length_980_cov_13.736663	532	612	0	37	80	0.4625000
NODE_7006_length_980_cov_13.736663	532	612	2	5	80	0.0625000
NODE_7006_length_980_cov_13.736663	532	612	4	38	80	0.4750000
NODE_7008_length_980_cov_10.842225	517	597	0	22	80	0.2750000
NODE_7008_length_980_cov_10.842225	517	597	1	58	80	0.7250000
NODE_7008_length_980_cov_10.842225	570	650	1	80	80	1.0000000
NODE_7009_length_980_cov_10.087401	341	424	0	83	83	1.0000000
NODE_7009_length_980_cov_10.087401	397	477	0	80	80	1.0000000
NODE_7010_length_980_cov_9.643587	267	347	0	80	80	1.0000000
NODE_7010_length_980_cov_9.643587	320	400	0	80	80	1.0000000
NODE_7010_length_980_cov_9.643587	396	476	0	29	80	0.3625000
NODE_7010_length_980_cov_9.643587	396	476	4	51	80	0.6375000
NODE_7010_length_980_cov_9.643587	449	529	4	80	80	1.0000000
NODE_7026_length_979_cov_22.576136	442	522	0	9	80	0.1125000
NODE_7026_length_979_cov_22.576136	442	522	2	71	80	0.8875000
NODE_7026_length_979_cov_22.576136	495	575	0	25	80	0.3125000
NODE_7026_length_979_cov_22.576136	495	575	2	55	80	0.6875000
NODE_7027_length_979_cov_19.739773	445	524	0	79	79	1.0000000
NODE_7027_length_979_cov_19.739773	497	577	0	80	80	1.0000000
NODE_7028_length_979_cov_19.480682	436	516	0	51	80	0.6375000
NODE_7028_length_979_cov_19.480682	436	516	1	29	80	0.3625000
NODE_7028_length_979_cov_19.480682	489	569	1	59	80	0.7375000
NODE_7028_length_979_cov_19.480682	489	569	2	21	80	0.2625000
NODE_7028_length_979_cov_19.480682	565	645	1	9	80	0.1125000
NODE_7028_length_979_cov_19.480682	565	645	2	71	80	0.8875000
NODE_7028_length_979_cov_19.480682	618	698	0	6	80	0.0750000
NODE_7028_length_979_cov_19.480682	618	698	1	56	80	0.7000000
NODE_7028_length_979_cov_19.480682	618	698	2	18	80	0.2250000
NODE_7029_length_979_cov_18.901136	470	550	0	78	80	0.9750000
NODE_7029_length_979_cov_18.901136	470	550	2	2	80	0.0250000
NODE_7029_length_979_cov_18.901136	523	603	0	25	80	0.3125000
NODE_7029_length_979_cov_18.901136	523	603	2	55	80	0.6875000
NODE_7031_length_979_cov_3.519318	101	168	4	3	67	0.0447761
NODE_7031_length_979_cov_3.519318	101	168	6	22	67	0.3283582
NODE_7031_length_979_cov_3.519318	101	168	8	13	67	0.1940299
NODE_7031_length_979_cov_3.519318	101	168	10	29	67	0.4328358
NODE_7040_length_978_cov_23.195677	424	504	2	4	80	0.0500000
NODE_7040_length_978_cov_23.195677	424	504	4	23	80	0.2875000
NODE_7040_length_978_cov_23.195677	424	504	6	48	80	0.6000000
NODE_7040_length_978_cov_23.195677	424	504	8	5	80	0.0625000
NODE_7040_length_978_cov_23.195677	477	557	4	53	80	0.6625000
NODE_7040_length_978_cov_23.195677	477	557	6	27	80	0.3375000
NODE_7041_length_978_cov_18.866894	440	520	2	12	80	0.1500000
NODE_7041_length_978_cov_18.866894	440	520	4	4	80	0.0500000
NODE_7041_length_978_cov_18.866894	440	520	6	10	80	0.1250000
NODE_7041_length_978_cov_18.866894	440	520	8	43	80	0.5375000
NODE_7041_length_978_cov_18.866894	440	520	10	3	80	0.0375000
NODE_7041_length_978_cov_18.866894	440	520	12	8	80	0.1000000
NODE_7041_length_978_cov_18.866894	493	573	5	8	80	0.1000000
NODE_7041_length_978_cov_18.866894	493	573	8	16	80	0.2000000
NODE_7041_length_978_cov_18.866894	493	573	9	26	80	0.3250000
NODE_7041_length_978_cov_18.866894	493	573	10	3	80	0.0375000
NODE_7041_length_978_cov_18.866894	493	573	11	19	80	0.2375000
NODE_7041_length_978_cov_18.866894	493	573	12	8	80	0.1000000
NODE_7042_length_978_cov_15.614334	341	421	0	26	80	0.3250000
NODE_7042_length_978_cov_15.614334	341	421	2	54	80	0.6750000
NODE_7042_length_978_cov_15.614334	394	474	0	79	80	0.9875000
NODE_7042_length_978_cov_15.614334	394	474	2	1	80	0.0125000
NODE_7042_length_978_cov_15.614334	470	550	0	16	80	0.2000000
NODE_7042_length_978_cov_15.614334	470	550	2	64	80	0.8000000
NODE_7042_length_978_cov_15.614334	523	603	2	38	80	0.4750000
NODE_7042_length_978_cov_15.614334	523	603	3	10	80	0.1250000
NODE_7042_length_978_cov_15.614334	523	603	4	32	80	0.4000000
NODE_7043_length_978_cov_15.253697	327	407	0	12	80	0.1500000
NODE_7043_length_978_cov_15.253697	327	407	2	35	80	0.4375000
NODE_7043_length_978_cov_15.253697	327	407	4	33	80	0.4125000
NODE_7043_length_978_cov_15.253697	380	460	0	12	80	0.1500000
NODE_7043_length_978_cov_15.253697	380	460	2	6	80	0.0750000
NODE_7043_length_978_cov_15.253697	380	460	4	62	80	0.7750000
NODE_7043_length_978_cov_15.253697	456	536	0	80	80	1.0000000
NODE_7043_length_978_cov_15.253697	509	589	0	80	80	1.0000000
NODE_7044_length_978_cov_14.730375	407	487	0	21	80	0.2625000
NODE_7044_length_978_cov_14.730375	407	487	2	59	80	0.7375000
NODE_7044_length_978_cov_14.730375	460	540	0	36	80	0.4500000
NODE_7044_length_978_cov_14.730375	460	540	2	44	80	0.5500000
NODE_7045_length_978_cov_7.257110	571	651	0	80	80	1.0000000
NODE_7045_length_978_cov_7.257110	624	704	0	80	80	1.0000000
NODE_7062_length_977_cov_47.484055	427	507	0	2	80	0.0250000
NODE_7062_length_977_cov_47.484055	427	507	1	78	80	0.9750000
NODE_7062_length_977_cov_47.484055	480	560	1	80	80	1.0000000
NODE_7063_length_977_cov_47.116173	428	508	0	2	80	0.0250000
NODE_7063_length_977_cov_47.116173	428	508	2	78	80	0.9750000
NODE_7063_length_977_cov_47.116173	481	561	0	55	80	0.6875000
NODE_7063_length_977_cov_47.116173	481	561	2	25	80	0.3125000
NODE_7063_length_977_cov_47.116173	557	637	0	80	80	1.0000000
NODE_7063_length_977_cov_47.116173	610	690	0	80	80	1.0000000
NODE_7064_length_977_cov_32.542141	486	566	0	32	80	0.4000000
NODE_7064_length_977_cov_32.542141	486	566	2	10	80	0.1250000
NODE_7064_length_977_cov_32.542141	486	566	4	38	80	0.4750000
NODE_7064_length_977_cov_32.542141	539	619	2	2	80	0.0250000
NODE_7064_length_977_cov_32.542141	539	619	4	78	80	0.9750000
NODE_7065_length_977_cov_30.676538	361	441	4	60	80	0.7500000
NODE_7065_length_977_cov_30.676538	361	441	6	20	80	0.2500000
NODE_7065_length_977_cov_30.676538	414	494	0	35	80	0.4375000
NODE_7065_length_977_cov_30.676538	414	494	2	15	80	0.1875000
NODE_7065_length_977_cov_30.676538	414	494	4	30	80	0.3750000
NODE_7066_length_977_cov_28.348519	455	535	0	24	80	0.3000000
NODE_7066_length_977_cov_28.348519	455	535	2	40	80	0.5000000
NODE_7066_length_977_cov_28.348519	455	535	4	16	80	0.2000000
NODE_7066_length_977_cov_28.348519	508	588	0	43	80	0.5375000
NODE_7066_length_977_cov_28.348519	508	588	2	37	80	0.4625000
NODE_7067_length_977_cov_26.571754	343	423	6	80	80	1.0000000
NODE_7067_length_977_cov_26.571754	396	476	0	29	80	0.3625000
NODE_7067_length_977_cov_26.571754	396	476	4	8	80	0.1000000
NODE_7067_length_977_cov_26.571754	396	476	6	43	80	0.5375000
NODE_7067_length_977_cov_26.571754	472	552	0	80	80	1.0000000
NODE_7067_length_977_cov_26.571754	525	600	0	75	75	1.0000000
NODE_7068_length_977_cov_24.898633	470	550	2	23	80	0.2875000
NODE_7068_length_977_cov_24.898633	470	550	4	57	80	0.7125000
NODE_7068_length_977_cov_24.898633	523	603	2	14	80	0.1750000
NODE_7068_length_977_cov_24.898633	523	603	4	56	80	0.7000000
NODE_7068_length_977_cov_24.898633	523	603	6	10	80	0.1250000
NODE_7069_length_977_cov_22.986333	313	393	1	2	80	0.0250000
NODE_7069_length_977_cov_22.986333	313	393	2	30	80	0.3750000
NODE_7069_length_977_cov_22.986333	313	393	3	2	80	0.0250000
NODE_7069_length_977_cov_22.986333	313	393	4	22	80	0.2750000
NODE_7069_length_977_cov_22.986333	313	393	7	24	80	0.3000000
NODE_7069_length_977_cov_22.986333	366	446	1	2	80	0.0250000
NODE_7069_length_977_cov_22.986333	366	446	2	1	80	0.0125000
NODE_7069_length_977_cov_22.986333	366	446	7	77	80	0.9625000
NODE_7069_length_977_cov_22.986333	442	522	0	56	80	0.7000000
NODE_7069_length_977_cov_22.986333	442	522	6	15	80	0.1875000
NODE_7069_length_977_cov_22.986333	442	522	7	9	80	0.1125000
NODE_7069_length_977_cov_22.986333	495	575	0	80	80	1.0000000
NODE_7070_length_977_cov_10.753986	290	370	0	13	80	0.1625000
NODE_7070_length_977_cov_10.753986	290	370	4	7	80	0.0875000
NODE_7070_length_977_cov_10.753986	290	370	6	28	80	0.3500000
NODE_7070_length_977_cov_10.753986	290	370	8	32	80	0.4000000
NODE_7070_length_977_cov_10.753986	343	423	2	3	80	0.0375000
NODE_7070_length_977_cov_10.753986	343	423	4	13	80	0.1625000
NODE_7070_length_977_cov_10.753986	343	423	8	64	80	0.8000000
NODE_7071_length_977_cov_9.924829	401	456	0	55	55	1.0000000
NODE_7073_length_977_cov_6.391800	483	563	0	80	80	1.0000000
NODE_7073_length_977_cov_6.391800	536	616	0	80	80	1.0000000
NODE_7075_length_977_cov_2.907745	191	241	6	17	50	0.3400000
NODE_7075_length_977_cov_2.907745	191	241	10	33	50	0.6600000
NODE_7085_length_976_cov_38.192702	326	406	0	18	80	0.2250000
NODE_7085_length_976_cov_38.192702	326	406	2	30	80	0.3750000
NODE_7085_length_976_cov_38.192702	326	406	4	32	80	0.4000000
NODE_7085_length_976_cov_38.192702	379	459	0	26	80	0.3250000
NODE_7085_length_976_cov_38.192702	379	459	2	54	80	0.6750000
NODE_7085_length_976_cov_38.192702	455	535	2	54	80	0.6750000
NODE_7085_length_976_cov_38.192702	455	535	4	26	80	0.3250000
NODE_7085_length_976_cov_38.192702	455	536	2	54	81	0.6666667
NODE_7085_length_976_cov_38.192702	455	536	4	27	81	0.3333333
NODE_7085_length_976_cov_38.192702	455	519	2	42	64	0.6562500
NODE_7085_length_976_cov_38.192702	455	519	4	22	64	0.3437500
NODE_7085_length_976_cov_38.192702	508	588	2	17	80	0.2125000
NODE_7085_length_976_cov_38.192702	508	588	4	36	80	0.4500000
NODE_7085_length_976_cov_38.192702	508	588	9	1	80	0.0125000
NODE_7085_length_976_cov_38.192702	508	588	10	26	80	0.3250000
NODE_7086_length_976_cov_26.275941	499	579	0	23	80	0.2875000
NODE_7086_length_976_cov_26.275941	499	579	1	1	80	0.0125000
NODE_7086_length_976_cov_26.275941	499	579	2	56	80	0.7000000
NODE_7086_length_976_cov_26.275941	552	632	0	18	80	0.2250000
NODE_7086_length_976_cov_26.275941	552	632	2	43	80	0.5375000
NODE_7086_length_976_cov_26.275941	552	632	4	19	80	0.2375000
NODE_7087_length_976_cov_25.559863	376	456	0	80	80	1.0000000
NODE_7087_length_976_cov_25.559863	429	509	0	49	80	0.6125000
NODE_7087_length_976_cov_25.559863	429	509	2	31	80	0.3875000
NODE_7088_length_976_cov_17.961231	572	652	0	12	80	0.1500000
NODE_7088_length_976_cov_17.961231	572	652	2	68	80	0.8500000
NODE_7088_length_976_cov_17.961231	625	705	0	23	80	0.2875000
NODE_7088_length_976_cov_17.961231	625	705	2	57	80	0.7125000
NODE_7089_length_976_cov_5.567845	789	851	8	38	62	0.6129032
NODE_7089_length_976_cov_5.567845	789	851	10	24	62	0.3870968
NODE_7089_length_976_cov_5.567845	842	904	0	15	62	0.2419355
NODE_7089_length_976_cov_5.567845	842	904	2	27	62	0.4354839
NODE_7089_length_976_cov_5.567845	842	904	4	5	62	0.0806452
NODE_7089_length_976_cov_5.567845	842	904	8	15	62	0.2419355
NODE_7101_length_975_cov_192.211187	722	802	41	3	80	0.0375000
NODE_7101_length_975_cov_192.211187	722	802	43	10	80	0.1250000
NODE_7101_length_975_cov_192.211187	722	802	45	7	80	0.0875000
NODE_7101_length_975_cov_192.211187	722	802	47	6	80	0.0750000
NODE_7101_length_975_cov_192.211187	722	802	49	5	80	0.0625000
NODE_7101_length_975_cov_192.211187	722	802	51	2	80	0.0250000
NODE_7101_length_975_cov_192.211187	722	802	52	1	80	0.0125000
NODE_7101_length_975_cov_192.211187	722	802	54	2	80	0.0250000
NODE_7101_length_975_cov_192.211187	722	802	56	3	80	0.0375000
NODE_7101_length_975_cov_192.211187	722	802	58	1	80	0.0125000
NODE_7101_length_975_cov_192.211187	722	802	59	3	80	0.0375000
NODE_7101_length_975_cov_192.211187	722	802	60	4	80	0.0500000
NODE_7101_length_975_cov_192.211187	722	802	63	6	80	0.0750000
NODE_7101_length_975_cov_192.211187	722	802	65	7	80	0.0875000
NODE_7101_length_975_cov_192.211187	722	802	67	5	80	0.0625000
NODE_7101_length_975_cov_192.211187	722	802	69	6	80	0.0750000
NODE_7101_length_975_cov_192.211187	722	802	71	8	80	0.1000000
NODE_7101_length_975_cov_192.211187	722	802	73	1	80	0.0125000
NODE_7102_length_975_cov_41.446347	414	494	2	25	80	0.3125000
NODE_7102_length_975_cov_41.446347	414	494	6	37	80	0.4625000
NODE_7102_length_975_cov_41.446347	414	494	8	18	80	0.2250000
NODE_7102_length_975_cov_41.446347	467	547	6	62	80	0.7750000
NODE_7102_length_975_cov_41.446347	467	547	8	18	80	0.2250000
NODE_7103_length_975_cov_37.618721	375	455	6	6	80	0.0750000
NODE_7103_length_975_cov_37.618721	375	455	8	74	80	0.9250000
NODE_7103_length_975_cov_37.618721	428	508	0	31	80	0.3875000
NODE_7103_length_975_cov_37.618721	428	508	2	20	80	0.2500000
NODE_7103_length_975_cov_37.618721	428	508	6	8	80	0.1000000
NODE_7103_length_975_cov_37.618721	428	508	8	21	80	0.2625000
NODE_7104_length_975_cov_34.265982	424	504	0	29	80	0.3625000
NODE_7104_length_975_cov_34.265982	424	504	2	51	80	0.6375000
NODE_7104_length_975_cov_34.265982	477	557	0	33	80	0.4125000
NODE_7104_length_975_cov_34.265982	477	557	2	47	80	0.5875000
NODE_7105_length_975_cov_31.888128	461	541	0	21	80	0.2625000
NODE_7105_length_975_cov_31.888128	461	541	2	59	80	0.7375000
NODE_7105_length_975_cov_31.888128	514	594	0	15	80	0.1875000
NODE_7105_length_975_cov_31.888128	514	594	2	65	80	0.8125000
NODE_7106_length_975_cov_22.093607	392	472	0	19	80	0.2375000
NODE_7106_length_975_cov_22.093607	392	472	2	20	80	0.2500000
NODE_7106_length_975_cov_22.093607	392	472	4	41	80	0.5125000
NODE_7106_length_975_cov_22.093607	445	525	2	33	80	0.4125000
NODE_7106_length_975_cov_22.093607	445	525	4	47	80	0.5875000
NODE_7107_length_975_cov_15.091324	403	483	6	80	80	1.0000000
NODE_7107_length_975_cov_15.091324	456	536	0	36	80	0.4500000
NODE_7107_length_975_cov_15.091324	456	536	6	44	80	0.5500000
NODE_7108_length_975_cov_15.046804	63	143	2	17	80	0.2125000
NODE_7108_length_975_cov_15.046804	63	143	6	63	80	0.7875000
NODE_7108_length_975_cov_15.046804	116	196	0	34	80	0.4250000
NODE_7108_length_975_cov_15.046804	116	196	4	17	80	0.2125000
NODE_7108_length_975_cov_15.046804	116	196	6	29	80	0.3625000
NODE_7109_length_975_cov_12.043379	535	615	4	80	80	1.0000000
NODE_7109_length_975_cov_12.043379	588	668	0	20	80	0.2500000
NODE_7109_length_975_cov_12.043379	588	668	4	60	80	0.7500000
NODE_7110_length_975_cov_11.772831	276	354	0	52	78	0.6666667
NODE_7110_length_975_cov_11.772831	276	354	2	26	78	0.3333333
NODE_7110_length_975_cov_11.772831	327	407	0	8	80	0.1000000
NODE_7110_length_975_cov_11.772831	327	407	2	72	80	0.9000000
NODE_7111_length_975_cov_10.599315	405	485	0	31	80	0.3875000
NODE_7111_length_975_cov_10.599315	405	485	2	31	80	0.3875000
NODE_7111_length_975_cov_10.599315	405	485	6	18	80	0.2250000
NODE_7111_length_975_cov_10.599315	458	538	2	9	80	0.1125000
NODE_7111_length_975_cov_10.599315	458	538	6	30	80	0.3750000
NODE_7111_length_975_cov_10.599315	458	538	8	41	80	0.5125000
NODE_7112_length_975_cov_8.089041	430	510	0	80	80	1.0000000
NODE_7112_length_975_cov_8.089041	483	563	0	80	80	1.0000000
NODE_7114_length_975_cov_3.728311	254	334	0	80	80	1.0000000
NODE_7114_length_975_cov_3.728311	307	387	0	80	80	1.0000000
NODE_7125_length_974_cov_293.334857	564	642	243	1	78	0.0128205
NODE_7125_length_974_cov_293.334857	564	642	247	1	78	0.0128205
NODE_7125_length_974_cov_293.334857	564	642	249	2	78	0.0256410
NODE_7125_length_974_cov_293.334857	564	642	252	2	78	0.0256410
NODE_7125_length_974_cov_293.334857	564	642	265	1	78	0.0128205
NODE_7125_length_974_cov_293.334857	564	642	269	3	78	0.0384615
NODE_7125_length_974_cov_293.334857	564	642	270	2	78	0.0256410
NODE_7125_length_974_cov_293.334857	564	642	272	1	78	0.0128205
NODE_7125_length_974_cov_293.334857	564	642	274	1	78	0.0128205
NODE_7125_length_974_cov_293.334857	564	642	276	1	78	0.0128205
NODE_7125_length_974_cov_293.334857	564	642	277	5	78	0.0641026
NODE_7125_length_974_cov_293.334857	564	642	278	2	78	0.0256410
NODE_7125_length_974_cov_293.334857	564	642	279	2	78	0.0256410
NODE_7125_length_974_cov_293.334857	564	642	280	1	78	0.0128205
NODE_7125_length_974_cov_293.334857	564	642	281	2	78	0.0256410
NODE_7125_length_974_cov_293.334857	564	642	284	1	78	0.0128205
NODE_7125_length_974_cov_293.334857	564	642	286	1	78	0.0128205
NODE_7125_length_974_cov_293.334857	564	642	288	1	78	0.0128205
NODE_7125_length_974_cov_293.334857	564	642	289	4	78	0.0512821
NODE_7125_length_974_cov_293.334857	564	642	290	3	78	0.0384615
NODE_7125_length_974_cov_293.334857	564	642	291	2	78	0.0256410
NODE_7125_length_974_cov_293.334857	564	642	292	6	78	0.0769231
NODE_7125_length_974_cov_293.334857	564	642	293	6	78	0.0769231
NODE_7125_length_974_cov_293.334857	564	642	294	4	78	0.0512821
NODE_7125_length_974_cov_293.334857	564	642	295	11	78	0.1410256
NODE_7125_length_974_cov_293.334857	564	642	296	3	78	0.0384615
NODE_7125_length_974_cov_293.334857	564	642	298	1	78	0.0128205
NODE_7125_length_974_cov_293.334857	564	642	300	1	78	0.0128205
NODE_7125_length_974_cov_293.334857	564	642	303	1	78	0.0128205
NODE_7125_length_974_cov_293.334857	564	642	310	1	78	0.0128205
NODE_7125_length_974_cov_293.334857	564	642	318	1	78	0.0128205
NODE_7125_length_974_cov_293.334857	564	642	319	1	78	0.0128205
NODE_7125_length_974_cov_293.334857	564	642	323	1	78	0.0128205
NODE_7125_length_974_cov_293.334857	564	642	326	1	78	0.0128205
NODE_7125_length_974_cov_293.334857	564	642	328	1	78	0.0128205
NODE_7125_length_974_cov_293.334857	564	642	243	1	78	0.0128205
NODE_7125_length_974_cov_293.334857	564	642	247	1	78	0.0128205
NODE_7125_length_974_cov_293.334857	564	642	249	2	78	0.0256410
NODE_7125_length_974_cov_293.334857	564	642	252	2	78	0.0256410
NODE_7125_length_974_cov_293.334857	564	642	265	1	78	0.0128205
NODE_7125_length_974_cov_293.334857	564	642	269	3	78	0.0384615
NODE_7125_length_974_cov_293.334857	564	642	270	2	78	0.0256410
NODE_7125_length_974_cov_293.334857	564	642	272	1	78	0.0128205
NODE_7125_length_974_cov_293.334857	564	642	274	1	78	0.0128205
NODE_7125_length_974_cov_293.334857	564	642	276	1	78	0.0128205
NODE_7125_length_974_cov_293.334857	564	642	277	5	78	0.0641026
NODE_7125_length_974_cov_293.334857	564	642	278	2	78	0.0256410
NODE_7125_length_974_cov_293.334857	564	642	279	2	78	0.0256410
NODE_7125_length_974_cov_293.334857	564	642	280	1	78	0.0128205
NODE_7125_length_974_cov_293.334857	564	642	281	2	78	0.0256410
NODE_7125_length_974_cov_293.334857	564	642	284	1	78	0.0128205
NODE_7125_length_974_cov_293.334857	564	642	286	1	78	0.0128205
NODE_7125_length_974_cov_293.334857	564	642	288	1	78	0.0128205
NODE_7125_length_974_cov_293.334857	564	642	289	4	78	0.0512821
NODE_7125_length_974_cov_293.334857	564	642	290	3	78	0.0384615
NODE_7125_length_974_cov_293.334857	564	642	291	2	78	0.0256410
NODE_7125_length_974_cov_293.334857	564	642	292	6	78	0.0769231
NODE_7125_length_974_cov_293.334857	564	642	293	6	78	0.0769231
NODE_7125_length_974_cov_293.334857	564	642	294	4	78	0.0512821
NODE_7125_length_974_cov_293.334857	564	642	295	11	78	0.1410256
NODE_7125_length_974_cov_293.334857	564	642	296	3	78	0.0384615
NODE_7125_length_974_cov_293.334857	564	642	298	1	78	0.0128205
NODE_7125_length_974_cov_293.334857	564	642	300	1	78	0.0128205
NODE_7125_length_974_cov_293.334857	564	642	303	1	78	0.0128205
NODE_7125_length_974_cov_293.334857	564	642	310	1	78	0.0128205
NODE_7125_length_974_cov_293.334857	564	642	318	1	78	0.0128205
NODE_7125_length_974_cov_293.334857	564	642	319	1	78	0.0128205
NODE_7125_length_974_cov_293.334857	564	642	323	1	78	0.0128205
NODE_7125_length_974_cov_293.334857	564	642	326	1	78	0.0128205
NODE_7125_length_974_cov_293.334857	564	642	328	1	78	0.0128205
NODE_7125_length_974_cov_293.334857	564	633	243	1	69	0.0144928
NODE_7125_length_974_cov_293.334857	564	633	247	1	69	0.0144928
NODE_7125_length_974_cov_293.334857	564	633	249	2	69	0.0289855
NODE_7125_length_974_cov_293.334857	564	633	252	2	69	0.0289855
NODE_7125_length_974_cov_293.334857	564	633	265	1	69	0.0144928
NODE_7125_length_974_cov_293.334857	564	633	269	3	69	0.0434783
NODE_7125_length_974_cov_293.334857	564	633	270	2	69	0.0289855
NODE_7125_length_974_cov_293.334857	564	633	272	1	69	0.0144928
NODE_7125_length_974_cov_293.334857	564	633	274	1	69	0.0144928
NODE_7125_length_974_cov_293.334857	564	633	277	5	69	0.0724638
NODE_7125_length_974_cov_293.334857	564	633	278	2	69	0.0289855
NODE_7125_length_974_cov_293.334857	564	633	279	2	69	0.0289855
NODE_7125_length_974_cov_293.334857	564	633	280	1	69	0.0144928
NODE_7125_length_974_cov_293.334857	564	633	281	2	69	0.0289855
NODE_7125_length_974_cov_293.334857	564	633	284	1	69	0.0144928
NODE_7125_length_974_cov_293.334857	564	633	286	1	69	0.0144928
NODE_7125_length_974_cov_293.334857	564	633	288	1	69	0.0144928
NODE_7125_length_974_cov_293.334857	564	633	289	4	69	0.0579710
NODE_7125_length_974_cov_293.334857	564	633	290	3	69	0.0434783
NODE_7125_length_974_cov_293.334857	564	633	292	4	69	0.0579710
NODE_7125_length_974_cov_293.334857	564	633	293	5	69	0.0724638
NODE_7125_length_974_cov_293.334857	564	633	294	4	69	0.0579710
NODE_7125_length_974_cov_293.334857	564	633	295	8	69	0.1159420
NODE_7125_length_974_cov_293.334857	564	633	296	3	69	0.0434783
NODE_7125_length_974_cov_293.334857	564	633	298	1	69	0.0144928
NODE_7125_length_974_cov_293.334857	564	633	300	1	69	0.0144928
NODE_7125_length_974_cov_293.334857	564	633	303	1	69	0.0144928
NODE_7125_length_974_cov_293.334857	564	633	310	1	69	0.0144928
NODE_7125_length_974_cov_293.334857	564	633	318	1	69	0.0144928
NODE_7125_length_974_cov_293.334857	564	633	319	1	69	0.0144928
NODE_7125_length_974_cov_293.334857	564	633	323	1	69	0.0144928
NODE_7125_length_974_cov_293.334857	564	633	326	1	69	0.0144928
NODE_7125_length_974_cov_293.334857	564	633	328	1	69	0.0144928
NODE_7126_length_974_cov_49.884571	459	539	2	80	80	1.0000000
NODE_7126_length_974_cov_49.884571	512	592	0	53	80	0.6625000
NODE_7126_length_974_cov_49.884571	512	592	2	27	80	0.3375000
NODE_7127_length_974_cov_38.384000	430	508	2	13	78	0.1666667
NODE_7127_length_974_cov_38.384000	430	508	4	65	78	0.8333333
NODE_7127_length_974_cov_38.384000	483	561	0	34	78	0.4358974
NODE_7127_length_974_cov_38.384000	483	561	2	20	78	0.2564103
NODE_7127_length_974_cov_38.384000	483	561	4	24	78	0.3076923
NODE_7128_length_974_cov_26.008000	391	471	0	80	80	1.0000000
NODE_7128_length_974_cov_26.008000	444	524	0	63	80	0.7875000
NODE_7128_length_974_cov_26.008000	444	524	2	17	80	0.2125000
NODE_7128_length_974_cov_26.008000	520	600	2	47	80	0.5875000
NODE_7128_length_974_cov_26.008000	520	600	3	1	80	0.0125000
NODE_7128_length_974_cov_26.008000	520	600	4	32	80	0.4000000
NODE_7128_length_974_cov_26.008000	573	653	2	68	80	0.8500000
NODE_7128_length_974_cov_26.008000	573	653	4	12	80	0.1500000
NODE_7129_length_974_cov_21.160000	460	540	2	29	80	0.3625000
NODE_7129_length_974_cov_21.160000	460	540	6	20	80	0.2500000
NODE_7129_length_974_cov_21.160000	460	540	8	31	80	0.3875000
NODE_7129_length_974_cov_21.160000	513	593	4	5	80	0.0625000
NODE_7129_length_974_cov_21.160000	513	593	6	20	80	0.2500000
NODE_7129_length_974_cov_21.160000	513	593	8	41	80	0.5125000
NODE_7129_length_974_cov_21.160000	513	593	10	14	80	0.1750000
NODE_7131_length_974_cov_11.384000	290	370	0	80	80	1.0000000
NODE_7131_length_974_cov_11.384000	343	423	0	80	80	1.0000000
NODE_7132_length_974_cov_11.216000	543	623	0	15	80	0.1875000
NODE_7132_length_974_cov_11.216000	543	623	2	19	80	0.2375000
NODE_7132_length_974_cov_11.216000	543	623	6	46	80	0.5750000
NODE_7132_length_974_cov_11.216000	596	668	0	60	72	0.8333333
NODE_7132_length_974_cov_11.216000	596	668	2	12	72	0.1666667
NODE_7133_length_974_cov_9.601143	436	516	0	36	80	0.4500000
NODE_7133_length_974_cov_9.601143	436	516	1	5	80	0.0625000
NODE_7133_length_974_cov_9.601143	436	516	3	21	80	0.2625000
NODE_7133_length_974_cov_9.601143	436	516	4	18	80	0.2250000
NODE_7133_length_974_cov_9.601143	489	569	0	80	80	1.0000000
NODE_7134_length_974_cov_7.436571	382	462	0	80	80	1.0000000
NODE_7134_length_974_cov_7.436571	436	515	0	79	79	1.0000000
NODE_7147_length_973_cov_46.012586	349	429	0	36	80	0.4500000
NODE_7147_length_973_cov_46.012586	349	429	2	44	80	0.5500000
NODE_7147_length_973_cov_46.012586	402	482	0	28	80	0.3500000
NODE_7147_length_973_cov_46.012586	402	482	2	46	80	0.5750000
NODE_7147_length_973_cov_46.012586	402	482	4	6	80	0.0750000
NODE_7147_length_973_cov_46.012586	478	558	4	7	80	0.0875000
NODE_7147_length_973_cov_46.012586	478	558	6	42	80	0.5250000
NODE_7147_length_973_cov_46.012586	478	558	10	13	80	0.1625000
NODE_7147_length_973_cov_46.012586	478	558	12	5	80	0.0625000
NODE_7147_length_973_cov_46.012586	478	558	14	11	80	0.1375000
NODE_7147_length_973_cov_46.012586	478	558	16	2	80	0.0250000
NODE_7147_length_973_cov_46.012586	531	611	10	9	80	0.1125000
NODE_7147_length_973_cov_46.012586	531	611	12	45	80	0.5625000
NODE_7147_length_973_cov_46.012586	531	611	14	18	80	0.2250000
NODE_7147_length_973_cov_46.012586	531	611	16	8	80	0.1000000
NODE_7148_length_973_cov_40.305492	364	444	0	80	80	1.0000000
NODE_7148_length_973_cov_40.305492	417	497	0	60	80	0.7500000
NODE_7148_length_973_cov_40.305492	417	497	2	20	80	0.2500000
NODE_7149_length_973_cov_24.105263	460	540	2	64	80	0.8000000
NODE_7149_length_973_cov_24.105263	460	540	4	16	80	0.2000000
NODE_7149_length_973_cov_24.105263	513	593	2	68	80	0.8500000
NODE_7149_length_973_cov_24.105263	513	593	4	12	80	0.1500000
NODE_7150_length_973_cov_22.106407	342	422	2	57	80	0.7125000
NODE_7150_length_973_cov_22.106407	342	422	4	23	80	0.2875000
NODE_7150_length_973_cov_22.106407	395	475	2	69	80	0.8625000
NODE_7150_length_973_cov_22.106407	395	475	4	11	80	0.1375000
NODE_7150_length_973_cov_22.106407	471	550	0	63	79	0.7974684
NODE_7150_length_973_cov_22.106407	471	550	2	16	79	0.2025317
NODE_7150_length_973_cov_22.106407	526	604	0	78	78	1.0000000
NODE_7151_length_973_cov_10.994279	430	510	0	16	80	0.2000000
NODE_7151_length_973_cov_10.994279	430	510	2	64	80	0.8000000
NODE_7151_length_973_cov_10.994279	483	563	0	16	80	0.2000000
NODE_7151_length_973_cov_10.994279	483	563	2	64	80	0.8000000
NODE_7151_length_973_cov_10.994279	559	635	0	76	76	1.0000000
NODE_7151_length_973_cov_10.994279	608	688	0	80	80	1.0000000
NODE_7153_length_973_cov_2.973684	734	814	0	66	80	0.8250000
NODE_7153_length_973_cov_2.973684	734	814	2	2	80	0.0250000
NODE_7153_length_973_cov_2.973684	734	814	4	6	80	0.0750000
NODE_7153_length_973_cov_2.973684	734	814	6	6	80	0.0750000
NODE_7153_length_973_cov_2.973684	820	890	10	1	70	0.0142857
NODE_7153_length_973_cov_2.973684	820	890	14	20	70	0.2857143
NODE_7153_length_973_cov_2.973684	820	890	16	2	70	0.0285714
NODE_7153_length_973_cov_2.973684	820	890	18	6	70	0.0857143
NODE_7153_length_973_cov_2.973684	820	890	20	41	70	0.5857143
NODE_7153_length_973_cov_2.973684	863	944	2	8	81	0.0987654
NODE_7153_length_973_cov_2.973684	863	944	4	4	81	0.0493827
NODE_7153_length_973_cov_2.973684	863	944	6	1	81	0.0123457
NODE_7153_length_973_cov_2.973684	863	944	8	8	81	0.0987654
NODE_7153_length_973_cov_2.973684	863	944	12	8	81	0.0987654
NODE_7153_length_973_cov_2.973684	863	944	14	1	81	0.0123457
NODE_7153_length_973_cov_2.973684	863	944	16	8	81	0.0987654
NODE_7153_length_973_cov_2.973684	863	944	18	3	81	0.0370370
NODE_7153_length_973_cov_2.973684	863	944	20	40	81	0.4938272
NODE_7166_length_972_cov_32.547537	299	379	0	80	80	1.0000000
NODE_7166_length_972_cov_32.547537	352	432	0	80	80	1.0000000
NODE_7166_length_972_cov_32.547537	428	508	0	32	80	0.4000000
NODE_7166_length_972_cov_32.547537	428	508	2	48	80	0.6000000
NODE_7166_length_972_cov_32.547537	481	561	2	80	80	1.0000000
NODE_7167_length_972_cov_31.010309	474	554	2	26	80	0.3250000
NODE_7167_length_972_cov_31.010309	474	554	4	54	80	0.6750000
NODE_7167_length_972_cov_31.010309	527	607	0	42	80	0.5250000
NODE_7167_length_972_cov_31.010309	527	607	2	27	80	0.3375000
NODE_7167_length_972_cov_31.010309	527	607	4	11	80	0.1375000
NODE_7168_length_972_cov_29.810997	481	561	6	21	80	0.2625000
NODE_7168_length_972_cov_29.810997	481	561	7	24	80	0.3000000
NODE_7168_length_972_cov_29.810997	481	561	8	10	80	0.1250000
NODE_7168_length_972_cov_29.810997	481	561	10	19	80	0.2375000
NODE_7168_length_972_cov_29.810997	481	561	11	6	80	0.0750000
NODE_7168_length_972_cov_29.810997	534	614	6	2	80	0.0250000
NODE_7168_length_972_cov_29.810997	534	614	7	20	80	0.2500000
NODE_7168_length_972_cov_29.810997	534	614	9	22	80	0.2750000
NODE_7168_length_972_cov_29.810997	534	614	10	26	80	0.3250000
NODE_7168_length_972_cov_29.810997	534	614	11	10	80	0.1250000
NODE_7169_length_972_cov_23.438717	442	522	0	8	80	0.1000000
NODE_7169_length_972_cov_23.438717	442	522	4	55	80	0.6875000
NODE_7169_length_972_cov_23.438717	442	522	6	17	80	0.2125000
NODE_7169_length_972_cov_23.438717	495	575	4	10	80	0.1250000
NODE_7169_length_972_cov_23.438717	495	575	6	70	80	0.8750000
NODE_7170_length_972_cov_18.886598	453	533	4	13	80	0.1625000
NODE_7170_length_972_cov_18.886598	453	533	6	32	80	0.4000000
NODE_7170_length_972_cov_18.886598	453	533	8	2	80	0.0250000
NODE_7170_length_972_cov_18.886598	453	533	10	33	80	0.4125000
NODE_7170_length_972_cov_18.886598	506	585	6	5	79	0.0632911
NODE_7170_length_972_cov_18.886598	506	585	7	16	79	0.2025317
NODE_7170_length_972_cov_18.886598	506	585	8	24	79	0.3037975
NODE_7170_length_972_cov_18.886598	506	585	9	6	79	0.0759494
NODE_7170_length_972_cov_18.886598	506	585	10	28	79	0.3544304
NODE_7171_length_972_cov_15.100802	329	409	0	8	80	0.1000000
NODE_7171_length_972_cov_15.100802	329	409	2	22	80	0.2750000
NODE_7171_length_972_cov_15.100802	329	409	4	50	80	0.6250000
NODE_7171_length_972_cov_15.100802	382	462	0	34	80	0.4250000
NODE_7171_length_972_cov_15.100802	382	462	2	14	80	0.1750000
NODE_7171_length_972_cov_15.100802	382	462	4	32	80	0.4000000
NODE_7172_length_972_cov_12.674685	444	524	0	49	80	0.6125000
NODE_7172_length_972_cov_12.674685	444	524	2	31	80	0.3875000
NODE_7172_length_972_cov_12.674685	497	577	0	80	80	1.0000000
NODE_7173_length_972_cov_11.235968	504	584	1	10	80	0.1250000
NODE_7173_length_972_cov_11.235968	504	584	2	70	80	0.8750000
NODE_7173_length_972_cov_11.235968	557	637	0	29	80	0.3625000
NODE_7173_length_972_cov_11.235968	557	637	1	34	80	0.4250000
NODE_7173_length_972_cov_11.235968	557	637	2	17	80	0.2125000
NODE_7174_length_972_cov_10.983963	402	482	0	80	80	1.0000000
NODE_7174_length_972_cov_10.983963	455	535	0	80	80	1.0000000
NODE_7175_length_972_cov_8.887743	302	382	0	80	80	1.0000000
NODE_7175_length_972_cov_8.887743	355	430	0	75	75	1.0000000
NODE_7176_length_972_cov_8.265750	488	568	0	80	80	1.0000000
NODE_7176_length_972_cov_8.265750	541	621	0	80	80	1.0000000
NODE_7182_length_972_cov_2.714777	165	241	0	4	76	0.0526316
NODE_7182_length_972_cov_2.714777	165	241	4	10	76	0.1315790
NODE_7182_length_972_cov_2.714777	165	241	5	35	76	0.4605263
NODE_7182_length_972_cov_2.714777	165	241	6	6	76	0.0789474
NODE_7182_length_972_cov_2.714777	165	241	8	21	76	0.2763158
NODE_7195_length_971_cov_52.575688	398	478	2	80	80	1.0000000
NODE_7195_length_971_cov_52.575688	451	531	1	22	80	0.2750000
NODE_7195_length_971_cov_52.575688	451	531	2	58	80	0.7250000
NODE_7195_length_971_cov_52.575688	527	607	0	61	80	0.7625000
NODE_7195_length_971_cov_52.575688	527	607	1	19	80	0.2375000
NODE_7195_length_971_cov_52.575688	580	660	0	80	80	1.0000000
NODE_7196_length_971_cov_44.464450	280	360	0	80	80	1.0000000
NODE_7196_length_971_cov_44.464450	333	413	0	74	80	0.9250000
NODE_7196_length_971_cov_44.464450	333	413	2	6	80	0.0750000
NODE_7196_length_971_cov_44.464450	409	489	2	80	80	1.0000000
NODE_7196_length_971_cov_44.464450	462	542	0	10	80	0.1250000
NODE_7196_length_971_cov_44.464450	462	542	2	70	80	0.8750000
NODE_7197_length_971_cov_32.721330	509	589	2	18	80	0.2250000
NODE_7197_length_971_cov_32.721330	509	589	4	60	80	0.7500000
NODE_7197_length_971_cov_32.721330	509	589	6	2	80	0.0250000
NODE_7197_length_971_cov_32.721330	562	642	0	26	80	0.3250000
NODE_7197_length_971_cov_32.721330	562	642	2	8	80	0.1000000
NODE_7197_length_971_cov_32.721330	562	642	4	46	80	0.5750000
NODE_7198_length_971_cov_30.264908	474	554	0	45	80	0.5625000
NODE_7198_length_971_cov_30.264908	474	554	2	35	80	0.4375000
NODE_7198_length_971_cov_30.264908	527	607	0	23	80	0.2875000
NODE_7198_length_971_cov_30.264908	527	607	2	57	80	0.7125000
NODE_7199_length_971_cov_26.631881	434	514	0	80	80	1.0000000
NODE_7199_length_971_cov_26.631881	487	567	0	80	80	1.0000000
NODE_7200_length_971_cov_25.635321	404	484	0	80	80	1.0000000
NODE_7200_length_971_cov_25.635321	457	537	0	80	80	1.0000000
NODE_7201_length_971_cov_23.334862	363	443	0	18	80	0.2250000
NODE_7201_length_971_cov_23.334862	363	443	2	62	80	0.7750000
NODE_7201_length_971_cov_23.334862	416	497	0	22	81	0.2716049
NODE_7201_length_971_cov_23.334862	416	497	2	59	81	0.7283950
NODE_7202_length_971_cov_18.254587	468	548	4	80	80	1.0000000
NODE_7202_length_971_cov_18.254587	521	601	0	34	80	0.4250000
NODE_7202_length_971_cov_18.254587	521	601	4	46	80	0.5750000
NODE_7203_length_971_cov_18.229358	392	472	0	80	80	1.0000000
NODE_7203_length_971_cov_18.229358	445	525	0	68	80	0.8500000
NODE_7203_length_971_cov_18.229358	445	525	2	1	80	0.0125000
NODE_7203_length_971_cov_18.229358	445	525	4	11	80	0.1375000
NODE_7204_length_971_cov_16.591743	481	561	0	43	80	0.5375000
NODE_7204_length_971_cov_16.591743	481	561	2	37	80	0.4625000
NODE_7204_length_971_cov_16.591743	534	614	2	80	80	1.0000000
NODE_7205_length_971_cov_15.563073	463	543	2	16	80	0.2000000
NODE_7205_length_971_cov_15.563073	463	543	4	4	80	0.0500000
NODE_7205_length_971_cov_15.563073	463	543	6	21	80	0.2625000
NODE_7205_length_971_cov_15.563073	463	543	7	1	80	0.0125000
NODE_7205_length_971_cov_15.563073	463	543	8	38	80	0.4750000
NODE_7205_length_971_cov_15.563073	516	596	8	80	80	1.0000000
NODE_7206_length_971_cov_12.141055	415	495	0	80	80	1.0000000
NODE_7206_length_971_cov_12.141055	468	548	0	80	80	1.0000000
NODE_7222_length_970_cov_34.928817	438	518	0	80	80	1.0000000
NODE_7222_length_970_cov_34.928817	491	571	0	39	80	0.4875000
NODE_7222_length_970_cov_34.928817	491	571	2	41	80	0.5125000
NODE_7223_length_970_cov_34.445465	540	620	16	1	80	0.0125000
NODE_7223_length_970_cov_34.445465	540	620	18	79	80	0.9875000
NODE_7223_length_970_cov_34.445465	593	673	0	18	80	0.2250000
NODE_7223_length_970_cov_34.445465	593	673	2	5	80	0.0625000
NODE_7223_length_970_cov_34.445465	593	673	4	8	80	0.1000000
NODE_7223_length_970_cov_34.445465	593	673	8	2	80	0.0250000
NODE_7223_length_970_cov_34.445465	593	673	12	19	80	0.2375000
NODE_7223_length_970_cov_34.445465	593	673	18	28	80	0.3500000
NODE_7224_length_970_cov_34.257176	352	432	0	42	80	0.5250000
NODE_7224_length_970_cov_34.257176	352	432	1	5	80	0.0625000
NODE_7224_length_970_cov_34.257176	352	432	2	33	80	0.4125000
NODE_7224_length_970_cov_34.257176	405	485	0	48	80	0.6000000
NODE_7224_length_970_cov_34.257176	405	485	2	32	80	0.4000000
NODE_7225_length_970_cov_26.904707	297	372	25	3	75	0.0400000
NODE_7225_length_970_cov_26.904707	297	372	27	2	75	0.0266667
NODE_7225_length_970_cov_26.904707	297	372	30	14	75	0.1866667
NODE_7225_length_970_cov_26.904707	297	372	32	5	75	0.0666667
NODE_7225_length_970_cov_26.904707	297	372	33	10	75	0.1333333
NODE_7225_length_970_cov_26.904707	297	372	35	41	75	0.5466667
NODE_7225_length_970_cov_26.904707	303	376	23	2	73	0.0273973
NODE_7225_length_970_cov_26.904707	303	376	25	5	73	0.0684932
NODE_7225_length_970_cov_26.904707	303	376	27	2	73	0.0273973
NODE_7225_length_970_cov_26.904707	303	376	30	14	73	0.1917808
NODE_7225_length_970_cov_26.904707	303	376	32	5	73	0.0684932
NODE_7225_length_970_cov_26.904707	303	376	33	10	73	0.1369863
NODE_7225_length_970_cov_26.904707	303	376	35	35	73	0.4794520
NODE_7225_length_970_cov_26.904707	311	377	23	3	66	0.0454545
NODE_7225_length_970_cov_26.904707	311	377	25	5	66	0.0757576
NODE_7225_length_970_cov_26.904707	311	377	27	2	66	0.0303030
NODE_7225_length_970_cov_26.904707	311	377	30	14	66	0.2121212
NODE_7225_length_970_cov_26.904707	311	377	32	5	66	0.0757576
NODE_7225_length_970_cov_26.904707	311	377	33	10	66	0.1515152
NODE_7225_length_970_cov_26.904707	311	377	35	27	66	0.4090909
NODE_7225_length_970_cov_26.904707	350	429	0	19	79	0.2405063
NODE_7225_length_970_cov_26.904707	350	429	13	9	79	0.1139240
NODE_7225_length_970_cov_26.904707	350	429	14	1	79	0.0126582
NODE_7225_length_970_cov_26.904707	350	429	21	5	79	0.0632911
NODE_7225_length_970_cov_26.904707	350	429	23	21	79	0.2658228
NODE_7225_length_970_cov_26.904707	350	429	25	5	79	0.0632911
NODE_7225_length_970_cov_26.904707	350	429	27	2	79	0.0253165
NODE_7225_length_970_cov_26.904707	350	429	30	14	79	0.1772152
NODE_7225_length_970_cov_26.904707	350	429	32	3	79	0.0379747
NODE_7225_length_970_cov_26.904707	350	429	0	19	79	0.2405063
NODE_7225_length_970_cov_26.904707	350	429	13	9	79	0.1139240
NODE_7225_length_970_cov_26.904707	350	429	14	1	79	0.0126582
NODE_7225_length_970_cov_26.904707	350	429	21	5	79	0.0632911
NODE_7225_length_970_cov_26.904707	350	429	23	21	79	0.2658228
NODE_7225_length_970_cov_26.904707	350	429	25	5	79	0.0632911
NODE_7225_length_970_cov_26.904707	350	429	27	2	79	0.0253165
NODE_7225_length_970_cov_26.904707	350	429	30	14	79	0.1772152
NODE_7225_length_970_cov_26.904707	350	429	32	3	79	0.0379747
NODE_7225_length_970_cov_26.904707	350	429	0	19	79	0.2405063
NODE_7225_length_970_cov_26.904707	350	429	13	9	79	0.1139240
NODE_7225_length_970_cov_26.904707	350	429	14	1	79	0.0126582
NODE_7225_length_970_cov_26.904707	350	429	21	5	79	0.0632911
NODE_7225_length_970_cov_26.904707	350	429	23	21	79	0.2658228
NODE_7225_length_970_cov_26.904707	350	429	25	5	79	0.0632911
NODE_7225_length_970_cov_26.904707	350	429	27	2	79	0.0253165
NODE_7225_length_970_cov_26.904707	350	429	30	14	79	0.1772152
NODE_7225_length_970_cov_26.904707	350	429	32	3	79	0.0379747
NODE_7226_length_970_cov_26.040184	266	346	0	80	80	1.0000000
NODE_7226_length_970_cov_26.040184	319	399	0	80	80	1.0000000
NODE_7226_length_970_cov_26.040184	395	475	0	36	80	0.4500000
NODE_7226_length_970_cov_26.040184	395	475	1	1	80	0.0125000
NODE_7226_length_970_cov_26.040184	395	475	2	19	80	0.2375000
NODE_7226_length_970_cov_26.040184	395	475	3	24	80	0.3000000
NODE_7226_length_970_cov_26.040184	448	528	2	3	80	0.0375000
NODE_7226_length_970_cov_26.040184	448	528	3	77	80	0.9625000
NODE_7227_length_970_cov_19.291619	415	495	0	12	80	0.1500000
NODE_7227_length_970_cov_19.291619	415	495	2	68	80	0.8500000
NODE_7227_length_970_cov_19.291619	468	548	0	20	80	0.2500000
NODE_7227_length_970_cov_19.291619	468	548	2	60	80	0.7500000
NODE_7228_length_970_cov_17.731343	557	637	0	25	80	0.3125000
NODE_7228_length_970_cov_17.731343	557	637	2	55	80	0.6875000
NODE_7228_length_970_cov_17.731343	610	690	0	32	80	0.4000000
NODE_7228_length_970_cov_17.731343	610	690	2	48	80	0.6000000
NODE_7229_length_970_cov_15.135476	407	487	0	80	80	1.0000000
NODE_7229_length_970_cov_15.135476	460	540	0	80	80	1.0000000
NODE_7230_length_970_cov_12.675086	534	614	0	6	80	0.0750000
NODE_7230_length_970_cov_12.675086	534	614	2	5	80	0.0625000
NODE_7230_length_970_cov_12.675086	534	614	4	69	80	0.8625000
NODE_7230_length_970_cov_12.675086	587	667	2	22	80	0.2750000
NODE_7230_length_970_cov_12.675086	587	667	4	58	80	0.7250000
NODE_7231_length_970_cov_8.095293	487	567	0	80	80	1.0000000
NODE_7231_length_970_cov_8.095293	540	620	0	80	80	1.0000000
NODE_7233_length_970_cov_7.127440	336	416	0	80	80	1.0000000
NODE_7233_length_970_cov_7.127440	389	469	0	80	80	1.0000000
NODE_7234_length_970_cov_5.824340	0	56	0	56	56	1.0000000
NODE_7246_length_969_cov_47.172414	419	499	0	80	80	1.0000000
NODE_7246_length_969_cov_47.172414	472	552	0	80	80	1.0000000
NODE_7247_length_969_cov_28.234483	327	407	0	67	80	0.8375000
NODE_7247_length_969_cov_28.234483	327	407	2	3	80	0.0375000
NODE_7247_length_969_cov_28.234483	327	407	4	4	80	0.0500000
NODE_7247_length_969_cov_28.234483	327	407	6	2	80	0.0250000
NODE_7247_length_969_cov_28.234483	327	407	9	4	80	0.0500000
NODE_7247_length_969_cov_28.234483	380	460	0	14	80	0.1750000
NODE_7247_length_969_cov_28.234483	380	460	2	3	80	0.0375000
NODE_7247_length_969_cov_28.234483	380	460	4	4	80	0.0500000
NODE_7247_length_969_cov_28.234483	380	460	6	2	80	0.0250000
NODE_7247_length_969_cov_28.234483	380	460	9	48	80	0.6000000
NODE_7247_length_969_cov_28.234483	380	460	10	9	80	0.1125000
NODE_7248_length_969_cov_27.131034	392	472	0	80	80	1.0000000
NODE_7248_length_969_cov_27.131034	445	525	0	80	80	1.0000000
NODE_7249_length_969_cov_26.345977	466	542	0	11	76	0.1447368
NODE_7249_length_969_cov_26.345977	466	542	2	65	76	0.8552632
NODE_7249_length_969_cov_26.345977	515	595	0	2	80	0.0250000
NODE_7249_length_969_cov_26.345977	515	595	2	78	80	0.9750000
NODE_7250_length_969_cov_18.954023	274	354	0	25	80	0.3125000
NODE_7250_length_969_cov_18.954023	274	354	4	55	80	0.6875000
NODE_7250_length_969_cov_18.954023	327	407	4	80	80	1.0000000
NODE_7251_length_969_cov_17.952874	410	490	0	15	80	0.1875000
NODE_7251_length_969_cov_17.952874	410	490	2	65	80	0.8125000
NODE_7251_length_969_cov_17.952874	463	543	0	68	80	0.8500000
NODE_7251_length_969_cov_17.952874	463	543	2	12	80	0.1500000
NODE_7251_length_969_cov_17.952874	693	773	0	42	80	0.5250000
NODE_7251_length_969_cov_17.952874	693	773	2	38	80	0.4750000
NODE_7251_length_969_cov_17.952874	746	826	2	58	80	0.7250000
NODE_7251_length_969_cov_17.952874	746	826	4	22	80	0.2750000
NODE_7252_length_969_cov_15.942529	446	526	0	80	80	1.0000000
NODE_7252_length_969_cov_15.942529	499	579	0	80	80	1.0000000
NODE_7253_length_969_cov_9.926437	573	653	0	80	80	1.0000000
NODE_7253_length_969_cov_9.926437	626	706	0	80	80	1.0000000
NODE_7265_length_968_cov_59.162255	376	456	0	80	80	1.0000000
NODE_7265_length_968_cov_59.162255	429	509	0	40	80	0.5000000
NODE_7265_length_968_cov_59.162255	429	509	2	40	80	0.5000000
NODE_7265_length_968_cov_59.162255	505	585	2	43	80	0.5375000
NODE_7265_length_968_cov_59.162255	505	585	5	1	80	0.0125000
NODE_7265_length_968_cov_59.162255	505	585	6	27	80	0.3375000
NODE_7265_length_968_cov_59.162255	505	585	8	9	80	0.1125000
NODE_7265_length_968_cov_59.162255	558	638	6	58	80	0.7250000
NODE_7265_length_968_cov_59.162255	558	638	8	22	80	0.2750000
NODE_7266_length_968_cov_40.005754	514	594	0	6	80	0.0750000
NODE_7266_length_968_cov_40.005754	514	594	1	74	80	0.9250000
NODE_7266_length_968_cov_40.005754	567	647	1	80	80	1.0000000
NODE_7267_length_968_cov_36.521289	450	530	0	14	80	0.1750000
NODE_7267_length_968_cov_36.521289	450	530	2	10	80	0.1250000
NODE_7267_length_968_cov_36.521289	450	530	4	56	80	0.7000000
NODE_7267_length_968_cov_36.521289	503	583	2	62	80	0.7750000
NODE_7267_length_968_cov_36.521289	503	583	4	18	80	0.2250000
NODE_7268_length_968_cov_34.799770	474	554	0	19	80	0.2375000
NODE_7268_length_968_cov_34.799770	474	554	3	1	80	0.0125000
NODE_7268_length_968_cov_34.799770	474	554	4	60	80	0.7500000
NODE_7268_length_968_cov_34.799770	527	607	0	14	80	0.1750000
NODE_7268_length_968_cov_34.799770	527	607	4	66	80	0.8250000
NODE_7269_length_968_cov_26.929804	293	372	4	33	79	0.4177215
NODE_7269_length_968_cov_26.929804	293	372	6	46	79	0.5822785
NODE_7269_length_968_cov_26.929804	345	425	0	38	80	0.4750000
NODE_7269_length_968_cov_26.929804	345	425	2	10	80	0.1250000
NODE_7269_length_968_cov_26.929804	345	425	4	27	80	0.3375000
NODE_7269_length_968_cov_26.929804	345	425	6	5	80	0.0625000
NODE_7269_length_968_cov_26.929804	421	501	0	4	80	0.0500000
NODE_7269_length_968_cov_26.929804	421	501	2	10	80	0.1250000
NODE_7269_length_968_cov_26.929804	421	501	4	2	80	0.0250000
NODE_7269_length_968_cov_26.929804	421	501	6	3	80	0.0375000
NODE_7269_length_968_cov_26.929804	421	501	8	13	80	0.1625000
NODE_7269_length_968_cov_26.929804	421	501	10	16	80	0.2000000
NODE_7269_length_968_cov_26.929804	421	501	12	32	80	0.4000000
NODE_7269_length_968_cov_26.929804	474	554	8	29	80	0.3625000
NODE_7269_length_968_cov_26.929804	474	554	10	23	80	0.2875000
NODE_7269_length_968_cov_26.929804	474	554	12	28	80	0.3500000
NODE_7270_length_968_cov_24.468354	434	514	2	12	80	0.1500000
NODE_7270_length_968_cov_24.468354	434	514	4	4	80	0.0500000
NODE_7270_length_968_cov_24.468354	434	514	6	64	80	0.8000000
NODE_7270_length_968_cov_24.468354	487	567	0	32	80	0.4000000
NODE_7270_length_968_cov_24.468354	487	567	2	33	80	0.4125000
NODE_7270_length_968_cov_24.468354	487	567	4	4	80	0.0500000
NODE_7270_length_968_cov_24.468354	487	567	6	11	80	0.1375000
NODE_7271_length_968_cov_23.204833	344	424	0	23	80	0.2875000
NODE_7271_length_968_cov_23.204833	344	424	2	57	80	0.7125000
NODE_7271_length_968_cov_23.204833	397	477	0	65	80	0.8125000
NODE_7271_length_968_cov_23.204833	397	477	2	15	80	0.1875000
NODE_7271_length_968_cov_23.204833	473	553	0	33	80	0.4125000
NODE_7271_length_968_cov_23.204833	473	553	2	47	80	0.5875000
NODE_7271_length_968_cov_23.204833	526	606	0	3	80	0.0375000
NODE_7271_length_968_cov_23.204833	526	606	2	77	80	0.9625000
NODE_7272_length_968_cov_22.321059	417	497	0	75	80	0.9375000
NODE_7272_length_968_cov_22.321059	417	497	2	5	80	0.0625000
NODE_7272_length_968_cov_22.321059	470	550	0	22	80	0.2750000
NODE_7272_length_968_cov_22.321059	470	550	2	58	80	0.7250000
NODE_7273_length_968_cov_20.897583	313	393	5	2	80	0.0250000
NODE_7273_length_968_cov_20.897583	313	393	7	11	80	0.1375000
NODE_7273_length_968_cov_20.897583	313	393	9	30	80	0.3750000
NODE_7273_length_968_cov_20.897583	313	393	11	8	80	0.1000000
NODE_7273_length_968_cov_20.897583	313	393	12	12	80	0.1500000
NODE_7273_length_968_cov_20.897583	313	393	14	17	80	0.2125000
NODE_7273_length_968_cov_20.897583	366	446	4	7	80	0.0875000
NODE_7273_length_968_cov_20.897583	366	446	6	28	80	0.3500000
NODE_7273_length_968_cov_20.897583	366	446	8	1	80	0.0125000
NODE_7273_length_968_cov_20.897583	366	446	10	7	80	0.0875000
NODE_7273_length_968_cov_20.897583	366	446	12	10	80	0.1250000
NODE_7273_length_968_cov_20.897583	366	446	13	1	80	0.0125000
NODE_7273_length_968_cov_20.897583	366	446	14	26	80	0.3250000
NODE_7274_length_968_cov_19.296893	401	481	8	33	80	0.4125000
NODE_7274_length_968_cov_19.296893	401	481	10	41	80	0.5125000
NODE_7274_length_968_cov_19.296893	401	481	12	6	80	0.0750000
NODE_7274_length_968_cov_19.296893	454	534	2	14	80	0.1750000
NODE_7274_length_968_cov_19.296893	454	534	4	15	80	0.1875000
NODE_7274_length_968_cov_19.296893	454	534	6	3	80	0.0375000
NODE_7274_length_968_cov_19.296893	454	534	10	42	80	0.5250000
NODE_7274_length_968_cov_19.296893	454	534	12	6	80	0.0750000
NODE_7275_length_968_cov_18.100115	573	653	0	16	80	0.2000000
NODE_7275_length_968_cov_18.100115	573	653	2	64	80	0.8000000
NODE_7275_length_968_cov_18.100115	626	706	0	64	80	0.8000000
NODE_7275_length_968_cov_18.100115	626	706	2	16	80	0.2000000
NODE_7276_length_968_cov_15.576525	472	552	0	53	80	0.6625000
NODE_7276_length_968_cov_15.576525	472	552	2	27	80	0.3375000
NODE_7276_length_968_cov_15.576525	525	605	2	80	80	1.0000000
NODE_7277_length_968_cov_15.024166	329	409	0	80	80	1.0000000
NODE_7277_length_968_cov_15.024166	382	462	0	80	80	1.0000000
NODE_7277_length_968_cov_15.024166	458	538	0	73	80	0.9125000
NODE_7277_length_968_cov_15.024166	458	538	2	7	80	0.0875000
NODE_7277_length_968_cov_15.024166	511	591	0	20	80	0.2500000
NODE_7277_length_968_cov_15.024166	511	591	2	60	80	0.7500000
NODE_7278_length_968_cov_13.911392	674	754	0	3	80	0.0375000
NODE_7278_length_968_cov_13.911392	674	754	2	1	80	0.0125000
NODE_7278_length_968_cov_13.911392	674	754	3	5	80	0.0625000
NODE_7278_length_968_cov_13.911392	674	754	5	37	80	0.4625000
NODE_7278_length_968_cov_13.911392	674	754	6	34	80	0.4250000
NODE_7278_length_968_cov_13.911392	727	807	0	56	80	0.7000000
NODE_7278_length_968_cov_13.911392	727	807	3	5	80	0.0625000
NODE_7278_length_968_cov_13.911392	727	807	5	19	80	0.2375000
NODE_7279_length_968_cov_11.698504	598	678	2	33	80	0.4125000
NODE_7279_length_968_cov_11.698504	598	678	4	47	80	0.5875000
NODE_7279_length_968_cov_11.698504	651	731	0	25	80	0.3125000
NODE_7279_length_968_cov_11.698504	651	731	2	35	80	0.4375000
NODE_7279_length_968_cov_11.698504	651	731	4	20	80	0.2500000
NODE_7280_length_968_cov_6.490219	538	618	0	80	80	1.0000000
NODE_7280_length_968_cov_6.490219	591	671	0	65	80	0.8125000
NODE_7280_length_968_cov_6.490219	591	671	2	15	80	0.1875000
NODE_7294_length_967_cov_25.572581	332	412	2	78	80	0.9750000
NODE_7294_length_967_cov_25.572581	332	412	4	2	80	0.0250000
NODE_7294_length_967_cov_25.572581	385	465	0	37	80	0.4625000
NODE_7294_length_967_cov_25.572581	385	465	2	43	80	0.5375000
NODE_7295_length_967_cov_24.919355	396	476	0	80	80	1.0000000
NODE_7295_length_967_cov_24.919355	449	529	0	80	80	1.0000000
NODE_7296_length_967_cov_19.137097	374	454	0	80	80	1.0000000
NODE_7296_length_967_cov_19.137097	427	507	0	80	80	1.0000000
NODE_7296_length_967_cov_19.137097	503	583	0	80	80	1.0000000
NODE_7296_length_967_cov_19.137097	556	636	0	80	80	1.0000000
NODE_7297_length_967_cov_14.654378	453	533	6	4	80	0.0500000
NODE_7297_length_967_cov_14.654378	453	533	8	43	80	0.5375000
NODE_7297_length_967_cov_14.654378	453	533	10	32	80	0.4000000
NODE_7297_length_967_cov_14.654378	453	533	12	1	80	0.0125000
NODE_7297_length_967_cov_14.654378	506	586	4	9	80	0.1125000
NODE_7297_length_967_cov_14.654378	506	586	6	3	80	0.0375000
NODE_7297_length_967_cov_14.654378	506	586	7	20	80	0.2500000
NODE_7297_length_967_cov_14.654378	506	586	8	2	80	0.0250000
NODE_7297_length_967_cov_14.654378	506	586	9	7	80	0.0875000
NODE_7297_length_967_cov_14.654378	506	586	10	37	80	0.4625000
NODE_7297_length_967_cov_14.654378	506	586	11	1	80	0.0125000
NODE_7297_length_967_cov_14.654378	506	586	12	1	80	0.0125000
NODE_7298_length_967_cov_8.027650	280	360	0	80	80	1.0000000
NODE_7298_length_967_cov_8.027650	333	413	0	80	80	1.0000000
NODE_7310_length_966_cov_43.154556	401	474	6	73	73	1.0000000
NODE_7310_length_966_cov_43.154556	447	527	0	34	80	0.4250000
NODE_7310_length_966_cov_43.154556	447	527	6	46	80	0.5750000
NODE_7311_length_966_cov_42.877739	477	557	2	58	80	0.7250000
NODE_7311_length_966_cov_42.877739	477	557	4	22	80	0.2750000
NODE_7311_length_966_cov_42.877739	530	610	2	80	80	1.0000000
NODE_7312_length_966_cov_39.956171	283	363	0	46	80	0.5750000
NODE_7312_length_966_cov_39.956171	283	363	4	34	80	0.4250000
NODE_7312_length_966_cov_39.956171	336	416	4	38	80	0.4750000
NODE_7312_length_966_cov_39.956171	336	416	13	21	80	0.2625000
NODE_7312_length_966_cov_39.956171	336	416	14	21	80	0.2625000
NODE_7312_length_966_cov_39.956171	412	494	0	3	82	0.0365854
NODE_7312_length_966_cov_39.956171	412	494	10	42	82	0.5121951
NODE_7312_length_966_cov_39.956171	412	494	14	37	82	0.4512195
NODE_7312_length_966_cov_39.956171	467	547	0	56	80	0.7000000
NODE_7312_length_966_cov_39.956171	467	547	10	24	80	0.3000000
NODE_7313_length_966_cov_36.160323	461	541	2	30	80	0.3750000
NODE_7313_length_966_cov_36.160323	461	541	4	39	80	0.4875000
NODE_7313_length_966_cov_36.160323	461	541	6	11	80	0.1375000
NODE_7313_length_966_cov_36.160323	461	541	2	30	80	0.3750000
NODE_7313_length_966_cov_36.160323	461	541	4	39	80	0.4875000
NODE_7313_length_966_cov_36.160323	461	541	6	11	80	0.1375000
NODE_7313_length_966_cov_36.160323	514	594	0	1	80	0.0125000
NODE_7313_length_966_cov_36.160323	514	594	2	23	80	0.2875000
NODE_7313_length_966_cov_36.160323	514	594	4	56	80	0.7000000
NODE_7314_length_966_cov_18.658593	408	488	0	13	80	0.1625000
NODE_7314_length_966_cov_18.658593	408	488	2	67	80	0.8375000
NODE_7314_length_966_cov_18.658593	461	541	0	18	80	0.2250000
NODE_7314_length_966_cov_18.658593	461	541	2	42	80	0.5250000
NODE_7314_length_966_cov_18.658593	461	541	4	20	80	0.2500000
NODE_7315_length_966_cov_17.606690	341	421	0	80	80	1.0000000
NODE_7315_length_966_cov_17.606690	394	474	0	80	80	1.0000000
NODE_7316_length_966_cov_16.064591	296	376	4	80	80	1.0000000
NODE_7316_length_966_cov_16.064591	349	429	0	15	80	0.1875000
NODE_7316_length_966_cov_16.064591	349	429	2	8	80	0.1000000
NODE_7316_length_966_cov_16.064591	349	429	4	57	80	0.7125000
NODE_7317_length_966_cov_15.155709	562	642	0	80	80	1.0000000
NODE_7317_length_966_cov_15.155709	615	695	0	80	80	1.0000000
NODE_7318_length_966_cov_7.726644	280	360	0	80	80	1.0000000
NODE_7318_length_966_cov_7.726644	334	414	0	80	80	1.0000000
NODE_7335_length_965_cov_51.524249	197	277	0	25	80	0.3125000
NODE_7335_length_965_cov_51.524249	197	277	5	28	80	0.3500000
NODE_7335_length_965_cov_51.524249	197	277	6	20	80	0.2500000
NODE_7335_length_965_cov_51.524249	197	277	7	7	80	0.0875000
NODE_7335_length_965_cov_51.524249	250	327	2	3	77	0.0389610
NODE_7335_length_965_cov_51.524249	250	327	6	20	77	0.2597403
NODE_7335_length_965_cov_51.524249	250	327	7	43	77	0.5584416
NODE_7335_length_965_cov_51.524249	250	327	8	11	77	0.1428571
NODE_7335_length_965_cov_51.524249	329	406	1	6	77	0.0779221
NODE_7335_length_965_cov_51.524249	329	406	2	71	77	0.9220779
NODE_7335_length_965_cov_51.524249	379	459	1	59	80	0.7375000
NODE_7335_length_965_cov_51.524249	379	459	2	21	80	0.2625000
NODE_7336_length_965_cov_18.072748	515	595	0	80	80	1.0000000
NODE_7336_length_965_cov_18.072748	568	648	0	80	80	1.0000000
NODE_7337_length_965_cov_14.277136	342	422	0	80	80	1.0000000
NODE_7337_length_965_cov_14.277136	395	470	0	75	75	1.0000000
NODE_7338_length_965_cov_7.808314	567	647	0	80	80	1.0000000
NODE_7338_length_965_cov_7.808314	620	700	0	80	80	1.0000000
NODE_7344_length_964_cov_60.153757	197	277	6	5	80	0.0625000
NODE_7344_length_964_cov_60.153757	197	277	8	22	80	0.2750000
NODE_7344_length_964_cov_60.153757	197	277	9	1	80	0.0125000
NODE_7344_length_964_cov_60.153757	197	277	11	9	80	0.1125000
NODE_7344_length_964_cov_60.153757	197	277	16	1	80	0.0125000
NODE_7344_length_964_cov_60.153757	197	277	17	18	80	0.2250000
NODE_7344_length_964_cov_60.153757	197	277	19	13	80	0.1625000
NODE_7344_length_964_cov_60.153757	197	277	20	2	80	0.0250000
NODE_7344_length_964_cov_60.153757	197	277	24	2	80	0.0250000
NODE_7344_length_964_cov_60.153757	197	277	28	1	80	0.0125000
NODE_7344_length_964_cov_60.153757	197	277	29	3	80	0.0375000
NODE_7344_length_964_cov_60.153757	197	277	31	1	80	0.0125000
NODE_7344_length_964_cov_60.153757	197	277	33	2	80	0.0250000
NODE_7344_length_964_cov_60.153757	250	314	0	21	64	0.3281250
NODE_7344_length_964_cov_60.153757	250	314	2	4	64	0.0625000
NODE_7344_length_964_cov_60.153757	250	314	4	1	64	0.0156250
NODE_7344_length_964_cov_60.153757	250	314	6	16	64	0.2500000
NODE_7344_length_964_cov_60.153757	250	314	8	22	64	0.3437500
NODE_7344_length_964_cov_60.153757	672	752	0	80	80	1.0000000
NODE_7344_length_964_cov_60.153757	725	805	0	80	80	1.0000000
NODE_7345_length_964_cov_45.564162	314	394	0	54	80	0.6750000
NODE_7345_length_964_cov_45.564162	314	394	3	1	80	0.0125000
NODE_7345_length_964_cov_45.564162	314	394	4	25	80	0.3125000
NODE_7345_length_964_cov_45.564162	367	447	0	1	80	0.0125000
NODE_7345_length_964_cov_45.564162	367	447	3	1	80	0.0125000
NODE_7345_length_964_cov_45.564162	367	447	4	78	80	0.9750000
NODE_7345_length_964_cov_45.564162	443	523	0	70	80	0.8750000
NODE_7345_length_964_cov_45.564162	443	523	4	10	80	0.1250000
NODE_7345_length_964_cov_45.564162	496	566	0	70	70	1.0000000
NODE_7346_length_964_cov_33.487861	363	443	0	44	80	0.5500000
NODE_7346_length_964_cov_33.487861	363	443	2	11	80	0.1375000
NODE_7346_length_964_cov_33.487861	363	443	4	22	80	0.2750000
NODE_7346_length_964_cov_33.487861	363	443	6	3	80	0.0375000
NODE_7346_length_964_cov_33.487861	416	496	2	3	80	0.0375000
NODE_7346_length_964_cov_33.487861	416	496	4	23	80	0.2875000
NODE_7346_length_964_cov_33.487861	416	496	6	54	80	0.6750000
NODE_7347_length_964_cov_33.077457	408	488	0	80	80	1.0000000
NODE_7347_length_964_cov_33.077457	461	541	0	80	80	1.0000000
NODE_7347_length_964_cov_33.077457	537	617	0	80	80	1.0000000
NODE_7347_length_964_cov_33.077457	590	670	0	80	80	1.0000000
NODE_7348_length_964_cov_29.250867	419	499	0	80	80	1.0000000
NODE_7348_length_964_cov_29.250867	472	552	0	80	80	1.0000000
NODE_7349_length_964_cov_20.191908	228	301	0	73	73	1.0000000
NODE_7349_length_964_cov_20.191908	349	429	0	72	80	0.9000000
NODE_7349_length_964_cov_20.191908	349	429	1	8	80	0.1000000
NODE_7349_length_964_cov_20.191908	402	482	0	19	80	0.2375000
NODE_7349_length_964_cov_20.191908	402	482	1	23	80	0.2875000
NODE_7349_length_964_cov_20.191908	402	482	3	38	80	0.4750000
NODE_7350_length_964_cov_18.510983	486	566	2	23	80	0.2875000
NODE_7350_length_964_cov_18.510983	486	566	3	12	80	0.1500000
NODE_7350_length_964_cov_18.510983	486	566	4	45	80	0.5625000
NODE_7350_length_964_cov_18.510983	539	619	0	27	80	0.3375000
NODE_7350_length_964_cov_18.510983	539	619	1	4	80	0.0500000
NODE_7350_length_964_cov_18.510983	539	619	3	34	80	0.4250000
NODE_7350_length_964_cov_18.510983	539	619	4	15	80	0.1875000
NODE_7351_length_964_cov_16.613873	464	544	0	67	80	0.8375000
NODE_7351_length_964_cov_16.613873	464	544	2	13	80	0.1625000
NODE_7351_length_964_cov_16.613873	517	597	0	14	80	0.1750000
NODE_7351_length_964_cov_16.613873	517	597	2	66	80	0.8250000
NODE_7352_length_964_cov_15.717919	411	491	0	80	80	1.0000000
NODE_7352_length_964_cov_15.717919	464	544	0	35	80	0.4375000
NODE_7352_length_964_cov_15.717919	464	544	2	45	80	0.5625000
NODE_7352_length_964_cov_15.717919	540	620	0	29	80	0.3625000
NODE_7352_length_964_cov_15.717919	540	620	2	51	80	0.6375000
NODE_7352_length_964_cov_15.717919	593	668	0	75	75	1.0000000
NODE_7353_length_964_cov_14.591908	521	601	0	71	80	0.8875000
NODE_7353_length_964_cov_14.591908	521	601	4	5	80	0.0625000
NODE_7353_length_964_cov_14.591908	521	601	6	4	80	0.0500000
NODE_7353_length_964_cov_14.591908	574	654	0	18	80	0.2250000
NODE_7353_length_964_cov_14.591908	574	654	4	11	80	0.1375000
NODE_7353_length_964_cov_14.591908	574	654	6	51	80	0.6375000
NODE_7354_length_964_cov_11.589595	475	555	0	53	80	0.6625000
NODE_7354_length_964_cov_11.589595	475	555	4	27	80	0.3375000
NODE_7354_length_964_cov_11.589595	528	608	0	80	80	1.0000000
NODE_7355_length_964_cov_7.639306	420	500	0	80	80	1.0000000
NODE_7355_length_964_cov_7.639306	473	553	0	80	80	1.0000000
NODE_7356_length_964_cov_7.596532	534	614	0	28	80	0.3500000
NODE_7356_length_964_cov_7.596532	534	614	2	52	80	0.6500000
NODE_7356_length_964_cov_7.596532	587	667	2	80	80	1.0000000
NODE_7357_length_964_cov_6.568786	368	448	0	68	80	0.8500000
NODE_7357_length_964_cov_6.568786	368	448	2	12	80	0.1500000
NODE_7357_length_964_cov_6.568786	421	501	0	15	80	0.1875000
NODE_7357_length_964_cov_6.568786	421	501	2	65	80	0.8125000
NODE_7359_length_964_cov_6.027746	890	940	2	29	50	0.5800000
NODE_7359_length_964_cov_6.027746	890	940	4	6	50	0.1200000
NODE_7359_length_964_cov_6.027746	890	940	6	5	50	0.1000000
NODE_7359_length_964_cov_6.027746	890	940	8	10	50	0.2000000
NODE_7361_length_964_cov_4.665896	706	772	0	66	66	1.0000000
NODE_7376_length_963_cov_66.251157	456	536	0	2	80	0.0250000
NODE_7376_length_963_cov_66.251157	456	536	2	78	80	0.9750000
NODE_7376_length_963_cov_66.251157	509	589	0	7	80	0.0875000
NODE_7376_length_963_cov_66.251157	509	589	2	72	80	0.9000000
NODE_7376_length_963_cov_66.251157	509	589	4	1	80	0.0125000
NODE_7376_length_963_cov_66.251157	585	665	0	2	80	0.0250000
NODE_7376_length_963_cov_66.251157	585	665	2	1	80	0.0125000
NODE_7376_length_963_cov_66.251157	585	665	4	46	80	0.5750000
NODE_7376_length_963_cov_66.251157	585	665	6	31	80	0.3875000
NODE_7376_length_963_cov_66.251157	638	718	2	38	80	0.4750000
NODE_7376_length_963_cov_66.251157	638	718	4	5	80	0.0625000
NODE_7376_length_963_cov_66.251157	638	718	6	37	80	0.4625000
NODE_7377_length_963_cov_35.638889	381	461	2	23	80	0.2875000
NODE_7377_length_963_cov_35.638889	381	461	6	52	80	0.6500000
NODE_7377_length_963_cov_35.638889	381	461	8	5	80	0.0625000
NODE_7377_length_963_cov_35.638889	434	514	2	76	80	0.9500000
NODE_7377_length_963_cov_35.638889	434	514	6	4	80	0.0500000
NODE_7377_length_963_cov_35.638889	510	590	0	55	80	0.6875000
NODE_7377_length_963_cov_35.638889	510	590	2	25	80	0.3125000
NODE_7377_length_963_cov_35.638889	563	643	0	80	80	1.0000000
NODE_7378_length_963_cov_33.642361	347	427	0	80	80	1.0000000
NODE_7378_length_963_cov_33.642361	400	480	0	80	80	1.0000000
NODE_7379_length_963_cov_18.626157	392	472	0	65	80	0.8125000
NODE_7379_length_963_cov_18.626157	392	472	2	15	80	0.1875000
NODE_7379_length_963_cov_18.626157	445	525	0	12	80	0.1500000
NODE_7379_length_963_cov_18.626157	445	525	2	68	80	0.8500000
NODE_7380_length_963_cov_17.750000	402	482	2	80	80	1.0000000
NODE_7380_length_963_cov_17.750000	455	535	2	79	80	0.9875000
NODE_7380_length_963_cov_17.750000	455	535	4	1	80	0.0125000
NODE_7381_length_963_cov_17.023148	542	622	0	80	80	1.0000000
NODE_7381_length_963_cov_17.023148	595	675	0	80	80	1.0000000
NODE_7382_length_963_cov_16.642361	481	561	0	80	80	1.0000000
NODE_7382_length_963_cov_16.642361	534	614	0	80	80	1.0000000
NODE_7382_length_963_cov_16.642361	572	629	0	57	57	1.0000000
NODE_7383_length_963_cov_14.961806	283	363	4	11	80	0.1375000
NODE_7383_length_963_cov_14.961806	283	363	5	69	80	0.8625000
NODE_7383_length_963_cov_14.961806	336	416	2	11	80	0.1375000
NODE_7383_length_963_cov_14.961806	336	416	4	53	80	0.6625000
NODE_7383_length_963_cov_14.961806	336	416	5	16	80	0.2000000
NODE_7384_length_963_cov_13.341435	558	638	0	3	80	0.0375000
NODE_7384_length_963_cov_13.341435	558	638	2	10	80	0.1250000
NODE_7384_length_963_cov_13.341435	558	638	4	3	80	0.0375000
NODE_7384_length_963_cov_13.341435	558	638	6	2	80	0.0250000
NODE_7384_length_963_cov_13.341435	558	638	8	3	80	0.0375000
NODE_7384_length_963_cov_13.341435	558	638	10	59	80	0.7375000
NODE_7384_length_963_cov_13.341435	611	691	0	9	80	0.1125000
NODE_7384_length_963_cov_13.341435	611	691	4	6	80	0.0750000
NODE_7384_length_963_cov_13.341435	611	691	6	21	80	0.2625000
NODE_7384_length_963_cov_13.341435	611	691	8	6	80	0.0750000
NODE_7384_length_963_cov_13.341435	611	691	10	38	80	0.4750000
NODE_7386_length_963_cov_9.520833	459	539	2	28	80	0.3500000
NODE_7386_length_963_cov_9.520833	459	539	4	52	80	0.6500000
NODE_7386_length_963_cov_9.520833	512	592	0	2	80	0.0250000
NODE_7386_length_963_cov_9.520833	512	592	2	45	80	0.5625000
NODE_7386_length_963_cov_9.520833	512	592	4	33	80	0.4125000
NODE_7386_length_963_cov_9.520833	588	662	2	74	74	1.0000000
NODE_7386_length_963_cov_9.520833	641	724	2	45	83	0.5421687
NODE_7386_length_963_cov_9.520833	641	724	4	38	83	0.4578313
NODE_7388_length_963_cov_7.510417	781	842	2	6	61	0.0983607
NODE_7388_length_963_cov_7.510417	781	842	4	7	61	0.1147541
NODE_7388_length_963_cov_7.510417	781	842	6	1	61	0.0163934
NODE_7388_length_963_cov_7.510417	781	842	8	2	61	0.0327869
NODE_7388_length_963_cov_7.510417	781	842	10	1	61	0.0163934
NODE_7388_length_963_cov_7.510417	781	842	12	3	61	0.0491803
NODE_7388_length_963_cov_7.510417	781	842	16	4	61	0.0655738
NODE_7388_length_963_cov_7.510417	781	842	18	5	61	0.0819672
NODE_7388_length_963_cov_7.510417	781	842	26	5	61	0.0819672
NODE_7388_length_963_cov_7.510417	781	842	28	6	61	0.0983607
NODE_7388_length_963_cov_7.510417	781	842	36	3	61	0.0491803
NODE_7388_length_963_cov_7.510417	781	842	38	10	61	0.1639344
NODE_7388_length_963_cov_7.510417	781	842	40	3	61	0.0491803
NODE_7388_length_963_cov_7.510417	781	842	42	5	61	0.0819672
NODE_7388_length_963_cov_7.510417	815	894	28	6	79	0.0759494
NODE_7388_length_963_cov_7.510417	815	894	36	3	79	0.0379747
NODE_7388_length_963_cov_7.510417	815	894	38	10	79	0.1265823
NODE_7388_length_963_cov_7.510417	815	894	40	4	79	0.0506329
NODE_7388_length_963_cov_7.510417	815	894	42	11	79	0.1392405
NODE_7388_length_963_cov_7.510417	815	894	44	12	79	0.1518987
NODE_7388_length_963_cov_7.510417	815	894	45	4	79	0.0506329
NODE_7388_length_963_cov_7.510417	815	894	46	1	79	0.0126582
NODE_7388_length_963_cov_7.510417	815	894	47	1	79	0.0126582
NODE_7388_length_963_cov_7.510417	815	894	48	1	79	0.0126582
NODE_7388_length_963_cov_7.510417	815	894	49	2	79	0.0253165
NODE_7388_length_963_cov_7.510417	815	894	50	1	79	0.0126582
NODE_7388_length_963_cov_7.510417	815	894	51	1	79	0.0126582
NODE_7388_length_963_cov_7.510417	815	894	52	22	79	0.2784810
NODE_7392_length_963_cov_3.755787	378	458	0	36	80	0.4500000
NODE_7392_length_963_cov_3.755787	378	458	2	14	80	0.1750000
NODE_7392_length_963_cov_3.755787	378	458	4	25	80	0.3125000
NODE_7392_length_963_cov_3.755787	378	458	6	5	80	0.0625000
NODE_7392_length_963_cov_3.755787	431	511	4	22	80	0.2750000
NODE_7392_length_963_cov_3.755787	431	511	6	25	80	0.3125000
NODE_7392_length_963_cov_3.755787	431	511	8	2	80	0.0250000
NODE_7392_length_963_cov_3.755787	431	511	12	16	80	0.2000000
NODE_7392_length_963_cov_3.755787	431	511	14	15	80	0.1875000
NODE_7397_length_963_cov_1.931713	426	485	2	59	59	1.0000000
NODE_7404_length_962_cov_37.169177	356	436	0	2	80	0.0250000
NODE_7404_length_962_cov_37.169177	356	436	2	9	80	0.1125000
NODE_7404_length_962_cov_37.169177	356	436	6	69	80	0.8625000
NODE_7404_length_962_cov_37.169177	409	489	0	14	80	0.1750000
NODE_7404_length_962_cov_37.169177	409	489	4	21	80	0.2625000
NODE_7404_length_962_cov_37.169177	409	489	6	45	80	0.5625000
NODE_7405_length_962_cov_28.852839	474	554	0	39	80	0.4875000
NODE_7405_length_962_cov_28.852839	474	554	2	2	80	0.0250000
NODE_7405_length_962_cov_28.852839	474	554	4	39	80	0.4875000
NODE_7405_length_962_cov_28.852839	527	607	2	6	80	0.0750000
NODE_7405_length_962_cov_28.852839	527	607	4	74	80	0.9250000
NODE_7405_length_962_cov_28.852839	603	683	0	40	80	0.5000000
NODE_7405_length_962_cov_28.852839	603	683	2	40	80	0.5000000
NODE_7405_length_962_cov_28.852839	656	736	0	38	80	0.4750000
NODE_7405_length_962_cov_28.852839	656	736	2	1	80	0.0125000
NODE_7405_length_962_cov_28.852839	656	736	3	3	80	0.0375000
NODE_7405_length_962_cov_28.852839	656	736	6	32	80	0.4000000
NODE_7405_length_962_cov_28.852839	656	736	8	6	80	0.0750000
NODE_7406_length_962_cov_27.859791	441	521	0	80	80	1.0000000
NODE_7406_length_962_cov_27.859791	494	574	0	80	80	1.0000000
NODE_7407_length_962_cov_21.019699	318	398	0	44	80	0.5500000
NODE_7407_length_962_cov_21.019699	318	398	4	22	80	0.2750000
NODE_7407_length_962_cov_21.019699	318	398	10	3	80	0.0375000
NODE_7407_length_962_cov_21.019699	318	398	12	11	80	0.1375000
NODE_7407_length_962_cov_21.019699	371	451	4	13	80	0.1625000
NODE_7407_length_962_cov_21.019699	371	451	10	3	80	0.0375000
NODE_7407_length_962_cov_21.019699	371	451	12	64	80	0.8000000
NODE_7408_length_962_cov_16.792584	350	430	0	3	80	0.0375000
NODE_7408_length_962_cov_16.792584	350	430	2	18	80	0.2250000
NODE_7408_length_962_cov_16.792584	350	430	4	59	80	0.7375000
NODE_7408_length_962_cov_16.792584	403	483	2	53	80	0.6625000
NODE_7408_length_962_cov_16.792584	403	483	4	27	80	0.3375000
NODE_7409_length_962_cov_14.650058	477	557	0	80	80	1.0000000
NODE_7409_length_962_cov_14.650058	530	610	0	80	80	1.0000000
NODE_7410_length_962_cov_7.993048	308	345	2	37	37	1.0000000
NODE_7411_length_962_cov_7.835458	447	527	0	80	80	1.0000000
NODE_7411_length_962_cov_7.835458	500	580	0	80	80	1.0000000
NODE_7412_length_962_cov_6.855156	490	570	0	1	80	0.0125000
NODE_7412_length_962_cov_6.855156	490	570	2	79	80	0.9875000
NODE_7412_length_962_cov_6.855156	543	623	2	67	80	0.8375000
NODE_7412_length_962_cov_6.855156	543	623	4	13	80	0.1625000
NODE_7417_length_962_cov_1.840093	88	151	0	2	63	0.0317460
NODE_7417_length_962_cov_1.840093	88	151	14	1	63	0.0158730
NODE_7417_length_962_cov_1.840093	88	151	18	2	63	0.0317460
NODE_7417_length_962_cov_1.840093	88	151	22	1	63	0.0158730
NODE_7417_length_962_cov_1.840093	88	151	26	1	63	0.0158730
NODE_7417_length_962_cov_1.840093	88	151	30	1	63	0.0158730
NODE_7417_length_962_cov_1.840093	88	151	32	1	63	0.0158730
NODE_7417_length_962_cov_1.840093	88	151	39	1	63	0.0158730
NODE_7417_length_962_cov_1.840093	88	151	44	2	63	0.0317460
NODE_7417_length_962_cov_1.840093	88	151	50	2	63	0.0317460
NODE_7417_length_962_cov_1.840093	88	151	52	1	63	0.0158730
NODE_7417_length_962_cov_1.840093	88	151	58	1	63	0.0158730
NODE_7417_length_962_cov_1.840093	88	151	60	1	63	0.0158730
NODE_7417_length_962_cov_1.840093	88	151	64	1	63	0.0158730
NODE_7417_length_962_cov_1.840093	88	151	68	3	63	0.0476190
NODE_7417_length_962_cov_1.840093	88	151	72	1	63	0.0158730
NODE_7417_length_962_cov_1.840093	88	151	76	2	63	0.0317460
NODE_7417_length_962_cov_1.840093	88	151	86	2	63	0.0317460
NODE_7417_length_962_cov_1.840093	88	151	88	3	63	0.0476190
NODE_7417_length_962_cov_1.840093	88	151	90	4	63	0.0634921
NODE_7417_length_962_cov_1.840093	88	151	96	2	63	0.0317460
NODE_7417_length_962_cov_1.840093	88	151	98	2	63	0.0317460
NODE_7417_length_962_cov_1.840093	88	151	102	3	63	0.0476190
NODE_7417_length_962_cov_1.840093	88	151	104	6	63	0.0952381
NODE_7417_length_962_cov_1.840093	88	151	108	1	63	0.0158730
NODE_7417_length_962_cov_1.840093	88	151	110	2	63	0.0317460
NODE_7417_length_962_cov_1.840093	88	151	112	3	63	0.0476190
NODE_7417_length_962_cov_1.840093	88	151	114	6	63	0.0952381
NODE_7417_length_962_cov_1.840093	88	151	116	5	63	0.0793651
NODE_7422_length_961_cov_61.019722	453	533	0	80	80	1.0000000
NODE_7422_length_961_cov_61.019722	506	586	0	80	80	1.0000000
NODE_7422_length_961_cov_61.019722	614	672	0	58	58	1.0000000
NODE_7423_length_961_cov_51.005800	334	414	18	2	80	0.0250000
NODE_7423_length_961_cov_51.005800	334	414	20	43	80	0.5375000
NODE_7423_length_961_cov_51.005800	334	414	22	12	80	0.1500000
NODE_7423_length_961_cov_51.005800	334	414	24	17	80	0.2125000
NODE_7423_length_961_cov_51.005800	334	414	26	6	80	0.0750000
NODE_7423_length_961_cov_51.005800	387	467	0	19	80	0.2375000
NODE_7423_length_961_cov_51.005800	387	467	2	7	80	0.0875000
NODE_7423_length_961_cov_51.005800	387	467	4	18	80	0.2250000
NODE_7423_length_961_cov_51.005800	387	467	6	7	80	0.0875000
NODE_7423_length_961_cov_51.005800	387	467	18	4	80	0.0500000
NODE_7423_length_961_cov_51.005800	387	467	20	25	80	0.3125000
NODE_7424_length_961_cov_45.923434	391	471	2	14	80	0.1750000
NODE_7424_length_961_cov_45.923434	391	471	6	11	80	0.1375000
NODE_7424_length_961_cov_45.923434	391	471	11	9	80	0.1125000
NODE_7424_length_961_cov_45.923434	391	471	17	5	80	0.0625000
NODE_7424_length_961_cov_45.923434	391	471	20	28	80	0.3500000
NODE_7424_length_961_cov_45.923434	391	471	22	13	80	0.1625000
NODE_7424_length_961_cov_45.923434	444	524	11	2	80	0.0250000
NODE_7424_length_961_cov_45.923434	444	524	17	34	80	0.4250000
NODE_7424_length_961_cov_45.923434	444	524	20	28	80	0.3500000
NODE_7424_length_961_cov_45.923434	444	524	21	12	80	0.1500000
NODE_7424_length_961_cov_45.923434	444	524	22	4	80	0.0500000
NODE_7426_length_961_cov_21.410673	313	393	2	5	80	0.0625000
NODE_7426_length_961_cov_21.410673	313	393	3	1	80	0.0125000
NODE_7426_length_961_cov_21.410673	313	393	4	17	80	0.2125000
NODE_7426_length_961_cov_21.410673	313	393	6	12	80	0.1500000
NODE_7426_length_961_cov_21.410673	313	393	8	11	80	0.1375000
NODE_7426_length_961_cov_21.410673	313	393	10	4	80	0.0500000
NODE_7426_length_961_cov_21.410673	313	393	12	7	80	0.0875000
NODE_7426_length_961_cov_21.410673	313	393	14	23	80	0.2875000
NODE_7426_length_961_cov_21.410673	366	446	6	1	80	0.0125000
NODE_7426_length_961_cov_21.410673	366	446	8	2	80	0.0250000
NODE_7426_length_961_cov_21.410673	366	446	10	13	80	0.1625000
NODE_7426_length_961_cov_21.410673	366	446	12	15	80	0.1875000
NODE_7426_length_961_cov_21.410673	366	446	14	49	80	0.6125000
NODE_7427_length_961_cov_18.592807	403	483	0	80	80	1.0000000
NODE_7427_length_961_cov_18.592807	456	536	0	80	80	1.0000000
NODE_7428_length_961_cov_17.701856	433	513	0	29	80	0.3625000
NODE_7428_length_961_cov_17.701856	433	513	2	11	80	0.1375000
NODE_7428_length_961_cov_17.701856	433	513	4	9	80	0.1125000
NODE_7428_length_961_cov_17.701856	433	513	5	2	80	0.0250000
NODE_7428_length_961_cov_17.701856	433	513	6	29	80	0.3625000
NODE_7428_length_961_cov_17.701856	486	566	2	2	80	0.0250000
NODE_7428_length_961_cov_17.701856	486	566	4	8	80	0.1000000
NODE_7428_length_961_cov_17.701856	486	566	6	70	80	0.8750000
NODE_7429_length_961_cov_17.020882	505	585	0	44	80	0.5500000
NODE_7429_length_961_cov_17.020882	505	585	4	26	80	0.3250000
NODE_7429_length_961_cov_17.020882	505	585	6	10	80	0.1250000
NODE_7429_length_961_cov_17.020882	558	638	0	80	80	1.0000000
NODE_7430_length_961_cov_16.235499	328	408	0	80	80	1.0000000
NODE_7430_length_961_cov_16.235499	381	461	0	65	80	0.8125000
NODE_7430_length_961_cov_16.235499	381	461	2	15	80	0.1875000
NODE_7432_length_961_cov_12.968677	347	427	0	80	80	1.0000000
NODE_7432_length_961_cov_12.968677	400	480	0	80	80	1.0000000
NODE_7433_length_961_cov_9.875870	439	519	0	80	80	1.0000000
NODE_7433_length_961_cov_9.875870	492	572	0	80	80	1.0000000
NODE_7434_length_961_cov_6.172854	624	704	0	19	80	0.2375000
NODE_7434_length_961_cov_6.172854	624	704	2	57	80	0.7125000
NODE_7434_length_961_cov_6.172854	624	704	6	4	80	0.0500000
NODE_7434_length_961_cov_6.172854	677	757	0	72	80	0.9000000
NODE_7434_length_961_cov_6.172854	677	757	2	8	80	0.1000000
NODE_7435_length_961_cov_4.553364	451	531	0	22	80	0.2750000
NODE_7435_length_961_cov_4.553364	451	531	4	31	80	0.3875000
NODE_7435_length_961_cov_4.553364	451	531	6	13	80	0.1625000
NODE_7435_length_961_cov_4.553364	451	531	8	14	80	0.1750000
NODE_7435_length_961_cov_4.553364	504	584	6	13	80	0.1625000
NODE_7435_length_961_cov_4.553364	504	584	8	67	80	0.8375000
NODE_7440_length_960_cov_35.649245	65	145	0	80	80	1.0000000
NODE_7440_length_960_cov_35.649245	118	198	0	55	80	0.6875000
NODE_7440_length_960_cov_35.649245	118	198	2	25	80	0.3125000
NODE_7440_length_960_cov_35.649245	446	526	1	12	80	0.1500000
NODE_7440_length_960_cov_35.649245	446	526	2	28	80	0.3500000
NODE_7440_length_960_cov_35.649245	446	526	4	40	80	0.5000000
NODE_7440_length_960_cov_35.649245	499	579	4	33	80	0.4125000
NODE_7440_length_960_cov_35.649245	499	579	5	14	80	0.1750000
NODE_7440_length_960_cov_35.649245	499	579	6	33	80	0.4125000
NODE_7441_length_960_cov_34.886179	386	466	0	11	80	0.1375000
NODE_7441_length_960_cov_34.886179	386	466	2	69	80	0.8625000
NODE_7441_length_960_cov_34.886179	439	519	0	41	80	0.5125000
NODE_7441_length_960_cov_34.886179	439	519	2	39	80	0.4875000
NODE_7443_length_960_cov_25.133566	413	493	0	50	80	0.6250000
NODE_7443_length_960_cov_25.133566	413	493	2	30	80	0.3750000
NODE_7443_length_960_cov_25.133566	466	546	0	80	80	1.0000000
NODE_7444_length_960_cov_19.336818	385	465	0	26	80	0.3250000
NODE_7444_length_960_cov_19.336818	385	465	2	54	80	0.6750000
NODE_7444_length_960_cov_19.336818	438	518	0	31	80	0.3875000
NODE_7444_length_960_cov_19.336818	438	518	2	49	80	0.6125000
NODE_7445_length_960_cov_13.221835	460	539	0	8	79	0.1012658
NODE_7445_length_960_cov_13.221835	460	539	2	71	79	0.8987342
NODE_7445_length_960_cov_13.221835	512	592	0	46	80	0.5750000
NODE_7445_length_960_cov_13.221835	512	592	2	34	80	0.4250000
NODE_7446_length_960_cov_12.804878	347	427	0	31	80	0.3875000
NODE_7446_length_960_cov_12.804878	347	427	2	49	80	0.6125000
NODE_7446_length_960_cov_12.804878	400	480	0	21	80	0.2625000
NODE_7446_length_960_cov_12.804878	400	480	2	59	80	0.7375000
NODE_7462_length_959_cov_39.394186	326	406	6	70	80	0.8750000
NODE_7462_length_959_cov_39.394186	326	406	8	9	80	0.1125000
NODE_7462_length_959_cov_39.394186	326	406	12	1	80	0.0125000
NODE_7462_length_959_cov_39.394186	379	459	6	70	80	0.8750000
NODE_7462_length_959_cov_39.394186	379	459	8	9	80	0.1125000
NODE_7462_length_959_cov_39.394186	379	459	12	1	80	0.0125000
NODE_7463_length_959_cov_28.895349	327	407	4	33	80	0.4125000
NODE_7463_length_959_cov_28.895349	327	407	6	47	80	0.5875000
NODE_7463_length_959_cov_28.895349	380	460	2	20	80	0.2500000
NODE_7463_length_959_cov_28.895349	380	460	4	36	80	0.4500000
NODE_7463_length_959_cov_28.895349	380	460	6	24	80	0.3000000
NODE_7464_length_959_cov_26.634884	563	643	0	80	80	1.0000000
NODE_7464_length_959_cov_26.634884	616	696	0	80	80	1.0000000
NODE_7464_length_959_cov_26.634884	692	772	0	44	80	0.5500000
NODE_7464_length_959_cov_26.634884	692	772	4	36	80	0.4500000
NODE_7464_length_959_cov_26.634884	745	825	0	1	80	0.0125000
NODE_7464_length_959_cov_26.634884	745	825	4	79	80	0.9875000
NODE_7465_length_959_cov_18.862791	320	400	4	7	80	0.0875000
NODE_7465_length_959_cov_18.862791	320	400	6	73	80	0.9125000
NODE_7465_length_959_cov_18.862791	373	453	0	19	80	0.2375000
NODE_7465_length_959_cov_18.862791	373	453	4	15	80	0.1875000
NODE_7465_length_959_cov_18.862791	373	453	6	46	80	0.5750000
NODE_7466_length_959_cov_17.910465	358	438	2	79	80	0.9875000
NODE_7466_length_959_cov_17.910465	358	438	4	1	80	0.0125000
NODE_7466_length_959_cov_17.910465	411	491	0	24	80	0.3000000
NODE_7466_length_959_cov_17.910465	411	491	2	56	80	0.7000000
NODE_7467_length_959_cov_15.337209	267	347	0	10	80	0.1250000
NODE_7467_length_959_cov_15.337209	267	347	4	41	80	0.5125000
NODE_7467_length_959_cov_15.337209	267	347	6	21	80	0.2625000
NODE_7467_length_959_cov_15.337209	267	347	8	5	80	0.0625000
NODE_7467_length_959_cov_15.337209	267	347	10	3	80	0.0375000
NODE_7467_length_959_cov_15.337209	320	400	4	5	80	0.0625000
NODE_7467_length_959_cov_15.337209	320	400	6	40	80	0.5000000
NODE_7467_length_959_cov_15.337209	320	400	8	5	80	0.0625000
NODE_7467_length_959_cov_15.337209	320	400	10	30	80	0.3750000
NODE_7468_length_959_cov_9.005814	529	609	4	29	80	0.3625000
NODE_7468_length_959_cov_9.005814	529	609	6	51	80	0.6375000
NODE_7468_length_959_cov_9.005814	582	662	0	24	80	0.3000000
NODE_7468_length_959_cov_9.005814	582	662	3	1	80	0.0125000
NODE_7468_length_959_cov_9.005814	582	662	4	1	80	0.0125000
NODE_7468_length_959_cov_9.005814	582	662	6	54	80	0.6750000
NODE_7469_length_959_cov_8.163953	392	472	0	80	80	1.0000000
NODE_7469_length_959_cov_8.163953	445	525	0	80	80	1.0000000
NODE_7470_length_959_cov_7.097674	401	481	4	27	80	0.3375000
NODE_7470_length_959_cov_7.097674	401	481	8	18	80	0.2250000
NODE_7470_length_959_cov_7.097674	401	481	10	35	80	0.4375000
NODE_7470_length_959_cov_7.097674	454	534	6	44	80	0.5500000
NODE_7470_length_959_cov_7.097674	454	534	10	36	80	0.4500000
NODE_7472_length_959_cov_4.603488	596	676	4	35	80	0.4375000
NODE_7472_length_959_cov_4.603488	596	676	6	41	80	0.5125000
NODE_7472_length_959_cov_4.603488	596	676	8	4	80	0.0500000
NODE_7472_length_959_cov_4.603488	649	729	4	60	80	0.7500000
NODE_7472_length_959_cov_4.603488	649	729	6	20	80	0.2500000
NODE_7486_length_958_cov_57.015134	328	408	0	80	80	1.0000000
NODE_7486_length_958_cov_57.015134	381	461	0	47	80	0.5875000
NODE_7486_length_958_cov_57.015134	381	461	2	33	80	0.4125000
NODE_7486_length_958_cov_57.015134	457	537	2	37	80	0.4625000
NODE_7486_length_958_cov_57.015134	457	537	4	43	80	0.5375000
NODE_7486_length_958_cov_57.015134	510	590	0	45	80	0.5625000
NODE_7486_length_958_cov_57.015134	510	590	2	29	80	0.3625000
NODE_7486_length_958_cov_57.015134	510	590	4	6	80	0.0750000
NODE_7487_length_958_cov_42.265425	418	498	0	80	80	1.0000000
NODE_7487_length_958_cov_42.265425	471	551	0	54	80	0.6750000
NODE_7487_length_958_cov_42.265425	471	551	1	26	80	0.3250000
NODE_7488_length_958_cov_28.618161	336	416	12	41	80	0.5125000
NODE_7488_length_958_cov_28.618161	336	416	16	39	80	0.4875000
NODE_7488_length_958_cov_28.618161	389	469	0	15	80	0.1875000
NODE_7488_length_958_cov_28.618161	389	469	4	17	80	0.2125000
NODE_7488_length_958_cov_28.618161	389	469	6	3	80	0.0375000
NODE_7488_length_958_cov_28.618161	389	469	8	8	80	0.1000000
NODE_7488_length_958_cov_28.618161	389	469	10	8	80	0.1000000
NODE_7488_length_958_cov_28.618161	389	469	16	29	80	0.3625000
NODE_7488_length_958_cov_28.618161	465	545	0	15	80	0.1875000
NODE_7488_length_958_cov_28.618161	465	545	2	24	80	0.3000000
NODE_7488_length_958_cov_28.618161	465	545	18	41	80	0.5125000
NODE_7488_length_958_cov_28.618161	518	598	13	21	80	0.2625000
NODE_7488_length_958_cov_28.618161	518	598	14	5	80	0.0625000
NODE_7488_length_958_cov_28.618161	518	598	15	1	80	0.0125000
NODE_7488_length_958_cov_28.618161	518	598	17	1	80	0.0125000
NODE_7488_length_958_cov_28.618161	518	598	18	52	80	0.6500000
NODE_7489_length_958_cov_16.452852	446	526	2	11	80	0.1375000
NODE_7489_length_958_cov_16.452852	446	526	4	14	80	0.1750000
NODE_7489_length_958_cov_16.452852	446	526	8	25	80	0.3125000
NODE_7489_length_958_cov_16.452852	446	526	10	30	80	0.3750000
NODE_7489_length_958_cov_16.452852	499	579	0	25	80	0.3125000
NODE_7489_length_958_cov_16.452852	499	579	2	39	80	0.4875000
NODE_7489_length_958_cov_16.452852	499	579	4	14	80	0.1750000
NODE_7489_length_958_cov_16.452852	499	579	10	2	80	0.0250000
NODE_7490_length_958_cov_16.008149	446	526	0	18	80	0.2250000
NODE_7490_length_958_cov_16.008149	446	526	2	50	80	0.6250000
NODE_7490_length_958_cov_16.008149	446	526	6	12	80	0.1500000
NODE_7490_length_958_cov_16.008149	499	579	2	15	80	0.1875000
NODE_7490_length_958_cov_16.008149	499	579	4	12	80	0.1500000
NODE_7490_length_958_cov_16.008149	499	579	6	53	80	0.6625000
NODE_7491_length_958_cov_14.154831	516	596	0	11	80	0.1375000
NODE_7491_length_958_cov_14.154831	516	596	2	59	80	0.7375000
NODE_7491_length_958_cov_14.154831	516	596	4	10	80	0.1250000
NODE_7491_length_958_cov_14.154831	569	649	0	4	80	0.0500000
NODE_7491_length_958_cov_14.154831	569	649	2	66	80	0.8250000
NODE_7491_length_958_cov_14.154831	569	649	4	10	80	0.1250000
NODE_7492_length_958_cov_12.381839	454	534	0	80	80	1.0000000
NODE_7492_length_958_cov_12.381839	507	587	0	80	80	1.0000000
NODE_7493_length_958_cov_11.782305	479	559	0	80	80	1.0000000
NODE_7493_length_958_cov_11.782305	532	612	0	60	80	0.7500000
NODE_7493_length_958_cov_11.782305	532	612	2	20	80	0.2500000
NODE_7501_length_957_cov_40.837995	746	826	0	59	80	0.7375000
NODE_7501_length_957_cov_40.837995	746	826	1	21	80	0.2625000
NODE_7501_length_957_cov_40.837995	799	879	0	27	80	0.3375000
NODE_7501_length_957_cov_40.837995	799	879	1	53	80	0.6625000
NODE_7502_length_957_cov_25.976690	631	711	4	29	80	0.3625000
NODE_7502_length_957_cov_25.976690	631	711	6	51	80	0.6375000
NODE_7502_length_957_cov_25.976690	684	764	4	6	80	0.0750000
NODE_7502_length_957_cov_25.976690	684	764	6	38	80	0.4750000
NODE_7502_length_957_cov_25.976690	684	764	8	36	80	0.4500000
NODE_7503_length_957_cov_25.855478	57	131	2	2	74	0.0270270
NODE_7503_length_957_cov_25.855478	57	131	8	1	74	0.0135135
NODE_7503_length_957_cov_25.855478	57	131	10	4	74	0.0540541
NODE_7503_length_957_cov_25.855478	57	131	12	6	74	0.0810811
NODE_7503_length_957_cov_25.855478	57	131	14	6	74	0.0810811
NODE_7503_length_957_cov_25.855478	57	131	16	1	74	0.0135135
NODE_7503_length_957_cov_25.855478	57	131	18	4	74	0.0540541
NODE_7503_length_957_cov_25.855478	57	131	20	3	74	0.0405405
NODE_7503_length_957_cov_25.855478	57	131	22	47	74	0.6351351
NODE_7503_length_957_cov_25.855478	414	494	0	10	80	0.1250000
NODE_7503_length_957_cov_25.855478	414	494	4	55	80	0.6875000
NODE_7503_length_957_cov_25.855478	414	494	5	2	80	0.0250000
NODE_7503_length_957_cov_25.855478	414	494	6	13	80	0.1625000
NODE_7503_length_957_cov_25.855478	467	547	2	41	80	0.5125000
NODE_7503_length_957_cov_25.855478	467	547	4	12	80	0.1500000
NODE_7503_length_957_cov_25.855478	467	547	5	2	80	0.0250000
NODE_7503_length_957_cov_25.855478	467	547	6	25	80	0.3125000
NODE_7504_length_957_cov_24.625874	445	525	0	8	80	0.1000000
NODE_7504_length_957_cov_24.625874	445	525	4	72	80	0.9000000
NODE_7504_length_957_cov_24.625874	498	578	0	20	80	0.2500000
NODE_7504_length_957_cov_24.625874	498	578	4	60	80	0.7500000
NODE_7505_length_957_cov_19.955711	286	366	0	42	80	0.5250000
NODE_7505_length_957_cov_19.955711	286	366	2	38	80	0.4750000
NODE_7505_length_957_cov_19.955711	339	419	2	80	80	1.0000000
NODE_7506_length_957_cov_18.861305	414	494	0	80	80	1.0000000
NODE_7506_length_957_cov_18.861305	467	547	0	80	80	1.0000000
NODE_7507_length_957_cov_17.356643	361	441	0	80	80	1.0000000
NODE_7507_length_957_cov_17.356643	414	494	0	53	80	0.6625000
NODE_7507_length_957_cov_17.356643	414	494	1	3	80	0.0375000
NODE_7507_length_957_cov_17.356643	414	494	2	24	80	0.3000000
NODE_7508_length_957_cov_13.569930	162	242	0	15	80	0.1875000
NODE_7508_length_957_cov_13.569930	162	242	1	1	80	0.0125000
NODE_7508_length_957_cov_13.569930	162	242	2	64	80	0.8000000
NODE_7508_length_957_cov_13.569930	215	299	0	10	84	0.1190476
NODE_7508_length_957_cov_13.569930	215	299	1	4	84	0.0476190
NODE_7508_length_957_cov_13.569930	215	299	2	70	84	0.8333333
NODE_7509_length_957_cov_12.334499	314	394	0	63	80	0.7875000
NODE_7509_length_957_cov_12.334499	314	394	2	17	80	0.2125000
NODE_7509_length_957_cov_12.334499	367	447	0	80	80	1.0000000
NODE_7510_length_957_cov_12.017483	173	253	0	39	80	0.4875000
NODE_7510_length_957_cov_12.017483	173	253	4	41	80	0.5125000
NODE_7510_length_957_cov_12.017483	226	306	0	80	80	1.0000000
NODE_7511_length_957_cov_10.026807	446	526	2	15	80	0.1875000
NODE_7511_length_957_cov_10.026807	446	526	4	65	80	0.8125000
NODE_7511_length_957_cov_10.026807	499	579	0	1	80	0.0125000
NODE_7511_length_957_cov_10.026807	499	579	2	63	80	0.7875000
NODE_7511_length_957_cov_10.026807	499	579	4	16	80	0.2000000
NODE_7529_length_956_cov_48.047841	479	559	4	9	80	0.1125000
NODE_7529_length_956_cov_48.047841	479	559	6	7	80	0.0875000
NODE_7529_length_956_cov_48.047841	479	559	10	9	80	0.1125000
NODE_7529_length_956_cov_48.047841	479	559	12	32	80	0.4000000
NODE_7529_length_956_cov_48.047841	479	559	14	23	80	0.2875000
NODE_7529_length_956_cov_48.047841	532	612	6	7	80	0.0875000
NODE_7529_length_956_cov_48.047841	532	612	8	4	80	0.0500000
NODE_7529_length_956_cov_48.047841	532	612	10	38	80	0.4750000
NODE_7529_length_956_cov_48.047841	532	612	12	31	80	0.3875000
NODE_7529_length_956_cov_48.047841	608	688	4	75	80	0.9375000
NODE_7529_length_956_cov_48.047841	608	688	6	5	80	0.0625000
NODE_7529_length_956_cov_48.047841	661	741	1	4	80	0.0500000
NODE_7529_length_956_cov_48.047841	661	741	2	33	80	0.4125000
NODE_7529_length_956_cov_48.047841	661	741	3	15	80	0.1875000
NODE_7529_length_956_cov_48.047841	661	741	4	28	80	0.3500000
NODE_7530_length_956_cov_34.539090	298	378	0	80	80	1.0000000
NODE_7530_length_956_cov_34.539090	351	431	0	80	80	1.0000000
NODE_7530_length_956_cov_34.539090	427	507	0	80	80	1.0000000
NODE_7530_length_956_cov_34.539090	480	560	0	67	80	0.8375000
NODE_7530_length_956_cov_34.539090	480	560	2	13	80	0.1625000
NODE_7531_length_956_cov_24.355893	398	478	0	80	80	1.0000000
NODE_7531_length_956_cov_24.355893	451	531	0	54	80	0.6750000
NODE_7531_length_956_cov_24.355893	451	531	2	26	80	0.3250000
NODE_7532_length_956_cov_21.940490	373	453	0	80	80	1.0000000
NODE_7532_length_956_cov_21.940490	426	506	0	80	80	1.0000000
NODE_7532_length_956_cov_21.940490	502	582	0	80	80	1.0000000
NODE_7532_length_956_cov_21.940490	555	635	0	80	80	1.0000000
NODE_7533_length_956_cov_19.435239	274	354	3	9	80	0.1125000
NODE_7533_length_956_cov_19.435239	274	354	4	4	80	0.0500000
NODE_7533_length_956_cov_19.435239	274	354	5	40	80	0.5000000
NODE_7533_length_956_cov_19.435239	274	354	6	27	80	0.3375000
NODE_7533_length_956_cov_19.435239	274	301	3	9	27	0.3333333
NODE_7533_length_956_cov_19.435239	274	301	5	18	27	0.6666667
NODE_7534_length_956_cov_17.819137	378	458	0	29	80	0.3625000
NODE_7534_length_956_cov_17.819137	378	458	2	51	80	0.6375000
NODE_7534_length_956_cov_17.819137	431	511	0	80	80	1.0000000
NODE_7535_length_956_cov_16.098016	551	631	2	18	80	0.2250000
NODE_7535_length_956_cov_16.098016	551	631	4	56	80	0.7000000
NODE_7535_length_956_cov_16.098016	551	631	6	6	80	0.0750000
NODE_7535_length_956_cov_16.098016	604	684	0	23	80	0.2875000
NODE_7535_length_956_cov_16.098016	604	684	2	20	80	0.2500000
NODE_7535_length_956_cov_16.098016	604	684	4	37	80	0.4625000
NODE_7536_length_956_cov_15.229872	490	570	0	80	80	1.0000000
NODE_7536_length_956_cov_15.229872	543	623	0	80	80	1.0000000
NODE_7537_length_956_cov_7.533256	439	519	0	80	80	1.0000000
NODE_7537_length_956_cov_7.533256	497	572	0	75	75	1.0000000
NODE_7545_length_955_cov_30.821262	438	518	0	27	80	0.3375000
NODE_7545_length_955_cov_30.821262	438	518	2	53	80	0.6625000
NODE_7545_length_955_cov_30.821262	491	571	0	22	80	0.2750000
NODE_7545_length_955_cov_30.821262	491	571	2	58	80	0.7250000
NODE_7546_length_955_cov_30.574766	380	460	0	80	80	1.0000000
NODE_7546_length_955_cov_30.574766	433	513	0	80	80	1.0000000
NODE_7546_length_955_cov_30.574766	509	589	0	43	80	0.5375000
NODE_7546_length_955_cov_30.574766	509	589	2	4	80	0.0500000
NODE_7546_length_955_cov_30.574766	509	589	4	33	80	0.4125000
NODE_7546_length_955_cov_30.574766	562	642	2	3	80	0.0375000
NODE_7546_length_955_cov_30.574766	562	642	4	77	80	0.9625000
NODE_7547_length_955_cov_27.734813	373	453	0	29	80	0.3625000
NODE_7547_length_955_cov_27.734813	373	453	2	51	80	0.6375000
NODE_7547_length_955_cov_27.734813	426	506	0	29	80	0.3625000
NODE_7547_length_955_cov_27.734813	426	506	2	51	80	0.6375000
NODE_7548_length_955_cov_24.475467	439	519	0	80	80	1.0000000
NODE_7548_length_955_cov_24.475467	492	572	0	80	80	1.0000000
NODE_7549_length_955_cov_22.146028	351	431	4	44	80	0.5500000
NODE_7549_length_955_cov_22.146028	351	431	6	10	80	0.1250000
NODE_7549_length_955_cov_22.146028	351	431	11	1	80	0.0125000
NODE_7549_length_955_cov_22.146028	351	431	12	10	80	0.1250000
NODE_7549_length_955_cov_22.146028	351	431	18	5	80	0.0625000
NODE_7549_length_955_cov_22.146028	351	431	21	1	80	0.0125000
NODE_7549_length_955_cov_22.146028	351	431	22	9	80	0.1125000
NODE_7549_length_955_cov_22.146028	404	484	6	1	80	0.0125000
NODE_7549_length_955_cov_22.146028	404	484	11	1	80	0.0125000
NODE_7549_length_955_cov_22.146028	404	484	12	10	80	0.1250000
NODE_7549_length_955_cov_22.146028	404	484	18	5	80	0.0625000
NODE_7549_length_955_cov_22.146028	404	484	21	1	80	0.0125000
NODE_7549_length_955_cov_22.146028	404	484	22	14	80	0.1750000
NODE_7549_length_955_cov_22.146028	404	484	26	1	80	0.0125000
NODE_7549_length_955_cov_22.146028	404	484	28	47	80	0.5875000
NODE_7550_length_955_cov_16.212617	441	521	0	25	80	0.3125000
NODE_7550_length_955_cov_16.212617	441	521	6	55	80	0.6875000
NODE_7550_length_955_cov_16.212617	494	574	0	22	80	0.2750000
NODE_7550_length_955_cov_16.212617	494	574	6	58	80	0.7250000
NODE_7551_length_955_cov_13.334112	269	349	0	80	80	1.0000000
NODE_7551_length_955_cov_13.334112	322	402	0	80	80	1.0000000
NODE_7552_length_955_cov_12.544393	363	443	2	11	80	0.1375000
NODE_7552_length_955_cov_12.544393	363	443	4	69	80	0.8625000
NODE_7552_length_955_cov_12.544393	416	496	0	48	80	0.6000000
NODE_7552_length_955_cov_12.544393	416	496	2	16	80	0.2000000
NODE_7552_length_955_cov_12.544393	416	496	4	16	80	0.2000000
NODE_7553_length_955_cov_8.204439	358	438	10	80	80	1.0000000
NODE_7553_length_955_cov_8.204439	411	491	0	10	80	0.1250000
NODE_7553_length_955_cov_8.204439	411	491	8	4	80	0.0500000
NODE_7553_length_955_cov_8.204439	411	491	10	66	80	0.8250000
NODE_7563_length_954_cov_35.691228	381	461	0	13	80	0.1625000
NODE_7563_length_954_cov_35.691228	381	461	4	67	80	0.8375000
NODE_7563_length_954_cov_35.691228	434	514	0	26	80	0.3250000
NODE_7563_length_954_cov_35.691228	434	514	4	54	80	0.6750000
NODE_7564_length_954_cov_30.769591	408	488	0	80	80	1.0000000
NODE_7564_length_954_cov_30.769591	461	541	0	80	80	1.0000000
NODE_7565_length_954_cov_27.247953	418	498	0	5	80	0.0625000
NODE_7565_length_954_cov_27.247953	418	498	2	75	80	0.9375000
NODE_7565_length_954_cov_27.247953	471	551	0	58	80	0.7250000
NODE_7565_length_954_cov_27.247953	471	551	2	22	80	0.2750000
NODE_7566_length_954_cov_22.796491	270	350	2	52	80	0.6500000
NODE_7566_length_954_cov_22.796491	270	350	4	28	80	0.3500000
NODE_7566_length_954_cov_22.796491	323	403	2	34	80	0.4250000
NODE_7566_length_954_cov_22.796491	323	403	4	46	80	0.5750000
NODE_7567_length_954_cov_15.645614	337	417	0	8	80	0.1000000
NODE_7567_length_954_cov_15.645614	337	417	4	21	80	0.2625000
NODE_7567_length_954_cov_15.645614	337	417	6	51	80	0.6375000
NODE_7567_length_954_cov_15.645614	390	470	0	2	80	0.0250000
NODE_7567_length_954_cov_15.645614	390	470	4	14	80	0.1750000
NODE_7567_length_954_cov_15.645614	390	470	6	64	80	0.8000000
NODE_7568_length_954_cov_13.538012	346	426	0	80	80	1.0000000
NODE_7568_length_954_cov_13.538012	399	479	0	80	80	1.0000000
NODE_7569_length_954_cov_12.162573	155	217	0	41	62	0.6612903
NODE_7569_length_954_cov_12.162573	155	217	2	21	62	0.3387097
NODE_7570_length_954_cov_10.714620	239	319	0	80	80	1.0000000
NODE_7570_length_954_cov_10.714620	292	372	0	80	80	1.0000000
NODE_7571_length_954_cov_5.670175	431	511	0	80	80	1.0000000
NODE_7571_length_954_cov_5.670175	484	564	0	80	80	1.0000000
NODE_7582_length_953_cov_35.789227	425	505	10	28	80	0.3500000
NODE_7582_length_953_cov_35.789227	425	505	11	13	80	0.1625000
NODE_7582_length_953_cov_35.789227	425	505	12	39	80	0.4875000
NODE_7582_length_953_cov_35.789227	478	558	2	37	80	0.4625000
NODE_7582_length_953_cov_35.789227	478	558	12	43	80	0.5375000
NODE_7583_length_953_cov_33.940281	430	510	0	26	80	0.3250000
NODE_7583_length_953_cov_33.940281	430	510	2	1	80	0.0125000
NODE_7583_length_953_cov_33.940281	430	510	4	53	80	0.6625000
NODE_7583_length_953_cov_33.940281	483	563	4	30	80	0.3750000
NODE_7583_length_953_cov_33.940281	483	563	6	50	80	0.6250000
NODE_7584_length_953_cov_26.844262	333	413	0	80	80	1.0000000
NODE_7584_length_953_cov_26.844262	386	466	0	80	80	1.0000000
NODE_7584_length_953_cov_26.844262	462	542	0	19	80	0.2375000
NODE_7584_length_953_cov_26.844262	462	542	2	23	80	0.2875000
NODE_7584_length_953_cov_26.844262	462	542	6	38	80	0.4750000
NODE_7584_length_953_cov_26.844262	515	595	4	39	80	0.4875000
NODE_7584_length_953_cov_26.844262	515	595	6	41	80	0.5125000
NODE_7585_length_953_cov_20.770492	301	381	0	17	80	0.2125000
NODE_7585_length_953_cov_20.770492	301	381	2	28	80	0.3500000
NODE_7585_length_953_cov_20.770492	301	381	4	35	80	0.4375000
NODE_7585_length_953_cov_20.770492	354	434	2	29	80	0.3625000
NODE_7585_length_953_cov_20.770492	354	434	4	51	80	0.6375000
NODE_7586_length_953_cov_17.514052	421	501	0	66	80	0.8250000
NODE_7586_length_953_cov_17.514052	421	501	2	14	80	0.1750000
NODE_7586_length_953_cov_17.514052	474	554	0	13	80	0.1625000
NODE_7586_length_953_cov_17.514052	474	554	2	63	80	0.7875000
NODE_7586_length_953_cov_17.514052	474	554	4	4	80	0.0500000
NODE_7586_length_953_cov_17.514052	550	630	2	22	80	0.2750000
NODE_7586_length_953_cov_17.514052	550	630	4	58	80	0.7250000
NODE_7586_length_953_cov_17.514052	603	683	0	49	80	0.6125000
NODE_7586_length_953_cov_17.514052	603	683	2	26	80	0.3250000
NODE_7586_length_953_cov_17.514052	603	683	4	5	80	0.0625000
NODE_7587_length_953_cov_11.579625	332	412	0	80	80	1.0000000
NODE_7587_length_953_cov_11.579625	385	465	0	80	80	1.0000000
NODE_7588_length_953_cov_7.281030	276	356	0	80	80	1.0000000
NODE_7588_length_953_cov_7.281030	329	409	0	80	80	1.0000000
NODE_7599_length_952_cov_44.880422	447	527	0	23	80	0.2875000
NODE_7599_length_952_cov_44.880422	447	527	2	39	80	0.4875000
NODE_7599_length_952_cov_44.880422	447	527	4	18	80	0.2250000
NODE_7599_length_952_cov_44.880422	500	580	0	6	80	0.0750000
NODE_7599_length_952_cov_44.880422	500	580	2	23	80	0.2875000
NODE_7599_length_952_cov_44.880422	500	580	4	51	80	0.6375000
NODE_7599_length_952_cov_44.880422	871	951	0	80	80	1.0000000
NODE_7600_length_952_cov_42.485346	402	482	1	65	80	0.8125000
NODE_7600_length_952_cov_42.485346	402	482	2	15	80	0.1875000
NODE_7600_length_952_cov_42.485346	455	535	1	12	80	0.1500000
NODE_7600_length_952_cov_42.485346	455	535	2	63	80	0.7875000
NODE_7600_length_952_cov_42.485346	455	535	4	5	80	0.0625000
NODE_7601_length_952_cov_40.065651	422	502	6	1	80	0.0125000
NODE_7601_length_952_cov_40.065651	422	502	8	1	80	0.0125000
NODE_7601_length_952_cov_40.065651	422	502	10	78	80	0.9750000
NODE_7601_length_952_cov_40.065651	475	555	0	17	80	0.2125000
NODE_7601_length_952_cov_40.065651	475	555	6	37	80	0.4625000
NODE_7601_length_952_cov_40.065651	475	555	8	1	80	0.0125000
NODE_7601_length_952_cov_40.065651	475	555	10	25	80	0.3125000
NODE_7602_length_952_cov_34.813599	308	388	0	23	80	0.2875000
NODE_7602_length_952_cov_34.813599	308	388	2	57	80	0.7125000
NODE_7602_length_952_cov_34.813599	361	441	0	76	80	0.9500000
NODE_7602_length_952_cov_34.813599	361	441	2	4	80	0.0500000
NODE_7603_length_952_cov_28.055100	661	741	0	28	80	0.3500000
NODE_7603_length_952_cov_28.055100	661	741	2	52	80	0.6500000
NODE_7603_length_952_cov_28.055100	714	794	0	80	80	1.0000000
NODE_7604_length_952_cov_23.739742	435	515	6	17	80	0.2125000
NODE_7604_length_952_cov_23.739742	435	515	8	22	80	0.2750000
NODE_7604_length_952_cov_23.739742	435	515	10	9	80	0.1125000
NODE_7604_length_952_cov_23.739742	435	515	12	32	80	0.4000000
NODE_7604_length_952_cov_23.739742	488	568	2	5	80	0.0625000
NODE_7604_length_952_cov_23.739742	488	568	6	65	80	0.8125000
NODE_7604_length_952_cov_23.739742	488	568	8	10	80	0.1250000
NODE_7606_length_952_cov_11.478312	245	324	0	24	79	0.3037975
NODE_7606_length_952_cov_11.478312	245	324	2	55	79	0.6962025
NODE_7606_length_952_cov_11.478312	297	377	0	77	80	0.9625000
NODE_7606_length_952_cov_11.478312	297	377	2	3	80	0.0375000
NODE_7607_length_952_cov_11.284877	272	352	8	80	80	1.0000000
NODE_7607_length_952_cov_11.284877	325	405	0	39	80	0.4875000
NODE_7607_length_952_cov_11.284877	325	405	6	14	80	0.1750000
NODE_7607_length_952_cov_11.284877	325	405	8	27	80	0.3375000
NODE_7608_length_952_cov_10.807737	458	538	0	28	80	0.3500000
NODE_7608_length_952_cov_10.807737	458	538	2	52	80	0.6500000
NODE_7608_length_952_cov_10.807737	511	591	0	1	80	0.0125000
NODE_7608_length_952_cov_10.807737	511	591	2	79	80	0.9875000
NODE_7609_length_952_cov_8.770223	375	455	0	80	80	1.0000000
NODE_7609_length_952_cov_8.770223	428	508	0	80	80	1.0000000
NODE_7623_length_951_cov_54.397887	354	434	2	63	80	0.7875000
NODE_7623_length_951_cov_54.397887	354	434	6	17	80	0.2125000
NODE_7623_length_951_cov_54.397887	407	487	0	42	80	0.5250000
NODE_7623_length_951_cov_54.397887	407	487	2	38	80	0.4750000
NODE_7623_length_951_cov_54.397887	483	563	0	33	80	0.4125000
NODE_7623_length_951_cov_54.397887	483	563	4	23	80	0.2875000
NODE_7623_length_951_cov_54.397887	483	563	5	17	80	0.2125000
NODE_7623_length_951_cov_54.397887	483	563	7	7	80	0.0875000
NODE_7623_length_951_cov_54.397887	544	616	5	12	72	0.1666667
NODE_7623_length_951_cov_54.397887	544	616	7	60	72	0.8333333
NODE_7624_length_951_cov_47.881455	355	435	0	3	80	0.0375000
NODE_7624_length_951_cov_47.881455	355	435	2	77	80	0.9625000
NODE_7624_length_951_cov_47.881455	408	488	2	32	80	0.4000000
NODE_7624_length_951_cov_47.881455	408	488	4	42	80	0.5250000
NODE_7624_length_951_cov_47.881455	408	488	6	6	80	0.0750000
NODE_7624_length_951_cov_47.881455	484	564	4	9	80	0.1125000
NODE_7624_length_951_cov_47.881455	484	564	6	4	80	0.0500000
NODE_7624_length_951_cov_47.881455	484	564	8	3	80	0.0375000
NODE_7624_length_951_cov_47.881455	484	564	10	4	80	0.0500000
NODE_7624_length_951_cov_47.881455	484	564	16	42	80	0.5250000
NODE_7624_length_951_cov_47.881455	484	564	18	18	80	0.2250000
NODE_7624_length_951_cov_47.881455	537	617	10	2	80	0.0250000
NODE_7624_length_951_cov_47.881455	537	617	12	12	80	0.1500000
NODE_7624_length_951_cov_47.881455	537	617	14	27	80	0.3375000
NODE_7624_length_951_cov_47.881455	537	617	16	11	80	0.1375000
NODE_7624_length_951_cov_47.881455	537	617	18	28	80	0.3500000
NODE_7625_length_951_cov_24.322770	479	559	4	46	80	0.5750000
NODE_7625_length_951_cov_24.322770	479	559	6	34	80	0.4250000
NODE_7625_length_951_cov_24.322770	532	612	0	20	80	0.2500000
NODE_7625_length_951_cov_24.322770	532	612	2	16	80	0.2000000
NODE_7625_length_951_cov_24.322770	532	612	4	44	80	0.5500000
NODE_7626_length_951_cov_23.001174	470	550	0	20	80	0.2500000
NODE_7626_length_951_cov_23.001174	470	550	2	60	80	0.7500000
NODE_7626_length_951_cov_23.001174	523	603	0	20	80	0.2500000
NODE_7626_length_951_cov_23.001174	523	603	2	60	80	0.7500000
NODE_7627_length_951_cov_22.059859	562	642	8	22	80	0.2750000
NODE_7627_length_951_cov_22.059859	562	642	10	12	80	0.1500000
NODE_7627_length_951_cov_22.059859	562	642	12	46	80	0.5750000
NODE_7627_length_951_cov_22.059859	615	695	2	12	80	0.1500000
NODE_7627_length_951_cov_22.059859	615	695	3	1	80	0.0125000
NODE_7627_length_951_cov_22.059859	615	695	4	37	80	0.4625000
NODE_7627_length_951_cov_22.059859	615	695	5	1	80	0.0125000
NODE_7627_length_951_cov_22.059859	615	695	6	1	80	0.0125000
NODE_7627_length_951_cov_22.059859	615	695	12	28	80	0.3500000
NODE_7628_length_951_cov_19.413146	456	536	3	43	80	0.5375000
NODE_7628_length_951_cov_19.413146	456	536	5	37	80	0.4625000
NODE_7628_length_951_cov_19.413146	509	589	3	46	80	0.5750000
NODE_7628_length_951_cov_19.413146	509	589	4	5	80	0.0625000
NODE_7628_length_951_cov_19.413146	509	589	5	29	80	0.3625000
NODE_7628_length_951_cov_19.413146	830	877	0	47	47	1.0000000
NODE_7629_length_951_cov_18.970657	384	464	0	48	80	0.6000000
NODE_7629_length_951_cov_18.970657	384	464	2	32	80	0.4000000
NODE_7629_length_951_cov_18.970657	437	517	0	80	80	1.0000000
NODE_7629_length_951_cov_18.970657	513	593	0	12	80	0.1500000
NODE_7629_length_951_cov_18.970657	513	593	2	68	80	0.8500000
NODE_7629_length_951_cov_18.970657	566	646	0	20	80	0.2500000
NODE_7629_length_951_cov_18.970657	566	646	2	60	80	0.7500000
NODE_7630_length_951_cov_17.164319	409	490	0	81	81	1.0000000
NODE_7630_length_951_cov_17.164319	463	543	0	80	80	1.0000000
NODE_7631_length_951_cov_17.009390	393	473	0	26	80	0.3250000
NODE_7631_length_951_cov_17.009390	393	473	16	54	80	0.6750000
NODE_7631_length_951_cov_17.009390	446	526	15	51	80	0.6375000
NODE_7631_length_951_cov_17.009390	446	526	16	29	80	0.3625000
NODE_7632_length_951_cov_15.551643	520	600	0	10	80	0.1250000
NODE_7632_length_951_cov_15.551643	520	600	2	6	80	0.0750000
NODE_7632_length_951_cov_15.551643	520	600	4	10	80	0.1250000
NODE_7632_length_951_cov_15.551643	520	600	8	25	80	0.3125000
NODE_7632_length_951_cov_15.551643	520	600	10	29	80	0.3625000
NODE_7632_length_951_cov_15.551643	573	653	0	63	80	0.7875000
NODE_7632_length_951_cov_15.551643	573	653	2	6	80	0.0750000
NODE_7632_length_951_cov_15.551643	573	653	4	10	80	0.1250000
NODE_7632_length_951_cov_15.551643	573	653	8	1	80	0.0125000
NODE_7633_length_951_cov_13.562207	364	444	0	80	80	1.0000000
NODE_7633_length_951_cov_13.562207	417	497	0	80	80	1.0000000
NODE_7634_length_951_cov_13.086854	450	530	10	67	80	0.8375000
NODE_7634_length_951_cov_13.086854	450	530	11	1	80	0.0125000
NODE_7634_length_951_cov_13.086854	450	530	12	12	80	0.1500000
NODE_7634_length_951_cov_13.086854	503	583	0	25	80	0.3125000
NODE_7634_length_951_cov_13.086854	503	583	2	2	80	0.0250000
NODE_7634_length_951_cov_13.086854	503	583	4	13	80	0.1625000
NODE_7634_length_951_cov_13.086854	503	583	10	38	80	0.4750000
NODE_7634_length_951_cov_13.086854	503	583	12	2	80	0.0250000
NODE_7635_length_951_cov_6.812207	350	430	1	19	80	0.2375000
NODE_7635_length_951_cov_6.812207	350	430	3	2	80	0.0250000
NODE_7635_length_951_cov_6.812207	350	430	5	59	80	0.7375000
NODE_7635_length_951_cov_6.812207	403	483	3	16	80	0.2000000
NODE_7635_length_951_cov_6.812207	403	483	5	64	80	0.8000000
NODE_7636_length_951_cov_5.076291	80	160	0	80	80	1.0000000
NODE_7636_length_951_cov_5.076291	133	213	0	80	80	1.0000000
NODE_7649_length_950_cov_62.151586	731	794	7	23	63	0.3650794
NODE_7649_length_950_cov_62.151586	731	794	8	12	63	0.1904762
NODE_7649_length_950_cov_62.151586	731	794	12	2	63	0.0317460
NODE_7649_length_950_cov_62.151586	731	794	13	6	63	0.0952381
NODE_7649_length_950_cov_62.151586	731	794	15	2	63	0.0317460
NODE_7649_length_950_cov_62.151586	731	794	17	10	63	0.1587302
NODE_7649_length_950_cov_62.151586	731	794	19	2	63	0.0317460
NODE_7649_length_950_cov_62.151586	731	794	27	6	63	0.0952381
NODE_7650_length_950_cov_56.088132	354	434	0	1	80	0.0125000
NODE_7650_length_950_cov_56.088132	354	434	4	79	80	0.9875000
NODE_7650_length_950_cov_56.088132	407	487	0	47	80	0.5875000
NODE_7650_length_950_cov_56.088132	407	487	2	7	80	0.0875000
NODE_7650_length_950_cov_56.088132	407	487	4	26	80	0.3250000
NODE_7650_length_950_cov_56.088132	483	563	2	37	80	0.4625000
NODE_7650_length_950_cov_56.088132	483	563	4	43	80	0.5375000
NODE_7650_length_950_cov_56.088132	536	616	2	32	80	0.4000000
NODE_7650_length_950_cov_56.088132	536	616	4	48	80	0.6000000
NODE_7651_length_950_cov_29.780259	501	581	0	80	80	1.0000000
NODE_7651_length_950_cov_29.780259	554	634	0	80	80	1.0000000
NODE_7652_length_950_cov_27.278496	388	468	0	80	80	1.0000000
NODE_7652_length_950_cov_27.278496	441	519	0	78	78	1.0000000
NODE_7653_length_950_cov_26.766157	322	402	0	6	80	0.0750000
NODE_7653_length_950_cov_26.766157	322	402	2	11	80	0.1375000
NODE_7653_length_950_cov_26.766157	322	402	4	63	80	0.7875000
NODE_7653_length_950_cov_26.766157	375	455	0	11	80	0.1375000
NODE_7653_length_950_cov_26.766157	375	455	2	50	80	0.6250000
NODE_7653_length_950_cov_26.766157	375	455	4	19	80	0.2375000
NODE_7653_length_950_cov_26.766157	451	531	2	44	80	0.5500000
NODE_7653_length_950_cov_26.766157	451	531	4	36	80	0.4500000
NODE_7653_length_950_cov_26.766157	504	584	2	50	80	0.6250000
NODE_7653_length_950_cov_26.766157	504	584	4	30	80	0.3750000
NODE_7654_length_950_cov_19.638073	421	501	0	80	80	1.0000000
NODE_7654_length_950_cov_19.638073	474	554	0	80	80	1.0000000
NODE_7654_length_950_cov_19.638073	550	630	0	52	80	0.6500000
NODE_7654_length_950_cov_19.638073	550	630	2	28	80	0.3500000
NODE_7654_length_950_cov_19.638073	603	683	0	15	80	0.1875000
NODE_7654_length_950_cov_19.638073	603	683	2	65	80	0.8125000
NODE_7655_length_950_cov_14.686251	376	456	0	80	80	1.0000000
NODE_7655_length_950_cov_14.686251	429	509	0	80	80	1.0000000
NODE_7656_length_950_cov_14.215041	339	419	0	80	80	1.0000000
NODE_7656_length_950_cov_14.215041	392	472	0	80	80	1.0000000
NODE_7657_length_950_cov_6.397180	370	450	0	80	80	1.0000000
NODE_7657_length_950_cov_6.397180	423	504	0	81	81	1.0000000
NODE_7659_length_950_cov_4.430082	594	674	0	80	80	1.0000000
NODE_7659_length_950_cov_4.430082	647	727	0	80	80	1.0000000
NODE_7672_length_949_cov_25.550588	371	451	0	6	80	0.0750000
NODE_7672_length_949_cov_25.550588	371	451	2	30	80	0.3750000
NODE_7672_length_949_cov_25.550588	371	451	4	44	80	0.5500000
NODE_7672_length_949_cov_25.550588	500	580	0	74	80	0.9250000
NODE_7672_length_949_cov_25.550588	500	580	2	6	80	0.0750000
NODE_7672_length_949_cov_25.550588	553	633	0	80	80	1.0000000
NODE_7673_length_949_cov_20.949412	252	332	2	60	80	0.7500000
NODE_7673_length_949_cov_20.949412	252	332	8	20	80	0.2500000
NODE_7673_length_949_cov_20.949412	305	385	2	7	80	0.0875000
NODE_7673_length_949_cov_20.949412	305	385	6	23	80	0.2875000
NODE_7673_length_949_cov_20.949412	305	385	8	50	80	0.6250000
NODE_7674_length_949_cov_20.601176	364	444	0	16	80	0.2000000
NODE_7674_length_949_cov_20.601176	364	444	2	64	80	0.8000000
NODE_7674_length_949_cov_20.601176	417	497	0	21	80	0.2625000
NODE_7674_length_949_cov_20.601176	417	497	2	43	80	0.5375000
NODE_7674_length_949_cov_20.601176	417	497	5	12	80	0.1500000
NODE_7674_length_949_cov_20.601176	417	497	10	4	80	0.0500000
NODE_7674_length_949_cov_20.601176	493	573	10	28	80	0.3500000
NODE_7674_length_949_cov_20.601176	493	573	12	52	80	0.6500000
NODE_7674_length_949_cov_20.601176	546	626	10	33	80	0.4125000
NODE_7674_length_949_cov_20.601176	546	626	12	47	80	0.5875000
NODE_7675_length_949_cov_20.575294	481	561	2	40	80	0.5000000
NODE_7675_length_949_cov_20.575294	481	561	4	40	80	0.5000000
NODE_7675_length_949_cov_20.575294	534	614	0	2	80	0.0250000
NODE_7675_length_949_cov_20.575294	534	614	2	74	80	0.9250000
NODE_7675_length_949_cov_20.575294	534	614	4	4	80	0.0500000
NODE_7676_length_949_cov_19.483529	340	420	0	80	80	1.0000000
NODE_7676_length_949_cov_19.483529	393	473	0	80	80	1.0000000
NODE_7676_length_949_cov_19.483529	469	549	0	72	80	0.9000000
NODE_7676_length_949_cov_19.483529	469	549	2	8	80	0.1000000
NODE_7676_length_949_cov_19.483529	522	602	0	19	80	0.2375000
NODE_7676_length_949_cov_19.483529	522	602	2	11	80	0.1375000
NODE_7676_length_949_cov_19.483529	522	602	4	23	80	0.2875000
NODE_7676_length_949_cov_19.483529	522	602	6	19	80	0.2375000
NODE_7676_length_949_cov_19.483529	522	602	8	8	80	0.1000000
NODE_7677_length_949_cov_19.407059	433	513	0	6	80	0.0750000
NODE_7677_length_949_cov_19.407059	433	513	2	74	80	0.9250000
NODE_7677_length_949_cov_19.407059	486	566	0	13	80	0.1625000
NODE_7677_length_949_cov_19.407059	486	566	2	67	80	0.8375000
NODE_7677_length_949_cov_19.407059	562	642	2	80	80	1.0000000
NODE_7677_length_949_cov_19.407059	615	695	0	45	80	0.5625000
NODE_7677_length_949_cov_19.407059	615	695	2	35	80	0.4375000
NODE_7678_length_949_cov_10.903529	561	641	0	80	80	1.0000000
NODE_7678_length_949_cov_10.903529	614	694	0	80	80	1.0000000
NODE_7679_length_949_cov_7.245882	0	71	0	71	71	1.0000000
NODE_7679_length_949_cov_7.245882	0	71	0	71	71	1.0000000
NODE_7679_length_949_cov_7.245882	44	124	0	38	80	0.4750000
NODE_7679_length_949_cov_7.245882	44	124	2	42	80	0.5250000
NODE_7680_length_949_cov_6.998824	494	574	0	80	80	1.0000000
NODE_7680_length_949_cov_6.998824	547	627	0	80	80	1.0000000
NODE_7702_length_948_cov_37.201413	510	590	0	16	80	0.2000000
NODE_7702_length_948_cov_37.201413	510	590	2	30	80	0.3750000
NODE_7702_length_948_cov_37.201413	510	590	4	34	80	0.4250000
NODE_7702_length_948_cov_37.201413	563	643	2	32	80	0.4000000
NODE_7702_length_948_cov_37.201413	563	643	4	48	80	0.6000000
NODE_7703_length_948_cov_20.082450	58	99	0	8	41	0.1951219
NODE_7703_length_948_cov_20.082450	58	99	2	33	41	0.8048781
NODE_7703_length_948_cov_20.082450	113	193	2	2	80	0.0250000
NODE_7703_length_948_cov_20.082450	113	193	4	1	80	0.0125000
NODE_7703_length_948_cov_20.082450	113	193	6	1	80	0.0125000
NODE_7703_length_948_cov_20.082450	113	193	8	2	80	0.0250000
NODE_7703_length_948_cov_20.082450	113	193	10	4	80	0.0500000
NODE_7703_length_948_cov_20.082450	113	193	12	4	80	0.0500000
NODE_7703_length_948_cov_20.082450	113	193	14	16	80	0.2000000
NODE_7703_length_948_cov_20.082450	113	193	17	3	80	0.0375000
NODE_7703_length_948_cov_20.082450	113	193	19	7	80	0.0875000
NODE_7703_length_948_cov_20.082450	113	193	21	10	80	0.1250000
NODE_7703_length_948_cov_20.082450	113	193	23	11	80	0.1375000
NODE_7703_length_948_cov_20.082450	113	193	25	4	80	0.0500000
NODE_7703_length_948_cov_20.082450	113	193	27	2	80	0.0250000
NODE_7703_length_948_cov_20.082450	113	193	29	1	80	0.0125000
NODE_7703_length_948_cov_20.082450	113	193	30	12	80	0.1500000
NODE_7703_length_948_cov_20.082450	166	246	23	10	80	0.1250000
NODE_7703_length_948_cov_20.082450	166	246	25	9	80	0.1125000
NODE_7703_length_948_cov_20.082450	166	246	26	14	80	0.1750000
NODE_7703_length_948_cov_20.082450	166	246	27	2	80	0.0250000
NODE_7703_length_948_cov_20.082450	166	246	28	8	80	0.1000000
NODE_7703_length_948_cov_20.082450	166	246	29	1	80	0.0125000
NODE_7703_length_948_cov_20.082450	166	246	30	33	80	0.4125000
NODE_7703_length_948_cov_20.082450	166	246	32	3	80	0.0375000
NODE_7704_length_948_cov_16.785630	308	388	2	65	80	0.8125000
NODE_7704_length_948_cov_16.785630	308	388	4	15	80	0.1875000
NODE_7704_length_948_cov_16.785630	361	441	2	49	80	0.6125000
NODE_7704_length_948_cov_16.785630	361	441	4	31	80	0.3875000
NODE_7704_length_948_cov_16.785630	437	517	0	34	80	0.4250000
NODE_7704_length_948_cov_16.785630	437	517	2	46	80	0.5750000
NODE_7704_length_948_cov_16.785630	490	570	0	80	80	1.0000000
NODE_7705_length_948_cov_12.740872	400	480	0	80	80	1.0000000
NODE_7705_length_948_cov_12.740872	453	533	0	80	80	1.0000000
NODE_7706_length_948_cov_10.220259	465	545	0	80	80	1.0000000
NODE_7706_length_948_cov_10.220259	518	598	0	80	80	1.0000000
NODE_7707_length_948_cov_8.504122	456	536	0	42	80	0.5250000
NODE_7707_length_948_cov_8.504122	456	536	2	38	80	0.4750000
NODE_7707_length_948_cov_8.504122	509	589	2	80	80	1.0000000
NODE_7709_length_948_cov_5.425206	641	721	0	16	80	0.2000000
NODE_7709_length_948_cov_5.425206	641	721	2	64	80	0.8000000
NODE_7709_length_948_cov_5.425206	694	774	0	15	80	0.1875000
NODE_7709_length_948_cov_5.425206	694	774	2	65	80	0.8125000
NODE_7711_length_948_cov_3.586572	696	776	2	80	80	1.0000000
NODE_7715_length_948_cov_2.786808	259	324	0	65	65	1.0000000
NODE_7715_length_948_cov_2.786808	297	377	0	80	80	1.0000000
NODE_7721_length_947_cov_91.466981	393	473	12	4	80	0.0500000
NODE_7721_length_947_cov_91.466981	393	473	13	47	80	0.5875000
NODE_7721_length_947_cov_91.466981	393	473	14	29	80	0.3625000
NODE_7721_length_947_cov_91.466981	446	526	2	14	80	0.1750000
NODE_7721_length_947_cov_91.466981	446	526	4	11	80	0.1375000
NODE_7721_length_947_cov_91.466981	446	526	11	3	80	0.0375000
NODE_7721_length_947_cov_91.466981	446	526	12	1	80	0.0125000
NODE_7721_length_947_cov_91.466981	446	526	13	51	80	0.6375000
NODE_7722_length_947_cov_61.139151	402	482	0	16	80	0.2000000
NODE_7722_length_947_cov_61.139151	402	482	5	1	80	0.0125000
NODE_7722_length_947_cov_61.139151	402	482	6	28	80	0.3500000
NODE_7722_length_947_cov_61.139151	402	482	8	12	80	0.1500000
NODE_7722_length_947_cov_61.139151	402	482	9	8	80	0.1000000
NODE_7722_length_947_cov_61.139151	402	482	10	15	80	0.1875000
NODE_7722_length_947_cov_61.139151	455	535	8	30	80	0.3750000
NODE_7722_length_947_cov_61.139151	455	535	9	8	80	0.1000000
NODE_7722_length_947_cov_61.139151	455	535	10	42	80	0.5250000
NODE_7723_length_947_cov_50.009434	488	568	2	6	80	0.0750000
NODE_7723_length_947_cov_50.009434	488	568	4	20	80	0.2500000
NODE_7723_length_947_cov_50.009434	488	568	6	54	80	0.6750000
NODE_7723_length_947_cov_50.009434	541	621	0	18	80	0.2250000
NODE_7723_length_947_cov_50.009434	541	621	2	41	80	0.5125000
NODE_7723_length_947_cov_50.009434	541	621	6	21	80	0.2625000
NODE_7724_length_947_cov_36.271226	511	591	4	2	80	0.0250000
NODE_7724_length_947_cov_36.271226	511	591	5	9	80	0.1125000
NODE_7724_length_947_cov_36.271226	511	591	6	36	80	0.4500000
NODE_7724_length_947_cov_36.271226	511	591	7	3	80	0.0375000
NODE_7724_length_947_cov_36.271226	511	591	8	30	80	0.3750000
NODE_7724_length_947_cov_36.271226	564	644	2	4	80	0.0500000
NODE_7724_length_947_cov_36.271226	564	644	4	51	80	0.6375000
NODE_7724_length_947_cov_36.271226	564	644	6	19	80	0.2375000
NODE_7724_length_947_cov_36.271226	564	644	8	6	80	0.0750000
NODE_7725_length_947_cov_23.384434	425	505	0	14	80	0.1750000
NODE_7725_length_947_cov_23.384434	425	505	2	66	80	0.8250000
NODE_7725_length_947_cov_23.384434	478	558	0	65	80	0.8125000
NODE_7725_length_947_cov_23.384434	478	558	2	15	80	0.1875000
NODE_7726_length_947_cov_19.103774	316	396	0	80	80	1.0000000
NODE_7726_length_947_cov_19.103774	369	449	0	30	80	0.3750000
NODE_7726_length_947_cov_19.103774	369	449	2	50	80	0.6250000
NODE_7727_length_947_cov_18.853774	516	596	0	80	80	1.0000000
NODE_7727_length_947_cov_18.853774	569	649	0	80	80	1.0000000
NODE_7728_length_947_cov_18.077830	315	395	4	55	80	0.6875000
NODE_7728_length_947_cov_18.077830	315	395	6	25	80	0.3125000
NODE_7728_length_947_cov_18.077830	368	448	0	5	80	0.0625000
NODE_7728_length_947_cov_18.077830	368	448	2	6	80	0.0750000
NODE_7728_length_947_cov_18.077830	368	448	4	2	80	0.0250000
NODE_7728_length_947_cov_18.077830	368	448	6	67	80	0.8375000
NODE_7729_length_947_cov_17.713443	403	483	0	9	80	0.1125000
NODE_7729_length_947_cov_17.713443	403	483	2	12	80	0.1500000
NODE_7729_length_947_cov_17.713443	403	483	4	59	80	0.7375000
NODE_7729_length_947_cov_17.713443	456	536	2	12	80	0.1500000
NODE_7729_length_947_cov_17.713443	456	536	4	68	80	0.8500000
NODE_7730_length_947_cov_14.492925	358	438	2	15	80	0.1875000
NODE_7730_length_947_cov_14.492925	358	438	4	65	80	0.8125000
NODE_7730_length_947_cov_14.492925	411	491	0	50	80	0.6250000
NODE_7730_length_947_cov_14.492925	411	491	2	18	80	0.2250000
NODE_7730_length_947_cov_14.492925	411	491	4	12	80	0.1500000
NODE_7730_length_947_cov_14.492925	487	567	0	74	80	0.9250000
NODE_7730_length_947_cov_14.492925	487	567	2	6	80	0.0750000
NODE_7730_length_947_cov_14.492925	540	620	0	21	80	0.2625000
NODE_7730_length_947_cov_14.492925	540	620	2	34	80	0.4250000
NODE_7730_length_947_cov_14.492925	540	620	4	25	80	0.3125000
NODE_7731_length_947_cov_10.573113	550	630	0	80	80	1.0000000
NODE_7731_length_947_cov_10.573113	603	683	0	80	80	1.0000000
NODE_7732_length_947_cov_7.762972	550	630	2	18	80	0.2250000
NODE_7732_length_947_cov_7.762972	550	630	4	5	80	0.0625000
NODE_7732_length_947_cov_7.762972	550	630	6	57	80	0.7125000
NODE_7732_length_947_cov_7.762972	607	683	0	13	76	0.1710526
NODE_7732_length_947_cov_7.762972	607	683	2	4	76	0.0526316
NODE_7732_length_947_cov_7.762972	607	683	4	13	76	0.1710526
NODE_7732_length_947_cov_7.762972	607	683	6	46	76	0.6052632
NODE_7747_length_946_cov_39.726092	378	458	2	1	80	0.0125000
NODE_7747_length_946_cov_39.726092	378	458	4	79	80	0.9875000
NODE_7747_length_946_cov_39.726092	431	511	0	16	80	0.2000000
NODE_7747_length_946_cov_39.726092	431	511	2	38	80	0.4750000
NODE_7747_length_946_cov_39.726092	431	511	4	26	80	0.3250000
NODE_7747_length_946_cov_39.726092	507	587	0	80	80	1.0000000
NODE_7747_length_946_cov_39.726092	560	640	0	80	80	1.0000000
NODE_7748_length_946_cov_32.728453	404	484	4	80	80	1.0000000
NODE_7748_length_946_cov_32.728453	457	537	0	12	80	0.1500000
NODE_7748_length_946_cov_32.728453	457	537	2	2	80	0.0250000
NODE_7748_length_946_cov_32.728453	457	537	4	66	80	0.8250000
NODE_7749_length_946_cov_27.548996	280	360	4	80	80	1.0000000
NODE_7749_length_946_cov_27.548996	333	413	0	6	80	0.0750000
NODE_7749_length_946_cov_27.548996	333	413	4	74	80	0.9250000
NODE_7750_length_946_cov_24.622196	352	432	0	50	80	0.6250000
NODE_7750_length_946_cov_24.622196	352	432	2	1	80	0.0125000
NODE_7750_length_946_cov_24.622196	352	432	4	29	80	0.3625000
NODE_7750_length_946_cov_24.622196	405	486	2	17	81	0.2098765
NODE_7750_length_946_cov_24.622196	405	486	4	64	81	0.7901235
NODE_7751_length_946_cov_18.082645	492	572	2	30	80	0.3750000
NODE_7751_length_946_cov_18.082645	492	572	4	1	80	0.0125000
NODE_7751_length_946_cov_18.082645	492	572	5	36	80	0.4500000
NODE_7751_length_946_cov_18.082645	492	572	6	13	80	0.1625000
NODE_7751_length_946_cov_18.082645	545	625	0	31	80	0.3875000
NODE_7751_length_946_cov_18.082645	545	625	1	15	80	0.1875000
NODE_7751_length_946_cov_18.082645	545	625	3	1	80	0.0125000
NODE_7751_length_946_cov_18.082645	545	625	5	33	80	0.4125000
NODE_7752_length_946_cov_18.031877	433	513	0	31	80	0.3875000
NODE_7752_length_946_cov_18.031877	433	513	3	2	80	0.0250000
NODE_7752_length_946_cov_18.031877	433	513	4	47	80	0.5875000
NODE_7752_length_946_cov_18.031877	486	566	2	22	80	0.2750000
NODE_7752_length_946_cov_18.031877	486	566	3	1	80	0.0125000
NODE_7752_length_946_cov_18.031877	486	566	4	57	80	0.7125000
NODE_7753_length_946_cov_15.188902	472	552	0	2	80	0.0250000
NODE_7753_length_946_cov_15.188902	472	552	2	78	80	0.9750000
NODE_7753_length_946_cov_15.188902	525	605	0	23	80	0.2875000
NODE_7753_length_946_cov_15.188902	525	605	2	25	80	0.3125000
NODE_7753_length_946_cov_15.188902	525	605	4	32	80	0.4000000
NODE_7754_length_946_cov_11.201889	408	488	0	21	80	0.2625000
NODE_7754_length_946_cov_11.201889	408	488	2	41	80	0.5125000
NODE_7754_length_946_cov_11.201889	408	488	4	18	80	0.2250000
NODE_7754_length_946_cov_11.201889	461	541	0	7	80	0.0875000
NODE_7754_length_946_cov_11.201889	461	541	2	14	80	0.1750000
NODE_7754_length_946_cov_11.201889	461	541	4	59	80	0.7375000
NODE_7768_length_945_cov_42.997636	361	441	2	17	80	0.2125000
NODE_7768_length_945_cov_42.997636	361	441	4	43	80	0.5375000
NODE_7768_length_945_cov_42.997636	361	441	6	20	80	0.2500000
NODE_7768_length_945_cov_42.997636	414	494	2	7	80	0.0875000
NODE_7768_length_945_cov_42.997636	414	494	6	31	80	0.3875000
NODE_7768_length_945_cov_42.997636	414	494	8	42	80	0.5250000
NODE_7769_length_945_cov_31.223404	357	437	6	17	80	0.2125000
NODE_7769_length_945_cov_31.223404	357	437	8	5	80	0.0625000
NODE_7769_length_945_cov_31.223404	357	437	14	58	80	0.7250000
NODE_7769_length_945_cov_31.223404	410	490	0	1	80	0.0125000
NODE_7769_length_945_cov_31.223404	410	490	4	7	80	0.0875000
NODE_7769_length_945_cov_31.223404	410	490	6	24	80	0.3000000
NODE_7769_length_945_cov_31.223404	410	490	8	20	80	0.2500000
NODE_7769_length_945_cov_31.223404	410	490	14	28	80	0.3500000
NODE_7770_length_945_cov_26.348700	331	411	0	5	80	0.0625000
NODE_7770_length_945_cov_26.348700	331	411	2	55	80	0.6875000
NODE_7770_length_945_cov_26.348700	331	411	4	20	80	0.2500000
NODE_7770_length_945_cov_26.348700	384	464	0	58	80	0.7250000
NODE_7770_length_945_cov_26.348700	384	464	2	22	80	0.2750000
NODE_7771_length_945_cov_20.349882	435	515	2	71	80	0.8875000
NODE_7771_length_945_cov_20.349882	435	515	6	9	80	0.1125000
NODE_7771_length_945_cov_20.349882	488	568	2	18	80	0.2250000
NODE_7771_length_945_cov_20.349882	488	568	4	38	80	0.4750000
NODE_7771_length_945_cov_20.349882	488	568	6	24	80	0.3000000
NODE_7772_length_945_cov_14.771868	386	466	0	12	80	0.1500000
NODE_7772_length_945_cov_14.771868	386	466	2	68	80	0.8500000
NODE_7772_length_945_cov_14.771868	439	519	0	8	80	0.1000000
NODE_7772_length_945_cov_14.771868	439	519	2	72	80	0.9000000
NODE_7773_length_945_cov_10.158392	599	679	0	80	80	1.0000000
NODE_7773_length_945_cov_10.158392	652	732	0	80	80	1.0000000
NODE_7775_length_945_cov_5.403073	357	437	0	80	80	1.0000000
NODE_7775_length_945_cov_5.403073	410	490	0	80	80	1.0000000
NODE_7785_length_944_cov_42.401183	358	438	0	8	80	0.1000000
NODE_7785_length_944_cov_42.401183	358	438	4	19	80	0.2375000
NODE_7785_length_944_cov_42.401183	358	438	6	16	80	0.2000000
NODE_7785_length_944_cov_42.401183	358	438	8	5	80	0.0625000
NODE_7785_length_944_cov_42.401183	358	438	10	6	80	0.0750000
NODE_7785_length_944_cov_42.401183	358	438	14	5	80	0.0625000
NODE_7785_length_944_cov_42.401183	358	438	16	4	80	0.0500000
NODE_7785_length_944_cov_42.401183	358	438	20	9	80	0.1125000
NODE_7785_length_944_cov_42.401183	358	438	22	2	80	0.0250000
NODE_7785_length_944_cov_42.401183	358	438	26	6	80	0.0750000
NODE_7785_length_944_cov_42.401183	411	498	10	1	87	0.0114943
NODE_7785_length_944_cov_42.401183	411	498	14	5	87	0.0574713
NODE_7785_length_944_cov_42.401183	411	498	16	4	87	0.0459770
NODE_7785_length_944_cov_42.401183	411	498	18	22	87	0.2528736
NODE_7785_length_944_cov_42.401183	411	498	20	12	87	0.1379310
NODE_7785_length_944_cov_42.401183	411	498	22	26	87	0.2988506
NODE_7785_length_944_cov_42.401183	411	498	26	17	87	0.1954023
NODE_7786_length_944_cov_32.712426	377	457	4	28	80	0.3500000
NODE_7786_length_944_cov_32.712426	377	457	6	52	80	0.6500000
NODE_7786_length_944_cov_32.712426	430	510	0	50	80	0.6250000
NODE_7786_length_944_cov_32.712426	430	510	4	30	80	0.3750000
NODE_7787_length_944_cov_27.839053	417	497	2	25	80	0.3125000
NODE_7787_length_944_cov_27.839053	417	497	4	10	80	0.1250000
NODE_7787_length_944_cov_27.839053	417	497	6	45	80	0.5625000
NODE_7787_length_944_cov_27.839053	470	550	0	6	80	0.0750000
NODE_7787_length_944_cov_27.839053	470	550	2	2	80	0.0250000
NODE_7787_length_944_cov_27.839053	470	550	4	21	80	0.2625000
NODE_7787_length_944_cov_27.839053	470	550	6	51	80	0.6375000
NODE_7788_length_944_cov_24.702959	413	493	0	73	80	0.9125000
NODE_7788_length_944_cov_24.702959	413	493	2	7	80	0.0875000
NODE_7788_length_944_cov_24.702959	466	546	0	80	80	1.0000000
NODE_7789_length_944_cov_11.951479	347	427	2	80	80	1.0000000
NODE_7789_length_944_cov_11.951479	400	480	0	2	80	0.0250000
NODE_7789_length_944_cov_11.951479	400	480	1	13	80	0.1625000
NODE_7789_length_944_cov_11.951479	400	480	2	65	80	0.8125000
NODE_7789_length_944_cov_11.951479	476	556	0	10	80	0.1250000
NODE_7789_length_944_cov_11.951479	476	556	1	2	80	0.0250000
NODE_7789_length_944_cov_11.951479	476	556	2	68	80	0.8500000
NODE_7789_length_944_cov_11.951479	529	609	0	17	80	0.2125000
NODE_7789_length_944_cov_11.951479	529	609	2	63	80	0.7875000
NODE_7790_length_944_cov_6.745562	366	446	0	80	80	1.0000000
NODE_7790_length_944_cov_6.745562	419	499	0	80	80	1.0000000
NODE_7792_length_944_cov_4.420118	236	316	0	80	80	1.0000000
NODE_7792_length_944_cov_4.420118	289	369	0	80	80	1.0000000
NODE_7800_length_943_cov_40.111374	536	614	0	78	78	1.0000000
NODE_7800_length_943_cov_40.111374	587	667	0	80	80	1.0000000
NODE_7801_length_943_cov_29.446682	338	418	0	80	80	1.0000000
NODE_7801_length_943_cov_29.446682	391	471	0	80	80	1.0000000
NODE_7802_length_943_cov_28.289100	393	473	2	9	80	0.1125000
NODE_7802_length_943_cov_28.289100	393	473	4	38	80	0.4750000
NODE_7802_length_943_cov_28.289100	393	473	6	33	80	0.4125000
NODE_7802_length_943_cov_28.289100	446	526	0	53	80	0.6625000
NODE_7802_length_943_cov_28.289100	446	526	4	27	80	0.3375000
NODE_7803_length_943_cov_27.225118	343	423	0	60	80	0.7500000
NODE_7803_length_943_cov_27.225118	343	423	2	20	80	0.2500000
NODE_7803_length_943_cov_27.225118	396	476	0	7	80	0.0875000
NODE_7803_length_943_cov_27.225118	396	476	2	64	80	0.8000000
NODE_7803_length_943_cov_27.225118	396	476	6	9	80	0.1125000
NODE_7804_length_943_cov_26.536730	275	303	0	3	28	0.1071429
NODE_7804_length_943_cov_26.536730	275	303	2	7	28	0.2500000
NODE_7804_length_943_cov_26.536730	275	303	4	18	28	0.6428571
NODE_7804_length_943_cov_26.536730	299	379	4	30	80	0.3750000
NODE_7804_length_943_cov_26.536730	299	379	6	50	80	0.6250000
NODE_7804_length_943_cov_26.536730	352	432	0	33	80	0.4125000
NODE_7804_length_943_cov_26.536730	352	432	4	18	80	0.2250000
NODE_7804_length_943_cov_26.536730	352	432	6	29	80	0.3625000
NODE_7805_length_943_cov_24.992891	374	454	0	24	80	0.3000000
NODE_7805_length_943_cov_24.992891	374	454	2	17	80	0.2125000
NODE_7805_length_943_cov_24.992891	374	454	4	39	80	0.4875000
NODE_7805_length_943_cov_24.992891	427	507	2	7	80	0.0875000
NODE_7805_length_943_cov_24.992891	427	507	4	73	80	0.9125000
NODE_7805_length_943_cov_24.992891	503	583	2	30	80	0.3750000
NODE_7805_length_943_cov_24.992891	503	583	4	2	80	0.0250000
NODE_7805_length_943_cov_24.992891	503	583	6	6	80	0.0750000
NODE_7805_length_943_cov_24.992891	503	583	8	5	80	0.0625000
NODE_7805_length_943_cov_24.992891	503	583	12	12	80	0.1500000
NODE_7805_length_943_cov_24.992891	503	583	13	1	80	0.0125000
NODE_7805_length_943_cov_24.992891	503	583	14	12	80	0.1500000
NODE_7805_length_943_cov_24.992891	503	583	15	10	80	0.1250000
NODE_7805_length_943_cov_24.992891	503	583	16	2	80	0.0250000
NODE_7805_length_943_cov_24.992891	556	636	12	8	80	0.1000000
NODE_7805_length_943_cov_24.992891	556	636	13	1	80	0.0125000
NODE_7805_length_943_cov_24.992891	556	636	14	6	80	0.0750000
NODE_7805_length_943_cov_24.992891	556	636	15	10	80	0.1250000
NODE_7805_length_943_cov_24.992891	556	636	16	21	80	0.2625000
NODE_7805_length_943_cov_24.992891	556	636	18	30	80	0.3750000
NODE_7805_length_943_cov_24.992891	556	636	20	4	80	0.0500000
NODE_7806_length_943_cov_24.758294	403	483	0	80	80	1.0000000
NODE_7806_length_943_cov_24.758294	456	536	0	80	80	1.0000000
NODE_7807_length_943_cov_22.316351	432	512	0	56	80	0.7000000
NODE_7807_length_943_cov_22.316351	432	512	2	24	80	0.3000000
NODE_7807_length_943_cov_22.316351	485	565	0	3	80	0.0375000
NODE_7807_length_943_cov_22.316351	485	565	2	77	80	0.9625000
NODE_7808_length_943_cov_22.149289	393	473	4	14	80	0.1750000
NODE_7808_length_943_cov_22.149289	393	473	6	66	80	0.8250000
NODE_7808_length_943_cov_22.149289	446	526	0	1	80	0.0125000
NODE_7808_length_943_cov_22.149289	446	526	2	24	80	0.3000000
NODE_7808_length_943_cov_22.149289	446	526	4	36	80	0.4500000
NODE_7808_length_943_cov_22.149289	446	526	6	19	80	0.2375000
NODE_7809_length_943_cov_20.055687	412	492	0	80	80	1.0000000
NODE_7809_length_943_cov_20.055687	465	545	0	80	80	1.0000000
NODE_7810_length_943_cov_16.022512	338	418	0	80	80	1.0000000
NODE_7810_length_943_cov_16.022512	391	471	0	80	80	1.0000000
NODE_7811_length_943_cov_10.939573	474	554	0	80	80	1.0000000
NODE_7811_length_943_cov_10.939573	527	607	0	80	80	1.0000000
NODE_7812_length_943_cov_9.483412	422	502	0	80	80	1.0000000
NODE_7812_length_943_cov_9.483412	475	555	0	80	80	1.0000000
NODE_7830_length_942_cov_58.088968	384	464	2	30	80	0.3750000
NODE_7830_length_942_cov_58.088968	384	464	4	50	80	0.6250000
NODE_7830_length_942_cov_58.088968	437	517	2	79	80	0.9875000
NODE_7830_length_942_cov_58.088968	437	517	4	1	80	0.0125000
NODE_7832_length_942_cov_27.466192	360	440	0	66	80	0.8250000
NODE_7832_length_942_cov_27.466192	360	440	2	14	80	0.1750000
NODE_7832_length_942_cov_27.466192	413	493	0	13	80	0.1625000
NODE_7832_length_942_cov_27.466192	413	493	2	67	80	0.8375000
NODE_7833_length_942_cov_26.914591	346	426	4	9	80	0.1125000
NODE_7833_length_942_cov_26.914591	346	426	6	18	80	0.2250000
NODE_7833_length_942_cov_26.914591	346	426	10	20	80	0.2500000
NODE_7833_length_942_cov_26.914591	346	426	12	33	80	0.4125000
NODE_7833_length_942_cov_26.914591	399	479	4	6	80	0.0750000
NODE_7833_length_942_cov_26.914591	399	479	6	41	80	0.5125000
NODE_7833_length_942_cov_26.914591	399	479	8	3	80	0.0375000
NODE_7833_length_942_cov_26.914591	399	479	10	7	80	0.0875000
NODE_7833_length_942_cov_26.914591	399	479	12	23	80	0.2875000
NODE_7834_length_942_cov_17.911032	390	470	0	9	80	0.1125000
NODE_7834_length_942_cov_17.911032	390	470	2	19	80	0.2375000
NODE_7834_length_942_cov_17.911032	390	470	4	4	80	0.0500000
NODE_7834_length_942_cov_17.911032	390	470	6	36	80	0.4500000
NODE_7834_length_942_cov_17.911032	390	470	8	7	80	0.0875000
NODE_7834_length_942_cov_17.911032	390	470	12	5	80	0.0625000
NODE_7834_length_942_cov_17.911032	443	523	6	15	80	0.1875000
NODE_7834_length_942_cov_17.911032	443	523	8	34	80	0.4250000
NODE_7834_length_942_cov_17.911032	443	523	12	31	80	0.3875000
NODE_7835_length_942_cov_14.695136	442	522	0	80	80	1.0000000
NODE_7835_length_942_cov_14.695136	495	575	0	80	80	1.0000000
NODE_7836_length_942_cov_14.097272	547	627	0	80	80	1.0000000
NODE_7836_length_942_cov_14.097272	600	680	0	80	80	1.0000000
NODE_7837_length_942_cov_13.174377	322	402	0	1	80	0.0125000
NODE_7837_length_942_cov_13.174377	322	402	2	79	80	0.9875000
NODE_7837_length_942_cov_13.174377	375	455	0	54	80	0.6750000
NODE_7837_length_942_cov_13.174377	375	455	2	26	80	0.3250000
NODE_7858_length_941_cov_36.592637	259	339	0	41	80	0.5125000
NODE_7858_length_941_cov_36.592637	259	339	2	39	80	0.4875000
NODE_7858_length_941_cov_36.592637	312	392	0	10	80	0.1250000
NODE_7858_length_941_cov_36.592637	312	392	2	70	80	0.8750000
NODE_7858_length_941_cov_36.592637	388	468	0	80	80	1.0000000
NODE_7858_length_941_cov_36.592637	441	521	0	27	80	0.3375000
NODE_7858_length_941_cov_36.592637	441	521	2	2	80	0.0250000
NODE_7858_length_941_cov_36.592637	441	521	4	51	80	0.6375000
NODE_7859_length_941_cov_35.375297	352	432	2	5	80	0.0625000
NODE_7859_length_941_cov_35.375297	352	432	4	75	80	0.9375000
NODE_7859_length_941_cov_35.375297	405	485	2	19	80	0.2375000
NODE_7859_length_941_cov_35.375297	405	485	3	13	80	0.1625000
NODE_7859_length_941_cov_35.375297	405	485	4	48	80	0.6000000
NODE_7859_length_941_cov_35.375297	481	561	0	58	80	0.7250000
NODE_7859_length_941_cov_35.375297	481	561	2	22	80	0.2750000
NODE_7859_length_941_cov_35.375297	534	614	0	55	80	0.6875000
NODE_7859_length_941_cov_35.375297	534	614	2	25	80	0.3125000
NODE_7860_length_941_cov_32.222090	407	487	0	75	80	0.9375000
NODE_7860_length_941_cov_32.222090	407	487	2	5	80	0.0625000
NODE_7860_length_941_cov_32.222090	460	540	0	23	80	0.2875000
NODE_7860_length_941_cov_32.222090	460	540	2	57	80	0.7125000
NODE_7861_length_941_cov_28.442993	391	471	0	25	80	0.3125000
NODE_7861_length_941_cov_28.442993	391	471	2	41	80	0.5125000
NODE_7861_length_941_cov_28.442993	391	471	4	14	80	0.1750000
NODE_7861_length_941_cov_28.442993	444	524	2	17	80	0.2125000
NODE_7861_length_941_cov_28.442993	444	524	4	63	80	0.7875000
NODE_7862_length_941_cov_20.788599	341	421	0	68	80	0.8500000
NODE_7862_length_941_cov_20.788599	341	421	2	12	80	0.1500000
NODE_7862_length_941_cov_20.788599	394	474	0	15	80	0.1875000
NODE_7862_length_941_cov_20.788599	394	474	2	65	80	0.8125000
NODE_7863_length_941_cov_18.000000	364	444	0	80	80	1.0000000
NODE_7863_length_941_cov_18.000000	417	497	0	80	80	1.0000000
NODE_7864_length_941_cov_11.020190	325	405	0	80	80	1.0000000
NODE_7864_length_941_cov_11.020190	378	458	0	80	80	1.0000000
NODE_7865_length_941_cov_6.020190	260	287	4	1	27	0.0370370
NODE_7865_length_941_cov_6.020190	260	287	5	8	27	0.2962963
NODE_7865_length_941_cov_6.020190	260	287	6	18	27	0.6666667
NODE_7865_length_941_cov_6.020190	260	340	2	14	80	0.1750000
NODE_7865_length_941_cov_6.020190	260	340	4	31	80	0.3875000
NODE_7865_length_941_cov_6.020190	260	340	5	8	80	0.1000000
NODE_7865_length_941_cov_6.020190	260	340	6	27	80	0.3375000
NODE_7867_length_941_cov_3.745843	867	941	2	19	74	0.2567568
NODE_7867_length_941_cov_3.745843	867	941	6	7	74	0.0945946
NODE_7867_length_941_cov_3.745843	867	941	8	22	74	0.2972973
NODE_7867_length_941_cov_3.745843	867	941	10	26	74	0.3513514
NODE_7877_length_940_cov_43.954816	243	323	0	80	80	1.0000000
NODE_7877_length_940_cov_43.954816	296	376	0	80	80	1.0000000
NODE_7877_length_940_cov_43.954816	372	452	0	32	80	0.4000000
NODE_7877_length_940_cov_43.954816	372	452	2	48	80	0.6000000
NODE_7877_length_940_cov_43.954816	425	505	0	5	80	0.0625000
NODE_7877_length_940_cov_43.954816	425	505	2	75	80	0.9375000
NODE_7878_length_940_cov_27.763377	423	503	0	80	80	1.0000000
NODE_7878_length_940_cov_27.763377	476	556	0	80	80	1.0000000
NODE_7897_length_939_cov_58.982143	363	443	4	26	80	0.3250000
NODE_7897_length_939_cov_58.982143	363	443	5	3	80	0.0375000
NODE_7897_length_939_cov_58.982143	363	443	7	2	80	0.0250000
NODE_7897_length_939_cov_58.982143	363	443	8	12	80	0.1500000
NODE_7897_length_939_cov_58.982143	363	443	10	37	80	0.4625000
NODE_7897_length_939_cov_58.982143	416	496	2	20	80	0.2500000
NODE_7897_length_939_cov_58.982143	416	496	4	4	80	0.0500000
NODE_7897_length_939_cov_58.982143	416	496	6	23	80	0.2875000
NODE_7897_length_939_cov_58.982143	416	496	8	18	80	0.2250000
NODE_7897_length_939_cov_58.982143	416	496	10	15	80	0.1875000
NODE_7898_length_939_cov_32.469048	327	407	0	80	80	1.0000000
NODE_7898_length_939_cov_32.469048	380	460	0	56	80	0.7000000
NODE_7898_length_939_cov_32.469048	380	460	6	24	80	0.3000000
NODE_7899_length_939_cov_31.895238	265	345	0	16	80	0.2000000
NODE_7899_length_939_cov_31.895238	265	345	2	64	80	0.8000000
NODE_7899_length_939_cov_31.895238	318	398	2	80	80	1.0000000
NODE_7900_length_939_cov_25.354762	439	519	0	80	80	1.0000000
NODE_7900_length_939_cov_25.354762	492	572	0	36	80	0.4500000
NODE_7900_length_939_cov_25.354762	492	572	2	44	80	0.5500000
NODE_7901_length_939_cov_24.892857	370	450	0	80	80	1.0000000
NODE_7901_length_939_cov_24.892857	423	503	0	80	80	1.0000000
NODE_7902_length_939_cov_24.246429	422	502	2	80	80	1.0000000
NODE_7902_length_939_cov_24.246429	475	555	0	24	80	0.3000000
NODE_7902_length_939_cov_24.246429	475	555	2	56	80	0.7000000
NODE_7902_length_939_cov_24.246429	551	631	2	80	80	1.0000000
NODE_7902_length_939_cov_24.246429	604	684	0	15	80	0.1875000
NODE_7902_length_939_cov_24.246429	604	684	2	65	80	0.8125000
NODE_7903_length_939_cov_21.141667	368	448	0	36	80	0.4500000
NODE_7903_length_939_cov_21.141667	368	448	2	44	80	0.5500000
NODE_7903_length_939_cov_21.141667	421	501	0	17	80	0.2125000
NODE_7903_length_939_cov_21.141667	421	501	2	63	80	0.7875000
NODE_7904_length_939_cov_16.425000	327	407	2	23	80	0.2875000
NODE_7904_length_939_cov_16.425000	327	407	6	1	80	0.0125000
NODE_7904_length_939_cov_16.425000	327	407	10	3	80	0.0375000
NODE_7904_length_939_cov_16.425000	327	407	12	53	80	0.6625000
NODE_7904_length_939_cov_16.425000	380	460	6	7	80	0.0875000
NODE_7904_length_939_cov_16.425000	380	460	8	6	80	0.0750000
NODE_7904_length_939_cov_16.425000	380	460	10	24	80	0.3000000
NODE_7904_length_939_cov_16.425000	380	460	12	43	80	0.5375000
NODE_7905_length_939_cov_13.828571	469	548	0	21	79	0.2658228
NODE_7905_length_939_cov_13.828571	469	548	2	58	79	0.7341772
NODE_7905_length_939_cov_13.828571	522	603	0	33	81	0.4074074
NODE_7905_length_939_cov_13.828571	522	603	2	48	81	0.5925926
NODE_7906_length_939_cov_13.521429	402	482	0	36	80	0.4500000
NODE_7906_length_939_cov_13.521429	402	482	2	44	80	0.5500000
NODE_7906_length_939_cov_13.521429	455	535	0	21	80	0.2625000
NODE_7906_length_939_cov_13.521429	455	535	2	59	80	0.7375000
NODE_7907_length_939_cov_12.955952	398	478	0	27	80	0.3375000
NODE_7907_length_939_cov_12.955952	398	478	1	39	80	0.4875000
NODE_7907_length_939_cov_12.955952	398	478	3	2	80	0.0250000
NODE_7907_length_939_cov_12.955952	398	478	4	12	80	0.1500000
NODE_7907_length_939_cov_12.955952	451	531	1	13	80	0.1625000
NODE_7907_length_939_cov_12.955952	451	531	3	2	80	0.0250000
NODE_7907_length_939_cov_12.955952	451	531	4	29	80	0.3625000
NODE_7907_length_939_cov_12.955952	451	531	6	12	80	0.1500000
NODE_7907_length_939_cov_12.955952	451	531	8	24	80	0.3000000
NODE_7908_length_939_cov_6.564286	523	545	0	22	22	1.0000000
NODE_7922_length_938_cov_44.458880	362	442	0	4	80	0.0500000
NODE_7922_length_938_cov_44.458880	362	442	1	3	80	0.0375000
NODE_7922_length_938_cov_44.458880	362	442	2	38	80	0.4750000
NODE_7922_length_938_cov_44.458880	362	442	4	35	80	0.4375000
NODE_7922_length_938_cov_44.458880	415	495	4	80	80	1.0000000
NODE_7923_length_938_cov_44.435042	748	815	2	9	67	0.1343284
NODE_7923_length_938_cov_44.435042	748	815	4	58	67	0.8656716
NODE_7924_length_938_cov_32.177592	466	546	2	58	80	0.7250000
NODE_7924_length_938_cov_32.177592	466	546	4	22	80	0.2750000
NODE_7924_length_938_cov_32.177592	519	599	2	41	80	0.5125000
NODE_7924_length_938_cov_32.177592	519	599	4	39	80	0.4875000
NODE_7925_length_938_cov_21.139452	474	554	0	80	80	1.0000000
NODE_7925_length_938_cov_21.139452	527	607	0	80	80	1.0000000
NODE_7927_length_938_cov_8.791418	300	380	0	80	80	1.0000000
NODE_7927_length_938_cov_8.791418	353	433	0	80	80	1.0000000
NODE_7932_length_938_cov_2.693683	59	139	0	14	80	0.1750000
NODE_7932_length_938_cov_2.693683	59	139	2	66	80	0.8250000
NODE_7932_length_938_cov_2.693683	112	192	0	67	80	0.8375000
NODE_7932_length_938_cov_2.693683	112	192	2	13	80	0.1625000
NODE_7946_length_937_cov_31.890215	407	487	1	21	80	0.2625000
NODE_7946_length_937_cov_31.890215	407	487	3	17	80	0.2125000
NODE_7946_length_937_cov_31.890215	407	487	4	42	80	0.5250000
NODE_7946_length_937_cov_31.890215	460	536	1	11	76	0.1447368
NODE_7946_length_937_cov_31.890215	460	536	2	29	76	0.3815790
NODE_7946_length_937_cov_31.890215	460	536	4	36	76	0.4736842
NODE_7947_length_937_cov_31.198091	425	505	0	80	80	1.0000000
NODE_7947_length_937_cov_31.198091	478	558	0	79	80	0.9875000
NODE_7947_length_937_cov_31.198091	478	558	2	1	80	0.0125000
NODE_7948_length_937_cov_29.742243	296	376	0	80	80	1.0000000
NODE_7948_length_937_cov_29.742243	349	429	0	80	80	1.0000000
NODE_7948_length_937_cov_29.742243	425	505	0	29	80	0.3625000
NODE_7948_length_937_cov_29.742243	425	505	2	51	80	0.6375000
NODE_7948_length_937_cov_29.742243	478	558	0	4	80	0.0500000
NODE_7948_length_937_cov_29.742243	478	558	2	76	80	0.9500000
NODE_7950_length_937_cov_26.153938	487	567	0	44	80	0.5500000
NODE_7950_length_937_cov_26.153938	487	567	2	36	80	0.4500000
NODE_7950_length_937_cov_26.153938	540	620	0	26	80	0.3250000
NODE_7950_length_937_cov_26.153938	540	620	2	54	80	0.6750000
NODE_7951_length_937_cov_20.898568	515	595	0	80	80	1.0000000
NODE_7951_length_937_cov_20.898568	568	648	0	80	80	1.0000000
NODE_7952_length_937_cov_20.502387	181	261	2	6	80	0.0750000
NODE_7952_length_937_cov_20.502387	181	261	4	74	80	0.9250000
NODE_7952_length_937_cov_20.502387	234	314	0	30	80	0.3750000
NODE_7952_length_937_cov_20.502387	234	314	2	27	80	0.3375000
NODE_7952_length_937_cov_20.502387	234	314	4	23	80	0.2875000
NODE_7952_length_937_cov_20.502387	310	390	0	21	80	0.2625000
NODE_7952_length_937_cov_20.502387	310	390	2	56	80	0.7000000
NODE_7952_length_937_cov_20.502387	310	390	4	3	80	0.0375000
NODE_7952_length_937_cov_20.502387	363	443	2	24	80	0.3000000
NODE_7952_length_937_cov_20.502387	363	443	4	56	80	0.7000000
NODE_7953_length_937_cov_15.219570	526	606	0	80	80	1.0000000
NODE_7953_length_937_cov_15.219570	579	659	0	80	80	1.0000000
NODE_7954_length_937_cov_9.633652	521	601	0	26	80	0.3250000
NODE_7954_length_937_cov_9.633652	521	601	4	32	80	0.4000000
NODE_7954_length_937_cov_9.633652	521	601	6	22	80	0.2750000
NODE_7954_length_937_cov_9.633652	574	654	2	20	80	0.2500000
NODE_7954_length_937_cov_9.633652	574	654	4	5	80	0.0625000
NODE_7954_length_937_cov_9.633652	574	654	6	55	80	0.6875000
NODE_7956_length_937_cov_6.630072	305	385	0	80	80	1.0000000
NODE_7956_length_937_cov_6.630072	358	438	0	32	80	0.4000000
NODE_7956_length_937_cov_6.630072	358	438	2	48	80	0.6000000
NODE_7957_length_937_cov_4.649165	470	550	0	80	80	1.0000000
NODE_7957_length_937_cov_4.649165	523	603	0	80	80	1.0000000
NODE_7969_length_936_cov_57.105137	267	347	0	80	80	1.0000000
NODE_7969_length_936_cov_57.105137	320	400	0	34	80	0.4250000
NODE_7969_length_936_cov_57.105137	320	400	2	40	80	0.5000000
NODE_7969_length_936_cov_57.105137	320	400	6	6	80	0.0750000
NODE_7969_length_936_cov_57.105137	396	476	6	66	80	0.8250000
NODE_7969_length_936_cov_57.105137	396	476	7	4	80	0.0500000
NODE_7969_length_936_cov_57.105137	396	476	8	10	80	0.1250000
NODE_7969_length_936_cov_57.105137	449	529	2	28	80	0.3500000
NODE_7969_length_936_cov_57.105137	449	529	6	52	80	0.6500000
NODE_7970_length_936_cov_39.983274	433	513	12	19	80	0.2375000
NODE_7970_length_936_cov_39.983274	433	513	14	3	80	0.0375000
NODE_7970_length_936_cov_39.983274	433	513	16	29	80	0.3625000
NODE_7970_length_936_cov_39.983274	433	513	18	29	80	0.3625000
NODE_7970_length_936_cov_39.983274	486	566	0	26	80	0.3250000
NODE_7970_length_936_cov_39.983274	486	566	2	16	80	0.2000000
NODE_7970_length_936_cov_39.983274	486	566	4	5	80	0.0625000
NODE_7970_length_936_cov_39.983274	486	566	8	2	80	0.0250000
NODE_7970_length_936_cov_39.983274	486	566	12	17	80	0.2125000
NODE_7970_length_936_cov_39.983274	486	566	14	3	80	0.0375000
NODE_7970_length_936_cov_39.983274	486	566	16	4	80	0.0500000
NODE_7970_length_936_cov_39.983274	486	566	18	7	80	0.0875000
NODE_7971_length_936_cov_22.486260	534	614	0	37	80	0.4625000
NODE_7971_length_936_cov_22.486260	534	614	2	43	80	0.5375000
NODE_7971_length_936_cov_22.486260	587	667	0	7	80	0.0875000
NODE_7971_length_936_cov_22.486260	587	667	2	73	80	0.9125000
NODE_7972_length_936_cov_19.639188	409	489	2	6	80	0.0750000
NODE_7972_length_936_cov_19.639188	409	489	6	74	80	0.9250000
NODE_7972_length_936_cov_19.639188	462	542	5	4	80	0.0500000
NODE_7972_length_936_cov_19.639188	462	542	6	76	80	0.9500000
NODE_7973_length_936_cov_15.083632	322	402	0	12	80	0.1500000
NODE_7973_length_936_cov_15.083632	322	402	1	14	80	0.1750000
NODE_7973_length_936_cov_15.083632	322	402	2	54	80	0.6750000
NODE_7973_length_936_cov_15.083632	375	455	2	80	80	1.0000000
NODE_7974_length_936_cov_13.962963	356	424	8	1	68	0.0147059
NODE_7974_length_936_cov_13.962963	356	424	10	27	68	0.3970588
NODE_7974_length_936_cov_13.962963	356	424	12	5	68	0.0735294
NODE_7974_length_936_cov_13.962963	356	424	14	35	68	0.5147059
NODE_7975_length_936_cov_12.502987	447	527	0	80	80	1.0000000
NODE_7975_length_936_cov_12.502987	500	580	0	80	80	1.0000000
NODE_7976_length_936_cov_12.279570	340	420	0	80	80	1.0000000
NODE_7976_length_936_cov_12.279570	393	473	0	33	80	0.4125000
NODE_7976_length_936_cov_12.279570	393	473	2	47	80	0.5875000
NODE_7977_length_936_cov_7.906810	587	667	0	80	80	1.0000000
NODE_7977_length_936_cov_7.906810	640	720	0	80	80	1.0000000
NODE_7978_length_936_cov_6.845878	322	402	2	80	80	1.0000000
NODE_7978_length_936_cov_6.845878	375	455	0	13	80	0.1625000
NODE_7978_length_936_cov_6.845878	375	455	2	67	80	0.8375000
NODE_7979_length_936_cov_6.434886	556	635	0	43	79	0.5443038
NODE_7979_length_936_cov_6.434886	556	635	2	36	79	0.4556962
NODE_7979_length_936_cov_6.434886	608	688	2	80	80	1.0000000
NODE_7993_length_935_cov_38.209330	57	137	90	2	80	0.0250000
NODE_7993_length_935_cov_38.209330	57	137	92	1	80	0.0125000
NODE_7993_length_935_cov_38.209330	57	137	94	5	80	0.0625000
NODE_7993_length_935_cov_38.209330	57	137	98	2	80	0.0250000
NODE_7993_length_935_cov_38.209330	57	137	100	1	80	0.0125000
NODE_7993_length_935_cov_38.209330	57	137	102	2	80	0.0250000
NODE_7993_length_935_cov_38.209330	57	137	103	2	80	0.0250000
NODE_7993_length_935_cov_38.209330	57	137	105	3	80	0.0375000
NODE_7993_length_935_cov_38.209330	57	137	107	1	80	0.0125000
NODE_7993_length_935_cov_38.209330	57	137	111	1	80	0.0125000
NODE_7993_length_935_cov_38.209330	57	137	117	1	80	0.0125000
NODE_7993_length_935_cov_38.209330	57	137	119	1	80	0.0125000
NODE_7993_length_935_cov_38.209330	57	137	123	1	80	0.0125000
NODE_7993_length_935_cov_38.209330	57	137	125	2	80	0.0250000
NODE_7993_length_935_cov_38.209330	57	137	129	2	80	0.0250000
NODE_7993_length_935_cov_38.209330	57	137	133	2	80	0.0250000
NODE_7993_length_935_cov_38.209330	57	137	135	51	80	0.6375000
NODE_7994_length_935_cov_27.306220	439	519	16	7	80	0.0875000
NODE_7994_length_935_cov_27.306220	439	519	18	4	80	0.0500000
NODE_7994_length_935_cov_27.306220	439	519	20	3	80	0.0375000
NODE_7994_length_935_cov_27.306220	439	519	24	7	80	0.0875000
NODE_7994_length_935_cov_27.306220	439	519	29	18	80	0.2250000
NODE_7994_length_935_cov_27.306220	439	519	31	1	80	0.0125000
NODE_7994_length_935_cov_27.306220	439	519	32	6	80	0.0750000
NODE_7994_length_935_cov_27.306220	439	519	34	1	80	0.0125000
NODE_7994_length_935_cov_27.306220	439	519	36	18	80	0.2250000
NODE_7994_length_935_cov_27.306220	439	519	38	15	80	0.1875000
NODE_7994_length_935_cov_27.306220	492	572	20	11	80	0.1375000
NODE_7994_length_935_cov_27.306220	492	572	21	1	80	0.0125000
NODE_7994_length_935_cov_27.306220	492	572	31	18	80	0.2250000
NODE_7994_length_935_cov_27.306220	492	572	34	8	80	0.1000000
NODE_7994_length_935_cov_27.306220	492	572	36	12	80	0.1500000
NODE_7994_length_935_cov_27.306220	492	572	37	11	80	0.1375000
NODE_7994_length_935_cov_27.306220	492	572	38	19	80	0.2375000
NODE_7995_length_935_cov_26.562201	321	401	0	2	80	0.0250000
NODE_7995_length_935_cov_26.562201	321	401	2	37	80	0.4625000
NODE_7995_length_935_cov_26.562201	321	401	4	41	80	0.5125000
NODE_7995_length_935_cov_26.562201	374	454	2	15	80	0.1875000
NODE_7995_length_935_cov_26.562201	374	454	4	65	80	0.8125000
NODE_7995_length_935_cov_26.562201	450	530	0	15	80	0.1875000
NODE_7995_length_935_cov_26.562201	450	530	2	27	80	0.3375000
NODE_7995_length_935_cov_26.562201	450	530	4	38	80	0.4750000
NODE_7995_length_935_cov_26.562201	503	583	4	80	80	1.0000000
NODE_7996_length_935_cov_25.098086	356	436	4	41	80	0.5125000
NODE_7996_length_935_cov_25.098086	356	436	7	5	80	0.0625000
NODE_7996_length_935_cov_25.098086	356	436	8	34	80	0.4250000
NODE_7996_length_935_cov_25.098086	409	489	3	20	80	0.2500000
NODE_7996_length_935_cov_25.098086	409	489	7	38	80	0.4750000
NODE_7996_length_935_cov_25.098086	409	489	8	22	80	0.2750000
NODE_7997_length_935_cov_24.316986	467	547	6	31	80	0.3875000
NODE_7997_length_935_cov_24.316986	467	547	8	39	80	0.4875000
NODE_7997_length_935_cov_24.316986	467	547	10	10	80	0.1250000
NODE_7997_length_935_cov_24.316986	520	600	4	26	80	0.3250000
NODE_7997_length_935_cov_24.316986	520	600	6	28	80	0.3500000
NODE_7997_length_935_cov_24.316986	520	600	8	16	80	0.2000000
NODE_7997_length_935_cov_24.316986	520	600	10	10	80	0.1250000
NODE_7998_length_935_cov_19.221292	397	477	0	80	80	1.0000000
NODE_7998_length_935_cov_19.221292	450	530	0	80	80	1.0000000
NODE_7999_length_935_cov_15.016746	404	484	0	70	80	0.8750000
NODE_7999_length_935_cov_15.016746	404	484	2	10	80	0.1250000
NODE_7999_length_935_cov_15.016746	457	537	0	36	80	0.4500000
NODE_7999_length_935_cov_15.016746	457	537	2	44	80	0.5500000
NODE_8000_length_935_cov_13.138756	341	421	0	8	80	0.1000000
NODE_8000_length_935_cov_13.138756	341	421	2	37	80	0.4625000
NODE_8000_length_935_cov_13.138756	341	421	4	11	80	0.1375000
NODE_8000_length_935_cov_13.138756	341	421	6	24	80	0.3000000
NODE_8000_length_935_cov_13.138756	394	474	4	3	80	0.0375000
NODE_8000_length_935_cov_13.138756	394	474	6	38	80	0.4750000
NODE_8000_length_935_cov_13.138756	394	474	8	39	80	0.4875000
NODE_8002_length_935_cov_6.485646	512	592	0	80	80	1.0000000
NODE_8002_length_935_cov_6.485646	565	645	0	80	80	1.0000000
NODE_8003_length_935_cov_6.467703	250	330	0	80	80	1.0000000
NODE_8003_length_935_cov_6.467703	303	383	0	80	80	1.0000000
NODE_8004_length_935_cov_6.144737	478	558	0	19	80	0.2375000
NODE_8004_length_935_cov_6.144737	478	558	4	61	80	0.7625000
NODE_8004_length_935_cov_6.144737	531	611	0	33	80	0.4125000
NODE_8004_length_935_cov_6.144737	531	611	4	47	80	0.5875000
NODE_8005_length_935_cov_3.905502	39	119	8	3	80	0.0375000
NODE_8005_length_935_cov_3.905502	39	119	10	1	80	0.0125000
NODE_8005_length_935_cov_3.905502	39	119	12	6	80	0.0750000
NODE_8005_length_935_cov_3.905502	39	119	14	2	80	0.0250000
NODE_8005_length_935_cov_3.905502	39	119	16	30	80	0.3750000
NODE_8005_length_935_cov_3.905502	39	119	18	38	80	0.4750000
NODE_8005_length_935_cov_3.905502	92	166	0	5	74	0.0675676
NODE_8005_length_935_cov_3.905502	92	166	2	12	74	0.1621622
NODE_8005_length_935_cov_3.905502	92	166	3	3	74	0.0405405
NODE_8005_length_935_cov_3.905502	92	166	5	2	74	0.0270270
NODE_8005_length_935_cov_3.905502	92	166	6	6	74	0.0810811
NODE_8005_length_935_cov_3.905502	92	166	8	22	74	0.2972973
NODE_8005_length_935_cov_3.905502	92	166	10	1	74	0.0135135
NODE_8005_length_935_cov_3.905502	92	166	12	6	74	0.0810811
NODE_8005_length_935_cov_3.905502	92	166	14	2	74	0.0270270
NODE_8005_length_935_cov_3.905502	92	166	16	14	74	0.1891892
NODE_8005_length_935_cov_3.905502	92	166	18	1	74	0.0135135
NODE_8028_length_934_cov_22.898204	403	483	0	80	80	1.0000000
NODE_8028_length_934_cov_22.898204	456	536	0	80	80	1.0000000
NODE_8029_length_934_cov_17.746108	246	326	0	26	80	0.3250000
NODE_8029_length_934_cov_17.746108	246	326	2	1	80	0.0125000
NODE_8029_length_934_cov_17.746108	246	326	4	29	80	0.3625000
NODE_8029_length_934_cov_17.746108	246	326	6	3	80	0.0375000
NODE_8029_length_934_cov_17.746108	246	326	8	21	80	0.2625000
NODE_8029_length_934_cov_17.746108	299	379	4	10	80	0.1250000
NODE_8029_length_934_cov_17.746108	299	379	6	10	80	0.1250000
NODE_8029_length_934_cov_17.746108	299	379	8	60	80	0.7500000
NODE_8030_length_934_cov_16.049102	367	447	0	38	80	0.4750000
NODE_8030_length_934_cov_16.049102	367	447	2	42	80	0.5250000
NODE_8030_length_934_cov_16.049102	420	500	2	80	80	1.0000000
NODE_8031_length_934_cov_13.738922	379	459	2	18	80	0.2250000
NODE_8031_length_934_cov_13.738922	379	459	4	15	80	0.1875000
NODE_8031_length_934_cov_13.738922	379	459	6	47	80	0.5875000
NODE_8031_length_934_cov_13.738922	432	459	2	18	27	0.6666667
NODE_8031_length_934_cov_13.738922	432	459	4	2	27	0.0740741
NODE_8031_length_934_cov_13.738922	432	459	6	7	27	0.2592593
NODE_8031_length_934_cov_13.738922	470	512	2	19	42	0.4523810
NODE_8031_length_934_cov_13.738922	470	512	4	23	42	0.5476190
NODE_8032_length_934_cov_9.091018	407	487	0	18	80	0.2250000
NODE_8032_length_934_cov_9.091018	407	487	2	62	80	0.7750000
NODE_8032_length_934_cov_9.091018	460	540	0	29	80	0.3625000
NODE_8032_length_934_cov_9.091018	460	540	2	51	80	0.6375000
NODE_8034_length_934_cov_5.349701	583	663	0	80	80	1.0000000
NODE_8050_length_933_cov_36.557554	462	542	0	70	80	0.8750000
NODE_8050_length_933_cov_36.557554	462	542	1	10	80	0.1250000
NODE_8050_length_933_cov_36.557554	515	595	0	80	80	1.0000000
NODE_8051_length_933_cov_27.645084	476	556	4	18	80	0.2250000
NODE_8051_length_933_cov_27.645084	476	556	6	4	80	0.0500000
NODE_8051_length_933_cov_27.645084	476	556	7	1	80	0.0125000
NODE_8051_length_933_cov_27.645084	476	556	8	57	80	0.7125000
NODE_8051_length_933_cov_27.645084	529	609	0	1	80	0.0125000
NODE_8051_length_933_cov_27.645084	529	609	4	30	80	0.3750000
NODE_8051_length_933_cov_27.645084	529	609	6	26	80	0.3250000
NODE_8051_length_933_cov_27.645084	529	609	7	1	80	0.0125000
NODE_8051_length_933_cov_27.645084	529	609	8	22	80	0.2750000
NODE_8052_length_933_cov_26.749400	611	691	0	36	80	0.4500000
NODE_8052_length_933_cov_26.749400	611	691	2	44	80	0.5500000
NODE_8052_length_933_cov_26.749400	664	744	0	5	80	0.0625000
NODE_8052_length_933_cov_26.749400	664	744	2	75	80	0.9375000
NODE_8053_length_933_cov_26.308153	430	510	0	80	80	1.0000000
NODE_8053_length_933_cov_26.308153	483	563	0	80	80	1.0000000
NODE_8054_length_933_cov_19.966427	444	530	2	4	86	0.0465116
NODE_8054_length_933_cov_19.966427	444	530	4	32	86	0.3720930
NODE_8054_length_933_cov_19.966427	444	530	6	29	86	0.3372093
NODE_8054_length_933_cov_19.966427	444	530	8	21	86	0.2441860
NODE_8054_length_933_cov_19.966427	497	583	0	16	86	0.1860465
NODE_8054_length_933_cov_19.966427	497	583	4	33	86	0.3837209
NODE_8054_length_933_cov_19.966427	497	583	6	33	86	0.3837209
NODE_8054_length_933_cov_19.966427	497	583	8	4	86	0.0465116
NODE_8055_length_933_cov_16.870504	284	364	2	40	80	0.5000000
NODE_8055_length_933_cov_16.870504	284	364	4	30	80	0.3750000
NODE_8055_length_933_cov_16.870504	284	364	6	10	80	0.1250000
NODE_8055_length_933_cov_16.870504	337	415	2	65	78	0.8333333
NODE_8055_length_933_cov_16.870504	337	415	4	13	78	0.1666667
NODE_8056_length_933_cov_16.699041	366	446	0	80	80	1.0000000
NODE_8056_length_933_cov_16.699041	419	499	0	80	80	1.0000000
NODE_8057_length_933_cov_11.171463	197	277	1	30	80	0.3750000
NODE_8057_length_933_cov_11.171463	197	277	2	50	80	0.6250000
NODE_8057_length_933_cov_11.171463	250	330	1	6	80	0.0750000
NODE_8057_length_933_cov_11.171463	250	330	2	74	80	0.9250000
NODE_8073_length_932_cov_26.656663	397	477	0	25	80	0.3125000
NODE_8073_length_932_cov_26.656663	397	477	2	55	80	0.6875000
NODE_8073_length_932_cov_26.656663	450	530	0	31	80	0.3875000
NODE_8073_length_932_cov_26.656663	450	530	2	49	80	0.6125000
NODE_8074_length_932_cov_16.581032	407	485	0	13	78	0.1666667
NODE_8074_length_932_cov_16.581032	407	485	2	34	78	0.4358974
NODE_8074_length_932_cov_16.581032	407	485	3	31	78	0.3974359
NODE_8074_length_932_cov_16.581032	460	538	0	55	78	0.7051282
NODE_8074_length_932_cov_16.581032	460	538	1	11	78	0.1410256
NODE_8074_length_932_cov_16.581032	460	538	2	12	78	0.1538462
NODE_8075_length_932_cov_13.462185	413	493	0	43	80	0.5375000
NODE_8075_length_932_cov_13.462185	413	493	2	37	80	0.4625000
NODE_8075_length_932_cov_13.462185	466	546	2	80	80	1.0000000
NODE_8076_length_932_cov_13.442977	386	466	0	10	80	0.1250000
NODE_8076_length_932_cov_13.442977	386	466	2	70	80	0.8750000
NODE_8076_length_932_cov_13.442977	439	519	0	51	80	0.6375000
NODE_8076_length_932_cov_13.442977	439	519	2	29	80	0.3625000
NODE_8077_length_932_cov_11.947179	344	424	0	80	80	1.0000000
NODE_8077_length_932_cov_11.947179	397	477	0	80	80	1.0000000
NODE_8079_length_932_cov_10.849940	409	489	0	43	80	0.5375000
NODE_8079_length_932_cov_10.849940	409	489	2	37	80	0.4625000
NODE_8079_length_932_cov_10.849940	462	542	2	80	80	1.0000000
NODE_8080_length_932_cov_10.174070	342	422	0	80	80	1.0000000
NODE_8080_length_932_cov_10.174070	395	475	0	80	80	1.0000000
NODE_8082_length_932_cov_9.200480	184	264	0	80	80	1.0000000
NODE_8082_length_932_cov_9.200480	237	317	0	80	80	1.0000000
NODE_8090_length_932_cov_2.689076	598	676	2	8	78	0.1025641
NODE_8090_length_932_cov_2.689076	598	676	3	12	78	0.1538462
NODE_8090_length_932_cov_2.689076	598	676	4	35	78	0.4487180
NODE_8090_length_932_cov_2.689076	598	676	5	23	78	0.2948718
NODE_8090_length_932_cov_2.689076	798	845	0	7	47	0.1489362
NODE_8090_length_932_cov_2.689076	798	845	2	40	47	0.8510638
NODE_8103_length_931_cov_51.451923	320	400	0	80	80	1.0000000
NODE_8103_length_931_cov_51.451923	373	453	0	80	80	1.0000000
NODE_8104_length_931_cov_46.621394	527	607	4	16	80	0.2000000
NODE_8104_length_931_cov_46.621394	527	607	5	6	80	0.0750000
NODE_8104_length_931_cov_46.621394	527	607	6	54	80	0.6750000
NODE_8104_length_931_cov_46.621394	527	607	7	4	80	0.0500000
NODE_8104_length_931_cov_46.621394	580	660	0	20	80	0.2500000
NODE_8104_length_931_cov_46.621394	580	660	4	47	80	0.5875000
NODE_8104_length_931_cov_46.621394	580	660	6	13	80	0.1625000
NODE_8105_length_931_cov_36.334135	347	427	0	28	80	0.3500000
NODE_8105_length_931_cov_36.334135	347	427	2	52	80	0.6500000
NODE_8105_length_931_cov_36.334135	400	480	0	80	80	1.0000000
NODE_8106_length_931_cov_32.495192	482	562	0	2	80	0.0250000
NODE_8106_length_931_cov_32.495192	482	562	4	78	80	0.9750000
NODE_8106_length_931_cov_32.495192	535	617	0	57	82	0.6951219
NODE_8106_length_931_cov_32.495192	535	617	4	25	82	0.3048781
NODE_8107_length_931_cov_22.100962	375	455	25	11	80	0.1375000
NODE_8107_length_931_cov_22.100962	375	455	26	7	80	0.0875000
NODE_8107_length_931_cov_22.100962	375	455	27	5	80	0.0625000
NODE_8107_length_931_cov_22.100962	375	455	28	7	80	0.0875000
NODE_8107_length_931_cov_22.100962	375	455	29	39	80	0.4875000
NODE_8107_length_931_cov_22.100962	375	455	30	11	80	0.1375000
NODE_8107_length_931_cov_22.100962	428	508	0	22	80	0.2750000
NODE_8107_length_931_cov_22.100962	428	508	2	6	80	0.0750000
NODE_8107_length_931_cov_22.100962	428	508	11	4	80	0.0500000
NODE_8107_length_931_cov_22.100962	428	508	16	7	80	0.0875000
NODE_8107_length_931_cov_22.100962	428	508	20	3	80	0.0375000
NODE_8107_length_931_cov_22.100962	428	508	24	3	80	0.0375000
NODE_8107_length_931_cov_22.100962	428	508	25	19	80	0.2375000
NODE_8107_length_931_cov_22.100962	428	508	27	5	80	0.0625000
NODE_8107_length_931_cov_22.100962	428	508	28	5	80	0.0625000
NODE_8107_length_931_cov_22.100962	428	508	29	6	80	0.0750000
NODE_8108_length_931_cov_21.781250	347	427	0	69	80	0.8625000
NODE_8108_length_931_cov_21.781250	347	427	4	11	80	0.1375000
NODE_8108_length_931_cov_21.781250	400	480	0	16	80	0.2000000
NODE_8108_length_931_cov_21.781250	400	480	4	64	80	0.8000000
NODE_8109_length_931_cov_19.084135	411	491	0	80	80	1.0000000
NODE_8109_length_931_cov_19.084135	464	544	0	80	80	1.0000000
NODE_8110_length_931_cov_14.879808	444	524	2	11	80	0.1375000
NODE_8110_length_931_cov_14.879808	444	524	4	40	80	0.5000000
NODE_8110_length_931_cov_14.879808	444	524	6	29	80	0.3625000
NODE_8110_length_931_cov_14.879808	497	577	0	38	80	0.4750000
NODE_8110_length_931_cov_14.879808	497	577	2	26	80	0.3250000
NODE_8110_length_931_cov_14.879808	497	577	4	16	80	0.2000000
NODE_8111_length_931_cov_13.087740	759	800	6	3	41	0.0731707
NODE_8111_length_931_cov_13.087740	759	800	8	1	41	0.0243902
NODE_8111_length_931_cov_13.087740	759	800	10	21	41	0.5121951
NODE_8111_length_931_cov_13.087740	759	800	14	15	41	0.3658537
NODE_8111_length_931_cov_13.087740	759	800	16	1	41	0.0243902
NODE_8112_length_931_cov_10.534856	399	479	0	30	80	0.3750000
NODE_8112_length_931_cov_10.534856	399	479	2	50	80	0.6250000
NODE_8112_length_931_cov_10.534856	452	532	0	80	80	1.0000000
NODE_8113_length_931_cov_9.865385	236	316	0	80	80	1.0000000
NODE_8113_length_931_cov_9.865385	289	369	0	80	80	1.0000000
NODE_8115_length_931_cov_6.201923	479	559	6	10	80	0.1250000
NODE_8115_length_931_cov_6.201923	479	559	8	16	80	0.2000000
NODE_8115_length_931_cov_6.201923	479	559	10	26	80	0.3250000
NODE_8115_length_931_cov_6.201923	479	559	12	28	80	0.3500000
NODE_8115_length_931_cov_6.201923	532	612	0	32	80	0.4000000
NODE_8115_length_931_cov_6.201923	532	612	2	1	80	0.0125000
NODE_8115_length_931_cov_6.201923	532	612	4	20	80	0.2500000
NODE_8115_length_931_cov_6.201923	532	612	6	10	80	0.1250000
NODE_8115_length_931_cov_6.201923	532	612	8	5	80	0.0625000
NODE_8115_length_931_cov_6.201923	532	612	10	12	80	0.1500000
NODE_8124_length_931_cov_1.780048	832	902	0	70	70	1.0000000
NODE_8126_length_931_cov_1.433894	220	284	12	6	64	0.0937500
NODE_8126_length_931_cov_1.433894	220	284	14	3	64	0.0468750
NODE_8126_length_931_cov_1.433894	220	284	16	2	64	0.0312500
NODE_8126_length_931_cov_1.433894	220	284	17	8	64	0.1250000
NODE_8126_length_931_cov_1.433894	220	284	19	5	64	0.0781250
NODE_8126_length_931_cov_1.433894	220	284	21	17	64	0.2656250
NODE_8126_length_931_cov_1.433894	220	284	23	8	64	0.1250000
NODE_8126_length_931_cov_1.433894	220	284	25	14	64	0.2187500
NODE_8126_length_931_cov_1.433894	220	284	27	1	64	0.0156250
NODE_8131_length_930_cov_49.052948	252	332	0	13	80	0.1625000
NODE_8131_length_930_cov_49.052948	252	332	2	8	80	0.1000000
NODE_8131_length_930_cov_49.052948	252	332	4	59	80	0.7375000
NODE_8131_length_930_cov_49.052948	305	385	0	66	80	0.8250000
NODE_8131_length_930_cov_49.052948	305	385	2	8	80	0.1000000
NODE_8131_length_930_cov_49.052948	305	385	4	6	80	0.0750000
NODE_8131_length_930_cov_49.052948	381	462	0	78	81	0.9629630
NODE_8131_length_930_cov_49.052948	381	462	2	3	81	0.0370370
NODE_8131_length_930_cov_49.052948	435	515	0	24	80	0.3000000
NODE_8131_length_930_cov_49.052948	435	515	2	56	80	0.7000000
NODE_8132_length_930_cov_31.510229	400	482	2	64	82	0.7804878
NODE_8132_length_930_cov_31.510229	400	482	6	18	82	0.2195122
NODE_8132_length_930_cov_31.510229	453	535	2	11	82	0.1341463
NODE_8132_length_930_cov_31.510229	453	535	4	53	82	0.6463414
NODE_8132_length_930_cov_31.510229	453	535	6	18	82	0.2195122
NODE_8133_length_930_cov_29.139591	329	409	0	41	80	0.5125000
NODE_8133_length_930_cov_29.139591	329	409	1	39	80	0.4875000
NODE_8133_length_930_cov_29.139591	382	462	1	52	80	0.6500000
NODE_8133_length_930_cov_29.139591	382	462	3	28	80	0.3500000
NODE_8134_length_930_cov_24.787004	518	598	0	7	80	0.0875000
NODE_8134_length_930_cov_24.787004	518	598	2	34	80	0.4250000
NODE_8134_length_930_cov_24.787004	518	598	4	23	80	0.2875000
NODE_8134_length_930_cov_24.787004	518	598	6	16	80	0.2000000
NODE_8134_length_930_cov_24.787004	571	651	2	10	80	0.1250000
NODE_8134_length_930_cov_24.787004	571	651	4	43	80	0.5375000
NODE_8134_length_930_cov_24.787004	571	651	6	27	80	0.3375000
NODE_8135_length_930_cov_24.608905	300	380	4	25	80	0.3125000
NODE_8135_length_930_cov_24.608905	300	380	5	1	80	0.0125000
NODE_8135_length_930_cov_24.608905	300	380	7	25	80	0.3125000
NODE_8135_length_930_cov_24.608905	300	380	8	10	80	0.1250000
NODE_8135_length_930_cov_24.608905	300	380	9	1	80	0.0125000
NODE_8135_length_930_cov_24.608905	300	380	10	18	80	0.2250000
NODE_8135_length_930_cov_24.608905	353	433	6	30	80	0.3750000
NODE_8135_length_930_cov_24.608905	353	433	8	33	80	0.4125000
NODE_8135_length_930_cov_24.608905	353	433	10	17	80	0.2125000
NODE_8136_length_930_cov_16.494585	482	562	4	17	80	0.2125000
NODE_8136_length_930_cov_16.494585	482	562	6	3	80	0.0375000
NODE_8136_length_930_cov_16.494585	482	562	8	60	80	0.7500000
NODE_8136_length_930_cov_16.494585	535	615	0	4	80	0.0500000
NODE_8136_length_930_cov_16.494585	535	615	2	2	80	0.0250000
NODE_8136_length_930_cov_16.494585	535	615	6	23	80	0.2875000
NODE_8136_length_930_cov_16.494585	535	615	8	51	80	0.6375000
NODE_8137_length_930_cov_13.296029	249	329	0	18	80	0.2250000
NODE_8137_length_930_cov_13.296029	249	329	1	6	80	0.0750000
NODE_8137_length_930_cov_13.296029	249	329	2	56	80	0.7000000
NODE_8137_length_930_cov_13.296029	302	382	0	20	80	0.2500000
NODE_8137_length_930_cov_13.296029	302	382	2	60	80	0.7500000
NODE_8137_length_930_cov_13.296029	378	458	0	80	80	1.0000000
NODE_8137_length_930_cov_13.296029	431	511	0	80	80	1.0000000
NODE_8138_length_930_cov_11.758123	463	543	2	30	80	0.3750000
NODE_8138_length_930_cov_11.758123	463	543	4	50	80	0.6250000
NODE_8138_length_930_cov_11.758123	516	596	2	2	80	0.0250000
NODE_8138_length_930_cov_11.758123	516	596	4	60	80	0.7500000
NODE_8138_length_930_cov_11.758123	516	596	6	18	80	0.2250000
NODE_8139_length_930_cov_7.576414	531	611	0	80	80	1.0000000
NODE_8139_length_930_cov_7.576414	584	664	0	80	80	1.0000000
NODE_8156_length_930_cov_0.821901	676	736	0	60	60	1.0000000
NODE_8157_length_929_cov_54.485542	313	393	6	12	80	0.1500000
NODE_8157_length_929_cov_54.485542	313	393	7	1	80	0.0125000
NODE_8157_length_929_cov_54.485542	313	393	8	50	80	0.6250000
NODE_8157_length_929_cov_54.485542	313	393	10	17	80	0.2125000
NODE_8157_length_929_cov_54.485542	366	446	2	15	80	0.1875000
NODE_8157_length_929_cov_54.485542	366	446	6	7	80	0.0875000
NODE_8157_length_929_cov_54.485542	366	446	8	57	80	0.7125000
NODE_8157_length_929_cov_54.485542	366	446	10	1	80	0.0125000
NODE_8157_length_929_cov_54.485542	442	522	0	68	80	0.8500000
NODE_8157_length_929_cov_54.485542	442	522	2	12	80	0.1500000
NODE_8157_length_929_cov_54.485542	495	575	0	80	80	1.0000000
NODE_8158_length_929_cov_49.865060	429	509	0	57	80	0.7125000
NODE_8158_length_929_cov_49.865060	429	509	2	14	80	0.1750000
NODE_8158_length_929_cov_49.865060	429	509	4	9	80	0.1125000
NODE_8158_length_929_cov_49.865060	482	562	0	4	80	0.0500000
NODE_8158_length_929_cov_49.865060	482	562	2	14	80	0.1750000
NODE_8158_length_929_cov_49.865060	482	562	4	62	80	0.7750000
NODE_8159_length_929_cov_34.634940	358	438	0	20	80	0.2500000
NODE_8159_length_929_cov_34.634940	358	438	2	60	80	0.7500000
NODE_8159_length_929_cov_34.634940	411	491	0	73	80	0.9125000
NODE_8159_length_929_cov_34.634940	411	491	2	7	80	0.0875000
NODE_8161_length_929_cov_20.815663	365	445	0	80	80	1.0000000
NODE_8161_length_929_cov_20.815663	418	498	0	80	80	1.0000000
NODE_8162_length_929_cov_17.798795	376	456	0	80	80	1.0000000
NODE_8162_length_929_cov_17.798795	429	509	0	80	80	1.0000000
NODE_8163_length_929_cov_16.622892	331	408	0	77	77	1.0000000
NODE_8163_length_929_cov_16.622892	381	461	0	80	80	1.0000000
NODE_8163_length_929_cov_16.622892	457	537	0	61	80	0.7625000
NODE_8163_length_929_cov_16.622892	457	537	2	19	80	0.2375000
NODE_8163_length_929_cov_16.622892	510	590	0	25	80	0.3125000
NODE_8163_length_929_cov_16.622892	510	590	2	55	80	0.6875000
NODE_8164_length_929_cov_15.242169	302	382	4	80	80	1.0000000
NODE_8164_length_929_cov_15.242169	355	435	0	10	80	0.1250000
NODE_8164_length_929_cov_15.242169	355	435	2	41	80	0.5125000
NODE_8164_length_929_cov_15.242169	355	435	4	29	80	0.3625000
NODE_8164_length_929_cov_15.242169	431	511	0	32	80	0.4000000
NODE_8164_length_929_cov_15.242169	431	511	2	44	80	0.5500000
NODE_8164_length_929_cov_15.242169	431	511	4	4	80	0.0500000
NODE_8164_length_929_cov_15.242169	484	564	2	23	80	0.2875000
NODE_8164_length_929_cov_15.242169	484	564	4	50	80	0.6250000
NODE_8164_length_929_cov_15.242169	484	564	6	7	80	0.0875000
NODE_8165_length_929_cov_13.197590	259	339	0	36	80	0.4500000
NODE_8165_length_929_cov_13.197590	259	339	2	20	80	0.2500000
NODE_8165_length_929_cov_13.197590	259	339	4	11	80	0.1375000
NODE_8165_length_929_cov_13.197590	259	339	6	13	80	0.1625000
NODE_8165_length_929_cov_13.197590	312	392	2	3	80	0.0375000
NODE_8165_length_929_cov_13.197590	312	392	4	21	80	0.2625000
NODE_8165_length_929_cov_13.197590	312	392	6	56	80	0.7000000
NODE_8167_length_929_cov_7.766265	385	465	0	80	80	1.0000000
NODE_8167_length_929_cov_7.766265	438	518	0	80	80	1.0000000
NODE_8168_length_929_cov_5.750602	382	462	0	80	80	1.0000000
NODE_8168_length_929_cov_5.750602	435	515	0	80	80	1.0000000
NODE_8181_length_928_cov_35.226779	273	353	2	80	80	1.0000000
NODE_8181_length_928_cov_35.226779	326	406	0	42	80	0.5250000
NODE_8181_length_928_cov_35.226779	326	406	2	38	80	0.4750000
NODE_8181_length_928_cov_35.226779	402	482	0	13	80	0.1625000
NODE_8181_length_928_cov_35.226779	402	482	2	67	80	0.8375000
NODE_8181_length_928_cov_35.226779	455	535	0	5	80	0.0625000
NODE_8181_length_928_cov_35.226779	455	535	2	75	80	0.9375000
NODE_8182_length_928_cov_25.218335	299	379	0	80	80	1.0000000
NODE_8182_length_928_cov_25.218335	352	432	0	80	80	1.0000000
NODE_8183_length_928_cov_22.815440	342	422	0	52	80	0.6500000
NODE_8183_length_928_cov_22.815440	342	422	2	28	80	0.3500000
NODE_8183_length_928_cov_22.815440	395	475	2	36	80	0.4500000
NODE_8183_length_928_cov_22.815440	395	475	4	44	80	0.5500000
NODE_8183_length_928_cov_22.815440	471	551	4	22	80	0.2750000
NODE_8183_length_928_cov_22.815440	471	551	6	9	80	0.1125000
NODE_8183_length_928_cov_22.815440	471	551	8	16	80	0.2000000
NODE_8183_length_928_cov_22.815440	471	551	9	1	80	0.0125000
NODE_8183_length_928_cov_22.815440	471	551	10	32	80	0.4000000
NODE_8183_length_928_cov_22.815440	524	604	2	18	80	0.2250000
NODE_8183_length_928_cov_22.815440	524	604	4	13	80	0.1625000
NODE_8183_length_928_cov_22.815440	524	604	6	6	80	0.0750000
NODE_8183_length_928_cov_22.815440	524	604	8	23	80	0.2875000
NODE_8183_length_928_cov_22.815440	524	604	9	1	80	0.0125000
NODE_8183_length_928_cov_22.815440	524	604	10	19	80	0.2375000
NODE_8184_length_928_cov_20.718938	365	445	1	14	80	0.1750000
NODE_8184_length_928_cov_20.718938	365	445	2	38	80	0.4750000
NODE_8184_length_928_cov_20.718938	365	445	4	12	80	0.1500000
NODE_8184_length_928_cov_20.718938	365	445	6	16	80	0.2000000
NODE_8184_length_928_cov_20.718938	418	498	4	11	80	0.1375000
NODE_8184_length_928_cov_20.718938	418	498	5	6	80	0.0750000
NODE_8184_length_928_cov_20.718938	418	498	6	63	80	0.7875000
NODE_8185_length_928_cov_19.418577	420	500	0	23	80	0.2875000
NODE_8185_length_928_cov_19.418577	420	500	2	11	80	0.1375000
NODE_8185_length_928_cov_19.418577	420	500	6	24	80	0.3000000
NODE_8185_length_928_cov_19.418577	420	500	7	22	80	0.2750000
NODE_8185_length_928_cov_19.418577	473	553	0	10	80	0.1250000
NODE_8185_length_928_cov_19.418577	473	553	5	39	80	0.4875000
NODE_8185_length_928_cov_19.418577	473	553	6	5	80	0.0625000
NODE_8185_length_928_cov_19.418577	473	553	7	26	80	0.3250000
NODE_8185_length_928_cov_19.418577	549	591	0	42	42	1.0000000
NODE_8186_length_928_cov_13.354644	323	403	2	35	80	0.4375000
NODE_8186_length_928_cov_13.354644	323	403	4	45	80	0.5625000
NODE_8186_length_928_cov_13.354644	376	456	2	32	80	0.4000000
NODE_8186_length_928_cov_13.354644	376	456	4	46	80	0.5750000
NODE_8186_length_928_cov_13.354644	376	456	6	2	80	0.0250000
NODE_8187_length_928_cov_13.096502	361	441	0	4	80	0.0500000
NODE_8187_length_928_cov_13.096502	361	441	1	76	80	0.9500000
NODE_8187_length_928_cov_13.096502	414	494	0	57	80	0.7125000
NODE_8187_length_928_cov_13.096502	414	494	1	23	80	0.2875000
NODE_8189_length_928_cov_10.399276	447	527	0	80	80	1.0000000
NODE_8189_length_928_cov_10.399276	500	580	0	80	80	1.0000000
NODE_8207_length_927_cov_19.516908	398	478	0	80	80	1.0000000
NODE_8207_length_927_cov_19.516908	451	531	0	80	80	1.0000000
NODE_8208_length_927_cov_11.190821	358	438	4	80	80	1.0000000
NODE_8208_length_927_cov_11.190821	411	491	0	36	80	0.4500000
NODE_8208_length_927_cov_11.190821	411	491	4	44	80	0.5500000
NODE_8209_length_927_cov_8.123188	239	319	0	25	80	0.3125000
NODE_8209_length_927_cov_8.123188	239	319	2	55	80	0.6875000
NODE_8209_length_927_cov_8.123188	292	372	0	30	80	0.3750000
NODE_8209_length_927_cov_8.123188	292	372	2	50	80	0.6250000
NODE_8210_length_927_cov_4.585749	515	595	0	55	80	0.6875000
NODE_8210_length_927_cov_4.585749	515	595	2	25	80	0.3125000
NODE_8210_length_927_cov_4.585749	568	648	0	80	80	1.0000000
NODE_8222_length_927_cov_1.250000	626	706	0	80	80	1.0000000
NODE_8222_length_927_cov_1.250000	679	759	0	80	80	1.0000000
NODE_8227_length_926_cov_78.382104	433	513	9	15	80	0.1875000
NODE_8227_length_926_cov_78.382104	433	513	13	14	80	0.1750000
NODE_8227_length_926_cov_78.382104	433	513	15	1	80	0.0125000
NODE_8227_length_926_cov_78.382104	433	513	17	15	80	0.1875000
NODE_8227_length_926_cov_78.382104	433	513	19	24	80	0.3000000
NODE_8227_length_926_cov_78.382104	433	513	21	11	80	0.1375000
NODE_8227_length_926_cov_78.382104	486	566	2	1	80	0.0125000
NODE_8227_length_926_cov_78.382104	486	566	4	1	80	0.0125000
NODE_8227_length_926_cov_78.382104	486	566	6	36	80	0.4500000
NODE_8227_length_926_cov_78.382104	486	566	10	1	80	0.0125000
NODE_8227_length_926_cov_78.382104	486	566	12	5	80	0.0625000
NODE_8227_length_926_cov_78.382104	486	566	18	4	80	0.0500000
NODE_8227_length_926_cov_78.382104	486	566	19	26	80	0.3250000
NODE_8227_length_926_cov_78.382104	486	566	21	6	80	0.0750000
NODE_8228_length_926_cov_44.385732	383	463	0	80	80	1.0000000
NODE_8228_length_926_cov_44.385732	436	516	0	80	80	1.0000000
NODE_8229_length_926_cov_43.446191	362	442	0	25	80	0.3125000
NODE_8229_length_926_cov_43.446191	362	442	1	1	80	0.0125000
NODE_8229_length_926_cov_43.446191	362	442	2	54	80	0.6750000
NODE_8229_length_926_cov_43.446191	415	495	0	25	80	0.3125000
NODE_8229_length_926_cov_43.446191	415	495	1	49	80	0.6125000
NODE_8229_length_926_cov_43.446191	415	495	2	6	80	0.0750000
NODE_8229_length_926_cov_43.446191	491	571	2	80	80	1.0000000
NODE_8229_length_926_cov_43.446191	544	624	1	33	80	0.4125000
NODE_8229_length_926_cov_43.446191	544	624	2	47	80	0.5875000
NODE_8230_length_926_cov_40.163241	42	61	0	19	19	1.0000000
NODE_8230_length_926_cov_40.163241	279	359	0	8	80	0.1000000
NODE_8230_length_926_cov_40.163241	279	359	4	72	80	0.9000000
NODE_8230_length_926_cov_40.163241	332	412	0	16	80	0.2000000
NODE_8230_length_926_cov_40.163241	332	412	2	2	80	0.0250000
NODE_8230_length_926_cov_40.163241	332	412	4	62	80	0.7750000
NODE_8230_length_926_cov_40.163241	408	488	0	2	80	0.0250000
NODE_8230_length_926_cov_40.163241	408	488	2	33	80	0.4125000
NODE_8230_length_926_cov_40.163241	408	488	6	45	80	0.5625000
NODE_8230_length_926_cov_40.163241	461	541	0	33	80	0.4125000
NODE_8230_length_926_cov_40.163241	461	541	4	8	80	0.1000000
NODE_8230_length_926_cov_40.163241	461	541	6	39	80	0.4875000
NODE_8231_length_926_cov_29.923821	372	452	0	12	80	0.1500000
NODE_8231_length_926_cov_29.923821	372	452	8	26	80	0.3250000
NODE_8231_length_926_cov_29.923821	372	452	11	1	80	0.0125000
NODE_8231_length_926_cov_29.923821	372	452	12	41	80	0.5125000
NODE_8231_length_926_cov_29.923821	425	505	4	10	80	0.1250000
NODE_8231_length_926_cov_29.923821	425	505	6	29	80	0.3625000
NODE_8231_length_926_cov_29.923821	425	505	8	6	80	0.0750000
NODE_8231_length_926_cov_29.923821	425	505	12	35	80	0.4375000
NODE_8232_length_926_cov_24.657799	350	430	0	27	80	0.3375000
NODE_8232_length_926_cov_24.657799	350	430	2	22	80	0.2750000
NODE_8232_length_926_cov_24.657799	350	430	6	31	80	0.3875000
NODE_8232_length_926_cov_24.657799	403	483	6	32	80	0.4000000
NODE_8232_length_926_cov_24.657799	403	483	10	48	80	0.6000000
NODE_8233_length_926_cov_17.438936	360	440	0	65	80	0.8125000
NODE_8233_length_926_cov_17.438936	360	440	2	15	80	0.1875000
NODE_8233_length_926_cov_17.438936	413	493	0	12	80	0.1500000
NODE_8233_length_926_cov_17.438936	413	493	2	68	80	0.8500000
NODE_8234_length_926_cov_12.413543	418	491	0	2	73	0.0273973
NODE_8234_length_926_cov_12.413543	418	491	2	15	73	0.2054795
NODE_8234_length_926_cov_12.413543	418	491	4	25	73	0.3424658
NODE_8234_length_926_cov_12.413543	418	491	6	31	73	0.4246575
NODE_8234_length_926_cov_12.413543	464	544	2	5	80	0.0625000
NODE_8234_length_926_cov_12.413543	464	544	4	21	80	0.2625000
NODE_8234_length_926_cov_12.413543	464	544	6	54	80	0.6750000
NODE_8235_length_926_cov_5.771463	453	533	0	12	80	0.1500000
NODE_8235_length_926_cov_5.771463	453	533	3	1	80	0.0125000
NODE_8235_length_926_cov_5.771463	453	533	4	67	80	0.8375000
NODE_8235_length_926_cov_5.771463	505	586	0	1	81	0.0123457
NODE_8235_length_926_cov_5.771463	505	586	3	42	81	0.5185185
NODE_8235_length_926_cov_5.771463	505	586	4	38	81	0.4691358
NODE_8236_length_926_cov_5.209190	435	515	0	80	80	1.0000000
NODE_8236_length_926_cov_5.209190	488	568	0	80	80	1.0000000
NODE_8247_length_925_cov_40.767554	514	594	2	34	80	0.4250000
NODE_8247_length_925_cov_40.767554	514	594	6	46	80	0.5750000
NODE_8247_length_925_cov_40.767554	567	647	4	8	80	0.1000000
NODE_8247_length_925_cov_40.767554	567	647	6	54	80	0.6750000
NODE_8247_length_925_cov_40.767554	567	647	8	18	80	0.2250000
NODE_8248_length_925_cov_30.226392	262	342	0	80	80	1.0000000
NODE_8248_length_925_cov_30.226392	315	395	0	80	80	1.0000000
NODE_8248_length_925_cov_30.226392	391	471	0	80	80	1.0000000
NODE_8248_length_925_cov_30.226392	444	524	0	80	80	1.0000000
NODE_8249_length_925_cov_22.075061	334	414	0	18	80	0.2250000
NODE_8249_length_925_cov_22.075061	334	414	2	44	80	0.5500000
NODE_8249_length_925_cov_22.075061	334	414	4	18	80	0.2250000
NODE_8249_length_925_cov_22.075061	387	467	0	10	80	0.1250000
NODE_8249_length_925_cov_22.075061	387	467	2	43	80	0.5375000
NODE_8249_length_925_cov_22.075061	387	467	4	27	80	0.3375000
NODE_8250_length_925_cov_18.164649	410	490	0	80	80	1.0000000
NODE_8250_length_925_cov_18.164649	464	543	0	75	79	0.9493671
NODE_8250_length_925_cov_18.164649	464	543	2	4	79	0.0506329
NODE_8251_length_925_cov_14.067797	472	548	2	11	76	0.1447368
NODE_8251_length_925_cov_14.067797	472	548	3	9	76	0.1184211
NODE_8251_length_925_cov_14.067797	472	548	4	21	76	0.2763158
NODE_8251_length_925_cov_14.067797	472	548	6	35	76	0.4605263
NODE_8251_length_925_cov_14.067797	525	601	4	3	76	0.0394737
NODE_8251_length_925_cov_14.067797	525	601	6	73	76	0.9605263
NODE_8252_length_925_cov_7.098063	418	498	0	22	80	0.2750000
NODE_8252_length_925_cov_7.098063	418	498	2	58	80	0.7250000
NODE_8252_length_925_cov_7.098063	471	551	0	33	80	0.4125000
NODE_8252_length_925_cov_7.098063	471	551	2	47	80	0.5875000
NODE_8266_length_924_cov_61.292121	397	477	0	33	80	0.4125000
NODE_8266_length_924_cov_61.292121	397	477	2	21	80	0.2625000
NODE_8266_length_924_cov_61.292121	397	477	4	19	80	0.2375000
NODE_8266_length_924_cov_61.292121	397	477	6	7	80	0.0875000
NODE_8266_length_924_cov_61.292121	450	530	2	1	80	0.0125000
NODE_8266_length_924_cov_61.292121	450	530	4	19	80	0.2375000
NODE_8266_length_924_cov_61.292121	450	530	6	60	80	0.7500000
NODE_8267_length_924_cov_31.522424	375	455	0	80	80	1.0000000
NODE_8267_length_924_cov_31.522424	428	508	0	80	80	1.0000000
NODE_8268_length_924_cov_30.446061	299	379	0	80	80	1.0000000
NODE_8268_length_924_cov_30.446061	352	432	0	80	80	1.0000000
NODE_8268_length_924_cov_30.446061	428	508	0	6	80	0.0750000
NODE_8268_length_924_cov_30.446061	428	508	2	29	80	0.3625000
NODE_8268_length_924_cov_30.446061	428	508	4	45	80	0.5625000
NODE_8268_length_924_cov_30.446061	481	561	4	80	80	1.0000000
NODE_8269_length_924_cov_28.877576	542	622	0	33	80	0.4125000
NODE_8269_length_924_cov_28.877576	542	622	2	47	80	0.5875000
NODE_8269_length_924_cov_28.877576	595	675	0	80	80	1.0000000
NODE_8270_length_924_cov_27.261818	506	586	0	15	80	0.1875000
NODE_8270_length_924_cov_27.261818	506	586	2	65	80	0.8125000
NODE_8270_length_924_cov_27.261818	559	639	0	8	80	0.1000000
NODE_8270_length_924_cov_27.261818	559	639	2	54	80	0.6750000
NODE_8270_length_924_cov_27.261818	559	639	16	18	80	0.2250000
NODE_8271_length_924_cov_25.946667	371	451	0	15	80	0.1875000
NODE_8271_length_924_cov_25.946667	371	451	2	5	80	0.0625000
NODE_8271_length_924_cov_25.946667	371	451	8	60	80	0.7500000
NODE_8271_length_924_cov_25.946667	424	504	8	80	80	1.0000000
NODE_8271_length_924_cov_25.946667	500	580	0	49	80	0.6125000
NODE_8271_length_924_cov_25.946667	500	580	1	6	80	0.0750000
NODE_8271_length_924_cov_25.946667	500	580	6	11	80	0.1375000
NODE_8271_length_924_cov_25.946667	500	580	8	14	80	0.1750000
NODE_8271_length_924_cov_25.946667	553	633	0	21	80	0.2625000
NODE_8271_length_924_cov_25.946667	553	633	1	10	80	0.1250000
NODE_8271_length_924_cov_25.946667	553	633	2	49	80	0.6125000
NODE_8272_length_924_cov_25.113939	305	385	0	80	80	1.0000000
NODE_8272_length_924_cov_25.113939	358	438	0	80	80	1.0000000
NODE_8272_length_924_cov_25.113939	434	514	0	80	80	1.0000000
NODE_8272_length_924_cov_25.113939	487	567	0	80	80	1.0000000
NODE_8273_length_924_cov_16.343030	481	561	0	80	80	1.0000000
NODE_8273_length_924_cov_16.343030	534	614	0	62	80	0.7750000
NODE_8273_length_924_cov_16.343030	534	614	2	18	80	0.2250000
NODE_8274_length_924_cov_14.793939	299	379	0	67	80	0.8375000
NODE_8274_length_924_cov_14.793939	299	379	2	13	80	0.1625000
NODE_8274_length_924_cov_14.793939	352	432	0	14	80	0.1750000
NODE_8274_length_924_cov_14.793939	352	432	2	66	80	0.8250000
NODE_8275_length_924_cov_14.209697	485	562	0	8	77	0.1038961
NODE_8275_length_924_cov_14.209697	485	562	2	35	77	0.4545455
NODE_8275_length_924_cov_14.209697	485	562	4	34	77	0.4415585
NODE_8275_length_924_cov_14.209697	535	615	0	3	80	0.0375000
NODE_8275_length_924_cov_14.209697	535	615	2	48	80	0.6000000
NODE_8275_length_924_cov_14.209697	535	615	4	29	80	0.3625000
NODE_8276_length_924_cov_13.423030	287	367	0	80	80	1.0000000
NODE_8276_length_924_cov_13.423030	340	420	0	80	80	1.0000000
NODE_8277_length_924_cov_12.008485	237	307	0	17	70	0.2428571
NODE_8277_length_924_cov_12.008485	237	307	2	53	70	0.7571428
NODE_8279_length_924_cov_8.619394	560	640	0	80	80	1.0000000
NODE_8279_length_924_cov_8.619394	613	693	0	80	80	1.0000000
NODE_8280_length_924_cov_4.640000	426	506	0	22	80	0.2750000
NODE_8280_length_924_cov_4.640000	426	506	2	58	80	0.7250000
NODE_8280_length_924_cov_4.640000	479	559	2	80	80	1.0000000
NODE_8290_length_924_cov_1.467879	352	381	0	29	29	1.0000000
NODE_8296_length_924_cov_0.648485	830	890	1	28	60	0.4666667
NODE_8296_length_924_cov_0.648485	830	890	2	32	60	0.5333334
NODE_8296_length_924_cov_0.648485	863	924	0	26	61	0.4262295
NODE_8296_length_924_cov_0.648485	863	924	1	35	61	0.5737705
NODE_8297_length_923_cov_43.213592	371	451	0	48	80	0.6000000
NODE_8297_length_923_cov_43.213592	371	451	2	32	80	0.4000000
NODE_8297_length_923_cov_43.213592	424	504	0	13	80	0.1625000
NODE_8297_length_923_cov_43.213592	424	504	2	67	80	0.8375000
NODE_8297_length_923_cov_43.213592	500	580	0	36	80	0.4500000
NODE_8297_length_923_cov_43.213592	500	580	4	44	80	0.5500000
NODE_8297_length_923_cov_43.213592	553	633	0	14	80	0.1750000
NODE_8297_length_923_cov_43.213592	553	633	4	66	80	0.8250000
NODE_8298_length_923_cov_34.108010	370	450	0	13	80	0.1625000
NODE_8298_length_923_cov_34.108010	370	450	2	13	80	0.1625000
NODE_8298_length_923_cov_34.108010	370	450	4	54	80	0.6750000
NODE_8298_length_923_cov_34.108010	423	503	4	80	80	1.0000000
NODE_8299_length_923_cov_29.163835	392	472	0	80	80	1.0000000
NODE_8299_length_923_cov_29.163835	445	525	0	80	80	1.0000000
NODE_8300_length_923_cov_19.139563	375	455	0	75	80	0.9375000
NODE_8300_length_923_cov_19.139563	375	455	2	5	80	0.0625000
NODE_8300_length_923_cov_19.139563	428	508	0	22	80	0.2750000
NODE_8300_length_923_cov_19.139563	428	508	2	58	80	0.7250000
NODE_8301_length_923_cov_17.433252	512	592	0	80	80	1.0000000
NODE_8301_length_923_cov_17.433252	565	645	0	80	80	1.0000000
NODE_8302_length_923_cov_16.597087	279	359	4	50	80	0.6250000
NODE_8302_length_923_cov_16.597087	279	359	6	30	80	0.3750000
NODE_8302_length_923_cov_16.597087	332	412	0	31	80	0.3875000
NODE_8302_length_923_cov_16.597087	332	412	2	9	80	0.1125000
NODE_8302_length_923_cov_16.597087	332	412	4	40	80	0.5000000
NODE_8303_length_923_cov_15.229369	446	526	0	43	80	0.5375000
NODE_8303_length_923_cov_15.229369	446	526	2	37	80	0.4625000
NODE_8303_length_923_cov_15.229369	499	579	0	80	80	1.0000000
NODE_8304_length_923_cov_14.007282	304	349	0	43	45	0.9555556
NODE_8304_length_923_cov_14.007282	304	349	2	2	45	0.0444444
NODE_8304_length_923_cov_14.007282	345	427	0	82	82	1.0000000
NODE_8304_length_923_cov_14.007282	397	480	0	83	83	1.0000000
NODE_8305_length_923_cov_6.500000	308	388	0	23	80	0.2875000
NODE_8305_length_923_cov_6.500000	308	388	2	57	80	0.7125000
NODE_8305_length_923_cov_6.500000	361	441	2	80	80	1.0000000
NODE_8307_length_923_cov_6.115291	447	527	0	11	80	0.1375000
NODE_8307_length_923_cov_6.115291	447	527	2	69	80	0.8625000
NODE_8307_length_923_cov_6.115291	500	580	0	33	80	0.4125000
NODE_8307_length_923_cov_6.115291	500	580	2	47	80	0.5875000
NODE_8308_length_923_cov_5.351942	363	445	0	5	82	0.0609756
NODE_8308_length_923_cov_5.351942	363	445	4	77	82	0.9390244
NODE_8308_length_923_cov_5.351942	365	445	0	3	80	0.0375000
NODE_8308_length_923_cov_5.351942	365	445	4	77	80	0.9625000
NODE_8317_length_923_cov_1.059466	63	143	0	27	80	0.3375000
NODE_8317_length_923_cov_1.059466	63	143	2	37	80	0.4625000
NODE_8317_length_923_cov_1.059466	63	143	4	16	80	0.2000000
NODE_8320_length_922_cov_40.331713	243	289	36	1	46	0.0217391
NODE_8320_length_922_cov_40.331713	243	289	38	3	46	0.0652174
NODE_8320_length_922_cov_40.331713	243	289	40	1	46	0.0217391
NODE_8320_length_922_cov_40.331713	243	289	41	1	46	0.0217391
NODE_8320_length_922_cov_40.331713	243	289	42	2	46	0.0434783
NODE_8320_length_922_cov_40.331713	243	289	43	2	46	0.0434783
NODE_8320_length_922_cov_40.331713	243	289	45	3	46	0.0652174
NODE_8320_length_922_cov_40.331713	243	289	46	4	46	0.0869565
NODE_8320_length_922_cov_40.331713	243	289	47	1	46	0.0217391
NODE_8320_length_922_cov_40.331713	243	289	48	4	46	0.0869565
NODE_8320_length_922_cov_40.331713	243	289	50	2	46	0.0434783
NODE_8320_length_922_cov_40.331713	243	289	52	1	46	0.0217391
NODE_8320_length_922_cov_40.331713	243	289	54	1	46	0.0217391
NODE_8320_length_922_cov_40.331713	243	289	56	1	46	0.0217391
NODE_8320_length_922_cov_40.331713	243	289	57	2	46	0.0434783
NODE_8320_length_922_cov_40.331713	243	289	58	2	46	0.0434783
NODE_8320_length_922_cov_40.331713	243	289	59	1	46	0.0217391
NODE_8320_length_922_cov_40.331713	243	289	61	1	46	0.0217391
NODE_8320_length_922_cov_40.331713	243	289	65	1	46	0.0217391
NODE_8320_length_922_cov_40.331713	243	289	68	2	46	0.0434783
NODE_8320_length_922_cov_40.331713	243	289	70	1	46	0.0217391
NODE_8320_length_922_cov_40.331713	243	289	73	1	46	0.0217391
NODE_8320_length_922_cov_40.331713	243	289	76	2	46	0.0434783
NODE_8320_length_922_cov_40.331713	243	289	81	2	46	0.0434783
NODE_8320_length_922_cov_40.331713	243	289	85	4	46	0.0869565
NODE_8320_length_922_cov_40.331713	262	342	36	1	80	0.0125000
NODE_8320_length_922_cov_40.331713	262	342	38	5	80	0.0625000
NODE_8320_length_922_cov_40.331713	262	342	40	2	80	0.0250000
NODE_8320_length_922_cov_40.331713	262	342	41	1	80	0.0125000
NODE_8320_length_922_cov_40.331713	262	342	42	3	80	0.0375000
NODE_8320_length_922_cov_40.331713	262	342	43	2	80	0.0250000
NODE_8320_length_922_cov_40.331713	262	342	45	3	80	0.0375000
NODE_8320_length_922_cov_40.331713	262	342	46	6	80	0.0750000
NODE_8320_length_922_cov_40.331713	262	342	47	1	80	0.0125000
NODE_8320_length_922_cov_40.331713	262	342	48	4	80	0.0500000
NODE_8320_length_922_cov_40.331713	262	342	50	2	80	0.0250000
NODE_8320_length_922_cov_40.331713	262	342	52	2	80	0.0250000
NODE_8320_length_922_cov_40.331713	262	342	54	2	80	0.0250000
NODE_8320_length_922_cov_40.331713	262	342	56	1	80	0.0125000
NODE_8320_length_922_cov_40.331713	262	342	62	1	80	0.0125000
NODE_8320_length_922_cov_40.331713	262	342	64	3	80	0.0375000
NODE_8320_length_922_cov_40.331713	262	342	69	1	80	0.0125000
NODE_8320_length_922_cov_40.331713	262	342	72	1	80	0.0125000
NODE_8320_length_922_cov_40.331713	262	342	74	3	80	0.0375000
NODE_8320_length_922_cov_40.331713	262	342	76	1	80	0.0125000
NODE_8320_length_922_cov_40.331713	262	342	83	2	80	0.0250000
NODE_8320_length_922_cov_40.331713	262	342	90	1	80	0.0125000
NODE_8320_length_922_cov_40.331713	262	342	91	1	80	0.0125000
NODE_8320_length_922_cov_40.331713	262	342	95	1	80	0.0125000
NODE_8320_length_922_cov_40.331713	262	342	98	1	80	0.0125000
NODE_8320_length_922_cov_40.331713	262	342	104	1	80	0.0125000
NODE_8320_length_922_cov_40.331713	262	342	108	1	80	0.0125000
NODE_8320_length_922_cov_40.331713	262	342	110	1	80	0.0125000
NODE_8320_length_922_cov_40.331713	262	342	118	1	80	0.0125000
NODE_8320_length_922_cov_40.331713	262	342	131	1	80	0.0125000
NODE_8320_length_922_cov_40.331713	262	342	132	1	80	0.0125000
NODE_8320_length_922_cov_40.331713	262	342	145	1	80	0.0125000
NODE_8320_length_922_cov_40.331713	262	342	155	1	80	0.0125000
NODE_8320_length_922_cov_40.331713	262	342	165	1	80	0.0125000
NODE_8320_length_922_cov_40.331713	262	342	169	1	80	0.0125000
NODE_8320_length_922_cov_40.331713	262	342	174	1	80	0.0125000
NODE_8320_length_922_cov_40.331713	262	342	178	1	80	0.0125000
NODE_8320_length_922_cov_40.331713	262	342	182	1	80	0.0125000
NODE_8320_length_922_cov_40.331713	262	342	186	1	80	0.0125000
NODE_8320_length_922_cov_40.331713	262	342	192	1	80	0.0125000
NODE_8320_length_922_cov_40.331713	262	342	200	1	80	0.0125000
NODE_8320_length_922_cov_40.331713	262	342	202	1	80	0.0125000
NODE_8320_length_922_cov_40.331713	262	342	210	1	80	0.0125000
NODE_8320_length_922_cov_40.331713	262	342	212	2	80	0.0250000
NODE_8320_length_922_cov_40.331713	262	342	214	2	80	0.0250000
NODE_8320_length_922_cov_40.331713	262	342	222	1	80	0.0125000
NODE_8320_length_922_cov_40.331713	262	342	229	1	80	0.0125000
NODE_8320_length_922_cov_40.331713	262	342	237	1	80	0.0125000
NODE_8320_length_922_cov_40.331713	262	342	250	1	80	0.0125000
NODE_8320_length_922_cov_40.331713	262	342	272	1	80	0.0125000
NODE_8320_length_922_cov_40.331713	262	342	284	1	80	0.0125000
NODE_8320_length_922_cov_40.331713	262	342	301	1	80	0.0125000
NODE_8320_length_922_cov_40.331713	780	860	4	13	80	0.1625000
NODE_8320_length_922_cov_40.331713	780	860	6	31	80	0.3875000
NODE_8320_length_922_cov_40.331713	780	860	8	36	80	0.4500000
NODE_8320_length_922_cov_40.331713	833	913	0	37	80	0.4625000
NODE_8320_length_922_cov_40.331713	833	913	2	2	80	0.0250000
NODE_8320_length_922_cov_40.331713	833	913	4	27	80	0.3375000
NODE_8320_length_922_cov_40.331713	833	913	6	14	80	0.1750000
NODE_8321_length_922_cov_38.549210	126	177	93	1	51	0.0196078
NODE_8321_length_922_cov_38.549210	126	177	99	1	51	0.0196078
NODE_8321_length_922_cov_38.549210	126	177	105	1	51	0.0196078
NODE_8321_length_922_cov_38.549210	126	177	117	1	51	0.0196078
NODE_8321_length_922_cov_38.549210	126	177	124	1	51	0.0196078
NODE_8321_length_922_cov_38.549210	126	177	126	1	51	0.0196078
NODE_8321_length_922_cov_38.549210	126	177	127	1	51	0.0196078
NODE_8321_length_922_cov_38.549210	126	177	134	1	51	0.0196078
NODE_8321_length_922_cov_38.549210	126	177	139	1	51	0.0196078
NODE_8321_length_922_cov_38.549210	126	177	145	1	51	0.0196078
NODE_8321_length_922_cov_38.549210	126	177	147	1	51	0.0196078
NODE_8321_length_922_cov_38.549210	126	177	149	2	51	0.0392157
NODE_8321_length_922_cov_38.549210	126	177	159	1	51	0.0196078
NODE_8321_length_922_cov_38.549210	126	177	164	1	51	0.0196078
NODE_8321_length_922_cov_38.549210	126	177	170	2	51	0.0392157
NODE_8321_length_922_cov_38.549210	126	177	172	1	51	0.0196078
NODE_8321_length_922_cov_38.549210	126	177	174	1	51	0.0196078
NODE_8321_length_922_cov_38.549210	126	177	183	1	51	0.0196078
NODE_8321_length_922_cov_38.549210	126	177	187	1	51	0.0196078
NODE_8321_length_922_cov_38.549210	126	177	188	1	51	0.0196078
NODE_8321_length_922_cov_38.549210	126	177	192	1	51	0.0196078
NODE_8321_length_922_cov_38.549210	126	177	195	1	51	0.0196078
NODE_8321_length_922_cov_38.549210	126	177	197	1	51	0.0196078
NODE_8321_length_922_cov_38.549210	126	177	201	4	51	0.0784314
NODE_8321_length_922_cov_38.549210	126	177	213	1	51	0.0196078
NODE_8321_length_922_cov_38.549210	126	177	215	1	51	0.0196078
NODE_8321_length_922_cov_38.549210	126	177	217	1	51	0.0196078
NODE_8321_length_922_cov_38.549210	126	177	218	1	51	0.0196078
NODE_8321_length_922_cov_38.549210	126	177	224	1	51	0.0196078
NODE_8321_length_922_cov_38.549210	126	177	229	1	51	0.0196078
NODE_8321_length_922_cov_38.549210	126	177	230	2	51	0.0392157
NODE_8321_length_922_cov_38.549210	126	177	236	2	51	0.0392157
NODE_8321_length_922_cov_38.549210	126	177	238	3	51	0.0588235
NODE_8321_length_922_cov_38.549210	126	177	241	1	51	0.0196078
NODE_8321_length_922_cov_38.549210	126	177	250	1	51	0.0196078
NODE_8321_length_922_cov_38.549210	126	177	255	1	51	0.0196078
NODE_8321_length_922_cov_38.549210	126	177	256	2	51	0.0392157
NODE_8321_length_922_cov_38.549210	126	177	268	1	51	0.0196078
NODE_8321_length_922_cov_38.549210	126	177	270	1	51	0.0196078
NODE_8321_length_922_cov_38.549210	126	177	279	1	51	0.0196078
NODE_8321_length_922_cov_38.549210	126	177	284	1	51	0.0196078
NODE_8321_length_922_cov_38.549210	308	383	0	75	75	1.0000000
NODE_8321_length_922_cov_38.549210	356	393	0	37	37	1.0000000
NODE_8321_length_922_cov_38.549210	818	898	2	80	80	1.0000000
NODE_8321_length_922_cov_38.549210	871	908	2	37	37	1.0000000
NODE_8322_length_922_cov_35.041312	385	465	2	80	80	1.0000000
NODE_8322_length_922_cov_35.041312	438	518	0	37	80	0.4625000
NODE_8322_length_922_cov_35.041312	438	518	2	43	80	0.5375000
NODE_8323_length_922_cov_30.749696	426	506	5	13	80	0.1625000
NODE_8323_length_922_cov_30.749696	426	506	7	1	80	0.0125000
NODE_8323_length_922_cov_30.749696	426	506	8	1	80	0.0125000
NODE_8323_length_922_cov_30.749696	426	506	10	7	80	0.0875000
NODE_8323_length_922_cov_30.749696	426	506	11	28	80	0.3500000
NODE_8323_length_922_cov_30.749696	426	506	12	30	80	0.3750000
NODE_8323_length_922_cov_30.749696	479	559	5	2	80	0.0250000
NODE_8323_length_922_cov_30.749696	479	559	6	22	80	0.2750000
NODE_8323_length_922_cov_30.749696	479	559	7	2	80	0.0250000
NODE_8323_length_922_cov_30.749696	479	559	8	5	80	0.0625000
NODE_8323_length_922_cov_30.749696	479	559	9	2	80	0.0250000
NODE_8323_length_922_cov_30.749696	479	559	10	15	80	0.1875000
NODE_8323_length_922_cov_30.749696	479	559	12	32	80	0.4000000
NODE_8324_length_922_cov_25.558931	291	370	2	70	79	0.8860760
NODE_8324_length_922_cov_25.558931	291	370	4	9	79	0.1139240
NODE_8324_length_922_cov_25.558931	344	423	0	11	79	0.1392405
NODE_8324_length_922_cov_25.558931	344	423	2	68	79	0.8607595
NODE_8325_length_922_cov_25.527339	391	471	0	80	80	1.0000000
NODE_8325_length_922_cov_25.527339	444	524	0	80	80	1.0000000
NODE_8326_length_922_cov_23.630620	224	304	2	80	80	1.0000000
NODE_8326_length_922_cov_23.630620	277	357	0	53	80	0.6625000
NODE_8326_length_922_cov_23.630620	277	357	2	27	80	0.3375000
NODE_8326_length_922_cov_23.630620	353	433	0	23	80	0.2875000
NODE_8326_length_922_cov_23.630620	353	433	4	57	80	0.7125000
NODE_8326_length_922_cov_23.630620	406	486	0	17	80	0.2125000
NODE_8326_length_922_cov_23.630620	406	486	4	63	80	0.7875000
NODE_8327_length_922_cov_22.388821	465	545	0	80	80	1.0000000
NODE_8327_length_922_cov_22.388821	518	598	0	80	80	1.0000000
NODE_8328_length_922_cov_20.320778	421	501	0	35	80	0.4375000
NODE_8328_length_922_cov_20.320778	421	501	2	45	80	0.5625000
NODE_8328_length_922_cov_20.320778	474	554	2	80	80	1.0000000
NODE_8329_length_922_cov_17.645200	413	479	6	44	66	0.6666667
NODE_8329_length_922_cov_17.645200	413	479	8	22	66	0.3333333
NODE_8330_length_922_cov_12.574727	454	534	0	25	80	0.3125000
NODE_8330_length_922_cov_12.574727	454	534	4	9	80	0.1125000
NODE_8330_length_922_cov_12.574727	454	534	6	46	80	0.5750000
NODE_8330_length_922_cov_12.574727	507	587	4	8	80	0.1000000
NODE_8330_length_922_cov_12.574727	507	587	6	29	80	0.3625000
NODE_8330_length_922_cov_12.574727	507	587	7	1	80	0.0125000
NODE_8330_length_922_cov_12.574727	507	587	8	19	80	0.2375000
NODE_8330_length_922_cov_12.574727	507	587	10	23	80	0.2875000
NODE_8331_length_922_cov_11.934386	255	335	2	71	80	0.8875000
NODE_8331_length_922_cov_11.934386	255	335	4	9	80	0.1125000
NODE_8331_length_922_cov_11.934386	308	388	0	20	80	0.2500000
NODE_8331_length_922_cov_11.934386	308	388	2	60	80	0.7500000
NODE_8332_length_922_cov_11.068044	423	503	0	80	80	1.0000000
NODE_8332_length_922_cov_11.068044	476	557	0	81	81	1.0000000
NODE_8333_length_922_cov_7.907655	441	521	0	44	80	0.5500000
NODE_8333_length_922_cov_7.907655	441	521	2	36	80	0.4500000
NODE_8333_length_922_cov_7.907655	494	574	0	80	80	1.0000000
NODE_8334_length_922_cov_7.737546	463	543	2	42	80	0.5250000
NODE_8334_length_922_cov_7.737546	463	543	4	38	80	0.4750000
NODE_8334_length_922_cov_7.737546	516	596	0	21	80	0.2625000
NODE_8334_length_922_cov_7.737546	516	596	2	11	80	0.1375000
NODE_8334_length_922_cov_7.737546	516	596	4	48	80	0.6000000
NODE_8335_length_922_cov_7.241798	298	378	0	53	80	0.6625000
NODE_8335_length_922_cov_7.241798	298	378	2	27	80	0.3375000
NODE_8335_length_922_cov_7.241798	351	431	0	80	80	1.0000000
NODE_8347_length_921_cov_21.317518	457	537	0	80	80	1.0000000
NODE_8347_length_921_cov_21.317518	510	590	0	80	80	1.0000000
NODE_8348_length_921_cov_18.462287	519	599	0	29	80	0.3625000
NODE_8348_length_921_cov_18.462287	519	599	2	51	80	0.6375000
NODE_8348_length_921_cov_18.462287	572	652	2	80	80	1.0000000
NODE_8349_length_921_cov_15.440389	373	453	0	25	80	0.3125000
NODE_8349_length_921_cov_15.440389	373	453	2	31	80	0.3875000
NODE_8349_length_921_cov_15.440389	373	453	4	24	80	0.3000000
NODE_8349_length_921_cov_15.440389	426	506	2	4	80	0.0500000
NODE_8349_length_921_cov_15.440389	426	506	4	76	80	0.9500000
NODE_8350_length_921_cov_13.216545	465	545	0	80	80	1.0000000
NODE_8350_length_921_cov_13.216545	518	598	0	80	80	1.0000000
NODE_8351_length_921_cov_9.283455	399	439	0	37	40	0.9250000
NODE_8351_length_921_cov_9.283455	399	439	2	3	40	0.0750000
NODE_8351_length_921_cov_9.283455	532	612	0	2	80	0.0250000
NODE_8351_length_921_cov_9.283455	532	612	2	30	80	0.3750000
NODE_8351_length_921_cov_9.283455	532	612	5	1	80	0.0125000
NODE_8351_length_921_cov_9.283455	532	612	6	46	80	0.5750000
NODE_8351_length_921_cov_9.283455	532	612	8	1	80	0.0125000
NODE_8351_length_921_cov_9.283455	585	665	0	55	80	0.6875000
NODE_8351_length_921_cov_9.283455	585	665	2	25	80	0.3125000
NODE_8352_length_921_cov_8.253041	289	369	0	21	80	0.2625000
NODE_8352_length_921_cov_8.253041	289	369	2	59	80	0.7375000
NODE_8352_length_921_cov_8.253041	342	422	0	74	80	0.9250000
NODE_8352_length_921_cov_8.253041	342	422	2	6	80	0.0750000
NODE_8364_length_920_cov_47.493301	543	623	0	80	80	1.0000000
NODE_8364_length_920_cov_47.493301	596	676	0	80	80	1.0000000
NODE_8365_length_920_cov_30.404385	543	623	0	18	80	0.2250000
NODE_8365_length_920_cov_30.404385	543	623	2	62	80	0.7750000
NODE_8365_length_920_cov_30.404385	596	676	0	15	80	0.1875000
NODE_8365_length_920_cov_30.404385	596	676	2	65	80	0.8125000
NODE_8366_length_920_cov_25.360536	413	493	2	1	80	0.0125000
NODE_8366_length_920_cov_25.360536	413	493	5	56	80	0.7000000
NODE_8366_length_920_cov_25.360536	413	493	9	23	80	0.2875000
NODE_8366_length_920_cov_25.360536	466	546	0	44	80	0.5500000
NODE_8366_length_920_cov_25.360536	466	546	2	10	80	0.1250000
NODE_8366_length_920_cov_25.360536	466	546	5	26	80	0.3250000
NODE_8366_length_920_cov_25.360536	542	615	0	47	73	0.6438356
NODE_8366_length_920_cov_25.360536	542	615	4	1	73	0.0136986
NODE_8366_length_920_cov_25.360536	542	615	6	25	73	0.3424658
NODE_8366_length_920_cov_25.360536	588	668	0	1	80	0.0125000
NODE_8366_length_920_cov_25.360536	588	668	4	1	80	0.0125000
NODE_8366_length_920_cov_25.360536	588	668	6	78	80	0.9750000
NODE_8367_length_920_cov_24.918392	403	483	1	80	80	1.0000000
NODE_8367_length_920_cov_24.918392	456	536	1	80	80	1.0000000
NODE_8368_length_920_cov_18.517661	353	433	0	80	80	1.0000000
NODE_8368_length_920_cov_18.517661	406	486	0	34	80	0.4250000
NODE_8368_length_920_cov_18.517661	406	486	2	46	80	0.5750000
NODE_8369_length_920_cov_17.710110	310	390	4	35	80	0.4375000
NODE_8369_length_920_cov_17.710110	310	390	6	7	80	0.0875000
NODE_8369_length_920_cov_17.710110	310	390	8	38	80	0.4750000
NODE_8369_length_920_cov_17.710110	363	443	0	3	80	0.0375000
NODE_8369_length_920_cov_17.710110	363	443	2	47	80	0.5875000
NODE_8369_length_920_cov_17.710110	363	443	4	8	80	0.1000000
NODE_8369_length_920_cov_17.710110	363	443	6	2	80	0.0250000
NODE_8369_length_920_cov_17.710110	363	443	8	20	80	0.2500000
NODE_8370_length_920_cov_15.650426	403	458	0	55	55	1.0000000
NODE_8371_length_920_cov_12.588307	454	534	2	80	80	1.0000000
NODE_8371_length_920_cov_12.588307	507	586	0	43	79	0.5443038
NODE_8371_length_920_cov_12.588307	507	586	2	36	79	0.4556962
NODE_8372_length_920_cov_10.822168	354	434	0	80	80	1.0000000
NODE_8372_length_920_cov_10.822168	407	487	0	80	80	1.0000000
NODE_8374_length_920_cov_8.297199	453	533	4	54	80	0.6750000
NODE_8374_length_920_cov_8.297199	453	533	6	26	80	0.3250000
NODE_8374_length_920_cov_8.297199	506	583	0	37	77	0.4805195
NODE_8374_length_920_cov_8.297199	506	583	2	9	77	0.1168831
NODE_8374_length_920_cov_8.297199	506	583	4	31	77	0.4025974
NODE_8378_length_920_cov_2.992692	501	581	0	17	80	0.2125000
NODE_8378_length_920_cov_2.992692	501	581	1	63	80	0.7875000
NODE_8378_length_920_cov_2.992692	554	634	0	17	80	0.2125000
NODE_8378_length_920_cov_2.992692	554	634	1	63	80	0.7875000
NODE_8389_length_919_cov_44.813415	338	418	6	8	80	0.1000000
NODE_8389_length_919_cov_44.813415	338	418	8	13	80	0.1625000
NODE_8389_length_919_cov_44.813415	338	418	12	1	80	0.0125000
NODE_8389_length_919_cov_44.813415	338	418	14	32	80	0.4000000
NODE_8389_length_919_cov_44.813415	338	418	16	11	80	0.1375000
NODE_8389_length_919_cov_44.813415	338	418	18	15	80	0.1875000
NODE_8389_length_919_cov_44.813415	391	471	0	2	80	0.0250000
NODE_8389_length_919_cov_44.813415	391	471	2	6	80	0.0750000
NODE_8389_length_919_cov_44.813415	391	471	6	16	80	0.2000000
NODE_8389_length_919_cov_44.813415	391	471	8	13	80	0.1625000
NODE_8389_length_919_cov_44.813415	391	471	10	8	80	0.1000000
NODE_8389_length_919_cov_44.813415	391	471	12	5	80	0.0625000
NODE_8389_length_919_cov_44.813415	391	471	14	24	80	0.3000000
NODE_8389_length_919_cov_44.813415	391	471	18	6	80	0.0750000
NODE_8389_length_919_cov_44.813415	467	547	0	2	80	0.0250000
NODE_8389_length_919_cov_44.813415	467	547	2	78	80	0.9750000
NODE_8389_length_919_cov_44.813415	520	600	0	23	80	0.2875000
NODE_8389_length_919_cov_44.813415	520	600	2	57	80	0.7125000
NODE_8390_length_919_cov_37.459756	389	469	0	26	80	0.3250000
NODE_8390_length_919_cov_37.459756	389	469	4	43	80	0.5375000
NODE_8390_length_919_cov_37.459756	389	469	6	11	80	0.1375000
NODE_8390_length_919_cov_37.459756	442	522	0	79	80	0.9875000
NODE_8390_length_919_cov_37.459756	442	522	4	1	80	0.0125000
NODE_8390_length_919_cov_37.459756	518	598	0	80	80	1.0000000
NODE_8390_length_919_cov_37.459756	571	651	0	58	80	0.7250000
NODE_8390_length_919_cov_37.459756	571	651	2	22	80	0.2750000
NODE_8391_length_919_cov_35.002439	474	554	0	80	80	1.0000000
NODE_8391_length_919_cov_35.002439	527	607	0	80	80	1.0000000
NODE_8392_length_919_cov_29.935366	246	326	0	80	80	1.0000000
NODE_8392_length_919_cov_29.935366	299	379	0	64	80	0.8000000
NODE_8392_length_919_cov_29.935366	299	379	4	16	80	0.2000000
NODE_8393_length_919_cov_28.190244	470	550	2	2	80	0.0250000
NODE_8393_length_919_cov_28.190244	470	550	4	16	80	0.2000000
NODE_8393_length_919_cov_28.190244	470	550	6	10	80	0.1250000
NODE_8393_length_919_cov_28.190244	470	550	8	11	80	0.1375000
NODE_8393_length_919_cov_28.190244	470	550	10	41	80	0.5125000
NODE_8393_length_919_cov_28.190244	523	603	0	44	80	0.5500000
NODE_8393_length_919_cov_28.190244	523	603	2	11	80	0.1375000
NODE_8393_length_919_cov_28.190244	523	603	4	16	80	0.2000000
NODE_8393_length_919_cov_28.190244	523	603	8	4	80	0.0500000
NODE_8393_length_919_cov_28.190244	523	603	10	5	80	0.0625000
NODE_8394_length_919_cov_27.119512	454	534	1	16	80	0.2000000
NODE_8394_length_919_cov_27.119512	454	534	2	3	80	0.0375000
NODE_8394_length_919_cov_27.119512	454	534	3	61	80	0.7625000
NODE_8394_length_919_cov_27.119512	507	587	1	45	80	0.5625000
NODE_8394_length_919_cov_27.119512	507	587	2	24	80	0.3000000
NODE_8394_length_919_cov_27.119512	507	587	3	11	80	0.1375000
NODE_8395_length_919_cov_21.836585	545	625	0	23	80	0.2875000
NODE_8395_length_919_cov_21.836585	545	625	2	57	80	0.7125000
NODE_8395_length_919_cov_21.836585	598	677	0	62	79	0.7848101
NODE_8395_length_919_cov_21.836585	598	677	2	17	79	0.2151899
NODE_8396_length_919_cov_17.442683	385	465	2	80	80	1.0000000
NODE_8396_length_919_cov_17.442683	438	518	0	13	80	0.1625000
NODE_8396_length_919_cov_17.442683	438	518	2	67	80	0.8375000
NODE_8397_length_919_cov_16.685366	309	389	0	80	80	1.0000000
NODE_8397_length_919_cov_16.685366	362	442	0	80	80	1.0000000
NODE_8398_length_919_cov_14.013415	435	515	0	80	80	1.0000000
NODE_8398_length_919_cov_14.013415	488	568	0	80	80	1.0000000
NODE_8399_length_919_cov_12.013415	340	420	0	8	80	0.1000000
NODE_8399_length_919_cov_12.013415	340	420	4	8	80	0.1000000
NODE_8399_length_919_cov_12.013415	340	420	6	64	80	0.8000000
NODE_8399_length_919_cov_12.013415	393	473	0	45	80	0.5625000
NODE_8399_length_919_cov_12.013415	393	473	2	6	80	0.0750000
NODE_8399_length_919_cov_12.013415	393	473	6	29	80	0.3625000
NODE_8403_length_919_cov_3.529268	424	504	0	42	80	0.5250000
NODE_8403_length_919_cov_3.529268	424	504	2	38	80	0.4750000
NODE_8403_length_919_cov_3.529268	477	557	2	80	80	1.0000000
NODE_8404_length_919_cov_3.200000	444	524	0	80	80	1.0000000
NODE_8404_length_919_cov_3.200000	497	577	0	80	80	1.0000000
NODE_8415_length_918_cov_41.115995	387	467	2	5	80	0.0625000
NODE_8415_length_918_cov_41.115995	387	467	4	71	80	0.8875000
NODE_8415_length_918_cov_41.115995	387	467	6	4	80	0.0500000
NODE_8415_length_918_cov_41.115995	440	520	2	36	80	0.4500000
NODE_8415_length_918_cov_41.115995	440	520	4	44	80	0.5500000
NODE_8416_length_918_cov_37.405372	427	507	6	53	80	0.6625000
NODE_8416_length_918_cov_37.405372	427	507	8	27	80	0.3375000
NODE_8416_length_918_cov_37.405372	480	560	0	7	80	0.0875000
NODE_8416_length_918_cov_37.405372	480	560	4	19	80	0.2375000
NODE_8416_length_918_cov_37.405372	480	560	6	43	80	0.5375000
NODE_8416_length_918_cov_37.405372	480	560	8	11	80	0.1375000
NODE_8417_length_918_cov_31.559219	289	369	0	4	80	0.0500000
NODE_8417_length_918_cov_31.559219	289	369	2	20	80	0.2500000
NODE_8417_length_918_cov_31.559219	289	369	3	3	80	0.0375000
NODE_8417_length_918_cov_31.559219	289	369	5	26	80	0.3250000
NODE_8417_length_918_cov_31.559219	289	369	6	24	80	0.3000000
NODE_8417_length_918_cov_31.559219	289	369	8	3	80	0.0375000
NODE_8417_length_918_cov_31.559219	342	422	0	4	80	0.0500000
NODE_8417_length_918_cov_31.559219	342	422	2	58	80	0.7250000
NODE_8417_length_918_cov_31.559219	342	422	3	3	80	0.0375000
NODE_8417_length_918_cov_31.559219	342	422	6	15	80	0.1875000
NODE_8417_length_918_cov_31.559219	418	498	6	77	80	0.9625000
NODE_8417_length_918_cov_31.559219	418	498	8	3	80	0.0375000
NODE_8417_length_918_cov_31.559219	471	551	0	40	80	0.5000000
NODE_8417_length_918_cov_31.559219	471	551	2	7	80	0.0875000
NODE_8417_length_918_cov_31.559219	471	551	6	33	80	0.4125000
NODE_8418_length_918_cov_25.195360	429	509	12	2	80	0.0250000
NODE_8418_length_918_cov_25.195360	429	509	18	33	80	0.4125000
NODE_8418_length_918_cov_25.195360	429	509	20	45	80	0.5625000
NODE_8418_length_918_cov_25.195360	482	562	4	12	80	0.1500000
NODE_8418_length_918_cov_25.195360	482	562	14	4	80	0.0500000
NODE_8418_length_918_cov_25.195360	482	562	20	48	80	0.6000000
NODE_8418_length_918_cov_25.195360	482	562	22	9	80	0.1125000
NODE_8418_length_918_cov_25.195360	482	562	23	1	80	0.0125000
NODE_8418_length_918_cov_25.195360	482	562	24	6	80	0.0750000
NODE_8420_length_918_cov_10.537241	361	441	0	80	80	1.0000000
NODE_8420_length_918_cov_10.537241	414	492	0	78	78	1.0000000
NODE_8421_length_918_cov_9.821734	283	363	0	80	80	1.0000000
NODE_8421_length_918_cov_9.821734	336	416	0	80	80	1.0000000
NODE_8422_length_918_cov_9.714286	365	445	0	27	80	0.3375000
NODE_8422_length_918_cov_9.714286	365	445	2	53	80	0.6625000
NODE_8422_length_918_cov_9.714286	418	498	0	80	80	1.0000000
NODE_8441_length_917_cov_38.845966	405	476	0	10	71	0.1408451
NODE_8441_length_917_cov_38.845966	405	476	8	61	71	0.8591549
NODE_8441_length_917_cov_38.845966	458	538	0	41	80	0.5125000
NODE_8441_length_917_cov_38.845966	458	538	8	39	80	0.4875000
NODE_8442_length_917_cov_37.775061	505	585	5	4	80	0.0500000
NODE_8442_length_917_cov_37.775061	505	585	6	27	80	0.3375000
NODE_8442_length_917_cov_37.775061	505	585	12	49	80	0.6125000
NODE_8442_length_917_cov_37.775061	558	638	3	2	80	0.0250000
NODE_8442_length_917_cov_37.775061	558	638	4	1	80	0.0125000
NODE_8442_length_917_cov_37.775061	558	638	5	54	80	0.6750000
NODE_8442_length_917_cov_37.775061	558	638	6	23	80	0.2875000
NODE_8443_length_917_cov_33.195599	335	415	0	80	80	1.0000000
NODE_8443_length_917_cov_33.195599	388	468	0	80	80	1.0000000
NODE_8443_length_917_cov_33.195599	464	544	0	80	80	1.0000000
NODE_8443_length_917_cov_33.195599	517	597	0	80	80	1.0000000
NODE_8444_length_917_cov_22.871638	463	543	0	50	80	0.6250000
NODE_8444_length_917_cov_22.871638	463	543	2	30	80	0.3750000
NODE_8444_length_917_cov_22.871638	516	593	2	77	77	1.0000000
NODE_8445_length_917_cov_16.899756	321	401	6	80	80	1.0000000
NODE_8445_length_917_cov_16.899756	374	454	0	29	80	0.3625000
NODE_8445_length_917_cov_16.899756	374	454	4	7	80	0.0875000
NODE_8445_length_917_cov_16.899756	374	454	6	44	80	0.5500000
NODE_8446_length_917_cov_12.283619	397	477	2	7	80	0.0875000
NODE_8446_length_917_cov_12.283619	397	477	4	6	80	0.0750000
NODE_8446_length_917_cov_12.283619	397	477	7	18	80	0.2250000
NODE_8446_length_917_cov_12.283619	397	477	8	36	80	0.4500000
NODE_8446_length_917_cov_12.283619	397	477	9	13	80	0.1625000
NODE_8446_length_917_cov_12.283619	450	530	2	16	80	0.2000000
NODE_8446_length_917_cov_12.283619	450	530	6	11	80	0.1375000
NODE_8446_length_917_cov_12.283619	450	530	8	47	80	0.5875000
NODE_8446_length_917_cov_12.283619	450	530	9	6	80	0.0750000
NODE_8447_length_917_cov_12.172372	380	460	0	17	80	0.2125000
NODE_8447_length_917_cov_12.172372	380	460	1	1	80	0.0125000
NODE_8447_length_917_cov_12.172372	380	460	2	26	80	0.3250000
NODE_8447_length_917_cov_12.172372	380	460	4	22	80	0.2750000
NODE_8447_length_917_cov_12.172372	380	460	5	5	80	0.0625000
NODE_8447_length_917_cov_12.172372	380	460	6	9	80	0.1125000
NODE_8447_length_917_cov_12.172372	433	513	4	13	80	0.1625000
NODE_8447_length_917_cov_12.172372	433	513	5	5	80	0.0625000
NODE_8447_length_917_cov_12.172372	433	513	6	62	80	0.7750000
NODE_8447_length_917_cov_12.172372	545	597	0	1	52	0.0192308
NODE_8447_length_917_cov_12.172372	545	597	2	44	52	0.8461539
NODE_8447_length_917_cov_12.172372	545	597	4	7	52	0.1346154
NODE_8448_length_917_cov_8.277506	564	644	0	46	80	0.5750000
NODE_8448_length_917_cov_8.277506	564	644	2	2	80	0.0250000
NODE_8448_length_917_cov_8.277506	564	644	4	32	80	0.4000000
NODE_8448_length_917_cov_8.277506	617	697	0	80	80	1.0000000
NODE_8449_length_917_cov_8.145477	155	235	0	57	80	0.7125000
NODE_8449_length_917_cov_8.145477	155	235	2	23	80	0.2875000
NODE_8449_length_917_cov_8.145477	208	288	0	4	80	0.0500000
NODE_8449_length_917_cov_8.145477	208	288	2	76	80	0.9500000
NODE_8451_length_917_cov_6.073350	366	446	0	40	80	0.5000000
NODE_8451_length_917_cov_6.073350	366	446	2	40	80	0.5000000
NODE_8451_length_917_cov_6.073350	419	499	2	80	80	1.0000000
NODE_8463_length_916_cov_32.867809	347	427	2	34	80	0.4250000
NODE_8463_length_916_cov_32.867809	347	427	4	46	80	0.5750000
NODE_8463_length_916_cov_32.867809	400	480	4	80	80	1.0000000
NODE_8464_length_916_cov_27.673195	450	530	0	80	80	1.0000000
NODE_8464_length_916_cov_27.673195	503	583	0	80	80	1.0000000
NODE_8465_length_916_cov_27.146879	223	303	8	22	80	0.2750000
NODE_8465_length_916_cov_27.146879	223	303	10	58	80	0.7250000
NODE_8465_length_916_cov_27.146879	276	356	0	45	80	0.5625000
NODE_8465_length_916_cov_27.146879	276	356	6	8	80	0.1000000
NODE_8465_length_916_cov_27.146879	276	356	8	22	80	0.2750000
NODE_8465_length_916_cov_27.146879	276	356	10	5	80	0.0625000
NODE_8466_length_916_cov_25.604651	398	478	13	24	80	0.3000000
NODE_8466_length_916_cov_25.604651	398	478	14	23	80	0.2875000
NODE_8466_length_916_cov_25.604651	398	478	15	33	80	0.4125000
NODE_8466_length_916_cov_25.604651	451	531	6	19	80	0.2375000
NODE_8466_length_916_cov_25.604651	451	531	8	13	80	0.1625000
NODE_8466_length_916_cov_25.604651	451	531	10	4	80	0.0500000
NODE_8466_length_916_cov_25.604651	451	531	12	3	80	0.0375000
NODE_8466_length_916_cov_25.604651	451	531	14	37	80	0.4625000
NODE_8466_length_916_cov_25.604651	451	531	15	4	80	0.0500000
NODE_8467_length_916_cov_18.035496	456	536	2	49	80	0.6125000
NODE_8467_length_916_cov_18.035496	456	536	4	31	80	0.3875000
NODE_8467_length_916_cov_18.035496	509	589	0	11	80	0.1375000
NODE_8467_length_916_cov_18.035496	509	589	2	69	80	0.8625000
NODE_8468_length_916_cov_12.651163	500	580	2	16	80	0.2000000
NODE_8468_length_916_cov_12.651163	500	580	3	2	80	0.0250000
NODE_8468_length_916_cov_12.651163	500	580	4	19	80	0.2375000
NODE_8468_length_916_cov_12.651163	500	580	6	43	80	0.5375000
NODE_8468_length_916_cov_12.651163	553	633	0	8	80	0.1000000
NODE_8468_length_916_cov_12.651163	553	633	2	17	80	0.2125000
NODE_8468_length_916_cov_12.651163	553	633	4	31	80	0.3875000
NODE_8468_length_916_cov_12.651163	553	633	6	24	80	0.3000000
NODE_8469_length_916_cov_11.337821	530	610	0	80	80	1.0000000
NODE_8469_length_916_cov_11.337821	583	663	0	80	80	1.0000000
NODE_8470_length_916_cov_9.640147	293	373	0	80	80	1.0000000
NODE_8470_length_916_cov_9.640147	346	426	0	80	80	1.0000000
NODE_8472_length_916_cov_8.042840	426	506	0	80	80	1.0000000
NODE_8472_length_916_cov_8.042840	479	559	0	80	80	1.0000000
NODE_8473_length_916_cov_7.123623	785	847	28	1	62	0.0161290
NODE_8473_length_916_cov_7.123623	785	847	30	3	62	0.0483871
NODE_8473_length_916_cov_7.123623	785	847	34	2	62	0.0322581
NODE_8473_length_916_cov_7.123623	785	847	44	1	62	0.0161290
NODE_8473_length_916_cov_7.123623	785	847	48	1	62	0.0161290
NODE_8473_length_916_cov_7.123623	785	847	52	4	62	0.0645161
NODE_8473_length_916_cov_7.123623	785	847	56	1	62	0.0161290
NODE_8473_length_916_cov_7.123623	785	847	60	1	62	0.0161290
NODE_8473_length_916_cov_7.123623	785	847	64	1	62	0.0161290
NODE_8473_length_916_cov_7.123623	785	847	66	4	62	0.0645161
NODE_8473_length_916_cov_7.123623	785	847	68	43	62	0.6935484
NODE_8473_length_916_cov_7.123623	820	900	57	1	80	0.0125000
NODE_8473_length_916_cov_7.123623	820	900	58	7	80	0.0875000
NODE_8473_length_916_cov_7.123623	820	900	60	2	80	0.0250000
NODE_8473_length_916_cov_7.123623	820	900	62	23	80	0.2875000
NODE_8473_length_916_cov_7.123623	820	900	66	17	80	0.2125000
NODE_8473_length_916_cov_7.123623	820	900	68	30	80	0.3750000
NODE_8481_length_915_cov_59.289216	398	478	0	78	80	0.9750000
NODE_8481_length_915_cov_59.289216	398	478	2	2	80	0.0250000
NODE_8481_length_915_cov_59.289216	451	531	0	43	80	0.5375000
NODE_8481_length_915_cov_59.289216	451	531	4	37	80	0.4625000
NODE_8481_length_915_cov_59.289216	527	607	4	52	80	0.6500000
NODE_8481_length_915_cov_59.289216	527	607	5	6	80	0.0750000
NODE_8481_length_915_cov_59.289216	527	607	6	1	80	0.0125000
NODE_8481_length_915_cov_59.289216	527	607	7	21	80	0.2625000
NODE_8481_length_915_cov_59.289216	580	660	2	9	80	0.1125000
NODE_8481_length_915_cov_59.289216	580	660	3	8	80	0.1000000
NODE_8481_length_915_cov_59.289216	580	660	4	14	80	0.1750000
NODE_8481_length_915_cov_59.289216	580	660	5	14	80	0.1750000
NODE_8481_length_915_cov_59.289216	580	660	7	35	80	0.4375000
NODE_8482_length_915_cov_45.104167	153	228	0	23	75	0.3066667
NODE_8482_length_915_cov_45.104167	153	228	2	52	75	0.6933333
NODE_8482_length_915_cov_45.104167	206	286	0	25	80	0.3125000
NODE_8482_length_915_cov_45.104167	206	286	2	55	80	0.6875000
NODE_8482_length_915_cov_45.104167	282	362	0	8	80	0.1000000
NODE_8482_length_915_cov_45.104167	282	362	6	8	80	0.1000000
NODE_8482_length_915_cov_45.104167	282	362	14	64	80	0.8000000
NODE_8482_length_915_cov_45.104167	335	415	10	2	80	0.0250000
NODE_8482_length_915_cov_45.104167	335	415	11	7	80	0.0875000
NODE_8482_length_915_cov_45.104167	335	415	12	35	80	0.4375000
NODE_8482_length_915_cov_45.104167	335	415	14	34	80	0.4250000
NODE_8482_length_915_cov_45.104167	335	415	16	2	80	0.0250000
NODE_8483_length_915_cov_37.599265	397	477	1	20	80	0.2500000
NODE_8483_length_915_cov_37.599265	397	477	2	16	80	0.2000000
NODE_8483_length_915_cov_37.599265	397	477	4	44	80	0.5500000
NODE_8483_length_915_cov_37.599265	450	530	0	32	80	0.4000000
NODE_8483_length_915_cov_37.599265	450	530	1	41	80	0.5125000
NODE_8483_length_915_cov_37.599265	450	530	2	7	80	0.0875000
NODE_8485_length_915_cov_20.458333	297	377	2	80	80	1.0000000
NODE_8485_length_915_cov_20.458333	350	430	0	13	80	0.1625000
NODE_8485_length_915_cov_20.458333	350	430	2	67	80	0.8375000
NODE_8485_length_915_cov_20.458333	426	506	0	80	80	1.0000000
NODE_8485_length_915_cov_20.458333	479	559	0	80	80	1.0000000
NODE_8486_length_915_cov_14.397059	175	255	0	7	80	0.0875000
NODE_8486_length_915_cov_14.397059	175	255	2	73	80	0.9125000
NODE_8486_length_915_cov_14.397059	228	308	0	41	80	0.5125000
NODE_8486_length_915_cov_14.397059	228	308	2	39	80	0.4875000
NODE_8487_length_915_cov_8.741422	295	375	0	80	80	1.0000000
NODE_8487_length_915_cov_8.741422	348	428	0	80	80	1.0000000
NODE_8488_length_915_cov_7.719363	823	894	2	71	71	1.0000000
NODE_8488_length_915_cov_7.719363	828	894	2	66	66	1.0000000
NODE_8488_length_915_cov_7.719363	867	915	0	12	48	0.2500000
NODE_8488_length_915_cov_7.719363	867	915	1	1	48	0.0208333
NODE_8488_length_915_cov_7.719363	867	915	2	35	48	0.7291667
NODE_8488_length_915_cov_7.719363	867	915	0	12	48	0.2500000
NODE_8488_length_915_cov_7.719363	867	915	1	1	48	0.0208333
NODE_8488_length_915_cov_7.719363	867	915	2	35	48	0.7291667
NODE_8488_length_915_cov_7.719363	867	915	0	12	48	0.2500000
NODE_8488_length_915_cov_7.719363	867	915	1	1	48	0.0208333
NODE_8488_length_915_cov_7.719363	867	915	2	35	48	0.7291667
NODE_8489_length_915_cov_7.648284	370	450	0	28	80	0.3500000
NODE_8489_length_915_cov_7.648284	370	450	4	52	80	0.6500000
NODE_8489_length_915_cov_7.648284	423	503	4	80	80	1.0000000
NODE_8490_length_915_cov_6.848039	434	514	0	4	80	0.0500000
NODE_8490_length_915_cov_6.848039	434	514	2	76	80	0.9500000
NODE_8490_length_915_cov_6.848039	487	567	0	57	80	0.7125000
NODE_8490_length_915_cov_6.848039	487	567	2	23	80	0.2875000
NODE_8497_length_915_cov_2.011029	24	99	4	2	75	0.0266667
NODE_8497_length_915_cov_2.011029	24	99	6	33	75	0.4400000
NODE_8497_length_915_cov_2.011029	24	99	7	40	75	0.5333334
NODE_8505_length_914_cov_89.814724	0	41	3	6	41	0.1463415
NODE_8505_length_914_cov_89.814724	0	41	8	2	41	0.0487805
NODE_8505_length_914_cov_89.814724	0	41	14	1	41	0.0243902
NODE_8505_length_914_cov_89.814724	0	41	16	1	41	0.0243902
NODE_8505_length_914_cov_89.814724	0	41	18	1	41	0.0243902
NODE_8505_length_914_cov_89.814724	0	41	20	1	41	0.0243902
NODE_8505_length_914_cov_89.814724	0	41	22	1	41	0.0243902
NODE_8505_length_914_cov_89.814724	0	41	34	1	41	0.0243902
NODE_8505_length_914_cov_89.814724	0	41	53	1	41	0.0243902
NODE_8505_length_914_cov_89.814724	0	41	59	1	41	0.0243902
NODE_8505_length_914_cov_89.814724	0	41	63	1	41	0.0243902
NODE_8505_length_914_cov_89.814724	0	41	66	2	41	0.0487805
NODE_8505_length_914_cov_89.814724	0	41	68	1	41	0.0243902
NODE_8505_length_914_cov_89.814724	0	41	70	1	41	0.0243902
NODE_8505_length_914_cov_89.814724	0	41	77	1	41	0.0243902
NODE_8505_length_914_cov_89.814724	0	41	89	1	41	0.0243902
NODE_8505_length_914_cov_89.814724	0	41	93	4	41	0.0975610
NODE_8505_length_914_cov_89.814724	0	41	95	2	41	0.0487805
NODE_8505_length_914_cov_89.814724	0	41	97	1	41	0.0243902
NODE_8505_length_914_cov_89.814724	0	41	107	1	41	0.0243902
NODE_8505_length_914_cov_89.814724	0	41	110	1	41	0.0243902
NODE_8505_length_914_cov_89.814724	0	41	120	1	41	0.0243902
NODE_8505_length_914_cov_89.814724	0	41	124	1	41	0.0243902
NODE_8505_length_914_cov_89.814724	0	41	135	3	41	0.0731707
NODE_8505_length_914_cov_89.814724	0	41	138	1	41	0.0243902
NODE_8505_length_914_cov_89.814724	0	41	140	1	41	0.0243902
NODE_8505_length_914_cov_89.814724	0	41	142	1	41	0.0243902
NODE_8505_length_914_cov_89.814724	0	41	144	1	41	0.0243902
NODE_8505_length_914_cov_89.814724	19	94	68	1	75	0.0133333
NODE_8505_length_914_cov_89.814724	19	94	70	1	75	0.0133333
NODE_8505_length_914_cov_89.814724	19	94	77	1	75	0.0133333
NODE_8505_length_914_cov_89.814724	19	94	89	1	75	0.0133333
NODE_8505_length_914_cov_89.814724	19	94	93	4	75	0.0533333
NODE_8505_length_914_cov_89.814724	19	94	95	2	75	0.0266667
NODE_8505_length_914_cov_89.814724	19	94	97	1	75	0.0133333
NODE_8505_length_914_cov_89.814724	19	94	107	1	75	0.0133333
NODE_8505_length_914_cov_89.814724	19	94	110	1	75	0.0133333
NODE_8505_length_914_cov_89.814724	19	94	120	1	75	0.0133333
NODE_8505_length_914_cov_89.814724	19	94	124	1	75	0.0133333
NODE_8505_length_914_cov_89.814724	19	94	135	3	75	0.0400000
NODE_8505_length_914_cov_89.814724	19	94	138	1	75	0.0133333
NODE_8505_length_914_cov_89.814724	19	94	140	1	75	0.0133333
NODE_8505_length_914_cov_89.814724	19	94	142	1	75	0.0133333
NODE_8505_length_914_cov_89.814724	19	94	144	1	75	0.0133333
NODE_8505_length_914_cov_89.814724	19	94	156	2	75	0.0266667
NODE_8505_length_914_cov_89.814724	19	94	161	5	75	0.0666667
NODE_8505_length_914_cov_89.814724	19	94	172	4	75	0.0533333
NODE_8505_length_914_cov_89.814724	19	94	174	1	75	0.0133333
NODE_8505_length_914_cov_89.814724	19	94	177	1	75	0.0133333
NODE_8505_length_914_cov_89.814724	19	94	181	1	75	0.0133333
NODE_8505_length_914_cov_89.814724	19	94	186	4	75	0.0533333
NODE_8505_length_914_cov_89.814724	19	94	194	3	75	0.0400000
NODE_8505_length_914_cov_89.814724	19	94	195	3	75	0.0400000
NODE_8505_length_914_cov_89.814724	19	94	197	3	75	0.0400000
NODE_8505_length_914_cov_89.814724	19	94	202	4	75	0.0533333
NODE_8505_length_914_cov_89.814724	19	94	204	1	75	0.0133333
NODE_8505_length_914_cov_89.814724	19	94	206	1	75	0.0133333
NODE_8505_length_914_cov_89.814724	19	94	208	1	75	0.0133333
NODE_8505_length_914_cov_89.814724	19	94	210	2	75	0.0266667
NODE_8505_length_914_cov_89.814724	19	94	211	2	75	0.0266667
NODE_8505_length_914_cov_89.814724	19	94	224	1	75	0.0133333
NODE_8505_length_914_cov_89.814724	19	94	226	1	75	0.0133333
NODE_8505_length_914_cov_89.814724	19	94	228	3	75	0.0400000
NODE_8505_length_914_cov_89.814724	19	94	231	1	75	0.0133333
NODE_8505_length_914_cov_89.814724	19	94	235	1	75	0.0133333
NODE_8505_length_914_cov_89.814724	19	94	241	1	75	0.0133333
NODE_8505_length_914_cov_89.814724	19	94	244	1	75	0.0133333
NODE_8505_length_914_cov_89.814724	19	94	245	4	75	0.0533333
NODE_8505_length_914_cov_89.814724	19	94	246	1	75	0.0133333
NODE_8505_length_914_cov_89.814724	19	94	251	1	75	0.0133333
NODE_8506_length_914_cov_33.755828	400	480	0	80	80	1.0000000
NODE_8506_length_914_cov_33.755828	453	533	0	80	80	1.0000000
NODE_8507_length_914_cov_31.557055	368	448	0	80	80	1.0000000
NODE_8507_length_914_cov_31.557055	421	501	0	29	80	0.3625000
NODE_8507_length_914_cov_31.557055	421	501	2	51	80	0.6375000
NODE_8508_length_914_cov_29.087117	331	411	6	22	80	0.2750000
NODE_8508_length_914_cov_29.087117	331	411	12	42	80	0.5250000
NODE_8508_length_914_cov_29.087117	331	411	14	16	80	0.2000000
NODE_8508_length_914_cov_29.087117	384	464	0	8	80	0.1000000
NODE_8508_length_914_cov_29.087117	384	464	2	12	80	0.1500000
NODE_8508_length_914_cov_29.087117	384	464	8	31	80	0.3875000
NODE_8508_length_914_cov_29.087117	384	464	12	26	80	0.3250000
NODE_8508_length_914_cov_29.087117	384	464	14	3	80	0.0375000
NODE_8509_length_914_cov_28.490798	273	353	0	28	80	0.3500000
NODE_8509_length_914_cov_28.490798	273	353	3	24	80	0.3000000
NODE_8509_length_914_cov_28.490798	273	353	4	25	80	0.3125000
NODE_8509_length_914_cov_28.490798	273	353	6	3	80	0.0375000
NODE_8509_length_914_cov_28.490798	326	406	4	27	80	0.3375000
NODE_8509_length_914_cov_28.490798	326	406	6	53	80	0.6625000
NODE_8509_length_914_cov_28.490798	402	482	4	7	80	0.0875000
NODE_8509_length_914_cov_28.490798	402	482	5	13	80	0.1625000
NODE_8509_length_914_cov_28.490798	402	482	6	5	80	0.0625000
NODE_8509_length_914_cov_28.490798	402	482	7	11	80	0.1375000
NODE_8509_length_914_cov_28.490798	402	482	8	44	80	0.5500000
NODE_8509_length_914_cov_28.490798	455	535	0	36	80	0.4500000
NODE_8509_length_914_cov_28.490798	455	535	2	12	80	0.1500000
NODE_8509_length_914_cov_28.490798	455	535	4	12	80	0.1500000
NODE_8509_length_914_cov_28.490798	455	535	5	13	80	0.1625000
NODE_8509_length_914_cov_28.490798	455	535	7	7	80	0.0875000
NODE_8510_length_914_cov_25.429448	393	473	8	3	80	0.0375000
NODE_8510_length_914_cov_25.429448	393	473	10	34	80	0.4250000
NODE_8510_length_914_cov_25.429448	393	473	12	8	80	0.1000000
NODE_8510_length_914_cov_25.429448	393	473	14	3	80	0.0375000
NODE_8510_length_914_cov_25.429448	393	473	15	14	80	0.1750000
NODE_8510_length_914_cov_25.429448	393	473	16	18	80	0.2250000
NODE_8510_length_914_cov_25.429448	446	526	4	2	80	0.0250000
NODE_8510_length_914_cov_25.429448	446	526	6	47	80	0.5875000
NODE_8510_length_914_cov_25.429448	446	526	8	7	80	0.0875000
NODE_8510_length_914_cov_25.429448	446	526	15	6	80	0.0750000
NODE_8510_length_914_cov_25.429448	446	526	16	18	80	0.2250000
NODE_8510_length_914_cov_25.429448	522	602	1	14	80	0.1750000
NODE_8510_length_914_cov_25.429448	522	602	2	58	80	0.7250000
NODE_8510_length_914_cov_25.429448	522	602	4	6	80	0.0750000
NODE_8510_length_914_cov_25.429448	522	602	6	2	80	0.0250000
NODE_8510_length_914_cov_25.429448	575	655	0	53	80	0.6625000
NODE_8510_length_914_cov_25.429448	575	655	1	14	80	0.1750000
NODE_8510_length_914_cov_25.429448	575	655	2	13	80	0.1625000
NODE_8511_length_914_cov_19.111656	354	434	2	23	80	0.2875000
NODE_8511_length_914_cov_19.111656	354	434	8	27	80	0.3375000
NODE_8511_length_914_cov_19.111656	354	434	10	15	80	0.1875000
NODE_8511_length_914_cov_19.111656	354	434	12	15	80	0.1875000
NODE_8511_length_914_cov_19.111656	407	487	2	3	80	0.0375000
NODE_8511_length_914_cov_19.111656	407	487	7	1	80	0.0125000
NODE_8511_length_914_cov_19.111656	407	487	8	11	80	0.1375000
NODE_8511_length_914_cov_19.111656	407	487	10	50	80	0.6250000
NODE_8511_length_914_cov_19.111656	407	487	12	15	80	0.1875000
NODE_8512_length_914_cov_13.423313	603	683	0	80	80	1.0000000
NODE_8512_length_914_cov_13.423313	656	736	0	80	80	1.0000000
NODE_8513_length_914_cov_10.947239	341	411	2	30	70	0.4285714
NODE_8513_length_914_cov_10.947239	341	411	4	40	70	0.5714286
NODE_8513_length_914_cov_10.947239	384	464	0	30	80	0.3750000
NODE_8513_length_914_cov_10.947239	384	464	2	48	80	0.6000000
NODE_8513_length_914_cov_10.947239	384	464	4	2	80	0.0250000
NODE_8518_length_914_cov_1.931288	833	873	0	6	40	0.1500000
NODE_8518_length_914_cov_1.931288	833	873	5	3	40	0.0750000
NODE_8518_length_914_cov_1.931288	833	873	9	31	40	0.7750000
NODE_8526_length_913_cov_49.665848	31	111	61	2	80	0.0250000
NODE_8526_length_913_cov_49.665848	31	111	63	2	80	0.0250000
NODE_8526_length_913_cov_49.665848	31	111	65	1	80	0.0125000
NODE_8526_length_913_cov_49.665848	31	111	69	1	80	0.0125000
NODE_8526_length_913_cov_49.665848	31	111	71	1	80	0.0125000
NODE_8526_length_913_cov_49.665848	31	111	77	2	80	0.0250000
NODE_8526_length_913_cov_49.665848	31	111	78	1	80	0.0125000
NODE_8526_length_913_cov_49.665848	31	111	79	14	80	0.1750000
NODE_8526_length_913_cov_49.665848	31	111	81	2	80	0.0250000
NODE_8526_length_913_cov_49.665848	31	111	83	1	80	0.0125000
NODE_8526_length_913_cov_49.665848	31	111	85	2	80	0.0250000
NODE_8526_length_913_cov_49.665848	31	111	87	1	80	0.0125000
NODE_8526_length_913_cov_49.665848	31	111	91	1	80	0.0125000
NODE_8526_length_913_cov_49.665848	31	111	93	1	80	0.0125000
NODE_8526_length_913_cov_49.665848	31	111	95	1	80	0.0125000
NODE_8526_length_913_cov_49.665848	31	111	97	2	80	0.0250000
NODE_8526_length_913_cov_49.665848	31	111	99	1	80	0.0125000
NODE_8526_length_913_cov_49.665848	31	111	108	1	80	0.0125000
NODE_8526_length_913_cov_49.665848	31	111	110	1	80	0.0125000
NODE_8526_length_913_cov_49.665848	31	111	112	1	80	0.0125000
NODE_8526_length_913_cov_49.665848	31	111	114	1	80	0.0125000
NODE_8526_length_913_cov_49.665848	31	111	118	1	80	0.0125000
NODE_8526_length_913_cov_49.665848	31	111	120	2	80	0.0250000
NODE_8526_length_913_cov_49.665848	31	111	122	1	80	0.0125000
NODE_8526_length_913_cov_49.665848	31	111	126	4	80	0.0500000
NODE_8526_length_913_cov_49.665848	31	111	128	1	80	0.0125000
NODE_8526_length_913_cov_49.665848	31	111	129	1	80	0.0125000
NODE_8526_length_913_cov_49.665848	31	111	130	8	80	0.1000000
NODE_8526_length_913_cov_49.665848	31	111	132	2	80	0.0250000
NODE_8526_length_913_cov_49.665848	31	111	137	1	80	0.0125000
NODE_8526_length_913_cov_49.665848	31	111	138	1	80	0.0125000
NODE_8526_length_913_cov_49.665848	31	111	140	1	80	0.0125000
NODE_8526_length_913_cov_49.665848	31	111	142	2	80	0.0250000
NODE_8526_length_913_cov_49.665848	31	111	146	1	80	0.0125000
NODE_8526_length_913_cov_49.665848	31	111	152	2	80	0.0250000
NODE_8526_length_913_cov_49.665848	31	111	153	1	80	0.0125000
NODE_8526_length_913_cov_49.665848	31	111	154	2	80	0.0250000
NODE_8526_length_913_cov_49.665848	31	111	155	1	80	0.0125000
NODE_8526_length_913_cov_49.665848	31	111	156	4	80	0.0500000
NODE_8526_length_913_cov_49.665848	31	111	157	4	80	0.0500000
NODE_8526_length_913_cov_49.665848	136	155	110	1	19	0.0526316
NODE_8526_length_913_cov_49.665848	136	155	114	1	19	0.0526316
NODE_8526_length_913_cov_49.665848	136	155	118	1	19	0.0526316
NODE_8526_length_913_cov_49.665848	136	155	120	1	19	0.0526316
NODE_8526_length_913_cov_49.665848	136	155	124	1	19	0.0526316
NODE_8526_length_913_cov_49.665848	136	155	126	1	19	0.0526316
NODE_8526_length_913_cov_49.665848	136	155	130	1	19	0.0526316
NODE_8526_length_913_cov_49.665848	136	155	132	1	19	0.0526316
NODE_8526_length_913_cov_49.665848	136	155	134	6	19	0.3157895
NODE_8526_length_913_cov_49.665848	136	155	136	5	19	0.2631579
NODE_8527_length_913_cov_47.115479	367	447	0	63	80	0.7875000
NODE_8527_length_913_cov_47.115479	367	447	4	9	80	0.1125000
NODE_8527_length_913_cov_47.115479	367	447	6	8	80	0.1000000
NODE_8527_length_913_cov_47.115479	420	500	0	10	80	0.1250000
NODE_8527_length_913_cov_47.115479	420	500	4	9	80	0.1125000
NODE_8527_length_913_cov_47.115479	420	500	6	61	80	0.7625000
NODE_8528_length_913_cov_36.541769	502	582	2	80	80	1.0000000
NODE_8528_length_913_cov_36.541769	555	635	0	39	80	0.4875000
NODE_8528_length_913_cov_36.541769	555	635	2	41	80	0.5125000
NODE_8529_length_913_cov_33.679361	433	513	0	26	80	0.3250000
NODE_8529_length_913_cov_33.679361	433	513	2	54	80	0.6750000
NODE_8529_length_913_cov_33.679361	486	566	0	5	80	0.0625000
NODE_8529_length_913_cov_33.679361	486	566	2	75	80	0.9375000
NODE_8530_length_913_cov_29.675676	408	488	2	47	80	0.5875000
NODE_8530_length_913_cov_29.675676	408	488	4	8	80	0.1000000
NODE_8530_length_913_cov_29.675676	408	488	6	22	80	0.2750000
NODE_8530_length_913_cov_29.675676	408	488	8	3	80	0.0375000
NODE_8530_length_913_cov_29.675676	461	541	4	26	80	0.3250000
NODE_8530_length_913_cov_29.675676	461	541	6	51	80	0.6375000
NODE_8530_length_913_cov_29.675676	461	541	8	3	80	0.0375000
NODE_8531_length_913_cov_24.901720	342	422	4	42	80	0.5250000
NODE_8531_length_913_cov_24.901720	342	422	6	38	80	0.4750000
NODE_8531_length_913_cov_24.901720	395	475	0	10	80	0.1250000
NODE_8531_length_913_cov_24.901720	395	475	2	4	80	0.0500000
NODE_8531_length_913_cov_24.901720	395	475	6	66	80	0.8250000
NODE_8532_length_913_cov_24.625307	396	476	0	80	80	1.0000000
NODE_8532_length_913_cov_24.625307	449	529	0	80	80	1.0000000
NODE_8533_length_913_cov_15.094595	525	589	0	64	64	1.0000000
NODE_8533_length_913_cov_15.094595	562	642	0	80	80	1.0000000
NODE_8534_length_913_cov_8.633907	305	385	0	80	80	1.0000000
NODE_8534_length_913_cov_8.633907	358	429	0	71	71	1.0000000
NODE_8546_length_912_cov_25.110701	419	499	0	10	80	0.1250000
NODE_8546_length_912_cov_25.110701	419	499	2	70	80	0.8750000
NODE_8546_length_912_cov_25.110701	472	552	2	80	80	1.0000000
NODE_8547_length_912_cov_20.045510	306	386	0	25	80	0.3125000
NODE_8547_length_912_cov_20.045510	306	386	2	55	80	0.6875000
NODE_8547_length_912_cov_20.045510	359	439	0	78	80	0.9750000
NODE_8547_length_912_cov_20.045510	359	439	2	2	80	0.0250000
NODE_8548_length_912_cov_19.635916	326	406	0	43	80	0.5375000
NODE_8548_length_912_cov_19.635916	326	406	2	29	80	0.3625000
NODE_8548_length_912_cov_19.635916	326	406	6	8	80	0.1000000
NODE_8548_length_912_cov_19.635916	379	459	2	19	80	0.2375000
NODE_8548_length_912_cov_19.635916	379	459	6	61	80	0.7625000
NODE_8549_length_912_cov_17.714637	395	475	0	9	80	0.1125000
NODE_8549_length_912_cov_17.714637	395	475	4	71	80	0.8875000
NODE_8549_length_912_cov_17.714637	448	528	0	25	80	0.3125000
NODE_8549_length_912_cov_17.714637	448	528	3	1	80	0.0125000
NODE_8549_length_912_cov_17.714637	448	528	4	54	80	0.6750000
NODE_8550_length_912_cov_15.546125	355	435	0	80	80	1.0000000
NODE_8550_length_912_cov_15.546125	408	488	0	45	80	0.5625000
NODE_8550_length_912_cov_15.546125	408	488	2	35	80	0.4375000
NODE_8551_length_912_cov_15.077491	255	291	0	1	36	0.0277778
NODE_8551_length_912_cov_15.077491	255	291	4	35	36	0.9722222
NODE_8551_length_912_cov_15.077491	264	328	0	35	64	0.5468750
NODE_8551_length_912_cov_15.077491	264	328	2	3	64	0.0468750
NODE_8551_length_912_cov_15.077491	264	328	4	26	64	0.4062500
NODE_8551_length_912_cov_15.077491	415	495	1	15	80	0.1875000
NODE_8551_length_912_cov_15.077491	415	495	2	65	80	0.8125000
NODE_8551_length_912_cov_15.077491	468	548	2	33	80	0.4125000
NODE_8551_length_912_cov_15.077491	468	548	4	47	80	0.5875000
NODE_8552_length_912_cov_15.023370	361	441	2	7	80	0.0875000
NODE_8552_length_912_cov_15.023370	361	441	7	1	80	0.0125000
NODE_8552_length_912_cov_15.023370	361	441	8	62	80	0.7750000
NODE_8552_length_912_cov_15.023370	361	441	10	10	80	0.1250000
NODE_8552_length_912_cov_15.023370	414	494	8	54	80	0.6750000
NODE_8552_length_912_cov_15.023370	414	494	9	1	80	0.0125000
NODE_8552_length_912_cov_15.023370	414	494	10	25	80	0.3125000
NODE_8553_length_912_cov_13.600246	61	141	2	80	80	1.0000000
NODE_8553_length_912_cov_13.600246	460	540	0	80	80	1.0000000
NODE_8553_length_912_cov_13.600246	513	593	0	80	80	1.0000000
NODE_8554_length_912_cov_13.113161	385	465	0	80	80	1.0000000
NODE_8554_length_912_cov_13.113161	438	518	0	80	80	1.0000000
NODE_8555_length_912_cov_11.110701	353	433	0	80	80	1.0000000
NODE_8555_length_912_cov_11.110701	406	486	0	80	80	1.0000000
NODE_8555_length_912_cov_11.110701	827	907	0	27	80	0.3375000
NODE_8555_length_912_cov_11.110701	827	907	2	53	80	0.6625000
NODE_8555_length_912_cov_11.110701	831	854	2	23	23	1.0000000
NODE_8584_length_911_cov_173.171182	580	660	333	1	80	0.0125000
NODE_8584_length_911_cov_173.171182	580	660	336	1	80	0.0125000
NODE_8584_length_911_cov_173.171182	580	660	338	1	80	0.0125000
NODE_8584_length_911_cov_173.171182	580	660	339	1	80	0.0125000
NODE_8584_length_911_cov_173.171182	580	660	342	2	80	0.0250000
NODE_8584_length_911_cov_173.171182	580	660	347	2	80	0.0250000
NODE_8584_length_911_cov_173.171182	580	660	356	1	80	0.0125000
NODE_8584_length_911_cov_173.171182	580	660	360	1	80	0.0125000
NODE_8584_length_911_cov_173.171182	580	660	362	1	80	0.0125000
NODE_8584_length_911_cov_173.171182	580	660	364	1	80	0.0125000
NODE_8584_length_911_cov_173.171182	580	660	370	1	80	0.0125000
NODE_8584_length_911_cov_173.171182	580	660	372	2	80	0.0250000
NODE_8584_length_911_cov_173.171182	580	660	373	1	80	0.0125000
NODE_8584_length_911_cov_173.171182	580	660	374	2	80	0.0250000
NODE_8584_length_911_cov_173.171182	580	660	375	1	80	0.0125000
NODE_8584_length_911_cov_173.171182	580	660	376	2	80	0.0250000
NODE_8584_length_911_cov_173.171182	580	660	378	1	80	0.0125000
NODE_8584_length_911_cov_173.171182	580	660	379	1	80	0.0125000
NODE_8584_length_911_cov_173.171182	580	660	380	1	80	0.0125000
NODE_8584_length_911_cov_173.171182	580	660	381	1	80	0.0125000
NODE_8584_length_911_cov_173.171182	580	660	382	1	80	0.0125000
NODE_8584_length_911_cov_173.171182	580	660	383	1	80	0.0125000
NODE_8584_length_911_cov_173.171182	580	660	384	1	80	0.0125000
NODE_8584_length_911_cov_173.171182	580	660	386	2	80	0.0250000
NODE_8584_length_911_cov_173.171182	580	660	388	1	80	0.0125000
NODE_8584_length_911_cov_173.171182	580	660	389	3	80	0.0375000
NODE_8584_length_911_cov_173.171182	580	660	390	1	80	0.0125000
NODE_8584_length_911_cov_173.171182	580	660	393	1	80	0.0125000
NODE_8584_length_911_cov_173.171182	580	660	394	1	80	0.0125000
NODE_8584_length_911_cov_173.171182	580	660	395	1	80	0.0125000
NODE_8584_length_911_cov_173.171182	580	660	397	2	80	0.0250000
NODE_8584_length_911_cov_173.171182	580	660	398	4	80	0.0500000
NODE_8584_length_911_cov_173.171182	580	660	399	1	80	0.0125000
NODE_8584_length_911_cov_173.171182	580	660	401	1	80	0.0125000
NODE_8584_length_911_cov_173.171182	580	660	402	2	80	0.0250000
NODE_8584_length_911_cov_173.171182	580	660	404	3	80	0.0375000
NODE_8584_length_911_cov_173.171182	580	660	406	1	80	0.0125000
NODE_8584_length_911_cov_173.171182	580	660	407	2	80	0.0250000
NODE_8584_length_911_cov_173.171182	580	660	408	1	80	0.0125000
NODE_8584_length_911_cov_173.171182	580	660	412	1	80	0.0125000
NODE_8584_length_911_cov_173.171182	580	660	413	1	80	0.0125000
NODE_8584_length_911_cov_173.171182	580	660	420	1	80	0.0125000
NODE_8584_length_911_cov_173.171182	580	660	421	1	80	0.0125000
NODE_8584_length_911_cov_173.171182	580	660	422	1	80	0.0125000
NODE_8584_length_911_cov_173.171182	580	660	425	1	80	0.0125000
NODE_8584_length_911_cov_173.171182	580	660	427	1	80	0.0125000
NODE_8584_length_911_cov_173.171182	580	660	431	1	80	0.0125000
NODE_8584_length_911_cov_173.171182	580	660	433	1	80	0.0125000
NODE_8584_length_911_cov_173.171182	580	660	442	2	80	0.0250000
NODE_8584_length_911_cov_173.171182	580	660	447	2	80	0.0250000
NODE_8584_length_911_cov_173.171182	580	660	448	3	80	0.0375000
NODE_8584_length_911_cov_173.171182	580	660	449	1	80	0.0125000
NODE_8584_length_911_cov_173.171182	580	660	450	3	80	0.0375000
NODE_8584_length_911_cov_173.171182	580	660	454	2	80	0.0250000
NODE_8584_length_911_cov_173.171182	580	660	457	1	80	0.0125000
NODE_8584_length_911_cov_173.171182	580	660	458	1	80	0.0125000
NODE_8584_length_911_cov_173.171182	580	660	465	1	80	0.0125000
NODE_8584_length_911_cov_173.171182	633	713	404	2	80	0.0250000
NODE_8584_length_911_cov_173.171182	633	713	408	1	80	0.0125000
NODE_8584_length_911_cov_173.171182	633	713	413	1	80	0.0125000
NODE_8584_length_911_cov_173.171182	633	713	420	1	80	0.0125000
NODE_8584_length_911_cov_173.171182	633	713	421	1	80	0.0125000
NODE_8584_length_911_cov_173.171182	633	713	422	1	80	0.0125000
NODE_8584_length_911_cov_173.171182	633	713	425	1	80	0.0125000
NODE_8584_length_911_cov_173.171182	633	713	427	1	80	0.0125000
NODE_8584_length_911_cov_173.171182	633	713	431	1	80	0.0125000
NODE_8584_length_911_cov_173.171182	633	713	433	1	80	0.0125000
NODE_8584_length_911_cov_173.171182	633	713	442	2	80	0.0250000
NODE_8584_length_911_cov_173.171182	633	713	447	2	80	0.0250000
NODE_8584_length_911_cov_173.171182	633	713	448	3	80	0.0375000
NODE_8584_length_911_cov_173.171182	633	713	449	1	80	0.0125000
NODE_8584_length_911_cov_173.171182	633	713	450	3	80	0.0375000
NODE_8584_length_911_cov_173.171182	633	713	454	2	80	0.0250000
NODE_8584_length_911_cov_173.171182	633	713	457	1	80	0.0125000
NODE_8584_length_911_cov_173.171182	633	713	458	1	80	0.0125000
NODE_8584_length_911_cov_173.171182	633	713	465	1	80	0.0125000
NODE_8584_length_911_cov_173.171182	633	713	469	1	80	0.0125000
NODE_8584_length_911_cov_173.171182	633	713	472	1	80	0.0125000
NODE_8584_length_911_cov_173.171182	633	713	480	2	80	0.0250000
NODE_8584_length_911_cov_173.171182	633	713	482	1	80	0.0125000
NODE_8584_length_911_cov_173.171182	633	713	490	1	80	0.0125000
NODE_8584_length_911_cov_173.171182	633	713	502	1	80	0.0125000
NODE_8584_length_911_cov_173.171182	633	713	517	1	80	0.0125000
NODE_8584_length_911_cov_173.171182	633	713	519	4	80	0.0500000
NODE_8584_length_911_cov_173.171182	633	713	521	5	80	0.0625000
NODE_8584_length_911_cov_173.171182	633	713	522	3	80	0.0375000
NODE_8584_length_911_cov_173.171182	633	713	523	1	80	0.0125000
NODE_8584_length_911_cov_173.171182	633	713	524	2	80	0.0250000
NODE_8584_length_911_cov_173.171182	633	713	526	2	80	0.0250000
NODE_8584_length_911_cov_173.171182	633	713	527	2	80	0.0250000
NODE_8584_length_911_cov_173.171182	633	713	528	3	80	0.0375000
NODE_8584_length_911_cov_173.171182	633	713	529	7	80	0.0875000
NODE_8584_length_911_cov_173.171182	633	713	531	3	80	0.0375000
NODE_8584_length_911_cov_173.171182	633	713	533	1	80	0.0125000
NODE_8584_length_911_cov_173.171182	633	713	537	1	80	0.0125000
NODE_8584_length_911_cov_173.171182	633	713	563	1	80	0.0125000
NODE_8584_length_911_cov_173.171182	633	713	564	2	80	0.0250000
NODE_8584_length_911_cov_173.171182	633	713	567	1	80	0.0125000
NODE_8584_length_911_cov_173.171182	633	713	591	1	80	0.0125000
NODE_8584_length_911_cov_173.171182	633	713	593	1	80	0.0125000
NODE_8584_length_911_cov_173.171182	633	713	598	1	80	0.0125000
NODE_8584_length_911_cov_173.171182	633	713	620	1	80	0.0125000
NODE_8584_length_911_cov_173.171182	633	713	627	1	80	0.0125000
NODE_8584_length_911_cov_173.171182	633	713	642	1	80	0.0125000
NODE_8584_length_911_cov_173.171182	633	713	653	1	80	0.0125000
NODE_8585_length_911_cov_88.250000	525	605	12	37	80	0.4625000
NODE_8585_length_911_cov_88.250000	525	605	13	43	80	0.5375000
NODE_8585_length_911_cov_88.250000	578	658	0	50	80	0.6250000
NODE_8585_length_911_cov_88.250000	578	658	12	30	80	0.3750000
NODE_8586_length_911_cov_46.854680	255	335	2	3	80	0.0375000
NODE_8586_length_911_cov_46.854680	255	335	4	12	80	0.1500000
NODE_8586_length_911_cov_46.854680	255	335	10	45	80	0.5625000
NODE_8586_length_911_cov_46.854680	255	335	12	20	80	0.2500000
NODE_8586_length_911_cov_46.854680	308	388	2	42	80	0.5250000
NODE_8586_length_911_cov_46.854680	308	388	8	4	80	0.0500000
NODE_8586_length_911_cov_46.854680	308	388	10	11	80	0.1375000
NODE_8586_length_911_cov_46.854680	308	388	12	23	80	0.2875000
NODE_8586_length_911_cov_46.854680	384	464	0	69	80	0.8625000
NODE_8586_length_911_cov_46.854680	384	464	2	11	80	0.1375000
NODE_8586_length_911_cov_46.854680	437	517	0	80	80	1.0000000
NODE_8587_length_911_cov_31.362069	301	381	2	30	80	0.3750000
NODE_8587_length_911_cov_31.362069	301	381	4	23	80	0.2875000
NODE_8587_length_911_cov_31.362069	301	381	6	21	80	0.2625000
NODE_8587_length_911_cov_31.362069	301	381	8	6	80	0.0750000
NODE_8587_length_911_cov_31.362069	354	434	6	21	80	0.2625000
NODE_8587_length_911_cov_31.362069	354	434	8	59	80	0.7375000
NODE_8588_length_911_cov_19.235222	445	525	2	9	80	0.1125000
NODE_8588_length_911_cov_19.235222	445	525	4	71	80	0.8875000
NODE_8588_length_911_cov_19.235222	498	578	0	15	80	0.1875000
NODE_8588_length_911_cov_19.235222	498	578	2	44	80	0.5500000
NODE_8588_length_911_cov_19.235222	498	578	4	21	80	0.2625000
NODE_8589_length_911_cov_16.230296	233	313	4	18	80	0.2250000
NODE_8589_length_911_cov_16.230296	233	313	6	62	80	0.7750000
NODE_8589_length_911_cov_16.230296	286	366	0	11	80	0.1375000
NODE_8589_length_911_cov_16.230296	286	366	2	40	80	0.5000000
NODE_8589_length_911_cov_16.230296	286	366	4	2	80	0.0250000
NODE_8589_length_911_cov_16.230296	286	366	6	27	80	0.3375000
NODE_8590_length_911_cov_14.979064	472	552	0	80	80	1.0000000
NODE_8590_length_911_cov_14.979064	525	605	0	80	80	1.0000000
NODE_8591_length_911_cov_12.089901	357	409	0	43	52	0.8269231
NODE_8591_length_911_cov_12.089901	357	409	2	9	52	0.1730769
NODE_8591_length_911_cov_12.089901	401	462	0	61	61	1.0000000
NODE_8606_length_910_cov_27.838471	347	427	4	27	80	0.3375000
NODE_8606_length_910_cov_27.838471	347	427	6	25	80	0.3125000
NODE_8606_length_910_cov_27.838471	347	427	8	28	80	0.3500000
NODE_8606_length_910_cov_27.838471	400	480	0	11	80	0.1375000
NODE_8606_length_910_cov_27.838471	400	480	4	64	80	0.8000000
NODE_8606_length_910_cov_27.838471	400	480	6	5	80	0.0625000
NODE_8607_length_910_cov_25.895191	361	441	10	10	80	0.1250000
NODE_8607_length_910_cov_25.895191	361	441	12	65	80	0.8125000
NODE_8607_length_910_cov_25.895191	361	441	14	5	80	0.0625000
NODE_8607_length_910_cov_25.895191	414	494	2	4	80	0.0500000
NODE_8607_length_910_cov_25.895191	414	494	4	5	80	0.0625000
NODE_8607_length_910_cov_25.895191	414	494	6	26	80	0.3250000
NODE_8607_length_910_cov_25.895191	414	494	8	13	80	0.1625000
NODE_8607_length_910_cov_25.895191	414	494	10	7	80	0.0875000
NODE_8607_length_910_cov_25.895191	414	494	12	25	80	0.3125000
NODE_8608_length_910_cov_25.604192	294	374	0	19	80	0.2375000
NODE_8608_length_910_cov_25.604192	294	374	2	32	80	0.4000000
NODE_8608_length_910_cov_25.604192	294	374	4	29	80	0.3625000
NODE_8608_length_910_cov_25.604192	347	427	0	72	80	0.9000000
NODE_8608_length_910_cov_25.604192	347	427	2	8	80	0.1000000
NODE_8608_length_910_cov_25.604192	423	503	0	18	80	0.2250000
NODE_8608_length_910_cov_25.604192	423	503	2	7	80	0.0875000
NODE_8608_length_910_cov_25.604192	423	503	6	27	80	0.3375000
NODE_8608_length_910_cov_25.604192	423	503	8	1	80	0.0125000
NODE_8608_length_910_cov_25.604192	423	503	10	27	80	0.3375000
NODE_8608_length_910_cov_25.604192	476	556	8	28	80	0.3500000
NODE_8608_length_910_cov_25.604192	476	556	10	52	80	0.6500000
NODE_8609_length_910_cov_16.066584	656	736	2	16	80	0.2000000
NODE_8609_length_910_cov_16.066584	656	736	4	36	80	0.4500000
NODE_8609_length_910_cov_16.066584	656	736	6	28	80	0.3500000
NODE_8609_length_910_cov_16.066584	709	789	4	51	80	0.6375000
NODE_8609_length_910_cov_16.066584	709	789	6	29	80	0.3625000
NODE_8610_length_910_cov_14.696671	417	497	2	40	80	0.5000000
NODE_8610_length_910_cov_14.696671	417	497	4	5	80	0.0625000
NODE_8610_length_910_cov_14.696671	417	497	6	35	80	0.4375000
NODE_8610_length_910_cov_14.696671	470	550	2	41	80	0.5125000
NODE_8610_length_910_cov_14.696671	470	550	4	9	80	0.1125000
NODE_8610_length_910_cov_14.696671	470	550	6	30	80	0.3750000
NODE_8612_length_910_cov_7.114673	442	522	2	31	80	0.3875000
NODE_8612_length_910_cov_7.114673	442	522	3	2	80	0.0250000
NODE_8612_length_910_cov_7.114673	442	522	5	47	80	0.5875000
NODE_8612_length_910_cov_7.114673	495	575	0	10	80	0.1250000
NODE_8612_length_910_cov_7.114673	495	575	3	12	80	0.1500000
NODE_8612_length_910_cov_7.114673	495	575	4	33	80	0.4125000
NODE_8612_length_910_cov_7.114673	495	575	5	25	80	0.3125000
NODE_8614_length_910_cov_2.992602	196	269	8	27	73	0.3698630
NODE_8614_length_910_cov_2.992602	196	269	10	11	73	0.1506849
NODE_8614_length_910_cov_2.992602	196	269	12	26	73	0.3561644
NODE_8614_length_910_cov_2.992602	196	269	14	4	73	0.0547945
NODE_8614_length_910_cov_2.992602	196	269	16	5	73	0.0684932
NODE_8614_length_910_cov_2.992602	249	329	10	2	80	0.0250000
NODE_8614_length_910_cov_2.992602	249	329	12	9	80	0.1125000
NODE_8614_length_910_cov_2.992602	249	329	14	4	80	0.0500000
NODE_8614_length_910_cov_2.992602	249	329	16	21	80	0.2625000
NODE_8614_length_910_cov_2.992602	249	329	17	7	80	0.0875000
NODE_8614_length_910_cov_2.992602	249	329	18	5	80	0.0625000
NODE_8614_length_910_cov_2.992602	249	329	20	8	80	0.1000000
NODE_8614_length_910_cov_2.992602	249	329	22	4	80	0.0500000
NODE_8614_length_910_cov_2.992602	249	329	24	8	80	0.1000000
NODE_8614_length_910_cov_2.992602	249	329	26	1	80	0.0125000
NODE_8614_length_910_cov_2.992602	249	329	28	11	80	0.1375000
NODE_8614_length_910_cov_2.992602	386	439	14	2	53	0.0377358
NODE_8614_length_910_cov_2.992602	386	439	16	4	53	0.0754717
NODE_8614_length_910_cov_2.992602	386	439	18	3	53	0.0566038
NODE_8614_length_910_cov_2.992602	386	439	20	32	53	0.6037736
NODE_8614_length_910_cov_2.992602	386	439	22	12	53	0.2264151
NODE_8623_length_909_cov_35.291358	426	506	0	7	80	0.0875000
NODE_8623_length_909_cov_35.291358	426	506	1	1	80	0.0125000
NODE_8623_length_909_cov_35.291358	426	506	2	72	80	0.9000000
NODE_8623_length_909_cov_35.291358	479	559	0	60	80	0.7500000
NODE_8623_length_909_cov_35.291358	479	559	1	1	80	0.0125000
NODE_8623_length_909_cov_35.291358	479	559	2	19	80	0.2375000
NODE_8624_length_909_cov_27.449383	311	391	0	2	80	0.0250000
NODE_8624_length_909_cov_27.449383	311	391	2	7	80	0.0875000
NODE_8624_length_909_cov_27.449383	311	391	3	10	80	0.1250000
NODE_8624_length_909_cov_27.449383	311	391	4	61	80	0.7625000
NODE_8624_length_909_cov_27.449383	364	444	2	20	80	0.2500000
NODE_8624_length_909_cov_27.449383	364	444	4	60	80	0.7500000
NODE_8625_length_909_cov_25.212346	295	375	0	32	80	0.4000000
NODE_8625_length_909_cov_25.212346	295	375	2	19	80	0.2375000
NODE_8625_length_909_cov_25.212346	295	375	4	4	80	0.0500000
NODE_8625_length_909_cov_25.212346	295	375	6	5	80	0.0625000
NODE_8625_length_909_cov_25.212346	295	375	9	1	80	0.0125000
NODE_8625_length_909_cov_25.212346	295	375	10	19	80	0.2375000
NODE_8625_length_909_cov_25.212346	348	428	4	2	80	0.0250000
NODE_8625_length_909_cov_25.212346	348	428	6	5	80	0.0625000
NODE_8625_length_909_cov_25.212346	348	428	9	1	80	0.0125000
NODE_8625_length_909_cov_25.212346	348	428	10	72	80	0.9000000
NODE_8626_length_909_cov_23.604938	403	483	4	7	80	0.0875000
NODE_8626_length_909_cov_23.604938	403	483	6	25	80	0.3125000
NODE_8626_length_909_cov_23.604938	403	483	8	48	80	0.6000000
NODE_8626_length_909_cov_23.604938	456	536	0	6	80	0.0750000
NODE_8626_length_909_cov_23.604938	456	536	2	1	80	0.0125000
NODE_8626_length_909_cov_23.604938	456	536	4	21	80	0.2625000
NODE_8626_length_909_cov_23.604938	456	536	6	34	80	0.4250000
NODE_8626_length_909_cov_23.604938	456	536	8	18	80	0.2250000
NODE_8627_length_909_cov_19.070370	441	521	0	32	80	0.4000000
NODE_8627_length_909_cov_19.070370	441	521	3	1	80	0.0125000
NODE_8627_length_909_cov_19.070370	441	521	4	47	80	0.5875000
NODE_8627_length_909_cov_19.070370	494	574	0	13	80	0.1625000
NODE_8627_length_909_cov_19.070370	494	574	4	67	80	0.8375000
NODE_8628_length_909_cov_11.533333	332	412	4	8	80	0.1000000
NODE_8628_length_909_cov_11.533333	332	412	6	20	80	0.2500000
NODE_8628_length_909_cov_11.533333	332	412	8	52	80	0.6500000
NODE_8628_length_909_cov_11.533333	385	465	0	21	80	0.2625000
NODE_8628_length_909_cov_11.533333	385	465	2	10	80	0.1250000
NODE_8628_length_909_cov_11.533333	385	465	4	30	80	0.3750000
NODE_8628_length_909_cov_11.533333	385	465	8	19	80	0.2375000
NODE_8629_length_909_cov_10.229630	497	577	0	80	80	1.0000000
NODE_8629_length_909_cov_10.229630	550	622	0	72	72	1.0000000
NODE_8631_length_909_cov_7.122222	328	408	0	80	80	1.0000000
NODE_8631_length_909_cov_7.122222	381	461	0	80	80	1.0000000
NODE_8632_length_909_cov_4.664198	775	855	6	17	80	0.2125000
NODE_8632_length_909_cov_4.664198	775	855	7	15	80	0.1875000
NODE_8632_length_909_cov_4.664198	775	855	9	9	80	0.1125000
NODE_8632_length_909_cov_4.664198	775	855	12	4	80	0.0500000
NODE_8632_length_909_cov_4.664198	775	855	14	28	80	0.3500000
NODE_8632_length_909_cov_4.664198	775	855	16	7	80	0.0875000
NODE_8632_length_909_cov_4.664198	828	885	0	3	57	0.0526316
NODE_8632_length_909_cov_4.664198	828	885	2	1	57	0.0175439
NODE_8632_length_909_cov_4.664198	828	885	4	16	57	0.2807018
NODE_8632_length_909_cov_4.664198	828	885	6	27	57	0.4736842
NODE_8632_length_909_cov_4.664198	828	885	7	10	57	0.1754386
NODE_8644_length_908_cov_55.546354	409	489	0	14	80	0.1750000
NODE_8644_length_908_cov_55.546354	409	489	2	28	80	0.3500000
NODE_8644_length_908_cov_55.546354	409	489	3	2	80	0.0250000
NODE_8644_length_908_cov_55.546354	409	489	4	36	80	0.4500000
NODE_8644_length_908_cov_55.546354	462	542	0	67	80	0.8375000
NODE_8644_length_908_cov_55.546354	462	542	2	13	80	0.1625000
NODE_8645_length_908_cov_18.720643	329	409	0	10	80	0.1250000
NODE_8645_length_908_cov_18.720643	329	409	5	33	80	0.4125000
NODE_8645_length_908_cov_18.720643	329	409	6	37	80	0.4625000
NODE_8645_length_908_cov_18.720643	382	462	5	80	80	1.0000000
NODE_8646_length_908_cov_14.640297	430	510	0	3	80	0.0375000
NODE_8646_length_908_cov_14.640297	430	510	2	9	80	0.1125000
NODE_8646_length_908_cov_14.640297	430	510	3	68	80	0.8500000
NODE_8646_length_908_cov_14.640297	483	562	0	7	79	0.0886076
NODE_8646_length_908_cov_14.640297	483	562	2	57	79	0.7215190
NODE_8646_length_908_cov_14.640297	483	562	3	15	79	0.1898734
NODE_8648_length_908_cov_10.789864	370	450	0	29	80	0.3625000
NODE_8648_length_908_cov_10.789864	370	450	2	51	80	0.6375000
NODE_8648_length_908_cov_10.789864	423	503	0	31	80	0.3875000
NODE_8648_length_908_cov_10.789864	423	503	2	49	80	0.6125000
NODE_8651_length_908_cov_3.737948	251	331	0	40	80	0.5000000
NODE_8651_length_908_cov_3.737948	251	331	2	40	80	0.5000000
NODE_8651_length_908_cov_3.737948	304	384	2	80	80	1.0000000
NODE_8664_length_907_cov_22.110149	459	539	0	80	80	1.0000000
NODE_8664_length_907_cov_22.110149	512	592	0	80	80	1.0000000
NODE_8665_length_907_cov_20.943069	410	490	0	44	80	0.5500000
NODE_8665_length_907_cov_20.943069	410	490	2	36	80	0.4500000
NODE_8665_length_907_cov_20.943069	463	543	2	80	80	1.0000000
NODE_8666_length_907_cov_19.519802	411	488	0	77	77	1.0000000
NODE_8666_length_907_cov_19.519802	461	541	0	80	80	1.0000000
NODE_8667_length_907_cov_17.928218	329	405	0	19	76	0.2500000
NODE_8667_length_907_cov_17.928218	329	405	2	22	76	0.2894737
NODE_8667_length_907_cov_17.928218	329	405	4	35	76	0.4605263
NODE_8667_length_907_cov_17.928218	382	462	0	7	80	0.0875000
NODE_8667_length_907_cov_17.928218	382	462	2	22	80	0.2750000
NODE_8667_length_907_cov_17.928218	382	462	4	51	80	0.6375000
NODE_8668_length_907_cov_13.060644	293	373	0	23	80	0.2875000
NODE_8668_length_907_cov_13.060644	293	373	2	57	80	0.7125000
NODE_8668_length_907_cov_13.060644	346	426	0	76	80	0.9500000
NODE_8668_length_907_cov_13.060644	346	426	2	4	80	0.0500000
NODE_8669_length_907_cov_11.155941	401	462	12	52	61	0.8524590
NODE_8669_length_907_cov_11.155941	401	462	16	9	61	0.1475410
NODE_8669_length_907_cov_11.155941	607	687	0	80	80	1.0000000
NODE_8670_length_907_cov_9.237624	247	327	0	80	80	1.0000000
NODE_8670_length_907_cov_9.237624	300	380	0	80	80	1.0000000
NODE_8671_length_907_cov_8.686881	275	365	0	71	90	0.7888889
NODE_8671_length_907_cov_8.686881	275	365	7	6	90	0.0666667
NODE_8671_length_907_cov_8.686881	275	365	8	13	90	0.1444445
NODE_8671_length_907_cov_8.686881	338	418	0	8	80	0.1000000
NODE_8671_length_907_cov_8.686881	338	418	7	6	80	0.0750000
NODE_8671_length_907_cov_8.686881	338	418	8	20	80	0.2500000
NODE_8671_length_907_cov_8.686881	338	418	10	46	80	0.5750000
NODE_8680_length_907_cov_2.949257	503	526	0	23	23	1.0000000
NODE_8686_length_906_cov_32.369269	447	527	4	76	80	0.9500000
NODE_8686_length_906_cov_32.369269	447	527	6	4	80	0.0500000
NODE_8686_length_906_cov_32.369269	500	580	2	47	80	0.5875000
NODE_8686_length_906_cov_32.369269	500	580	4	29	80	0.3625000
NODE_8686_length_906_cov_32.369269	500	580	6	4	80	0.0500000
NODE_8687_length_906_cov_23.594796	196	276	12	18	80	0.2250000
NODE_8687_length_906_cov_23.594796	196	276	13	3	80	0.0375000
NODE_8687_length_906_cov_23.594796	196	276	14	58	80	0.7250000
NODE_8687_length_906_cov_23.594796	196	276	16	1	80	0.0125000
NODE_8687_length_906_cov_23.594796	249	329	2	41	80	0.5125000
NODE_8687_length_906_cov_23.594796	249	329	4	10	80	0.1250000
NODE_8687_length_906_cov_23.594796	249	329	12	20	80	0.2500000
NODE_8687_length_906_cov_23.594796	249	329	13	3	80	0.0375000
NODE_8687_length_906_cov_23.594796	249	329	14	6	80	0.0750000
NODE_8688_length_906_cov_21.443618	404	484	2	47	80	0.5875000
NODE_8688_length_906_cov_21.443618	404	484	4	15	80	0.1875000
NODE_8688_length_906_cov_21.443618	404	484	5	6	80	0.0750000
NODE_8688_length_906_cov_21.443618	404	484	6	12	80	0.1500000
NODE_8688_length_906_cov_21.443618	457	537	4	9	80	0.1125000
NODE_8688_length_906_cov_21.443618	457	537	5	6	80	0.0750000
NODE_8688_length_906_cov_21.443618	457	537	6	65	80	0.8125000
NODE_8689_length_906_cov_20.596035	593	634	0	41	41	1.0000000
NODE_8690_length_906_cov_20.429988	410	490	0	52	80	0.6500000
NODE_8690_length_906_cov_20.429988	410	490	2	28	80	0.3500000
NODE_8690_length_906_cov_20.429988	463	543	2	80	80	1.0000000
NODE_8691_length_906_cov_20.395291	523	603	2	80	80	1.0000000
NODE_8691_length_906_cov_20.395291	576	656	0	47	80	0.5875000
NODE_8691_length_906_cov_20.395291	576	656	2	33	80	0.4125000
NODE_8692_length_906_cov_19.297398	255	335	0	15	80	0.1875000
NODE_8692_length_906_cov_19.297398	255	335	2	65	80	0.8125000
NODE_8692_length_906_cov_19.297398	308	388	0	68	80	0.8500000
NODE_8692_length_906_cov_19.297398	308	388	2	12	80	0.1500000
NODE_8693_length_906_cov_18.505576	357	437	0	50	80	0.6250000
NODE_8693_length_906_cov_18.505576	357	437	2	30	80	0.3750000
NODE_8693_length_906_cov_18.505576	410	490	2	80	80	1.0000000
NODE_8694_length_906_cov_10.068154	191	271	0	80	80	1.0000000
NODE_8694_length_906_cov_10.068154	244	324	0	80	80	1.0000000
NODE_8695_length_906_cov_10.006196	304	384	0	80	80	1.0000000
NODE_8695_length_906_cov_10.006196	357	437	0	30	80	0.3750000
NODE_8695_length_906_cov_10.006196	357	437	1	7	80	0.0875000
NODE_8695_length_906_cov_10.006196	357	437	2	43	80	0.5375000
NODE_8696_length_906_cov_8.562577	370	454	0	84	84	1.0000000
NODE_8696_length_906_cov_8.562577	423	507	0	84	84	1.0000000
NODE_8716_length_905_cov_39.203474	406	486	0	40	80	0.5000000
NODE_8716_length_905_cov_39.203474	406	486	3	40	80	0.5000000
NODE_8716_length_905_cov_39.203474	459	539	0	9	80	0.1125000
NODE_8716_length_905_cov_39.203474	459	539	2	1	80	0.0125000
NODE_8716_length_905_cov_39.203474	459	539	3	70	80	0.8750000
NODE_8717_length_905_cov_37.053350	411	491	2	11	80	0.1375000
NODE_8717_length_905_cov_37.053350	411	491	4	69	80	0.8625000
NODE_8717_length_905_cov_37.053350	464	544	0	42	80	0.5250000
NODE_8717_length_905_cov_37.053350	464	544	2	22	80	0.2750000
NODE_8717_length_905_cov_37.053350	464	544	4	16	80	0.2000000
NODE_8718_length_905_cov_27.426799	288	368	3	25	80	0.3125000
NODE_8718_length_905_cov_27.426799	288	368	5	55	80	0.6875000
NODE_8718_length_905_cov_27.426799	341	421	3	7	80	0.0875000
NODE_8718_length_905_cov_27.426799	341	421	4	6	80	0.0750000
NODE_8718_length_905_cov_27.426799	341	421	5	67	80	0.8375000
NODE_8719_length_905_cov_26.332506	375	455	0	29	80	0.3625000
NODE_8719_length_905_cov_26.332506	375	455	1	51	80	0.6375000
NODE_8719_length_905_cov_26.332506	428	508	1	80	80	1.0000000
NODE_8720_length_905_cov_20.651365	377	457	0	47	80	0.5875000
NODE_8720_length_905_cov_20.651365	377	457	2	33	80	0.4125000
NODE_8720_length_905_cov_20.651365	430	510	0	4	80	0.0500000
NODE_8720_length_905_cov_20.651365	430	510	2	76	80	0.9500000
NODE_8721_length_905_cov_19.718362	365	445	0	80	80	1.0000000
NODE_8721_length_905_cov_19.718362	418	498	0	80	80	1.0000000
NODE_8722_length_905_cov_13.696030	366	420	2	54	54	1.0000000
NODE_8723_length_905_cov_9.978908	222	302	0	49	80	0.6125000
NODE_8723_length_905_cov_9.978908	222	302	2	31	80	0.3875000
NODE_8723_length_905_cov_9.978908	275	355	0	80	80	1.0000000
NODE_8725_length_905_cov_7.980149	321	401	0	74	80	0.9250000
NODE_8725_length_905_cov_7.980149	321	401	2	6	80	0.0750000
NODE_8725_length_905_cov_7.980149	374	454	0	21	80	0.2625000
NODE_8725_length_905_cov_7.980149	374	454	2	59	80	0.7375000
NODE_8727_length_905_cov_6.064516	459	539	0	46	80	0.5750000
NODE_8727_length_905_cov_6.064516	459	539	4	34	80	0.4250000
NODE_8727_length_905_cov_6.064516	512	592	0	33	80	0.4125000
NODE_8727_length_905_cov_6.064516	512	592	2	47	80	0.5875000
NODE_8742_length_905_cov_1.040943	73	119	26	33	46	0.7173913
NODE_8742_length_905_cov_1.040943	73	119	28	13	46	0.2826087
NODE_8742_length_905_cov_1.040943	126	172	3	1	46	0.0217391
NODE_8742_length_905_cov_1.040943	126	172	5	4	46	0.0869565
NODE_8742_length_905_cov_1.040943	126	172	7	9	46	0.1956522
NODE_8742_length_905_cov_1.040943	126	172	12	9	46	0.1956522
NODE_8742_length_905_cov_1.040943	126	172	15	1	46	0.0217391
NODE_8742_length_905_cov_1.040943	126	172	16	8	46	0.1739130
NODE_8742_length_905_cov_1.040943	126	172	18	1	46	0.0217391
NODE_8742_length_905_cov_1.040943	126	172	20	7	46	0.1521739
NODE_8742_length_905_cov_1.040943	126	172	22	2	46	0.0434783
NODE_8742_length_905_cov_1.040943	126	172	24	3	46	0.0652174
NODE_8742_length_905_cov_1.040943	126	172	26	1	46	0.0217391
NODE_8743_length_904_cov_29.532919	338	418	0	74	80	0.9250000
NODE_8743_length_904_cov_29.532919	338	418	2	6	80	0.0750000
NODE_8743_length_904_cov_29.532919	391	471	0	80	80	1.0000000
NODE_8743_length_904_cov_29.532919	467	547	0	80	80	1.0000000
NODE_8743_length_904_cov_29.532919	520	600	0	80	80	1.0000000
NODE_8744_length_904_cov_28.844720	371	451	0	28	80	0.3500000
NODE_8744_length_904_cov_28.844720	371	451	4	45	80	0.5625000
NODE_8744_length_904_cov_28.844720	371	451	6	7	80	0.0875000
NODE_8744_length_904_cov_28.844720	424	504	2	29	80	0.3625000
NODE_8744_length_904_cov_28.844720	424	504	4	20	80	0.2500000
NODE_8744_length_904_cov_28.844720	424	504	5	1	80	0.0125000
NODE_8744_length_904_cov_28.844720	424	504	6	30	80	0.3750000
NODE_8745_length_904_cov_26.977640	488	568	0	80	80	1.0000000
NODE_8745_length_904_cov_26.977640	541	621	0	80	80	1.0000000
NODE_8746_length_904_cov_24.529193	464	544	0	80	80	1.0000000
NODE_8746_length_904_cov_24.529193	517	597	0	80	80	1.0000000
NODE_8747_length_904_cov_24.452174	507	587	0	4	80	0.0500000
NODE_8747_length_904_cov_24.452174	507	587	2	76	80	0.9500000
NODE_8747_length_904_cov_24.452174	560	640	0	27	80	0.3375000
NODE_8747_length_904_cov_24.452174	560	640	2	53	80	0.6625000
NODE_8748_length_904_cov_19.649689	307	387	2	80	80	1.0000000
NODE_8748_length_904_cov_19.649689	360	440	0	32	80	0.4000000
NODE_8748_length_904_cov_19.649689	360	440	2	48	80	0.6000000
NODE_8748_length_904_cov_19.649689	595	675	2	80	80	1.0000000
NODE_8748_length_904_cov_19.649689	648	728	0	36	80	0.4500000
NODE_8748_length_904_cov_19.649689	648	728	2	44	80	0.5500000
NODE_8750_length_904_cov_16.608696	252	332	0	80	80	1.0000000
NODE_8750_length_904_cov_16.608696	305	385	0	80	80	1.0000000
NODE_8750_length_904_cov_16.608696	381	461	0	16	80	0.2000000
NODE_8750_length_904_cov_16.608696	381	461	2	64	80	0.8000000
NODE_8750_length_904_cov_16.608696	434	514	2	55	80	0.6875000
NODE_8750_length_904_cov_16.608696	434	514	4	8	80	0.1000000
NODE_8750_length_904_cov_16.608696	434	514	6	17	80	0.2125000
NODE_8751_length_904_cov_15.811180	431	511	0	71	80	0.8875000
NODE_8751_length_904_cov_15.811180	431	511	2	9	80	0.1125000
NODE_8751_length_904_cov_15.811180	484	564	0	18	80	0.2250000
NODE_8751_length_904_cov_15.811180	484	564	2	62	80	0.7750000
NODE_8752_length_904_cov_9.249689	581	661	0	80	80	1.0000000
NODE_8752_length_904_cov_9.249689	634	714	0	80	80	1.0000000
NODE_8756_length_904_cov_4.772671	318	398	0	80	80	1.0000000
NODE_8756_length_904_cov_4.772671	371	451	0	80	80	1.0000000
NODE_8773_length_903_cov_58.723881	386	466	10	8	80	0.1000000
NODE_8773_length_903_cov_58.723881	386	466	16	3	80	0.0375000
NODE_8773_length_903_cov_58.723881	386	466	18	14	80	0.1750000
NODE_8773_length_903_cov_58.723881	386	466	21	1	80	0.0125000
NODE_8773_length_903_cov_58.723881	386	466	23	2	80	0.0250000
NODE_8773_length_903_cov_58.723881	386	466	25	11	80	0.1375000
NODE_8773_length_903_cov_58.723881	386	466	26	13	80	0.1625000
NODE_8773_length_903_cov_58.723881	386	466	29	6	80	0.0750000
NODE_8773_length_903_cov_58.723881	386	466	30	1	80	0.0125000
NODE_8773_length_903_cov_58.723881	386	466	31	3	80	0.0375000
NODE_8773_length_903_cov_58.723881	386	466	33	16	80	0.2000000
NODE_8773_length_903_cov_58.723881	386	466	35	2	80	0.0250000
NODE_8773_length_903_cov_58.723881	439	519	13	5	80	0.0625000
NODE_8773_length_903_cov_58.723881	439	519	15	1	80	0.0125000
NODE_8773_length_903_cov_58.723881	439	519	19	31	80	0.3875000
NODE_8773_length_903_cov_58.723881	439	519	21	2	80	0.0250000
NODE_8773_length_903_cov_58.723881	439	519	25	3	80	0.0375000
NODE_8773_length_903_cov_58.723881	439	519	27	8	80	0.1000000
NODE_8773_length_903_cov_58.723881	439	519	29	9	80	0.1125000
NODE_8773_length_903_cov_58.723881	439	519	31	3	80	0.0375000
NODE_8773_length_903_cov_58.723881	439	519	33	16	80	0.2000000
NODE_8773_length_903_cov_58.723881	439	519	35	2	80	0.0250000
NODE_8773_length_903_cov_58.723881	515	595	4	19	80	0.2375000
NODE_8773_length_903_cov_58.723881	515	595	5	11	80	0.1375000
NODE_8773_length_903_cov_58.723881	515	595	11	4	80	0.0500000
NODE_8773_length_903_cov_58.723881	515	595	12	11	80	0.1375000
NODE_8773_length_903_cov_58.723881	515	595	13	6	80	0.0750000
NODE_8773_length_903_cov_58.723881	515	595	14	20	80	0.2500000
NODE_8773_length_903_cov_58.723881	515	595	15	9	80	0.1125000
NODE_8773_length_903_cov_58.723881	568	648	4	72	80	0.9000000
NODE_8773_length_903_cov_58.723881	568	648	5	8	80	0.1000000
NODE_8774_length_903_cov_41.298507	397	477	4	43	80	0.5375000
NODE_8774_length_903_cov_41.298507	397	477	6	37	80	0.4625000
NODE_8774_length_903_cov_41.298507	450	530	0	9	80	0.1125000
NODE_8774_length_903_cov_41.298507	450	530	4	71	80	0.8875000
NODE_8775_length_903_cov_28.691542	394	474	0	80	80	1.0000000
NODE_8775_length_903_cov_28.691542	447	527	0	80	80	1.0000000
NODE_8776_length_903_cov_26.276119	441	521	2	3	80	0.0375000
NODE_8776_length_903_cov_26.276119	441	521	4	73	80	0.9125000
NODE_8776_length_903_cov_26.276119	441	521	5	4	80	0.0500000
NODE_8776_length_903_cov_26.276119	494	574	2	3	80	0.0375000
NODE_8776_length_903_cov_26.276119	494	574	4	20	80	0.2500000
NODE_8776_length_903_cov_26.276119	494	574	5	14	80	0.1750000
NODE_8776_length_903_cov_26.276119	494	574	6	27	80	0.3375000
NODE_8776_length_903_cov_26.276119	494	574	7	16	80	0.2000000
NODE_8778_length_903_cov_18.166667	351	431	0	80	80	1.0000000
NODE_8778_length_903_cov_18.166667	404	484	0	80	80	1.0000000
NODE_8779_length_903_cov_15.460199	440	520	0	5	80	0.0625000
NODE_8779_length_903_cov_15.460199	440	520	2	75	80	0.9375000
NODE_8779_length_903_cov_15.460199	493	573	1	1	80	0.0125000
NODE_8779_length_903_cov_15.460199	493	573	2	55	80	0.6875000
NODE_8779_length_903_cov_15.460199	493	573	3	15	80	0.1875000
NODE_8779_length_903_cov_15.460199	493	573	4	9	80	0.1125000
NODE_8780_length_903_cov_15.084577	352	432	0	80	80	1.0000000
NODE_8780_length_903_cov_15.084577	405	485	0	80	80	1.0000000
NODE_8781_length_903_cov_15.070896	367	447	0	28	80	0.3500000
NODE_8781_length_903_cov_15.070896	367	447	2	52	80	0.6500000
NODE_8781_length_903_cov_15.070896	420	500	0	80	80	1.0000000
NODE_8782_length_903_cov_14.004975	318	399	2	20	81	0.2469136
NODE_8782_length_903_cov_14.004975	318	399	4	22	81	0.2716049
NODE_8782_length_903_cov_14.004975	318	399	6	39	81	0.4814815
NODE_8782_length_903_cov_14.004975	372	452	4	5	80	0.0625000
NODE_8782_length_903_cov_14.004975	372	452	6	66	80	0.8250000
NODE_8782_length_903_cov_14.004975	372	452	8	9	80	0.1125000
NODE_8783_length_903_cov_10.546020	150	230	0	49	80	0.6125000
NODE_8783_length_903_cov_10.546020	150	230	2	31	80	0.3875000
NODE_8783_length_903_cov_10.546020	203	283	0	80	80	1.0000000
NODE_8784_length_903_cov_9.288557	373	453	0	2	80	0.0250000
NODE_8784_length_903_cov_9.288557	373	453	2	14	80	0.1750000
NODE_8784_length_903_cov_9.288557	373	453	4	64	80	0.8000000
NODE_8784_length_903_cov_9.288557	426	506	0	55	80	0.6875000
NODE_8784_length_903_cov_9.288557	426	506	2	14	80	0.1750000
NODE_8784_length_903_cov_9.288557	426	506	4	11	80	0.1375000
NODE_8785_length_903_cov_8.052239	439	519	0	80	80	1.0000000
NODE_8785_length_903_cov_8.052239	492	572	0	80	80	1.0000000
NODE_8798_length_902_cov_64.459527	355	435	0	80	80	1.0000000
NODE_8798_length_902_cov_64.459527	408	488	0	80	80	1.0000000
NODE_8798_length_902_cov_64.459527	484	564	0	64	80	0.8000000
NODE_8798_length_902_cov_64.459527	484	564	2	16	80	0.2000000
NODE_8798_length_902_cov_64.459527	537	617	0	11	80	0.1375000
NODE_8798_length_902_cov_64.459527	537	617	2	69	80	0.8625000
NODE_8799_length_902_cov_60.823163	395	475	0	6	80	0.0750000
NODE_8799_length_902_cov_60.823163	395	475	2	74	80	0.9250000
NODE_8799_length_902_cov_60.823163	448	528	0	6	80	0.0750000
NODE_8799_length_902_cov_60.823163	448	528	2	74	80	0.9250000
NODE_8800_length_902_cov_44.002491	383	463	0	6	80	0.0750000
NODE_8800_length_902_cov_44.002491	383	463	4	27	80	0.3375000
NODE_8800_length_902_cov_44.002491	383	463	5	1	80	0.0125000
NODE_8800_length_902_cov_44.002491	383	463	6	46	80	0.5750000
NODE_8800_length_902_cov_44.002491	436	516	2	28	80	0.3500000
NODE_8800_length_902_cov_44.002491	436	516	6	52	80	0.6500000
NODE_8801_length_902_cov_41.059776	378	458	6	80	80	1.0000000
NODE_8801_length_902_cov_41.059776	431	511	0	43	80	0.5375000
NODE_8801_length_902_cov_41.059776	431	511	6	37	80	0.4625000
NODE_8802_length_902_cov_38.952677	372	452	0	80	80	1.0000000
NODE_8802_length_902_cov_38.952677	425	505	0	80	80	1.0000000
NODE_8803_length_902_cov_34.156912	373	453	2	80	80	1.0000000
NODE_8803_length_902_cov_34.156912	426	506	0	4	80	0.0500000
NODE_8803_length_902_cov_34.156912	426	506	2	76	80	0.9500000
NODE_8804_length_902_cov_23.007472	295	375	0	25	80	0.3125000
NODE_8804_length_902_cov_23.007472	295	375	2	2	80	0.0250000
NODE_8804_length_902_cov_23.007472	295	375	4	20	80	0.2500000
NODE_8804_length_902_cov_23.007472	295	375	6	33	80	0.4125000
NODE_8804_length_902_cov_23.007472	348	428	6	80	80	1.0000000
NODE_8805_length_902_cov_19.491905	238	291	0	1	53	0.0188679
NODE_8805_length_902_cov_19.491905	238	291	2	18	53	0.3396226
NODE_8805_length_902_cov_19.491905	238	291	8	3	53	0.0566038
NODE_8805_length_902_cov_19.491905	238	291	10	12	53	0.2264151
NODE_8805_length_902_cov_19.491905	238	291	12	19	53	0.3584906
NODE_8805_length_902_cov_19.491905	264	344	10	8	80	0.1000000
NODE_8805_length_902_cov_19.491905	264	344	12	69	80	0.8625000
NODE_8805_length_902_cov_19.491905	264	344	14	3	80	0.0375000
NODE_8806_length_902_cov_10.794521	214	294	0	80	80	1.0000000
NODE_8806_length_902_cov_10.794521	267	347	0	80	80	1.0000000
NODE_8807_length_902_cov_9.520548	518	598	0	39	80	0.4875000
NODE_8807_length_902_cov_9.520548	518	598	4	41	80	0.5125000
NODE_8807_length_902_cov_9.520548	571	651	4	73	80	0.9125000
NODE_8807_length_902_cov_9.520548	571	651	6	7	80	0.0875000
NODE_8808_length_902_cov_8.323786	337	417	2	62	80	0.7750000
NODE_8808_length_902_cov_8.323786	337	417	4	18	80	0.2250000
NODE_8808_length_902_cov_8.323786	390	470	2	67	80	0.8375000
NODE_8808_length_902_cov_8.323786	390	470	4	13	80	0.1625000
NODE_8811_length_902_cov_7.300125	434	514	0	80	80	1.0000000
NODE_8811_length_902_cov_7.300125	487	567	0	80	80	1.0000000
NODE_8812_length_902_cov_4.185554	505	585	0	16	80	0.2000000
NODE_8812_length_902_cov_4.185554	505	585	1	3	80	0.0375000
NODE_8812_length_902_cov_4.185554	505	585	2	61	80	0.7625000
NODE_8812_length_902_cov_4.185554	558	588	0	19	30	0.6333333
NODE_8812_length_902_cov_4.185554	558	588	1	3	30	0.1000000
NODE_8812_length_902_cov_4.185554	558	588	2	8	30	0.2666667
NODE_8812_length_902_cov_4.185554	610	662	0	52	52	1.0000000
NODE_8830_length_902_cov_0.963885	82	106	0	24	24	1.0000000
NODE_8832_length_901_cov_36.066085	412	490	6	1	78	0.0128205
NODE_8832_length_901_cov_36.066085	412	490	9	11	78	0.1410256
NODE_8832_length_901_cov_36.066085	412	490	10	66	78	0.8461539
NODE_8832_length_901_cov_36.066085	463	543	0	20	80	0.2500000
NODE_8832_length_901_cov_36.066085	463	543	2	8	80	0.1000000
NODE_8832_length_901_cov_36.066085	463	543	5	4	80	0.0500000
NODE_8832_length_901_cov_36.066085	463	543	9	31	80	0.3875000
NODE_8832_length_901_cov_36.066085	463	543	10	17	80	0.2125000
NODE_8833_length_901_cov_28.129676	377	457	0	9	80	0.1125000
NODE_8833_length_901_cov_28.129676	377	457	2	3	80	0.0375000
NODE_8833_length_901_cov_28.129676	377	457	5	14	80	0.1750000
NODE_8833_length_901_cov_28.129676	377	457	6	54	80	0.6750000
NODE_8833_length_901_cov_28.129676	430	510	0	1	80	0.0125000
NODE_8833_length_901_cov_28.129676	430	510	5	12	80	0.1500000
NODE_8833_length_901_cov_28.129676	430	510	6	16	80	0.2000000
NODE_8833_length_901_cov_28.129676	430	510	8	24	80	0.3000000
NODE_8833_length_901_cov_28.129676	430	510	9	27	80	0.3375000
NODE_8834_length_901_cov_26.763092	272	352	0	33	80	0.4125000
NODE_8834_length_901_cov_26.763092	272	352	2	47	80	0.5875000
NODE_8834_length_901_cov_26.763092	325	405	0	26	80	0.3250000
NODE_8834_length_901_cov_26.763092	325	405	2	54	80	0.6750000
NODE_8834_length_901_cov_26.763092	401	481	0	80	80	1.0000000
NODE_8834_length_901_cov_26.763092	454	534	0	80	80	1.0000000
NODE_8835_length_901_cov_25.628429	369	449	0	21	80	0.2625000
NODE_8835_length_901_cov_25.628429	369	449	2	15	80	0.1875000
NODE_8835_length_901_cov_25.628429	369	449	4	44	80	0.5500000
NODE_8835_length_901_cov_25.628429	422	502	4	61	80	0.7625000
NODE_8835_length_901_cov_25.628429	422	502	5	2	80	0.0250000
NODE_8835_length_901_cov_25.628429	422	502	6	17	80	0.2125000
NODE_8836_length_901_cov_17.857855	408	488	0	33	80	0.4125000
NODE_8836_length_901_cov_17.857855	408	488	2	18	80	0.2250000
NODE_8836_length_901_cov_17.857855	408	488	4	29	80	0.3625000
NODE_8836_length_901_cov_17.857855	461	541	0	15	80	0.1875000
NODE_8836_length_901_cov_17.857855	461	541	2	1	80	0.0125000
NODE_8836_length_901_cov_17.857855	461	541	4	64	80	0.8000000
NODE_8837_length_901_cov_16.254364	362	442	0	80	80	1.0000000
NODE_8837_length_901_cov_16.254364	415	495	0	80	80	1.0000000
NODE_8838_length_901_cov_8.346633	321	401	0	17	80	0.2125000
NODE_8838_length_901_cov_8.346633	321	401	2	63	80	0.7875000
NODE_8838_length_901_cov_8.346633	374	454	0	43	80	0.5375000
NODE_8838_length_901_cov_8.346633	374	454	2	37	80	0.4625000
NODE_8840_length_901_cov_6.044888	363	443	0	24	80	0.3000000
NODE_8840_length_901_cov_6.044888	363	443	2	56	80	0.7000000
NODE_8840_length_901_cov_6.044888	416	496	2	80	80	1.0000000
NODE_8845_length_901_cov_3.814214	194	274	0	80	80	1.0000000
NODE_8845_length_901_cov_3.814214	247	326	0	79	79	1.0000000
NODE_8857_length_900_cov_30.284644	407	487	0	12	80	0.1500000
NODE_8857_length_900_cov_30.284644	407	487	2	68	80	0.8500000
NODE_8857_length_900_cov_30.284644	460	540	0	48	80	0.6000000
NODE_8857_length_900_cov_30.284644	460	540	2	32	80	0.4000000
NODE_8858_length_900_cov_29.679151	425	505	8	33	80	0.4125000
NODE_8858_length_900_cov_29.679151	425	505	10	4	80	0.0500000
NODE_8858_length_900_cov_29.679151	425	505	11	3	80	0.0375000
NODE_8858_length_900_cov_29.679151	425	505	12	18	80	0.2250000
NODE_8858_length_900_cov_29.679151	425	505	13	5	80	0.0625000
NODE_8858_length_900_cov_29.679151	425	505	15	17	80	0.2125000
NODE_8858_length_900_cov_29.679151	478	558	0	17	80	0.2125000
NODE_8858_length_900_cov_29.679151	478	558	6	10	80	0.1250000
NODE_8858_length_900_cov_29.679151	478	558	8	53	80	0.6625000
NODE_8859_length_900_cov_25.963795	321	401	0	51	80	0.6375000
NODE_8859_length_900_cov_25.963795	321	401	2	29	80	0.3625000
NODE_8859_length_900_cov_25.963795	374	454	2	80	80	1.0000000
NODE_8860_length_900_cov_17.681648	530	606	0	36	76	0.4736842
NODE_8860_length_900_cov_17.681648	530	606	2	1	76	0.0131579
NODE_8860_length_900_cov_17.681648	530	606	4	22	76	0.2894737
NODE_8860_length_900_cov_17.681648	530	606	6	17	76	0.2236842
NODE_8860_length_900_cov_17.681648	583	659	2	3	76	0.0394737
NODE_8860_length_900_cov_17.681648	583	659	4	28	76	0.3684210
NODE_8860_length_900_cov_17.681648	583	659	6	45	76	0.5921053
NODE_8861_length_900_cov_16.294632	316	396	0	80	80	1.0000000
NODE_8861_length_900_cov_16.294632	369	449	0	79	80	0.9875000
NODE_8861_length_900_cov_16.294632	369	449	2	1	80	0.0125000
NODE_8863_length_900_cov_5.962547	0	70	2	3	70	0.0428571
NODE_8863_length_900_cov_5.962547	0	70	4	1	70	0.0142857
NODE_8863_length_900_cov_5.962547	0	70	6	1	70	0.0142857
NODE_8863_length_900_cov_5.962547	0	70	8	3	70	0.0428571
NODE_8863_length_900_cov_5.962547	0	70	14	1	70	0.0142857
NODE_8863_length_900_cov_5.962547	0	70	16	30	70	0.4285714
NODE_8863_length_900_cov_5.962547	0	70	20	1	70	0.0142857
NODE_8863_length_900_cov_5.962547	0	70	22	30	70	0.4285714
NODE_8863_length_900_cov_5.962547	43	108	14	3	65	0.0461538
NODE_8863_length_900_cov_5.962547	43	108	18	1	65	0.0153846
NODE_8863_length_900_cov_5.962547	43	108	20	1	65	0.0153846
NODE_8863_length_900_cov_5.962547	43	108	22	60	65	0.9230769
NODE_8870_length_900_cov_2.521848	85	165	0	80	80	1.0000000
NODE_8870_length_900_cov_2.521848	138	218	0	80	80	1.0000000
NODE_8879_length_899_cov_45.853750	380	460	0	80	80	1.0000000
NODE_8879_length_899_cov_45.853750	433	516	0	34	83	0.4096386
NODE_8879_length_899_cov_45.853750	433	516	2	36	83	0.4337350
NODE_8879_length_899_cov_45.853750	433	516	3	2	83	0.0240964
NODE_8879_length_899_cov_45.853750	433	516	6	11	83	0.1325301
NODE_8880_length_899_cov_37.758750	381	461	7	6	80	0.0750000
NODE_8880_length_899_cov_37.758750	381	461	9	70	80	0.8750000
NODE_8880_length_899_cov_37.758750	381	461	10	4	80	0.0500000
NODE_8880_length_899_cov_37.758750	434	514	6	6	80	0.0750000
NODE_8880_length_899_cov_37.758750	434	514	7	20	80	0.2500000
NODE_8880_length_899_cov_37.758750	434	514	9	54	80	0.6750000
NODE_8881_length_899_cov_27.362500	413	493	0	2	80	0.0250000
NODE_8881_length_899_cov_27.362500	413	493	4	23	80	0.2875000
NODE_8881_length_899_cov_27.362500	413	493	6	55	80	0.6875000
NODE_8881_length_899_cov_27.362500	466	546	0	55	80	0.6875000
NODE_8881_length_899_cov_27.362500	466	546	4	23	80	0.2875000
NODE_8881_length_899_cov_27.362500	466	546	6	2	80	0.0250000
NODE_8882_length_899_cov_20.563750	379	459	0	10	80	0.1250000
NODE_8882_length_899_cov_20.563750	379	459	2	15	80	0.1875000
NODE_8882_length_899_cov_20.563750	379	459	4	38	80	0.4750000
NODE_8882_length_899_cov_20.563750	379	459	6	17	80	0.2125000
NODE_8882_length_899_cov_20.563750	432	507	0	11	75	0.1466667
NODE_8882_length_899_cov_20.563750	432	507	2	52	75	0.6933333
NODE_8882_length_899_cov_20.563750	432	507	6	12	75	0.1600000
NODE_8884_length_899_cov_17.130000	319	399	0	45	80	0.5625000
NODE_8884_length_899_cov_17.130000	319	399	2	35	80	0.4375000
NODE_8884_length_899_cov_17.130000	372	452	2	80	80	1.0000000
NODE_8885_length_899_cov_16.317500	270	350	0	19	80	0.2375000
NODE_8885_length_899_cov_16.317500	270	350	2	61	80	0.7625000
NODE_8885_length_899_cov_16.317500	323	403	0	41	80	0.5125000
NODE_8885_length_899_cov_16.317500	323	403	2	13	80	0.1625000
NODE_8885_length_899_cov_16.317500	323	403	4	26	80	0.3250000
NODE_8886_length_899_cov_16.190000	284	364	0	5	80	0.0625000
NODE_8886_length_899_cov_16.190000	284	364	1	43	80	0.5375000
NODE_8886_length_899_cov_16.190000	284	364	2	32	80	0.4000000
NODE_8886_length_899_cov_16.190000	337	417	2	80	80	1.0000000
NODE_8887_length_899_cov_13.873750	317	397	0	4	80	0.0500000
NODE_8887_length_899_cov_13.873750	317	397	2	7	80	0.0875000
NODE_8887_length_899_cov_13.873750	317	397	4	69	80	0.8625000
NODE_8887_length_899_cov_13.873750	370	450	0	28	80	0.3500000
NODE_8887_length_899_cov_13.873750	370	450	2	30	80	0.3750000
NODE_8887_length_899_cov_13.873750	370	450	4	22	80	0.2750000
NODE_8888_length_899_cov_12.957500	240	320	0	6	80	0.0750000
NODE_8888_length_899_cov_12.957500	240	320	2	26	80	0.3250000
NODE_8888_length_899_cov_12.957500	240	320	4	48	80	0.6000000
NODE_8888_length_899_cov_12.957500	293	373	4	80	80	1.0000000
NODE_8889_length_899_cov_12.516250	387	467	2	74	80	0.9250000
NODE_8889_length_899_cov_12.516250	387	467	4	6	80	0.0750000
NODE_8889_length_899_cov_12.516250	440	520	0	16	80	0.2000000
NODE_8889_length_899_cov_12.516250	440	520	2	64	80	0.8000000
NODE_8890_length_899_cov_10.846250	348	428	0	46	80	0.5750000
NODE_8890_length_899_cov_10.846250	348	428	2	34	80	0.4250000
NODE_8890_length_899_cov_10.846250	401	485	2	84	84	1.0000000
NODE_8891_length_899_cov_9.185000	347	427	0	80	80	1.0000000
NODE_8891_length_899_cov_9.185000	400	480	0	80	80	1.0000000
NODE_8892_length_899_cov_8.655000	498	578	0	80	80	1.0000000
NODE_8892_length_899_cov_8.655000	551	631	0	80	80	1.0000000
NODE_8893_length_899_cov_3.551250	0	54	0	25	54	0.4629630
NODE_8893_length_899_cov_3.551250	0	54	4	4	54	0.0740741
NODE_8893_length_899_cov_3.551250	0	54	5	1	54	0.0185185
NODE_8893_length_899_cov_3.551250	0	54	9	24	54	0.4444444
NODE_8893_length_899_cov_3.551250	27	107	4	2	80	0.0250000
NODE_8893_length_899_cov_3.551250	27	107	5	1	80	0.0125000
NODE_8893_length_899_cov_3.551250	27	107	9	25	80	0.3125000
NODE_8893_length_899_cov_3.551250	27	107	11	2	80	0.0250000
NODE_8893_length_899_cov_3.551250	27	107	13	14	80	0.1750000
NODE_8893_length_899_cov_3.551250	27	107	14	8	80	0.1000000
NODE_8893_length_899_cov_3.551250	27	107	16	13	80	0.1625000
NODE_8893_length_899_cov_3.551250	27	107	18	15	80	0.1875000
NODE_8893_length_899_cov_3.551250	103	183	0	2	80	0.0250000
NODE_8893_length_899_cov_3.551250	103	183	1	2	80	0.0250000
NODE_8893_length_899_cov_3.551250	103	183	3	2	80	0.0250000
NODE_8893_length_899_cov_3.551250	103	183	6	28	80	0.3500000
NODE_8893_length_899_cov_3.551250	103	183	12	28	80	0.3500000
NODE_8893_length_899_cov_3.551250	103	183	16	11	80	0.1375000
NODE_8893_length_899_cov_3.551250	103	183	18	7	80	0.0875000
NODE_8893_length_899_cov_3.551250	156	179	3	2	23	0.0869565
NODE_8893_length_899_cov_3.551250	156	179	6	21	23	0.9130435
NODE_8914_length_898_cov_52.405507	299	379	0	54	80	0.6750000
NODE_8914_length_898_cov_52.405507	299	379	2	26	80	0.3250000
NODE_8914_length_898_cov_52.405507	352	432	0	1	80	0.0125000
NODE_8914_length_898_cov_52.405507	352	432	2	72	80	0.9000000
NODE_8914_length_898_cov_52.405507	352	432	6	7	80	0.0875000
NODE_8914_length_898_cov_52.405507	428	508	0	4	80	0.0500000
NODE_8914_length_898_cov_52.405507	428	508	4	51	80	0.6375000
NODE_8914_length_898_cov_52.405507	428	508	6	25	80	0.3125000
NODE_8914_length_898_cov_52.405507	481	561	0	57	80	0.7125000
NODE_8914_length_898_cov_52.405507	481	561	4	23	80	0.2875000
NODE_8915_length_898_cov_44.973717	363	443	0	55	80	0.6875000
NODE_8915_length_898_cov_44.973717	363	443	2	25	80	0.3125000
NODE_8915_length_898_cov_44.973717	416	496	0	80	80	1.0000000
NODE_8916_length_898_cov_38.269086	425	505	2	3	80	0.0375000
NODE_8916_length_898_cov_38.269086	425	505	4	77	80	0.9625000
NODE_8916_length_898_cov_38.269086	478	558	0	24	80	0.3000000
NODE_8916_length_898_cov_38.269086	478	558	2	32	80	0.4000000
NODE_8916_length_898_cov_38.269086	478	558	4	24	80	0.3000000
NODE_8917_length_898_cov_27.006258	465	545	0	13	80	0.1625000
NODE_8917_length_898_cov_27.006258	465	545	2	16	80	0.2000000
NODE_8917_length_898_cov_27.006258	465	545	16	21	80	0.2625000
NODE_8917_length_898_cov_27.006258	465	545	20	30	80	0.3750000
NODE_8917_length_898_cov_27.006258	518	598	16	9	80	0.1125000
NODE_8917_length_898_cov_27.006258	518	598	20	67	80	0.8375000
NODE_8917_length_898_cov_27.006258	518	598	22	4	80	0.0500000
NODE_8918_length_898_cov_25.902378	185	265	0	10	80	0.1250000
NODE_8918_length_898_cov_25.902378	185	265	2	70	80	0.8750000
NODE_8918_length_898_cov_25.902378	238	318	0	8	80	0.1000000
NODE_8918_length_898_cov_25.902378	238	318	2	44	80	0.5500000
NODE_8918_length_898_cov_25.902378	238	318	4	26	80	0.3250000
NODE_8918_length_898_cov_25.902378	238	318	6	2	80	0.0250000
NODE_8918_length_898_cov_25.902378	314	394	4	2	80	0.0250000
NODE_8918_length_898_cov_25.902378	314	394	6	2	80	0.0250000
NODE_8918_length_898_cov_25.902378	314	394	8	76	80	0.9500000
NODE_8918_length_898_cov_25.902378	367	447	2	18	80	0.2250000
NODE_8918_length_898_cov_25.902378	367	447	4	1	80	0.0125000
NODE_8918_length_898_cov_25.902378	367	447	6	21	80	0.2625000
NODE_8918_length_898_cov_25.902378	367	447	8	40	80	0.5000000
NODE_8919_length_898_cov_25.209011	368	448	0	80	80	1.0000000
NODE_8919_length_898_cov_25.209011	421	501	0	75	80	0.9375000
NODE_8919_length_898_cov_25.209011	421	501	2	2	80	0.0250000
NODE_8919_length_898_cov_25.209011	421	501	4	3	80	0.0375000
NODE_8920_length_898_cov_21.923655	325	405	0	24	80	0.3000000
NODE_8920_length_898_cov_21.923655	325	405	2	56	80	0.7000000
NODE_8920_length_898_cov_21.923655	378	458	2	80	80	1.0000000
NODE_8921_length_898_cov_21.065081	306	386	0	21	80	0.2625000
NODE_8921_length_898_cov_21.065081	306	386	1	11	80	0.1375000
NODE_8921_length_898_cov_21.065081	306	386	2	37	80	0.4625000
NODE_8921_length_898_cov_21.065081	306	386	4	11	80	0.1375000
NODE_8921_length_898_cov_21.065081	359	439	2	16	80	0.2000000
NODE_8921_length_898_cov_21.065081	359	439	4	15	80	0.1875000
NODE_8921_length_898_cov_21.065081	359	439	6	49	80	0.6125000
NODE_8922_length_898_cov_20.954944	374	454	0	66	80	0.8250000
NODE_8922_length_898_cov_20.954944	374	454	4	14	80	0.1750000
NODE_8922_length_898_cov_20.954944	427	507	0	13	80	0.1625000
NODE_8922_length_898_cov_20.954944	427	507	4	67	80	0.8375000
NODE_8923_length_898_cov_17.387985	398	478	2	66	80	0.8250000
NODE_8923_length_898_cov_17.387985	398	478	4	14	80	0.1750000
NODE_8923_length_898_cov_17.387985	451	531	0	11	80	0.1375000
NODE_8923_length_898_cov_17.387985	451	531	2	69	80	0.8625000
NODE_8924_length_898_cov_17.252816	265	345	0	6	80	0.0750000
NODE_8924_length_898_cov_17.252816	265	345	3	1	80	0.0125000
NODE_8924_length_898_cov_17.252816	265	345	4	37	80	0.4625000
NODE_8924_length_898_cov_17.252816	265	345	6	36	80	0.4500000
NODE_8924_length_898_cov_17.252816	318	398	4	18	80	0.2250000
NODE_8924_length_898_cov_17.252816	318	398	6	62	80	0.7750000
NODE_8926_length_898_cov_13.152691	455	535	1	24	80	0.3000000
NODE_8926_length_898_cov_13.152691	455	535	2	56	80	0.7000000
NODE_8926_length_898_cov_13.152691	508	588	2	80	80	1.0000000
NODE_8927_length_898_cov_12.612015	375	455	0	1	80	0.0125000
NODE_8927_length_898_cov_12.612015	375	455	2	25	80	0.3125000
NODE_8927_length_898_cov_12.612015	375	455	4	54	80	0.6750000
NODE_8927_length_898_cov_12.612015	428	508	0	4	80	0.0500000
NODE_8927_length_898_cov_12.612015	428	508	2	27	80	0.3375000
NODE_8927_length_898_cov_12.612015	428	508	4	49	80	0.6125000
NODE_8928_length_898_cov_12.498123	428	508	0	80	80	1.0000000
NODE_8928_length_898_cov_12.498123	481	561	0	80	80	1.0000000
NODE_8932_length_898_cov_1.790989	0	56	0	56	56	1.0000000
NODE_8932_length_898_cov_1.790989	29	93	0	50	64	0.7812500
NODE_8932_length_898_cov_1.790989	29	93	2	14	64	0.2187500
NODE_8944_length_897_cov_63.921053	350	430	0	80	80	1.0000000
NODE_8944_length_897_cov_63.921053	403	483	0	80	80	1.0000000
NODE_8945_length_897_cov_58.921053	316	396	4	6	80	0.0750000
NODE_8945_length_897_cov_58.921053	316	396	6	40	80	0.5000000
NODE_8945_length_897_cov_58.921053	316	396	7	1	80	0.0125000
NODE_8945_length_897_cov_58.921053	316	396	9	9	80	0.1125000
NODE_8945_length_897_cov_58.921053	316	396	10	19	80	0.2375000
NODE_8945_length_897_cov_58.921053	316	396	11	5	80	0.0625000
NODE_8945_length_897_cov_58.921053	369	449	6	3	80	0.0375000
NODE_8945_length_897_cov_58.921053	369	449	9	8	80	0.1000000
NODE_8945_length_897_cov_58.921053	369	449	10	69	80	0.8625000
NODE_8946_length_897_cov_35.946115	324	404	0	80	80	1.0000000
NODE_8946_length_897_cov_35.946115	377	457	0	80	80	1.0000000
NODE_8947_length_897_cov_25.548872	238	318	2	1	80	0.0125000
NODE_8947_length_897_cov_25.548872	238	318	4	60	80	0.7500000
NODE_8947_length_897_cov_25.548872	238	318	6	19	80	0.2375000
NODE_8947_length_897_cov_25.548872	291	371	2	54	80	0.6750000
NODE_8947_length_897_cov_25.548872	291	371	4	17	80	0.2125000
NODE_8947_length_897_cov_25.548872	291	371	6	9	80	0.1125000
NODE_8948_length_897_cov_24.913534	399	479	0	34	80	0.4250000
NODE_8948_length_897_cov_24.913534	399	479	2	46	80	0.5750000
NODE_8948_length_897_cov_24.913534	452	532	0	27	80	0.3375000
NODE_8948_length_897_cov_24.913534	452	532	2	53	80	0.6625000
NODE_8949_length_897_cov_21.839599	308	388	0	33	80	0.4125000
NODE_8949_length_897_cov_21.839599	308	388	2	47	80	0.5875000
NODE_8949_length_897_cov_21.839599	361	441	2	49	80	0.6125000
NODE_8949_length_897_cov_21.839599	361	441	6	31	80	0.3875000
NODE_8950_length_897_cov_19.355890	489	569	0	4	80	0.0500000
NODE_8950_length_897_cov_19.355890	489	569	4	76	80	0.9500000
NODE_8950_length_897_cov_19.355890	542	622	0	8	80	0.1000000
NODE_8950_length_897_cov_19.355890	542	622	4	72	80	0.9000000
NODE_8951_length_897_cov_16.295739	209	289	1	22	80	0.2750000
NODE_8951_length_897_cov_16.295739	209	289	2	7	80	0.0875000
NODE_8951_length_897_cov_16.295739	209	289	3	51	80	0.6375000
NODE_8951_length_897_cov_16.295739	262	342	3	80	80	1.0000000
NODE_8952_length_897_cov_14.766917	395	475	2	28	80	0.3500000
NODE_8952_length_897_cov_14.766917	395	475	4	52	80	0.6500000
NODE_8952_length_897_cov_14.766917	448	528	0	6	80	0.0750000
NODE_8952_length_897_cov_14.766917	448	528	2	6	80	0.0750000
NODE_8952_length_897_cov_14.766917	448	528	4	68	80	0.8500000
NODE_8953_length_897_cov_14.219298	253	333	0	16	80	0.2000000
NODE_8953_length_897_cov_14.219298	253	333	2	64	80	0.8000000
NODE_8953_length_897_cov_14.219298	306	386	0	69	80	0.8625000
NODE_8953_length_897_cov_14.219298	306	386	2	11	80	0.1375000
NODE_8954_length_897_cov_11.116541	182	262	0	80	80	1.0000000
NODE_8954_length_897_cov_11.116541	235	315	0	27	80	0.3375000
NODE_8954_length_897_cov_11.116541	235	315	2	53	80	0.6625000
NODE_8955_length_897_cov_8.211779	303	383	0	11	80	0.1375000
NODE_8955_length_897_cov_8.211779	303	383	2	69	80	0.8625000
NODE_8955_length_897_cov_8.211779	356	436	0	34	80	0.4250000
NODE_8955_length_897_cov_8.211779	356	436	2	46	80	0.5750000
NODE_8973_length_896_cov_48.249686	397	477	0	57	80	0.7125000
NODE_8973_length_896_cov_48.249686	397	477	4	23	80	0.2875000
NODE_8973_length_896_cov_48.249686	450	530	0	4	80	0.0500000
NODE_8973_length_896_cov_48.249686	450	530	4	76	80	0.9500000
NODE_8974_length_896_cov_24.824341	213	293	0	80	80	1.0000000
NODE_8974_length_896_cov_24.824341	266	346	0	80	80	1.0000000
NODE_8975_length_896_cov_23.130489	333	413	0	80	80	1.0000000
NODE_8975_length_896_cov_23.130489	386	466	0	80	80	1.0000000
NODE_8975_length_896_cov_23.130489	462	542	0	4	80	0.0500000
NODE_8975_length_896_cov_23.130489	462	542	2	76	80	0.9500000
NODE_8975_length_896_cov_23.130489	515	595	0	42	80	0.5250000
NODE_8975_length_896_cov_23.130489	515	595	2	38	80	0.4750000
NODE_8976_length_896_cov_20.673777	361	441	0	80	80	1.0000000
NODE_8976_length_896_cov_20.673777	414	497	0	64	83	0.7710843
NODE_8976_length_896_cov_20.673777	414	497	2	12	83	0.1445783
NODE_8976_length_896_cov_20.673777	414	497	4	7	83	0.0843373
NODE_8977_length_896_cov_18.979925	418	498	4	11	80	0.1375000
NODE_8977_length_896_cov_18.979925	418	498	6	12	80	0.1500000
NODE_8977_length_896_cov_18.979925	418	498	8	51	80	0.6375000
NODE_8977_length_896_cov_18.979925	418	498	12	6	80	0.0750000
NODE_8977_length_896_cov_18.979925	471	551	4	18	80	0.2250000
NODE_8977_length_896_cov_18.979925	471	551	6	20	80	0.2500000
NODE_8977_length_896_cov_18.979925	471	551	8	31	80	0.3875000
NODE_8977_length_896_cov_18.979925	471	551	12	11	80	0.1375000
NODE_8978_length_896_cov_15.875784	340	420	5	50	80	0.6250000
NODE_8978_length_896_cov_15.875784	340	420	6	30	80	0.3750000
NODE_8978_length_896_cov_15.875784	393	473	1	19	80	0.2375000
NODE_8978_length_896_cov_15.875784	393	473	2	3	80	0.0375000
NODE_8978_length_896_cov_15.875784	393	473	4	13	80	0.1625000
NODE_8978_length_896_cov_15.875784	393	473	6	45	80	0.5625000
NODE_8980_length_896_cov_10.646173	337	417	2	1	80	0.0125000
NODE_8980_length_896_cov_10.646173	337	417	4	45	80	0.5625000
NODE_8980_length_896_cov_10.646173	337	417	6	34	80	0.4250000
NODE_8980_length_896_cov_10.646173	390	470	2	10	80	0.1250000
NODE_8980_length_896_cov_10.646173	390	470	4	2	80	0.0250000
NODE_8980_length_896_cov_10.646173	390	470	6	68	80	0.8500000
NODE_8981_length_896_cov_10.351317	327	407	0	66	80	0.8250000
NODE_8981_length_896_cov_10.351317	327	407	2	14	80	0.1750000
NODE_8981_length_896_cov_10.351317	380	460	0	13	80	0.1625000
NODE_8981_length_896_cov_10.351317	380	460	2	19	80	0.2375000
NODE_8981_length_896_cov_10.351317	380	460	4	48	80	0.6000000
NODE_8982_length_896_cov_9.754078	411	491	0	69	80	0.8625000
NODE_8982_length_896_cov_9.754078	411	491	2	11	80	0.1375000
NODE_8982_length_896_cov_9.754078	464	544	0	16	80	0.2000000
NODE_8982_length_896_cov_9.754078	464	544	2	64	80	0.8000000
NODE_8983_length_896_cov_8.069009	340	422	0	82	82	1.0000000
NODE_8983_length_896_cov_8.069009	395	475	0	80	80	1.0000000
NODE_8986_length_896_cov_4.939774	384	464	0	80	80	1.0000000
NODE_8986_length_896_cov_4.939774	437	517	0	80	80	1.0000000
NODE_9005_length_895_cov_54.949749	378	458	0	15	80	0.1875000
NODE_9005_length_895_cov_54.949749	378	458	2	65	80	0.8125000
NODE_9005_length_895_cov_54.949749	431	511	0	42	80	0.5250000
NODE_9005_length_895_cov_54.949749	431	511	2	38	80	0.4750000
NODE_9006_length_895_cov_53.945980	306	386	0	66	80	0.8250000
NODE_9006_length_895_cov_53.945980	306	386	2	14	80	0.1750000
NODE_9006_length_895_cov_53.945980	359	439	0	13	80	0.1625000
NODE_9006_length_895_cov_53.945980	359	439	2	30	80	0.3750000
NODE_9006_length_895_cov_53.945980	359	439	4	37	80	0.4625000
NODE_9007_length_895_cov_48.915829	369	449	10	34	80	0.4250000
NODE_9007_length_895_cov_48.915829	369	449	12	15	80	0.1875000
NODE_9007_length_895_cov_48.915829	369	449	16	31	80	0.3875000
NODE_9007_length_895_cov_48.915829	422	502	4	24	80	0.3000000
NODE_9007_length_895_cov_48.915829	422	502	8	3	80	0.0375000
NODE_9007_length_895_cov_48.915829	422	502	10	8	80	0.1000000
NODE_9007_length_895_cov_48.915829	422	502	14	14	80	0.1750000
NODE_9007_length_895_cov_48.915829	422	502	16	31	80	0.3875000
NODE_9007_length_895_cov_48.915829	498	578	4	58	80	0.7250000
NODE_9007_length_895_cov_48.915829	498	578	8	22	80	0.2750000
NODE_9007_length_895_cov_48.915829	551	631	0	10	80	0.1250000
NODE_9007_length_895_cov_48.915829	551	631	4	70	80	0.8750000
NODE_9008_length_895_cov_38.347990	452	532	0	16	80	0.2000000
NODE_9008_length_895_cov_38.347990	452	532	2	64	80	0.8000000
NODE_9008_length_895_cov_38.347990	505	585	0	2	80	0.0250000
NODE_9008_length_895_cov_38.347990	505	585	2	26	80	0.3250000
NODE_9008_length_895_cov_38.347990	505	585	4	52	80	0.6500000
NODE_9009_length_895_cov_33.716080	418	499	0	2	81	0.0246914
NODE_9009_length_895_cov_33.716080	418	499	2	1	81	0.0123457
NODE_9009_length_895_cov_33.716080	418	499	3	8	81	0.0987654
NODE_9009_length_895_cov_33.716080	418	499	4	43	81	0.5308642
NODE_9009_length_895_cov_33.716080	418	499	5	27	81	0.3333333
NODE_9009_length_895_cov_33.716080	472	552	0	25	80	0.3125000
NODE_9009_length_895_cov_33.716080	472	552	4	8	80	0.1000000
NODE_9009_length_895_cov_33.716080	472	552	5	47	80	0.5875000
NODE_9010_length_895_cov_21.630653	392	468	0	28	76	0.3684210
NODE_9010_length_895_cov_21.630653	392	468	2	48	76	0.6315789
NODE_9010_length_895_cov_21.630653	441	521	0	80	80	1.0000000
NODE_9011_length_895_cov_19.932161	331	411	0	29	80	0.3625000
NODE_9011_length_895_cov_19.932161	331	411	2	51	80	0.6375000
NODE_9011_length_895_cov_19.932161	384	464	0	80	80	1.0000000
NODE_9011_length_895_cov_19.932161	460	540	0	19	80	0.2375000
NODE_9011_length_895_cov_19.932161	460	540	1	30	80	0.3750000
NODE_9011_length_895_cov_19.932161	460	540	2	11	80	0.1375000
NODE_9011_length_895_cov_19.932161	460	540	4	20	80	0.2500000
NODE_9011_length_895_cov_19.932161	513	593	2	7	80	0.0875000
NODE_9011_length_895_cov_19.932161	513	593	4	45	80	0.5625000
NODE_9011_length_895_cov_19.932161	513	593	6	28	80	0.3500000
NODE_9012_length_895_cov_16.037688	403	479	0	13	76	0.1710526
NODE_9012_length_895_cov_16.037688	403	479	4	5	76	0.0657895
NODE_9012_length_895_cov_16.037688	403	479	8	58	76	0.7631579
NODE_9012_length_895_cov_16.037688	452	532	8	80	80	1.0000000
NODE_9013_length_895_cov_13.003769	372	452	2	80	80	1.0000000
NODE_9013_length_895_cov_13.003769	425	491	0	18	66	0.2727273
NODE_9013_length_895_cov_13.003769	425	491	2	48	66	0.7272727
NODE_9014_length_895_cov_12.736181	280	360	0	19	80	0.2375000
NODE_9014_length_895_cov_12.736181	280	360	4	24	80	0.3000000
NODE_9014_length_895_cov_12.736181	280	360	6	7	80	0.0875000
NODE_9014_length_895_cov_12.736181	280	360	8	3	80	0.0375000
NODE_9014_length_895_cov_12.736181	280	360	10	27	80	0.3375000
NODE_9014_length_895_cov_12.736181	333	413	2	5	80	0.0625000
NODE_9014_length_895_cov_12.736181	333	413	4	14	80	0.1750000
NODE_9014_length_895_cov_12.736181	333	413	6	2	80	0.0250000
NODE_9014_length_895_cov_12.736181	333	413	10	59	80	0.7375000
NODE_9015_length_895_cov_11.090452	505	585	2	35	80	0.4375000
NODE_9015_length_895_cov_11.090452	505	585	4	45	80	0.5625000
NODE_9015_length_895_cov_11.090452	558	638	2	25	80	0.3125000
NODE_9015_length_895_cov_11.090452	558	638	4	55	80	0.6875000
NODE_9016_length_895_cov_9.266332	468	548	0	80	80	1.0000000
NODE_9016_length_895_cov_9.266332	521	601	0	80	80	1.0000000
NODE_9018_length_895_cov_5.659548	472	552	0	5	80	0.0625000
NODE_9018_length_895_cov_5.659548	472	552	2	75	80	0.9375000
NODE_9018_length_895_cov_5.659548	525	605	0	4	80	0.0500000
NODE_9018_length_895_cov_5.659548	525	605	2	76	80	0.9500000
NODE_9019_length_895_cov_5.383166	42	123	4	5	81	0.0617284
NODE_9019_length_895_cov_5.383166	42	123	6	52	81	0.6419753
NODE_9019_length_895_cov_5.383166	42	123	8	24	81	0.2962963
NODE_9030_length_894_cov_60.153459	446	526	0	80	80	1.0000000
NODE_9030_length_894_cov_60.153459	499	579	0	80	80	1.0000000
NODE_9031_length_894_cov_49.618868	373	453	2	33	80	0.4125000
NODE_9031_length_894_cov_49.618868	373	453	6	5	80	0.0625000
NODE_9031_length_894_cov_49.618868	373	453	8	9	80	0.1125000
NODE_9031_length_894_cov_49.618868	373	453	10	33	80	0.4125000
NODE_9031_length_894_cov_49.618868	426	506	8	61	80	0.7625000
NODE_9031_length_894_cov_49.618868	426	506	10	19	80	0.2375000
NODE_9032_length_894_cov_33.228931	459	539	0	17	80	0.2125000
NODE_9032_length_894_cov_33.228931	459	539	2	10	80	0.1250000
NODE_9032_length_894_cov_33.228931	459	539	4	53	80	0.6625000
NODE_9032_length_894_cov_33.228931	512	592	0	70	80	0.8750000
NODE_9032_length_894_cov_33.228931	512	592	2	10	80	0.1250000
NODE_9033_length_894_cov_31.933333	411	491	2	32	80	0.4000000
NODE_9033_length_894_cov_31.933333	411	491	4	30	80	0.3750000
NODE_9033_length_894_cov_31.933333	411	491	6	18	80	0.2250000
NODE_9033_length_894_cov_31.933333	464	544	0	9	80	0.1125000
NODE_9033_length_894_cov_31.933333	464	544	1	9	80	0.1125000
NODE_9033_length_894_cov_31.933333	464	544	2	62	80	0.7750000
NODE_9034_length_894_cov_30.499371	270	350	4	80	80	1.0000000
NODE_9034_length_894_cov_30.499371	323	403	0	42	80	0.5250000
NODE_9034_length_894_cov_30.499371	323	403	4	38	80	0.4750000
NODE_9034_length_894_cov_30.499371	399	479	0	23	80	0.2875000
NODE_9034_length_894_cov_30.499371	399	479	1	22	80	0.2750000
NODE_9034_length_894_cov_30.499371	399	479	3	35	80	0.4375000
NODE_9034_length_894_cov_30.499371	452	532	3	58	80	0.7250000
NODE_9034_length_894_cov_30.499371	452	532	5	22	80	0.2750000
NODE_9035_length_894_cov_23.046541	79	159	0	80	80	1.0000000
NODE_9035_length_894_cov_23.046541	132	212	0	80	80	1.0000000
NODE_9036_length_894_cov_22.266667	381	461	0	28	80	0.3500000
NODE_9036_length_894_cov_22.266667	381	461	2	16	80	0.2000000
NODE_9036_length_894_cov_22.266667	381	461	3	12	80	0.1500000
NODE_9036_length_894_cov_22.266667	381	461	4	24	80	0.3000000
NODE_9036_length_894_cov_22.266667	434	514	2	19	80	0.2375000
NODE_9036_length_894_cov_22.266667	434	514	3	3	80	0.0375000
NODE_9036_length_894_cov_22.266667	434	514	4	58	80	0.7250000
NODE_9037_length_894_cov_21.997484	332	412	2	80	80	1.0000000
NODE_9037_length_894_cov_21.997484	385	465	1	21	80	0.2625000
NODE_9037_length_894_cov_21.997484	385	465	2	59	80	0.7375000
NODE_9038_length_894_cov_21.205031	319	399	0	57	80	0.7125000
NODE_9038_length_894_cov_21.205031	319	399	2	23	80	0.2875000
NODE_9038_length_894_cov_21.205031	372	452	0	80	80	1.0000000
NODE_9038_length_894_cov_21.205031	448	528	0	80	80	1.0000000
NODE_9038_length_894_cov_21.205031	501	581	0	80	80	1.0000000
NODE_9039_length_894_cov_21.132075	422	502	2	80	80	1.0000000
NODE_9039_length_894_cov_21.132075	475	555	0	40	80	0.5000000
NODE_9039_length_894_cov_21.132075	475	555	2	40	80	0.5000000
NODE_9040_length_894_cov_15.598742	338	418	2	19	80	0.2375000
NODE_9040_length_894_cov_15.598742	338	418	4	54	80	0.6750000
NODE_9040_length_894_cov_15.598742	338	418	5	2	80	0.0250000
NODE_9040_length_894_cov_15.598742	338	418	6	5	80	0.0625000
NODE_9040_length_894_cov_15.598742	391	471	0	15	80	0.1875000
NODE_9040_length_894_cov_15.598742	391	471	2	18	80	0.2250000
NODE_9040_length_894_cov_15.598742	391	471	4	47	80	0.5875000
NODE_9041_length_894_cov_14.079245	344	424	0	80	80	1.0000000
NODE_9041_length_894_cov_14.079245	397	477	0	58	80	0.7250000
NODE_9041_length_894_cov_14.079245	397	477	2	22	80	0.2750000
NODE_9042_length_894_cov_13.031447	336	416	0	8	80	0.1000000
NODE_9042_length_894_cov_13.031447	336	416	2	25	80	0.3125000
NODE_9042_length_894_cov_13.031447	336	416	4	18	80	0.2250000
NODE_9042_length_894_cov_13.031447	336	416	6	29	80	0.3625000
NODE_9042_length_894_cov_13.031447	389	469	2	7	80	0.0875000
NODE_9042_length_894_cov_13.031447	389	469	4	14	80	0.1750000
NODE_9042_length_894_cov_13.031447	389	469	6	59	80	0.7375000
NODE_9043_length_894_cov_13.031447	353	433	2	17	80	0.2125000
NODE_9043_length_894_cov_13.031447	353	433	4	63	80	0.7875000
NODE_9043_length_894_cov_13.031447	406	486	0	11	80	0.1375000
NODE_9043_length_894_cov_13.031447	406	486	2	33	80	0.4125000
NODE_9043_length_894_cov_13.031447	406	486	4	36	80	0.4500000
NODE_9044_length_894_cov_9.706918	330	410	0	68	80	0.8500000
NODE_9044_length_894_cov_9.706918	330	410	6	12	80	0.1500000
NODE_9045_length_894_cov_6.963522	378	458	0	80	80	1.0000000
NODE_9045_length_894_cov_6.963522	431	511	0	46	80	0.5750000
NODE_9045_length_894_cov_6.963522	431	511	1	34	80	0.4250000
NODE_9046_length_894_cov_4.993711	365	445	0	80	80	1.0000000
NODE_9046_length_894_cov_4.993711	418	498	0	80	80	1.0000000
NODE_9066_length_893_cov_59.134761	261	341	0	20	80	0.2500000
NODE_9066_length_893_cov_59.134761	261	341	2	5	80	0.0625000
NODE_9066_length_893_cov_59.134761	261	341	4	41	80	0.5125000
NODE_9066_length_893_cov_59.134761	261	341	6	14	80	0.1750000
NODE_9066_length_893_cov_59.134761	314	394	4	57	80	0.7125000
NODE_9066_length_893_cov_59.134761	314	394	6	23	80	0.2875000
NODE_9067_length_893_cov_58.991184	388	468	4	46	80	0.5750000
NODE_9067_length_893_cov_58.991184	388	468	6	34	80	0.4250000
NODE_9067_length_893_cov_58.991184	441	521	0	23	80	0.2875000
NODE_9067_length_893_cov_58.991184	441	521	2	7	80	0.0875000
NODE_9067_length_893_cov_58.991184	441	521	4	39	80	0.4875000
NODE_9067_length_893_cov_58.991184	441	521	6	11	80	0.1375000
NODE_9067_length_893_cov_58.991184	517	597	0	80	80	1.0000000
NODE_9067_length_893_cov_58.991184	570	650	0	80	80	1.0000000
NODE_9068_length_893_cov_55.644836	434	514	0	51	80	0.6375000
NODE_9068_length_893_cov_55.644836	434	514	2	29	80	0.3625000
NODE_9068_length_893_cov_55.644836	487	567	0	80	80	1.0000000
NODE_9068_length_893_cov_55.644836	563	643	0	80	80	1.0000000
NODE_9068_length_893_cov_55.644836	616	696	0	80	80	1.0000000
NODE_9069_length_893_cov_54.803526	479	559	0	80	80	1.0000000
NODE_9069_length_893_cov_54.803526	532	612	0	80	80	1.0000000
NODE_9070_length_893_cov_38.147355	391	471	0	7	80	0.0875000
NODE_9070_length_893_cov_38.147355	391	471	1	17	80	0.2125000
NODE_9070_length_893_cov_38.147355	391	471	10	56	80	0.7000000
NODE_9070_length_893_cov_38.147355	444	524	0	2	80	0.0250000
NODE_9070_length_893_cov_38.147355	444	524	10	78	80	0.9750000
NODE_9071_length_893_cov_33.690176	387	467	0	32	80	0.4000000
NODE_9071_length_893_cov_33.690176	387	467	4	48	80	0.6000000
NODE_9071_length_893_cov_33.690176	440	520	0	10	80	0.1250000
NODE_9071_length_893_cov_33.690176	440	520	4	70	80	0.8750000
NODE_9072_length_893_cov_32.162469	524	604	4	15	80	0.1875000
NODE_9072_length_893_cov_32.162469	524	604	6	29	80	0.3625000
NODE_9072_length_893_cov_32.162469	524	604	8	36	80	0.4500000
NODE_9072_length_893_cov_32.162469	577	657	0	4	80	0.0500000
NODE_9072_length_893_cov_32.162469	577	657	2	44	80	0.5500000
NODE_9072_length_893_cov_32.162469	577	657	4	18	80	0.2250000
NODE_9072_length_893_cov_32.162469	577	657	8	14	80	0.1750000
NODE_9073_length_893_cov_31.916877	344	424	0	80	80	1.0000000
NODE_9073_length_893_cov_31.916877	397	477	0	80	80	1.0000000
NODE_9074_length_893_cov_28.693955	437	517	0	59	80	0.7375000
NODE_9074_length_893_cov_28.693955	437	517	2	21	80	0.2625000
NODE_9074_length_893_cov_28.693955	490	570	0	6	80	0.0750000
NODE_9074_length_893_cov_28.693955	490	570	2	74	80	0.9250000
NODE_9075_length_893_cov_23.564232	363	443	0	80	80	1.0000000
NODE_9075_length_893_cov_23.564232	416	496	0	80	80	1.0000000
NODE_9076_length_893_cov_22.633501	272	352	0	60	80	0.7500000
NODE_9076_length_893_cov_22.633501	272	352	2	20	80	0.2500000
NODE_9076_length_893_cov_22.633501	272	352	0	60	80	0.7500000
NODE_9076_length_893_cov_22.633501	272	352	2	20	80	0.2500000
NODE_9076_length_893_cov_22.633501	272	352	0	60	80	0.7500000
NODE_9076_length_893_cov_22.633501	272	352	2	20	80	0.2500000
NODE_9076_length_893_cov_22.633501	325	405	0	11	80	0.1375000
NODE_9076_length_893_cov_22.633501	325	405	2	69	80	0.8625000
NODE_9076_length_893_cov_22.633501	325	405	0	11	80	0.1375000
NODE_9076_length_893_cov_22.633501	325	405	2	69	80	0.8625000
NODE_9076_length_893_cov_22.633501	325	405	0	11	80	0.1375000
NODE_9076_length_893_cov_22.633501	325	405	2	69	80	0.8625000
NODE_9076_length_893_cov_22.633501	401	481	0	64	80	0.8000000
NODE_9076_length_893_cov_22.633501	401	481	2	16	80	0.2000000
NODE_9076_length_893_cov_22.633501	454	534	0	11	80	0.1375000
NODE_9076_length_893_cov_22.633501	454	534	2	69	80	0.8625000
NODE_9077_length_893_cov_22.403023	453	533	6	12	80	0.1500000
NODE_9077_length_893_cov_22.403023	453	533	8	3	80	0.0375000
NODE_9077_length_893_cov_22.403023	453	533	10	3	80	0.0375000
NODE_9077_length_893_cov_22.403023	453	533	12	4	80	0.0500000
NODE_9077_length_893_cov_22.403023	453	533	14	31	80	0.3875000
NODE_9077_length_893_cov_22.403023	453	533	18	27	80	0.3375000
NODE_9077_length_893_cov_22.403023	506	586	0	1	80	0.0125000
NODE_9077_length_893_cov_22.403023	506	586	2	3	80	0.0375000
NODE_9077_length_893_cov_22.403023	506	586	5	3	80	0.0375000
NODE_9077_length_893_cov_22.403023	506	586	6	12	80	0.1500000
NODE_9077_length_893_cov_22.403023	506	586	8	10	80	0.1250000
NODE_9077_length_893_cov_22.403023	506	586	10	19	80	0.2375000
NODE_9077_length_893_cov_22.403023	506	586	12	2	80	0.0250000
NODE_9077_length_893_cov_22.403023	506	586	14	25	80	0.3125000
NODE_9077_length_893_cov_22.403023	506	586	18	5	80	0.0625000
NODE_9078_length_893_cov_19.423174	298	378	0	80	80	1.0000000
NODE_9078_length_893_cov_19.423174	351	431	0	80	80	1.0000000
NODE_9078_length_893_cov_19.423174	427	507	0	80	80	1.0000000
NODE_9078_length_893_cov_19.423174	480	560	0	49	80	0.6125000
NODE_9078_length_893_cov_19.423174	480	560	2	31	80	0.3875000
NODE_9079_length_893_cov_19.389169	360	440	0	80	80	1.0000000
NODE_9079_length_893_cov_19.389169	413	493	0	28	80	0.3500000
NODE_9079_length_893_cov_19.389169	413	493	2	52	80	0.6500000
NODE_9079_length_893_cov_19.389169	489	569	2	54	80	0.6750000
NODE_9079_length_893_cov_19.389169	489	569	4	11	80	0.1375000
NODE_9079_length_893_cov_19.389169	489	569	6	15	80	0.1875000
NODE_9079_length_893_cov_19.389169	542	622	2	1	80	0.0125000
NODE_9079_length_893_cov_19.389169	542	622	4	64	80	0.8000000
NODE_9079_length_893_cov_19.389169	542	622	6	15	80	0.1875000
NODE_9080_length_893_cov_18.152393	394	474	4	57	80	0.7125000
NODE_9080_length_893_cov_18.152393	394	474	5	8	80	0.1000000
NODE_9080_length_893_cov_18.152393	394	474	6	12	80	0.1500000
NODE_9080_length_893_cov_18.152393	394	474	8	3	80	0.0375000
NODE_9080_length_893_cov_18.152393	447	527	0	32	80	0.4000000
NODE_9080_length_893_cov_18.152393	447	527	4	48	80	0.6000000
NODE_9081_length_893_cov_15.960957	442	522	0	11	80	0.1375000
NODE_9081_length_893_cov_15.960957	442	522	2	6	80	0.0750000
NODE_9081_length_893_cov_15.960957	442	522	4	63	80	0.7875000
NODE_9081_length_893_cov_15.960957	495	575	2	42	80	0.5250000
NODE_9081_length_893_cov_15.960957	495	575	4	38	80	0.4750000
NODE_9082_length_893_cov_13.119647	473	553	0	20	80	0.2500000
NODE_9082_length_893_cov_13.119647	473	553	2	60	80	0.7500000
NODE_9082_length_893_cov_13.119647	526	606	2	80	80	1.0000000
NODE_9084_length_893_cov_5.549118	353	415	2	7	62	0.1129032
NODE_9084_length_893_cov_5.549118	353	415	4	55	62	0.8870968
NODE_9100_length_893_cov_1.141058	28	108	2	5	80	0.0625000
NODE_9100_length_893_cov_1.141058	28	108	4	75	80	0.9375000
NODE_9104_length_892_cov_74.968474	333	413	5	1	80	0.0125000
NODE_9104_length_892_cov_74.968474	333	413	6	47	80	0.5875000
NODE_9104_length_892_cov_74.968474	333	413	8	32	80	0.4000000
NODE_9104_length_892_cov_74.968474	386	466	0	18	80	0.2250000
NODE_9104_length_892_cov_74.968474	386	466	2	14	80	0.1750000
NODE_9104_length_892_cov_74.968474	386	466	3	8	80	0.1000000
NODE_9104_length_892_cov_74.968474	386	466	5	14	80	0.1750000
NODE_9104_length_892_cov_74.968474	386	466	6	26	80	0.3250000
NODE_9104_length_892_cov_74.968474	462	542	0	80	80	1.0000000
NODE_9104_length_892_cov_74.968474	515	595	0	80	80	1.0000000
NODE_9105_length_892_cov_54.549811	463	550	0	87	87	1.0000000
NODE_9105_length_892_cov_54.549811	523	603	0	80	80	1.0000000
NODE_9105_length_892_cov_54.549811	599	679	0	80	80	1.0000000
NODE_9106_length_892_cov_37.887768	373	453	0	80	80	1.0000000
NODE_9106_length_892_cov_37.887768	426	506	0	47	80	0.5875000
NODE_9106_length_892_cov_37.887768	426	506	12	31	80	0.3875000
NODE_9106_length_892_cov_37.887768	426	506	13	2	80	0.0250000
NODE_9107_length_892_cov_19.732661	361	441	7	59	80	0.7375000
NODE_9107_length_892_cov_19.732661	361	441	9	21	80	0.2625000
NODE_9107_length_892_cov_19.732661	414	494	7	42	80	0.5250000
NODE_9107_length_892_cov_19.732661	414	494	8	38	80	0.4750000
NODE_9108_length_892_cov_19.052963	290	370	2	17	80	0.2125000
NODE_9108_length_892_cov_19.052963	290	370	4	63	80	0.7875000
NODE_9108_length_892_cov_19.052963	343	423	0	43	80	0.5375000
NODE_9108_length_892_cov_19.052963	343	423	2	15	80	0.1875000
NODE_9108_length_892_cov_19.052963	343	423	4	22	80	0.2750000
NODE_9108_length_892_cov_19.052963	419	499	0	3	80	0.0375000
NODE_9108_length_892_cov_19.052963	419	499	2	41	80	0.5125000
NODE_9108_length_892_cov_19.052963	419	499	3	4	80	0.0500000
NODE_9108_length_892_cov_19.052963	419	499	4	6	80	0.0750000
NODE_9108_length_892_cov_19.052963	419	499	5	16	80	0.2000000
NODE_9108_length_892_cov_19.052963	419	499	6	10	80	0.1250000
NODE_9108_length_892_cov_19.052963	472	552	4	9	80	0.1125000
NODE_9108_length_892_cov_19.052963	472	552	5	16	80	0.2000000
NODE_9108_length_892_cov_19.052963	472	552	6	19	80	0.2375000
NODE_9108_length_892_cov_19.052963	472	552	8	11	80	0.1375000
NODE_9108_length_892_cov_19.052963	472	552	10	25	80	0.3125000
NODE_9109_length_892_cov_17.276166	341	421	0	22	80	0.2750000
NODE_9109_length_892_cov_17.276166	341	421	2	10	80	0.1250000
NODE_9109_length_892_cov_17.276166	341	421	4	48	80	0.6000000
NODE_9109_length_892_cov_17.276166	394	474	0	1	80	0.0125000
NODE_9109_length_892_cov_17.276166	394	474	2	12	80	0.1500000
NODE_9109_length_892_cov_17.276166	394	474	4	67	80	0.8375000
NODE_9110_length_892_cov_16.312736	411	491	0	3	80	0.0375000
NODE_9110_length_892_cov_16.312736	411	491	2	77	80	0.9625000
NODE_9110_length_892_cov_16.312736	464	544	0	32	80	0.4000000
NODE_9110_length_892_cov_16.312736	464	544	2	48	80	0.6000000
NODE_9111_length_892_cov_15.808323	395	475	2	17	80	0.2125000
NODE_9111_length_892_cov_15.808323	395	475	4	63	80	0.7875000
NODE_9111_length_892_cov_15.808323	448	528	0	33	80	0.4125000
NODE_9111_length_892_cov_15.808323	448	528	1	13	80	0.1625000
NODE_9111_length_892_cov_15.808323	448	528	2	24	80	0.3000000
NODE_9111_length_892_cov_15.808323	448	528	4	10	80	0.1250000
NODE_9112_length_892_cov_14.020177	522	602	0	80	80	1.0000000
NODE_9112_length_892_cov_14.020177	575	655	0	80	80	1.0000000
NODE_9114_length_892_cov_8.798235	400	480	0	26	80	0.3250000
NODE_9114_length_892_cov_8.798235	400	480	4	54	80	0.6750000
NODE_9114_length_892_cov_8.798235	453	533	4	80	80	1.0000000
NODE_9115_length_892_cov_8.413619	428	508	2	12	80	0.1500000
NODE_9115_length_892_cov_8.413619	428	508	6	57	80	0.7125000
NODE_9115_length_892_cov_8.413619	428	508	8	11	80	0.1375000
NODE_9115_length_892_cov_8.413619	481	561	0	19	80	0.2375000
NODE_9115_length_892_cov_8.413619	481	561	2	46	80	0.5750000
NODE_9115_length_892_cov_8.413619	481	561	6	10	80	0.1250000
NODE_9115_length_892_cov_8.413619	481	561	8	5	80	0.0625000
NODE_9116_length_892_cov_6.694830	374	454	0	80	80	1.0000000
NODE_9116_length_892_cov_6.694830	427	507	0	80	80	1.0000000
NODE_9134_length_891_cov_30.166667	295	375	0	5	80	0.0625000
NODE_9134_length_891_cov_30.166667	295	375	2	75	80	0.9375000
NODE_9134_length_891_cov_30.166667	348	428	0	5	80	0.0625000
NODE_9134_length_891_cov_30.166667	348	428	2	75	80	0.9375000
NODE_9135_length_891_cov_26.333333	319	399	0	20	80	0.2500000
NODE_9135_length_891_cov_26.333333	319	399	1	9	80	0.1125000
NODE_9135_length_891_cov_26.333333	319	399	2	51	80	0.6375000
NODE_9135_length_891_cov_26.333333	372	452	0	33	80	0.4125000
NODE_9135_length_891_cov_26.333333	372	452	2	47	80	0.5875000
NODE_9136_length_891_cov_22.228535	336	416	0	80	80	1.0000000
NODE_9136_length_891_cov_22.228535	389	469	0	80	80	1.0000000
NODE_9137_length_891_cov_20.446970	377	457	2	80	80	1.0000000
NODE_9137_length_891_cov_20.446970	430	510	0	6	80	0.0750000
NODE_9137_length_891_cov_20.446970	430	510	2	74	80	0.9250000
NODE_9138_length_891_cov_20.226010	310	390	2	80	80	1.0000000
NODE_9138_length_891_cov_20.226010	363	443	0	44	80	0.5500000
NODE_9138_length_891_cov_20.226010	363	443	2	36	80	0.4500000
NODE_9140_length_891_cov_13.207071	392	472	0	80	80	1.0000000
NODE_9140_length_891_cov_13.207071	445	525	0	76	80	0.9500000
NODE_9140_length_891_cov_13.207071	445	525	2	4	80	0.0500000
NODE_9141_length_891_cov_11.579545	379	459	0	2	80	0.0250000
NODE_9141_length_891_cov_11.579545	379	459	2	78	80	0.9750000
NODE_9141_length_891_cov_11.579545	432	512	0	55	80	0.6875000
NODE_9141_length_891_cov_11.579545	432	512	2	25	80	0.3125000
NODE_9142_length_891_cov_11.117424	499	579	2	17	80	0.2125000
NODE_9142_length_891_cov_11.117424	499	579	4	63	80	0.7875000
NODE_9142_length_891_cov_11.117424	552	632	0	49	80	0.6125000
NODE_9142_length_891_cov_11.117424	552	632	2	21	80	0.2625000
NODE_9142_length_891_cov_11.117424	552	632	4	10	80	0.1250000
NODE_9153_length_890_cov_29.070796	284	364	0	80	80	1.0000000
NODE_9153_length_890_cov_29.070796	337	417	0	80	80	1.0000000
NODE_9153_length_890_cov_29.070796	413	497	0	84	84	1.0000000
NODE_9153_length_890_cov_29.070796	470	550	0	80	80	1.0000000
NODE_9154_length_890_cov_27.295828	550	630	3	7	80	0.0875000
NODE_9154_length_890_cov_27.295828	550	630	5	7	80	0.0875000
NODE_9154_length_890_cov_27.295828	550	630	7	33	80	0.4125000
NODE_9154_length_890_cov_27.295828	550	630	8	33	80	0.4125000
NODE_9154_length_890_cov_27.295828	603	683	4	23	80	0.2875000
NODE_9154_length_890_cov_27.295828	603	683	6	30	80	0.3750000
NODE_9154_length_890_cov_27.295828	603	683	8	27	80	0.3375000
NODE_9155_length_890_cov_18.088496	80	135	2	10	55	0.1818182
NODE_9155_length_890_cov_18.088496	80	135	4	45	55	0.8181818
NODE_9155_length_890_cov_18.088496	276	356	0	14	80	0.1750000
NODE_9155_length_890_cov_18.088496	276	356	2	66	80	0.8250000
NODE_9155_length_890_cov_18.088496	329	406	0	28	77	0.3636364
NODE_9155_length_890_cov_18.088496	329	406	2	49	77	0.6363636
NODE_9156_length_890_cov_16.831858	402	482	0	61	80	0.7625000
NODE_9156_length_890_cov_16.831858	402	482	1	1	80	0.0125000
NODE_9156_length_890_cov_16.831858	402	482	2	18	80	0.2250000
NODE_9156_length_890_cov_16.831858	455	535	0	32	80	0.4000000
NODE_9156_length_890_cov_16.831858	455	535	1	1	80	0.0125000
NODE_9156_length_890_cov_16.831858	455	535	2	47	80	0.5875000
NODE_9157_length_890_cov_11.881163	222	302	2	11	80	0.1375000
NODE_9157_length_890_cov_11.881163	222	302	4	69	80	0.8625000
NODE_9157_length_890_cov_11.881163	275	355	0	26	80	0.3250000
NODE_9157_length_890_cov_11.881163	275	355	2	38	80	0.4750000
NODE_9157_length_890_cov_11.881163	275	355	4	16	80	0.2000000
NODE_9158_length_890_cov_8.676359	335	415	0	5	80	0.0625000
NODE_9158_length_890_cov_8.676359	335	415	1	55	80	0.6875000
NODE_9158_length_890_cov_8.676359	335	415	2	20	80	0.2500000
NODE_9158_length_890_cov_8.676359	388	468	0	58	80	0.7250000
NODE_9158_length_890_cov_8.676359	388	468	1	22	80	0.2750000
NODE_9183_length_889_cov_61.520253	334	414	2	5	80	0.0625000
NODE_9183_length_889_cov_61.520253	334	414	4	16	80	0.2000000
NODE_9183_length_889_cov_61.520253	334	414	6	13	80	0.1625000
NODE_9183_length_889_cov_61.520253	334	414	7	46	80	0.5750000
NODE_9183_length_889_cov_61.520253	387	467	7	59	80	0.7375000
NODE_9183_length_889_cov_61.520253	387	467	9	6	80	0.0750000
NODE_9183_length_889_cov_61.520253	387	467	10	15	80	0.1875000
NODE_9183_length_889_cov_61.520253	463	543	3	25	80	0.3125000
NODE_9183_length_889_cov_61.520253	463	543	4	18	80	0.2250000
NODE_9183_length_889_cov_61.520253	463	543	6	9	80	0.1125000
NODE_9183_length_889_cov_61.520253	463	543	8	12	80	0.1500000
NODE_9183_length_889_cov_61.520253	463	543	10	16	80	0.2000000
NODE_9183_length_889_cov_61.520253	516	596	1	38	80	0.4750000
NODE_9183_length_889_cov_61.520253	516	596	3	40	80	0.5000000
NODE_9183_length_889_cov_61.520253	516	596	4	2	80	0.0250000
NODE_9184_length_889_cov_30.012658	311	391	0	14	80	0.1750000
NODE_9184_length_889_cov_30.012658	311	391	2	9	80	0.1125000
NODE_9184_length_889_cov_30.012658	311	391	4	7	80	0.0875000
NODE_9184_length_889_cov_30.012658	311	391	5	1	80	0.0125000
NODE_9184_length_889_cov_30.012658	311	391	6	15	80	0.1875000
NODE_9184_length_889_cov_30.012658	311	391	10	9	80	0.1125000
NODE_9184_length_889_cov_30.012658	311	391	12	25	80	0.3125000
NODE_9184_length_889_cov_30.012658	364	444	6	18	80	0.2250000
NODE_9184_length_889_cov_30.012658	364	444	8	5	80	0.0625000
NODE_9184_length_889_cov_30.012658	364	444	10	12	80	0.1500000
NODE_9184_length_889_cov_30.012658	364	444	12	45	80	0.5625000
NODE_9185_length_889_cov_28.217722	413	483	6	10	70	0.1428571
NODE_9185_length_889_cov_28.217722	413	483	10	11	70	0.1571429
NODE_9185_length_889_cov_28.217722	413	483	12	49	70	0.7000000
NODE_9185_length_889_cov_28.217722	466	542	0	18	76	0.2368421
NODE_9185_length_889_cov_28.217722	466	542	2	22	76	0.2894737
NODE_9185_length_889_cov_28.217722	466	542	6	19	76	0.2500000
NODE_9185_length_889_cov_28.217722	466	542	12	17	76	0.2236842
NODE_9186_length_889_cov_27.924051	379	449	0	70	70	1.0000000
NODE_9186_length_889_cov_27.924051	432	512	0	80	80	1.0000000
NODE_9187_length_889_cov_25.887342	227	285	4	18	58	0.3103448
NODE_9187_length_889_cov_25.887342	227	285	6	29	58	0.5000000
NODE_9187_length_889_cov_25.887342	227	285	8	11	58	0.1896552
NODE_9187_length_889_cov_25.887342	258	337	2	4	79	0.0506329
NODE_9187_length_889_cov_25.887342	258	337	6	49	79	0.6202531
NODE_9187_length_889_cov_25.887342	258	337	8	26	79	0.3291139
NODE_9188_length_889_cov_22.992405	451	531	0	80	80	1.0000000
NODE_9188_length_889_cov_22.992405	504	584	0	80	80	1.0000000
NODE_9189_length_889_cov_20.703797	331	411	2	20	80	0.2500000
NODE_9189_length_889_cov_20.703797	331	411	4	53	80	0.6625000
NODE_9189_length_889_cov_20.703797	331	411	6	7	80	0.0875000
NODE_9189_length_889_cov_20.703797	384	464	2	33	80	0.4125000
NODE_9189_length_889_cov_20.703797	384	464	4	40	80	0.5000000
NODE_9189_length_889_cov_20.703797	384	464	6	7	80	0.0875000
NODE_9190_length_889_cov_20.226582	234	314	0	4	80	0.0500000
NODE_9190_length_889_cov_20.226582	234	314	2	76	80	0.9500000
NODE_9190_length_889_cov_20.226582	287	367	0	57	80	0.7125000
NODE_9190_length_889_cov_20.226582	287	367	2	23	80	0.2875000
NODE_9191_length_889_cov_15.587342	407	487	2	35	80	0.4375000
NODE_9191_length_889_cov_15.587342	407	487	3	39	80	0.4875000
NODE_9191_length_889_cov_15.587342	407	487	5	6	80	0.0750000
NODE_9191_length_889_cov_15.587342	460	540	3	21	80	0.2625000
NODE_9191_length_889_cov_15.587342	460	540	5	59	80	0.7375000
NODE_9192_length_889_cov_12.669620	313	393	0	56	80	0.7000000
NODE_9192_length_889_cov_12.669620	313	393	2	24	80	0.3000000
NODE_9192_length_889_cov_12.669620	366	446	0	25	80	0.3125000
NODE_9192_length_889_cov_12.669620	366	446	2	55	80	0.6875000
NODE_9193_length_889_cov_12.198734	399	479	0	4	80	0.0500000
NODE_9193_length_889_cov_12.198734	399	479	2	76	80	0.9500000
NODE_9193_length_889_cov_12.198734	452	532	0	22	80	0.2750000
NODE_9193_length_889_cov_12.198734	452	532	2	58	80	0.7250000
NODE_9197_length_889_cov_3.841772	187	267	0	80	80	1.0000000
NODE_9197_length_889_cov_3.841772	240	320	0	80	80	1.0000000
NODE_9213_length_888_cov_37.102662	490	570	0	35	80	0.4375000
NODE_9213_length_888_cov_37.102662	490	570	2	30	80	0.3750000
NODE_9213_length_888_cov_37.102662	490	570	4	15	80	0.1875000
NODE_9213_length_888_cov_37.102662	543	623	2	12	80	0.1500000
NODE_9213_length_888_cov_37.102662	543	623	4	68	80	0.8500000
NODE_9214_length_888_cov_28.230672	366	446	0	80	80	1.0000000
NODE_9214_length_888_cov_28.230672	419	499	0	80	80	1.0000000
NODE_9215_length_888_cov_25.243346	391	471	10	6	80	0.0750000
NODE_9215_length_888_cov_25.243346	391	471	11	22	80	0.2750000
NODE_9215_length_888_cov_25.243346	391	471	12	6	80	0.0750000
NODE_9215_length_888_cov_25.243346	391	471	19	7	80	0.0875000
NODE_9215_length_888_cov_25.243346	391	471	21	39	80	0.4875000
NODE_9215_length_888_cov_25.243346	444	524	6	5	80	0.0625000
NODE_9215_length_888_cov_25.243346	444	524	7	1	80	0.0125000
NODE_9215_length_888_cov_25.243346	444	524	11	14	80	0.1750000
NODE_9215_length_888_cov_25.243346	444	524	13	22	80	0.2750000
NODE_9215_length_888_cov_25.243346	444	524	14	1	80	0.0125000
NODE_9215_length_888_cov_25.243346	444	524	17	2	80	0.0250000
NODE_9215_length_888_cov_25.243346	444	524	19	7	80	0.0875000
NODE_9215_length_888_cov_25.243346	444	524	21	28	80	0.3500000
NODE_9216_length_888_cov_21.045627	236	316	0	80	80	1.0000000
NODE_9216_length_888_cov_21.045627	289	367	0	78	78	1.0000000
NODE_9218_length_888_cov_13.447402	515	595	1	19	80	0.2375000
NODE_9218_length_888_cov_13.447402	515	595	3	39	80	0.4875000
NODE_9218_length_888_cov_13.447402	515	595	5	22	80	0.2750000
NODE_9218_length_888_cov_13.447402	568	648	3	38	80	0.4750000
NODE_9218_length_888_cov_13.447402	568	648	4	17	80	0.2125000
NODE_9218_length_888_cov_13.447402	568	648	5	25	80	0.3125000
NODE_9219_length_888_cov_12.806084	179	259	0	80	80	1.0000000
NODE_9219_length_888_cov_12.806084	232	312	0	34	80	0.4250000
NODE_9219_length_888_cov_12.806084	232	312	2	46	80	0.5750000
NODE_9219_length_888_cov_12.806084	308	388	2	4	80	0.0500000
NODE_9219_length_888_cov_12.806084	308	388	4	49	80	0.6125000
NODE_9219_length_888_cov_12.806084	308	388	6	27	80	0.3375000
NODE_9219_length_888_cov_12.806084	361	441	4	15	80	0.1875000
NODE_9219_length_888_cov_12.806084	361	441	5	3	80	0.0375000
NODE_9219_length_888_cov_12.806084	361	441	6	52	80	0.6500000
NODE_9219_length_888_cov_12.806084	361	441	7	10	80	0.1250000
NODE_9220_length_888_cov_12.551331	365	445	0	12	80	0.1500000
NODE_9220_length_888_cov_12.551331	365	445	2	68	80	0.8500000
NODE_9220_length_888_cov_12.551331	418	498	0	65	80	0.8125000
NODE_9220_length_888_cov_12.551331	418	498	2	15	80	0.1875000
NODE_9228_length_888_cov_2.041825	42	102	0	60	60	1.0000000
NODE_9237_length_887_cov_32.927665	514	594	4	3	80	0.0375000
NODE_9237_length_887_cov_32.927665	514	594	6	1	80	0.0125000
NODE_9237_length_887_cov_32.927665	514	594	8	76	80	0.9500000
NODE_9237_length_887_cov_32.927665	567	647	0	11	80	0.1375000
NODE_9237_length_887_cov_32.927665	567	647	2	11	80	0.1375000
NODE_9237_length_887_cov_32.927665	567	647	6	12	80	0.1500000
NODE_9237_length_887_cov_32.927665	567	647	8	46	80	0.5750000
NODE_9238_length_887_cov_26.920051	358	438	5	13	80	0.1625000
NODE_9238_length_887_cov_26.920051	358	438	6	14	80	0.1750000
NODE_9238_length_887_cov_26.920051	358	438	8	53	80	0.6625000
NODE_9238_length_887_cov_26.920051	411	491	1	2	80	0.0250000
NODE_9238_length_887_cov_26.920051	411	491	2	25	80	0.3125000
NODE_9238_length_887_cov_26.920051	411	491	4	25	80	0.3125000
NODE_9238_length_887_cov_26.920051	411	491	8	28	80	0.3500000
NODE_9239_length_887_cov_20.714467	304	384	0	80	80	1.0000000
NODE_9239_length_887_cov_20.714467	357	433	0	76	76	1.0000000
NODE_9240_length_887_cov_19.771574	407	487	0	14	80	0.1750000
NODE_9240_length_887_cov_19.771574	407	487	2	3	80	0.0375000
NODE_9240_length_887_cov_19.771574	407	487	4	61	80	0.7625000
NODE_9240_length_887_cov_19.771574	407	487	6	2	80	0.0250000
NODE_9240_length_887_cov_19.771574	460	540	2	5	80	0.0625000
NODE_9240_length_887_cov_19.771574	460	540	4	30	80	0.3750000
NODE_9240_length_887_cov_19.771574	460	540	6	45	80	0.5625000
NODE_9241_length_887_cov_14.535533	333	413	4	80	80	1.0000000
NODE_9241_length_887_cov_14.535533	386	466	0	36	80	0.4500000
NODE_9241_length_887_cov_14.535533	386	466	2	16	80	0.2000000
NODE_9241_length_887_cov_14.535533	386	466	4	28	80	0.3500000
NODE_9242_length_887_cov_14.114213	345	425	0	56	80	0.7000000
NODE_9242_length_887_cov_14.114213	345	425	2	24	80	0.3000000
NODE_9242_length_887_cov_14.114213	398	478	0	3	80	0.0375000
NODE_9242_length_887_cov_14.114213	398	478	2	77	80	0.9625000
NODE_9243_length_887_cov_9.451777	406	486	0	20	80	0.2500000
NODE_9243_length_887_cov_9.451777	406	486	2	60	80	0.7500000
NODE_9243_length_887_cov_9.451777	459	539	2	80	80	1.0000000
NODE_9245_length_887_cov_6.656091	473	553	2	2	80	0.0250000
NODE_9245_length_887_cov_6.656091	473	553	3	38	80	0.4750000
NODE_9245_length_887_cov_6.656091	473	553	4	40	80	0.5000000
NODE_9245_length_887_cov_6.656091	526	606	2	15	80	0.1875000
NODE_9245_length_887_cov_6.656091	526	606	4	65	80	0.8125000
NODE_9246_length_887_cov_4.719543	420	500	0	80	80	1.0000000
NODE_9246_length_887_cov_4.719543	473	553	0	80	80	1.0000000
NODE_9250_length_887_cov_2.583756	385	429	0	44	44	1.0000000
NODE_9250_length_887_cov_2.583756	393	428	0	35	35	1.0000000
NODE_9261_length_887_cov_1.087563	754	829	2	11	75	0.1466667
NODE_9261_length_887_cov_1.087563	754	829	4	28	75	0.3733333
NODE_9261_length_887_cov_1.087563	754	829	6	36	75	0.4800000
NODE_9264_length_886_cov_35.482846	365	445	0	80	80	1.0000000
NODE_9264_length_886_cov_35.482846	418	498	0	80	80	1.0000000
NODE_9265_length_886_cov_31.939009	438	518	0	7	80	0.0875000
NODE_9265_length_886_cov_31.939009	438	518	5	1	80	0.0125000
NODE_9265_length_886_cov_31.939009	438	518	6	20	80	0.2500000
NODE_9265_length_886_cov_31.939009	438	518	10	10	80	0.1250000
NODE_9265_length_886_cov_31.939009	438	518	12	42	80	0.5250000
NODE_9265_length_886_cov_31.939009	491	571	2	23	80	0.2875000
NODE_9265_length_886_cov_31.939009	491	571	6	29	80	0.3625000
NODE_9265_length_886_cov_31.939009	491	571	12	28	80	0.3500000
NODE_9266_length_886_cov_25.301144	326	406	0	28	80	0.3500000
NODE_9266_length_886_cov_25.301144	326	406	2	52	80	0.6500000
NODE_9266_length_886_cov_25.301144	326	406	0	28	80	0.3500000
NODE_9266_length_886_cov_25.301144	326	406	2	52	80	0.6500000
NODE_9266_length_886_cov_25.301144	379	459	2	31	80	0.3875000
NODE_9266_length_886_cov_25.301144	379	459	4	49	80	0.6125000
NODE_9266_length_886_cov_25.301144	379	459	2	31	80	0.3875000
NODE_9266_length_886_cov_25.301144	379	459	4	49	80	0.6125000
NODE_9267_length_886_cov_14.463787	327	407	0	80	80	1.0000000
NODE_9267_length_886_cov_14.463787	380	460	0	80	80	1.0000000
NODE_9286_length_885_cov_35.510178	373	453	0	80	80	1.0000000
NODE_9286_length_885_cov_35.510178	426	506	0	80	80	1.0000000
NODE_9287_length_885_cov_31.857506	368	448	0	44	80	0.5500000
NODE_9287_length_885_cov_31.857506	368	448	2	36	80	0.4500000
NODE_9287_length_885_cov_31.857506	421	501	2	80	80	1.0000000
NODE_9288_length_885_cov_31.195929	395	475	0	1	80	0.0125000
NODE_9288_length_885_cov_31.195929	395	475	2	38	80	0.4750000
NODE_9288_length_885_cov_31.195929	395	475	4	1	80	0.0125000
NODE_9288_length_885_cov_31.195929	395	475	6	40	80	0.5000000
NODE_9288_length_885_cov_31.195929	448	528	4	28	80	0.3500000
NODE_9288_length_885_cov_31.195929	448	528	6	52	80	0.6500000
NODE_9289_length_885_cov_23.735369	356	436	0	80	80	1.0000000
NODE_9289_length_885_cov_23.735369	409	489	0	80	80	1.0000000
NODE_9289_length_885_cov_23.735369	485	565	0	80	80	1.0000000
NODE_9289_length_885_cov_23.735369	538	618	0	80	80	1.0000000
NODE_9290_length_885_cov_22.174300	340	420	0	80	80	1.0000000
NODE_9290_length_885_cov_22.174300	393	473	0	80	80	1.0000000
NODE_9290_length_885_cov_22.174300	469	549	0	80	80	1.0000000
NODE_9290_length_885_cov_22.174300	522	602	0	80	80	1.0000000
NODE_9291_length_885_cov_17.852417	413	493	0	13	80	0.1625000
NODE_9291_length_885_cov_17.852417	413	493	2	67	80	0.8375000
NODE_9291_length_885_cov_17.852417	466	546	0	66	80	0.8250000
NODE_9291_length_885_cov_17.852417	466	546	2	14	80	0.1750000
NODE_9292_length_885_cov_15.652672	346	426	0	38	80	0.4750000
NODE_9292_length_885_cov_15.652672	346	426	2	42	80	0.5250000
NODE_9292_length_885_cov_15.652672	399	479	0	16	80	0.2000000
NODE_9292_length_885_cov_15.652672	399	479	2	64	80	0.8000000
NODE_9292_length_885_cov_15.652672	475	555	0	23	80	0.2875000
NODE_9292_length_885_cov_15.652672	475	555	2	57	80	0.7125000
NODE_9292_length_885_cov_15.652672	528	608	2	80	80	1.0000000
NODE_9293_length_885_cov_11.648855	530	610	0	49	80	0.6125000
NODE_9293_length_885_cov_11.648855	530	610	4	31	80	0.3875000
NODE_9293_length_885_cov_11.648855	583	663	4	80	80	1.0000000
NODE_9294_length_885_cov_9.707379	611	691	0	80	80	1.0000000
NODE_9294_length_885_cov_9.707379	664	744	0	80	80	1.0000000
NODE_9311_length_884_cov_73.050955	536	616	4	35	80	0.4375000
NODE_9311_length_884_cov_73.050955	536	616	8	28	80	0.3500000
NODE_9311_length_884_cov_73.050955	536	616	10	4	80	0.0500000
NODE_9311_length_884_cov_73.050955	536	616	12	13	80	0.1625000
NODE_9311_length_884_cov_73.050955	589	669	8	11	80	0.1375000
NODE_9311_length_884_cov_73.050955	589	669	10	56	80	0.7000000
NODE_9311_length_884_cov_73.050955	589	669	12	13	80	0.1625000
NODE_9312_length_884_cov_28.373248	381	461	2	13	80	0.1625000
NODE_9312_length_884_cov_28.373248	381	461	4	32	80	0.4000000
NODE_9312_length_884_cov_28.373248	381	461	6	35	80	0.4375000
NODE_9312_length_884_cov_28.373248	434	514	0	11	80	0.1375000
NODE_9312_length_884_cov_28.373248	434	514	2	55	80	0.6875000
NODE_9312_length_884_cov_28.373248	434	514	6	14	80	0.1750000
NODE_9313_length_884_cov_20.649682	463	543	2	59	80	0.7375000
NODE_9313_length_884_cov_20.649682	463	543	3	4	80	0.0500000
NODE_9313_length_884_cov_20.649682	463	543	4	6	80	0.0750000
NODE_9313_length_884_cov_20.649682	463	543	6	11	80	0.1375000
NODE_9313_length_884_cov_20.649682	516	596	2	6	80	0.0750000
NODE_9313_length_884_cov_20.649682	516	596	3	4	80	0.0500000
NODE_9313_length_884_cov_20.649682	516	596	4	46	80	0.5750000
NODE_9313_length_884_cov_20.649682	516	596	6	24	80	0.3000000
NODE_9314_length_884_cov_13.391083	225	305	0	80	80	1.0000000
NODE_9314_length_884_cov_13.391083	278	358	0	80	80	1.0000000
NODE_9315_length_884_cov_9.192357	278	358	2	80	80	1.0000000
NODE_9315_length_884_cov_9.192357	331	411	0	35	80	0.4375000
NODE_9315_length_884_cov_9.192357	331	411	2	45	80	0.5625000
NODE_9315_length_884_cov_9.192357	407	487	0	18	80	0.2250000
NODE_9315_length_884_cov_9.192357	407	487	2	62	80	0.7750000
NODE_9315_length_884_cov_9.192357	460	540	0	32	80	0.4000000
NODE_9315_length_884_cov_9.192357	460	540	2	48	80	0.6000000
NODE_9335_length_883_cov_46.780612	344	424	0	14	80	0.1750000
NODE_9335_length_883_cov_46.780612	344	424	2	59	80	0.7375000
NODE_9335_length_883_cov_46.780612	344	424	5	2	80	0.0250000
NODE_9335_length_883_cov_46.780612	344	424	6	5	80	0.0625000
NODE_9335_length_883_cov_46.780612	397	477	2	20	80	0.2500000
NODE_9335_length_883_cov_46.780612	397	477	4	41	80	0.5125000
NODE_9335_length_883_cov_46.780612	397	477	5	2	80	0.0250000
NODE_9335_length_883_cov_46.780612	397	477	6	17	80	0.2125000
NODE_9336_length_883_cov_46.304847	387	467	0	30	80	0.3750000
NODE_9336_length_883_cov_46.304847	387	467	2	26	80	0.3250000
NODE_9336_length_883_cov_46.304847	387	467	4	6	80	0.0750000
NODE_9336_length_883_cov_46.304847	387	467	8	15	80	0.1875000
NODE_9336_length_883_cov_46.304847	387	467	10	3	80	0.0375000
NODE_9336_length_883_cov_46.304847	440	520	2	3	80	0.0375000
NODE_9336_length_883_cov_46.304847	440	520	4	6	80	0.0750000
NODE_9336_length_883_cov_46.304847	440	520	8	15	80	0.1875000
NODE_9336_length_883_cov_46.304847	440	520	10	45	80	0.5625000
NODE_9336_length_883_cov_46.304847	440	520	12	11	80	0.1375000
NODE_9337_length_883_cov_39.579082	410	490	0	80	80	1.0000000
NODE_9337_length_883_cov_39.579082	463	543	0	80	80	1.0000000
NODE_9338_length_883_cov_28.307398	379	459	2	8	80	0.1000000
NODE_9338_length_883_cov_28.307398	379	459	4	1	80	0.0125000
NODE_9338_length_883_cov_28.307398	379	459	5	11	80	0.1375000
NODE_9338_length_883_cov_28.307398	379	459	6	25	80	0.3125000
NODE_9338_length_883_cov_28.307398	379	459	8	20	80	0.2500000
NODE_9338_length_883_cov_28.307398	379	459	9	15	80	0.1875000
NODE_9338_length_883_cov_28.307398	432	512	3	17	80	0.2125000
NODE_9338_length_883_cov_28.307398	432	512	5	9	80	0.1125000
NODE_9338_length_883_cov_28.307398	432	512	6	6	80	0.0750000
NODE_9338_length_883_cov_28.307398	432	512	8	41	80	0.5125000
NODE_9338_length_883_cov_28.307398	432	512	9	7	80	0.0875000
NODE_9339_length_883_cov_24.927296	429	509	2	17	80	0.2125000
NODE_9339_length_883_cov_24.927296	429	509	4	23	80	0.2875000
NODE_9339_length_883_cov_24.927296	429	509	6	4	80	0.0500000
NODE_9339_length_883_cov_24.927296	429	509	8	36	80	0.4500000
NODE_9339_length_883_cov_24.927296	482	562	0	8	80	0.1000000
NODE_9339_length_883_cov_24.927296	482	562	4	27	80	0.3375000
NODE_9339_length_883_cov_24.927296	482	562	6	22	80	0.2750000
NODE_9339_length_883_cov_24.927296	482	562	8	23	80	0.2875000
NODE_9341_length_883_cov_17.445153	326	406	0	8	80	0.1000000
NODE_9341_length_883_cov_17.445153	326	406	1	9	80	0.1125000
NODE_9341_length_883_cov_17.445153	326	406	2	16	80	0.2000000
NODE_9341_length_883_cov_17.445153	326	406	4	1	80	0.0125000
NODE_9341_length_883_cov_17.445153	326	406	8	4	80	0.0500000
NODE_9341_length_883_cov_17.445153	326	406	10	3	80	0.0375000
NODE_9341_length_883_cov_17.445153	326	406	12	1	80	0.0125000
NODE_9341_length_883_cov_17.445153	326	406	13	1	80	0.0125000
NODE_9341_length_883_cov_17.445153	326	406	15	10	80	0.1250000
NODE_9341_length_883_cov_17.445153	326	406	17	27	80	0.3375000
NODE_9341_length_883_cov_17.445153	379	459	7	8	80	0.1000000
NODE_9341_length_883_cov_17.445153	379	459	9	15	80	0.1875000
NODE_9341_length_883_cov_17.445153	379	459	11	2	80	0.0250000
NODE_9341_length_883_cov_17.445153	379	459	14	1	80	0.0125000
NODE_9341_length_883_cov_17.445153	379	459	15	7	80	0.0875000
NODE_9341_length_883_cov_17.445153	379	459	17	47	80	0.5875000
NODE_9342_length_883_cov_14.660714	319	395	0	15	76	0.1973684
NODE_9342_length_883_cov_14.660714	319	395	2	61	76	0.8026316
NODE_9342_length_883_cov_14.660714	740	816	0	34	76	0.4473684
NODE_9342_length_883_cov_14.660714	740	816	2	3	76	0.0394737
NODE_9342_length_883_cov_14.660714	740	816	4	39	76	0.5131579
NODE_9343_length_883_cov_11.052296	223	303	0	80	80	1.0000000
NODE_9343_length_883_cov_11.052296	276	356	0	80	80	1.0000000
NODE_9344_length_883_cov_6.873724	0	66	0	3	66	0.0454545
NODE_9344_length_883_cov_6.873724	0	66	1	13	66	0.1969697
NODE_9344_length_883_cov_6.873724	0	66	15	7	66	0.1060606
NODE_9344_length_883_cov_6.873724	0	66	17	23	66	0.3484848
NODE_9344_length_883_cov_6.873724	0	66	19	11	66	0.1666667
NODE_9344_length_883_cov_6.873724	0	66	21	3	66	0.0454545
NODE_9344_length_883_cov_6.873724	0	66	26	6	66	0.0909091
NODE_9345_length_883_cov_3.873724	471	551	0	2	80	0.0250000
NODE_9345_length_883_cov_3.873724	471	551	2	78	80	0.9750000
NODE_9345_length_883_cov_3.873724	524	604	0	2	80	0.0250000
NODE_9345_length_883_cov_3.873724	524	604	2	78	80	0.9750000
NODE_9346_length_883_cov_3.247449	294	374	0	80	80	1.0000000
NODE_9346_length_883_cov_3.247449	347	427	0	80	80	1.0000000
NODE_9370_length_882_cov_24.241379	438	518	6	4	80	0.0500000
NODE_9370_length_882_cov_24.241379	438	518	8	5	80	0.0625000
NODE_9370_length_882_cov_24.241379	438	518	9	1	80	0.0125000
NODE_9370_length_882_cov_24.241379	438	518	10	16	80	0.2000000
NODE_9370_length_882_cov_24.241379	438	518	12	12	80	0.1500000
NODE_9370_length_882_cov_24.241379	438	518	13	2	80	0.0250000
NODE_9370_length_882_cov_24.241379	438	518	14	40	80	0.5000000
NODE_9370_length_882_cov_24.241379	491	571	0	35	80	0.4375000
NODE_9370_length_882_cov_24.241379	491	571	2	12	80	0.1500000
NODE_9370_length_882_cov_24.241379	491	571	6	10	80	0.1250000
NODE_9370_length_882_cov_24.241379	491	571	10	11	80	0.1375000
NODE_9370_length_882_cov_24.241379	491	571	14	12	80	0.1500000
NODE_9371_length_882_cov_23.145594	355	435	0	8	80	0.1000000
NODE_9371_length_882_cov_23.145594	355	435	2	72	80	0.9000000
NODE_9371_length_882_cov_23.145594	408	488	0	27	80	0.3375000
NODE_9371_length_882_cov_23.145594	408	488	2	53	80	0.6625000
NODE_9372_length_882_cov_21.401022	335	415	0	80	80	1.0000000
NODE_9372_length_882_cov_21.401022	388	468	0	80	80	1.0000000
NODE_9373_length_882_cov_19.579821	456	511	0	55	55	1.0000000
NODE_9373_length_882_cov_19.579821	506	586	0	80	80	1.0000000
NODE_9373_length_882_cov_19.579821	559	639	0	80	80	1.0000000
NODE_9374_length_882_cov_19.342273	298	378	2	80	80	1.0000000
NODE_9374_length_882_cov_19.342273	351	431	0	13	80	0.1625000
NODE_9374_length_882_cov_19.342273	351	431	2	31	80	0.3875000
NODE_9374_length_882_cov_19.342273	351	431	4	36	80	0.4500000
NODE_9374_length_882_cov_19.342273	427	508	4	81	81	1.0000000
NODE_9374_length_882_cov_19.342273	481	561	0	45	80	0.5625000
NODE_9374_length_882_cov_19.342273	481	561	4	35	80	0.4375000
NODE_9375_length_882_cov_11.873563	267	347	0	40	80	0.5000000
NODE_9375_length_882_cov_11.873563	267	347	2	14	80	0.1750000
NODE_9375_length_882_cov_11.873563	267	347	4	26	80	0.3250000
NODE_9375_length_882_cov_11.873563	320	400	0	5	80	0.0625000
NODE_9375_length_882_cov_11.873563	320	400	2	2	80	0.0250000
NODE_9375_length_882_cov_11.873563	320	400	4	73	80	0.9125000
NODE_9376_length_882_cov_8.794381	430	510	0	80	80	1.0000000
NODE_9376_length_882_cov_8.794381	483	563	0	80	80	1.0000000
NODE_9377_length_882_cov_7.537676	527	608	4	1	81	0.0123457
NODE_9377_length_882_cov_7.537676	527	608	5	22	81	0.2716049
NODE_9377_length_882_cov_7.537676	527	608	6	58	81	0.7160494
NODE_9379_length_882_cov_6.696041	355	435	0	3	80	0.0375000
NODE_9379_length_882_cov_6.696041	355	435	2	77	80	0.9625000
NODE_9379_length_882_cov_6.696041	408	488	0	56	80	0.7000000
NODE_9379_length_882_cov_6.696041	408	488	2	24	80	0.3000000
NODE_9380_length_882_cov_4.734355	585	665	0	28	80	0.3500000
NODE_9380_length_882_cov_4.734355	585	665	2	52	80	0.6500000
NODE_9380_length_882_cov_4.734355	638	718	0	20	80	0.2500000
NODE_9380_length_882_cov_4.734355	638	718	2	60	80	0.7500000
NODE_9398_length_881_cov_32.875959	444	524	0	80	80	1.0000000
NODE_9398_length_881_cov_32.875959	497	577	0	80	80	1.0000000
NODE_9399_length_881_cov_25.750639	43	117	2	23	74	0.3108108
NODE_9399_length_881_cov_25.750639	43	117	4	51	74	0.6891892
NODE_9399_length_881_cov_25.750639	116	193	2	13	77	0.1688312
NODE_9399_length_881_cov_25.750639	116	193	6	14	77	0.1818182
NODE_9399_length_881_cov_25.750639	116	193	7	7	77	0.0909091
NODE_9399_length_881_cov_25.750639	116	193	8	43	77	0.5584416
NODE_9400_length_881_cov_23.897698	286	365	0	42	79	0.5316456
NODE_9400_length_881_cov_23.897698	286	365	2	25	79	0.3164557
NODE_9400_length_881_cov_23.897698	286	365	4	6	79	0.0759494
NODE_9400_length_881_cov_23.897698	286	365	6	6	79	0.0759494
NODE_9400_length_881_cov_23.897698	338	418	2	15	80	0.1875000
NODE_9400_length_881_cov_23.897698	338	418	4	6	80	0.0750000
NODE_9400_length_881_cov_23.897698	338	418	6	59	80	0.7375000
NODE_9401_length_881_cov_20.656010	359	439	4	25	80	0.3125000
NODE_9401_length_881_cov_20.656010	359	439	6	13	80	0.1625000
NODE_9401_length_881_cov_20.656010	359	439	8	42	80	0.5250000
NODE_9401_length_881_cov_20.656010	412	492	0	6	80	0.0750000
NODE_9401_length_881_cov_20.656010	412	492	2	8	80	0.1000000
NODE_9401_length_881_cov_20.656010	412	492	4	45	80	0.5625000
NODE_9401_length_881_cov_20.656010	412	492	6	1	80	0.0125000
NODE_9401_length_881_cov_20.656010	412	492	8	20	80	0.2500000
NODE_9402_length_881_cov_20.340153	242	322	0	80	80	1.0000000
NODE_9402_length_881_cov_20.340153	295	375	0	80	80	1.0000000
NODE_9403_length_881_cov_18.234015	420	500	2	78	80	0.9750000
NODE_9403_length_881_cov_18.234015	420	500	4	2	80	0.0250000
NODE_9403_length_881_cov_18.234015	473	553	0	17	80	0.2125000
NODE_9403_length_881_cov_18.234015	473	553	1	24	80	0.3000000
NODE_9403_length_881_cov_18.234015	473	553	2	39	80	0.4875000
NODE_9404_length_881_cov_17.748082	291	371	0	33	80	0.4125000
NODE_9404_length_881_cov_17.748082	291	371	2	47	80	0.5875000
NODE_9404_length_881_cov_17.748082	344	424	2	80	80	1.0000000
NODE_9405_length_881_cov_12.884910	332	412	4	52	80	0.6500000
NODE_9405_length_881_cov_12.884910	332	412	6	28	80	0.3500000
NODE_9405_length_881_cov_12.884910	385	465	0	8	80	0.1000000
NODE_9405_length_881_cov_12.884910	385	465	2	38	80	0.4750000
NODE_9405_length_881_cov_12.884910	385	465	4	11	80	0.1375000
NODE_9405_length_881_cov_12.884910	385	465	6	23	80	0.2875000
NODE_9406_length_881_cov_6.473146	474	553	0	79	79	1.0000000
NODE_9406_length_881_cov_6.473146	514	594	0	80	80	1.0000000
NODE_9406_length_881_cov_6.473146	526	565	0	39	39	1.0000000
NODE_9406_length_881_cov_6.473146	555	606	0	51	51	1.0000000
NODE_9406_length_881_cov_6.473146	567	647	0	80	80	1.0000000
NODE_9407_length_881_cov_5.615090	547	627	0	20	80	0.2500000
NODE_9407_length_881_cov_5.615090	547	627	1	8	80	0.1000000
NODE_9407_length_881_cov_5.615090	547	627	2	52	80	0.6500000
NODE_9407_length_881_cov_5.615090	600	680	0	73	80	0.9125000
NODE_9407_length_881_cov_5.615090	600	680	1	7	80	0.0875000
NODE_9424_length_880_cov_26.663252	320	400	0	14	80	0.1750000
NODE_9424_length_880_cov_26.663252	320	400	2	66	80	0.8250000
NODE_9424_length_880_cov_26.663252	373	453	2	69	80	0.8625000
NODE_9424_length_880_cov_26.663252	373	453	4	11	80	0.1375000
NODE_9425_length_880_cov_21.828425	328	408	8	31	80	0.3875000
NODE_9425_length_880_cov_21.828425	328	408	10	49	80	0.6125000
NODE_9425_length_880_cov_21.828425	381	461	2	24	80	0.3000000
NODE_9425_length_880_cov_21.828425	381	461	6	5	80	0.0625000
NODE_9425_length_880_cov_21.828425	381	461	10	51	80	0.6375000
NODE_9426_length_880_cov_20.245839	427	507	0	80	80	1.0000000
NODE_9426_length_880_cov_20.245839	480	560	0	80	80	1.0000000
NODE_9427_length_880_cov_19.434059	0	69	0	69	69	1.0000000
NODE_9428_length_880_cov_11.843790	363	430	2	52	67	0.7761194
NODE_9428_length_880_cov_11.843790	363	430	4	15	67	0.2238806
NODE_9429_length_880_cov_11.544174	185	265	0	80	80	1.0000000
NODE_9429_length_880_cov_11.544174	238	318	0	80	80	1.0000000
NODE_9430_length_880_cov_10.956466	354	434	0	80	80	1.0000000
NODE_9430_length_880_cov_10.956466	407	487	0	80	80	1.0000000
NODE_9431_length_880_cov_10.008963	395	474	0	55	79	0.6962025
NODE_9431_length_880_cov_10.008963	395	474	2	24	79	0.3037975
NODE_9431_length_880_cov_10.008963	448	527	0	2	79	0.0253165
NODE_9431_length_880_cov_10.008963	448	527	2	29	79	0.3670886
NODE_9431_length_880_cov_10.008963	448	527	4	15	79	0.1898734
NODE_9431_length_880_cov_10.008963	448	527	6	33	79	0.4177215
NODE_9453_length_879_cov_23.565385	326	406	0	80	80	1.0000000
NODE_9453_length_879_cov_23.565385	379	459	0	79	80	0.9875000
NODE_9453_length_879_cov_23.565385	379	459	2	1	80	0.0125000
NODE_9453_length_879_cov_23.565385	455	535	0	3	80	0.0375000
NODE_9453_length_879_cov_23.565385	455	535	2	34	80	0.4250000
NODE_9453_length_879_cov_23.565385	455	535	4	43	80	0.5375000
NODE_9453_length_879_cov_23.565385	508	586	0	48	78	0.6153846
NODE_9453_length_879_cov_23.565385	508	586	2	30	78	0.3846154
NODE_9454_length_879_cov_20.758974	355	439	0	9	84	0.1071429
NODE_9454_length_879_cov_20.758974	355	439	4	75	84	0.8928571
NODE_9454_length_879_cov_20.758974	412	492	0	62	80	0.7750000
NODE_9454_length_879_cov_20.758974	412	492	4	18	80	0.2250000
NODE_9455_length_879_cov_19.685897	295	375	2	2	80	0.0250000
NODE_9455_length_879_cov_19.685897	295	375	4	4	80	0.0500000
NODE_9455_length_879_cov_19.685897	295	375	6	55	80	0.6875000
NODE_9455_length_879_cov_19.685897	295	375	8	11	80	0.1375000
NODE_9455_length_879_cov_19.685897	295	375	12	8	80	0.1000000
NODE_9455_length_879_cov_19.685897	348	428	6	8	80	0.1000000
NODE_9455_length_879_cov_19.685897	348	428	8	29	80	0.3625000
NODE_9455_length_879_cov_19.685897	348	428	10	1	80	0.0125000
NODE_9455_length_879_cov_19.685897	348	428	12	25	80	0.3125000
NODE_9455_length_879_cov_19.685897	348	428	13	1	80	0.0125000
NODE_9455_length_879_cov_19.685897	348	428	14	16	80	0.2000000
NODE_9456_length_879_cov_17.738462	413	488	2	23	75	0.3066667
NODE_9456_length_879_cov_17.738462	413	488	4	17	75	0.2266667
NODE_9456_length_879_cov_17.738462	413	488	6	35	75	0.4666667
NODE_9456_length_879_cov_17.738462	569	649	0	29	80	0.3625000
NODE_9456_length_879_cov_17.738462	569	649	2	51	80	0.6375000
NODE_9456_length_879_cov_17.738462	569	649	0	29	80	0.3625000
NODE_9456_length_879_cov_17.738462	569	649	2	51	80	0.6375000
NODE_9456_length_879_cov_17.738462	569	649	0	29	80	0.3625000
NODE_9456_length_879_cov_17.738462	569	649	2	51	80	0.6375000
NODE_9456_length_879_cov_17.738462	622	676	0	54	54	1.0000000
NODE_9458_length_879_cov_10.756410	335	415	0	72	80	0.9000000
NODE_9458_length_879_cov_10.756410	335	415	2	8	80	0.1000000
NODE_9458_length_879_cov_10.756410	388	468	0	19	80	0.2375000
NODE_9458_length_879_cov_10.756410	388	468	2	61	80	0.7625000
NODE_9459_length_879_cov_7.432051	234	314	0	7	80	0.0875000
NODE_9459_length_879_cov_7.432051	234	314	2	7	80	0.0875000
NODE_9459_length_879_cov_7.432051	234	314	4	15	80	0.1875000
NODE_9459_length_879_cov_7.432051	234	314	6	51	80	0.6375000
NODE_9459_length_879_cov_7.432051	288	367	0	60	79	0.7594936
NODE_9459_length_879_cov_7.432051	288	367	2	7	79	0.0886076
NODE_9459_length_879_cov_7.432051	288	367	4	12	79	0.1518987
NODE_9473_length_878_cov_230.436457	415	495	5	10	80	0.1250000
NODE_9473_length_878_cov_230.436457	415	495	7	41	80	0.5125000
NODE_9473_length_878_cov_230.436457	415	495	8	2	80	0.0250000
NODE_9473_length_878_cov_230.436457	415	495	9	3	80	0.0375000
NODE_9473_length_878_cov_230.436457	415	495	11	1	80	0.0125000
NODE_9473_length_878_cov_230.436457	415	495	12	23	80	0.2875000
NODE_9473_length_878_cov_230.436457	468	548	6	1	80	0.0125000
NODE_9473_length_878_cov_230.436457	468	548	7	1	80	0.0125000
NODE_9473_length_878_cov_230.436457	468	548	8	40	80	0.5000000
NODE_9473_length_878_cov_230.436457	468	548	10	8	80	0.1000000
NODE_9473_length_878_cov_230.436457	468	548	11	1	80	0.0125000
NODE_9473_length_878_cov_230.436457	468	548	12	29	80	0.3625000
NODE_9474_length_878_cov_49.514763	410	490	2	4	80	0.0500000
NODE_9474_length_878_cov_49.514763	410	490	4	3	80	0.0375000
NODE_9474_length_878_cov_49.514763	410	490	6	1	80	0.0125000
NODE_9474_length_878_cov_49.514763	410	490	7	4	80	0.0500000
NODE_9474_length_878_cov_49.514763	410	490	9	10	80	0.1250000
NODE_9474_length_878_cov_49.514763	410	490	12	7	80	0.0875000
NODE_9474_length_878_cov_49.514763	410	490	13	5	80	0.0625000
NODE_9474_length_878_cov_49.514763	410	490	14	46	80	0.5750000
NODE_9474_length_878_cov_49.514763	463	543	0	19	80	0.2375000
NODE_9474_length_878_cov_49.514763	463	543	4	1	80	0.0125000
NODE_9474_length_878_cov_49.514763	463	543	5	9	80	0.1125000
NODE_9474_length_878_cov_49.514763	463	543	8	7	80	0.0875000
NODE_9474_length_878_cov_49.514763	463	543	9	3	80	0.0375000
NODE_9474_length_878_cov_49.514763	463	543	10	1	80	0.0125000
NODE_9474_length_878_cov_49.514763	463	543	12	20	80	0.2500000
NODE_9474_length_878_cov_49.514763	463	543	14	20	80	0.2500000
NODE_9475_length_878_cov_38.862644	365	445	0	80	80	1.0000000
NODE_9475_length_878_cov_38.862644	418	498	0	80	80	1.0000000
NODE_9476_length_878_cov_36.517330	346	426	0	45	80	0.5625000
NODE_9476_length_878_cov_36.517330	346	426	2	35	80	0.4375000
NODE_9476_length_878_cov_36.517330	399	479	2	80	80	1.0000000
NODE_9476_length_878_cov_36.517330	475	555	0	53	80	0.6625000
NODE_9476_length_878_cov_36.517330	475	555	2	27	80	0.3375000
NODE_9476_length_878_cov_36.517330	528	608	0	80	80	1.0000000
NODE_9477_length_878_cov_34.404365	627	707	4	18	80	0.2250000
NODE_9477_length_878_cov_34.404365	627	707	6	15	80	0.1875000
NODE_9477_length_878_cov_34.404365	627	707	8	47	80	0.5875000
NODE_9477_length_878_cov_34.404365	627	695	4	18	68	0.2647059
NODE_9477_length_878_cov_34.404365	627	695	6	3	68	0.0441176
NODE_9477_length_878_cov_34.404365	627	695	8	47	68	0.6911765
NODE_9477_length_878_cov_34.404365	680	760	6	15	80	0.1875000
NODE_9477_length_878_cov_34.404365	680	760	8	13	80	0.1625000
NODE_9477_length_878_cov_34.404365	680	760	10	8	80	0.1000000
NODE_9477_length_878_cov_34.404365	680	760	12	7	80	0.0875000
NODE_9477_length_878_cov_34.404365	680	760	14	1	80	0.0125000
NODE_9477_length_878_cov_34.404365	680	760	15	6	80	0.0750000
NODE_9477_length_878_cov_34.404365	680	760	16	3	80	0.0375000
NODE_9477_length_878_cov_34.404365	680	760	17	9	80	0.1125000
NODE_9477_length_878_cov_34.404365	680	760	19	1	80	0.0125000
NODE_9477_length_878_cov_34.404365	680	760	21	3	80	0.0375000
NODE_9477_length_878_cov_34.404365	680	760	22	1	80	0.0125000
NODE_9477_length_878_cov_34.404365	680	760	23	3	80	0.0375000
NODE_9477_length_878_cov_34.404365	680	760	24	5	80	0.0625000
NODE_9477_length_878_cov_34.404365	680	760	25	1	80	0.0125000
NODE_9477_length_878_cov_34.404365	680	760	28	4	80	0.0500000
NODE_9478_length_878_cov_28.761232	467	547	0	80	80	1.0000000
NODE_9478_length_878_cov_28.761232	520	600	0	80	80	1.0000000
NODE_9479_length_878_cov_24.899872	316	396	0	80	80	1.0000000
NODE_9479_length_878_cov_24.899872	369	449	0	80	80	1.0000000
NODE_9479_length_878_cov_24.899872	445	525	0	80	80	1.0000000
NODE_9479_length_878_cov_24.899872	498	578	0	80	80	1.0000000
NODE_9480_length_878_cov_21.446727	377	457	4	80	80	1.0000000
NODE_9480_length_878_cov_21.446727	430	510	2	47	80	0.5875000
NODE_9480_length_878_cov_21.446727	430	510	4	33	80	0.4125000
NODE_9481_length_878_cov_20.553273	424	504	0	22	80	0.2750000
NODE_9481_length_878_cov_20.553273	424	504	4	58	80	0.7250000
NODE_9481_length_878_cov_20.553273	477	557	0	8	80	0.1000000
NODE_9481_length_878_cov_20.553273	477	557	4	72	80	0.9000000
NODE_9482_length_878_cov_14.016688	214	294	0	80	80	1.0000000
NODE_9482_length_878_cov_14.016688	267	347	0	80	80	1.0000000
NODE_9483_length_878_cov_9.252888	423	503	2	80	80	1.0000000
NODE_9483_length_878_cov_9.252888	476	556	0	35	80	0.4375000
NODE_9483_length_878_cov_9.252888	476	556	2	45	80	0.5625000
NODE_9484_length_878_cov_8.695764	333	413	0	80	80	1.0000000
NODE_9484_length_878_cov_8.695764	386	466	0	74	80	0.9250000
NODE_9484_length_878_cov_8.695764	386	466	2	6	80	0.0750000
NODE_9485_length_878_cov_6.686778	65	145	0	80	80	1.0000000
NODE_9485_length_878_cov_6.686778	118	198	0	80	80	1.0000000
NODE_9487_length_878_cov_6.328626	426	506	0	80	80	1.0000000
NODE_9487_length_878_cov_6.328626	479	559	0	80	80	1.0000000
NODE_9488_length_878_cov_5.771502	470	513	0	43	43	1.0000000
NODE_9490_length_878_cov_2.672657	499	579	0	23	80	0.2875000
NODE_9490_length_878_cov_2.672657	499	579	2	57	80	0.7125000
NODE_9490_length_878_cov_2.672657	552	631	2	45	79	0.5696203
NODE_9490_length_878_cov_2.672657	552	631	4	34	79	0.4303797
NODE_9507_length_877_cov_59.021851	324	404	5	49	80	0.6125000
NODE_9507_length_877_cov_59.021851	324	404	6	16	80	0.2000000
NODE_9507_length_877_cov_59.021851	324	404	7	8	80	0.1000000
NODE_9507_length_877_cov_59.021851	324	404	8	3	80	0.0375000
NODE_9507_length_877_cov_59.021851	324	404	9	3	80	0.0375000
NODE_9507_length_877_cov_59.021851	324	404	11	1	80	0.0125000
NODE_9507_length_877_cov_59.021851	377	457	5	15	80	0.1875000
NODE_9507_length_877_cov_59.021851	377	457	6	10	80	0.1250000
NODE_9507_length_877_cov_59.021851	377	457	7	8	80	0.1000000
NODE_9507_length_877_cov_59.021851	377	457	9	46	80	0.5750000
NODE_9507_length_877_cov_59.021851	377	457	11	1	80	0.0125000
NODE_9508_length_877_cov_54.422879	418	498	1	28	80	0.3500000
NODE_9508_length_877_cov_54.422879	418	498	3	52	80	0.6500000
NODE_9508_length_877_cov_54.422879	471	551	0	29	80	0.3625000
NODE_9508_length_877_cov_54.422879	471	551	1	51	80	0.6375000
NODE_9509_length_877_cov_47.672237	451	527	0	36	76	0.4736842
NODE_9509_length_877_cov_47.672237	451	527	4	40	76	0.5263158
NODE_9509_length_877_cov_47.672237	500	580	0	8	80	0.1000000
NODE_9509_length_877_cov_47.672237	500	580	2	37	80	0.4625000
NODE_9509_length_877_cov_47.672237	500	580	4	35	80	0.4375000
NODE_9510_length_877_cov_29.884319	349	429	4	67	80	0.8375000
NODE_9510_length_877_cov_29.884319	349	429	6	13	80	0.1625000
NODE_9510_length_877_cov_29.884319	402	482	2	51	80	0.6375000
NODE_9510_length_877_cov_29.884319	402	482	4	29	80	0.3625000
NODE_9511_length_877_cov_17.681234	423	503	0	80	80	1.0000000
NODE_9511_length_877_cov_17.681234	476	556	0	80	80	1.0000000
NODE_9512_length_877_cov_17.520566	228	308	0	80	80	1.0000000
NODE_9512_length_877_cov_17.520566	281	361	0	80	80	1.0000000
NODE_9513_length_877_cov_17.374036	362	442	4	53	80	0.6625000
NODE_9513_length_877_cov_17.374036	362	442	6	3	80	0.0375000
NODE_9513_length_877_cov_17.374036	362	442	8	24	80	0.3000000
NODE_9513_length_877_cov_17.374036	415	495	6	31	80	0.3875000
NODE_9513_length_877_cov_17.374036	415	495	8	29	80	0.3625000
NODE_9513_length_877_cov_17.374036	415	495	10	20	80	0.2500000
NODE_9515_length_877_cov_9.320051	395	475	0	80	80	1.0000000
NODE_9515_length_877_cov_9.320051	448	528	0	80	80	1.0000000
NODE_9517_length_877_cov_6.755784	222	302	0	15	80	0.1875000
NODE_9517_length_877_cov_6.755784	222	302	2	65	80	0.8125000
NODE_9517_length_877_cov_6.755784	275	354	0	67	79	0.8481013
NODE_9517_length_877_cov_6.755784	275	354	2	12	79	0.1518987
NODE_9537_length_876_cov_46.021879	389	469	2	80	80	1.0000000
NODE_9537_length_876_cov_46.021879	442	522	0	6	80	0.0750000
NODE_9537_length_876_cov_46.021879	442	522	2	74	80	0.9250000
NODE_9538_length_876_cov_34.441441	379	459	0	2	80	0.0250000
NODE_9538_length_876_cov_34.441441	379	459	2	8	80	0.1000000
NODE_9538_length_876_cov_34.441441	379	459	6	70	80	0.8750000
NODE_9538_length_876_cov_34.441441	432	512	0	18	80	0.2250000
NODE_9538_length_876_cov_34.441441	432	512	4	17	80	0.2125000
NODE_9538_length_876_cov_34.441441	432	512	6	45	80	0.5625000
NODE_9539_length_876_cov_30.742600	344	424	0	48	80	0.6000000
NODE_9539_length_876_cov_30.742600	344	424	2	32	80	0.4000000
NODE_9539_length_876_cov_30.742600	397	477	2	64	80	0.8000000
NODE_9539_length_876_cov_30.742600	397	477	4	16	80	0.2000000
NODE_9540_length_876_cov_28.476190	345	425	0	80	80	1.0000000
NODE_9540_length_876_cov_28.476190	398	478	0	80	80	1.0000000
NODE_9541_length_876_cov_22.722008	324	404	4	7	80	0.0875000
NODE_9541_length_876_cov_22.722008	324	404	6	37	80	0.4625000
NODE_9541_length_876_cov_22.722008	324	404	8	36	80	0.4500000
NODE_9541_length_876_cov_22.722008	377	457	0	45	80	0.5625000
NODE_9541_length_876_cov_22.722008	377	457	2	2	80	0.0250000
NODE_9541_length_876_cov_22.722008	377	457	6	33	80	0.4125000
NODE_9542_length_876_cov_17.458172	367	447	2	15	80	0.1875000
NODE_9542_length_876_cov_17.458172	367	447	4	65	80	0.8125000
NODE_9542_length_876_cov_17.458172	420	500	0	34	80	0.4250000
NODE_9542_length_876_cov_17.458172	420	500	2	34	80	0.4250000
NODE_9542_length_876_cov_17.458172	420	500	4	12	80	0.1500000
NODE_9561_length_875_cov_52.965206	190	270	4	17	80	0.2125000
NODE_9561_length_875_cov_52.965206	190	270	6	63	80	0.7875000
NODE_9561_length_875_cov_52.965206	243	323	0	38	80	0.4750000
NODE_9561_length_875_cov_52.965206	243	323	2	15	80	0.1875000
NODE_9561_length_875_cov_52.965206	243	323	6	27	80	0.3375000
NODE_9561_length_875_cov_52.965206	319	399	0	69	80	0.8625000
NODE_9561_length_875_cov_52.965206	319	399	2	11	80	0.1375000
NODE_9561_length_875_cov_52.965206	372	447	0	16	75	0.2133333
NODE_9561_length_875_cov_52.965206	372	447	2	59	75	0.7866667
NODE_9562_length_875_cov_35.634021	260	340	0	80	80	1.0000000
NODE_9562_length_875_cov_35.634021	313	393	0	80	80	1.0000000
NODE_9562_length_875_cov_35.634021	389	469	0	49	80	0.6125000
NODE_9562_length_875_cov_35.634021	389	469	7	7	80	0.0875000
NODE_9562_length_875_cov_35.634021	389	469	9	21	80	0.2625000
NODE_9562_length_875_cov_35.634021	389	469	10	3	80	0.0375000
NODE_9562_length_875_cov_35.634021	442	522	7	3	80	0.0375000
NODE_9562_length_875_cov_35.634021	442	522	9	21	80	0.2625000
NODE_9562_length_875_cov_35.634021	442	522	10	54	80	0.6750000
NODE_9562_length_875_cov_35.634021	442	522	12	2	80	0.0250000
NODE_9563_length_875_cov_33.771907	363	441	0	78	78	1.0000000
NODE_9563_length_875_cov_33.771907	414	494	0	78	80	0.9750000
NODE_9563_length_875_cov_33.771907	414	494	2	2	80	0.0250000
NODE_9564_length_875_cov_29.698454	322	402	0	61	80	0.7625000
NODE_9564_length_875_cov_29.698454	322	402	2	19	80	0.2375000
NODE_9564_length_875_cov_29.698454	375	455	0	17	80	0.2125000
NODE_9564_length_875_cov_29.698454	375	455	2	63	80	0.7875000
NODE_9565_length_875_cov_23.041237	364	444	0	80	80	1.0000000
NODE_9565_length_875_cov_23.041237	417	497	0	80	80	1.0000000
NODE_9565_length_875_cov_23.041237	493	573	0	80	80	1.0000000
NODE_9565_length_875_cov_23.041237	546	626	0	80	80	1.0000000
NODE_9566_length_875_cov_9.800258	242	322	0	80	80	1.0000000
NODE_9566_length_875_cov_9.800258	295	376	0	81	81	1.0000000
NODE_9567_length_875_cov_8.195876	407	487	4	37	80	0.4625000
NODE_9567_length_875_cov_8.195876	407	487	6	43	80	0.5375000
NODE_9567_length_875_cov_8.195876	460	540	0	29	80	0.3625000
NODE_9567_length_875_cov_8.195876	460	540	2	2	80	0.0250000
NODE_9567_length_875_cov_8.195876	460	540	4	49	80	0.6125000
NODE_9585_length_874_cov_48.925161	185	265	0	18	80	0.2250000
NODE_9585_length_874_cov_48.925161	185	265	8	62	80	0.7750000
NODE_9585_length_874_cov_48.925161	238	318	8	72	80	0.9000000
NODE_9585_length_874_cov_48.925161	238	318	10	8	80	0.1000000
NODE_9587_length_874_cov_37.354839	199	279	0	9	80	0.1125000
NODE_9587_length_874_cov_37.354839	199	279	4	71	80	0.8875000
NODE_9587_length_874_cov_37.354839	252	332	0	34	80	0.4250000
NODE_9587_length_874_cov_37.354839	252	332	2	28	80	0.3500000
NODE_9587_length_874_cov_37.354839	252	332	4	18	80	0.2250000
NODE_9588_length_874_cov_35.040000	231	311	0	17	80	0.2125000
NODE_9588_length_874_cov_35.040000	231	311	2	7	80	0.0875000
NODE_9588_length_874_cov_35.040000	231	311	4	4	80	0.0500000
NODE_9588_length_874_cov_35.040000	231	311	6	52	80	0.6500000
NODE_9588_length_874_cov_35.040000	284	364	0	5	80	0.0625000
NODE_9588_length_874_cov_35.040000	284	364	4	52	80	0.6500000
NODE_9588_length_874_cov_35.040000	284	364	6	23	80	0.2875000
NODE_9589_length_874_cov_23.415484	327	407	0	36	80	0.4500000
NODE_9589_length_874_cov_23.415484	327	407	2	44	80	0.5500000
NODE_9589_length_874_cov_23.415484	380	460	0	80	80	1.0000000
NODE_9589_length_874_cov_23.415484	456	536	0	15	80	0.1875000
NODE_9589_length_874_cov_23.415484	456	536	2	65	80	0.8125000
NODE_9589_length_874_cov_23.415484	509	589	0	63	80	0.7875000
NODE_9589_length_874_cov_23.415484	509	589	2	17	80	0.2125000
NODE_9590_length_874_cov_21.885161	279	359	2	58	80	0.7250000
NODE_9590_length_874_cov_21.885161	279	359	3	2	80	0.0250000
NODE_9590_length_874_cov_21.885161	279	359	4	20	80	0.2500000
NODE_9590_length_874_cov_21.885161	332	412	2	50	80	0.6250000
NODE_9590_length_874_cov_21.885161	332	412	3	10	80	0.1250000
NODE_9590_length_874_cov_21.885161	332	412	4	20	80	0.2500000
NODE_9591_length_874_cov_11.172903	67	147	0	80	80	1.0000000
NODE_9591_length_874_cov_11.172903	120	200	0	80	80	1.0000000
NODE_9592_length_874_cov_9.645161	424	504	0	32	80	0.4000000
NODE_9592_length_874_cov_9.645161	424	504	2	17	80	0.2125000
NODE_9592_length_874_cov_9.645161	424	504	4	31	80	0.3875000
NODE_9592_length_874_cov_9.645161	477	557	2	19	80	0.2375000
NODE_9592_length_874_cov_9.645161	477	557	4	61	80	0.7625000
NODE_9593_length_874_cov_8.637419	359	439	0	80	80	1.0000000
NODE_9593_length_874_cov_8.637419	412	499	0	87	87	1.0000000
NODE_9596_length_874_cov_4.785806	829	874	0	24	45	0.5333334
NODE_9596_length_874_cov_4.785806	829	874	2	1	45	0.0222222
NODE_9596_length_874_cov_4.785806	829	874	4	7	45	0.1555556
NODE_9596_length_874_cov_4.785806	829	874	6	13	45	0.2888889
NODE_9618_length_873_cov_100.625323	50	130	14	11	80	0.1375000
NODE_9618_length_873_cov_100.625323	50	130	15	3	80	0.0375000
NODE_9618_length_873_cov_100.625323	50	130	16	4	80	0.0500000
NODE_9618_length_873_cov_100.625323	50	130	18	62	80	0.7750000
NODE_9619_length_873_cov_45.633075	226	306	0	80	80	1.0000000
NODE_9619_length_873_cov_45.633075	279	359	0	80	80	1.0000000
NODE_9619_length_873_cov_45.633075	693	773	4	34	80	0.4250000
NODE_9619_length_873_cov_45.633075	693	773	5	22	80	0.2750000
NODE_9619_length_873_cov_45.633075	693	773	6	24	80	0.3000000
NODE_9619_length_873_cov_45.633075	746	826	0	47	80	0.5875000
NODE_9619_length_873_cov_45.633075	746	826	4	33	80	0.4125000
NODE_9620_length_873_cov_39.224806	190	270	0	80	80	1.0000000
NODE_9620_length_873_cov_39.224806	243	307	0	64	64	1.0000000
NODE_9620_length_873_cov_39.224806	390	470	2	55	80	0.6875000
NODE_9620_length_873_cov_39.224806	390	470	4	25	80	0.3125000
NODE_9620_length_873_cov_39.224806	443	523	2	35	80	0.4375000
NODE_9620_length_873_cov_39.224806	443	523	4	45	80	0.5625000
NODE_9620_length_873_cov_39.224806	504	523	2	19	19	1.0000000
NODE_9620_length_873_cov_39.224806	519	599	0	11	80	0.1375000
NODE_9620_length_873_cov_39.224806	519	599	2	6	80	0.0750000
NODE_9620_length_873_cov_39.224806	519	599	6	63	80	0.7875000
NODE_9620_length_873_cov_39.224806	572	652	6	80	80	1.0000000
NODE_9621_length_873_cov_27.992248	372	452	0	80	80	1.0000000
NODE_9621_length_873_cov_27.992248	425	505	0	80	80	1.0000000
NODE_9622_length_873_cov_23.270026	390	470	0	80	80	1.0000000
NODE_9622_length_873_cov_23.270026	443	528	0	85	85	1.0000000
NODE_9623_length_873_cov_23.197674	293	373	0	29	80	0.3625000
NODE_9623_length_873_cov_23.197674	293	373	4	51	80	0.6375000
NODE_9623_length_873_cov_23.197674	346	426	0	17	80	0.2125000
NODE_9623_length_873_cov_23.197674	346	426	4	63	80	0.7875000
NODE_9624_length_873_cov_20.432817	347	427	0	47	80	0.5875000
NODE_9624_length_873_cov_20.432817	347	427	2	13	80	0.1625000
NODE_9624_length_873_cov_20.432817	347	427	4	20	80	0.2500000
NODE_9624_length_873_cov_20.432817	400	480	2	7	80	0.0875000
NODE_9624_length_873_cov_20.432817	400	480	4	73	80	0.9125000
NODE_9624_length_873_cov_20.432817	476	556	0	60	80	0.7500000
NODE_9624_length_873_cov_20.432817	476	556	2	14	80	0.1750000
NODE_9624_length_873_cov_20.432817	476	556	4	6	80	0.0750000
NODE_9624_length_873_cov_20.432817	529	609	0	80	80	1.0000000
NODE_9625_length_873_cov_19.913437	445	525	0	27	80	0.3375000
NODE_9625_length_873_cov_19.913437	445	525	2	53	80	0.6625000
NODE_9625_length_873_cov_19.913437	498	578	0	16	80	0.2000000
NODE_9625_length_873_cov_19.913437	498	578	2	64	80	0.8000000
NODE_9626_length_873_cov_16.718346	276	356	0	19	80	0.2375000
NODE_9626_length_873_cov_16.718346	276	356	2	61	80	0.7625000
NODE_9626_length_873_cov_16.718346	329	409	0	72	80	0.9000000
NODE_9626_length_873_cov_16.718346	329	409	2	8	80	0.1000000
NODE_9627_length_873_cov_16.422481	423	503	0	21	80	0.2625000
NODE_9627_length_873_cov_16.422481	423	503	2	59	80	0.7375000
NODE_9627_length_873_cov_16.422481	476	556	0	17	80	0.2125000
NODE_9627_length_873_cov_16.422481	476	556	2	63	80	0.7875000
NODE_9628_length_873_cov_11.198966	410	490	0	80	80	1.0000000
NODE_9628_length_873_cov_11.198966	463	543	0	80	80	1.0000000
NODE_9629_length_873_cov_9.799742	334	414	0	80	80	1.0000000
NODE_9629_length_873_cov_9.799742	387	467	0	80	80	1.0000000
NODE_9632_length_873_cov_3.828165	490	570	5	20	80	0.2500000
NODE_9632_length_873_cov_3.828165	490	570	6	27	80	0.3375000
NODE_9632_length_873_cov_3.828165	490	570	9	27	80	0.3375000
NODE_9632_length_873_cov_3.828165	490	570	11	6	80	0.0750000
NODE_9632_length_873_cov_3.828165	543	583	9	36	40	0.9000000
NODE_9632_length_873_cov_3.828165	543	583	11	4	40	0.1000000
NODE_9632_length_873_cov_3.828165	690	735	0	12	45	0.2666667
NODE_9632_length_873_cov_3.828165	690	735	2	33	45	0.7333333
NODE_9633_length_873_cov_3.443152	716	746	18	3	30	0.1000000
NODE_9633_length_873_cov_3.443152	716	746	20	1	30	0.0333333
NODE_9633_length_873_cov_3.443152	716	746	26	26	30	0.8666667
NODE_9647_length_873_cov_1.239018	593	658	2	9	65	0.1384615
NODE_9647_length_873_cov_1.239018	593	658	6	1	65	0.0153846
NODE_9647_length_873_cov_1.239018	593	658	8	6	65	0.0923077
NODE_9647_length_873_cov_1.239018	593	658	10	8	65	0.1230769
NODE_9647_length_873_cov_1.239018	593	658	12	7	65	0.1076923
NODE_9647_length_873_cov_1.239018	593	658	14	5	65	0.0769231
NODE_9647_length_873_cov_1.239018	593	658	16	4	65	0.0615385
NODE_9647_length_873_cov_1.239018	593	658	18	6	65	0.0923077
NODE_9647_length_873_cov_1.239018	593	658	20	15	65	0.2307692
NODE_9647_length_873_cov_1.239018	593	658	22	2	65	0.0307692
NODE_9647_length_873_cov_1.239018	593	658	23	2	65	0.0307692
NODE_9651_length_872_cov_47.732212	432	512	2	20	80	0.2500000
NODE_9651_length_872_cov_47.732212	432	512	4	60	80	0.7500000
NODE_9651_length_872_cov_47.732212	484	564	0	6	80	0.0750000
NODE_9651_length_872_cov_47.732212	484	564	2	49	80	0.6125000
NODE_9651_length_872_cov_47.732212	484	564	4	25	80	0.3125000
NODE_9651_length_872_cov_47.732212	560	640	0	57	80	0.7125000
NODE_9651_length_872_cov_47.732212	560	640	2	23	80	0.2875000
NODE_9651_length_872_cov_47.732212	613	693	0	7	80	0.0875000
NODE_9651_length_872_cov_47.732212	613	693	2	73	80	0.9125000
NODE_9652_length_872_cov_16.204398	349	429	0	80	80	1.0000000
NODE_9652_length_872_cov_16.204398	402	482	0	67	80	0.8375000
NODE_9652_length_872_cov_16.204398	402	482	2	13	80	0.1625000
NODE_9652_length_872_cov_16.204398	478	558	2	10	80	0.1250000
NODE_9652_length_872_cov_16.204398	478	558	4	13	80	0.1625000
NODE_9652_length_872_cov_16.204398	478	558	6	7	80	0.0875000
NODE_9652_length_872_cov_16.204398	478	558	10	24	80	0.3000000
NODE_9652_length_872_cov_16.204398	478	558	12	26	80	0.3250000
NODE_9652_length_872_cov_16.204398	531	611	2	16	80	0.2000000
NODE_9652_length_872_cov_16.204398	531	611	6	3	80	0.0375000
NODE_9652_length_872_cov_16.204398	531	611	8	24	80	0.3000000
NODE_9652_length_872_cov_16.204398	531	611	10	2	80	0.0250000
NODE_9652_length_872_cov_16.204398	531	611	12	35	80	0.4375000
NODE_9653_length_872_cov_12.835705	376	456	0	80	80	1.0000000
NODE_9653_length_872_cov_12.835705	429	509	0	80	80	1.0000000
NODE_9654_length_872_cov_9.657180	356	431	0	12	75	0.1600000
NODE_9654_length_872_cov_9.657180	356	431	2	63	75	0.8400000
NODE_9660_length_872_cov_3.531695	425	505	0	80	80	1.0000000
NODE_9660_length_872_cov_3.531695	478	559	0	43	81	0.5308642
NODE_9660_length_872_cov_3.531695	478	559	2	38	81	0.4691358
NODE_9673_length_871_cov_56.841969	265	345	0	80	80	1.0000000
NODE_9673_length_871_cov_56.841969	318	398	0	80	80	1.0000000
NODE_9673_length_871_cov_56.841969	394	474	0	80	80	1.0000000
NODE_9673_length_871_cov_56.841969	447	527	0	80	80	1.0000000
NODE_9674_length_871_cov_47.528497	461	541	0	7	80	0.0875000
NODE_9674_length_871_cov_47.528497	461	541	2	24	80	0.3000000
NODE_9674_length_871_cov_47.528497	461	541	3	15	80	0.1875000
NODE_9674_length_871_cov_47.528497	461	541	4	8	80	0.1000000
NODE_9674_length_871_cov_47.528497	461	541	6	26	80	0.3250000
NODE_9674_length_871_cov_47.528497	514	594	4	28	80	0.3500000
NODE_9674_length_871_cov_47.528497	514	594	6	52	80	0.6500000
NODE_9675_length_871_cov_31.145078	326	406	0	80	80	1.0000000
NODE_9675_length_871_cov_31.145078	379	459	0	80	80	1.0000000
NODE_9676_length_871_cov_27.993523	379	459	0	25	80	0.3125000
NODE_9676_length_871_cov_27.993523	379	459	2	55	80	0.6875000
NODE_9676_length_871_cov_27.993523	432	512	0	25	80	0.3125000
NODE_9676_length_871_cov_27.993523	432	512	2	55	80	0.6875000
NODE_9677_length_871_cov_25.954663	463	543	0	20	80	0.2500000
NODE_9677_length_871_cov_25.954663	463	543	2	60	80	0.7500000
NODE_9677_length_871_cov_25.954663	516	596	0	6	80	0.0750000
NODE_9677_length_871_cov_25.954663	516	596	2	74	80	0.9250000
NODE_9678_length_871_cov_24.069948	492	558	0	66	66	1.0000000
NODE_9678_length_871_cov_24.069948	558	634	0	16	76	0.2105263
NODE_9678_length_871_cov_24.069948	558	634	6	60	76	0.7894737
NODE_9679_length_871_cov_23.953368	445	522	14	9	77	0.1168831
NODE_9679_length_871_cov_23.953368	445	522	16	1	77	0.0129870
NODE_9679_length_871_cov_23.953368	445	522	21	3	77	0.0389610
NODE_9679_length_871_cov_23.953368	445	522	22	14	77	0.1818182
NODE_9679_length_871_cov_23.953368	445	522	24	36	77	0.4675325
NODE_9679_length_871_cov_23.953368	445	522	25	2	77	0.0259740
NODE_9679_length_871_cov_23.953368	445	522	26	6	77	0.0779221
NODE_9679_length_871_cov_23.953368	445	522	27	3	77	0.0389610
NODE_9679_length_871_cov_23.953368	445	522	28	3	77	0.0389610
NODE_9680_length_871_cov_19.304404	335	415	0	80	80	1.0000000
NODE_9680_length_871_cov_19.304404	388	468	0	80	80	1.0000000
NODE_9682_length_871_cov_18.108808	370	450	2	14	80	0.1750000
NODE_9682_length_871_cov_18.108808	370	450	4	5	80	0.0625000
NODE_9682_length_871_cov_18.108808	370	450	6	35	80	0.4375000
NODE_9682_length_871_cov_18.108808	370	450	8	26	80	0.3250000
NODE_9682_length_871_cov_18.108808	423	503	2	20	80	0.2500000
NODE_9682_length_871_cov_18.108808	423	503	4	5	80	0.0625000
NODE_9682_length_871_cov_18.108808	423	503	6	27	80	0.3375000
NODE_9682_length_871_cov_18.108808	423	503	8	28	80	0.3500000
NODE_9683_length_871_cov_17.034974	362	442	0	80	80	1.0000000
NODE_9683_length_871_cov_17.034974	415	495	0	80	80	1.0000000
NODE_9684_length_871_cov_16.768135	374	454	0	80	80	1.0000000
NODE_9685_length_871_cov_14.196891	267	347	0	2	80	0.0250000
NODE_9685_length_871_cov_14.196891	267	347	2	13	80	0.1625000
NODE_9685_length_871_cov_14.196891	267	347	4	23	80	0.2875000
NODE_9685_length_871_cov_14.196891	267	347	6	42	80	0.5250000
NODE_9685_length_871_cov_14.196891	320	400	4	20	80	0.2500000
NODE_9685_length_871_cov_14.196891	320	400	6	60	80	0.7500000
NODE_9686_length_871_cov_13.443005	246	326	0	17	80	0.2125000
NODE_9686_length_871_cov_13.443005	246	326	2	63	80	0.7875000
NODE_9686_length_871_cov_13.443005	299	322	0	13	23	0.5652174
NODE_9686_length_871_cov_13.443005	299	322	2	10	23	0.4347826
NODE_9687_length_871_cov_11.839378	29	109	0	80	80	1.0000000
NODE_9687_length_871_cov_11.839378	82	149	0	67	67	1.0000000
NODE_9687_length_871_cov_11.839378	331	411	0	80	80	1.0000000
NODE_9687_length_871_cov_11.839378	384	464	0	80	80	1.0000000
NODE_9689_length_871_cov_5.730570	316	373	0	57	57	1.0000000
NODE_9694_length_871_cov_3.544041	428	508	0	61	80	0.7625000
NODE_9694_length_871_cov_3.544041	428	508	2	19	80	0.2375000
NODE_9694_length_871_cov_3.544041	481	561	0	8	80	0.1000000
NODE_9694_length_871_cov_3.544041	481	561	2	72	80	0.9000000
NODE_9716_length_870_cov_43.400778	542	622	2	80	80	1.0000000
NODE_9716_length_870_cov_43.400778	595	675	0	9	80	0.1125000
NODE_9716_length_870_cov_43.400778	595	675	2	71	80	0.8875000
NODE_9719_length_870_cov_28.249027	442	524	8	23	82	0.2804878
NODE_9719_length_870_cov_28.249027	442	524	10	59	82	0.7195122
NODE_9719_length_870_cov_28.249027	497	577	0	18	80	0.2250000
NODE_9719_length_870_cov_28.249027	497	577	5	2	80	0.0250000
NODE_9719_length_870_cov_28.249027	497	577	6	5	80	0.0625000
NODE_9719_length_870_cov_28.249027	497	577	8	46	80	0.5750000
NODE_9719_length_870_cov_28.249027	497	577	10	9	80	0.1125000
NODE_9720_length_870_cov_26.992218	240	320	0	80	80	1.0000000
NODE_9720_length_870_cov_26.992218	293	373	0	80	80	1.0000000
NODE_9720_length_870_cov_26.992218	369	449	0	35	80	0.4375000
NODE_9720_length_870_cov_26.992218	369	449	2	40	80	0.5000000
NODE_9720_length_870_cov_26.992218	369	449	4	5	80	0.0625000
NODE_9720_length_870_cov_26.992218	422	502	2	46	80	0.5750000
NODE_9720_length_870_cov_26.992218	422	502	4	34	80	0.4250000
NODE_9721_length_870_cov_25.806744	186	237	4	15	51	0.2941177
NODE_9721_length_870_cov_25.806744	186	237	6	36	51	0.7058824
NODE_9721_length_870_cov_25.806744	391	471	2	80	80	1.0000000
NODE_9721_length_870_cov_25.806744	444	524	0	9	80	0.1125000
NODE_9721_length_870_cov_25.806744	444	524	1	23	80	0.2875000
NODE_9721_length_870_cov_25.806744	444	524	2	48	80	0.6000000
NODE_9722_length_870_cov_18.862516	345	425	0	43	80	0.5375000
NODE_9722_length_870_cov_18.862516	345	425	2	15	80	0.1875000
NODE_9722_length_870_cov_18.862516	345	425	6	4	80	0.0500000
NODE_9722_length_870_cov_18.862516	345	425	10	18	80	0.2250000
NODE_9722_length_870_cov_18.862516	398	478	2	5	80	0.0625000
NODE_9722_length_870_cov_18.862516	398	478	6	4	80	0.0500000
NODE_9722_length_870_cov_18.862516	398	478	10	71	80	0.8875000
NODE_9723_length_870_cov_15.686122	330	410	0	43	80	0.5375000
NODE_9723_length_870_cov_15.686122	330	410	2	37	80	0.4625000
NODE_9723_length_870_cov_15.686122	383	463	2	80	80	1.0000000
NODE_9725_length_870_cov_13.334630	479	559	0	80	80	1.0000000
NODE_9725_length_870_cov_13.334630	532	612	0	80	80	1.0000000
NODE_9726_length_870_cov_9.712062	410	490	0	15	80	0.1875000
NODE_9726_length_870_cov_9.712062	410	490	2	65	80	0.8125000
NODE_9726_length_870_cov_9.712062	463	542	0	64	79	0.8101266
NODE_9726_length_870_cov_9.712062	463	542	2	15	79	0.1898734
NODE_9728_length_870_cov_7.556420	448	528	0	80	80	1.0000000
NODE_9728_length_870_cov_7.556420	501	581	0	80	80	1.0000000
NODE_9746_length_869_cov_42.784416	395	475	2	80	80	1.0000000
NODE_9746_length_869_cov_42.784416	448	528	0	42	80	0.5250000
NODE_9746_length_869_cov_42.784416	448	528	2	38	80	0.4750000
NODE_9747_length_869_cov_29.525974	211	291	0	52	80	0.6500000
NODE_9747_length_869_cov_29.525974	211	291	2	6	80	0.0750000
NODE_9747_length_869_cov_29.525974	211	291	6	10	80	0.1250000
NODE_9747_length_869_cov_29.525974	211	291	8	12	80	0.1500000
NODE_9747_length_869_cov_29.525974	264	344	2	17	80	0.2125000
NODE_9747_length_869_cov_29.525974	264	344	6	11	80	0.1375000
NODE_9747_length_869_cov_29.525974	264	344	8	52	80	0.6500000
NODE_9748_length_869_cov_16.258442	389	469	2	80	80	1.0000000
NODE_9748_length_869_cov_16.258442	442	522	0	12	80	0.1500000
NODE_9748_length_869_cov_16.258442	442	522	2	40	80	0.5000000
NODE_9748_length_869_cov_16.258442	442	522	4	28	80	0.3500000
NODE_9749_length_869_cov_15.940260	321	401	0	80	80	1.0000000
NODE_9749_length_869_cov_15.940260	374	454	0	80	80	1.0000000
NODE_9750_length_869_cov_9.619481	402	442	130	2	40	0.0500000
NODE_9750_length_869_cov_9.619481	402	442	132	1	40	0.0250000
NODE_9750_length_869_cov_9.619481	402	442	133	1	40	0.0250000
NODE_9750_length_869_cov_9.619481	402	442	135	1	40	0.0250000
NODE_9750_length_869_cov_9.619481	402	442	137	1	40	0.0250000
NODE_9750_length_869_cov_9.619481	402	442	139	1	40	0.0250000
NODE_9750_length_869_cov_9.619481	402	442	146	1	40	0.0250000
NODE_9750_length_869_cov_9.619481	402	442	147	1	40	0.0250000
NODE_9750_length_869_cov_9.619481	402	442	151	4	40	0.1000000
NODE_9750_length_869_cov_9.619481	402	442	153	1	40	0.0250000
NODE_9750_length_869_cov_9.619481	402	442	154	2	40	0.0500000
NODE_9750_length_869_cov_9.619481	402	442	156	3	40	0.0750000
NODE_9750_length_869_cov_9.619481	402	442	157	5	40	0.1250000
NODE_9750_length_869_cov_9.619481	402	442	158	2	40	0.0500000
NODE_9750_length_869_cov_9.619481	402	442	160	1	40	0.0250000
NODE_9750_length_869_cov_9.619481	402	442	166	1	40	0.0250000
NODE_9750_length_869_cov_9.619481	402	442	168	1	40	0.0250000
NODE_9750_length_869_cov_9.619481	402	442	173	1	40	0.0250000
NODE_9750_length_869_cov_9.619481	402	442	177	1	40	0.0250000
NODE_9750_length_869_cov_9.619481	402	442	183	1	40	0.0250000
NODE_9750_length_869_cov_9.619481	402	442	189	1	40	0.0250000
NODE_9750_length_869_cov_9.619481	402	442	195	4	40	0.1000000
NODE_9750_length_869_cov_9.619481	402	442	198	1	40	0.0250000
NODE_9750_length_869_cov_9.619481	402	442	200	2	40	0.0500000
NODE_9751_length_869_cov_7.123377	392	472	0	80	80	1.0000000
NODE_9751_length_869_cov_7.123377	445	525	0	78	80	0.9750000
NODE_9751_length_869_cov_7.123377	445	525	2	2	80	0.0250000
NODE_9753_length_869_cov_3.658442	310	378	0	68	68	1.0000000
NODE_9777_length_868_cov_57.465540	355	435	2	6	80	0.0750000
NODE_9777_length_868_cov_57.465540	355	435	4	27	80	0.3375000
NODE_9777_length_868_cov_57.465540	355	435	8	24	80	0.3000000
NODE_9777_length_868_cov_57.465540	355	435	10	1	80	0.0125000
NODE_9777_length_868_cov_57.465540	355	435	12	22	80	0.2750000
NODE_9778_length_868_cov_46.509753	0	65	0	65	65	1.0000000
NODE_9778_length_868_cov_46.509753	0	65	0	65	65	1.0000000
NODE_9778_length_868_cov_46.509753	0	65	0	65	65	1.0000000
NODE_9778_length_868_cov_46.509753	0	65	0	65	65	1.0000000
NODE_9778_length_868_cov_46.509753	61	141	0	80	80	1.0000000
NODE_9778_length_868_cov_46.509753	61	141	0	80	80	1.0000000
NODE_9778_length_868_cov_46.509753	114	194	0	80	80	1.0000000
NODE_9778_length_868_cov_46.509753	114	194	0	80	80	1.0000000
NODE_9779_length_868_cov_26.092328	318	398	0	80	80	1.0000000
NODE_9779_length_868_cov_26.092328	371	451	0	80	80	1.0000000
NODE_9781_length_868_cov_22.555267	377	457	0	80	80	1.0000000
NODE_9781_length_868_cov_22.555267	430	510	0	80	80	1.0000000
NODE_9782_length_868_cov_20.466840	259	339	2	4	80	0.0500000
NODE_9782_length_868_cov_20.466840	259	339	4	76	80	0.9500000
NODE_9782_length_868_cov_20.466840	312	392	1	2	80	0.0250000
NODE_9782_length_868_cov_20.466840	312	392	2	55	80	0.6875000
NODE_9782_length_868_cov_20.466840	312	392	4	23	80	0.2875000
NODE_9782_length_868_cov_20.466840	388	468	0	74	80	0.9250000
NODE_9782_length_868_cov_20.466840	388	468	1	4	80	0.0500000
NODE_9782_length_868_cov_20.466840	388	468	2	2	80	0.0250000
NODE_9782_length_868_cov_20.466840	441	521	0	80	80	1.0000000
NODE_9783_length_868_cov_20.414824	311	391	2	80	80	1.0000000
NODE_9783_length_868_cov_20.414824	364	444	0	20	80	0.2500000
NODE_9783_length_868_cov_20.414824	364	444	2	60	80	0.7500000
NODE_9784_length_868_cov_17.613784	340	420	2	37	80	0.4625000
NODE_9784_length_868_cov_17.613784	340	420	4	43	80	0.5375000
NODE_9784_length_868_cov_17.613784	393	473	0	34	80	0.4250000
NODE_9784_length_868_cov_17.613784	393	473	2	45	80	0.5625000
NODE_9784_length_868_cov_17.613784	393	473	4	1	80	0.0125000
NODE_9785_length_868_cov_15.768531	353	433	0	80	80	1.0000000
NODE_9785_length_868_cov_15.768531	406	486	0	80	80	1.0000000
NODE_9786_length_868_cov_13.997399	611	691	0	80	80	1.0000000
NODE_9786_length_868_cov_13.997399	664	744	0	80	80	1.0000000
NODE_9787_length_868_cov_13.224967	451	531	0	80	80	1.0000000
NODE_9787_length_868_cov_13.224967	504	583	0	79	79	1.0000000
NODE_9788_length_868_cov_11.851756	363	422	0	59	59	1.0000000
NODE_9788_length_868_cov_11.851756	395	475	0	80	80	1.0000000
NODE_9789_length_868_cov_11.352406	361	441	2	13	80	0.1625000
NODE_9789_length_868_cov_11.352406	361	441	4	49	80	0.6125000
NODE_9789_length_868_cov_11.352406	361	441	6	18	80	0.2250000
NODE_9789_length_868_cov_11.352406	414	494	0	24	80	0.3000000
NODE_9789_length_868_cov_11.352406	414	494	2	12	80	0.1500000
NODE_9789_length_868_cov_11.352406	414	494	4	44	80	0.5500000
NODE_9790_length_868_cov_11.335501	289	369	2	80	80	1.0000000
NODE_9790_length_868_cov_11.335501	342	422	0	19	80	0.2375000
NODE_9790_length_868_cov_11.335501	342	422	2	61	80	0.7625000
NODE_9791_length_868_cov_8.455137	401	481	0	33	80	0.4125000
NODE_9791_length_868_cov_8.455137	401	481	2	47	80	0.5875000
NODE_9791_length_868_cov_8.455137	454	534	0	80	80	1.0000000
NODE_9816_length_867_cov_27.756510	333	376	0	4	43	0.0930233
NODE_9816_length_867_cov_27.756510	333	376	2	39	43	0.9069768
NODE_9816_length_867_cov_27.756510	349	429	0	10	80	0.1250000
NODE_9816_length_867_cov_27.756510	349	429	2	70	80	0.8750000
NODE_9816_length_867_cov_27.756510	425	505	0	73	80	0.9125000
NODE_9816_length_867_cov_27.756510	425	505	2	7	80	0.0875000
NODE_9816_length_867_cov_27.756510	478	542	0	20	64	0.3125000
NODE_9816_length_867_cov_27.756510	478	542	2	44	64	0.6875000
NODE_9817_length_867_cov_25.354167	280	345	0	20	65	0.3076923
NODE_9817_length_867_cov_25.354167	280	345	2	45	65	0.6923077
NODE_9817_length_867_cov_25.354167	325	397	0	72	72	1.0000000
NODE_9818_length_867_cov_23.968750	369	449	0	24	80	0.3000000
NODE_9818_length_867_cov_23.968750	369	449	2	56	80	0.7000000
NODE_9818_length_867_cov_23.968750	422	502	0	23	80	0.2875000
NODE_9818_length_867_cov_23.968750	422	502	2	57	80	0.7125000
NODE_9819_length_867_cov_21.220052	524	604	2	40	80	0.5000000
NODE_9819_length_867_cov_21.220052	524	604	4	40	80	0.5000000
NODE_9819_length_867_cov_21.220052	577	657	2	1	80	0.0125000
NODE_9819_length_867_cov_21.220052	577	657	4	79	80	0.9875000
NODE_9820_length_867_cov_15.042969	287	364	2	56	77	0.7272727
NODE_9820_length_867_cov_15.042969	287	364	5	10	77	0.1298701
NODE_9820_length_867_cov_15.042969	287	364	7	11	77	0.1428571
NODE_9821_length_867_cov_11.057292	305	373	0	68	68	1.0000000
NODE_9821_length_867_cov_11.057292	346	426	0	80	80	1.0000000
NODE_9821_length_867_cov_11.057292	475	555	0	80	80	1.0000000
NODE_9822_length_867_cov_8.127604	347	427	0	80	80	1.0000000
NODE_9822_length_867_cov_8.127604	400	480	0	80	80	1.0000000
NODE_9823_length_867_cov_7.621094	292	372	0	80	80	1.0000000
NODE_9823_length_867_cov_7.621094	345	425	0	80	80	1.0000000
NODE_9826_length_867_cov_5.494792	445	525	0	80	80	1.0000000
NODE_9826_length_867_cov_5.494792	498	578	0	80	80	1.0000000
NODE_9857_length_866_cov_49.224250	269	349	0	80	80	1.0000000
NODE_9857_length_866_cov_49.224250	322	402	0	28	80	0.3500000
NODE_9857_length_866_cov_49.224250	322	402	2	24	80	0.3000000
NODE_9857_length_866_cov_49.224250	322	402	4	15	80	0.1875000
NODE_9857_length_866_cov_49.224250	322	402	6	9	80	0.1125000
NODE_9857_length_866_cov_49.224250	322	402	8	4	80	0.0500000
NODE_9858_length_866_cov_47.160365	428	508	0	12	80	0.1500000
NODE_9858_length_866_cov_47.160365	428	508	2	29	80	0.3625000
NODE_9858_length_866_cov_47.160365	428	508	4	39	80	0.4875000
NODE_9858_length_866_cov_47.160365	481	561	0	10	80	0.1250000
NODE_9858_length_866_cov_47.160365	481	561	2	26	80	0.3250000
NODE_9858_length_866_cov_47.160365	481	561	4	44	80	0.5500000
NODE_9858_length_866_cov_47.160365	557	637	0	80	80	1.0000000
NODE_9858_length_866_cov_47.160365	610	690	0	80	80	1.0000000
NODE_9859_length_866_cov_23.398957	281	361	0	5	80	0.0625000
NODE_9859_length_866_cov_23.398957	281	361	4	1	80	0.0125000
NODE_9859_length_866_cov_23.398957	281	361	5	7	80	0.0875000
NODE_9859_length_866_cov_23.398957	281	361	7	6	80	0.0750000
NODE_9859_length_866_cov_23.398957	281	361	9	4	80	0.0500000
NODE_9859_length_866_cov_23.398957	281	361	14	7	80	0.0875000
NODE_9859_length_866_cov_23.398957	281	361	18	18	80	0.2250000
NODE_9859_length_866_cov_23.398957	281	361	22	3	80	0.0375000
NODE_9859_length_866_cov_23.398957	281	361	24	29	80	0.3625000
NODE_9859_length_866_cov_23.398957	334	414	24	80	80	1.0000000
NODE_9860_length_866_cov_22.186441	455	535	0	75	80	0.9375000
NODE_9860_length_866_cov_22.186441	455	535	2	4	80	0.0500000
NODE_9860_length_866_cov_22.186441	455	535	5	1	80	0.0125000
NODE_9860_length_866_cov_22.186441	508	588	0	80	80	1.0000000
NODE_9861_length_866_cov_18.362451	451	531	2	35	80	0.4375000
NODE_9861_length_866_cov_18.362451	451	531	4	45	80	0.5625000
NODE_9861_length_866_cov_18.362451	504	584	0	45	80	0.5625000
NODE_9861_length_866_cov_18.362451	504	584	2	20	80	0.2500000
NODE_9861_length_866_cov_18.362451	504	584	4	15	80	0.1875000
NODE_9862_length_866_cov_16.830508	372	452	0	80	80	1.0000000
NODE_9862_length_866_cov_16.830508	425	505	0	80	80	1.0000000
NODE_9882_length_865_cov_63.137076	288	368	0	60	80	0.7500000
NODE_9882_length_865_cov_63.137076	288	368	2	4	80	0.0500000
NODE_9882_length_865_cov_63.137076	288	368	3	1	80	0.0125000
NODE_9882_length_865_cov_63.137076	288	368	4	15	80	0.1875000
NODE_9882_length_865_cov_63.137076	341	421	0	7	80	0.0875000
NODE_9882_length_865_cov_63.137076	341	421	2	4	80	0.0500000
NODE_9882_length_865_cov_63.137076	341	421	3	1	80	0.0125000
NODE_9882_length_865_cov_63.137076	341	421	4	18	80	0.2250000
NODE_9882_length_865_cov_63.137076	341	421	6	50	80	0.6250000
NODE_9883_length_865_cov_19.882507	335	415	0	80	80	1.0000000
NODE_9883_length_865_cov_19.882507	388	468	0	80	80	1.0000000
NODE_9884_length_865_cov_17.784595	306	386	0	80	80	1.0000000
NODE_9884_length_865_cov_17.784595	359	439	0	80	80	1.0000000
NODE_9885_length_865_cov_16.150131	451	531	2	80	80	1.0000000
NODE_9885_length_865_cov_16.150131	504	584	0	31	80	0.3875000
NODE_9885_length_865_cov_16.150131	504	584	2	49	80	0.6125000
NODE_9886_length_865_cov_14.751958	473	553	0	80	80	1.0000000
NODE_9886_length_865_cov_14.751958	473	553	0	80	80	1.0000000
NODE_9886_length_865_cov_14.751958	526	589	0	63	63	1.0000000
NODE_9886_length_865_cov_14.751958	526	606	0	80	80	1.0000000
NODE_9887_length_865_cov_10.937337	422	502	2	13	80	0.1625000
NODE_9887_length_865_cov_10.937337	422	502	6	3	80	0.0375000
NODE_9887_length_865_cov_10.937337	422	502	10	1	80	0.0125000
NODE_9887_length_865_cov_10.937337	422	502	12	36	80	0.4500000
NODE_9887_length_865_cov_10.937337	422	502	14	27	80	0.3375000
NODE_9887_length_865_cov_10.937337	475	555	0	38	80	0.4750000
NODE_9887_length_865_cov_10.937337	475	555	2	28	80	0.3500000
NODE_9887_length_865_cov_10.937337	475	555	6	3	80	0.0375000
NODE_9887_length_865_cov_10.937337	475	555	10	1	80	0.0125000
NODE_9887_length_865_cov_10.937337	475	555	12	10	80	0.1250000
NODE_9889_length_865_cov_9.167102	389	469	0	80	80	1.0000000
NODE_9889_length_865_cov_9.167102	442	522	0	80	80	1.0000000
NODE_9912_length_864_cov_13.398693	491	571	2	31	80	0.3875000
NODE_9912_length_864_cov_13.398693	491	571	3	11	80	0.1375000
NODE_9912_length_864_cov_13.398693	491	571	4	38	80	0.4750000
NODE_9912_length_864_cov_13.398693	544	624	0	8	80	0.1000000
NODE_9912_length_864_cov_13.398693	544	624	2	46	80	0.5750000
NODE_9912_length_864_cov_13.398693	544	624	3	11	80	0.1375000
NODE_9912_length_864_cov_13.398693	544	624	4	15	80	0.1875000
NODE_9913_length_864_cov_8.466667	308	388	0	4	80	0.0500000
NODE_9913_length_864_cov_8.466667	308	388	2	76	80	0.9500000
NODE_9913_length_864_cov_8.466667	361	441	0	53	80	0.6625000
NODE_9913_length_864_cov_8.466667	361	441	2	27	80	0.3375000
NODE_9917_length_864_cov_3.947712	651	676	2	25	25	1.0000000
NODE_9917_length_864_cov_3.947712	725	805	6	3	80	0.0375000
NODE_9917_length_864_cov_3.947712	725	805	8	8	80	0.1000000
NODE_9917_length_864_cov_3.947712	725	805	10	1	80	0.0125000
NODE_9917_length_864_cov_3.947712	725	805	11	1	80	0.0125000
NODE_9917_length_864_cov_3.947712	725	805	12	26	80	0.3250000
NODE_9917_length_864_cov_3.947712	725	805	14	11	80	0.1375000
NODE_9917_length_864_cov_3.947712	725	805	15	6	80	0.0750000
NODE_9917_length_864_cov_3.947712	725	805	16	24	80	0.3000000
NODE_9917_length_864_cov_3.947712	778	844	8	5	66	0.0757576
NODE_9917_length_864_cov_3.947712	778	844	10	6	66	0.0909091
NODE_9917_length_864_cov_3.947712	778	844	12	25	66	0.3787879
NODE_9917_length_864_cov_3.947712	778	844	14	7	66	0.1060606
NODE_9917_length_864_cov_3.947712	778	844	15	6	66	0.0909091
NODE_9917_length_864_cov_3.947712	778	844	16	17	66	0.2575758
NODE_9931_length_863_cov_72.856021	241	321	0	32	80	0.4000000
NODE_9931_length_863_cov_72.856021	241	321	2	48	80	0.6000000
NODE_9931_length_863_cov_72.856021	294	374	0	72	80	0.9000000
NODE_9931_length_863_cov_72.856021	294	374	2	8	80	0.1000000
NODE_9931_length_863_cov_72.856021	370	450	0	29	80	0.3625000
NODE_9931_length_863_cov_72.856021	370	450	6	36	80	0.4500000
NODE_9931_length_863_cov_72.856021	370	450	8	15	80	0.1875000
NODE_9931_length_863_cov_72.856021	423	503	6	12	80	0.1500000
NODE_9931_length_863_cov_72.856021	423	503	8	68	80	0.8500000
NODE_9932_length_863_cov_37.130890	363	443	1	80	80	1.0000000
NODE_9932_length_863_cov_37.130890	416	496	0	30	80	0.3750000
NODE_9932_length_863_cov_37.130890	416	496	1	50	80	0.6250000
NODE_9932_length_863_cov_37.130890	492	572	0	80	80	1.0000000
NODE_9932_length_863_cov_37.130890	545	617	0	64	72	0.8888889
NODE_9932_length_863_cov_37.130890	545	617	4	1	72	0.0138889
NODE_9932_length_863_cov_37.130890	545	617	6	1	72	0.0138889
NODE_9932_length_863_cov_37.130890	545	617	8	2	72	0.0277778
NODE_9932_length_863_cov_37.130890	545	617	12	2	72	0.0277778
NODE_9932_length_863_cov_37.130890	545	617	18	1	72	0.0138889
NODE_9932_length_863_cov_37.130890	545	617	45	1	72	0.0138889
NODE_9933_length_863_cov_33.159686	287	367	0	80	80	1.0000000
NODE_9933_length_863_cov_33.159686	340	420	0	80	80	1.0000000
NODE_9934_length_863_cov_24.714660	370	450	0	46	80	0.5750000
NODE_9934_length_863_cov_24.714660	370	450	2	34	80	0.4250000
NODE_9934_length_863_cov_24.714660	423	503	0	6	80	0.0750000
NODE_9934_length_863_cov_24.714660	423	503	2	74	80	0.9250000
NODE_9935_length_863_cov_21.945026	341	421	0	65	80	0.8125000
NODE_9935_length_863_cov_21.945026	341	421	2	15	80	0.1875000
NODE_9935_length_863_cov_21.945026	394	474	0	80	80	1.0000000
NODE_9936_length_863_cov_19.794503	393	473	2	20	80	0.2500000
NODE_9936_length_863_cov_19.794503	393	473	4	60	80	0.7500000
NODE_9936_length_863_cov_19.794503	446	526	2	33	80	0.4125000
NODE_9936_length_863_cov_19.794503	446	526	4	47	80	0.5875000
NODE_9937_length_863_cov_11.778796	303	383	0	80	80	1.0000000
NODE_9937_length_863_cov_11.778796	356	436	0	74	80	0.9250000
NODE_9937_length_863_cov_11.778796	356	436	2	6	80	0.0750000
NODE_9938_length_863_cov_10.026178	283	363	0	80	80	1.0000000
NODE_9938_length_863_cov_10.026178	336	416	0	80	80	1.0000000
NODE_9957_length_862_cov_46.811271	272	352	0	80	80	1.0000000
NODE_9957_length_862_cov_46.811271	325	405	0	80	80	1.0000000
NODE_9957_length_862_cov_46.811271	401	481	0	80	80	1.0000000
NODE_9957_length_862_cov_46.811271	454	534	0	80	80	1.0000000
NODE_9958_length_862_cov_34.638270	259	339	0	5	80	0.0625000
NODE_9958_length_862_cov_34.638270	259	339	2	75	80	0.9375000
NODE_9958_length_862_cov_34.638270	312	392	2	71	80	0.8875000
NODE_9958_length_862_cov_34.638270	312	392	4	9	80	0.1125000
NODE_9958_length_862_cov_34.638270	388	468	2	60	80	0.7500000
NODE_9958_length_862_cov_34.638270	388	468	4	20	80	0.2500000
NODE_9958_length_862_cov_34.638270	441	521	2	60	80	0.7500000
NODE_9958_length_862_cov_34.638270	441	521	4	20	80	0.2500000
NODE_9959_length_862_cov_32.068152	468	548	1	58	80	0.7250000
NODE_9959_length_862_cov_32.068152	468	548	2	22	80	0.2750000
NODE_9959_length_862_cov_32.068152	521	601	0	8	80	0.1000000
NODE_9959_length_862_cov_32.068152	521	601	1	72	80	0.9000000
NODE_9960_length_862_cov_23.584535	526	606	0	16	80	0.2000000
NODE_9960_length_862_cov_23.584535	526	606	1	2	80	0.0250000
NODE_9960_length_862_cov_23.584535	526	606	2	62	80	0.7750000
NODE_9960_length_862_cov_23.584535	579	659	0	4	80	0.0500000
NODE_9960_length_862_cov_23.584535	579	659	2	76	80	0.9500000
NODE_9961_length_862_cov_19.980341	347	427	0	24	80	0.3000000
NODE_9961_length_862_cov_19.980341	347	427	2	56	80	0.7000000
NODE_9961_length_862_cov_19.980341	400	480	0	13	80	0.1625000
NODE_9961_length_862_cov_19.980341	400	480	2	67	80	0.8375000
NODE_9962_length_862_cov_19.079948	379	459	0	80	80	1.0000000
NODE_9962_length_862_cov_19.079948	432	512	0	80	80	1.0000000
NODE_9963_length_862_cov_18.425950	94	174	0	74	80	0.9250000
NODE_9963_length_862_cov_18.425950	94	174	2	6	80	0.0750000
NODE_9963_length_862_cov_18.425950	147	201	0	21	54	0.3888889
NODE_9963_length_862_cov_18.425950	147	201	2	27	54	0.5000000
NODE_9963_length_862_cov_18.425950	147	201	4	6	54	0.1111111
NODE_9963_length_862_cov_18.425950	392	472	2	80	80	1.0000000
NODE_9963_length_862_cov_18.425950	445	525	0	50	80	0.6250000
NODE_9963_length_862_cov_18.425950	445	525	2	30	80	0.3750000
NODE_9964_length_862_cov_11.740498	348	428	4	7	80	0.0875000
NODE_9964_length_862_cov_11.740498	348	428	6	50	80	0.6250000
NODE_9964_length_862_cov_11.740498	348	428	8	3	80	0.0375000
NODE_9964_length_862_cov_11.740498	348	428	10	20	80	0.2500000
NODE_9964_length_862_cov_11.740498	401	481	4	24	80	0.3000000
NODE_9964_length_862_cov_11.740498	401	481	6	30	80	0.3750000
NODE_9964_length_862_cov_11.740498	401	481	8	3	80	0.0375000
NODE_9964_length_862_cov_11.740498	401	481	9	1	80	0.0125000
NODE_9964_length_862_cov_11.740498	401	481	10	22	80	0.2750000
NODE_9965_length_862_cov_11.685452	292	372	0	80	80	1.0000000
NODE_9965_length_862_cov_11.685452	345	425	0	80	80	1.0000000
NODE_9966_length_862_cov_8.259502	385	465	2	8	80	0.1000000
NODE_9966_length_862_cov_8.259502	385	465	4	72	80	0.9000000
NODE_9966_length_862_cov_8.259502	438	518	0	25	80	0.3125000
NODE_9966_length_862_cov_8.259502	438	518	2	3	80	0.0375000
NODE_9966_length_862_cov_8.259502	438	518	4	52	80	0.6500000
NODE_9970_length_862_cov_2.895151	388	468	0	80	80	1.0000000
NODE_9970_length_862_cov_2.895151	441	521	0	80	80	1.0000000
NODE_9984_length_861_cov_52.679790	450	530	4	80	80	1.0000000
NODE_9984_length_861_cov_52.679790	503	583	0	11	80	0.1375000
NODE_9984_length_861_cov_52.679790	503	583	2	31	80	0.3875000
NODE_9984_length_861_cov_52.679790	503	583	4	38	80	0.4750000
NODE_9985_length_861_cov_34.868766	470	550	0	80	80	1.0000000
NODE_9985_length_861_cov_34.868766	523	603	0	80	80	1.0000000
NODE_9986_length_861_cov_25.622047	145	225	0	74	80	0.9250000
NODE_9986_length_861_cov_25.622047	145	225	2	6	80	0.0750000
NODE_9986_length_861_cov_25.622047	198	278	0	21	80	0.2625000
NODE_9986_length_861_cov_25.622047	198	278	2	20	80	0.2500000
NODE_9986_length_861_cov_25.622047	198	278	4	39	80	0.4875000
NODE_9987_length_861_cov_22.052493	401	481	0	44	80	0.5500000
NODE_9987_length_861_cov_22.052493	401	481	2	36	80	0.4500000
NODE_9987_length_861_cov_22.052493	454	534	0	70	80	0.8750000
NODE_9987_length_861_cov_22.052493	454	534	2	10	80	0.1250000
NODE_9988_length_861_cov_19.913386	400	480	0	24	80	0.3000000
NODE_9988_length_861_cov_19.913386	400	480	8	56	80	0.7000000
NODE_9988_length_861_cov_19.913386	453	533	8	47	80	0.5875000
NODE_9988_length_861_cov_19.913386	453	533	12	33	80	0.4125000
NODE_9989_length_861_cov_15.237533	492	572	0	58	80	0.7250000
NODE_9989_length_861_cov_15.237533	492	572	2	22	80	0.2750000
NODE_9989_length_861_cov_15.237533	545	625	0	5	80	0.0625000
NODE_9989_length_861_cov_15.237533	545	625	2	75	80	0.9375000
NODE_9990_length_861_cov_12.460630	451	531	0	80	80	1.0000000
NODE_9990_length_861_cov_12.460630	504	584	0	80	80	1.0000000
NODE_9991_length_861_cov_9.463255	446	526	0	2	80	0.0250000
NODE_9991_length_861_cov_9.463255	446	526	2	40	80	0.5000000
NODE_9991_length_861_cov_9.463255	446	526	4	38	80	0.4750000
NODE_9991_length_861_cov_9.463255	499	579	2	18	80	0.2250000
NODE_9991_length_861_cov_9.463255	499	579	4	62	80	0.7750000
NODE_9992_length_861_cov_9.435696	348	423	0	75	75	1.0000000
NODE_9993_length_861_cov_7.009186	51	91	0	40	40	1.0000000
NODE_9993_length_861_cov_7.009186	185	265	0	34	80	0.4250000
NODE_9993_length_861_cov_7.009186	185	265	2	46	80	0.5750000
NODE_9993_length_861_cov_7.009186	238	318	2	80	80	1.0000000
NODE_10019_length_860_cov_54.315375	245	325	0	80	80	1.0000000
NODE_10019_length_860_cov_54.315375	298	378	0	80	80	1.0000000
NODE_10019_length_860_cov_54.315375	374	454	0	80	80	1.0000000
NODE_10019_length_860_cov_54.315375	427	507	0	80	80	1.0000000
NODE_10020_length_860_cov_29.618922	356	436	0	25	80	0.3125000
NODE_10020_length_860_cov_29.618922	356	436	2	55	80	0.6875000
NODE_10020_length_860_cov_29.618922	409	489	0	18	80	0.2250000
NODE_10020_length_860_cov_29.618922	409	489	2	62	80	0.7750000
NODE_10021_length_860_cov_15.152431	393	473	4	21	80	0.2625000
NODE_10021_length_860_cov_15.152431	393	473	6	5	80	0.0625000
NODE_10021_length_860_cov_15.152431	393	473	8	12	80	0.1500000
NODE_10021_length_860_cov_15.152431	393	473	10	26	80	0.3250000
NODE_10021_length_860_cov_15.152431	393	473	12	16	80	0.2000000
NODE_10021_length_860_cov_15.152431	446	526	8	4	80	0.0500000
NODE_10021_length_860_cov_15.152431	446	526	9	2	80	0.0250000
NODE_10021_length_860_cov_15.152431	446	526	10	58	80	0.7250000
NODE_10021_length_860_cov_15.152431	446	526	12	16	80	0.2000000
NODE_10022_length_860_cov_11.320631	343	423	0	80	80	1.0000000
NODE_10022_length_860_cov_11.320631	396	476	0	43	80	0.5375000
NODE_10022_length_860_cov_11.320631	396	476	2	2	80	0.0250000
NODE_10022_length_860_cov_11.320631	396	476	4	35	80	0.4375000
NODE_10049_length_859_cov_48.173684	432	512	2	8	80	0.1000000
NODE_10049_length_859_cov_48.173684	432	512	4	13	80	0.1625000
NODE_10049_length_859_cov_48.173684	432	512	6	9	80	0.1125000
NODE_10049_length_859_cov_48.173684	432	512	8	30	80	0.3750000
NODE_10049_length_859_cov_48.173684	432	512	10	20	80	0.2500000
NODE_10049_length_859_cov_48.173684	485	565	0	44	80	0.5500000
NODE_10049_length_859_cov_48.173684	485	565	2	17	80	0.2125000
NODE_10049_length_859_cov_48.173684	485	565	6	9	80	0.1125000
NODE_10049_length_859_cov_48.173684	485	565	8	10	80	0.1250000
NODE_10050_length_859_cov_24.957895	402	482	2	30	80	0.3750000
NODE_10050_length_859_cov_24.957895	402	482	4	50	80	0.6250000
NODE_10050_length_859_cov_24.957895	455	535	2	49	80	0.6125000
NODE_10050_length_859_cov_24.957895	455	535	4	31	80	0.3875000
NODE_10051_length_859_cov_23.431579	251	331	2	5	80	0.0625000
NODE_10051_length_859_cov_23.431579	251	331	4	14	80	0.1750000
NODE_10051_length_859_cov_23.431579	251	331	6	10	80	0.1250000
NODE_10051_length_859_cov_23.431579	251	331	8	2	80	0.0250000
NODE_10051_length_859_cov_23.431579	251	331	10	18	80	0.2250000
NODE_10051_length_859_cov_23.431579	251	331	12	18	80	0.2250000
NODE_10051_length_859_cov_23.431579	251	331	14	13	80	0.1625000
NODE_10051_length_859_cov_23.431579	304	384	5	2	80	0.0250000
NODE_10051_length_859_cov_23.431579	304	384	7	12	80	0.1500000
NODE_10051_length_859_cov_23.431579	304	384	9	1	80	0.0125000
NODE_10051_length_859_cov_23.431579	304	384	10	23	80	0.2875000
NODE_10051_length_859_cov_23.431579	304	384	12	16	80	0.2000000
NODE_10051_length_859_cov_23.431579	304	384	14	26	80	0.3250000
NODE_10052_length_859_cov_20.523684	341	421	0	80	80	1.0000000
NODE_10052_length_859_cov_20.523684	394	474	0	80	80	1.0000000
NODE_10053_length_859_cov_17.996053	316	396	0	80	80	1.0000000
NODE_10053_length_859_cov_17.996053	369	449	0	80	80	1.0000000
NODE_10054_length_859_cov_16.757895	404	484	0	80	80	1.0000000
NODE_10054_length_859_cov_16.757895	457	537	0	80	80	1.0000000
NODE_10055_length_859_cov_15.852632	346	426	10	19	80	0.2375000
NODE_10055_length_859_cov_15.852632	346	426	12	50	80	0.6250000
NODE_10055_length_859_cov_15.852632	346	426	14	11	80	0.1375000
NODE_10055_length_859_cov_15.852632	399	479	2	23	80	0.2875000
NODE_10055_length_859_cov_15.852632	399	479	8	16	80	0.2000000
NODE_10055_length_859_cov_15.852632	399	479	10	14	80	0.1750000
NODE_10055_length_859_cov_15.852632	399	479	12	27	80	0.3375000
NODE_10056_length_859_cov_11.584211	407	487	0	23	80	0.2875000
NODE_10056_length_859_cov_11.584211	407	487	2	57	80	0.7125000
NODE_10056_length_859_cov_11.584211	460	540	2	69	80	0.8625000
NODE_10056_length_859_cov_11.584211	460	540	4	11	80	0.1375000
NODE_10057_length_859_cov_10.296053	368	448	0	61	80	0.7625000
NODE_10057_length_859_cov_10.296053	368	448	2	9	80	0.1125000
NODE_10057_length_859_cov_10.296053	368	448	4	10	80	0.1250000
NODE_10057_length_859_cov_10.296053	421	501	0	8	80	0.1000000
NODE_10057_length_859_cov_10.296053	421	501	2	9	80	0.1125000
NODE_10057_length_859_cov_10.296053	421	501	4	63	80	0.7875000
NODE_10066_length_859_cov_2.359211	498	578	0	10	80	0.1250000
NODE_10066_length_859_cov_2.359211	498	578	2	2	80	0.0250000
NODE_10066_length_859_cov_2.359211	498	578	4	68	80	0.8500000
NODE_10066_length_859_cov_2.359211	551	631	0	5	80	0.0625000
NODE_10066_length_859_cov_2.359211	551	631	2	21	80	0.2625000
NODE_10066_length_859_cov_2.359211	551	631	4	54	80	0.6750000
NODE_10079_length_858_cov_54.677207	277	357	0	17	80	0.2125000
NODE_10079_length_858_cov_54.677207	277	357	1	63	80	0.7875000
NODE_10079_length_858_cov_54.677207	330	410	0	70	80	0.8750000
NODE_10079_length_858_cov_54.677207	330	410	1	10	80	0.1250000
NODE_10080_length_858_cov_40.584980	500	580	0	26	80	0.3250000
NODE_10080_length_858_cov_40.584980	500	580	1	11	80	0.1375000
NODE_10080_length_858_cov_40.584980	500	580	2	43	80	0.5375000
NODE_10080_length_858_cov_40.584980	553	633	0	79	80	0.9875000
NODE_10080_length_858_cov_40.584980	553	633	1	1	80	0.0125000
NODE_10081_length_858_cov_30.177866	363	443	0	6	80	0.0750000
NODE_10081_length_858_cov_30.177866	363	443	4	74	80	0.9250000
NODE_10081_length_858_cov_30.177866	416	496	0	45	80	0.5625000
NODE_10081_length_858_cov_30.177866	416	496	4	35	80	0.4375000
NODE_10081_length_858_cov_30.177866	492	572	0	80	80	1.0000000
NODE_10081_length_858_cov_30.177866	545	625	0	80	80	1.0000000
NODE_10082_length_858_cov_18.534914	371	451	0	29	80	0.3625000
NODE_10082_length_858_cov_18.534914	371	451	2	9	80	0.1125000
NODE_10082_length_858_cov_18.534914	371	451	3	34	80	0.4250000
NODE_10082_length_858_cov_18.534914	371	451	4	8	80	0.1000000
NODE_10082_length_858_cov_18.534914	424	504	2	36	80	0.4500000
NODE_10082_length_858_cov_18.534914	424	504	3	19	80	0.2375000
NODE_10082_length_858_cov_18.534914	424	504	4	25	80	0.3125000
NODE_10083_length_858_cov_15.378129	232	312	0	15	80	0.1875000
NODE_10083_length_858_cov_15.378129	232	312	2	25	80	0.3125000
NODE_10083_length_858_cov_15.378129	232	312	4	40	80	0.5000000
NODE_10083_length_858_cov_15.378129	285	365	0	20	80	0.2500000
NODE_10083_length_858_cov_15.378129	285	365	2	7	80	0.0875000
NODE_10083_length_858_cov_15.378129	285	365	4	53	80	0.6625000
NODE_10084_length_858_cov_12.310935	335	415	0	80	80	1.0000000
NODE_10084_length_858_cov_12.310935	388	468	0	80	80	1.0000000
NODE_10085_length_858_cov_7.835310	396	479	0	83	83	1.0000000
NODE_10085_length_858_cov_7.835310	452	532	0	80	80	1.0000000
NODE_10088_length_858_cov_4.953887	474	554	0	80	80	1.0000000
NODE_10088_length_858_cov_4.953887	527	607	0	80	80	1.0000000
NODE_10091_length_858_cov_3.475626	428	502	0	74	74	1.0000000
NODE_10091_length_858_cov_3.475626	498	578	0	62	80	0.7750000
NODE_10091_length_858_cov_3.475626	498	578	2	7	80	0.0875000
NODE_10091_length_858_cov_3.475626	498	578	4	11	80	0.1375000
NODE_10091_length_858_cov_3.475626	551	631	0	9	80	0.1125000
NODE_10091_length_858_cov_3.475626	551	631	2	28	80	0.3500000
NODE_10091_length_858_cov_3.475626	551	631	4	43	80	0.5375000
NODE_10108_length_857_cov_33.449868	384	455	2	2	71	0.0281690
NODE_10108_length_857_cov_33.449868	384	455	8	69	71	0.9718310
NODE_10108_length_857_cov_33.449868	437	518	0	7	81	0.0864198
NODE_10108_length_857_cov_33.449868	437	518	2	58	81	0.7160494
NODE_10108_length_857_cov_33.449868	437	518	8	16	81	0.1975309
NODE_10109_length_857_cov_32.527704	391	471	0	3	80	0.0375000
NODE_10109_length_857_cov_32.527704	391	471	2	10	80	0.1250000
NODE_10109_length_857_cov_32.527704	391	471	8	22	80	0.2750000
NODE_10109_length_857_cov_32.527704	391	471	10	45	80	0.5625000
NODE_10109_length_857_cov_32.527704	444	524	8	47	80	0.5875000
NODE_10109_length_857_cov_32.527704	444	524	10	33	80	0.4125000
NODE_10110_length_857_cov_27.853562	310	390	0	31	80	0.3875000
NODE_10110_length_857_cov_27.853562	310	390	4	49	80	0.6125000
NODE_10110_length_857_cov_27.853562	363	443	4	80	80	1.0000000
NODE_10111_length_857_cov_24.654354	282	362	0	4	80	0.0500000
NODE_10111_length_857_cov_24.654354	282	362	2	25	80	0.3125000
NODE_10111_length_857_cov_24.654354	282	362	4	51	80	0.6375000
NODE_10111_length_857_cov_24.654354	335	415	0	7	80	0.0875000
NODE_10111_length_857_cov_24.654354	335	415	2	40	80	0.5000000
NODE_10111_length_857_cov_24.654354	335	415	4	33	80	0.4125000
NODE_10112_length_857_cov_22.604222	374	456	0	82	82	1.0000000
NODE_10112_length_857_cov_22.604222	427	509	0	82	82	1.0000000
NODE_10113_length_857_cov_17.399736	320	400	4	18	80	0.2250000
NODE_10113_length_857_cov_17.399736	320	400	6	62	80	0.7750000
NODE_10113_length_857_cov_17.399736	373	453	0	31	80	0.3875000
NODE_10113_length_857_cov_17.399736	373	453	4	40	80	0.5000000
NODE_10113_length_857_cov_17.399736	373	453	6	9	80	0.1125000
NODE_10114_length_857_cov_17.069921	388	468	0	20	80	0.2500000
NODE_10114_length_857_cov_17.069921	388	468	2	6	80	0.0750000
NODE_10114_length_857_cov_17.069921	388	468	4	54	80	0.6750000
NODE_10114_length_857_cov_17.069921	441	521	0	73	80	0.9125000
NODE_10114_length_857_cov_17.069921	441	521	2	6	80	0.0750000
NODE_10114_length_857_cov_17.069921	441	521	4	1	80	0.0125000
NODE_10115_length_857_cov_11.816623	433	513	0	80	80	1.0000000
NODE_10115_length_857_cov_11.816623	486	566	0	80	80	1.0000000
NODE_10116_length_857_cov_6.733509	513	593	0	80	80	1.0000000
NODE_10117_length_857_cov_6.251979	298	378	0	80	80	1.0000000
NODE_10117_length_857_cov_6.251979	351	431	0	80	80	1.0000000
NODE_10118_length_857_cov_5.827177	323	403	0	80	80	1.0000000
NODE_10118_length_857_cov_5.827177	376	456	0	80	80	1.0000000
NODE_10120_length_857_cov_4.530343	362	442	0	80	80	1.0000000
NODE_10120_length_857_cov_4.530343	415	495	0	80	80	1.0000000
NODE_10128_length_857_cov_1.464380	179	249	0	5	70	0.0714286
NODE_10128_length_857_cov_1.464380	179	249	4	3	70	0.0428571
NODE_10128_length_857_cov_1.464380	179	249	6	1	70	0.0142857
NODE_10128_length_857_cov_1.464380	179	249	7	1	70	0.0142857
NODE_10128_length_857_cov_1.464380	179	249	12	1	70	0.0142857
NODE_10128_length_857_cov_1.464380	179	249	14	12	70	0.1714286
NODE_10128_length_857_cov_1.464380	179	249	16	47	70	0.6714286
NODE_10128_length_857_cov_1.464380	222	288	12	7	66	0.1060606
NODE_10128_length_857_cov_1.464380	222	288	13	5	66	0.0757576
NODE_10128_length_857_cov_1.464380	222	288	14	1	66	0.0151515
NODE_10128_length_857_cov_1.464380	222	288	16	34	66	0.5151515
NODE_10128_length_857_cov_1.464380	222	288	18	7	66	0.1060606
NODE_10128_length_857_cov_1.464380	222	288	20	12	66	0.1818182
NODE_10138_length_856_cov_39.147952	157	237	2	80	80	1.0000000
NODE_10138_length_856_cov_39.147952	210	290	0	49	80	0.6125000
NODE_10138_length_856_cov_39.147952	210	290	2	31	80	0.3875000
NODE_10138_length_856_cov_39.147952	286	366	0	48	80	0.6000000
NODE_10138_length_856_cov_39.147952	286	366	2	25	80	0.3125000
NODE_10138_length_856_cov_39.147952	286	366	4	4	80	0.0500000
NODE_10138_length_856_cov_39.147952	286	366	6	3	80	0.0375000
NODE_10138_length_856_cov_39.147952	339	419	2	20	80	0.2500000
NODE_10138_length_856_cov_39.147952	339	419	4	4	80	0.0500000
NODE_10138_length_856_cov_39.147952	339	419	6	56	80	0.7000000
NODE_10139_length_856_cov_21.937913	353	433	0	30	80	0.3750000
NODE_10139_length_856_cov_21.937913	353	433	2	50	80	0.6250000
NODE_10139_length_856_cov_21.937913	406	486	0	35	80	0.4375000
NODE_10139_length_856_cov_21.937913	406	486	2	45	80	0.5625000
NODE_10140_length_856_cov_20.227213	375	459	0	84	84	1.0000000
NODE_10140_length_856_cov_20.227213	432	512	0	69	80	0.8625000
NODE_10140_length_856_cov_20.227213	432	512	2	11	80	0.1375000
NODE_10141_length_856_cov_18.445178	340	420	0	80	80	1.0000000
NODE_10141_length_856_cov_18.445178	393	473	0	80	80	1.0000000
NODE_10142_length_856_cov_16.564069	462	543	0	26	81	0.3209876
NODE_10142_length_856_cov_16.564069	462	543	2	9	81	0.1111111
NODE_10142_length_856_cov_16.564069	462	543	4	2	81	0.0246914
NODE_10142_length_856_cov_16.564069	462	543	6	16	81	0.1975309
NODE_10142_length_856_cov_16.564069	462	543	8	28	81	0.3456790
NODE_10142_length_856_cov_16.564069	516	596	8	80	80	1.0000000
NODE_10142_length_856_cov_16.564069	516	593	8	77	77	1.0000000
NODE_10143_length_856_cov_15.803170	403	483	0	52	80	0.6500000
NODE_10143_length_856_cov_15.803170	403	483	2	5	80	0.0625000
NODE_10143_length_856_cov_15.803170	403	483	4	23	80	0.2875000
NODE_10143_length_856_cov_15.803170	456	536	0	80	80	1.0000000
NODE_10144_length_856_cov_12.904888	345	425	0	66	80	0.8250000
NODE_10144_length_856_cov_12.904888	345	425	2	14	80	0.1750000
NODE_10144_length_856_cov_12.904888	398	478	0	80	80	1.0000000
NODE_10145_length_856_cov_9.881110	338	418	0	75	80	0.9375000
NODE_10145_length_856_cov_9.881110	338	418	1	5	80	0.0625000
NODE_10145_length_856_cov_9.881110	391	471	0	22	80	0.2750000
NODE_10145_length_856_cov_9.881110	391	471	1	20	80	0.2500000
NODE_10145_length_856_cov_9.881110	391	471	2	38	80	0.4750000
NODE_10146_length_856_cov_5.875826	405	485	0	16	80	0.2000000
NODE_10146_length_856_cov_5.875826	405	485	4	64	80	0.8000000
NODE_10146_length_856_cov_5.875826	458	538	0	69	80	0.8625000
NODE_10146_length_856_cov_5.875826	458	538	4	11	80	0.1375000
NODE_10149_length_856_cov_4.821664	466	546	0	48	80	0.6000000
NODE_10149_length_856_cov_4.821664	466	546	4	16	80	0.2000000
NODE_10149_length_856_cov_4.821664	466	546	6	16	80	0.2000000
NODE_10149_length_856_cov_4.821664	519	599	4	11	80	0.1375000
NODE_10149_length_856_cov_4.821664	519	599	6	69	80	0.8625000
NODE_10151_length_856_cov_4.195509	248	328	0	48	80	0.6000000
NODE_10151_length_856_cov_4.195509	248	328	2	30	80	0.3750000
NODE_10151_length_856_cov_4.195509	248	328	3	2	80	0.0250000
NODE_10151_length_856_cov_4.195509	301	381	0	37	80	0.4625000
NODE_10151_length_856_cov_4.195509	301	381	2	4	80	0.0500000
NODE_10151_length_856_cov_4.195509	301	381	4	21	80	0.2625000
NODE_10151_length_856_cov_4.195509	301	381	6	18	80	0.2250000
NODE_10152_length_856_cov_3.899604	262	339	0	77	77	1.0000000
NODE_10152_length_856_cov_3.899604	312	392	0	79	80	0.9875000
NODE_10152_length_856_cov_3.899604	312	392	2	1	80	0.0125000
NODE_10176_length_855_cov_28.312169	541	621	0	56	80	0.7000000
NODE_10176_length_855_cov_28.312169	541	621	2	24	80	0.3000000
NODE_10176_length_855_cov_28.312169	594	674	0	80	80	1.0000000
NODE_10177_length_855_cov_19.392857	692	772	2	18	80	0.2250000
NODE_10177_length_855_cov_19.392857	692	772	3	28	80	0.3500000
NODE_10177_length_855_cov_19.392857	692	772	4	34	80	0.4250000
NODE_10177_length_855_cov_19.392857	745	825	0	36	80	0.4500000
NODE_10177_length_855_cov_19.392857	745	825	2	29	80	0.3625000
NODE_10177_length_855_cov_19.392857	745	825	3	15	80	0.1875000
NODE_10178_length_855_cov_13.402116	343	423	0	20	80	0.2500000
NODE_10178_length_855_cov_13.402116	343	423	2	12	80	0.1500000
NODE_10178_length_855_cov_13.402116	343	423	6	48	80	0.6000000
NODE_10178_length_855_cov_13.402116	396	476	4	32	80	0.4000000
NODE_10178_length_855_cov_13.402116	396	476	6	48	80	0.6000000
NODE_10179_length_855_cov_13.116402	295	375	0	7	80	0.0875000
NODE_10179_length_855_cov_13.116402	295	375	2	6	80	0.0750000
NODE_10179_length_855_cov_13.116402	295	375	4	23	80	0.2875000
NODE_10179_length_855_cov_13.116402	295	375	6	44	80	0.5500000
NODE_10179_length_855_cov_13.116402	348	428	0	12	80	0.1500000
NODE_10179_length_855_cov_13.116402	348	428	2	11	80	0.1375000
NODE_10179_length_855_cov_13.116402	348	428	4	24	80	0.3000000
NODE_10179_length_855_cov_13.116402	348	428	6	33	80	0.4125000
NODE_10180_length_855_cov_11.179894	360	436	0	76	76	1.0000000
NODE_10180_length_855_cov_11.179894	409	489	0	80	80	1.0000000
NODE_10183_length_855_cov_8.593915	339	419	0	80	80	1.0000000
NODE_10183_length_855_cov_8.593915	392	472	0	80	80	1.0000000
NODE_10206_length_854_cov_64.200000	586	666	4	4	80	0.0500000
NODE_10206_length_854_cov_64.200000	586	666	6	23	80	0.2875000
NODE_10206_length_854_cov_64.200000	586	666	7	53	80	0.6625000
NODE_10206_length_854_cov_64.200000	639	719	2	7	80	0.0875000
NODE_10206_length_854_cov_64.200000	639	719	4	19	80	0.2375000
NODE_10206_length_854_cov_64.200000	639	719	6	2	80	0.0250000
NODE_10206_length_854_cov_64.200000	639	719	7	35	80	0.4375000
NODE_10206_length_854_cov_64.200000	639	719	8	17	80	0.2125000
NODE_10207_length_854_cov_46.037086	348	428	4	80	80	1.0000000
NODE_10207_length_854_cov_46.037086	401	481	0	41	80	0.5125000
NODE_10207_length_854_cov_46.037086	401	481	2	5	80	0.0625000
NODE_10207_length_854_cov_46.037086	401	481	4	34	80	0.4250000
NODE_10207_length_854_cov_46.037086	458	481	0	23	23	1.0000000
NODE_10208_length_854_cov_45.633113	393	473	6	6	80	0.0750000
NODE_10208_length_854_cov_45.633113	393	473	8	13	80	0.1625000
NODE_10208_length_854_cov_45.633113	393	473	10	61	80	0.7625000
NODE_10208_length_854_cov_45.633113	446	526	0	21	80	0.2625000
NODE_10208_length_854_cov_45.633113	446	526	2	1	80	0.0125000
NODE_10208_length_854_cov_45.633113	446	526	4	27	80	0.3375000
NODE_10208_length_854_cov_45.633113	446	526	8	13	80	0.1625000
NODE_10208_length_854_cov_45.633113	446	526	10	18	80	0.2250000
NODE_10209_length_854_cov_40.407947	489	569	0	40	80	0.5000000
NODE_10209_length_854_cov_40.407947	489	569	2	40	80	0.5000000
NODE_10209_length_854_cov_40.407947	542	622	0	2	80	0.0250000
NODE_10209_length_854_cov_40.407947	542	622	2	78	80	0.9750000
NODE_10210_length_854_cov_29.773510	450	530	2	33	80	0.4125000
NODE_10210_length_854_cov_29.773510	450	530	4	47	80	0.5875000
NODE_10210_length_854_cov_29.773510	503	583	0	6	80	0.0750000
NODE_10210_length_854_cov_29.773510	503	583	2	20	80	0.2500000
NODE_10210_length_854_cov_29.773510	503	583	4	54	80	0.6750000
NODE_10211_length_854_cov_22.968212	318	398	0	33	80	0.4125000
NODE_10211_length_854_cov_22.968212	318	398	2	47	80	0.5875000
NODE_10211_length_854_cov_22.968212	371	451	0	25	80	0.3125000
NODE_10211_length_854_cov_22.968212	371	451	2	55	80	0.6875000
NODE_10212_length_854_cov_18.038411	387	467	0	51	80	0.6375000
NODE_10212_length_854_cov_18.038411	387	467	2	29	80	0.3625000
NODE_10212_length_854_cov_18.038411	440	520	2	29	80	0.3625000
NODE_10212_length_854_cov_18.038411	440	520	4	51	80	0.6375000
NODE_10213_length_854_cov_13.774834	330	410	0	80	80	1.0000000
NODE_10213_length_854_cov_13.774834	383	463	0	80	80	1.0000000
NODE_10214_length_854_cov_11.998675	366	446	0	32	80	0.4000000
NODE_10214_length_854_cov_11.998675	366	446	4	48	80	0.6000000
NODE_10214_length_854_cov_11.998675	419	499	0	80	80	1.0000000
NODE_10215_length_854_cov_7.600000	298	378	0	36	80	0.4500000
NODE_10215_length_854_cov_7.600000	298	378	2	7	80	0.0875000
NODE_10215_length_854_cov_7.600000	298	378	4	15	80	0.1875000
NODE_10215_length_854_cov_7.600000	298	378	6	22	80	0.2750000
NODE_10215_length_854_cov_7.600000	351	431	4	21	80	0.2625000
NODE_10215_length_854_cov_7.600000	351	431	6	59	80	0.7375000
NODE_10218_length_854_cov_4.939073	603	633	0	29	30	0.9666666
NODE_10218_length_854_cov_4.939073	603	633	2	1	30	0.0333333
NODE_10226_length_854_cov_2.354967	613	633	0	20	20	1.0000000
NODE_10239_length_853_cov_61.988064	380	460	7	10	80	0.1250000
NODE_10239_length_853_cov_61.988064	380	460	8	6	80	0.0750000
NODE_10239_length_853_cov_61.988064	380	460	9	6	80	0.0750000
NODE_10239_length_853_cov_61.988064	380	460	10	58	80	0.7250000
NODE_10239_length_853_cov_61.988064	433	513	4	4	80	0.0500000
NODE_10239_length_853_cov_61.988064	433	513	5	26	80	0.3250000
NODE_10239_length_853_cov_61.988064	433	513	7	6	80	0.0750000
NODE_10239_length_853_cov_61.988064	433	513	8	23	80	0.2875000
NODE_10239_length_853_cov_61.988064	433	513	10	21	80	0.2625000
NODE_10240_length_853_cov_33.683024	384	464	2	8	80	0.1000000
NODE_10240_length_853_cov_33.683024	384	464	4	65	80	0.8125000
NODE_10240_length_853_cov_33.683024	384	464	6	7	80	0.0875000
NODE_10240_length_853_cov_33.683024	437	517	2	53	80	0.6625000
NODE_10240_length_853_cov_33.683024	437	517	4	27	80	0.3375000
NODE_10241_length_853_cov_31.965517	224	305	2	6	81	0.0740741
NODE_10241_length_853_cov_31.965517	224	305	4	12	81	0.1481481
NODE_10241_length_853_cov_31.965517	224	305	8	8	81	0.0987654
NODE_10241_length_853_cov_31.965517	224	305	10	44	81	0.5432099
NODE_10241_length_853_cov_31.965517	224	305	12	11	81	0.1358025
NODE_10241_length_853_cov_31.965517	278	358	4	13	80	0.1625000
NODE_10241_length_853_cov_31.965517	278	358	6	19	80	0.2375000
NODE_10241_length_853_cov_31.965517	278	358	9	18	80	0.2250000
NODE_10241_length_853_cov_31.965517	278	358	10	24	80	0.3000000
NODE_10241_length_853_cov_31.965517	278	358	12	6	80	0.0750000
NODE_10241_length_853_cov_31.965517	354	434	0	9	80	0.1125000
NODE_10241_length_853_cov_31.965517	354	434	2	40	80	0.5000000
NODE_10241_length_853_cov_31.965517	354	434	3	9	80	0.1125000
NODE_10241_length_853_cov_31.965517	354	434	4	22	80	0.2750000
NODE_10241_length_853_cov_31.965517	407	466	0	41	59	0.6949152
NODE_10241_length_853_cov_31.965517	407	466	2	18	59	0.3050847
NODE_10242_length_853_cov_16.551724	247	327	0	3	80	0.0375000
NODE_10242_length_853_cov_16.551724	247	327	2	56	80	0.7000000
NODE_10242_length_853_cov_16.551724	247	327	4	21	80	0.2625000
NODE_10242_length_853_cov_16.551724	300	380	0	10	80	0.1250000
NODE_10242_length_853_cov_16.551724	300	380	2	70	80	0.8750000
NODE_10242_length_853_cov_16.551724	376	456	0	80	80	1.0000000
NODE_10242_length_853_cov_16.551724	429	509	0	64	80	0.8000000
NODE_10242_length_853_cov_16.551724	429	509	2	16	80	0.2000000
NODE_10243_length_853_cov_15.395225	395	475	0	10	80	0.1250000
NODE_10243_length_853_cov_15.395225	395	475	2	70	80	0.8750000
NODE_10243_length_853_cov_15.395225	448	528	0	20	80	0.2500000
NODE_10243_length_853_cov_15.395225	448	528	2	60	80	0.7500000
NODE_10244_length_853_cov_15.086207	355	434	10	48	79	0.6075949
NODE_10244_length_853_cov_15.086207	355	434	12	31	79	0.3924051
NODE_10244_length_853_cov_15.086207	408	488	2	7	80	0.0875000
NODE_10244_length_853_cov_15.086207	408	488	8	1	80	0.0125000
NODE_10244_length_853_cov_15.086207	408	488	10	49	80	0.6125000
NODE_10244_length_853_cov_15.086207	408	488	12	23	80	0.2875000
NODE_10245_length_853_cov_14.929708	160	240	4	51	80	0.6375000
NODE_10245_length_853_cov_14.929708	160	240	8	29	80	0.3625000
NODE_10245_length_853_cov_14.929708	213	293	4	34	80	0.4250000
NODE_10245_length_853_cov_14.929708	213	293	8	46	80	0.5750000
NODE_10246_length_853_cov_11.299735	395	475	0	80	80	1.0000000
NODE_10246_length_853_cov_11.299735	448	528	0	80	80	1.0000000
NODE_10247_length_853_cov_9.571618	479	559	0	36	80	0.4500000
NODE_10247_length_853_cov_9.571618	479	559	2	44	80	0.5500000
NODE_10247_length_853_cov_9.571618	532	612	0	20	80	0.2500000
NODE_10247_length_853_cov_9.571618	532	612	2	60	80	0.7500000
NODE_10248_length_853_cov_7.828912	265	345	0	39	80	0.4875000
NODE_10248_length_853_cov_7.828912	265	345	4	41	80	0.5125000
NODE_10248_length_853_cov_7.828912	318	398	4	80	80	1.0000000
NODE_10249_length_853_cov_7.623342	255	335	0	80	80	1.0000000
NODE_10249_length_853_cov_7.623342	308	388	0	53	80	0.6625000
NODE_10249_length_853_cov_7.623342	308	388	2	27	80	0.3375000
NODE_10253_length_853_cov_3.173740	212	292	0	80	80	1.0000000
NODE_10253_length_853_cov_3.173740	265	343	0	78	78	1.0000000
NODE_10258_length_853_cov_1.823607	710	773	0	63	63	1.0000000
NODE_10258_length_853_cov_1.823607	711	773	0	62	62	1.0000000
NODE_10258_length_853_cov_1.823607	711	773	0	62	62	1.0000000
NODE_10258_length_853_cov_1.823607	746	826	0	80	80	1.0000000
NODE_10267_length_852_cov_30.022576	279	359	4	80	80	1.0000000
NODE_10267_length_852_cov_30.022576	332	412	0	53	80	0.6625000
NODE_10267_length_852_cov_30.022576	332	412	4	27	80	0.3375000
NODE_10268_length_852_cov_19.373174	353	433	2	80	80	1.0000000
NODE_10268_length_852_cov_19.373174	406	486	0	41	80	0.5125000
NODE_10268_length_852_cov_19.373174	406	486	2	39	80	0.4875000
NODE_10269_length_852_cov_18.853918	297	377	2	15	80	0.1875000
NODE_10269_length_852_cov_18.853918	297	377	4	65	80	0.8125000
NODE_10269_length_852_cov_18.853918	350	430	0	48	80	0.6000000
NODE_10269_length_852_cov_18.853918	350	430	2	20	80	0.2500000
NODE_10269_length_852_cov_18.853918	350	430	4	12	80	0.1500000
NODE_10269_length_852_cov_18.853918	426	506	0	80	80	1.0000000
NODE_10269_length_852_cov_18.853918	489	559	0	70	70	1.0000000
NODE_10270_length_852_cov_17.391766	472	552	0	80	80	1.0000000
NODE_10270_length_852_cov_17.391766	525	605	0	80	80	1.0000000
NODE_10271_length_852_cov_8.818061	513	593	0	80	80	1.0000000
NODE_10271_length_852_cov_8.818061	566	646	0	80	80	1.0000000
NODE_10274_length_852_cov_4.403718	493	573	0	80	80	1.0000000
NODE_10274_length_852_cov_4.403718	546	626	0	76	80	0.9500000
NODE_10274_length_852_cov_4.403718	546	626	1	4	80	0.0500000
NODE_10285_length_851_cov_33.953457	329	409	0	80	80	1.0000000
NODE_10285_length_851_cov_33.953457	382	462	0	80	80	1.0000000
NODE_10286_length_851_cov_30.488032	395	475	0	37	80	0.4625000
NODE_10286_length_851_cov_30.488032	395	475	2	13	80	0.1625000
NODE_10286_length_851_cov_30.488032	395	475	4	4	80	0.0500000
NODE_10286_length_851_cov_30.488032	395	475	6	26	80	0.3250000
NODE_10286_length_851_cov_30.488032	448	528	2	14	80	0.1750000
NODE_10286_length_851_cov_30.488032	448	528	4	6	80	0.0750000
NODE_10286_length_851_cov_30.488032	448	528	6	60	80	0.7500000
NODE_10287_length_851_cov_27.481383	353	433	0	80	80	1.0000000
NODE_10287_length_851_cov_27.481383	406	486	0	80	80	1.0000000
NODE_10288_length_851_cov_23.656915	345	425	2	80	80	1.0000000
NODE_10288_length_851_cov_23.656915	398	478	0	39	80	0.4875000
NODE_10288_length_851_cov_23.656915	398	478	2	41	80	0.5125000
NODE_10289_length_851_cov_19.769947	298	378	2	42	80	0.5250000
NODE_10289_length_851_cov_19.769947	298	378	4	18	80	0.2250000
NODE_10289_length_851_cov_19.769947	298	378	6	20	80	0.2500000
NODE_10289_length_851_cov_19.769947	351	431	0	5	80	0.0625000
NODE_10289_length_851_cov_19.769947	351	431	4	66	80	0.8250000
NODE_10289_length_851_cov_19.769947	351	431	6	9	80	0.1125000
NODE_10290_length_851_cov_17.386968	459	539	0	7	80	0.0875000
NODE_10290_length_851_cov_17.386968	459	539	1	1	80	0.0125000
NODE_10290_length_851_cov_17.386968	459	539	2	72	80	0.9000000
NODE_10290_length_851_cov_17.386968	512	592	2	80	80	1.0000000
NODE_10291_length_851_cov_13.519947	323	403	4	23	80	0.2875000
NODE_10291_length_851_cov_13.519947	323	403	6	31	80	0.3875000
NODE_10291_length_851_cov_13.519947	323	403	8	26	80	0.3250000
NODE_10291_length_851_cov_13.519947	376	456	0	11	80	0.1375000
NODE_10291_length_851_cov_13.519947	376	456	2	24	80	0.3000000
NODE_10291_length_851_cov_13.519947	376	456	4	31	80	0.3875000
NODE_10291_length_851_cov_13.519947	376	456	8	14	80	0.1750000
NODE_10292_length_851_cov_11.771277	403	483	0	80	80	1.0000000
NODE_10292_length_851_cov_11.771277	456	536	0	80	80	1.0000000
NODE_10293_length_851_cov_11.698138	227	307	4	18	80	0.2250000
NODE_10293_length_851_cov_11.698138	227	307	6	10	80	0.1250000
NODE_10293_length_851_cov_11.698138	227	307	8	52	80	0.6500000
NODE_10293_length_851_cov_11.698138	280	360	4	71	80	0.8875000
NODE_10293_length_851_cov_11.698138	280	360	6	9	80	0.1125000
NODE_10293_length_851_cov_11.698138	356	436	0	42	80	0.5250000
NODE_10293_length_851_cov_11.698138	356	436	2	32	80	0.4000000
NODE_10293_length_851_cov_11.698138	356	436	4	6	80	0.0750000
NODE_10293_length_851_cov_11.698138	409	489	2	56	80	0.7000000
NODE_10293_length_851_cov_11.698138	409	489	4	24	80	0.3000000
NODE_10294_length_851_cov_11.672872	372	452	0	4	80	0.0500000
NODE_10294_length_851_cov_11.672872	372	452	1	11	80	0.1375000
NODE_10294_length_851_cov_11.672872	372	452	5	65	80	0.8125000
NODE_10294_length_851_cov_11.672872	425	505	1	17	80	0.2125000
NODE_10294_length_851_cov_11.672872	425	505	5	63	80	0.7875000
NODE_10295_length_851_cov_10.938830	418	499	0	81	81	1.0000000
NODE_10296_length_851_cov_10.074468	454	534	0	80	80	1.0000000
NODE_10296_length_851_cov_10.074468	507	587	0	80	80	1.0000000
NODE_10297_length_851_cov_7.599734	330	410	0	63	80	0.7875000
NODE_10297_length_851_cov_7.599734	330	410	2	17	80	0.2125000
NODE_10297_length_851_cov_7.599734	383	463	0	10	80	0.1250000
NODE_10297_length_851_cov_7.599734	383	463	2	70	80	0.8750000
NODE_10298_length_851_cov_5.639628	379	459	0	80	80	1.0000000
NODE_10298_length_851_cov_5.639628	432	512	0	80	80	1.0000000
NODE_10300_length_851_cov_3.880319	729	765	0	36	36	1.0000000
NODE_10300_length_851_cov_3.880319	743	824	0	81	81	1.0000000
NODE_10301_length_851_cov_3.823138	380	460	0	80	80	1.0000000
NODE_10301_length_851_cov_3.823138	433	513	0	80	80	1.0000000
NODE_10318_length_851_cov_1.130319	33	103	2	70	70	1.0000000
NODE_10326_length_850_cov_36.527297	360	440	0	80	80	1.0000000
NODE_10326_length_850_cov_36.527297	413	493	0	80	80	1.0000000
NODE_10327_length_850_cov_31.006658	330	410	2	80	80	1.0000000
NODE_10327_length_850_cov_31.006658	383	463	0	24	80	0.3000000
NODE_10327_length_850_cov_31.006658	383	463	2	56	80	0.7000000
NODE_10328_length_850_cov_30.460719	251	331	0	80	80	1.0000000
NODE_10328_length_850_cov_30.460719	304	384	0	80	80	1.0000000
NODE_10329_length_850_cov_25.263648	355	435	0	2	80	0.0250000
NODE_10329_length_850_cov_25.263648	355	435	2	19	80	0.2375000
NODE_10329_length_850_cov_25.263648	355	435	4	50	80	0.6250000
NODE_10329_length_850_cov_25.263648	355	435	6	9	80	0.1125000
NODE_10329_length_850_cov_25.263648	408	488	4	18	80	0.2250000
NODE_10329_length_850_cov_25.263648	408	488	6	40	80	0.5000000
NODE_10329_length_850_cov_25.263648	408	488	8	22	80	0.2750000
NODE_10330_length_850_cov_21.368842	290	370	0	43	80	0.5375000
NODE_10330_length_850_cov_21.368842	290	370	2	37	80	0.4625000
NODE_10330_length_850_cov_21.368842	343	423	2	80	80	1.0000000
NODE_10331_length_850_cov_20.500666	318	398	0	80	80	1.0000000
NODE_10331_length_850_cov_20.500666	371	451	0	80	80	1.0000000
NODE_10332_length_850_cov_17.268975	398	478	0	80	80	1.0000000
NODE_10332_length_850_cov_17.268975	451	531	0	44	80	0.5500000
NODE_10332_length_850_cov_17.268975	451	531	2	36	80	0.4500000
NODE_10333_length_850_cov_14.728362	379	459	13	9	80	0.1125000
NODE_10333_length_850_cov_14.728362	379	459	14	71	80	0.8875000
NODE_10333_length_850_cov_14.728362	432	512	0	30	80	0.3750000
NODE_10333_length_850_cov_14.728362	432	512	9	22	80	0.2750000
NODE_10333_length_850_cov_14.728362	432	512	13	10	80	0.1250000
NODE_10333_length_850_cov_14.728362	432	512	14	18	80	0.2250000
NODE_10334_length_850_cov_14.230360	313	393	0	80	80	1.0000000
NODE_10334_length_850_cov_14.230360	366	446	0	80	80	1.0000000
NODE_10335_length_850_cov_12.387483	337	417	0	54	80	0.6750000
NODE_10335_length_850_cov_12.387483	337	417	2	26	80	0.3250000
NODE_10335_length_850_cov_12.387483	390	470	0	80	80	1.0000000
NODE_10335_length_850_cov_12.387483	466	545	0	79	79	1.0000000
NODE_10335_length_850_cov_12.387483	518	598	0	80	80	1.0000000
NODE_10336_length_850_cov_11.402130	329	409	0	48	80	0.6000000
NODE_10336_length_850_cov_11.402130	329	409	2	32	80	0.4000000
NODE_10336_length_850_cov_11.402130	382	462	2	80	80	1.0000000
NODE_10337_length_850_cov_10.326232	330	410	0	80	80	1.0000000
NODE_10337_length_850_cov_10.326232	383	463	0	80	80	1.0000000
NODE_10338_length_850_cov_9.675100	464	544	0	2	80	0.0250000
NODE_10338_length_850_cov_9.675100	464	544	2	78	80	0.9750000
NODE_10338_length_850_cov_9.675100	517	597	0	31	80	0.3875000
NODE_10338_length_850_cov_9.675100	517	597	2	49	80	0.6125000
NODE_10367_length_849_cov_43.137333	336	416	0	38	80	0.4750000
NODE_10367_length_849_cov_43.137333	336	416	2	42	80	0.5250000
NODE_10367_length_849_cov_43.137333	389	469	0	80	80	1.0000000
NODE_10368_length_849_cov_36.562667	326	406	0	80	80	1.0000000
NODE_10368_length_849_cov_36.562667	379	459	0	80	80	1.0000000
NODE_10369_length_849_cov_35.449333	408	488	2	17	80	0.2125000
NODE_10369_length_849_cov_35.449333	408	488	4	20	80	0.2500000
NODE_10369_length_849_cov_35.449333	408	488	6	9	80	0.1125000
NODE_10369_length_849_cov_35.449333	408	488	8	34	80	0.4250000
NODE_10369_length_849_cov_35.449333	461	541	2	17	80	0.2125000
NODE_10369_length_849_cov_35.449333	461	541	4	4	80	0.0500000
NODE_10369_length_849_cov_35.449333	461	541	6	7	80	0.0875000
NODE_10369_length_849_cov_35.449333	461	541	8	52	80	0.6500000
NODE_10370_length_849_cov_29.989333	332	412	2	31	80	0.3875000
NODE_10370_length_849_cov_29.989333	332	412	4	27	80	0.3375000
NODE_10370_length_849_cov_29.989333	332	412	5	15	80	0.1875000
NODE_10370_length_849_cov_29.989333	332	412	9	7	80	0.0875000
NODE_10370_length_849_cov_29.989333	385	465	2	5	80	0.0625000
NODE_10370_length_849_cov_29.989333	385	465	5	15	80	0.1875000
NODE_10370_length_849_cov_29.989333	385	465	9	7	80	0.0875000
NODE_10370_length_849_cov_29.989333	385	465	11	15	80	0.1875000
NODE_10370_length_849_cov_29.989333	385	465	12	28	80	0.3500000
NODE_10370_length_849_cov_29.989333	385	465	14	10	80	0.1250000
NODE_10371_length_849_cov_17.974667	343	423	8	1	80	0.0125000
NODE_10371_length_849_cov_17.974667	343	423	10	9	80	0.1125000
NODE_10371_length_849_cov_17.974667	343	423	12	2	80	0.0250000
NODE_10371_length_849_cov_17.974667	343	423	14	42	80	0.5250000
NODE_10371_length_849_cov_17.974667	343	423	18	26	80	0.3250000
NODE_10371_length_849_cov_17.974667	396	476	2	6	80	0.0750000
NODE_10371_length_849_cov_17.974667	396	476	4	46	80	0.5750000
NODE_10371_length_849_cov_17.974667	396	476	8	2	80	0.0250000
NODE_10371_length_849_cov_17.974667	396	476	12	2	80	0.0250000
NODE_10371_length_849_cov_17.974667	396	476	18	24	80	0.3000000
NODE_10372_length_849_cov_17.018667	360	440	0	38	80	0.4750000
NODE_10372_length_849_cov_17.018667	360	440	2	3	80	0.0375000
NODE_10372_length_849_cov_17.018667	360	440	3	1	80	0.0125000
NODE_10372_length_849_cov_17.018667	360	440	4	38	80	0.4750000
NODE_10372_length_849_cov_17.018667	416	493	0	77	77	1.0000000
NODE_10373_length_849_cov_15.581333	287	367	0	7	80	0.0875000
NODE_10373_length_849_cov_15.581333	287	367	2	73	80	0.9125000
NODE_10373_length_849_cov_15.581333	340	420	0	48	80	0.6000000
NODE_10373_length_849_cov_15.581333	340	420	2	32	80	0.4000000
NODE_10373_length_849_cov_15.581333	416	496	0	80	80	1.0000000
NODE_10373_length_849_cov_15.581333	469	549	0	80	80	1.0000000
NODE_10374_length_849_cov_9.460000	370	450	0	36	80	0.4500000
NODE_10374_length_849_cov_9.460000	370	450	1	44	80	0.5500000
NODE_10374_length_849_cov_9.460000	423	503	0	80	80	1.0000000
NODE_10375_length_849_cov_4.893333	427	507	2	25	80	0.3125000
NODE_10375_length_849_cov_4.893333	427	507	4	55	80	0.6875000
NODE_10375_length_849_cov_4.893333	480	560	0	42	80	0.5250000
NODE_10375_length_849_cov_4.893333	480	560	2	28	80	0.3500000
NODE_10375_length_849_cov_4.893333	480	560	4	10	80	0.1250000
NODE_10376_length_849_cov_4.860000	380	460	0	80	80	1.0000000
NODE_10376_length_849_cov_4.860000	433	513	0	80	80	1.0000000
NODE_10379_length_849_cov_2.761333	254	334	0	80	80	1.0000000
NODE_10396_length_848_cov_27.287049	253	333	0	80	80	1.0000000
NODE_10396_length_848_cov_27.287049	306	386	0	80	80	1.0000000
NODE_10396_length_848_cov_27.287049	382	458	0	47	76	0.6184211
NODE_10396_length_848_cov_27.287049	382	458	4	29	76	0.3815790
NODE_10396_length_848_cov_27.287049	435	513	0	13	78	0.1666667
NODE_10396_length_848_cov_27.287049	435	513	4	65	78	0.8333333
NODE_10397_length_848_cov_23.511348	248	328	0	80	80	1.0000000
NODE_10397_length_848_cov_23.511348	301	381	0	36	80	0.4500000
NODE_10397_length_848_cov_23.511348	301	381	2	44	80	0.5500000
NODE_10397_length_848_cov_23.511348	377	457	2	59	80	0.7375000
NODE_10397_length_848_cov_23.511348	377	457	4	21	80	0.2625000
NODE_10397_length_848_cov_23.511348	430	508	0	1	78	0.0128205
NODE_10397_length_848_cov_23.511348	430	508	2	63	78	0.8076923
NODE_10397_length_848_cov_23.511348	430	508	4	14	78	0.1794872
NODE_10398_length_848_cov_21.939920	295	375	0	67	80	0.8375000
NODE_10398_length_848_cov_21.939920	295	375	2	13	80	0.1625000
NODE_10398_length_848_cov_21.939920	348	428	0	16	80	0.2000000
NODE_10398_length_848_cov_21.939920	348	428	2	64	80	0.8000000
NODE_10399_length_848_cov_21.937250	434	514	0	75	80	0.9375000
NODE_10399_length_848_cov_21.937250	434	514	2	5	80	0.0625000
NODE_10399_length_848_cov_21.937250	487	567	0	22	80	0.2750000
NODE_10399_length_848_cov_21.937250	487	567	2	58	80	0.7250000
NODE_10400_length_848_cov_19.500668	367	392	0	25	25	1.0000000
NODE_10400_length_848_cov_19.500668	388	468	0	25	80	0.3125000
NODE_10400_length_848_cov_19.500668	388	468	2	4	80	0.0500000
NODE_10400_length_848_cov_19.500668	388	468	4	51	80	0.6375000
NODE_10400_length_848_cov_19.500668	441	521	0	31	80	0.3875000
NODE_10400_length_848_cov_19.500668	441	521	2	1	80	0.0125000
NODE_10400_length_848_cov_19.500668	441	521	4	48	80	0.6000000
NODE_10400_length_848_cov_19.500668	443	512	0	22	69	0.3188406
NODE_10400_length_848_cov_19.500668	443	512	2	1	69	0.0144928
NODE_10400_length_848_cov_19.500668	443	512	4	46	69	0.6666667
NODE_10400_length_848_cov_19.500668	443	472	4	29	29	1.0000000
NODE_10401_length_848_cov_16.566088	323	403	0	80	80	1.0000000
NODE_10401_length_848_cov_16.566088	376	456	0	80	80	1.0000000
NODE_10402_length_848_cov_16.109479	256	336	0	43	80	0.5375000
NODE_10402_length_848_cov_16.109479	256	336	2	37	80	0.4625000
NODE_10402_length_848_cov_16.109479	309	389	0	28	80	0.3500000
NODE_10402_length_848_cov_16.109479	309	389	2	52	80	0.6500000
NODE_10402_length_848_cov_16.109479	385	465	0	26	80	0.3250000
NODE_10402_length_848_cov_16.109479	385	465	2	54	80	0.6750000
NODE_10402_length_848_cov_16.109479	438	518	0	79	80	0.9875000
NODE_10402_length_848_cov_16.109479	438	518	2	1	80	0.0125000
NODE_10403_length_848_cov_15.919893	492	568	6	76	76	1.0000000
NODE_10403_length_848_cov_15.919893	541	621	0	15	80	0.1875000
NODE_10403_length_848_cov_15.919893	541	621	2	29	80	0.3625000
NODE_10403_length_848_cov_15.919893	541	621	6	36	80	0.4500000
NODE_10404_length_848_cov_13.979973	269	349	0	50	80	0.6250000
NODE_10404_length_848_cov_13.979973	269	349	2	30	80	0.3750000
NODE_10404_length_848_cov_13.979973	322	402	0	1	80	0.0125000
NODE_10404_length_848_cov_13.979973	322	402	2	79	80	0.9875000
NODE_10405_length_848_cov_13.073431	343	423	0	36	80	0.4500000
NODE_10405_length_848_cov_13.073431	343	423	2	44	80	0.5500000
NODE_10405_length_848_cov_13.073431	396	476	0	2	80	0.0250000
NODE_10405_length_848_cov_13.073431	396	476	2	78	80	0.9750000
NODE_10406_length_848_cov_8.523364	232	312	0	80	80	1.0000000
NODE_10406_length_848_cov_8.523364	285	365	0	80	80	1.0000000
NODE_10406_length_848_cov_8.523364	361	441	0	80	80	1.0000000
NODE_10406_length_848_cov_8.523364	414	494	0	80	80	1.0000000
NODE_10408_length_848_cov_5.903872	251	331	0	16	80	0.2000000
NODE_10408_length_848_cov_5.903872	251	331	2	24	80	0.3000000
NODE_10408_length_848_cov_5.903872	251	331	4	40	80	0.5000000
NODE_10408_length_848_cov_5.903872	304	383	4	79	79	1.0000000
NODE_10409_length_848_cov_5.236315	378	458	0	80	80	1.0000000
NODE_10409_length_848_cov_5.236315	431	507	0	76	76	1.0000000
NODE_10424_length_847_cov_56.417112	576	656	4	3	80	0.0375000
NODE_10424_length_847_cov_56.417112	576	656	15	2	80	0.0250000
NODE_10424_length_847_cov_56.417112	576	656	17	1	80	0.0125000
NODE_10424_length_847_cov_56.417112	576	656	18	4	80	0.0500000
NODE_10424_length_847_cov_56.417112	576	656	24	24	80	0.3000000
NODE_10424_length_847_cov_56.417112	576	656	26	5	80	0.0625000
NODE_10424_length_847_cov_56.417112	576	656	28	4	80	0.0500000
NODE_10424_length_847_cov_56.417112	576	656	30	30	80	0.3750000
NODE_10424_length_847_cov_56.417112	576	656	32	7	80	0.0875000
NODE_10424_length_847_cov_56.417112	629	709	8	18	80	0.2250000
NODE_10424_length_847_cov_56.417112	629	709	18	3	80	0.0375000
NODE_10424_length_847_cov_56.417112	629	709	20	4	80	0.0500000
NODE_10424_length_847_cov_56.417112	629	709	22	16	80	0.2000000
NODE_10424_length_847_cov_56.417112	629	709	28	13	80	0.1625000
NODE_10424_length_847_cov_56.417112	629	709	30	19	80	0.2375000
NODE_10424_length_847_cov_56.417112	629	709	32	7	80	0.0875000
NODE_10425_length_847_cov_27.292781	390	470	10	49	80	0.6125000
NODE_10425_length_847_cov_27.292781	390	470	12	1	80	0.0125000
NODE_10425_length_847_cov_27.292781	390	470	14	30	80	0.3750000
NODE_10425_length_847_cov_27.292781	443	523	0	6	80	0.0750000
NODE_10425_length_847_cov_27.292781	443	523	4	32	80	0.4000000
NODE_10425_length_847_cov_27.292781	443	523	8	3	80	0.0375000
NODE_10425_length_847_cov_27.292781	443	523	10	34	80	0.4250000
NODE_10425_length_847_cov_27.292781	443	523	12	1	80	0.0125000
NODE_10425_length_847_cov_27.292781	443	523	14	4	80	0.0500000
NODE_10426_length_847_cov_24.954545	342	422	3	37	80	0.4625000
NODE_10426_length_847_cov_24.954545	342	422	5	1	80	0.0125000
NODE_10426_length_847_cov_24.954545	342	422	6	37	80	0.4625000
NODE_10426_length_847_cov_24.954545	342	422	8	5	80	0.0625000
NODE_10426_length_847_cov_24.954545	395	475	4	21	80	0.2625000
NODE_10426_length_847_cov_24.954545	395	475	6	22	80	0.2750000
NODE_10426_length_847_cov_24.954545	395	475	8	31	80	0.3875000
NODE_10426_length_847_cov_24.954545	395	475	10	6	80	0.0750000
NODE_10427_length_847_cov_20.310160	341	421	0	80	80	1.0000000
NODE_10427_length_847_cov_20.310160	394	474	0	80	80	1.0000000
NODE_10428_length_847_cov_19.002674	368	448	0	26	80	0.3250000
NODE_10428_length_847_cov_19.002674	368	448	2	54	80	0.6750000
NODE_10428_length_847_cov_19.002674	421	501	2	80	80	1.0000000
NODE_10429_length_847_cov_16.879679	218	298	4	19	80	0.2375000
NODE_10429_length_847_cov_16.879679	218	298	8	1	80	0.0125000
NODE_10429_length_847_cov_16.879679	218	298	9	2	80	0.0250000
NODE_10429_length_847_cov_16.879679	218	298	10	36	80	0.4500000
NODE_10429_length_847_cov_16.879679	218	298	12	6	80	0.0750000
NODE_10429_length_847_cov_16.879679	218	298	14	16	80	0.2000000
NODE_10429_length_847_cov_16.879679	271	351	4	7	80	0.0875000
NODE_10429_length_847_cov_16.879679	271	351	10	55	80	0.6875000
NODE_10429_length_847_cov_16.879679	271	351	12	3	80	0.0375000
NODE_10429_length_847_cov_16.879679	271	351	14	15	80	0.1875000
NODE_10431_length_847_cov_11.784759	298	378	0	47	80	0.5875000
NODE_10431_length_847_cov_11.784759	298	378	2	26	80	0.3250000
NODE_10431_length_847_cov_11.784759	298	378	4	7	80	0.0875000
NODE_10431_length_847_cov_11.784759	351	431	2	43	80	0.5375000
NODE_10431_length_847_cov_11.784759	351	431	4	37	80	0.4625000
NODE_10431_length_847_cov_11.784759	427	507	0	62	80	0.7750000
NODE_10431_length_847_cov_11.784759	427	507	2	18	80	0.2250000
NODE_10431_length_847_cov_11.784759	480	560	0	80	80	1.0000000
NODE_10432_length_847_cov_11.604278	407	487	4	80	80	1.0000000
NODE_10432_length_847_cov_11.604278	460	540	0	25	80	0.3125000
NODE_10432_length_847_cov_11.604278	460	540	4	55	80	0.6875000
NODE_10433_length_847_cov_10.221925	395	475	0	34	80	0.4250000
NODE_10433_length_847_cov_10.221925	395	475	2	46	80	0.5750000
NODE_10433_length_847_cov_10.221925	448	528	0	80	80	1.0000000
NODE_10434_length_847_cov_4.602941	97	154	10	2	57	0.0350877
NODE_10434_length_847_cov_4.602941	97	154	12	3	57	0.0526316
NODE_10434_length_847_cov_4.602941	97	154	14	10	57	0.1754386
NODE_10434_length_847_cov_4.602941	97	154	16	5	57	0.0877193
NODE_10434_length_847_cov_4.602941	97	154	18	37	57	0.6491228
NODE_10434_length_847_cov_4.602941	127	207	0	9	80	0.1125000
NODE_10434_length_847_cov_4.602941	127	207	2	8	80	0.1000000
NODE_10434_length_847_cov_4.602941	127	207	3	2	80	0.0250000
NODE_10434_length_847_cov_4.602941	127	207	5	3	80	0.0375000
NODE_10434_length_847_cov_4.602941	127	207	6	23	80	0.2875000
NODE_10434_length_847_cov_4.602941	127	207	10	10	80	0.1250000
NODE_10434_length_847_cov_4.602941	127	207	12	3	80	0.0375000
NODE_10434_length_847_cov_4.602941	127	207	14	10	80	0.1250000
NODE_10434_length_847_cov_4.602941	127	207	16	1	80	0.0125000
NODE_10434_length_847_cov_4.602941	127	207	18	11	80	0.1375000
NODE_10456_length_846_cov_39.476573	336	416	3	33	80	0.4125000
NODE_10456_length_846_cov_39.476573	336	416	4	47	80	0.5875000
NODE_10456_length_846_cov_39.476573	389	469	0	19	80	0.2375000
NODE_10456_length_846_cov_39.476573	389	469	1	15	80	0.1875000
NODE_10456_length_846_cov_39.476573	389	469	3	46	80	0.5750000
NODE_10456_length_846_cov_39.476573	465	545	0	64	80	0.8000000
NODE_10456_length_846_cov_39.476573	465	545	10	16	80	0.2000000
NODE_10456_length_846_cov_39.476573	518	598	0	11	80	0.1375000
NODE_10456_length_846_cov_39.476573	518	598	9	24	80	0.3000000
NODE_10456_length_846_cov_39.476573	518	598	10	45	80	0.5625000
NODE_10457_length_846_cov_37.297189	312	392	0	26	80	0.3250000
NODE_10457_length_846_cov_37.297189	312	392	4	54	80	0.6750000
NODE_10457_length_846_cov_37.297189	365	445	0	42	80	0.5250000
NODE_10457_length_846_cov_37.297189	365	445	2	27	80	0.3375000
NODE_10457_length_846_cov_37.297189	365	445	4	11	80	0.1375000
NODE_10458_length_846_cov_32.852744	279	359	0	56	80	0.7000000
NODE_10458_length_846_cov_32.852744	279	359	6	24	80	0.3000000
NODE_10458_length_846_cov_32.852744	332	412	0	3	80	0.0375000
NODE_10458_length_846_cov_32.852744	332	412	6	77	80	0.9625000
NODE_10459_length_846_cov_31.717537	290	370	1	47	80	0.5875000
NODE_10459_length_846_cov_31.717537	290	370	3	33	80	0.4125000
NODE_10459_length_846_cov_31.717537	343	423	2	36	80	0.4500000
NODE_10459_length_846_cov_31.717537	343	423	3	44	80	0.5500000
NODE_10460_length_846_cov_24.380187	350	430	0	80	80	1.0000000
NODE_10460_length_846_cov_24.380187	403	483	0	80	80	1.0000000
NODE_10461_length_846_cov_16.155288	364	444	4	26	80	0.3250000
NODE_10461_length_846_cov_16.155288	364	444	8	54	80	0.6750000
NODE_10461_length_846_cov_16.155288	417	497	0	23	80	0.2875000
NODE_10461_length_846_cov_16.155288	417	497	4	4	80	0.0500000
NODE_10461_length_846_cov_16.155288	417	497	8	53	80	0.6625000
NODE_10462_length_846_cov_15.917001	398	478	0	80	80	1.0000000
NODE_10462_length_846_cov_15.917001	451	531	0	80	80	1.0000000
NODE_10463_length_846_cov_15.275770	355	435	0	80	80	1.0000000
NODE_10463_length_846_cov_15.275770	408	488	0	80	80	1.0000000
NODE_10464_length_846_cov_13.618474	216	296	2	50	80	0.6250000
NODE_10464_length_846_cov_13.618474	216	296	4	30	80	0.3750000
NODE_10464_length_846_cov_13.618474	269	349	4	32	80	0.4000000
NODE_10464_length_846_cov_13.618474	269	349	6	48	80	0.6000000
NODE_10464_length_846_cov_13.618474	345	425	6	9	80	0.1125000
NODE_10464_length_846_cov_13.618474	345	425	7	1	80	0.0125000
NODE_10464_length_846_cov_13.618474	345	425	8	49	80	0.6125000
NODE_10464_length_846_cov_13.618474	345	425	10	21	80	0.2625000
NODE_10464_length_846_cov_13.618474	398	478	2	3	80	0.0375000
NODE_10464_length_846_cov_13.618474	398	478	4	16	80	0.2000000
NODE_10464_length_846_cov_13.618474	398	478	6	21	80	0.2625000
NODE_10464_length_846_cov_13.618474	398	478	7	1	80	0.0125000
NODE_10464_length_846_cov_13.618474	398	478	8	39	80	0.4875000
NODE_10465_length_846_cov_12.878179	425	505	0	80	80	1.0000000
NODE_10465_length_846_cov_12.878179	478	558	0	80	80	1.0000000
NODE_10467_length_846_cov_7.232932	407	487	0	32	80	0.4000000
NODE_10467_length_846_cov_7.232932	407	487	2	48	80	0.6000000
NODE_10467_length_846_cov_7.232932	460	540	2	80	80	1.0000000
NODE_10468_length_846_cov_6.776439	320	400	0	80	80	1.0000000
NODE_10468_length_846_cov_6.776439	373	453	0	80	80	1.0000000
NODE_10472_length_846_cov_3.025435	190	270	0	80	80	1.0000000
NODE_10472_length_846_cov_3.025435	243	323	0	80	80	1.0000000
NODE_10488_length_845_cov_34.458445	213	293	0	12	80	0.1500000
NODE_10488_length_845_cov_34.458445	213	293	2	10	80	0.1250000
NODE_10488_length_845_cov_34.458445	213	293	4	9	80	0.1125000
NODE_10488_length_845_cov_34.458445	213	293	11	31	80	0.3875000
NODE_10488_length_845_cov_34.458445	213	293	15	2	80	0.0250000
NODE_10488_length_845_cov_34.458445	213	293	17	2	80	0.0250000
NODE_10488_length_845_cov_34.458445	213	293	19	14	80	0.1750000
NODE_10488_length_845_cov_34.458445	266	346	11	9	80	0.1125000
NODE_10488_length_845_cov_34.458445	266	346	15	2	80	0.0250000
NODE_10488_length_845_cov_34.458445	266	346	17	2	80	0.0250000
NODE_10488_length_845_cov_34.458445	266	346	19	18	80	0.2250000
NODE_10488_length_845_cov_34.458445	266	346	20	18	80	0.2250000
NODE_10488_length_845_cov_34.458445	266	346	21	6	80	0.0750000
NODE_10488_length_845_cov_34.458445	266	346	22	19	80	0.2375000
NODE_10488_length_845_cov_34.458445	266	346	24	6	80	0.0750000
NODE_10489_length_845_cov_33.025469	309	389	0	7	80	0.0875000
NODE_10489_length_845_cov_33.025469	309	389	2	73	80	0.9125000
NODE_10489_length_845_cov_33.025469	362	442	0	38	80	0.4750000
NODE_10489_length_845_cov_33.025469	362	442	2	42	80	0.5250000
NODE_10490_length_845_cov_30.331099	288	368	2	8	80	0.1000000
NODE_10490_length_845_cov_30.331099	288	368	4	24	80	0.3000000
NODE_10490_length_845_cov_30.331099	288	368	6	12	80	0.1500000
NODE_10490_length_845_cov_30.331099	288	368	8	36	80	0.4500000
NODE_10490_length_845_cov_30.331099	341	421	2	3	80	0.0375000
NODE_10490_length_845_cov_30.331099	341	421	4	77	80	0.9625000
NODE_10491_length_845_cov_22.042895	455	535	2	1	80	0.0125000
NODE_10491_length_845_cov_22.042895	455	535	4	7	80	0.0875000
NODE_10491_length_845_cov_22.042895	455	535	8	72	80	0.9000000
NODE_10491_length_845_cov_22.042895	508	588	0	33	80	0.4125000
NODE_10491_length_845_cov_22.042895	508	588	4	1	80	0.0125000
NODE_10491_length_845_cov_22.042895	508	588	6	19	80	0.2375000
NODE_10491_length_845_cov_22.042895	508	588	8	27	80	0.3375000
NODE_10492_length_845_cov_20.662198	325	406	0	53	81	0.6543210
NODE_10492_length_845_cov_20.662198	325	406	4	28	81	0.3456790
NODE_10492_length_845_cov_20.662198	379	459	4	59	80	0.7375000
NODE_10492_length_845_cov_20.662198	379	459	6	21	80	0.2625000
NODE_10493_length_845_cov_17.214477	352	432	0	36	80	0.4500000
NODE_10493_length_845_cov_17.214477	352	432	2	44	80	0.5500000
NODE_10493_length_845_cov_17.214477	405	485	0	15	80	0.1875000
NODE_10493_length_845_cov_17.214477	405	485	2	65	80	0.8125000
NODE_10494_length_845_cov_15.805630	409	489	0	50	80	0.6250000
NODE_10494_length_845_cov_15.805630	409	489	2	30	80	0.3750000
NODE_10494_length_845_cov_15.805630	462	542	0	48	80	0.6000000
NODE_10494_length_845_cov_15.805630	462	542	2	32	80	0.4000000
NODE_10495_length_845_cov_13.443700	329	409	2	11	80	0.1375000
NODE_10495_length_845_cov_13.443700	329	409	4	69	80	0.8625000
NODE_10495_length_845_cov_13.443700	382	462	0	12	80	0.1500000
NODE_10495_length_845_cov_13.443700	382	462	1	7	80	0.0875000
NODE_10495_length_845_cov_13.443700	382	462	3	22	80	0.2750000
NODE_10495_length_845_cov_13.443700	382	462	4	39	80	0.4875000
NODE_10496_length_845_cov_12.301609	334	414	0	13	80	0.1625000
NODE_10496_length_845_cov_12.301609	334	414	2	67	80	0.8375000
NODE_10496_length_845_cov_12.301609	387	467	2	80	80	1.0000000
NODE_10497_length_845_cov_11.836461	389	469	0	80	80	1.0000000
NODE_10497_length_845_cov_11.836461	442	522	0	80	80	1.0000000
NODE_10499_length_845_cov_8.140751	439	519	0	37	80	0.4625000
NODE_10499_length_845_cov_8.140751	439	519	2	18	80	0.2250000
NODE_10499_length_845_cov_8.140751	439	519	4	25	80	0.3125000
NODE_10499_length_845_cov_8.140751	492	572	2	2	80	0.0250000
NODE_10499_length_845_cov_8.140751	492	572	4	78	80	0.9750000
NODE_10516_length_845_cov_1.680965	447	491	4	4	44	0.0909091
NODE_10516_length_845_cov_1.680965	447	491	6	40	44	0.9090909
NODE_10528_length_844_cov_43.778523	313	393	8	16	80	0.2000000
NODE_10528_length_844_cov_43.778523	313	393	12	6	80	0.0750000
NODE_10528_length_844_cov_43.778523	313	393	14	58	80	0.7250000
NODE_10528_length_844_cov_43.778523	366	446	2	17	80	0.2125000
NODE_10528_length_844_cov_43.778523	366	446	4	27	80	0.3375000
NODE_10528_length_844_cov_43.778523	366	446	8	25	80	0.3125000
NODE_10528_length_844_cov_43.778523	366	446	12	3	80	0.0375000
NODE_10528_length_844_cov_43.778523	366	446	14	8	80	0.1000000
NODE_10528_length_844_cov_43.778523	442	522	4	43	80	0.5375000
NODE_10528_length_844_cov_43.778523	442	522	6	21	80	0.2625000
NODE_10528_length_844_cov_43.778523	442	522	10	12	80	0.1500000
NODE_10528_length_844_cov_43.778523	442	522	12	4	80	0.0500000
NODE_10528_length_844_cov_43.778523	495	575	6	11	80	0.1375000
NODE_10528_length_844_cov_43.778523	495	575	8	27	80	0.3375000
NODE_10528_length_844_cov_43.778523	495	575	10	23	80	0.2875000
NODE_10528_length_844_cov_43.778523	495	575	12	19	80	0.2375000
NODE_10529_length_844_cov_36.762416	381	461	1	8	80	0.1000000
NODE_10529_length_844_cov_36.762416	381	461	3	31	80	0.3875000
NODE_10529_length_844_cov_36.762416	381	461	4	41	80	0.5125000
NODE_10529_length_844_cov_36.762416	434	514	4	42	80	0.5250000
NODE_10529_length_844_cov_36.762416	434	514	6	38	80	0.4750000
NODE_10529_length_844_cov_36.762416	510	590	2	21	80	0.2625000
NODE_10529_length_844_cov_36.762416	510	590	3	49	80	0.6125000
NODE_10529_length_844_cov_36.762416	510	590	4	10	80	0.1250000
NODE_10529_length_844_cov_36.762416	563	644	0	45	81	0.5555556
NODE_10529_length_844_cov_36.762416	563	644	2	30	81	0.3703704
NODE_10529_length_844_cov_36.762416	563	644	3	6	81	0.0740741
NODE_10530_length_844_cov_35.765101	424	504	0	23	80	0.2875000
NODE_10530_length_844_cov_35.765101	424	504	2	57	80	0.7125000
NODE_10530_length_844_cov_35.765101	477	557	0	76	80	0.9500000
NODE_10530_length_844_cov_35.765101	477	557	2	4	80	0.0500000
NODE_10531_length_844_cov_18.445638	353	420	0	67	67	1.0000000
NODE_10531_length_844_cov_18.445638	393	473	0	35	80	0.4375000
NODE_10531_length_844_cov_18.445638	393	473	1	32	80	0.4000000
NODE_10531_length_844_cov_18.445638	393	473	2	13	80	0.1625000
NODE_10532_length_844_cov_12.616107	363	443	2	80	80	1.0000000
NODE_10532_length_844_cov_12.616107	416	496	0	44	80	0.5500000
NODE_10532_length_844_cov_12.616107	416	496	2	36	80	0.4500000
NODE_10533_length_844_cov_12.092617	171	251	0	80	80	1.0000000
NODE_10533_length_844_cov_12.092617	224	304	0	80	80	1.0000000
NODE_10534_length_844_cov_11.883221	341	421	0	12	80	0.1500000
NODE_10534_length_844_cov_11.883221	341	421	2	5	80	0.0625000
NODE_10534_length_844_cov_11.883221	341	421	4	63	80	0.7875000
NODE_10534_length_844_cov_11.883221	394	474	0	65	80	0.8125000
NODE_10534_length_844_cov_11.883221	394	474	2	5	80	0.0625000
NODE_10534_length_844_cov_11.883221	394	474	4	10	80	0.1250000
NODE_10535_length_844_cov_10.571812	390	448	2	32	58	0.5517241
NODE_10535_length_844_cov_10.571812	390	448	4	26	58	0.4482759
NODE_10537_length_844_cov_9.357047	370	450	0	80	80	1.0000000
NODE_10537_length_844_cov_9.357047	423	503	0	80	80	1.0000000
NODE_10538_length_844_cov_8.975839	355	435	0	80	80	1.0000000
NODE_10538_length_844_cov_8.975839	408	488	0	80	80	1.0000000
NODE_10539_length_844_cov_7.347651	357	438	0	81	81	1.0000000
NODE_10539_length_844_cov_7.347651	410	491	0	81	81	1.0000000
NODE_10540_length_844_cov_6.975839	444	524	0	74	80	0.9250000
NODE_10540_length_844_cov_6.975839	444	524	2	6	80	0.0750000
NODE_10540_length_844_cov_6.975839	497	577	0	21	80	0.2625000
NODE_10540_length_844_cov_6.975839	497	577	2	59	80	0.7375000
NODE_10567_length_843_cov_48.258065	203	262	152	1	59	0.0169492
NODE_10567_length_843_cov_48.258065	203	262	154	3	59	0.0508475
NODE_10567_length_843_cov_48.258065	203	262	155	2	59	0.0338983
NODE_10567_length_843_cov_48.258065	203	262	156	12	59	0.2033898
NODE_10567_length_843_cov_48.258065	203	262	157	6	59	0.1016949
NODE_10567_length_843_cov_48.258065	203	262	158	7	59	0.1186441
NODE_10567_length_843_cov_48.258065	203	262	159	4	59	0.0677966
NODE_10567_length_843_cov_48.258065	203	262	160	5	59	0.0847458
NODE_10567_length_843_cov_48.258065	203	262	161	3	59	0.0508475
NODE_10567_length_843_cov_48.258065	203	262	162	1	59	0.0169492
NODE_10567_length_843_cov_48.258065	203	262	163	1	59	0.0169492
NODE_10567_length_843_cov_48.258065	203	262	164	3	59	0.0508475
NODE_10567_length_843_cov_48.258065	203	262	166	3	59	0.0508475
NODE_10567_length_843_cov_48.258065	203	262	167	6	59	0.1016949
NODE_10567_length_843_cov_48.258065	203	262	168	1	59	0.0169492
NODE_10567_length_843_cov_48.258065	203	262	169	1	59	0.0169492
NODE_10568_length_843_cov_31.279570	351	431	0	26	80	0.3250000
NODE_10568_length_843_cov_31.279570	351	431	1	1	80	0.0125000
NODE_10568_length_843_cov_31.279570	351	431	2	25	80	0.3125000
NODE_10568_length_843_cov_31.279570	351	431	4	28	80	0.3500000
NODE_10568_length_843_cov_31.279570	404	484	0	79	80	0.9875000
NODE_10568_length_843_cov_31.279570	404	484	1	1	80	0.0125000
NODE_10569_length_843_cov_27.060484	423	503	4	28	80	0.3500000
NODE_10569_length_843_cov_27.060484	423	503	6	29	80	0.3625000
NODE_10569_length_843_cov_27.060484	423	503	8	23	80	0.2875000
NODE_10569_length_843_cov_27.060484	476	556	2	11	80	0.1375000
NODE_10569_length_843_cov_27.060484	476	556	4	2	80	0.0250000
NODE_10569_length_843_cov_27.060484	476	556	6	45	80	0.5625000
NODE_10569_length_843_cov_27.060484	476	556	8	22	80	0.2750000
NODE_10570_length_843_cov_22.725806	334	414	0	80	80	1.0000000
NODE_10570_length_843_cov_22.725806	339	396	0	57	57	1.0000000
NODE_10570_length_843_cov_22.725806	356	427	0	71	71	1.0000000
NODE_10570_length_843_cov_22.725806	387	455	0	67	68	0.9852941
NODE_10570_length_843_cov_22.725806	387	455	2	1	68	0.0147059
NODE_10570_length_843_cov_22.725806	401	476	0	53	75	0.7066666
NODE_10570_length_843_cov_22.725806	401	476	2	22	75	0.2933333
NODE_10570_length_843_cov_22.725806	418	486	0	36	68	0.5294118
NODE_10570_length_843_cov_22.725806	418	486	2	32	68	0.4705882
NODE_10570_length_843_cov_22.725806	449	529	0	5	80	0.0625000
NODE_10570_length_843_cov_22.725806	449	529	2	75	80	0.9375000
NODE_10571_length_843_cov_22.387097	412	492	0	80	80	1.0000000
NODE_10571_length_843_cov_22.387097	465	545	0	80	80	1.0000000
NODE_10572_length_843_cov_16.326613	551	631	4	15	80	0.1875000
NODE_10572_length_843_cov_16.326613	551	631	6	65	80	0.8125000
NODE_10572_length_843_cov_16.326613	604	684	2	22	80	0.2750000
NODE_10572_length_843_cov_16.326613	604	684	4	13	80	0.1625000
NODE_10572_length_843_cov_16.326613	604	684	6	27	80	0.3375000
NODE_10572_length_843_cov_16.326613	604	684	8	18	80	0.2250000
NODE_10573_length_843_cov_13.478495	381	461	0	60	80	0.7500000
NODE_10573_length_843_cov_13.478495	381	461	2	20	80	0.2500000
NODE_10573_length_843_cov_13.478495	434	514	0	7	80	0.0875000
NODE_10573_length_843_cov_13.478495	434	514	2	73	80	0.9125000
NODE_10574_length_843_cov_13.150538	448	528	0	80	80	1.0000000
NODE_10574_length_843_cov_13.150538	501	581	0	80	80	1.0000000
NODE_10575_length_843_cov_12.510753	360	440	0	80	80	1.0000000
NODE_10575_length_843_cov_12.510753	413	493	0	80	80	1.0000000
NODE_10576_length_843_cov_11.090054	457	537	0	2	80	0.0250000
NODE_10576_length_843_cov_11.090054	457	537	2	78	80	0.9750000
NODE_10576_length_843_cov_11.090054	510	590	0	55	80	0.6875000
NODE_10576_length_843_cov_11.090054	510	590	2	25	80	0.3125000
NODE_10577_length_843_cov_7.672043	472	552	1	12	80	0.1500000
NODE_10577_length_843_cov_7.672043	472	552	3	12	80	0.1500000
NODE_10577_length_843_cov_7.672043	472	552	4	19	80	0.2375000
NODE_10577_length_843_cov_7.672043	472	552	6	37	80	0.4625000
NODE_10577_length_843_cov_7.672043	525	605	1	65	80	0.8125000
NODE_10577_length_843_cov_7.672043	525	605	3	12	80	0.1500000
NODE_10577_length_843_cov_7.672043	525	605	4	3	80	0.0375000
NODE_10601_length_842_cov_39.518170	390	470	10	3	80	0.0375000
NODE_10601_length_842_cov_39.518170	390	470	12	61	80	0.7625000
NODE_10601_length_842_cov_39.518170	390	470	14	16	80	0.2000000
NODE_10601_length_842_cov_39.518170	443	523	2	1	80	0.0125000
NODE_10601_length_842_cov_39.518170	443	523	4	2	80	0.0250000
NODE_10601_length_842_cov_39.518170	443	523	5	5	80	0.0625000
NODE_10601_length_842_cov_39.518170	443	523	6	15	80	0.1875000
NODE_10601_length_842_cov_39.518170	443	523	8	17	80	0.2125000
NODE_10601_length_842_cov_39.518170	443	523	10	14	80	0.1750000
NODE_10601_length_842_cov_39.518170	443	523	12	26	80	0.3250000
NODE_10602_length_842_cov_21.567968	331	411	0	80	80	1.0000000
NODE_10602_length_842_cov_21.567968	384	464	0	80	80	1.0000000
NODE_10603_length_842_cov_19.761777	228	308	0	80	80	1.0000000
NODE_10603_length_842_cov_19.761777	281	361	0	80	80	1.0000000
NODE_10605_length_842_cov_8.703903	641	722	2	81	81	1.0000000
NODE_10608_length_842_cov_5.305518	287	367	0	65	80	0.8125000
NODE_10608_length_842_cov_5.305518	287	367	2	3	80	0.0375000
NODE_10608_length_842_cov_5.305518	287	367	4	12	80	0.1500000
NODE_10608_length_842_cov_5.305518	340	420	0	80	80	1.0000000
NODE_10617_length_842_cov_1.751009	35	66	3	2	31	0.0645161
NODE_10617_length_842_cov_1.751009	35	66	4	29	31	0.9354839
NODE_10622_length_841_cov_23.815364	292	372	0	80	80	1.0000000
NODE_10622_length_841_cov_23.815364	345	425	0	80	80	1.0000000
NODE_10623_length_841_cov_18.871968	338	418	0	67	80	0.8375000
NODE_10623_length_841_cov_18.871968	338	418	4	13	80	0.1625000
NODE_10623_length_841_cov_18.871968	391	471	0	14	80	0.1750000
NODE_10623_length_841_cov_18.871968	391	471	4	66	80	0.8250000
NODE_10624_length_841_cov_14.663073	345	425	0	80	80	1.0000000
NODE_10624_length_841_cov_14.663073	398	478	0	80	80	1.0000000
NODE_10625_length_841_cov_14.149596	341	421	1	1	80	0.0125000
NODE_10625_length_841_cov_14.149596	341	421	2	5	80	0.0625000
NODE_10625_length_841_cov_14.149596	341	421	3	27	80	0.3375000
NODE_10625_length_841_cov_14.149596	341	421	4	47	80	0.5875000
NODE_10625_length_841_cov_14.149596	394	474	1	48	80	0.6000000
NODE_10625_length_841_cov_14.149596	394	474	3	32	80	0.4000000
NODE_10626_length_841_cov_12.452830	240	320	0	80	80	1.0000000
NODE_10626_length_841_cov_12.452830	293	373	0	80	80	1.0000000
NODE_10628_length_841_cov_9.925876	394	474	0	80	80	1.0000000
NODE_10628_length_841_cov_9.925876	447	527	0	80	80	1.0000000
NODE_10629_length_841_cov_7.407008	317	397	0	80	80	1.0000000
NODE_10629_length_841_cov_7.407008	370	450	0	80	80	1.0000000
NODE_10632_length_841_cov_3.865229	305	356	0	5	51	0.0980392
NODE_10632_length_841_cov_3.865229	305	356	2	46	51	0.9019608
NODE_10651_length_840_cov_63.726046	461	541	2	25	80	0.3125000
NODE_10651_length_840_cov_63.726046	461	541	4	17	80	0.2125000
NODE_10651_length_840_cov_63.726046	461	541	6	38	80	0.4750000
NODE_10651_length_840_cov_63.726046	514	594	0	15	80	0.1875000
NODE_10651_length_840_cov_63.726046	514	594	2	60	80	0.7500000
NODE_10651_length_840_cov_63.726046	514	594	4	5	80	0.0625000
NODE_10652_length_840_cov_35.874494	486	566	0	14	80	0.1750000
NODE_10652_length_840_cov_35.874494	486	566	2	66	80	0.8250000
NODE_10652_length_840_cov_35.874494	539	619	0	67	80	0.8375000
NODE_10652_length_840_cov_35.874494	539	619	2	13	80	0.1625000
NODE_10653_length_840_cov_24.499325	224	304	0	80	80	1.0000000
NODE_10653_length_840_cov_24.499325	277	357	0	27	80	0.3375000
NODE_10653_length_840_cov_24.499325	277	357	4	9	80	0.1125000
NODE_10653_length_840_cov_24.499325	277	357	6	44	80	0.5500000
NODE_10653_length_840_cov_24.499325	353	433	2	40	80	0.5000000
NODE_10653_length_840_cov_24.499325	353	433	6	32	80	0.4000000
NODE_10653_length_840_cov_24.499325	353	433	8	8	80	0.1000000
NODE_10653_length_840_cov_24.499325	406	486	0	41	80	0.5125000
NODE_10653_length_840_cov_24.499325	406	486	2	39	80	0.4875000
NODE_10654_length_840_cov_23.272605	309	389	0	4	80	0.0500000
NODE_10654_length_840_cov_23.272605	309	389	2	22	80	0.2750000
NODE_10654_length_840_cov_23.272605	309	389	4	54	80	0.6750000
NODE_10654_length_840_cov_23.272605	362	442	0	18	80	0.2250000
NODE_10654_length_840_cov_23.272605	362	442	2	35	80	0.4375000
NODE_10654_length_840_cov_23.272605	362	442	4	27	80	0.3375000
NODE_10655_length_840_cov_22.221323	293	373	0	32	80	0.4000000
NODE_10655_length_840_cov_22.221323	293	373	2	48	80	0.6000000
NODE_10655_length_840_cov_22.221323	346	426	0	80	80	1.0000000
NODE_10656_length_840_cov_17.026991	348	432	0	84	84	1.0000000
NODE_10656_length_840_cov_17.026991	405	485	0	80	80	1.0000000
NODE_10657_length_840_cov_16.635628	347	427	0	80	80	1.0000000
NODE_10657_length_840_cov_16.635628	400	480	0	80	80	1.0000000
NODE_10658_length_840_cov_12.133603	336	416	0	80	80	1.0000000
NODE_10658_length_840_cov_12.133603	389	469	0	80	80	1.0000000
NODE_10659_length_840_cov_12.041835	332	412	0	80	80	1.0000000
NODE_10659_length_840_cov_12.041835	385	465	0	80	80	1.0000000
NODE_10660_length_840_cov_10.719298	275	354	2	35	79	0.4430380
NODE_10660_length_840_cov_10.719298	275	354	4	44	79	0.5569620
NODE_10660_length_840_cov_10.719298	327	407	4	35	80	0.4375000
NODE_10660_length_840_cov_10.719298	327	407	6	38	80	0.4750000
NODE_10660_length_840_cov_10.719298	327	407	8	7	80	0.0875000
NODE_10663_length_840_cov_5.207827	427	507	0	31	80	0.3875000
NODE_10663_length_840_cov_5.207827	427	507	2	49	80	0.6125000
NODE_10663_length_840_cov_5.207827	480	560	2	80	80	1.0000000
NODE_10683_length_839_cov_274.987838	450	530	37	1	80	0.0125000
NODE_10683_length_839_cov_274.987838	450	530	39	2	80	0.0250000
NODE_10683_length_839_cov_274.987838	450	530	40	2	80	0.0250000
NODE_10683_length_839_cov_274.987838	450	530	43	3	80	0.0375000
NODE_10683_length_839_cov_274.987838	450	530	46	4	80	0.0500000
NODE_10683_length_839_cov_274.987838	450	530	50	2	80	0.0250000
NODE_10683_length_839_cov_274.987838	450	530	51	3	80	0.0375000
NODE_10683_length_839_cov_274.987838	450	530	53	2	80	0.0250000
NODE_10683_length_839_cov_274.987838	450	530	54	2	80	0.0250000
NODE_10683_length_839_cov_274.987838	450	530	55	2	80	0.0250000
NODE_10683_length_839_cov_274.987838	450	530	64	2	80	0.0250000
NODE_10683_length_839_cov_274.987838	450	530	67	1	80	0.0125000
NODE_10683_length_839_cov_274.987838	450	530	69	1	80	0.0125000
NODE_10683_length_839_cov_274.987838	450	530	79	1	80	0.0125000
NODE_10683_length_839_cov_274.987838	450	530	83	1	80	0.0125000
NODE_10683_length_839_cov_274.987838	450	530	84	1	80	0.0125000
NODE_10683_length_839_cov_274.987838	450	530	100	1	80	0.0125000
NODE_10683_length_839_cov_274.987838	450	530	102	4	80	0.0500000
NODE_10683_length_839_cov_274.987838	450	530	103	2	80	0.0250000
NODE_10683_length_839_cov_274.987838	450	530	105	2	80	0.0250000
NODE_10683_length_839_cov_274.987838	450	530	109	2	80	0.0250000
NODE_10683_length_839_cov_274.987838	450	530	110	1	80	0.0125000
NODE_10683_length_839_cov_274.987838	450	530	112	1	80	0.0125000
NODE_10683_length_839_cov_274.987838	450	530	118	1	80	0.0125000
NODE_10683_length_839_cov_274.987838	450	530	120	5	80	0.0625000
NODE_10683_length_839_cov_274.987838	450	530	124	1	80	0.0125000
NODE_10683_length_839_cov_274.987838	450	530	128	1	80	0.0125000
NODE_10683_length_839_cov_274.987838	450	530	130	2	80	0.0250000
NODE_10683_length_839_cov_274.987838	450	530	134	1	80	0.0125000
NODE_10683_length_839_cov_274.987838	450	530	135	3	80	0.0375000
NODE_10683_length_839_cov_274.987838	450	530	136	2	80	0.0250000
NODE_10683_length_839_cov_274.987838	450	530	138	2	80	0.0250000
NODE_10683_length_839_cov_274.987838	450	530	139	4	80	0.0500000
NODE_10683_length_839_cov_274.987838	450	530	141	2	80	0.0250000
NODE_10683_length_839_cov_274.987838	450	530	146	8	80	0.1000000
NODE_10683_length_839_cov_274.987838	450	530	148	3	80	0.0375000
NODE_10683_length_839_cov_274.987838	450	530	150	1	80	0.0125000
NODE_10683_length_839_cov_274.987838	450	530	157	1	80	0.0125000
NODE_10683_length_839_cov_274.987838	503	583	134	1	80	0.0125000
NODE_10683_length_839_cov_274.987838	503	583	135	3	80	0.0375000
NODE_10683_length_839_cov_274.987838	503	583	136	2	80	0.0250000
NODE_10683_length_839_cov_274.987838	503	583	138	2	80	0.0250000
NODE_10683_length_839_cov_274.987838	503	583	139	5	80	0.0625000
NODE_10683_length_839_cov_274.987838	503	583	140	1	80	0.0125000
NODE_10683_length_839_cov_274.987838	503	583	141	3	80	0.0375000
NODE_10683_length_839_cov_274.987838	503	583	142	2	80	0.0250000
NODE_10683_length_839_cov_274.987838	503	583	143	5	80	0.0625000
NODE_10683_length_839_cov_274.987838	503	583	146	8	80	0.1000000
NODE_10683_length_839_cov_274.987838	503	583	148	4	80	0.0500000
NODE_10683_length_839_cov_274.987838	503	583	150	1	80	0.0125000
NODE_10683_length_839_cov_274.987838	503	583	154	2	80	0.0250000
NODE_10683_length_839_cov_274.987838	503	583	157	2	80	0.0250000
NODE_10683_length_839_cov_274.987838	503	583	159	1	80	0.0125000
NODE_10683_length_839_cov_274.987838	503	583	161	3	80	0.0375000
NODE_10683_length_839_cov_274.987838	503	583	165	1	80	0.0125000
NODE_10683_length_839_cov_274.987838	503	583	169	1	80	0.0125000
NODE_10683_length_839_cov_274.987838	503	583	170	1	80	0.0125000
NODE_10683_length_839_cov_274.987838	503	583	172	2	80	0.0250000
NODE_10683_length_839_cov_274.987838	503	583	173	1	80	0.0125000
NODE_10683_length_839_cov_274.987838	503	583	174	2	80	0.0250000
NODE_10683_length_839_cov_274.987838	503	583	175	2	80	0.0250000
NODE_10683_length_839_cov_274.987838	503	583	176	6	80	0.0750000
NODE_10683_length_839_cov_274.987838	503	583	178	1	80	0.0125000
NODE_10683_length_839_cov_274.987838	503	583	179	1	80	0.0125000
NODE_10683_length_839_cov_274.987838	503	583	180	3	80	0.0375000
NODE_10683_length_839_cov_274.987838	503	583	182	1	80	0.0125000
NODE_10683_length_839_cov_274.987838	503	583	184	6	80	0.0750000
NODE_10683_length_839_cov_274.987838	503	583	185	4	80	0.0500000
NODE_10683_length_839_cov_274.987838	503	583	188	3	80	0.0375000
NODE_10684_length_839_cov_24.500000	303	383	6	10	80	0.1250000
NODE_10684_length_839_cov_24.500000	303	383	8	48	80	0.6000000
NODE_10684_length_839_cov_24.500000	303	383	10	22	80	0.2750000
NODE_10684_length_839_cov_24.500000	356	436	0	5	80	0.0625000
NODE_10684_length_839_cov_24.500000	356	436	2	19	80	0.2375000
NODE_10684_length_839_cov_24.500000	356	436	4	16	80	0.2000000
NODE_10684_length_839_cov_24.500000	356	436	6	23	80	0.2875000
NODE_10684_length_839_cov_24.500000	356	436	10	17	80	0.2125000
NODE_10685_length_839_cov_16.390541	477	557	2	17	80	0.2125000
NODE_10685_length_839_cov_16.390541	477	557	4	1	80	0.0125000
NODE_10685_length_839_cov_16.390541	477	557	5	3	80	0.0375000
NODE_10685_length_839_cov_16.390541	477	557	6	7	80	0.0875000
NODE_10685_length_839_cov_16.390541	477	557	8	52	80	0.6500000
NODE_10685_length_839_cov_16.390541	530	610	2	2	80	0.0250000
NODE_10685_length_839_cov_16.390541	530	610	4	14	80	0.1750000
NODE_10685_length_839_cov_16.390541	530	610	6	18	80	0.2250000
NODE_10685_length_839_cov_16.390541	530	610	8	46	80	0.5750000
NODE_10686_length_839_cov_10.006757	383	463	0	80	80	1.0000000
NODE_10686_length_839_cov_10.006757	436	516	0	80	80	1.0000000
NODE_10688_length_839_cov_7.612162	308	388	0	80	80	1.0000000
NODE_10688_length_839_cov_7.612162	361	441	0	80	80	1.0000000
NODE_10689_length_839_cov_6.693243	343	423	0	43	80	0.5375000
NODE_10689_length_839_cov_6.693243	343	423	2	5	80	0.0625000
NODE_10689_length_839_cov_6.693243	343	423	5	32	80	0.4000000
NODE_10706_length_838_cov_39.263870	383	463	0	5	80	0.0625000
NODE_10706_length_838_cov_39.263870	383	463	2	22	80	0.2750000
NODE_10706_length_838_cov_39.263870	383	463	7	11	80	0.1375000
NODE_10706_length_838_cov_39.263870	383	463	9	21	80	0.2625000
NODE_10706_length_838_cov_39.263870	383	463	10	21	80	0.2625000
NODE_10706_length_838_cov_39.263870	436	516	0	3	80	0.0375000
NODE_10706_length_838_cov_39.263870	436	516	2	8	80	0.1000000
NODE_10706_length_838_cov_39.263870	436	516	4	20	80	0.2500000
NODE_10706_length_838_cov_39.263870	436	516	8	1	80	0.0125000
NODE_10706_length_838_cov_39.263870	436	516	9	27	80	0.3375000
NODE_10706_length_838_cov_39.263870	436	516	10	21	80	0.2625000
NODE_10707_length_838_cov_27.843031	473	553	0	80	80	1.0000000
NODE_10707_length_838_cov_27.843031	526	606	0	80	80	1.0000000
NODE_10708_length_838_cov_27.238160	432	512	4	23	80	0.2875000
NODE_10708_length_838_cov_27.238160	432	512	6	17	80	0.2125000
NODE_10708_length_838_cov_27.238160	432	512	8	40	80	0.5000000
NODE_10708_length_838_cov_27.238160	485	565	2	19	80	0.2375000
NODE_10708_length_838_cov_27.238160	485	565	4	26	80	0.3250000
NODE_10708_length_838_cov_27.238160	485	565	6	13	80	0.1625000
NODE_10708_length_838_cov_27.238160	485	565	8	22	80	0.2750000
NODE_10709_length_838_cov_22.691475	380	460	4	6	80	0.0750000
NODE_10709_length_838_cov_22.691475	380	460	7	2	80	0.0250000
NODE_10709_length_838_cov_22.691475	380	460	8	72	80	0.9000000
NODE_10709_length_838_cov_22.691475	433	513	0	53	80	0.6625000
NODE_10709_length_838_cov_22.691475	433	513	4	2	80	0.0250000
NODE_10709_length_838_cov_22.691475	433	513	7	1	80	0.0125000
NODE_10709_length_838_cov_22.691475	433	513	8	24	80	0.3000000
NODE_10710_length_838_cov_16.169147	312	392	0	80	80	1.0000000
NODE_10710_length_838_cov_16.169147	365	445	0	55	80	0.6875000
NODE_10710_length_838_cov_16.169147	365	445	2	25	80	0.3125000
NODE_10711_length_838_cov_15.753721	328	408	0	38	80	0.4750000
NODE_10711_length_838_cov_15.753721	328	408	4	42	80	0.5250000
NODE_10711_length_838_cov_15.753721	381	461	0	80	80	1.0000000
NODE_10712_length_838_cov_15.514208	294	374	0	17	80	0.2125000
NODE_10712_length_838_cov_15.514208	294	374	2	63	80	0.7875000
NODE_10712_length_838_cov_15.514208	347	427	0	36	80	0.4500000
NODE_10712_length_838_cov_15.514208	347	427	2	44	80	0.5500000
NODE_10713_length_838_cov_7.733424	350	430	0	16	80	0.2000000
NODE_10713_length_838_cov_7.733424	350	430	2	64	80	0.8000000
NODE_10713_length_838_cov_7.733424	403	483	0	62	80	0.7750000
NODE_10713_length_838_cov_7.733424	403	483	2	18	80	0.2250000
NODE_10716_length_838_cov_4.511502	131	213	0	47	82	0.5731707
NODE_10716_length_838_cov_4.511502	131	213	2	35	82	0.4268293
NODE_10716_length_838_cov_4.511502	184	252	0	68	68	1.0000000
NODE_10722_length_838_cov_2.247632	359	405	0	46	46	1.0000000
NODE_10727_length_838_cov_1.843031	732	752	0	19	20	0.9500000
NODE_10727_length_838_cov_1.843031	732	752	2	1	20	0.0500000
NODE_10740_length_837_cov_32.691057	401	481	12	80	80	1.0000000
NODE_10740_length_837_cov_32.691057	454	534	4	34	80	0.4250000
NODE_10740_length_837_cov_32.691057	454	534	8	5	80	0.0625000
NODE_10740_length_837_cov_32.691057	454	534	10	14	80	0.1750000
NODE_10740_length_837_cov_32.691057	454	534	12	27	80	0.3375000
NODE_10741_length_837_cov_30.995935	399	479	0	5	80	0.0625000
NODE_10741_length_837_cov_30.995935	399	479	2	40	80	0.5000000
NODE_10741_length_837_cov_30.995935	399	479	4	22	80	0.2750000
NODE_10741_length_837_cov_30.995935	399	479	6	13	80	0.1625000
NODE_10741_length_837_cov_30.995935	452	532	4	30	80	0.3750000
NODE_10741_length_837_cov_30.995935	452	532	6	50	80	0.6250000
NODE_10742_length_837_cov_30.883469	278	358	0	47	80	0.5875000
NODE_10742_length_837_cov_30.883469	278	358	2	31	80	0.3875000
NODE_10742_length_837_cov_30.883469	278	358	6	1	80	0.0125000
NODE_10742_length_837_cov_30.883469	278	358	7	1	80	0.0125000
NODE_10742_length_837_cov_30.883469	331	411	2	25	80	0.3125000
NODE_10742_length_837_cov_30.883469	331	411	6	1	80	0.0125000
NODE_10742_length_837_cov_30.883469	331	411	7	10	80	0.1250000
NODE_10742_length_837_cov_30.883469	331	411	8	44	80	0.5500000
NODE_10742_length_837_cov_30.883469	407	487	6	19	80	0.2375000
NODE_10742_length_837_cov_30.883469	407	487	8	61	80	0.7625000
NODE_10742_length_837_cov_30.883469	460	540	0	37	80	0.4625000
NODE_10742_length_837_cov_30.883469	460	540	2	12	80	0.1500000
NODE_10742_length_837_cov_30.883469	460	540	8	31	80	0.3875000
NODE_10743_length_837_cov_14.573171	205	280	0	64	75	0.8533334
NODE_10743_length_837_cov_14.573171	205	280	2	11	75	0.1466667
NODE_10743_length_837_cov_14.573171	258	337	0	11	79	0.1392405
NODE_10743_length_837_cov_14.573171	258	337	2	16	79	0.2025317
NODE_10743_length_837_cov_14.573171	258	337	4	52	79	0.6582279
NODE_10743_length_837_cov_14.573171	333	413	2	61	80	0.7625000
NODE_10743_length_837_cov_14.573171	333	413	4	19	80	0.2375000
NODE_10743_length_837_cov_14.573171	386	466	0	53	80	0.6625000
NODE_10743_length_837_cov_14.573171	386	466	2	27	80	0.3375000
NODE_10744_length_837_cov_12.582656	226	306	0	80	80	1.0000000
NODE_10744_length_837_cov_12.582656	279	359	0	28	80	0.3500000
NODE_10744_length_837_cov_12.582656	279	359	2	8	80	0.1000000
NODE_10744_length_837_cov_12.582656	279	359	6	44	80	0.5500000
NODE_10745_length_837_cov_6.998645	389	474	6	85	85	1.0000000
NODE_10745_length_837_cov_6.998645	447	527	0	19	80	0.2375000
NODE_10745_length_837_cov_6.998645	447	527	6	61	80	0.7625000
NODE_10750_length_837_cov_3.119241	373	453	0	80	80	1.0000000
NODE_10750_length_837_cov_3.119241	426	506	0	80	80	1.0000000
NODE_10769_length_836_cov_40.141113	224	304	0	80	80	1.0000000
NODE_10769_length_836_cov_40.141113	277	357	0	73	80	0.9125000
NODE_10769_length_836_cov_40.141113	277	357	1	7	80	0.0875000
NODE_10769_length_836_cov_40.141113	353	433	1	25	80	0.3125000
NODE_10769_length_836_cov_40.141113	353	433	2	4	80	0.0500000
NODE_10769_length_836_cov_40.141113	353	433	6	9	80	0.1125000
NODE_10769_length_836_cov_40.141113	353	433	10	23	80	0.2875000
NODE_10769_length_836_cov_40.141113	353	433	16	19	80	0.2375000
NODE_10769_length_836_cov_40.141113	406	486	10	8	80	0.1000000
NODE_10769_length_836_cov_40.141113	406	486	16	72	80	0.9000000
NODE_10770_length_836_cov_27.610583	344	424	4	2	80	0.0250000
NODE_10770_length_836_cov_27.610583	344	424	8	19	80	0.2375000
NODE_10770_length_836_cov_27.610583	344	424	10	59	80	0.7375000
NODE_10770_length_836_cov_27.610583	397	477	0	39	80	0.4875000
NODE_10770_length_836_cov_27.610583	397	477	4	16	80	0.2000000
NODE_10770_length_836_cov_27.610583	397	477	8	19	80	0.2375000
NODE_10770_length_836_cov_27.610583	397	477	10	6	80	0.0750000
NODE_10771_length_836_cov_15.719132	295	375	0	80	80	1.0000000
NODE_10771_length_836_cov_15.719132	348	428	0	80	80	1.0000000
NODE_10772_length_836_cov_9.309362	295	375	0	44	80	0.5500000
NODE_10772_length_836_cov_9.309362	295	375	2	36	80	0.4500000
NODE_10772_length_836_cov_9.309362	348	428	2	80	80	1.0000000
NODE_10773_length_836_cov_6.283582	336	416	0	80	80	1.0000000
NODE_10773_length_836_cov_6.283582	389	469	0	80	80	1.0000000
NODE_10774_length_836_cov_4.979647	371	451	0	80	80	1.0000000
NODE_10774_length_836_cov_4.979647	424	504	0	80	80	1.0000000
NODE_10787_length_835_cov_61.033967	253	333	0	10	80	0.1250000
NODE_10787_length_835_cov_61.033967	253	333	1	12	80	0.1500000
NODE_10787_length_835_cov_61.033967	253	333	2	2	80	0.0250000
NODE_10787_length_835_cov_61.033967	253	333	4	56	80	0.7000000
NODE_10787_length_835_cov_61.033967	306	386	4	80	80	1.0000000
NODE_10788_length_835_cov_32.380435	390	470	0	80	80	1.0000000
NODE_10788_length_835_cov_32.380435	443	523	0	80	80	1.0000000
NODE_10789_length_835_cov_20.779891	415	495	0	80	80	1.0000000
NODE_10789_length_835_cov_20.779891	468	548	0	80	80	1.0000000
NODE_10808_length_835_cov_1.694293	18	80	0	62	62	1.0000000
NODE_10820_length_834_cov_13.689796	213	293	0	80	80	1.0000000
NODE_10820_length_834_cov_13.689796	266	346	0	80	80	1.0000000
NODE_10822_length_834_cov_12.609524	406	486	0	80	80	1.0000000
NODE_10822_length_834_cov_12.609524	459	539	0	80	80	1.0000000
NODE_10823_length_834_cov_11.492517	248	328	2	33	80	0.4125000
NODE_10823_length_834_cov_11.492517	248	328	6	13	80	0.1625000
NODE_10823_length_834_cov_11.492517	248	328	10	34	80	0.4250000
NODE_10823_length_834_cov_11.492517	301	381	4	1	80	0.0125000
NODE_10823_length_834_cov_11.492517	301	381	8	52	80	0.6500000
NODE_10823_length_834_cov_11.492517	301	381	10	27	80	0.3375000
NODE_10824_length_834_cov_9.957823	212	292	0	41	80	0.5125000
NODE_10824_length_834_cov_9.957823	212	292	2	18	80	0.2250000
NODE_10824_length_834_cov_9.957823	212	292	4	12	80	0.1500000
NODE_10824_length_834_cov_9.957823	212	292	10	9	80	0.1125000
NODE_10824_length_834_cov_9.957823	265	345	0	6	80	0.0750000
NODE_10824_length_834_cov_9.957823	265	345	4	12	80	0.1500000
NODE_10824_length_834_cov_9.957823	265	345	10	62	80	0.7750000
NODE_10825_length_834_cov_6.448980	482	546	0	19	64	0.2968750
NODE_10825_length_834_cov_6.448980	482	546	2	45	64	0.7031250
NODE_10833_length_834_cov_2.658503	589	641	0	52	52	1.0000000
NODE_10846_length_833_cov_57.702997	338	418	0	29	80	0.3625000
NODE_10846_length_833_cov_57.702997	338	418	2	25	80	0.3125000
NODE_10846_length_833_cov_57.702997	338	418	4	26	80	0.3250000
NODE_10846_length_833_cov_57.702997	391	471	2	17	80	0.2125000
NODE_10846_length_833_cov_57.702997	391	471	4	63	80	0.7875000
NODE_10847_length_833_cov_38.153951	364	444	0	33	80	0.4125000
NODE_10847_length_833_cov_38.153951	364	444	2	47	80	0.5875000
NODE_10847_length_833_cov_38.153951	417	497	0	80	80	1.0000000
NODE_10848_length_833_cov_34.302452	368	448	0	80	80	1.0000000
NODE_10848_length_833_cov_34.302452	421	501	0	80	80	1.0000000
NODE_10849_length_833_cov_20.452316	311	392	0	42	81	0.5185185
NODE_10849_length_833_cov_20.452316	311	392	2	39	81	0.4814815
NODE_10849_length_833_cov_20.452316	365	445	0	80	80	1.0000000
NODE_10850_length_833_cov_16.643052	238	318	0	10	80	0.1250000
NODE_10850_length_833_cov_16.643052	238	318	2	12	80	0.1500000
NODE_10850_length_833_cov_16.643052	238	318	4	53	80	0.6625000
NODE_10850_length_833_cov_16.643052	238	318	6	5	80	0.0625000
NODE_10851_length_833_cov_16.536785	84	164	0	80	80	1.0000000
NODE_10851_length_833_cov_16.536785	137	217	0	80	80	1.0000000
NODE_10865_length_833_cov_3.089918	467	547	0	80	80	1.0000000
NODE_10865_length_833_cov_3.089918	520	600	0	80	80	1.0000000
NODE_10891_length_832_cov_35.728513	460	540	0	45	80	0.5625000
NODE_10891_length_832_cov_35.728513	460	540	2	35	80	0.4375000
NODE_10891_length_832_cov_35.728513	513	593	2	80	80	1.0000000
NODE_10892_length_832_cov_25.450205	292	372	0	80	80	1.0000000
NODE_10892_length_832_cov_25.450205	345	425	0	80	80	1.0000000
NODE_10893_length_832_cov_18.858117	428	508	0	2	80	0.0250000
NODE_10893_length_832_cov_18.858117	428	508	2	37	80	0.4625000
NODE_10893_length_832_cov_18.858117	428	508	6	41	80	0.5125000
NODE_10893_length_832_cov_18.858117	481	561	4	3	80	0.0375000
NODE_10893_length_832_cov_18.858117	481	561	6	77	80	0.9625000
NODE_10894_length_832_cov_17.799454	314	394	0	80	80	1.0000000
NODE_10894_length_832_cov_17.799454	367	447	0	80	80	1.0000000
NODE_10895_length_832_cov_14.811733	353	433	0	33	80	0.4125000
NODE_10895_length_832_cov_14.811733	353	433	2	31	80	0.3875000
NODE_10895_length_832_cov_14.811733	353	433	4	11	80	0.1375000
NODE_10895_length_832_cov_14.811733	353	433	6	5	80	0.0625000
NODE_10896_length_832_cov_14.770805	259	339	2	5	80	0.0625000
NODE_10896_length_832_cov_14.770805	259	339	4	30	80	0.3750000
NODE_10896_length_832_cov_14.770805	259	339	6	2	80	0.0250000
NODE_10896_length_832_cov_14.770805	259	339	8	43	80	0.5375000
NODE_10896_length_832_cov_14.770805	312	392	7	25	80	0.3125000
NODE_10896_length_832_cov_14.770805	312	392	8	28	80	0.3500000
NODE_10896_length_832_cov_14.770805	312	392	9	5	80	0.0625000
NODE_10896_length_832_cov_14.770805	312	392	10	22	80	0.2750000
NODE_10897_length_832_cov_8.305593	266	346	0	80	80	1.0000000
NODE_10897_length_832_cov_8.305593	319	399	0	80	80	1.0000000
NODE_10918_length_831_cov_18.403005	371	451	0	2	80	0.0250000
NODE_10918_length_831_cov_18.403005	371	451	2	69	80	0.8625000
NODE_10918_length_831_cov_18.403005	371	451	4	9	80	0.1125000
NODE_10918_length_831_cov_18.403005	424	504	2	71	80	0.8875000
NODE_10918_length_831_cov_18.403005	424	504	4	9	80	0.1125000
NODE_10919_length_831_cov_16.017760	357	437	6	22	80	0.2750000
NODE_10919_length_831_cov_16.017760	357	437	7	42	80	0.5250000
NODE_10919_length_831_cov_16.017760	357	437	8	16	80	0.2000000
NODE_10919_length_831_cov_16.017760	410	490	0	17	80	0.2125000
NODE_10919_length_831_cov_16.017760	410	490	2	2	80	0.0250000
NODE_10919_length_831_cov_16.017760	410	490	4	5	80	0.0625000
NODE_10919_length_831_cov_16.017760	410	490	5	20	80	0.2500000
NODE_10919_length_831_cov_16.017760	410	490	7	36	80	0.4500000
NODE_10920_length_831_cov_13.740437	405	485	0	80	80	1.0000000
NODE_10920_length_831_cov_13.740437	458	538	0	80	80	1.0000000
NODE_10921_length_831_cov_9.595628	281	361	0	80	80	1.0000000
NODE_10921_length_831_cov_9.595628	334	414	0	80	80	1.0000000
NODE_10922_length_831_cov_8.199454	433	482	6	49	49	1.0000000
NODE_10923_length_831_cov_7.607923	216	296	0	80	80	1.0000000
NODE_10923_length_831_cov_7.607923	269	349	0	80	80	1.0000000
NODE_10924_length_831_cov_6.454918	334	409	0	75	75	1.0000000
NODE_10924_length_831_cov_6.454918	382	462	0	80	80	1.0000000
NODE_10960_length_830_cov_40.856361	238	318	0	25	80	0.3125000
NODE_10960_length_830_cov_40.856361	238	318	6	55	80	0.6875000
NODE_10960_length_830_cov_40.856361	291	371	0	27	80	0.3375000
NODE_10960_length_830_cov_40.856361	291	371	6	53	80	0.6625000
NODE_10961_length_830_cov_32.170999	302	378	0	76	76	1.0000000
NODE_10961_length_830_cov_32.170999	303	383	0	80	80	1.0000000
NODE_10961_length_830_cov_32.170999	356	436	0	80	80	1.0000000
NODE_10962_length_830_cov_28.041040	393	473	0	80	80	1.0000000
NODE_10962_length_830_cov_28.041040	446	526	0	80	80	1.0000000
NODE_10963_length_830_cov_20.280438	360	440	2	58	80	0.7250000
NODE_10963_length_830_cov_20.280438	360	440	4	22	80	0.2750000
NODE_10963_length_830_cov_20.280438	413	492	2	51	79	0.6455696
NODE_10963_length_830_cov_20.280438	413	492	4	28	79	0.3544304
NODE_10964_length_830_cov_19.495212	274	354	6	50	80	0.6250000
NODE_10964_length_830_cov_19.495212	274	354	8	30	80	0.3750000
NODE_10964_length_830_cov_19.495212	327	407	6	50	80	0.6250000
NODE_10964_length_830_cov_19.495212	327	407	8	30	80	0.3750000
NODE_10965_length_830_cov_18.522572	368	448	0	80	80	1.0000000
NODE_10965_length_830_cov_18.522572	421	501	0	27	80	0.3375000
NODE_10965_length_830_cov_18.522572	421	501	2	53	80	0.6625000
NODE_10966_length_830_cov_13.830369	278	358	4	80	80	1.0000000
NODE_10966_length_830_cov_13.830369	331	411	0	41	80	0.5125000
NODE_10966_length_830_cov_13.830369	331	411	4	39	80	0.4875000
NODE_10967_length_830_cov_12.459644	201	281	0	80	80	1.0000000
NODE_10967_length_830_cov_12.459644	254	334	0	80	80	1.0000000
NODE_10968_length_830_cov_8.344733	450	530	0	80	80	1.0000000
NODE_10968_length_830_cov_8.344733	503	583	0	80	80	1.0000000
NODE_10969_length_830_cov_8.227086	634	714	0	58	80	0.7250000
NODE_10969_length_830_cov_8.227086	634	714	4	22	80	0.2750000
NODE_10969_length_830_cov_8.227086	687	767	0	5	80	0.0625000
NODE_10969_length_830_cov_8.227086	687	767	4	75	80	0.9375000
NODE_10995_length_829_cov_74.910959	271	351	0	15	80	0.1875000
NODE_10995_length_829_cov_74.910959	271	351	2	30	80	0.3750000
NODE_10995_length_829_cov_74.910959	271	351	4	35	80	0.4375000
NODE_10995_length_829_cov_74.910959	324	404	4	48	80	0.6000000
NODE_10995_length_829_cov_74.910959	324	404	6	18	80	0.2250000
NODE_10995_length_829_cov_74.910959	324	404	8	14	80	0.1750000
NODE_10996_length_829_cov_34.068493	302	382	6	54	80	0.6750000
NODE_10996_length_829_cov_34.068493	302	382	10	26	80	0.3250000
NODE_10996_length_829_cov_34.068493	355	435	4	28	80	0.3500000
NODE_10996_length_829_cov_34.068493	355	435	6	1	80	0.0125000
NODE_10996_length_829_cov_34.068493	355	435	9	1	80	0.0125000
NODE_10996_length_829_cov_34.068493	355	435	10	50	80	0.6250000
NODE_10997_length_829_cov_24.027397	441	521	4	5	80	0.0625000
NODE_10997_length_829_cov_24.027397	441	521	6	75	80	0.9375000
NODE_10997_length_829_cov_24.027397	494	574	0	27	80	0.3375000
NODE_10997_length_829_cov_24.027397	494	574	4	31	80	0.3875000
NODE_10997_length_829_cov_24.027397	494	574	6	22	80	0.2750000
NODE_10998_length_829_cov_21.735616	420	500	0	80	80	1.0000000
NODE_10998_length_829_cov_21.735616	473	553	0	80	80	1.0000000
NODE_10999_length_829_cov_18.446575	407	487	0	50	80	0.6250000
NODE_10999_length_829_cov_18.446575	407	487	1	30	80	0.3750000
NODE_10999_length_829_cov_18.446575	460	540	1	33	80	0.4125000
NODE_10999_length_829_cov_18.446575	460	540	2	47	80	0.5875000
NODE_11000_length_829_cov_10.971233	368	448	2	14	80	0.1750000
NODE_11000_length_829_cov_10.971233	368	448	4	37	80	0.4625000
NODE_11000_length_829_cov_10.971233	368	448	6	29	80	0.3625000
NODE_11000_length_829_cov_10.971233	421	501	0	9	80	0.1125000
NODE_11000_length_829_cov_10.971233	421	501	2	58	80	0.7250000
NODE_11000_length_829_cov_10.971233	421	501	4	13	80	0.1625000
NODE_11001_length_829_cov_10.035616	387	467	0	80	80	1.0000000
NODE_11001_length_829_cov_10.035616	440	520	0	80	80	1.0000000
NODE_11002_length_829_cov_9.906849	326	406	0	80	80	1.0000000
NODE_11002_length_829_cov_9.906849	379	459	0	38	80	0.4750000
NODE_11002_length_829_cov_9.906849	379	459	4	42	80	0.5250000
NODE_11003_length_829_cov_8.809589	450	530	0	61	80	0.7625000
NODE_11003_length_829_cov_8.809589	450	530	2	19	80	0.2375000
NODE_11003_length_829_cov_8.809589	503	583	0	8	80	0.1000000
NODE_11003_length_829_cov_8.809589	503	583	2	72	80	0.9000000
NODE_11006_length_829_cov_4.310959	473	553	2	41	80	0.5125000
NODE_11006_length_829_cov_4.310959	473	553	6	39	80	0.4875000
NODE_11006_length_829_cov_4.310959	526	606	0	6	80	0.0750000
NODE_11006_length_829_cov_4.310959	526	606	4	28	80	0.3500000
NODE_11006_length_829_cov_4.310959	526	606	6	46	80	0.5750000
NODE_11008_length_829_cov_3.079452	507	587	0	21	80	0.2625000
NODE_11008_length_829_cov_3.079452	507	587	2	12	80	0.1500000
NODE_11008_length_829_cov_3.079452	507	587	4	47	80	0.5875000
NODE_11008_length_829_cov_3.079452	507	587	0	21	80	0.2625000
NODE_11008_length_829_cov_3.079452	507	587	2	12	80	0.1500000
NODE_11008_length_829_cov_3.079452	507	587	4	47	80	0.5875000
NODE_11008_length_829_cov_3.079452	560	640	2	3	80	0.0375000
NODE_11008_length_829_cov_3.079452	560	640	4	59	80	0.7375000
NODE_11008_length_829_cov_3.079452	560	640	6	18	80	0.2250000
NODE_11025_length_828_cov_41.116598	436	516	2	20	80	0.2500000
NODE_11025_length_828_cov_41.116598	436	516	6	1	80	0.0125000
NODE_11025_length_828_cov_41.116598	436	516	8	32	80	0.4000000
NODE_11025_length_828_cov_41.116598	436	516	10	27	80	0.3375000
NODE_11025_length_828_cov_41.116598	489	569	6	12	80	0.1500000
NODE_11025_length_828_cov_41.116598	489	569	8	15	80	0.1875000
NODE_11025_length_828_cov_41.116598	489	569	10	53	80	0.6625000
NODE_11026_length_828_cov_36.459534	372	452	0	55	80	0.6875000
NODE_11026_length_828_cov_36.459534	372	452	2	25	80	0.3125000
NODE_11026_length_828_cov_36.459534	425	505	0	2	80	0.0250000
NODE_11026_length_828_cov_36.459534	425	505	2	78	80	0.9750000
NODE_11027_length_828_cov_33.515775	443	523	7	6	80	0.0750000
NODE_11027_length_828_cov_33.515775	443	523	9	53	80	0.6625000
NODE_11027_length_828_cov_33.515775	443	523	10	20	80	0.2500000
NODE_11027_length_828_cov_33.515775	443	523	11	1	80	0.0125000
NODE_11027_length_828_cov_33.515775	496	576	4	29	80	0.3625000
NODE_11027_length_828_cov_33.515775	496	576	6	3	80	0.0375000
NODE_11027_length_828_cov_33.515775	496	576	8	13	80	0.1625000
NODE_11027_length_828_cov_33.515775	496	576	9	6	80	0.0750000
NODE_11027_length_828_cov_33.515775	496	576	10	28	80	0.3500000
NODE_11027_length_828_cov_33.515775	496	576	11	1	80	0.0125000
NODE_11028_length_828_cov_21.123457	380	460	0	2	80	0.0250000
NODE_11028_length_828_cov_21.123457	380	460	2	78	80	0.9750000
NODE_11028_length_828_cov_21.123457	433	513	0	28	80	0.3500000
NODE_11028_length_828_cov_21.123457	433	513	2	52	80	0.6500000
NODE_11029_length_828_cov_17.406036	304	392	0	35	88	0.3977273
NODE_11029_length_828_cov_17.406036	304	392	2	17	88	0.1931818
NODE_11029_length_828_cov_17.406036	304	392	4	36	88	0.4090909
NODE_11029_length_828_cov_17.406036	369	445	2	31	76	0.4078947
NODE_11029_length_828_cov_17.406036	369	445	4	45	76	0.5921053
NODE_11030_length_828_cov_14.606310	287	367	4	80	80	1.0000000
NODE_11030_length_828_cov_14.606310	340	420	0	51	80	0.6375000
NODE_11030_length_828_cov_14.606310	340	420	2	2	80	0.0250000
NODE_11030_length_828_cov_14.606310	340	420	4	27	80	0.3375000
NODE_11031_length_828_cov_14.493827	326	406	0	80	80	1.0000000
NODE_11031_length_828_cov_14.493827	379	459	0	80	80	1.0000000
NODE_11031_length_828_cov_14.493827	455	535	0	80	80	1.0000000
NODE_11031_length_828_cov_14.493827	508	588	0	80	80	1.0000000
NODE_11032_length_828_cov_10.550069	280	360	0	80	80	1.0000000
NODE_11032_length_828_cov_10.550069	333	413	0	80	80	1.0000000
NODE_11033_length_828_cov_9.292181	594	674	0	80	80	1.0000000
NODE_11033_length_828_cov_9.292181	647	727	0	80	80	1.0000000
NODE_11034_length_828_cov_8.747599	298	378	8	64	80	0.8000000
NODE_11034_length_828_cov_8.747599	298	378	10	16	80	0.2000000
NODE_11034_length_828_cov_8.747599	351	431	2	2	80	0.0250000
NODE_11034_length_828_cov_8.747599	351	431	3	1	80	0.0125000
NODE_11034_length_828_cov_8.747599	351	431	4	7	80	0.0875000
NODE_11034_length_828_cov_8.747599	351	431	6	28	80	0.3500000
NODE_11034_length_828_cov_8.747599	351	431	8	22	80	0.2750000
NODE_11034_length_828_cov_8.747599	351	431	10	20	80	0.2500000
NODE_11035_length_828_cov_8.098765	199	279	0	80	80	1.0000000
NODE_11035_length_828_cov_8.098765	252	332	0	80	80	1.0000000
NODE_11037_length_828_cov_7.473251	300	380	0	80	80	1.0000000
NODE_11037_length_828_cov_7.473251	353	433	0	80	80	1.0000000
NODE_11039_length_828_cov_5.481481	543	623	0	8	80	0.1000000
NODE_11039_length_828_cov_5.481481	543	623	2	72	80	0.9000000
NODE_11039_length_828_cov_5.481481	596	676	2	65	80	0.8125000
NODE_11039_length_828_cov_5.481481	596	676	4	15	80	0.1875000
NODE_11041_length_828_cov_5.069959	259	339	0	51	80	0.6375000
NODE_11041_length_828_cov_5.069959	259	339	2	29	80	0.3625000
NODE_11066_length_827_cov_34.567308	269	349	0	41	80	0.5125000
NODE_11066_length_827_cov_34.567308	269	349	2	39	80	0.4875000
NODE_11066_length_827_cov_34.567308	322	402	0	9	80	0.1125000
NODE_11066_length_827_cov_34.567308	322	402	2	71	80	0.8875000
NODE_11066_length_827_cov_34.567308	398	478	0	80	80	1.0000000
NODE_11066_length_827_cov_34.567308	451	531	0	80	80	1.0000000
NODE_11067_length_827_cov_31.538462	320	400	0	16	80	0.2000000
NODE_11067_length_827_cov_31.538462	320	400	2	25	80	0.3125000
NODE_11067_length_827_cov_31.538462	320	400	4	8	80	0.1000000
NODE_11067_length_827_cov_31.538462	320	400	6	16	80	0.2000000
NODE_11067_length_827_cov_31.538462	320	400	8	1	80	0.0125000
NODE_11067_length_827_cov_31.538462	320	400	10	14	80	0.1750000
NODE_11067_length_827_cov_31.538462	373	453	4	9	80	0.1125000
NODE_11067_length_827_cov_31.538462	373	453	6	13	80	0.1625000
NODE_11067_length_827_cov_31.538462	373	453	8	13	80	0.1625000
NODE_11067_length_827_cov_31.538462	373	453	10	45	80	0.5625000
NODE_11068_length_827_cov_19.548077	464	544	0	21	80	0.2625000
NODE_11068_length_827_cov_19.548077	464	544	2	59	80	0.7375000
NODE_11068_length_827_cov_19.548077	517	597	0	5	80	0.0625000
NODE_11068_length_827_cov_19.548077	517	597	2	75	80	0.9375000
NODE_11069_length_827_cov_17.490385	320	400	0	79	80	0.9875000
NODE_11069_length_827_cov_17.490385	320	400	4	1	80	0.0125000
NODE_11069_length_827_cov_17.490385	373	453	0	26	80	0.3250000
NODE_11069_length_827_cov_17.490385	373	453	4	54	80	0.6750000
NODE_11070_length_827_cov_15.247253	205	285	0	80	80	1.0000000
NODE_11070_length_827_cov_15.247253	258	338	0	80	80	1.0000000
NODE_11071_length_827_cov_14.151099	372	452	2	80	80	1.0000000
NODE_11071_length_827_cov_14.151099	425	505	0	38	80	0.4750000
NODE_11071_length_827_cov_14.151099	425	505	2	42	80	0.5250000
NODE_11072_length_827_cov_12.157967	262	342	0	80	80	1.0000000
NODE_11072_length_827_cov_12.157967	315	395	0	80	80	1.0000000
NODE_11073_length_827_cov_11.777473	316	396	0	80	80	1.0000000
NODE_11073_length_827_cov_11.777473	369	449	0	80	80	1.0000000
NODE_11074_length_827_cov_11.651099	393	473	0	80	80	1.0000000
NODE_11074_length_827_cov_11.651099	446	526	0	80	80	1.0000000
NODE_11075_length_827_cov_10.711538	286	366	0	13	80	0.1625000
NODE_11075_length_827_cov_10.711538	286	366	2	48	80	0.6000000
NODE_11075_length_827_cov_10.711538	286	366	4	19	80	0.2375000
NODE_11075_length_827_cov_10.711538	339	419	2	15	80	0.1875000
NODE_11075_length_827_cov_10.711538	339	419	4	65	80	0.8125000
NODE_11076_length_827_cov_10.262363	273	353	0	80	80	1.0000000
NODE_11076_length_827_cov_10.262363	326	406	0	80	80	1.0000000
NODE_11077_length_827_cov_10.221154	256	336	2	3	80	0.0375000
NODE_11077_length_827_cov_10.221154	256	336	5	77	80	0.9625000
NODE_11078_length_827_cov_9.576923	359	439	0	80	80	1.0000000
NODE_11078_length_827_cov_9.576923	412	492	0	80	80	1.0000000
NODE_11079_length_827_cov_8.780220	361	441	0	23	80	0.2875000
NODE_11079_length_827_cov_8.780220	361	441	2	25	80	0.3125000
NODE_11079_length_827_cov_8.780220	361	441	4	13	80	0.1625000
NODE_11079_length_827_cov_8.780220	361	441	6	13	80	0.1625000
NODE_11079_length_827_cov_8.780220	361	441	8	6	80	0.0750000
NODE_11079_length_827_cov_8.780220	414	494	4	8	80	0.1000000
NODE_11079_length_827_cov_8.780220	414	494	6	13	80	0.1625000
NODE_11079_length_827_cov_8.780220	414	494	8	59	80	0.7375000
NODE_11093_length_827_cov_1.412088	736	784	6	26	48	0.5416667
NODE_11093_length_827_cov_1.412088	736	784	9	1	48	0.0208333
NODE_11093_length_827_cov_1.412088	736	784	10	21	48	0.4375000
NODE_11106_length_826_cov_34.026135	211	291	1	59	80	0.7375000
NODE_11106_length_826_cov_34.026135	211	291	2	4	80	0.0500000
NODE_11106_length_826_cov_34.026135	211	291	3	17	80	0.2125000
NODE_11106_length_826_cov_34.026135	264	344	1	6	80	0.0750000
NODE_11106_length_826_cov_34.026135	264	344	2	4	80	0.0500000
NODE_11106_length_826_cov_34.026135	264	344	3	60	80	0.7500000
NODE_11106_length_826_cov_34.026135	264	344	5	10	80	0.1250000
NODE_11107_length_826_cov_24.093535	282	362	0	80	80	1.0000000
NODE_11107_length_826_cov_24.093535	335	415	0	80	80	1.0000000
NODE_11108_length_826_cov_20.943604	207	287	4	48	80	0.6000000
NODE_11108_length_826_cov_20.943604	207	287	6	1	80	0.0125000
NODE_11108_length_826_cov_20.943604	207	287	8	31	80	0.3875000
NODE_11108_length_826_cov_20.943604	260	340	4	6	80	0.0750000
NODE_11108_length_826_cov_20.943604	260	340	6	14	80	0.1750000
NODE_11108_length_826_cov_20.943604	260	340	8	60	80	0.7500000
NODE_11109_length_826_cov_20.437414	413	493	0	80	80	1.0000000
NODE_11109_length_826_cov_20.437414	466	546	0	80	80	1.0000000
NODE_11110_length_826_cov_20.200825	432	512	0	80	80	1.0000000
NODE_11110_length_826_cov_20.200825	485	565	0	80	80	1.0000000
NODE_11111_length_826_cov_18.489684	345	425	0	80	80	1.0000000
NODE_11111_length_826_cov_18.489684	398	478	0	80	80	1.0000000
NODE_11112_length_826_cov_17.998624	336	416	0	63	80	0.7875000
NODE_11112_length_826_cov_17.998624	336	416	2	17	80	0.2125000
NODE_11112_length_826_cov_17.998624	389	469	0	10	80	0.1250000
NODE_11112_length_826_cov_17.998624	389	469	2	70	80	0.8750000
NODE_11113_length_826_cov_17.038514	358	438	0	57	80	0.7125000
NODE_11113_length_826_cov_17.038514	358	438	1	23	80	0.2875000
NODE_11113_length_826_cov_17.038514	411	491	0	80	80	1.0000000
NODE_11114_length_826_cov_16.777166	514	603	0	89	89	1.0000000
NODE_11115_length_826_cov_16.177442	361	441	2	45	80	0.5625000
NODE_11115_length_826_cov_16.177442	361	441	4	35	80	0.4375000
NODE_11115_length_826_cov_16.177442	414	494	0	14	80	0.1750000
NODE_11115_length_826_cov_16.177442	414	494	2	51	80	0.6375000
NODE_11115_length_826_cov_16.177442	414	494	4	15	80	0.1875000
NODE_11116_length_826_cov_15.134801	346	426	0	1	80	0.0125000
NODE_11116_length_826_cov_15.134801	346	426	2	79	80	0.9875000
NODE_11116_length_826_cov_15.134801	399	479	0	44	80	0.5500000
NODE_11116_length_826_cov_15.134801	399	479	2	36	80	0.4500000
NODE_11117_length_826_cov_9.943604	320	400	0	80	80	1.0000000
NODE_11117_length_826_cov_9.943604	373	453	0	80	80	1.0000000
NODE_11120_length_826_cov_4.852820	501	579	0	78	78	1.0000000
NODE_11120_length_826_cov_4.852820	552	632	0	80	80	1.0000000
NODE_11161_length_825_cov_61.804408	382	462	0	80	80	1.0000000
NODE_11161_length_825_cov_61.804408	435	514	0	79	79	1.0000000
NODE_11162_length_825_cov_43.825069	488	568	0	19	80	0.2375000
NODE_11162_length_825_cov_43.825069	488	568	2	61	80	0.7625000
NODE_11162_length_825_cov_43.825069	541	621	0	72	80	0.9000000
NODE_11162_length_825_cov_43.825069	541	621	2	8	80	0.1000000
NODE_11162_length_825_cov_43.825069	617	697	0	40	80	0.5000000
NODE_11162_length_825_cov_43.825069	617	697	8	22	80	0.2750000
NODE_11162_length_825_cov_43.825069	617	697	10	18	80	0.2250000
NODE_11162_length_825_cov_43.825069	670	750	8	9	80	0.1125000
NODE_11162_length_825_cov_43.825069	670	750	9	14	80	0.1750000
NODE_11162_length_825_cov_43.825069	670	750	10	57	80	0.7125000
NODE_11163_length_825_cov_43.389807	496	576	0	68	80	0.8500000
NODE_11163_length_825_cov_43.389807	496	576	2	12	80	0.1500000
NODE_11163_length_825_cov_43.389807	549	629	0	15	80	0.1875000
NODE_11163_length_825_cov_43.389807	549	629	2	65	80	0.8125000
NODE_11164_length_825_cov_39.603306	386	466	1	23	80	0.2875000
NODE_11164_length_825_cov_39.603306	386	466	2	57	80	0.7125000
NODE_11164_length_825_cov_39.603306	439	519	1	64	80	0.8000000
NODE_11164_length_825_cov_39.603306	439	519	2	16	80	0.2000000
NODE_11165_length_825_cov_32.205234	354	434	2	34	80	0.4250000
NODE_11165_length_825_cov_32.205234	354	434	4	46	80	0.5750000
NODE_11165_length_825_cov_32.205234	407	487	2	54	80	0.6750000
NODE_11165_length_825_cov_32.205234	407	487	4	26	80	0.3250000
NODE_11166_length_825_cov_29.411846	503	583	0	3	80	0.0375000
NODE_11166_length_825_cov_29.411846	503	583	2	11	80	0.1375000
NODE_11166_length_825_cov_29.411846	503	583	4	10	80	0.1250000
NODE_11166_length_825_cov_29.411846	503	583	10	48	80	0.6000000
NODE_11166_length_825_cov_29.411846	503	583	11	4	80	0.0500000
NODE_11166_length_825_cov_29.411846	503	583	12	4	80	0.0500000
NODE_11166_length_825_cov_29.411846	556	636	4	11	80	0.1375000
NODE_11166_length_825_cov_29.411846	556	636	7	1	80	0.0125000
NODE_11166_length_825_cov_29.411846	556	636	8	13	80	0.1625000
NODE_11166_length_825_cov_29.411846	556	636	10	47	80	0.5875000
NODE_11166_length_825_cov_29.411846	556	636	11	4	80	0.0500000
NODE_11166_length_825_cov_29.411846	556	636	12	4	80	0.0500000
NODE_11167_length_825_cov_22.428375	312	392	2	14	80	0.1750000
NODE_11167_length_825_cov_22.428375	312	392	4	66	80	0.8250000
NODE_11167_length_825_cov_22.428375	365	445	0	14	80	0.1750000
NODE_11167_length_825_cov_22.428375	365	445	2	45	80	0.5625000
NODE_11167_length_825_cov_22.428375	365	445	4	21	80	0.2625000
NODE_11167_length_825_cov_22.428375	441	521	0	41	80	0.5125000
NODE_11167_length_825_cov_22.428375	441	521	2	14	80	0.1750000
NODE_11167_length_825_cov_22.428375	441	521	4	25	80	0.3125000
NODE_11167_length_825_cov_22.428375	494	574	2	20	80	0.2500000
NODE_11167_length_825_cov_22.428375	494	574	4	60	80	0.7500000
NODE_11168_length_825_cov_19.964187	249	329	0	22	80	0.2750000
NODE_11168_length_825_cov_19.964187	249	329	2	58	80	0.7250000
NODE_11168_length_825_cov_19.964187	302	382	2	80	80	1.0000000
NODE_11169_length_825_cov_13.790634	273	353	0	80	80	1.0000000
NODE_11169_length_825_cov_13.790634	326	406	0	80	80	1.0000000
NODE_11170_length_825_cov_11.834711	331	411	0	78	80	0.9750000
NODE_11170_length_825_cov_11.834711	331	411	2	2	80	0.0250000
NODE_11170_length_825_cov_11.834711	384	464	0	80	80	1.0000000
NODE_11171_length_825_cov_11.477961	392	472	0	7	80	0.0875000
NODE_11171_length_825_cov_11.477961	392	472	2	4	80	0.0500000
NODE_11171_length_825_cov_11.477961	392	472	4	1	80	0.0125000
NODE_11171_length_825_cov_11.477961	392	472	6	68	80	0.8500000
NODE_11172_length_825_cov_8.947658	259	339	0	80	80	1.0000000
NODE_11172_length_825_cov_8.947658	312	392	0	73	80	0.9125000
NODE_11172_length_825_cov_8.947658	312	392	3	7	80	0.0875000
NODE_11173_length_825_cov_7.811295	379	459	0	80	80	1.0000000
NODE_11173_length_825_cov_7.811295	432	512	0	80	80	1.0000000
NODE_11174_length_825_cov_7.104683	464	544	0	80	80	1.0000000
NODE_11174_length_825_cov_7.104683	517	597	0	80	80	1.0000000
NODE_11176_length_825_cov_6.252066	542	622	0	80	80	1.0000000
NODE_11176_length_825_cov_6.252066	595	675	0	80	80	1.0000000
NODE_11178_length_825_cov_5.230028	264	344	0	43	80	0.5375000
NODE_11178_length_825_cov_5.230028	264	344	2	37	80	0.4625000
NODE_11178_length_825_cov_5.230028	317	372	0	55	55	1.0000000
NODE_11178_length_825_cov_5.230028	383	463	0	80	80	1.0000000
NODE_11178_length_825_cov_5.230028	436	516	0	80	80	1.0000000
NODE_11205_length_825_cov_0.765840	0	50	0	50	50	1.0000000
NODE_11207_length_824_cov_27.074483	337	412	2	36	75	0.4800000
NODE_11207_length_824_cov_27.074483	337	412	4	39	75	0.5200000
NODE_11207_length_824_cov_27.074483	390	470	0	19	80	0.2375000
NODE_11207_length_824_cov_27.074483	390	470	2	54	80	0.6750000
NODE_11207_length_824_cov_27.074483	390	470	4	7	80	0.0875000
NODE_11208_length_824_cov_23.936552	365	445	0	4	80	0.0500000
NODE_11208_length_824_cov_23.936552	365	445	2	7	80	0.0875000
NODE_11208_length_824_cov_23.936552	365	445	4	69	80	0.8625000
NODE_11208_length_824_cov_23.936552	418	493	0	22	75	0.2933333
NODE_11208_length_824_cov_23.936552	418	493	2	11	75	0.1466667
NODE_11208_length_824_cov_23.936552	418	493	4	42	75	0.5600000
NODE_11209_length_824_cov_22.129655	377	457	2	56	80	0.7000000
NODE_11209_length_824_cov_22.129655	377	457	3	11	80	0.1375000
NODE_11209_length_824_cov_22.129655	377	457	4	13	80	0.1625000
NODE_11209_length_824_cov_22.129655	430	510	0	29	80	0.3625000
NODE_11209_length_824_cov_22.129655	430	510	2	51	80	0.6375000
NODE_11210_length_824_cov_17.914483	387	467	0	6	80	0.0750000
NODE_11210_length_824_cov_17.914483	387	467	2	74	80	0.9250000
NODE_11210_length_824_cov_17.914483	440	520	0	59	80	0.7375000
NODE_11210_length_824_cov_17.914483	440	520	2	21	80	0.2625000
NODE_11211_length_824_cov_16.662069	362	442	0	80	80	1.0000000
NODE_11211_length_824_cov_16.662069	415	495	0	80	80	1.0000000
NODE_11212_length_824_cov_16.306207	352	432	0	80	80	1.0000000
NODE_11212_length_824_cov_16.306207	405	485	0	80	80	1.0000000
NODE_11213_length_824_cov_15.891034	342	422	0	80	80	1.0000000
NODE_11213_length_824_cov_15.891034	395	475	0	80	80	1.0000000
NODE_11214_length_824_cov_12.485517	280	360	0	45	80	0.5625000
NODE_11214_length_824_cov_12.485517	280	360	2	1	80	0.0125000
NODE_11214_length_824_cov_12.485517	280	360	8	34	80	0.4250000
NODE_11214_length_824_cov_12.485517	333	413	8	80	80	1.0000000
NODE_11216_length_824_cov_5.924138	269	349	0	2	80	0.0250000
NODE_11216_length_824_cov_5.924138	269	349	2	78	80	0.9750000
NODE_11216_length_824_cov_5.924138	322	402	0	55	80	0.6875000
NODE_11216_length_824_cov_5.924138	322	402	2	25	80	0.3125000
NODE_11222_length_824_cov_3.849655	191	271	0	80	80	1.0000000
NODE_11251_length_823_cov_75.169890	207	287	3	19	80	0.2375000
NODE_11251_length_823_cov_75.169890	207	287	4	42	80	0.5250000
NODE_11251_length_823_cov_75.169890	207	287	5	1	80	0.0125000
NODE_11251_length_823_cov_75.169890	207	287	7	18	80	0.2250000
NODE_11251_length_823_cov_75.169890	260	340	3	40	80	0.5000000
NODE_11251_length_823_cov_75.169890	260	340	4	3	80	0.0375000
NODE_11251_length_823_cov_75.169890	260	340	5	8	80	0.1000000
NODE_11251_length_823_cov_75.169890	260	340	6	22	80	0.2750000
NODE_11251_length_823_cov_75.169890	260	340	7	7	80	0.0875000
NODE_11251_length_823_cov_75.169890	336	416	5	16	80	0.2000000
NODE_11251_length_823_cov_75.169890	336	416	6	30	80	0.3750000
NODE_11251_length_823_cov_75.169890	336	416	8	32	80	0.4000000
NODE_11251_length_823_cov_75.169890	336	416	9	2	80	0.0250000
NODE_11251_length_823_cov_75.169890	389	469	2	1	80	0.0125000
NODE_11251_length_823_cov_75.169890	389	469	6	7	80	0.0875000
NODE_11251_length_823_cov_75.169890	389	469	7	3	80	0.0375000
NODE_11251_length_823_cov_75.169890	389	469	8	69	80	0.8625000
NODE_11253_length_823_cov_37.738950	332	412	2	5	80	0.0625000
NODE_11253_length_823_cov_37.738950	332	412	4	14	80	0.1750000
NODE_11253_length_823_cov_37.738950	332	412	6	61	80	0.7625000
NODE_11253_length_823_cov_37.738950	385	466	0	45	81	0.5555556
NODE_11253_length_823_cov_37.738950	385	466	2	12	81	0.1481481
NODE_11253_length_823_cov_37.738950	385	466	4	14	81	0.1728395
NODE_11253_length_823_cov_37.738950	385	466	6	10	81	0.1234568
NODE_11254_length_823_cov_29.349448	400	480	4	80	80	1.0000000
NODE_11254_length_823_cov_29.349448	453	533	0	27	80	0.3375000
NODE_11254_length_823_cov_29.349448	453	533	4	53	80	0.6625000
NODE_11255_length_823_cov_25.730663	338	418	0	30	80	0.3750000
NODE_11255_length_823_cov_25.730663	338	418	2	33	80	0.4125000
NODE_11255_length_823_cov_25.730663	338	418	4	17	80	0.2125000
NODE_11255_length_823_cov_25.730663	391	471	2	10	80	0.1250000
NODE_11255_length_823_cov_25.730663	391	471	4	28	80	0.3500000
NODE_11255_length_823_cov_25.730663	391	471	6	12	80	0.1500000
NODE_11255_length_823_cov_25.730663	391	471	8	30	80	0.3750000
NODE_11256_length_823_cov_24.599448	349	429	6	43	80	0.5375000
NODE_11256_length_823_cov_24.599448	349	429	8	19	80	0.2375000
NODE_11256_length_823_cov_24.599448	349	429	10	4	80	0.0500000
NODE_11256_length_823_cov_24.599448	349	429	12	14	80	0.1750000
NODE_11256_length_823_cov_24.599448	402	482	0	40	80	0.5000000
NODE_11256_length_823_cov_24.599448	402	482	4	7	80	0.0875000
NODE_11256_length_823_cov_24.599448	402	482	6	33	80	0.4125000
NODE_11257_length_823_cov_22.149171	356	436	0	47	80	0.5875000
NODE_11257_length_823_cov_22.149171	356	436	2	33	80	0.4125000
NODE_11257_length_823_cov_22.149171	409	489	0	3	80	0.0375000
NODE_11257_length_823_cov_22.149171	409	489	2	25	80	0.3125000
NODE_11257_length_823_cov_22.149171	409	489	6	23	80	0.2875000
NODE_11257_length_823_cov_22.149171	409	489	8	29	80	0.3625000
NODE_11257_length_823_cov_22.149171	485	565	0	14	80	0.1750000
NODE_11257_length_823_cov_22.149171	485	565	2	11	80	0.1375000
NODE_11257_length_823_cov_22.149171	485	565	6	10	80	0.1250000
NODE_11257_length_823_cov_22.149171	485	565	8	45	80	0.5625000
NODE_11257_length_823_cov_22.149171	538	618	0	46	80	0.5750000
NODE_11257_length_823_cov_22.149171	538	618	2	32	80	0.4000000
NODE_11257_length_823_cov_22.149171	538	618	6	2	80	0.0250000
NODE_11258_length_823_cov_20.892265	329	409	0	80	80	1.0000000
NODE_11258_length_823_cov_20.892265	382	462	0	64	80	0.8000000
NODE_11258_length_823_cov_20.892265	382	462	2	16	80	0.2000000
NODE_11259_length_823_cov_19.281768	305	385	2	27	80	0.3375000
NODE_11259_length_823_cov_19.281768	305	385	4	26	80	0.3250000
NODE_11259_length_823_cov_19.281768	305	385	6	27	80	0.3375000
NODE_11259_length_823_cov_19.281768	358	438	2	53	80	0.6625000
NODE_11259_length_823_cov_19.281768	358	438	4	27	80	0.3375000
NODE_11260_length_823_cov_15.738950	409	489	0	80	80	1.0000000
NODE_11260_length_823_cov_15.738950	462	542	0	69	80	0.8625000
NODE_11260_length_823_cov_15.738950	462	542	2	11	80	0.1375000
NODE_11261_length_823_cov_10.729282	362	437	0	75	75	1.0000000
NODE_11261_length_823_cov_10.729282	410	484	0	74	74	1.0000000
NODE_11262_length_823_cov_9.110497	394	474	0	41	80	0.5125000
NODE_11262_length_823_cov_9.110497	394	474	2	39	80	0.4875000
NODE_11262_length_823_cov_9.110497	447	527	0	3	80	0.0375000
NODE_11262_length_823_cov_9.110497	447	527	2	77	80	0.9625000
NODE_11265_length_823_cov_5.511050	168	248	12	3	80	0.0375000
NODE_11265_length_823_cov_5.511050	168	248	16	1	80	0.0125000
NODE_11265_length_823_cov_5.511050	168	248	18	13	80	0.1625000
NODE_11265_length_823_cov_5.511050	168	248	20	60	80	0.7500000
NODE_11265_length_823_cov_5.511050	168	248	22	3	80	0.0375000
NODE_11265_length_823_cov_5.511050	434	485	0	51	51	1.0000000
NODE_11292_length_823_cov_0.968232	86	154	0	25	68	0.3676471
NODE_11292_length_823_cov_0.968232	86	154	2	43	68	0.6323529
NODE_11298_length_822_cov_25.423237	377	459	0	82	82	1.0000000
NODE_11298_length_822_cov_25.423237	432	512	0	80	80	1.0000000
NODE_11299_length_822_cov_16.381743	394	474	3	28	80	0.3500000
NODE_11299_length_822_cov_16.381743	394	474	5	18	80	0.2250000
NODE_11299_length_822_cov_16.381743	394	474	6	34	80	0.4250000
NODE_11299_length_822_cov_16.381743	447	527	2	14	80	0.1750000
NODE_11299_length_822_cov_16.381743	447	527	3	1	80	0.0125000
NODE_11299_length_822_cov_16.381743	447	527	4	18	80	0.2250000
NODE_11299_length_822_cov_16.381743	447	527	6	47	80	0.5875000
NODE_11300_length_822_cov_12.426003	223	296	0	73	73	1.0000000
NODE_11300_length_822_cov_12.426003	278	349	0	71	71	1.0000000
NODE_11301_length_822_cov_10.608575	464	544	2	16	80	0.2000000
NODE_11301_length_822_cov_10.608575	464	544	4	57	80	0.7125000
NODE_11301_length_822_cov_10.608575	464	544	6	7	80	0.0875000
NODE_11301_length_822_cov_10.608575	517	597	2	39	80	0.4875000
NODE_11301_length_822_cov_10.608575	517	597	4	41	80	0.5125000
NODE_11302_length_822_cov_9.496542	363	443	0	56	80	0.7000000
NODE_11302_length_822_cov_9.496542	363	443	2	24	80	0.3000000
NODE_11302_length_822_cov_9.496542	416	496	0	8	80	0.1000000
NODE_11302_length_822_cov_9.496542	416	496	2	72	80	0.9000000
NODE_11333_length_821_cov_39.818560	341	420	2	14	79	0.1772152
NODE_11333_length_821_cov_39.818560	341	420	4	8	79	0.1012658
NODE_11333_length_821_cov_39.818560	341	420	6	44	79	0.5569620
NODE_11333_length_821_cov_39.818560	341	420	8	13	79	0.1645570
NODE_11333_length_821_cov_39.818560	393	473	2	8	80	0.1000000
NODE_11333_length_821_cov_39.818560	393	473	4	53	80	0.6625000
NODE_11333_length_821_cov_39.818560	393	473	6	6	80	0.0750000
NODE_11333_length_821_cov_39.818560	393	473	8	13	80	0.1625000
NODE_11334_length_821_cov_27.721607	299	379	0	33	80	0.4125000
NODE_11334_length_821_cov_27.721607	299	379	2	47	80	0.5875000
NODE_11334_length_821_cov_27.721607	352	432	0	80	80	1.0000000
NODE_11335_length_821_cov_26.252078	386	466	2	18	80	0.2250000
NODE_11335_length_821_cov_26.252078	386	466	4	27	80	0.3375000
NODE_11335_length_821_cov_26.252078	386	466	6	35	80	0.4375000
NODE_11335_length_821_cov_26.252078	439	519	0	24	80	0.3000000
NODE_11335_length_821_cov_26.252078	439	519	2	47	80	0.5875000
NODE_11335_length_821_cov_26.252078	439	519	4	9	80	0.1125000
NODE_11336_length_821_cov_19.603878	353	433	0	21	80	0.2625000
NODE_11336_length_821_cov_19.603878	353	433	1	15	80	0.1875000
NODE_11336_length_821_cov_19.603878	353	433	2	28	80	0.3500000
NODE_11336_length_821_cov_19.603878	353	433	6	16	80	0.2000000
NODE_11336_length_821_cov_19.603878	406	486	2	11	80	0.1375000
NODE_11336_length_821_cov_19.603878	406	486	6	69	80	0.8625000
NODE_11337_length_821_cov_15.945983	310	390	4	80	80	1.0000000
NODE_11337_length_821_cov_15.945983	363	443	0	50	80	0.6250000
NODE_11337_length_821_cov_15.945983	363	443	4	30	80	0.3750000
NODE_11339_length_821_cov_8.711911	288	368	2	13	80	0.1625000
NODE_11339_length_821_cov_8.711911	288	368	3	43	80	0.5375000
NODE_11339_length_821_cov_8.711911	288	368	4	24	80	0.3000000
NODE_11339_length_821_cov_8.711911	341	421	0	33	80	0.4125000
NODE_11339_length_821_cov_8.711911	341	421	2	33	80	0.4125000
NODE_11339_length_821_cov_8.711911	341	421	3	14	80	0.1750000
NODE_11349_length_821_cov_3.026316	310	390	0	43	80	0.5375000
NODE_11349_length_821_cov_3.026316	310	390	2	37	80	0.4625000
NODE_11349_length_821_cov_3.026316	363	443	2	80	80	1.0000000
NODE_11361_length_820_cov_67.292649	328	408	4	42	80	0.5250000
NODE_11361_length_820_cov_67.292649	328	408	6	10	80	0.1250000
NODE_11361_length_820_cov_67.292649	328	408	8	28	80	0.3500000
NODE_11361_length_820_cov_67.292649	381	461	4	16	80	0.2000000
NODE_11361_length_820_cov_67.292649	381	461	6	47	80	0.5875000
NODE_11361_length_820_cov_67.292649	381	461	8	17	80	0.2125000
NODE_11362_length_820_cov_26.915395	308	388	6	5	80	0.0625000
NODE_11362_length_820_cov_26.915395	308	388	8	20	80	0.2500000
NODE_11362_length_820_cov_26.915395	308	388	10	12	80	0.1500000
NODE_11362_length_820_cov_26.915395	308	388	12	11	80	0.1375000
NODE_11362_length_820_cov_26.915395	308	388	14	3	80	0.0375000
NODE_11362_length_820_cov_26.915395	308	388	16	26	80	0.3250000
NODE_11362_length_820_cov_26.915395	308	388	18	3	80	0.0375000
NODE_11363_length_820_cov_25.253814	301	381	0	62	80	0.7750000
NODE_11363_length_820_cov_25.253814	301	381	2	9	80	0.1125000
NODE_11363_length_820_cov_25.253814	301	381	3	1	80	0.0125000
NODE_11363_length_820_cov_25.253814	301	381	6	8	80	0.1000000
NODE_11363_length_820_cov_25.253814	354	434	0	78	80	0.9750000
NODE_11363_length_820_cov_25.253814	354	434	2	2	80	0.0250000
NODE_11363_length_820_cov_25.253814	430	510	0	2	80	0.0250000
NODE_11363_length_820_cov_25.253814	430	510	2	78	80	0.9750000
NODE_11363_length_820_cov_25.253814	483	563	0	25	80	0.3125000
NODE_11363_length_820_cov_25.253814	483	563	2	55	80	0.6875000
NODE_11364_length_820_cov_16.015257	325	405	0	80	80	1.0000000
NODE_11364_length_820_cov_16.015257	378	458	0	80	80	1.0000000
NODE_11365_length_820_cov_14.703190	371	451	2	80	80	1.0000000
NODE_11365_length_820_cov_14.703190	424	504	0	51	80	0.6375000
NODE_11365_length_820_cov_14.703190	424	504	2	29	80	0.3625000
NODE_11366_length_820_cov_14.527046	249	329	0	14	80	0.1750000
NODE_11366_length_820_cov_14.527046	249	329	2	24	80	0.3000000
NODE_11366_length_820_cov_14.527046	249	329	12	6	80	0.0750000
NODE_11366_length_820_cov_14.527046	249	329	16	14	80	0.1750000
NODE_11366_length_820_cov_14.527046	249	329	18	22	80	0.2750000
NODE_11366_length_820_cov_14.527046	302	382	16	5	80	0.0625000
NODE_11366_length_820_cov_14.527046	302	382	18	75	80	0.9375000
NODE_11367_length_820_cov_14.284327	286	366	2	65	80	0.8125000
NODE_11367_length_820_cov_14.284327	286	366	4	15	80	0.1875000
NODE_11367_length_820_cov_14.284327	339	419	2	42	80	0.5250000
NODE_11367_length_820_cov_14.284327	339	419	4	38	80	0.4750000
NODE_11367_length_820_cov_14.284327	619	699	0	58	80	0.7250000
NODE_11367_length_820_cov_14.284327	619	699	2	22	80	0.2750000
NODE_11368_length_820_cov_13.036061	364	444	10	6	80	0.0750000
NODE_11368_length_820_cov_13.036061	364	444	15	3	80	0.0375000
NODE_11368_length_820_cov_13.036061	364	444	16	71	80	0.8875000
NODE_11368_length_820_cov_13.036061	417	497	0	41	80	0.5125000
NODE_11368_length_820_cov_13.036061	417	497	10	18	80	0.2250000
NODE_11368_length_820_cov_13.036061	417	497	16	21	80	0.2625000
NODE_11369_length_820_cov_12.830791	313	393	0	27	80	0.3375000
NODE_11369_length_820_cov_12.830791	313	393	2	53	80	0.6625000
NODE_11369_length_820_cov_12.830791	366	446	0	80	80	1.0000000
NODE_11370_length_820_cov_12.768377	366	443	0	77	77	1.0000000
NODE_11370_length_820_cov_12.768377	496	525	0	29	29	1.0000000
NODE_11371_length_820_cov_12.223301	452	519	0	67	67	1.0000000
NODE_11371_length_820_cov_12.223301	492	572	0	80	80	1.0000000
NODE_11396_length_819_cov_43.027778	403	483	0	80	80	1.0000000
NODE_11396_length_819_cov_43.027778	456	536	0	80	80	1.0000000
NODE_11396_length_819_cov_43.027778	532	612	0	34	80	0.4250000
NODE_11396_length_819_cov_43.027778	532	612	2	12	80	0.1500000
NODE_11396_length_819_cov_43.027778	532	612	3	25	80	0.3125000
NODE_11396_length_819_cov_43.027778	532	612	4	9	80	0.1125000
NODE_11396_length_819_cov_43.027778	585	665	3	18	80	0.2250000
NODE_11396_length_819_cov_43.027778	585	665	4	62	80	0.7750000
NODE_11397_length_819_cov_42.758333	391	471	0	7	80	0.0875000
NODE_11397_length_819_cov_42.758333	391	471	2	5	80	0.0625000
NODE_11397_length_819_cov_42.758333	391	471	6	68	80	0.8500000
NODE_11397_length_819_cov_42.758333	444	524	4	50	80	0.6250000
NODE_11397_length_819_cov_42.758333	444	524	6	30	80	0.3750000
NODE_11398_length_819_cov_41.341667	86	166	2	76	80	0.9500000
NODE_11398_length_819_cov_41.341667	86	166	4	4	80	0.0500000
NODE_11398_length_819_cov_41.341667	139	219	0	26	80	0.3250000
NODE_11398_length_819_cov_41.341667	139	219	2	54	80	0.6750000
NODE_11398_length_819_cov_41.341667	215	295	2	64	80	0.8000000
NODE_11398_length_819_cov_41.341667	215	295	3	9	80	0.1125000
NODE_11398_length_819_cov_41.341667	215	295	4	7	80	0.0875000
NODE_11398_length_819_cov_41.341667	268	348	2	64	80	0.8000000
NODE_11398_length_819_cov_41.341667	268	348	3	9	80	0.1125000
NODE_11398_length_819_cov_41.341667	268	348	4	7	80	0.0875000
NODE_11399_length_819_cov_23.656944	335	415	6	80	80	1.0000000
NODE_11399_length_819_cov_23.656944	388	468	0	15	80	0.1875000
NODE_11399_length_819_cov_23.656944	388	468	6	65	80	0.8125000
NODE_11400_length_819_cov_20.633333	475	555	0	38	80	0.4750000
NODE_11400_length_819_cov_20.633333	475	555	2	3	80	0.0375000
NODE_11400_length_819_cov_20.633333	475	555	12	39	80	0.4875000
NODE_11400_length_819_cov_20.633333	528	608	10	5	80	0.0625000
NODE_11400_length_819_cov_20.633333	528	608	12	75	80	0.9375000
NODE_11401_length_819_cov_18.941667	307	387	0	57	80	0.7125000
NODE_11401_length_819_cov_18.941667	307	387	3	8	80	0.1000000
NODE_11401_length_819_cov_18.941667	307	387	4	15	80	0.1875000
NODE_11401_length_819_cov_18.941667	360	440	0	80	80	1.0000000
NODE_11401_length_819_cov_18.941667	436	516	0	80	80	1.0000000
NODE_11401_length_819_cov_18.941667	489	569	0	80	80	1.0000000
NODE_11402_length_819_cov_12.225000	431	511	0	29	80	0.3625000
NODE_11402_length_819_cov_12.225000	431	511	4	51	80	0.6375000
NODE_11402_length_819_cov_12.225000	484	564	0	27	80	0.3375000
NODE_11402_length_819_cov_12.225000	484	564	4	53	80	0.6625000
NODE_11403_length_819_cov_11.562500	273	353	0	80	80	1.0000000
NODE_11403_length_819_cov_11.562500	326	406	0	80	80	1.0000000
NODE_11404_length_819_cov_8.905556	477	557	0	39	80	0.4875000
NODE_11404_length_819_cov_8.905556	477	557	2	41	80	0.5125000
NODE_11404_length_819_cov_8.905556	530	610	0	80	80	1.0000000
NODE_11405_length_819_cov_5.675000	232	312	0	80	80	1.0000000
NODE_11405_length_819_cov_5.675000	285	365	0	80	80	1.0000000
NODE_11431_length_818_cov_21.979138	342	422	0	80	80	1.0000000
NODE_11431_length_818_cov_21.979138	395	475	0	80	80	1.0000000
NODE_11432_length_818_cov_15.326843	334	414	6	70	80	0.8750000
NODE_11432_length_818_cov_15.326843	334	414	8	10	80	0.1250000
NODE_11432_length_818_cov_15.326843	387	467	0	26	80	0.3250000
NODE_11432_length_818_cov_15.326843	387	467	2	27	80	0.3375000
NODE_11432_length_818_cov_15.326843	387	467	6	27	80	0.3375000
NODE_11433_length_818_cov_14.880389	392	472	0	80	80	1.0000000
NODE_11433_length_818_cov_14.880389	445	525	0	80	80	1.0000000
NODE_11434_length_818_cov_12.369958	390	470	0	80	80	1.0000000
NODE_11434_length_818_cov_12.369958	443	523	0	80	80	1.0000000
NODE_11436_length_818_cov_8.421419	370	450	0	80	80	1.0000000
NODE_11436_length_818_cov_8.421419	423	503	0	80	80	1.0000000
NODE_11437_length_818_cov_6.439499	706	741	0	35	35	1.0000000
NODE_11439_length_818_cov_4.098748	320	390	0	70	70	1.0000000
NODE_11439_length_818_cov_4.098748	416	472	0	44	56	0.7857143
NODE_11439_length_818_cov_4.098748	416	472	2	12	56	0.2142857
NODE_11457_length_817_cov_7.238162	494	574	0	80	80	1.0000000
NODE_11457_length_817_cov_7.238162	547	627	0	28	80	0.3500000
NODE_11457_length_817_cov_7.238162	547	627	2	52	80	0.6500000
NODE_11458_length_817_cov_5.789694	400	480	2	45	80	0.5625000
NODE_11458_length_817_cov_5.789694	400	480	4	35	80	0.4375000
NODE_11458_length_817_cov_5.789694	476	555	0	53	79	0.6708861
NODE_11458_length_817_cov_5.789694	476	555	2	26	79	0.3291139
NODE_11458_length_817_cov_5.789694	528	608	0	80	80	1.0000000
NODE_11462_length_817_cov_4.357939	433	513	0	80	80	1.0000000
NODE_11462_length_817_cov_4.357939	486	566	0	80	80	1.0000000
NODE_11486_length_817_cov_0.692201	626	696	0	9	70	0.1285714
NODE_11486_length_817_cov_0.692201	626	696	2	7	70	0.1000000
NODE_11486_length_817_cov_0.692201	626	696	3	7	70	0.1000000
NODE_11486_length_817_cov_0.692201	626	696	5	4	70	0.0571429
NODE_11486_length_817_cov_0.692201	626	696	10	13	70	0.1857143
NODE_11486_length_817_cov_0.692201	626	696	12	15	70	0.2142857
NODE_11486_length_817_cov_0.692201	626	696	14	3	70	0.0428571
NODE_11486_length_817_cov_0.692201	626	696	16	12	70	0.1714286
NODE_11488_length_816_cov_69.800558	395	475	3	18	80	0.2250000
NODE_11488_length_816_cov_69.800558	395	475	5	62	80	0.7750000
NODE_11488_length_816_cov_69.800558	448	520	3	8	72	0.1111111
NODE_11488_length_816_cov_69.800558	448	520	5	64	72	0.8888889
NODE_11489_length_816_cov_19.044630	77	154	0	77	77	1.0000000
NODE_11489_length_816_cov_19.044630	130	212	0	82	82	1.0000000
NODE_11490_length_816_cov_16.418410	381	461	0	80	80	1.0000000
NODE_11490_length_816_cov_16.418410	434	514	0	80	80	1.0000000
NODE_11491_length_816_cov_15.945607	319	399	0	80	80	1.0000000
NODE_11491_length_816_cov_15.945607	372	452	0	80	80	1.0000000
NODE_11492_length_816_cov_12.797768	358	438	0	21	80	0.2625000
NODE_11492_length_816_cov_12.797768	358	438	2	15	80	0.1875000
NODE_11492_length_816_cov_12.797768	358	438	4	44	80	0.5500000
NODE_11492_length_816_cov_12.797768	411	491	0	74	80	0.9250000
NODE_11492_length_816_cov_12.797768	411	491	2	6	80	0.0750000
NODE_11493_length_816_cov_12.086471	242	322	0	11	80	0.1375000
NODE_11493_length_816_cov_12.086471	242	322	2	69	80	0.8625000
NODE_11493_length_816_cov_12.086471	295	375	0	64	80	0.8000000
NODE_11493_length_816_cov_12.086471	295	375	2	16	80	0.2000000
NODE_11495_length_816_cov_3.873082	412	492	0	80	80	1.0000000
NODE_11495_length_816_cov_3.873082	465	545	0	80	80	1.0000000
NODE_11516_length_815_cov_48.090782	334	414	0	80	80	1.0000000
NODE_11516_length_815_cov_48.090782	387	467	0	80	80	1.0000000
NODE_11517_length_815_cov_27.748603	290	370	0	80	80	1.0000000
NODE_11517_length_815_cov_27.748603	343	423	0	80	80	1.0000000
NODE_11518_length_815_cov_23.748603	429	509	0	80	80	1.0000000
NODE_11518_length_815_cov_23.748603	482	562	0	80	80	1.0000000
NODE_11519_length_815_cov_14.870112	318	398	0	78	80	0.9750000
NODE_11519_length_815_cov_14.870112	318	398	2	2	80	0.0250000
NODE_11519_length_815_cov_14.870112	371	451	0	80	80	1.0000000
NODE_11520_length_815_cov_13.317039	338	418	0	80	80	1.0000000
NODE_11520_length_815_cov_13.317039	391	471	0	53	80	0.6625000
NODE_11520_length_815_cov_13.317039	391	471	2	27	80	0.3375000
NODE_11521_length_815_cov_12.270950	315	395	0	80	80	1.0000000
NODE_11521_length_815_cov_12.270950	368	448	0	80	80	1.0000000
NODE_11522_length_815_cov_9.304469	150	230	4	31	80	0.3875000
NODE_11522_length_815_cov_9.304469	150	230	6	2	80	0.0250000
NODE_11522_length_815_cov_9.304469	150	230	8	12	80	0.1500000
NODE_11522_length_815_cov_9.304469	150	230	10	35	80	0.4375000
NODE_11522_length_815_cov_9.304469	203	283	4	17	80	0.2125000
NODE_11522_length_815_cov_9.304469	203	283	6	8	80	0.1000000
NODE_11522_length_815_cov_9.304469	203	283	10	55	80	0.6875000
NODE_11524_length_815_cov_8.117318	437	517	0	80	80	1.0000000
NODE_11524_length_815_cov_8.117318	490	570	0	80	80	1.0000000
NODE_11530_length_815_cov_3.963687	275	355	0	15	80	0.1875000
NODE_11530_length_815_cov_3.963687	275	355	2	65	80	0.8125000
NODE_11530_length_815_cov_3.963687	328	408	0	34	80	0.4250000
NODE_11530_length_815_cov_3.963687	328	408	2	46	80	0.5750000
NODE_11532_length_815_cov_2.976257	441	508	0	67	67	1.0000000
NODE_11554_length_814_cov_55.545455	304	384	10	11	80	0.1375000
NODE_11554_length_814_cov_55.545455	304	384	18	1	80	0.0125000
NODE_11554_length_814_cov_55.545455	304	384	20	33	80	0.4125000
NODE_11554_length_814_cov_55.545455	304	384	22	35	80	0.4375000
NODE_11554_length_814_cov_55.545455	357	437	4	5	80	0.0625000
NODE_11554_length_814_cov_55.545455	357	437	6	14	80	0.1750000
NODE_11554_length_814_cov_55.545455	357	437	8	12	80	0.1500000
NODE_11554_length_814_cov_55.545455	357	437	9	1	80	0.0125000
NODE_11554_length_814_cov_55.545455	357	437	10	32	80	0.4000000
NODE_11554_length_814_cov_55.545455	357	437	20	3	80	0.0375000
NODE_11554_length_814_cov_55.545455	357	437	22	13	80	0.1625000
NODE_11554_length_814_cov_55.545455	517	559	0	42	42	1.0000000
NODE_11554_length_814_cov_55.545455	724	804	7	2	80	0.0250000
NODE_11554_length_814_cov_55.545455	724	804	9	1	80	0.0125000
NODE_11554_length_814_cov_55.545455	724	804	11	1	80	0.0125000
NODE_11554_length_814_cov_55.545455	724	804	14	1	80	0.0125000
NODE_11554_length_814_cov_55.545455	724	804	17	1	80	0.0125000
NODE_11554_length_814_cov_55.545455	724	804	19	2	80	0.0250000
NODE_11554_length_814_cov_55.545455	724	804	20	1	80	0.0125000
NODE_11554_length_814_cov_55.545455	724	804	21	6	80	0.0750000
NODE_11554_length_814_cov_55.545455	724	804	22	2	80	0.0250000
NODE_11554_length_814_cov_55.545455	724	804	23	1	80	0.0125000
NODE_11554_length_814_cov_55.545455	724	804	25	3	80	0.0375000
NODE_11554_length_814_cov_55.545455	724	804	27	1	80	0.0125000
NODE_11554_length_814_cov_55.545455	724	804	29	1	80	0.0125000
NODE_11554_length_814_cov_55.545455	724	804	32	1	80	0.0125000
NODE_11554_length_814_cov_55.545455	724	804	35	1	80	0.0125000
NODE_11554_length_814_cov_55.545455	724	804	37	10	80	0.1250000
NODE_11554_length_814_cov_55.545455	724	804	39	4	80	0.0500000
NODE_11554_length_814_cov_55.545455	724	804	41	1	80	0.0125000
NODE_11554_length_814_cov_55.545455	724	804	43	5	80	0.0625000
NODE_11554_length_814_cov_55.545455	724	804	45	4	80	0.0500000
NODE_11554_length_814_cov_55.545455	724	804	46	17	80	0.2125000
NODE_11554_length_814_cov_55.545455	724	804	48	6	80	0.0750000
NODE_11554_length_814_cov_55.545455	724	804	50	8	80	0.1000000
NODE_11555_length_814_cov_32.216783	317	397	0	60	80	0.7500000
NODE_11555_length_814_cov_32.216783	317	397	2	20	80	0.2500000
NODE_11555_length_814_cov_32.216783	370	450	0	80	80	1.0000000
NODE_11556_length_814_cov_19.507692	174	254	0	25	80	0.3125000
NODE_11556_length_814_cov_19.507692	174	254	2	55	80	0.6875000
NODE_11556_length_814_cov_19.507692	227	307	0	78	80	0.9750000
NODE_11556_length_814_cov_19.507692	227	307	2	2	80	0.0250000
NODE_11556_length_814_cov_19.507692	303	383	0	80	80	1.0000000
NODE_11556_length_814_cov_19.507692	356	436	0	80	80	1.0000000
NODE_11557_length_814_cov_18.579021	433	513	4	61	80	0.7625000
NODE_11557_length_814_cov_18.579021	433	513	6	19	80	0.2375000
NODE_11557_length_814_cov_18.579021	486	566	4	14	80	0.1750000
NODE_11557_length_814_cov_18.579021	486	566	6	66	80	0.8250000
NODE_11558_length_814_cov_17.183217	339	419	0	13	80	0.1625000
NODE_11558_length_814_cov_17.183217	339	419	2	67	80	0.8375000
NODE_11558_length_814_cov_17.183217	392	472	0	1	80	0.0125000
NODE_11558_length_814_cov_17.183217	392	472	2	79	80	0.9875000
NODE_11559_length_814_cov_15.306294	238	318	0	80	80	1.0000000
NODE_11559_length_814_cov_15.306294	291	371	0	80	80	1.0000000
NODE_11560_length_814_cov_11.511888	397	477	2	80	80	1.0000000
NODE_11560_length_814_cov_11.511888	459	530	0	52	71	0.7323943
NODE_11560_length_814_cov_11.511888	459	530	2	19	71	0.2676056
NODE_11561_length_814_cov_10.395804	305	385	0	80	80	1.0000000
NODE_11561_length_814_cov_10.395804	358	438	0	80	80	1.0000000
NODE_11562_length_814_cov_9.692308	347	427	6	22	80	0.2750000
NODE_11562_length_814_cov_9.692308	347	427	8	5	80	0.0625000
NODE_11562_length_814_cov_9.692308	347	427	10	19	80	0.2375000
NODE_11562_length_814_cov_9.692308	347	427	12	34	80	0.4250000
NODE_11562_length_814_cov_9.692308	400	480	0	36	80	0.4500000
NODE_11562_length_814_cov_9.692308	400	480	2	8	80	0.1000000
NODE_11562_length_814_cov_9.692308	400	480	6	31	80	0.3875000
NODE_11562_length_814_cov_9.692308	400	480	8	5	80	0.0625000
NODE_11564_length_814_cov_9.274126	245	325	0	68	80	0.8500000
NODE_11564_length_814_cov_9.274126	245	325	4	12	80	0.1500000
NODE_11564_length_814_cov_9.274126	298	378	0	15	80	0.1875000
NODE_11564_length_814_cov_9.274126	298	378	4	65	80	0.8125000
NODE_11565_length_814_cov_8.973427	271	351	0	80	80	1.0000000
NODE_11565_length_814_cov_8.973427	324	404	0	80	80	1.0000000
NODE_11573_length_814_cov_2.145455	273	327	0	54	54	1.0000000
NODE_11573_length_814_cov_2.145455	307	371	0	64	64	1.0000000
NODE_11587_length_813_cov_39.228291	225	305	0	39	80	0.4875000
NODE_11587_length_813_cov_39.228291	225	305	2	41	80	0.5125000
NODE_11587_length_813_cov_39.228291	278	358	0	7	80	0.0875000
NODE_11587_length_813_cov_39.228291	278	358	2	73	80	0.9125000
NODE_11588_length_813_cov_36.570028	406	486	0	13	80	0.1625000
NODE_11588_length_813_cov_36.570028	406	486	4	67	80	0.8375000
NODE_11588_length_813_cov_36.570028	459	539	0	66	80	0.8250000
NODE_11588_length_813_cov_36.570028	459	539	4	14	80	0.1750000
NODE_11589_length_813_cov_26.718487	209	289	0	26	80	0.3250000
NODE_11589_length_813_cov_26.718487	209	289	2	8	80	0.1000000
NODE_11589_length_813_cov_26.718487	209	289	6	46	80	0.5750000
NODE_11589_length_813_cov_26.718487	262	342	0	12	80	0.1500000
NODE_11589_length_813_cov_26.718487	262	342	4	32	80	0.4000000
NODE_11589_length_813_cov_26.718487	262	342	6	36	80	0.4500000
NODE_11590_length_813_cov_17.537815	335	415	0	80	80	1.0000000
NODE_11590_length_813_cov_17.537815	388	468	0	80	80	1.0000000
NODE_11591_length_813_cov_14.243697	279	359	0	35	80	0.4375000
NODE_11591_length_813_cov_14.243697	279	359	1	1	80	0.0125000
NODE_11591_length_813_cov_14.243697	279	359	8	2	80	0.0250000
NODE_11591_length_813_cov_14.243697	279	359	9	39	80	0.4875000
NODE_11591_length_813_cov_14.243697	279	359	10	3	80	0.0375000
NODE_11591_length_813_cov_14.243697	332	412	9	24	80	0.3000000
NODE_11591_length_813_cov_14.243697	332	412	10	56	80	0.7000000
NODE_11592_length_813_cov_13.984594	307	387	0	26	80	0.3250000
NODE_11592_length_813_cov_13.984594	307	387	2	5	80	0.0625000
NODE_11592_length_813_cov_13.984594	307	387	4	4	80	0.0500000
NODE_11592_length_813_cov_13.984594	307	387	8	45	80	0.5625000
NODE_11592_length_813_cov_13.984594	360	440	8	78	80	0.9750000
NODE_11592_length_813_cov_13.984594	360	440	10	2	80	0.0250000
NODE_11593_length_813_cov_13.242297	336	416	0	3	80	0.0375000
NODE_11593_length_813_cov_13.242297	336	416	2	69	80	0.8625000
NODE_11593_length_813_cov_13.242297	336	416	3	8	80	0.1000000
NODE_11593_length_813_cov_13.242297	389	469	2	19	80	0.2375000
NODE_11593_length_813_cov_13.242297	389	469	3	34	80	0.4250000
NODE_11593_length_813_cov_13.242297	389	469	4	25	80	0.3125000
NODE_11593_length_813_cov_13.242297	389	469	6	2	80	0.0250000
NODE_11594_length_813_cov_11.985994	374	454	0	20	80	0.2500000
NODE_11594_length_813_cov_11.985994	374	454	2	60	80	0.7500000
NODE_11594_length_813_cov_11.985994	427	507	0	9	80	0.1125000
NODE_11594_length_813_cov_11.985994	427	507	2	71	80	0.8875000
NODE_11595_length_813_cov_11.668067	279	359	0	80	80	1.0000000
NODE_11595_length_813_cov_11.668067	332	412	0	80	80	1.0000000
NODE_11596_length_813_cov_8.149860	538	618	0	80	80	1.0000000
NODE_11596_length_813_cov_8.149860	591	671	0	80	80	1.0000000
NODE_11597_length_813_cov_7.098039	234	314	2	33	80	0.4125000
NODE_11597_length_813_cov_7.098039	234	314	4	47	80	0.5875000
NODE_11597_length_813_cov_7.098039	287	367	2	34	80	0.4250000
NODE_11597_length_813_cov_7.098039	287	367	4	46	80	0.5750000
NODE_11613_length_812_cov_45.183731	435	515	2	2	80	0.0250000
NODE_11613_length_812_cov_45.183731	435	515	4	17	80	0.2125000
NODE_11613_length_812_cov_45.183731	435	515	6	61	80	0.7625000
NODE_11613_length_812_cov_45.183731	488	568	0	11	80	0.1375000
NODE_11613_length_812_cov_45.183731	488	568	1	8	80	0.1000000
NODE_11613_length_812_cov_45.183731	488	568	2	20	80	0.2500000
NODE_11613_length_812_cov_45.183731	488	568	4	1	80	0.0125000
NODE_11613_length_812_cov_45.183731	488	568	6	40	80	0.5000000
NODE_11614_length_812_cov_23.862553	386	466	0	77	80	0.9625000
NODE_11614_length_812_cov_23.862553	386	466	2	3	80	0.0375000
NODE_11614_length_812_cov_23.862553	439	519	0	74	80	0.9250000
NODE_11614_length_812_cov_23.862553	439	519	2	6	80	0.0750000
NODE_11615_length_812_cov_23.516129	295	375	0	80	80	1.0000000
NODE_11615_length_812_cov_23.516129	348	428	0	80	80	1.0000000
NODE_11616_length_812_cov_15.577840	509	589	0	80	80	1.0000000
NODE_11616_length_812_cov_15.577840	562	644	0	82	82	1.0000000
NODE_11617_length_812_cov_13.277700	257	331	0	30	74	0.4054054
NODE_11617_length_812_cov_13.277700	257	331	4	27	74	0.3648649
NODE_11617_length_812_cov_13.277700	257	331	6	9	74	0.1216216
NODE_11617_length_812_cov_13.277700	257	331	8	7	74	0.0945946
NODE_11617_length_812_cov_13.277700	257	331	10	1	74	0.0135135
NODE_11617_length_812_cov_13.277700	304	384	4	10	80	0.1250000
NODE_11617_length_812_cov_13.277700	304	384	6	9	80	0.1125000
NODE_11617_length_812_cov_13.277700	304	384	8	7	80	0.0875000
NODE_11617_length_812_cov_13.277700	304	384	10	24	80	0.3000000
NODE_11617_length_812_cov_13.277700	304	384	12	30	80	0.3750000
NODE_11619_length_812_cov_6.697055	309	389	0	39	80	0.4875000
NODE_11619_length_812_cov_6.697055	309	389	2	41	80	0.5125000
NODE_11619_length_812_cov_6.697055	362	442	0	3	80	0.0375000
NODE_11619_length_812_cov_6.697055	362	442	2	77	80	0.9625000
NODE_11642_length_811_cov_65.762640	418	492	10	6	74	0.0810811
NODE_11642_length_811_cov_65.762640	418	492	12	5	74	0.0675676
NODE_11642_length_811_cov_65.762640	418	492	13	3	74	0.0405405
NODE_11642_length_811_cov_65.762640	418	492	14	19	74	0.2567568
NODE_11642_length_811_cov_65.762640	418	492	16	7	74	0.0945946
NODE_11642_length_811_cov_65.762640	418	492	18	33	74	0.4459459
NODE_11642_length_811_cov_65.762640	418	492	20	1	74	0.0135135
NODE_11642_length_811_cov_65.762640	471	545	2	9	74	0.1216216
NODE_11642_length_811_cov_65.762640	471	545	4	39	74	0.5270270
NODE_11642_length_811_cov_65.762640	471	545	6	1	74	0.0135135
NODE_11642_length_811_cov_65.762640	471	545	7	2	74	0.0270270
NODE_11642_length_811_cov_65.762640	471	545	10	8	74	0.1081081
NODE_11642_length_811_cov_65.762640	471	545	12	5	74	0.0675676
NODE_11642_length_811_cov_65.762640	471	545	13	3	74	0.0405405
NODE_11642_length_811_cov_65.762640	471	545	14	1	74	0.0135135
NODE_11642_length_811_cov_65.762640	471	545	16	4	74	0.0540541
NODE_11642_length_811_cov_65.762640	471	545	18	2	74	0.0270270
NODE_11643_length_811_cov_62.933989	457	537	0	80	80	1.0000000
NODE_11643_length_811_cov_62.933989	510	590	0	80	80	1.0000000
NODE_11644_length_811_cov_26.401685	397	477	4	76	80	0.9500000
NODE_11644_length_811_cov_26.401685	397	477	6	4	80	0.0500000
NODE_11644_length_811_cov_26.401685	450	530	2	11	80	0.1375000
NODE_11644_length_811_cov_26.401685	450	530	4	23	80	0.2875000
NODE_11644_length_811_cov_26.401685	450	530	6	46	80	0.5750000
NODE_11645_length_811_cov_23.009831	189	269	0	8	80	0.1000000
NODE_11645_length_811_cov_23.009831	189	269	2	72	80	0.9000000
NODE_11645_length_811_cov_23.009831	242	322	2	80	80	1.0000000
NODE_11646_length_811_cov_20.523876	375	455	0	31	80	0.3875000
NODE_11646_length_811_cov_20.523876	375	455	2	26	80	0.3250000
NODE_11646_length_811_cov_20.523876	375	455	4	23	80	0.2875000
NODE_11646_length_811_cov_20.523876	428	508	0	80	80	1.0000000
NODE_11647_length_811_cov_17.386236	421	501	0	41	80	0.5125000
NODE_11647_length_811_cov_17.386236	421	501	2	39	80	0.4875000
NODE_11647_length_811_cov_17.386236	474	554	0	2	80	0.0250000
NODE_11647_length_811_cov_17.386236	474	554	2	78	80	0.9750000
NODE_11648_length_811_cov_15.279494	368	448	0	21	80	0.2625000
NODE_11648_length_811_cov_15.279494	368	448	2	4	80	0.0500000
NODE_11648_length_811_cov_15.279494	368	448	4	36	80	0.4500000
NODE_11648_length_811_cov_15.279494	368	448	6	19	80	0.2375000
NODE_11648_length_811_cov_15.279494	421	502	4	36	81	0.4444444
NODE_11648_length_811_cov_15.279494	421	502	6	45	81	0.5555556
NODE_11649_length_811_cov_14.543539	222	302	6	27	80	0.3375000
NODE_11649_length_811_cov_14.543539	222	302	8	53	80	0.6625000
NODE_11649_length_811_cov_14.543539	275	355	0	50	80	0.6250000
NODE_11649_length_811_cov_14.543539	275	355	6	30	80	0.3750000
NODE_11650_length_811_cov_12.196629	402	482	0	80	80	1.0000000
NODE_11650_length_811_cov_12.196629	455	535	0	80	80	1.0000000
NODE_11651_length_811_cov_12.117978	289	369	0	36	80	0.4500000
NODE_11651_length_811_cov_12.117978	289	369	2	44	80	0.5500000
NODE_11651_length_811_cov_12.117978	342	422	0	22	80	0.2750000
NODE_11651_length_811_cov_12.117978	342	422	2	58	80	0.7250000
NODE_11652_length_811_cov_11.886236	330	410	0	80	80	1.0000000
NODE_11652_length_811_cov_11.886236	383	463	0	41	80	0.5125000
NODE_11652_length_811_cov_11.886236	383	463	2	39	80	0.4875000
NODE_11653_length_811_cov_10.602528	342	422	0	5	80	0.0625000
NODE_11653_length_811_cov_10.602528	342	422	6	75	80	0.9375000
NODE_11653_length_811_cov_10.602528	395	461	0	18	66	0.2727273
NODE_11653_length_811_cov_10.602528	395	461	5	1	66	0.0151515
NODE_11653_length_811_cov_10.602528	395	461	6	47	66	0.7121212
NODE_11653_length_811_cov_10.602528	452	519	0	67	67	1.0000000
NODE_11653_length_811_cov_10.602528	492	572	0	80	80	1.0000000
NODE_11654_length_811_cov_7.539326	324	404	0	80	80	1.0000000
NODE_11654_length_811_cov_7.539326	377	457	0	80	80	1.0000000
NODE_11655_length_811_cov_6.398876	419	499	0	35	80	0.4375000
NODE_11655_length_811_cov_6.398876	419	499	2	45	80	0.5625000
NODE_11655_length_811_cov_6.398876	472	552	0	80	80	1.0000000
NODE_11657_length_811_cov_5.939607	496	527	2	31	31	1.0000000
NODE_11657_length_811_cov_5.939607	528	603	2	32	75	0.4266667
NODE_11657_length_811_cov_5.939607	528	603	3	4	75	0.0533333
NODE_11657_length_811_cov_5.939607	528	603	4	39	75	0.5200000
NODE_11669_length_811_cov_1.501404	645	676	2	31	31	1.0000000
NODE_11684_length_810_cov_42.358650	484	564	4	2	80	0.0250000
NODE_11684_length_810_cov_42.358650	484	564	6	5	80	0.0625000
NODE_11684_length_810_cov_42.358650	484	564	8	21	80	0.2625000
NODE_11684_length_810_cov_42.358650	484	564	9	25	80	0.3125000
NODE_11684_length_810_cov_42.358650	484	564	10	27	80	0.3375000
NODE_11684_length_810_cov_42.358650	537	617	2	43	80	0.5375000
NODE_11684_length_810_cov_42.358650	537	617	4	12	80	0.1500000
NODE_11684_length_810_cov_42.358650	537	617	6	5	80	0.0625000
NODE_11684_length_810_cov_42.358650	537	617	8	15	80	0.1875000
NODE_11684_length_810_cov_42.358650	537	617	10	5	80	0.0625000
NODE_11685_length_810_cov_38.604782	370	450	0	75	80	0.9375000
NODE_11685_length_810_cov_38.604782	370	450	2	5	80	0.0625000
NODE_11685_length_810_cov_38.604782	423	499	0	76	76	1.0000000
NODE_11686_length_810_cov_20.354430	338	418	4	2	80	0.0250000
NODE_11686_length_810_cov_20.354430	338	418	6	49	80	0.6125000
NODE_11686_length_810_cov_20.354430	338	418	8	22	80	0.2750000
NODE_11686_length_810_cov_20.354430	338	418	9	1	80	0.0125000
NODE_11686_length_810_cov_20.354430	338	418	10	6	80	0.0750000
NODE_11686_length_810_cov_20.354430	391	471	4	23	80	0.2875000
NODE_11686_length_810_cov_20.354430	391	471	6	14	80	0.1750000
NODE_11686_length_810_cov_20.354430	391	471	7	1	80	0.0125000
NODE_11686_length_810_cov_20.354430	391	471	8	35	80	0.4375000
NODE_11686_length_810_cov_20.354430	391	471	9	1	80	0.0125000
NODE_11686_length_810_cov_20.354430	391	471	10	6	80	0.0750000
NODE_11688_length_810_cov_12.367089	144	224	0	30	80	0.3750000
NODE_11688_length_810_cov_12.367089	144	224	2	22	80	0.2750000
NODE_11688_length_810_cov_12.367089	144	224	4	28	80	0.3500000
NODE_11688_length_810_cov_12.367089	197	277	4	80	80	1.0000000
NODE_11689_length_810_cov_8.886076	333	399	0	34	66	0.5151515
NODE_11689_length_810_cov_8.886076	333	399	3	1	66	0.0151515
NODE_11689_length_810_cov_8.886076	333	399	4	31	66	0.4696970
NODE_11690_length_810_cov_8.291139	446	526	0	80	80	1.0000000
NODE_11690_length_810_cov_8.291139	499	579	0	80	80	1.0000000
NODE_11692_length_810_cov_7.213783	335	406	0	57	71	0.8028169
NODE_11692_length_810_cov_7.213783	335	406	2	14	71	0.1971831
NODE_11692_length_810_cov_7.213783	335	416	0	57	81	0.7037037
NODE_11692_length_810_cov_7.213783	335	416	2	23	81	0.2839506
NODE_11692_length_810_cov_7.213783	335	416	4	1	81	0.0123457
NODE_11692_length_810_cov_7.213783	379	459	0	13	80	0.1625000
NODE_11692_length_810_cov_7.213783	379	459	2	23	80	0.2875000
NODE_11692_length_810_cov_7.213783	379	459	4	44	80	0.5500000
NODE_11714_length_809_cov_40.536620	428	500	0	49	72	0.6805556
NODE_11714_length_809_cov_40.536620	428	500	1	16	72	0.2222222
NODE_11714_length_809_cov_40.536620	428	500	2	7	72	0.0972222
NODE_11714_length_809_cov_40.536620	473	553	0	4	80	0.0500000
NODE_11714_length_809_cov_40.536620	473	553	1	16	80	0.2000000
NODE_11714_length_809_cov_40.536620	473	553	2	60	80	0.7500000
NODE_11715_length_809_cov_15.871831	385	465	0	80	80	1.0000000
NODE_11715_length_809_cov_15.871831	402	465	0	63	63	1.0000000
NODE_11715_length_809_cov_15.871831	438	518	0	80	80	1.0000000
NODE_11715_length_809_cov_15.871831	438	518	0	80	80	1.0000000
NODE_11716_length_809_cov_15.019718	286	366	0	80	80	1.0000000
NODE_11716_length_809_cov_15.019718	339	419	0	80	80	1.0000000
NODE_11718_length_809_cov_4.483099	244	324	0	4	80	0.0500000
NODE_11718_length_809_cov_4.483099	244	324	2	42	80	0.5250000
NODE_11718_length_809_cov_4.483099	244	324	4	34	80	0.4250000
NODE_11718_length_809_cov_4.483099	278	324	2	12	46	0.2608696
NODE_11718_length_809_cov_4.483099	278	324	4	34	46	0.7391304
NODE_11718_length_809_cov_4.483099	298	377	2	10	79	0.1265823
NODE_11718_length_809_cov_4.483099	298	377	4	68	79	0.8607595
NODE_11718_length_809_cov_4.483099	298	377	6	1	79	0.0126582
NODE_11718_length_809_cov_4.483099	308	377	2	10	69	0.1449275
NODE_11718_length_809_cov_4.483099	308	377	4	58	69	0.8405797
NODE_11718_length_809_cov_4.483099	308	377	6	1	69	0.0144928
NODE_11738_length_808_cov_45.023977	325	405	0	44	80	0.5500000
NODE_11738_length_808_cov_45.023977	325	405	2	2	80	0.0250000
NODE_11738_length_808_cov_45.023977	325	405	4	3	80	0.0375000
NODE_11738_length_808_cov_45.023977	325	405	7	5	80	0.0625000
NODE_11738_length_808_cov_45.023977	325	405	9	26	80	0.3250000
NODE_11738_length_808_cov_45.023977	378	458	7	1	80	0.0125000
NODE_11738_length_808_cov_45.023977	378	458	9	44	80	0.5500000
NODE_11738_length_808_cov_45.023977	378	458	10	23	80	0.2875000
NODE_11738_length_808_cov_45.023977	378	458	11	12	80	0.1500000
NODE_11739_length_808_cov_24.087447	287	367	0	80	80	1.0000000
NODE_11739_length_808_cov_24.087447	340	420	0	80	80	1.0000000
NODE_11740_length_808_cov_21.867419	324	404	0	80	80	1.0000000
NODE_11740_length_808_cov_21.867419	377	457	0	80	80	1.0000000
NODE_11741_length_808_cov_16.289140	333	413	0	6	80	0.0750000
NODE_11741_length_808_cov_16.289140	333	413	2	26	80	0.3250000
NODE_11741_length_808_cov_16.289140	333	413	6	48	80	0.6000000
NODE_11741_length_808_cov_16.289140	386	466	4	48	80	0.6000000
NODE_11741_length_808_cov_16.289140	386	466	6	32	80	0.4000000
NODE_11742_length_808_cov_14.489422	307	387	2	5	80	0.0625000
NODE_11742_length_808_cov_14.489422	307	387	3	58	80	0.7250000
NODE_11742_length_808_cov_14.489422	307	387	4	17	80	0.2125000
NODE_11742_length_808_cov_14.489422	360	440	2	8	80	0.1000000
NODE_11742_length_808_cov_14.489422	360	440	3	35	80	0.4375000
NODE_11742_length_808_cov_14.489422	360	440	4	37	80	0.4625000
NODE_11744_length_808_cov_10.507757	317	397	0	80	80	1.0000000
NODE_11744_length_808_cov_10.507757	370	450	0	80	80	1.0000000
NODE_11745_length_808_cov_10.066291	483	563	0	35	80	0.4375000
NODE_11745_length_808_cov_10.066291	483	563	2	45	80	0.5625000
NODE_11745_length_808_cov_10.066291	536	616	0	33	80	0.4125000
NODE_11745_length_808_cov_10.066291	536	616	2	47	80	0.5875000
NODE_11746_length_808_cov_7.581100	358	438	0	80	80	1.0000000
NODE_11746_length_808_cov_7.581100	411	491	0	80	80	1.0000000
NODE_11756_length_808_cov_3.283498	471	551	0	40	80	0.5000000
NODE_11756_length_808_cov_3.283498	471	551	2	11	80	0.1375000
NODE_11756_length_808_cov_3.283498	471	551	4	29	80	0.3625000
NODE_11756_length_808_cov_3.283498	524	604	4	80	80	1.0000000
NODE_11783_length_807_cov_67.341808	2	25	15	1	23	0.0434783
NODE_11783_length_807_cov_67.341808	2	25	22	1	23	0.0434783
NODE_11783_length_807_cov_67.341808	2	25	25	1	23	0.0434783
NODE_11783_length_807_cov_67.341808	2	25	28	2	23	0.0869565
NODE_11783_length_807_cov_67.341808	2	25	31	2	23	0.0869565
NODE_11783_length_807_cov_67.341808	2	25	35	1	23	0.0434783
NODE_11783_length_807_cov_67.341808	2	25	43	1	23	0.0434783
NODE_11783_length_807_cov_67.341808	2	25	55	1	23	0.0434783
NODE_11783_length_807_cov_67.341808	2	25	59	2	23	0.0869565
NODE_11783_length_807_cov_67.341808	2	25	64	1	23	0.0434783
NODE_11783_length_807_cov_67.341808	2	25	68	1	23	0.0434783
NODE_11783_length_807_cov_67.341808	2	25	74	1	23	0.0434783
NODE_11783_length_807_cov_67.341808	2	25	77	1	23	0.0434783
NODE_11783_length_807_cov_67.341808	2	25	81	1	23	0.0434783
NODE_11783_length_807_cov_67.341808	2	25	83	1	23	0.0434783
NODE_11783_length_807_cov_67.341808	2	25	94	1	23	0.0434783
NODE_11783_length_807_cov_67.341808	2	25	104	1	23	0.0434783
NODE_11783_length_807_cov_67.341808	2	25	105	1	23	0.0434783
NODE_11783_length_807_cov_67.341808	2	25	111	1	23	0.0434783
NODE_11783_length_807_cov_67.341808	2	25	114	1	23	0.0434783
NODE_11783_length_807_cov_67.341808	339	370	181	1	31	0.0322581
NODE_11783_length_807_cov_67.341808	339	370	202	1	31	0.0322581
NODE_11783_length_807_cov_67.341808	339	370	209	1	31	0.0322581
NODE_11783_length_807_cov_67.341808	339	370	218	1	31	0.0322581
NODE_11783_length_807_cov_67.341808	339	370	223	3	31	0.0967742
NODE_11783_length_807_cov_67.341808	339	370	237	1	31	0.0322581
NODE_11783_length_807_cov_67.341808	339	370	242	1	31	0.0322581
NODE_11783_length_807_cov_67.341808	339	370	252	1	31	0.0322581
NODE_11783_length_807_cov_67.341808	339	370	259	1	31	0.0322581
NODE_11783_length_807_cov_67.341808	339	370	261	1	31	0.0322581
NODE_11783_length_807_cov_67.341808	339	370	262	1	31	0.0322581
NODE_11783_length_807_cov_67.341808	339	370	268	1	31	0.0322581
NODE_11783_length_807_cov_67.341808	339	370	270	1	31	0.0322581
NODE_11783_length_807_cov_67.341808	339	370	271	1	31	0.0322581
NODE_11783_length_807_cov_67.341808	339	370	277	1	31	0.0322581
NODE_11783_length_807_cov_67.341808	339	370	287	2	31	0.0645161
NODE_11783_length_807_cov_67.341808	339	370	289	1	31	0.0322581
NODE_11783_length_807_cov_67.341808	339	370	291	2	31	0.0645161
NODE_11783_length_807_cov_67.341808	339	370	292	3	31	0.0967742
NODE_11783_length_807_cov_67.341808	339	370	294	1	31	0.0322581
NODE_11783_length_807_cov_67.341808	339	370	295	1	31	0.0322581
NODE_11783_length_807_cov_67.341808	339	370	296	1	31	0.0322581
NODE_11783_length_807_cov_67.341808	339	370	297	1	31	0.0322581
NODE_11783_length_807_cov_67.341808	339	370	300	1	31	0.0322581
NODE_11783_length_807_cov_67.341808	339	370	301	1	31	0.0322581
NODE_11783_length_807_cov_67.341808	343	423	223	3	80	0.0375000
NODE_11783_length_807_cov_67.341808	343	423	237	1	80	0.0125000
NODE_11783_length_807_cov_67.341808	343	423	242	1	80	0.0125000
NODE_11783_length_807_cov_67.341808	343	423	252	1	80	0.0125000
NODE_11783_length_807_cov_67.341808	343	423	259	1	80	0.0125000
NODE_11783_length_807_cov_67.341808	343	423	261	1	80	0.0125000
NODE_11783_length_807_cov_67.341808	343	423	262	1	80	0.0125000
NODE_11783_length_807_cov_67.341808	343	423	268	1	80	0.0125000
NODE_11783_length_807_cov_67.341808	343	423	270	1	80	0.0125000
NODE_11783_length_807_cov_67.341808	343	423	271	1	80	0.0125000
NODE_11783_length_807_cov_67.341808	343	423	277	1	80	0.0125000
NODE_11783_length_807_cov_67.341808	343	423	287	2	80	0.0250000
NODE_11783_length_807_cov_67.341808	343	423	289	1	80	0.0125000
NODE_11783_length_807_cov_67.341808	343	423	291	2	80	0.0250000
NODE_11783_length_807_cov_67.341808	343	423	292	3	80	0.0375000
NODE_11783_length_807_cov_67.341808	343	423	294	1	80	0.0125000
NODE_11783_length_807_cov_67.341808	343	423	295	1	80	0.0125000
NODE_11783_length_807_cov_67.341808	343	423	296	1	80	0.0125000
NODE_11783_length_807_cov_67.341808	343	423	297	1	80	0.0125000
NODE_11783_length_807_cov_67.341808	343	423	300	1	80	0.0125000
NODE_11783_length_807_cov_67.341808	343	423	301	2	80	0.0250000
NODE_11783_length_807_cov_67.341808	343	423	302	3	80	0.0375000
NODE_11783_length_807_cov_67.341808	343	423	304	1	80	0.0125000
NODE_11783_length_807_cov_67.341808	343	423	305	1	80	0.0125000
NODE_11783_length_807_cov_67.341808	343	423	306	1	80	0.0125000
NODE_11783_length_807_cov_67.341808	343	423	312	4	80	0.0500000
NODE_11783_length_807_cov_67.341808	343	423	314	3	80	0.0375000
NODE_11783_length_807_cov_67.341808	343	423	316	3	80	0.0375000
NODE_11783_length_807_cov_67.341808	343	423	319	2	80	0.0250000
NODE_11783_length_807_cov_67.341808	343	423	320	1	80	0.0125000
NODE_11783_length_807_cov_67.341808	343	423	321	4	80	0.0500000
NODE_11783_length_807_cov_67.341808	343	423	328	1	80	0.0125000
NODE_11783_length_807_cov_67.341808	343	423	335	2	80	0.0250000
NODE_11783_length_807_cov_67.341808	343	423	337	1	80	0.0125000
NODE_11783_length_807_cov_67.341808	343	423	342	1	80	0.0125000
NODE_11783_length_807_cov_67.341808	343	423	347	1	80	0.0125000
NODE_11783_length_807_cov_67.341808	343	423	353	1	80	0.0125000
NODE_11783_length_807_cov_67.341808	343	423	358	1	80	0.0125000
NODE_11783_length_807_cov_67.341808	343	423	360	5	80	0.0625000
NODE_11783_length_807_cov_67.341808	343	423	362	1	80	0.0125000
NODE_11783_length_807_cov_67.341808	343	423	364	2	80	0.0250000
NODE_11783_length_807_cov_67.341808	343	423	368	1	80	0.0125000
NODE_11783_length_807_cov_67.341808	343	423	372	1	80	0.0125000
NODE_11783_length_807_cov_67.341808	343	423	374	1	80	0.0125000
NODE_11783_length_807_cov_67.341808	343	423	384	1	80	0.0125000
NODE_11783_length_807_cov_67.341808	343	423	386	1	80	0.0125000
NODE_11783_length_807_cov_67.341808	343	423	388	2	80	0.0250000
NODE_11783_length_807_cov_67.341808	343	423	390	1	80	0.0125000
NODE_11783_length_807_cov_67.341808	343	423	391	1	80	0.0125000
NODE_11783_length_807_cov_67.341808	343	423	393	1	80	0.0125000
NODE_11783_length_807_cov_67.341808	343	423	395	1	80	0.0125000
NODE_11783_length_807_cov_67.341808	343	423	399	1	80	0.0125000
NODE_11783_length_807_cov_67.341808	343	423	403	1	80	0.0125000
NODE_11784_length_807_cov_54.980226	683	749	106	1	66	0.0151515
NODE_11784_length_807_cov_54.980226	683	749	110	2	66	0.0303030
NODE_11784_length_807_cov_54.980226	683	749	114	3	66	0.0454545
NODE_11784_length_807_cov_54.980226	683	749	116	3	66	0.0454545
NODE_11784_length_807_cov_54.980226	683	749	118	1	66	0.0151515
NODE_11784_length_807_cov_54.980226	683	749	120	4	66	0.0606061
NODE_11784_length_807_cov_54.980226	683	749	122	1	66	0.0151515
NODE_11784_length_807_cov_54.980226	683	749	130	4	66	0.0606061
NODE_11784_length_807_cov_54.980226	683	749	134	2	66	0.0303030
NODE_11784_length_807_cov_54.980226	683	749	136	2	66	0.0303030
NODE_11784_length_807_cov_54.980226	683	749	140	1	66	0.0151515
NODE_11784_length_807_cov_54.980226	683	749	142	2	66	0.0303030
NODE_11784_length_807_cov_54.980226	683	749	144	1	66	0.0151515
NODE_11784_length_807_cov_54.980226	683	749	150	1	66	0.0151515
NODE_11784_length_807_cov_54.980226	683	749	152	1	66	0.0151515
NODE_11784_length_807_cov_54.980226	683	749	158	2	66	0.0303030
NODE_11784_length_807_cov_54.980226	683	749	162	2	66	0.0303030
NODE_11784_length_807_cov_54.980226	683	749	173	1	66	0.0151515
NODE_11784_length_807_cov_54.980226	683	749	178	2	66	0.0303030
NODE_11784_length_807_cov_54.980226	683	749	179	4	66	0.0606061
NODE_11784_length_807_cov_54.980226	683	749	182	5	66	0.0757576
NODE_11784_length_807_cov_54.980226	683	749	183	2	66	0.0303030
NODE_11784_length_807_cov_54.980226	683	749	184	3	66	0.0454545
NODE_11784_length_807_cov_54.980226	683	749	185	1	66	0.0151515
NODE_11784_length_807_cov_54.980226	683	749	186	4	66	0.0606061
NODE_11784_length_807_cov_54.980226	683	749	188	1	66	0.0151515
NODE_11784_length_807_cov_54.980226	683	749	189	1	66	0.0151515
NODE_11784_length_807_cov_54.980226	683	749	190	2	66	0.0303030
NODE_11784_length_807_cov_54.980226	683	749	191	1	66	0.0151515
NODE_11784_length_807_cov_54.980226	683	749	193	1	66	0.0151515
NODE_11784_length_807_cov_54.980226	683	749	201	4	66	0.0606061
NODE_11784_length_807_cov_54.980226	683	749	205	1	66	0.0151515
NODE_11784_length_807_cov_54.980226	727	802	12	1	75	0.0133333
NODE_11784_length_807_cov_54.980226	727	802	16	1	75	0.0133333
NODE_11784_length_807_cov_54.980226	727	802	18	1	75	0.0133333
NODE_11784_length_807_cov_54.980226	727	802	22	2	75	0.0266667
NODE_11784_length_807_cov_54.980226	727	802	25	1	75	0.0133333
NODE_11784_length_807_cov_54.980226	727	802	27	1	75	0.0133333
NODE_11784_length_807_cov_54.980226	727	802	29	1	75	0.0133333
NODE_11784_length_807_cov_54.980226	727	802	32	1	75	0.0133333
NODE_11784_length_807_cov_54.980226	727	802	34	4	75	0.0533333
NODE_11784_length_807_cov_54.980226	727	802	36	2	75	0.0266667
NODE_11784_length_807_cov_54.980226	727	802	38	1	75	0.0133333
NODE_11784_length_807_cov_54.980226	727	802	40	1	75	0.0133333
NODE_11784_length_807_cov_54.980226	727	802	47	1	75	0.0133333
NODE_11784_length_807_cov_54.980226	727	802	51	1	75	0.0133333
NODE_11784_length_807_cov_54.980226	727	802	53	1	75	0.0133333
NODE_11784_length_807_cov_54.980226	727	802	57	3	75	0.0400000
NODE_11784_length_807_cov_54.980226	727	802	59	1	75	0.0133333
NODE_11784_length_807_cov_54.980226	727	802	63	1	75	0.0133333
NODE_11784_length_807_cov_54.980226	727	802	66	2	75	0.0266667
NODE_11784_length_807_cov_54.980226	727	802	70	1	75	0.0133333
NODE_11784_length_807_cov_54.980226	727	802	72	6	75	0.0800000
NODE_11784_length_807_cov_54.980226	727	802	73	1	75	0.0133333
NODE_11784_length_807_cov_54.980226	727	802	75	2	75	0.0266667
NODE_11784_length_807_cov_54.980226	727	802	79	3	75	0.0400000
NODE_11784_length_807_cov_54.980226	727	802	80	1	75	0.0133333
NODE_11784_length_807_cov_54.980226	727	802	82	4	75	0.0533333
NODE_11784_length_807_cov_54.980226	727	802	84	1	75	0.0133333
NODE_11784_length_807_cov_54.980226	727	802	88	2	75	0.0266667
NODE_11784_length_807_cov_54.980226	727	802	94	2	75	0.0266667
NODE_11784_length_807_cov_54.980226	727	802	96	1	75	0.0133333
NODE_11784_length_807_cov_54.980226	727	802	98	1	75	0.0133333
NODE_11784_length_807_cov_54.980226	727	802	102	1	75	0.0133333
NODE_11784_length_807_cov_54.980226	727	802	106	1	75	0.0133333
NODE_11784_length_807_cov_54.980226	727	802	110	2	75	0.0266667
NODE_11784_length_807_cov_54.980226	727	802	114	3	75	0.0400000
NODE_11784_length_807_cov_54.980226	727	802	116	3	75	0.0400000
NODE_11784_length_807_cov_54.980226	727	802	118	1	75	0.0133333
NODE_11784_length_807_cov_54.980226	727	802	120	4	75	0.0533333
NODE_11784_length_807_cov_54.980226	727	802	122	1	75	0.0133333
NODE_11784_length_807_cov_54.980226	727	802	130	4	75	0.0533333
NODE_11784_length_807_cov_54.980226	727	802	134	2	75	0.0266667
NODE_11784_length_807_cov_54.980226	727	802	136	1	75	0.0133333
NODE_11785_length_807_cov_37.306497	435	515	0	80	80	1.0000000
NODE_11785_length_807_cov_37.306497	488	568	0	80	80	1.0000000
NODE_11786_length_807_cov_31.177966	287	367	0	8	80	0.1000000
NODE_11786_length_807_cov_31.177966	287	367	2	65	80	0.8125000
NODE_11786_length_807_cov_31.177966	287	367	4	5	80	0.0625000
NODE_11786_length_807_cov_31.177966	287	367	5	2	80	0.0250000
NODE_11786_length_807_cov_31.177966	340	420	2	20	80	0.2500000
NODE_11786_length_807_cov_31.177966	340	420	3	21	80	0.2625000
NODE_11786_length_807_cov_31.177966	340	420	4	5	80	0.0625000
NODE_11786_length_807_cov_31.177966	340	420	5	34	80	0.4250000
NODE_11787_length_807_cov_30.638418	250	329	0	79	79	1.0000000
NODE_11787_length_807_cov_30.638418	302	382	0	80	80	1.0000000
NODE_11787_length_807_cov_30.638418	378	458	0	80	80	1.0000000
NODE_11787_length_807_cov_30.638418	431	511	0	67	80	0.8375000
NODE_11787_length_807_cov_30.638418	431	511	2	13	80	0.1625000
NODE_11788_length_807_cov_29.725989	362	442	0	17	80	0.2125000
NODE_11788_length_807_cov_29.725989	362	442	4	63	80	0.7875000
NODE_11788_length_807_cov_29.725989	415	495	0	36	80	0.4500000
NODE_11788_length_807_cov_29.725989	415	495	4	44	80	0.5500000
NODE_11789_length_807_cov_23.200565	441	521	0	8	80	0.1000000
NODE_11789_length_807_cov_23.200565	441	521	2	8	80	0.1000000
NODE_11789_length_807_cov_23.200565	441	521	4	16	80	0.2000000
NODE_11789_length_807_cov_23.200565	441	521	10	48	80	0.6000000
NODE_11789_length_807_cov_23.200565	494	574	6	1	80	0.0125000
NODE_11789_length_807_cov_23.200565	494	574	8	42	80	0.5250000
NODE_11789_length_807_cov_23.200565	494	574	10	37	80	0.4625000
NODE_11790_length_807_cov_21.888418	319	386	0	67	67	1.0000000
NODE_11790_length_807_cov_21.888418	390	440	0	50	50	1.0000000
NODE_11791_length_807_cov_17.480226	339	419	1	57	80	0.7125000
NODE_11791_length_807_cov_17.480226	339	419	5	23	80	0.2875000
NODE_11791_length_807_cov_17.480226	392	472	1	4	80	0.0500000
NODE_11791_length_807_cov_17.480226	392	472	4	17	80	0.2125000
NODE_11791_length_807_cov_17.480226	392	472	5	59	80	0.7375000
NODE_11792_length_807_cov_14.895480	350	430	2	80	80	1.0000000
NODE_11792_length_807_cov_14.895480	403	483	0	30	80	0.3750000
NODE_11792_length_807_cov_14.895480	403	483	2	50	80	0.6250000
NODE_11794_length_807_cov_12.255650	440	520	2	5	80	0.0625000
NODE_11794_length_807_cov_12.255650	440	520	4	4	80	0.0500000
NODE_11794_length_807_cov_12.255650	440	520	6	71	80	0.8875000
NODE_11794_length_807_cov_12.255650	493	573	0	52	80	0.6500000
NODE_11794_length_807_cov_12.255650	493	573	2	6	80	0.0750000
NODE_11794_length_807_cov_12.255650	493	573	4	4	80	0.0500000
NODE_11794_length_807_cov_12.255650	493	573	6	18	80	0.2250000
NODE_11795_length_807_cov_11.129944	359	439	0	7	80	0.0875000
NODE_11795_length_807_cov_11.129944	359	439	2	73	80	0.9125000
NODE_11795_length_807_cov_11.129944	412	492	0	60	80	0.7500000
NODE_11795_length_807_cov_11.129944	412	492	2	20	80	0.2500000
NODE_11801_length_807_cov_3.847458	322	385	0	63	63	1.0000000
NODE_11822_length_806_cov_35.650636	397	477	2	74	80	0.9250000
NODE_11822_length_806_cov_35.650636	397	477	4	6	80	0.0750000
NODE_11822_length_806_cov_35.650636	450	530	0	45	80	0.5625000
NODE_11822_length_806_cov_35.650636	450	530	2	35	80	0.4375000
NODE_11822_length_806_cov_35.650636	526	606	0	4	80	0.0500000
NODE_11822_length_806_cov_35.650636	526	606	2	76	80	0.9500000
NODE_11822_length_806_cov_35.650636	579	667	0	22	88	0.2500000
NODE_11822_length_806_cov_35.650636	579	667	2	66	88	0.7500000
NODE_11823_length_806_cov_29.615276	377	457	8	4	80	0.0500000
NODE_11823_length_806_cov_29.615276	377	457	10	26	80	0.3250000
NODE_11823_length_806_cov_29.615276	377	457	12	35	80	0.4375000
NODE_11823_length_806_cov_29.615276	377	457	14	15	80	0.1875000
NODE_11823_length_806_cov_29.615276	430	510	0	12	80	0.1500000
NODE_11823_length_806_cov_29.615276	430	510	2	12	80	0.1500000
NODE_11823_length_806_cov_29.615276	430	510	6	20	80	0.2500000
NODE_11823_length_806_cov_29.615276	430	510	8	11	80	0.1375000
NODE_11823_length_806_cov_29.615276	430	510	10	25	80	0.3125000
NODE_11824_length_806_cov_23.680339	394	474	0	27	80	0.3375000
NODE_11824_length_806_cov_23.680339	394	474	2	11	80	0.1375000
NODE_11824_length_806_cov_23.680339	394	474	4	5	80	0.0625000
NODE_11824_length_806_cov_23.680339	394	474	5	1	80	0.0125000
NODE_11824_length_806_cov_23.680339	394	474	6	5	80	0.0625000
NODE_11824_length_806_cov_23.680339	394	474	8	31	80	0.3875000
NODE_11824_length_806_cov_23.680339	447	527	6	5	80	0.0625000
NODE_11824_length_806_cov_23.680339	447	527	8	75	80	0.9375000
NODE_11825_length_806_cov_19.107496	239	293	0	54	54	1.0000000
NODE_11825_length_806_cov_19.107496	248	293	0	45	45	1.0000000
NODE_11825_length_806_cov_19.107496	266	345	0	79	79	1.0000000
NODE_11825_length_806_cov_19.107496	266	345	0	79	79	1.0000000
NODE_11825_length_806_cov_19.107496	421	501	0	11	80	0.1375000
NODE_11825_length_806_cov_19.107496	421	501	2	69	80	0.8625000
NODE_11826_length_806_cov_17.551627	308	388	0	80	80	1.0000000
NODE_11826_length_806_cov_17.551627	361	441	0	80	80	1.0000000
NODE_11827_length_806_cov_15.608204	408	488	4	55	80	0.6875000
NODE_11827_length_806_cov_15.608204	408	488	8	25	80	0.3125000
NODE_11827_length_806_cov_15.608204	461	543	4	52	82	0.6341463
NODE_11827_length_806_cov_15.608204	461	543	6	18	82	0.2195122
NODE_11827_length_806_cov_15.608204	461	543	8	12	82	0.1463415
NODE_11864_length_805_cov_94.121813	398	478	0	80	80	1.0000000
NODE_11864_length_805_cov_94.121813	451	531	0	80	80	1.0000000
NODE_11865_length_805_cov_54.001416	284	364	0	2	80	0.0250000
NODE_11865_length_805_cov_54.001416	284	364	4	78	80	0.9750000
NODE_11865_length_805_cov_54.001416	337	417	0	52	80	0.6500000
NODE_11865_length_805_cov_54.001416	337	417	4	28	80	0.3500000
NODE_11865_length_805_cov_54.001416	413	493	0	26	80	0.3250000
NODE_11865_length_805_cov_54.001416	413	493	2	54	80	0.6750000
NODE_11865_length_805_cov_54.001416	466	546	0	23	80	0.2875000
NODE_11865_length_805_cov_54.001416	466	546	2	57	80	0.7125000
NODE_11866_length_805_cov_42.325779	377	457	1	27	80	0.3375000
NODE_11866_length_805_cov_42.325779	377	457	2	12	80	0.1500000
NODE_11866_length_805_cov_42.325779	377	457	3	41	80	0.5125000
NODE_11866_length_805_cov_42.325779	430	510	1	80	80	1.0000000
NODE_11867_length_805_cov_36.742210	345	425	2	19	80	0.2375000
NODE_11867_length_805_cov_36.742210	345	425	3	2	80	0.0250000
NODE_11867_length_805_cov_36.742210	345	425	5	5	80	0.0625000
NODE_11867_length_805_cov_36.742210	345	425	8	33	80	0.4125000
NODE_11867_length_805_cov_36.742210	345	425	9	6	80	0.0750000
NODE_11867_length_805_cov_36.742210	345	425	10	15	80	0.1875000
NODE_11867_length_805_cov_36.742210	398	478	0	6	80	0.0750000
NODE_11867_length_805_cov_36.742210	398	478	2	66	80	0.8250000
NODE_11867_length_805_cov_36.742210	398	478	3	2	80	0.0250000
NODE_11867_length_805_cov_36.742210	398	478	5	5	80	0.0625000
NODE_11867_length_805_cov_36.742210	398	478	9	1	80	0.0125000
NODE_11868_length_805_cov_25.879603	361	441	0	80	80	1.0000000
NODE_11868_length_805_cov_25.879603	414	494	0	80	80	1.0000000
NODE_11869_length_805_cov_25.048159	306	386	0	18	80	0.2250000
NODE_11869_length_805_cov_25.048159	306	386	2	62	80	0.7750000
NODE_11869_length_805_cov_25.048159	359	439	0	33	80	0.4125000
NODE_11869_length_805_cov_25.048159	359	439	2	47	80	0.5875000
NODE_11870_length_805_cov_15.453258	311	391	0	80	80	1.0000000
NODE_11870_length_805_cov_15.453258	364	444	0	80	80	1.0000000
NODE_11871_length_805_cov_14.930595	264	344	0	73	80	0.9125000
NODE_11871_length_805_cov_14.930595	264	344	2	7	80	0.0875000
NODE_11871_length_805_cov_14.930595	317	397	0	80	80	1.0000000
NODE_11872_length_805_cov_10.888102	259	339	0	32	80	0.4000000
NODE_11872_length_805_cov_10.888102	259	339	2	48	80	0.6000000
NODE_11872_length_805_cov_10.888102	312	392	0	80	80	1.0000000
NODE_11873_length_805_cov_10.716714	348	428	0	80	80	1.0000000
NODE_11873_length_805_cov_10.716714	401	481	0	80	80	1.0000000
NODE_11876_length_805_cov_7.212465	374	454	2	21	80	0.2625000
NODE_11876_length_805_cov_7.212465	374	454	4	59	80	0.7375000
NODE_11876_length_805_cov_7.212465	427	507	0	7	80	0.0875000
NODE_11876_length_805_cov_7.212465	427	507	2	67	80	0.8375000
NODE_11876_length_805_cov_7.212465	427	507	4	6	80	0.0750000
NODE_11877_length_805_cov_5.637394	323	403	0	80	80	1.0000000
NODE_11877_length_805_cov_5.637394	376	456	0	80	80	1.0000000
NODE_11878_length_805_cov_4.001416	304	384	0	80	80	1.0000000
NODE_11878_length_805_cov_4.001416	357	437	0	58	80	0.7250000
NODE_11878_length_805_cov_4.001416	357	437	2	22	80	0.2750000
NODE_11903_length_804_cov_26.204255	319	399	0	2	80	0.0250000
NODE_11903_length_804_cov_26.204255	319	399	2	78	80	0.9750000
NODE_11903_length_804_cov_26.204255	372	452	0	55	80	0.6875000
NODE_11903_length_804_cov_26.204255	372	452	2	25	80	0.3125000
NODE_11904_length_804_cov_25.978723	242	322	0	28	80	0.3500000
NODE_11904_length_804_cov_25.978723	242	322	2	52	80	0.6500000
NODE_11904_length_804_cov_25.978723	295	375	2	30	80	0.3750000
NODE_11904_length_804_cov_25.978723	295	375	4	50	80	0.6250000
NODE_11904_length_804_cov_25.978723	371	451	4	19	80	0.2375000
NODE_11904_length_804_cov_25.978723	371	451	6	44	80	0.5500000
NODE_11904_length_804_cov_25.978723	371	451	10	3	80	0.0375000
NODE_11904_length_804_cov_25.978723	371	451	12	9	80	0.1125000
NODE_11904_length_804_cov_25.978723	371	451	14	5	80	0.0625000
NODE_11904_length_804_cov_25.978723	424	504	4	5	80	0.0625000
NODE_11904_length_804_cov_25.978723	424	504	6	10	80	0.1250000
NODE_11904_length_804_cov_25.978723	424	504	8	2	80	0.0250000
NODE_11904_length_804_cov_25.978723	424	504	10	49	80	0.6125000
NODE_11904_length_804_cov_25.978723	424	504	12	9	80	0.1125000
NODE_11904_length_804_cov_25.978723	424	504	14	5	80	0.0625000
NODE_11905_length_804_cov_25.628369	444	524	0	25	80	0.3125000
NODE_11905_length_804_cov_25.628369	444	524	2	55	80	0.6875000
NODE_11905_length_804_cov_25.628369	497	577	2	80	80	1.0000000
NODE_11906_length_804_cov_22.438298	269	349	2	80	80	1.0000000
NODE_11906_length_804_cov_22.438298	322	402	2	80	80	1.0000000
NODE_11907_length_804_cov_17.425532	273	353	0	78	80	0.9750000
NODE_11907_length_804_cov_17.425532	273	353	2	2	80	0.0250000
NODE_11907_length_804_cov_17.425532	326	406	0	25	80	0.3125000
NODE_11907_length_804_cov_17.425532	326	406	2	55	80	0.6875000
NODE_11908_length_804_cov_16.849645	229	309	0	70	80	0.8750000
NODE_11908_length_804_cov_16.849645	229	309	4	10	80	0.1250000
NODE_11908_length_804_cov_16.849645	282	362	0	80	80	1.0000000
NODE_11909_length_804_cov_16.024113	499	579	0	11	80	0.1375000
NODE_11909_length_804_cov_16.024113	499	579	2	69	80	0.8625000
NODE_11909_length_804_cov_16.024113	552	632	0	64	80	0.8000000
NODE_11909_length_804_cov_16.024113	552	632	2	16	80	0.2000000
NODE_11910_length_804_cov_14.567376	375	455	4	10	80	0.1250000
NODE_11910_length_804_cov_14.567376	375	455	5	9	80	0.1125000
NODE_11910_length_804_cov_14.567376	375	455	6	9	80	0.1125000
NODE_11910_length_804_cov_14.567376	375	455	8	38	80	0.4750000
NODE_11910_length_804_cov_14.567376	375	455	10	14	80	0.1750000
NODE_11910_length_804_cov_14.567376	428	508	4	56	80	0.7000000
NODE_11910_length_804_cov_14.567376	428	508	5	9	80	0.1125000
NODE_11910_length_804_cov_14.567376	428	508	6	15	80	0.1875000
NODE_11911_length_804_cov_14.011348	262	342	0	28	80	0.3500000
NODE_11911_length_804_cov_14.011348	262	342	2	52	80	0.6500000
NODE_11911_length_804_cov_14.011348	315	395	0	49	80	0.6125000
NODE_11911_length_804_cov_14.011348	315	395	2	31	80	0.3875000
NODE_11912_length_804_cov_13.800000	289	318	0	29	29	1.0000000
NODE_11913_length_804_cov_12.585816	396	476	0	80	80	1.0000000
NODE_11913_length_804_cov_12.585816	449	529	0	80	80	1.0000000
NODE_11914_length_804_cov_12.375887	190	270	0	43	80	0.5375000
NODE_11914_length_804_cov_12.375887	190	270	4	37	80	0.4625000
NODE_11914_length_804_cov_12.375887	243	323	4	80	80	1.0000000
NODE_11915_length_804_cov_10.947518	363	443	0	80	80	1.0000000
NODE_11915_length_804_cov_10.947518	416	496	0	80	80	1.0000000
NODE_11916_length_804_cov_8.164539	427	507	0	80	80	1.0000000
NODE_11916_length_804_cov_8.164539	480	560	0	80	80	1.0000000
NODE_11917_length_804_cov_7.462411	345	425	0	80	80	1.0000000
NODE_11917_length_804_cov_7.462411	398	478	0	80	80	1.0000000
NODE_11919_length_804_cov_3.663830	736	799	0	63	63	1.0000000
NODE_11933_length_804_cov_1.303546	480	560	0	12	80	0.1500000
NODE_11933_length_804_cov_1.303546	480	560	2	6	80	0.0750000
NODE_11933_length_804_cov_1.303546	480	560	4	36	80	0.4500000
NODE_11933_length_804_cov_1.303546	480	560	6	26	80	0.3250000
NODE_11933_length_804_cov_1.303546	533	613	2	4	80	0.0500000
NODE_11933_length_804_cov_1.303546	533	613	4	26	80	0.3250000
NODE_11933_length_804_cov_1.303546	533	613	6	50	80	0.6250000
NODE_11942_length_803_cov_40.930398	374	454	0	80	80	1.0000000
NODE_11942_length_803_cov_40.930398	427	507	0	80	80	1.0000000
NODE_11944_length_803_cov_28.346591	242	322	2	33	80	0.4125000
NODE_11944_length_803_cov_28.346591	242	322	4	47	80	0.5875000
NODE_11944_length_803_cov_28.346591	295	375	2	53	80	0.6625000
NODE_11944_length_803_cov_28.346591	295	375	4	27	80	0.3375000
NODE_11945_length_803_cov_23.420455	288	368	0	80	80	1.0000000
NODE_11945_length_803_cov_23.420455	341	421	0	80	80	1.0000000
NODE_11946_length_803_cov_20.977273	316	396	0	80	80	1.0000000
NODE_11946_length_803_cov_20.977273	369	449	0	32	80	0.4000000
NODE_11946_length_803_cov_20.977273	369	449	2	12	80	0.1500000
NODE_11946_length_803_cov_20.977273	369	449	4	36	80	0.4500000
NODE_11947_length_803_cov_18.458807	307	387	2	24	80	0.3000000
NODE_11947_length_803_cov_18.458807	307	387	6	56	80	0.7000000
NODE_11947_length_803_cov_18.458807	360	440	0	18	80	0.2250000
NODE_11947_length_803_cov_18.458807	360	440	3	1	80	0.0125000
NODE_11947_length_803_cov_18.458807	360	440	4	30	80	0.3750000
NODE_11947_length_803_cov_18.458807	360	440	6	31	80	0.3875000
NODE_11948_length_803_cov_14.411932	386	466	0	14	80	0.1750000
NODE_11948_length_803_cov_14.411932	386	466	2	66	80	0.8250000
NODE_11948_length_803_cov_14.411932	439	519	0	21	80	0.2625000
NODE_11948_length_803_cov_14.411932	439	519	2	59	80	0.7375000
NODE_11949_length_803_cov_10.157670	319	399	2	7	80	0.0875000
NODE_11949_length_803_cov_10.157670	319	399	4	73	80	0.9125000
NODE_11949_length_803_cov_10.157670	372	452	0	45	80	0.5625000
NODE_11949_length_803_cov_10.157670	372	452	2	12	80	0.1500000
NODE_11949_length_803_cov_10.157670	372	452	4	23	80	0.2875000
NODE_11950_length_803_cov_8.977273	362	442	4	80	80	1.0000000
NODE_11950_length_803_cov_8.977273	415	485	0	10	70	0.1428571
NODE_11950_length_803_cov_8.977273	415	485	2	27	70	0.3857143
NODE_11950_length_803_cov_8.977273	415	485	3	2	70	0.0285714
NODE_11950_length_803_cov_8.977273	415	485	4	31	70	0.4428571
NODE_11951_length_803_cov_7.735795	195	275	2	10	80	0.1250000
NODE_11951_length_803_cov_7.735795	195	275	3	1	80	0.0125000
NODE_11951_length_803_cov_7.735795	195	275	4	46	80	0.5750000
NODE_11951_length_803_cov_7.735795	195	275	6	23	80	0.2875000
NODE_11951_length_803_cov_7.735795	248	328	2	55	80	0.6875000
NODE_11951_length_803_cov_7.735795	248	328	3	1	80	0.0125000
NODE_11951_length_803_cov_7.735795	248	328	4	24	80	0.3000000
NODE_11955_length_803_cov_4.613636	266	346	0	17	80	0.2125000
NODE_11955_length_803_cov_4.613636	266	346	2	33	80	0.4125000
NODE_11955_length_803_cov_4.613636	266	346	4	30	80	0.3750000
NODE_11955_length_803_cov_4.613636	319	399	2	3	80	0.0375000
NODE_11955_length_803_cov_4.613636	319	399	4	74	80	0.9250000
NODE_11955_length_803_cov_4.613636	319	399	6	3	80	0.0375000
NODE_11957_length_803_cov_4.220170	72	152	0	80	80	1.0000000
NODE_11957_length_803_cov_4.220170	130	207	0	77	77	1.0000000
NODE_11985_length_802_cov_42.294452	289	369	8	2	80	0.0250000
NODE_11985_length_802_cov_42.294452	289	369	13	12	80	0.1500000
NODE_11985_length_802_cov_42.294452	289	369	15	15	80	0.1875000
NODE_11985_length_802_cov_42.294452	289	369	16	12	80	0.1500000
NODE_11985_length_802_cov_42.294452	289	369	18	17	80	0.2125000
NODE_11985_length_802_cov_42.294452	289	369	20	15	80	0.1875000
NODE_11985_length_802_cov_42.294452	289	369	22	5	80	0.0625000
NODE_11985_length_802_cov_42.294452	289	369	24	2	80	0.0250000
NODE_11985_length_802_cov_42.294452	342	422	0	12	80	0.1500000
NODE_11985_length_802_cov_42.294452	342	422	2	14	80	0.1750000
NODE_11985_length_802_cov_42.294452	342	422	4	5	80	0.0625000
NODE_11985_length_802_cov_42.294452	342	422	6	15	80	0.1875000
NODE_11985_length_802_cov_42.294452	342	422	8	9	80	0.1125000
NODE_11985_length_802_cov_42.294452	342	422	13	12	80	0.1500000
NODE_11985_length_802_cov_42.294452	342	422	15	13	80	0.1625000
NODE_11986_length_802_cov_31.896159	246	326	0	80	80	1.0000000
NODE_11986_length_802_cov_31.896159	299	379	0	47	80	0.5875000
NODE_11986_length_802_cov_31.896159	299	379	4	33	80	0.4125000
NODE_11987_length_802_cov_30.786629	419	499	2	59	80	0.7375000
NODE_11987_length_802_cov_30.786629	419	499	4	21	80	0.2625000
NODE_11987_length_802_cov_30.786629	472	552	0	25	80	0.3125000
NODE_11987_length_802_cov_30.786629	472	552	2	55	80	0.6875000
NODE_11988_length_802_cov_19.540541	368	448	2	25	80	0.3125000
NODE_11988_length_802_cov_19.540541	368	448	4	55	80	0.6875000
NODE_11988_length_802_cov_19.540541	421	501	0	2	80	0.0250000
NODE_11988_length_802_cov_19.540541	421	501	2	73	80	0.9125000
NODE_11988_length_802_cov_19.540541	421	501	4	5	80	0.0625000
NODE_11989_length_802_cov_17.689900	268	348	0	40	80	0.5000000
NODE_11989_length_802_cov_17.689900	268	348	1	8	80	0.1000000
NODE_11989_length_802_cov_17.689900	268	348	2	32	80	0.4000000
NODE_11989_length_802_cov_17.689900	321	401	2	27	80	0.3375000
NODE_11989_length_802_cov_17.689900	321	401	4	53	80	0.6625000
NODE_11990_length_802_cov_16.432432	364	444	0	80	80	1.0000000
NODE_11990_length_802_cov_16.432432	417	497	0	80	80	1.0000000
NODE_11991_length_802_cov_15.409673	317	397	0	29	80	0.3625000
NODE_11991_length_802_cov_15.409673	317	397	2	6	80	0.0750000
NODE_11991_length_802_cov_15.409673	317	397	4	1	80	0.0125000
NODE_11991_length_802_cov_15.409673	317	397	5	8	80	0.1000000
NODE_11991_length_802_cov_15.409673	317	397	9	1	80	0.0125000
NODE_11991_length_802_cov_15.409673	317	397	10	22	80	0.2750000
NODE_11991_length_802_cov_15.409673	317	397	12	13	80	0.1625000
NODE_11991_length_802_cov_15.409673	370	450	10	54	80	0.6750000
NODE_11991_length_802_cov_15.409673	370	450	12	26	80	0.3250000
NODE_11992_length_802_cov_12.507824	340	420	0	2	80	0.0250000
NODE_11992_length_802_cov_12.507824	340	420	2	59	80	0.7375000
NODE_11992_length_802_cov_12.507824	340	420	4	19	80	0.2375000
NODE_11992_length_802_cov_12.507824	393	473	2	53	80	0.6625000
NODE_11992_length_802_cov_12.507824	393	473	4	27	80	0.3375000
NODE_11993_length_802_cov_9.310100	374	454	0	80	80	1.0000000
NODE_11993_length_802_cov_9.310100	427	507	0	80	80	1.0000000
NODE_11994_length_802_cov_8.421053	272	351	0	79	79	1.0000000
NODE_11994_length_802_cov_8.421053	324	404	0	80	80	1.0000000
NODE_11997_length_802_cov_5.576102	294	374	0	16	80	0.2000000
NODE_11997_length_802_cov_5.576102	294	374	2	20	80	0.2500000
NODE_11997_length_802_cov_5.576102	294	374	4	44	80	0.5500000
NODE_11997_length_802_cov_5.576102	347	427	0	44	80	0.5500000
NODE_11997_length_802_cov_5.576102	347	427	2	36	80	0.4500000
NODE_12025_length_801_cov_35.199430	334	414	1	7	80	0.0875000
NODE_12025_length_801_cov_35.199430	334	414	2	73	80	0.9125000
NODE_12025_length_801_cov_35.199430	387	467	0	25	80	0.3125000
NODE_12025_length_801_cov_35.199430	387	467	2	55	80	0.6875000
NODE_12026_length_801_cov_20.096866	347	427	10	27	80	0.3375000
NODE_12026_length_801_cov_20.096866	347	427	12	48	80	0.6000000
NODE_12026_length_801_cov_20.096866	347	427	14	5	80	0.0625000
NODE_12026_length_801_cov_20.096866	400	480	2	4	80	0.0500000
NODE_12026_length_801_cov_20.096866	400	480	4	12	80	0.1500000
NODE_12026_length_801_cov_20.096866	400	480	6	27	80	0.3375000
NODE_12026_length_801_cov_20.096866	400	480	8	2	80	0.0250000
NODE_12026_length_801_cov_20.096866	400	480	9	1	80	0.0125000
NODE_12026_length_801_cov_20.096866	400	480	10	25	80	0.3125000
NODE_12026_length_801_cov_20.096866	400	480	12	5	80	0.0625000
NODE_12026_length_801_cov_20.096866	400	480	14	4	80	0.0500000
NODE_12027_length_801_cov_18.643875	355	435	2	37	80	0.4625000
NODE_12027_length_801_cov_18.643875	355	435	4	43	80	0.5375000
NODE_12027_length_801_cov_18.643875	408	488	2	35	80	0.4375000
NODE_12027_length_801_cov_18.643875	408	488	4	45	80	0.5625000
NODE_12028_length_801_cov_16.099715	427	507	2	44	80	0.5500000
NODE_12028_length_801_cov_16.099715	427	507	3	1	80	0.0125000
NODE_12028_length_801_cov_16.099715	427	507	4	19	80	0.2375000
NODE_12028_length_801_cov_16.099715	427	507	6	16	80	0.2000000
NODE_12028_length_801_cov_16.099715	480	560	4	16	80	0.2000000
NODE_12028_length_801_cov_16.099715	480	560	6	64	80	0.8000000
NODE_12029_length_801_cov_12.307692	332	412	0	80	80	1.0000000
NODE_12029_length_801_cov_12.307692	385	465	0	80	80	1.0000000
NODE_12030_length_801_cov_11.464387	293	373	0	15	80	0.1875000
NODE_12030_length_801_cov_11.464387	293	373	2	10	80	0.1250000
NODE_12030_length_801_cov_11.464387	293	373	4	55	80	0.6875000
NODE_12030_length_801_cov_11.464387	346	426	0	19	80	0.2375000
NODE_12030_length_801_cov_11.464387	346	426	1	8	80	0.1000000
NODE_12030_length_801_cov_11.464387	346	426	2	51	80	0.6375000
NODE_12030_length_801_cov_11.464387	346	426	4	2	80	0.0250000
NODE_12031_length_801_cov_8.562678	309	389	0	40	80	0.5000000
NODE_12031_length_801_cov_8.562678	309	389	2	40	80	0.5000000
NODE_12031_length_801_cov_8.562678	362	442	0	4	80	0.0500000
NODE_12031_length_801_cov_8.562678	362	442	2	76	80	0.9500000
NODE_12032_length_801_cov_3.927350	339	419	0	80	80	1.0000000
NODE_12032_length_801_cov_3.927350	392	472	0	80	80	1.0000000
NODE_12053_length_800_cov_72.029957	245	325	0	13	80	0.1625000
NODE_12053_length_800_cov_72.029957	245	325	1	2	80	0.0250000
NODE_12053_length_800_cov_72.029957	245	325	2	65	80	0.8125000
NODE_12053_length_800_cov_72.029957	298	378	2	80	80	1.0000000
NODE_12054_length_800_cov_22.631954	297	377	2	3	80	0.0375000
NODE_12054_length_800_cov_22.631954	297	377	4	12	80	0.1500000
NODE_12054_length_800_cov_22.631954	297	377	6	49	80	0.6125000
NODE_12054_length_800_cov_22.631954	297	377	8	16	80	0.2000000
NODE_12054_length_800_cov_22.631954	350	430	2	3	80	0.0375000
NODE_12054_length_800_cov_22.631954	350	430	4	35	80	0.4375000
NODE_12054_length_800_cov_22.631954	350	430	6	27	80	0.3375000
NODE_12054_length_800_cov_22.631954	350	430	8	15	80	0.1875000
NODE_12055_length_800_cov_9.457917	409	489	2	38	80	0.4750000
NODE_12055_length_800_cov_9.457917	409	489	6	29	80	0.3625000
NODE_12055_length_800_cov_9.457917	409	489	8	13	80	0.1625000
NODE_12055_length_800_cov_9.457917	462	542	0	39	80	0.4875000
NODE_12055_length_800_cov_9.457917	462	542	2	41	80	0.5125000
NODE_12084_length_799_cov_101.640000	101	132	49	1	31	0.0322581
NODE_12084_length_799_cov_101.640000	101	132	51	2	31	0.0645161
NODE_12084_length_799_cov_101.640000	101	132	55	1	31	0.0322581
NODE_12084_length_799_cov_101.640000	101	132	62	2	31	0.0645161
NODE_12084_length_799_cov_101.640000	101	132	64	2	31	0.0645161
NODE_12084_length_799_cov_101.640000	101	132	68	1	31	0.0322581
NODE_12084_length_799_cov_101.640000	101	132	70	2	31	0.0645161
NODE_12084_length_799_cov_101.640000	101	132	72	1	31	0.0322581
NODE_12084_length_799_cov_101.640000	101	132	73	3	31	0.0967742
NODE_12084_length_799_cov_101.640000	101	132	76	1	31	0.0322581
NODE_12084_length_799_cov_101.640000	101	132	78	1	31	0.0322581
NODE_12084_length_799_cov_101.640000	101	132	81	1	31	0.0322581
NODE_12084_length_799_cov_101.640000	101	132	85	1	31	0.0322581
NODE_12084_length_799_cov_101.640000	101	132	89	1	31	0.0322581
NODE_12084_length_799_cov_101.640000	101	132	91	1	31	0.0322581
NODE_12084_length_799_cov_101.640000	101	132	94	1	31	0.0322581
NODE_12084_length_799_cov_101.640000	101	132	96	1	31	0.0322581
NODE_12084_length_799_cov_101.640000	101	132	103	1	31	0.0322581
NODE_12084_length_799_cov_101.640000	101	132	111	1	31	0.0322581
NODE_12084_length_799_cov_101.640000	101	132	114	1	31	0.0322581
NODE_12084_length_799_cov_101.640000	101	132	123	1	31	0.0322581
NODE_12084_length_799_cov_101.640000	101	132	127	1	31	0.0322581
NODE_12084_length_799_cov_101.640000	101	132	128	1	31	0.0322581
NODE_12084_length_799_cov_101.640000	101	132	132	1	31	0.0322581
NODE_12084_length_799_cov_101.640000	101	132	134	1	31	0.0322581
NODE_12085_length_799_cov_33.630000	367	447	8	3	80	0.0375000
NODE_12085_length_799_cov_33.630000	367	447	9	71	80	0.8875000
NODE_12085_length_799_cov_33.630000	367	447	10	6	80	0.0750000
NODE_12085_length_799_cov_33.630000	420	500	0	21	80	0.2625000
NODE_12085_length_799_cov_33.630000	420	500	8	35	80	0.4375000
NODE_12085_length_799_cov_33.630000	420	500	9	23	80	0.2875000
NODE_12085_length_799_cov_33.630000	420	500	10	1	80	0.0125000
NODE_12086_length_799_cov_15.717143	408	488	4	3	80	0.0375000
NODE_12086_length_799_cov_15.717143	408	488	6	15	80	0.1875000
NODE_12086_length_799_cov_15.717143	408	488	8	62	80	0.7750000
NODE_12086_length_799_cov_15.717143	461	541	0	19	80	0.2375000
NODE_12086_length_799_cov_15.717143	461	541	2	3	80	0.0375000
NODE_12086_length_799_cov_15.717143	461	541	4	34	80	0.4250000
NODE_12086_length_799_cov_15.717143	461	541	6	8	80	0.1000000
NODE_12086_length_799_cov_15.717143	461	541	8	16	80	0.2000000
NODE_12087_length_799_cov_15.175714	293	373	0	6	80	0.0750000
NODE_12087_length_799_cov_15.175714	293	373	2	74	80	0.9250000
NODE_12087_length_799_cov_15.175714	346	426	2	80	80	1.0000000
NODE_12088_length_799_cov_8.444286	408	488	0	31	80	0.3875000
NODE_12088_length_799_cov_8.444286	408	488	2	15	80	0.1875000
NODE_12088_length_799_cov_8.444286	408	488	4	34	80	0.4250000
NODE_12088_length_799_cov_8.444286	461	541	2	27	80	0.3375000
NODE_12088_length_799_cov_8.444286	461	541	4	53	80	0.6625000
NODE_12120_length_798_cov_42.629471	148	228	0	40	80	0.5000000
NODE_12120_length_798_cov_42.629471	148	228	4	40	80	0.5000000
NODE_12120_length_798_cov_42.629471	201	281	0	15	80	0.1875000
NODE_12120_length_798_cov_42.629471	201	281	4	65	80	0.8125000
NODE_12121_length_798_cov_23.658083	368	448	2	2	80	0.0250000
NODE_12121_length_798_cov_23.658083	368	448	4	45	80	0.5625000
NODE_12121_length_798_cov_23.658083	368	448	6	33	80	0.4125000
NODE_12121_length_798_cov_23.658083	421	501	4	61	80	0.7625000
NODE_12121_length_798_cov_23.658083	421	501	6	19	80	0.2375000
NODE_12122_length_798_cov_15.037196	341	421	0	80	80	1.0000000
NODE_12122_length_798_cov_15.037196	394	474	0	80	80	1.0000000
NODE_12123_length_798_cov_6.816881	404	483	0	79	79	1.0000000
NODE_12123_length_798_cov_6.816881	457	536	0	79	79	1.0000000
NODE_12129_length_798_cov_2.796853	246	326	0	26	80	0.3250000
NODE_12129_length_798_cov_2.796853	246	326	2	54	80	0.6750000
NODE_12129_length_798_cov_2.796853	299	379	0	79	80	0.9875000
NODE_12129_length_798_cov_2.796853	299	379	2	1	80	0.0125000
NODE_12151_length_797_cov_24.340974	207	287	0	19	80	0.2375000
NODE_12151_length_797_cov_24.340974	207	287	4	3	80	0.0375000
NODE_12151_length_797_cov_24.340974	207	287	6	35	80	0.4375000
NODE_12151_length_797_cov_24.340974	207	287	8	5	80	0.0625000
NODE_12151_length_797_cov_24.340974	207	287	10	18	80	0.2250000
NODE_12151_length_797_cov_24.340974	260	340	4	4	80	0.0500000
NODE_12151_length_797_cov_24.340974	260	340	6	46	80	0.5750000
NODE_12151_length_797_cov_24.340974	260	340	8	5	80	0.0625000
NODE_12151_length_797_cov_24.340974	260	340	10	25	80	0.3125000
NODE_12152_length_797_cov_21.071633	372	452	0	48	80	0.6000000
NODE_12152_length_797_cov_21.071633	372	452	4	19	80	0.2375000
NODE_12152_length_797_cov_21.071633	372	452	6	1	80	0.0125000
NODE_12152_length_797_cov_21.071633	372	452	8	12	80	0.1500000
NODE_12152_length_797_cov_21.071633	425	505	4	14	80	0.1750000
NODE_12152_length_797_cov_21.071633	425	505	6	6	80	0.0750000
NODE_12152_length_797_cov_21.071633	425	505	7	1	80	0.0125000
NODE_12152_length_797_cov_21.071633	425	505	8	58	80	0.7250000
NODE_12152_length_797_cov_21.071633	425	505	10	1	80	0.0125000
NODE_12153_length_797_cov_18.286533	346	426	0	80	80	1.0000000
NODE_12153_length_797_cov_18.286533	399	479	0	80	80	1.0000000
NODE_12154_length_797_cov_16.628940	322	402	0	80	80	1.0000000
NODE_12154_length_797_cov_16.628940	375	455	0	65	80	0.8125000
NODE_12154_length_797_cov_16.628940	375	455	2	15	80	0.1875000
NODE_12155_length_797_cov_15.266476	299	379	0	8	80	0.1000000
NODE_12155_length_797_cov_15.266476	299	379	1	65	80	0.8125000
NODE_12155_length_797_cov_15.266476	299	379	2	7	80	0.0875000
NODE_12155_length_797_cov_15.266476	352	432	1	20	80	0.2500000
NODE_12155_length_797_cov_15.266476	352	432	2	8	80	0.1000000
NODE_12155_length_797_cov_15.266476	352	432	6	48	80	0.6000000
NODE_12155_length_797_cov_15.266476	352	432	7	4	80	0.0500000
NODE_12156_length_797_cov_15.035817	263	343	2	39	80	0.4875000
NODE_12156_length_797_cov_15.035817	263	343	3	31	80	0.3875000
NODE_12156_length_797_cov_15.035817	263	343	5	10	80	0.1250000
NODE_12156_length_797_cov_15.035817	316	396	3	44	80	0.5500000
NODE_12156_length_797_cov_15.035817	316	396	4	2	80	0.0250000
NODE_12156_length_797_cov_15.035817	316	396	5	34	80	0.4250000
NODE_12157_length_797_cov_12.934097	403	484	0	51	81	0.6296296
NODE_12157_length_797_cov_12.934097	403	484	2	30	81	0.3703704
NODE_12157_length_797_cov_12.934097	457	537	2	74	80	0.9250000
NODE_12157_length_797_cov_12.934097	457	537	4	6	80	0.0750000
NODE_12158_length_797_cov_11.140401	201	281	0	44	80	0.5500000
NODE_12158_length_797_cov_11.140401	201	281	2	36	80	0.4500000
NODE_12158_length_797_cov_11.140401	254	334	2	43	80	0.5375000
NODE_12158_length_797_cov_11.140401	254	334	4	37	80	0.4625000
NODE_12159_length_797_cov_8.681948	284	364	0	75	80	0.9375000
NODE_12159_length_797_cov_8.681948	284	364	2	5	80	0.0625000
NODE_12159_length_797_cov_8.681948	337	417	0	22	80	0.2750000
NODE_12159_length_797_cov_8.681948	337	417	2	37	80	0.4625000
NODE_12159_length_797_cov_8.681948	337	417	6	21	80	0.2625000
NODE_12160_length_797_cov_7.616046	314	397	4	12	83	0.1445783
NODE_12160_length_797_cov_7.616046	314	397	6	1	83	0.0120482
NODE_12160_length_797_cov_7.616046	314	397	8	70	83	0.8433735
NODE_12160_length_797_cov_7.616046	370	450	0	33	80	0.4125000
NODE_12160_length_797_cov_7.616046	370	450	4	31	80	0.3875000
NODE_12160_length_797_cov_7.616046	370	450	6	1	80	0.0125000
NODE_12160_length_797_cov_7.616046	370	450	8	15	80	0.1875000
NODE_12161_length_797_cov_7.487106	275	347	0	61	72	0.8472222
NODE_12161_length_797_cov_7.487106	275	347	2	11	72	0.1527778
NODE_12161_length_797_cov_7.487106	320	400	0	16	80	0.2000000
NODE_12161_length_797_cov_7.487106	320	400	2	64	80	0.8000000
NODE_12163_length_797_cov_6.068768	357	437	0	78	80	0.9750000
NODE_12163_length_797_cov_6.068768	357	437	2	2	80	0.0250000
NODE_12163_length_797_cov_6.068768	410	490	0	25	80	0.3125000
NODE_12163_length_797_cov_6.068768	410	490	2	40	80	0.5000000
NODE_12163_length_797_cov_6.068768	410	490	3	12	80	0.1500000
NODE_12163_length_797_cov_6.068768	410	490	4	3	80	0.0375000
NODE_12186_length_796_cov_20.862267	262	342	0	64	80	0.8000000
NODE_12186_length_796_cov_20.862267	262	342	2	16	80	0.2000000
NODE_12186_length_796_cov_20.862267	315	395	0	11	80	0.1375000
NODE_12186_length_796_cov_20.862267	315	395	2	69	80	0.8625000
NODE_12187_length_796_cov_18.291248	283	363	6	15	80	0.1875000
NODE_12187_length_796_cov_18.291248	283	363	14	1	80	0.0125000
NODE_12187_length_796_cov_18.291248	283	363	26	18	80	0.2250000
NODE_12187_length_796_cov_18.291248	283	363	28	11	80	0.1375000
NODE_12187_length_796_cov_18.291248	283	363	30	23	80	0.2875000
NODE_12187_length_796_cov_18.291248	283	363	31	1	80	0.0125000
NODE_12187_length_796_cov_18.291248	283	363	32	6	80	0.0750000
NODE_12187_length_796_cov_18.291248	283	363	34	5	80	0.0625000
NODE_12187_length_796_cov_18.291248	336	416	12	2	80	0.0250000
NODE_12187_length_796_cov_18.291248	336	416	13	6	80	0.0750000
NODE_12187_length_796_cov_18.291248	336	416	14	1	80	0.0125000
NODE_12187_length_796_cov_18.291248	336	416	20	3	80	0.0375000
NODE_12187_length_796_cov_18.291248	336	416	22	9	80	0.1125000
NODE_12187_length_796_cov_18.291248	336	416	23	4	80	0.0500000
NODE_12187_length_796_cov_18.291248	336	416	29	14	80	0.1750000
NODE_12187_length_796_cov_18.291248	336	416	30	23	80	0.2875000
NODE_12187_length_796_cov_18.291248	336	416	31	7	80	0.0875000
NODE_12187_length_796_cov_18.291248	336	416	32	6	80	0.0750000
NODE_12187_length_796_cov_18.291248	336	416	34	5	80	0.0625000
NODE_12189_length_796_cov_7.880918	388	460	0	72	72	1.0000000
NODE_12189_length_796_cov_7.880918	442	513	0	71	71	1.0000000
NODE_12216_length_795_cov_31.729885	298	378	0	2	80	0.0250000
NODE_12216_length_795_cov_31.729885	298	378	2	73	80	0.9125000
NODE_12216_length_795_cov_31.729885	298	378	4	5	80	0.0625000
NODE_12216_length_795_cov_31.729885	351	431	2	62	80	0.7750000
NODE_12216_length_795_cov_31.729885	351	431	4	18	80	0.2250000
NODE_12217_length_795_cov_26.760057	367	447	0	6	80	0.0750000
NODE_12217_length_795_cov_26.760057	367	447	2	74	80	0.9250000
NODE_12217_length_795_cov_26.760057	420	500	2	80	80	1.0000000
NODE_12218_length_795_cov_24.522989	352	432	0	55	80	0.6875000
NODE_12218_length_795_cov_24.522989	352	432	2	25	80	0.3125000
NODE_12218_length_795_cov_24.522989	405	485	0	2	80	0.0250000
NODE_12218_length_795_cov_24.522989	405	485	2	78	80	0.9750000
NODE_12219_length_795_cov_22.747126	363	443	0	42	80	0.5250000
NODE_12219_length_795_cov_22.747126	363	443	2	4	80	0.0500000
NODE_12219_length_795_cov_22.747126	363	443	4	14	80	0.1750000
NODE_12219_length_795_cov_22.747126	363	443	10	20	80	0.2500000
NODE_12219_length_795_cov_22.747126	416	496	4	7	80	0.0875000
NODE_12219_length_795_cov_22.747126	416	496	6	16	80	0.2000000
NODE_12219_length_795_cov_22.747126	416	496	10	57	80	0.7125000
NODE_12220_length_795_cov_9.439655	425	505	0	80	80	1.0000000
NODE_12220_length_795_cov_9.439655	478	558	0	80	80	1.0000000
NODE_12232_length_795_cov_3.359195	349	429	0	80	80	1.0000000
NODE_12232_length_795_cov_3.359195	402	482	0	79	80	0.9875000
NODE_12232_length_795_cov_3.359195	402	482	2	1	80	0.0125000
NODE_12256_length_794_cov_24.680576	326	406	4	9	80	0.1125000
NODE_12256_length_794_cov_24.680576	326	406	6	8	80	0.1000000
NODE_12256_length_794_cov_24.680576	326	406	8	3	80	0.0375000
NODE_12256_length_794_cov_24.680576	326	406	10	34	80	0.4250000
NODE_12256_length_794_cov_24.680576	326	406	12	26	80	0.3250000
NODE_12256_length_794_cov_24.680576	379	459	0	12	80	0.1500000
NODE_12256_length_794_cov_24.680576	379	459	2	22	80	0.2750000
NODE_12256_length_794_cov_24.680576	379	459	4	28	80	0.3500000
NODE_12256_length_794_cov_24.680576	379	459	6	8	80	0.1000000
NODE_12256_length_794_cov_24.680576	379	459	8	3	80	0.0375000
NODE_12256_length_794_cov_24.680576	379	459	10	7	80	0.0875000
NODE_12257_length_794_cov_20.057554	153	233	2	30	80	0.3750000
NODE_12257_length_794_cov_20.057554	153	233	4	34	80	0.4250000
NODE_12257_length_794_cov_20.057554	153	233	6	16	80	0.2000000
NODE_12257_length_794_cov_20.057554	206	286	2	17	80	0.2125000
NODE_12257_length_794_cov_20.057554	206	286	4	63	80	0.7875000
NODE_12257_length_794_cov_20.057554	282	362	0	33	80	0.4125000
NODE_12257_length_794_cov_20.057554	282	362	2	47	80	0.5875000
NODE_12257_length_794_cov_20.057554	335	415	0	80	80	1.0000000
NODE_12258_length_794_cov_16.602878	361	441	0	28	80	0.3500000
NODE_12258_length_794_cov_16.602878	361	441	2	52	80	0.6500000
NODE_12258_length_794_cov_16.602878	414	494	0	70	80	0.8750000
NODE_12258_length_794_cov_16.602878	414	494	2	10	80	0.1250000
NODE_12259_length_794_cov_16.362590	337	417	0	80	80	1.0000000
NODE_12259_length_794_cov_16.362590	390	470	0	80	80	1.0000000
NODE_12260_length_794_cov_14.444604	101	160	0	59	59	1.0000000
NODE_12260_length_794_cov_14.444604	409	489	0	80	80	1.0000000
NODE_12260_length_794_cov_14.444604	462	542	0	80	80	1.0000000
NODE_12261_length_794_cov_12.866187	442	522	2	10	80	0.1250000
NODE_12261_length_794_cov_12.866187	442	522	4	70	80	0.8750000
NODE_12261_length_794_cov_12.866187	495	575	2	33	80	0.4125000
NODE_12261_length_794_cov_12.866187	495	575	4	47	80	0.5875000
NODE_12262_length_794_cov_12.287770	235	315	0	80	80	1.0000000
NODE_12262_length_794_cov_12.287770	288	368	0	80	80	1.0000000
NODE_12263_length_794_cov_11.210072	315	395	0	48	80	0.6000000
NODE_12263_length_794_cov_11.210072	315	395	2	32	80	0.4000000
NODE_12263_length_794_cov_11.210072	368	448	0	6	80	0.0750000
NODE_12263_length_794_cov_11.210072	368	448	2	74	80	0.9250000
NODE_12264_length_794_cov_10.638849	325	406	0	42	81	0.5185185
NODE_12264_length_794_cov_10.638849	325	406	2	39	81	0.4814815
NODE_12264_length_794_cov_10.638849	379	459	0	80	80	1.0000000
NODE_12266_length_794_cov_6.274820	412	492	6	10	80	0.1250000
NODE_12266_length_794_cov_6.274820	412	492	8	37	80	0.4625000
NODE_12266_length_794_cov_6.274820	412	492	9	2	80	0.0250000
NODE_12266_length_794_cov_6.274820	412	492	10	31	80	0.3875000
NODE_12266_length_794_cov_6.274820	465	545	0	36	80	0.4500000
NODE_12266_length_794_cov_6.274820	465	545	6	27	80	0.3375000
NODE_12266_length_794_cov_6.274820	465	545	8	17	80	0.2125000
NODE_12271_length_794_cov_3.197122	273	338	0	65	65	1.0000000
NODE_12282_length_794_cov_1.848921	246	326	0	80	80	1.0000000
NODE_12282_length_794_cov_1.848921	299	379	0	80	80	1.0000000
NODE_12295_length_793_cov_29.878963	326	406	0	3	80	0.0375000
NODE_12295_length_793_cov_29.878963	326	406	2	1	80	0.0125000
NODE_12295_length_793_cov_29.878963	326	406	3	9	80	0.1125000
NODE_12295_length_793_cov_29.878963	326	406	4	14	80	0.1750000
NODE_12295_length_793_cov_29.878963	326	406	7	12	80	0.1500000
NODE_12295_length_793_cov_29.878963	326	406	9	1	80	0.0125000
NODE_12295_length_793_cov_29.878963	326	406	10	7	80	0.0875000
NODE_12295_length_793_cov_29.878963	326	406	12	33	80	0.4125000
NODE_12295_length_793_cov_29.878963	379	459	6	18	80	0.2250000
NODE_12295_length_793_cov_29.878963	379	459	8	5	80	0.0625000
NODE_12295_length_793_cov_29.878963	379	459	10	31	80	0.3875000
NODE_12295_length_793_cov_29.878963	379	459	12	26	80	0.3250000
NODE_12296_length_793_cov_25.981268	310	390	0	27	80	0.3375000
NODE_12296_length_793_cov_25.981268	310	390	2	53	80	0.6625000
NODE_12296_length_793_cov_25.981268	363	445	0	23	82	0.2804878
NODE_12296_length_793_cov_25.981268	363	445	2	59	82	0.7195122
NODE_12297_length_793_cov_24.840058	331	411	0	51	80	0.6375000
NODE_12297_length_793_cov_24.840058	331	411	2	29	80	0.3625000
NODE_12297_length_793_cov_24.840058	384	464	2	80	80	1.0000000
NODE_12298_length_793_cov_21.707493	398	478	2	1	80	0.0125000
NODE_12298_length_793_cov_21.707493	398	478	4	79	80	0.9875000
NODE_12298_length_793_cov_21.707493	451	531	0	9	80	0.1125000
NODE_12298_length_793_cov_21.707493	451	531	2	10	80	0.1250000
NODE_12298_length_793_cov_21.707493	451	531	4	61	80	0.7625000
NODE_12299_length_793_cov_8.358790	257	337	0	80	80	1.0000000
NODE_12299_length_793_cov_8.358790	310	390	0	80	80	1.0000000
NODE_12300_length_793_cov_8.236311	477	557	0	80	80	1.0000000
NODE_12300_length_793_cov_8.236311	530	610	0	80	80	1.0000000
NODE_12302_length_793_cov_6.763689	461	541	0	80	80	1.0000000
NODE_12302_length_793_cov_6.763689	514	594	0	80	80	1.0000000
NODE_12307_length_793_cov_4.465418	501	549	0	48	48	1.0000000
NODE_12311_length_793_cov_4.138329	174	254	0	80	80	1.0000000
NODE_12311_length_793_cov_4.138329	227	307	0	80	80	1.0000000
NODE_12338_length_792_cov_40.025974	198	278	0	80	80	1.0000000
NODE_12338_length_792_cov_40.025974	251	331	0	80	80	1.0000000
NODE_12338_length_792_cov_40.025974	327	408	0	81	81	1.0000000
NODE_12338_length_792_cov_40.025974	381	461	0	80	80	1.0000000
NODE_12339_length_792_cov_31.176046	331	411	0	80	80	1.0000000
NODE_12339_length_792_cov_31.176046	384	463	0	79	79	1.0000000
NODE_12339_length_792_cov_31.176046	459	539	0	80	80	1.0000000
NODE_12339_length_792_cov_31.176046	512	546	0	34	34	1.0000000
NODE_12340_length_792_cov_21.347763	303	383	0	80	80	1.0000000
NODE_12340_length_792_cov_21.347763	356	436	0	80	80	1.0000000
NODE_12341_length_792_cov_20.142857	361	441	0	80	80	1.0000000
NODE_12341_length_792_cov_20.142857	414	494	0	80	80	1.0000000
NODE_12342_length_792_cov_18.733045	320	400	0	1	80	0.0125000
NODE_12342_length_792_cov_18.733045	320	400	2	3	80	0.0375000
NODE_12342_length_792_cov_18.733045	320	400	4	46	80	0.5750000
NODE_12342_length_792_cov_18.733045	320	400	6	30	80	0.3750000
NODE_12342_length_792_cov_18.733045	373	453	2	5	80	0.0625000
NODE_12342_length_792_cov_18.733045	373	453	4	22	80	0.2750000
NODE_12342_length_792_cov_18.733045	373	453	6	53	80	0.6625000
NODE_12343_length_792_cov_12.024531	369	449	0	15	80	0.1875000
NODE_12343_length_792_cov_12.024531	369	449	2	65	80	0.8125000
NODE_12343_length_792_cov_12.024531	422	502	0	45	80	0.5625000
NODE_12343_length_792_cov_12.024531	422	502	2	35	80	0.4375000
NODE_12372_length_791_cov_53.573699	287	359	0	32	72	0.4444444
NODE_12372_length_791_cov_53.573699	287	359	2	5	72	0.0694444
NODE_12372_length_791_cov_53.573699	287	359	4	24	72	0.3333333
NODE_12372_length_791_cov_53.573699	287	359	8	11	72	0.1527778
NODE_12372_length_791_cov_53.573699	332	412	4	44	80	0.5500000
NODE_12372_length_791_cov_53.573699	332	412	6	21	80	0.2625000
NODE_12372_length_791_cov_53.573699	332	412	8	15	80	0.1875000
NODE_12373_length_791_cov_40.416185	238	318	0	30	80	0.3750000
NODE_12373_length_791_cov_40.416185	238	318	2	50	80	0.6250000
NODE_12373_length_791_cov_40.416185	291	371	2	80	80	1.0000000
NODE_12374_length_791_cov_38.791908	309	389	0	80	80	1.0000000
NODE_12374_length_791_cov_38.791908	362	442	0	80	80	1.0000000
NODE_12375_length_791_cov_23.468208	328	408	0	80	80	1.0000000
NODE_12375_length_791_cov_23.468208	381	461	0	80	80	1.0000000
NODE_12376_length_791_cov_20.897399	299	379	0	64	80	0.8000000
NODE_12376_length_791_cov_20.897399	299	379	2	16	80	0.2000000
NODE_12376_length_791_cov_20.897399	352	432	0	35	80	0.4375000
NODE_12376_length_791_cov_20.897399	352	432	2	45	80	0.5625000
NODE_12377_length_791_cov_13.504335	339	419	0	5	80	0.0625000
NODE_12377_length_791_cov_13.504335	339	419	2	9	80	0.1125000
NODE_12377_length_791_cov_13.504335	339	419	4	66	80	0.8250000
NODE_12377_length_791_cov_13.504335	392	472	0	56	80	0.7000000
NODE_12377_length_791_cov_13.504335	392	472	2	3	80	0.0375000
NODE_12377_length_791_cov_13.504335	392	472	4	21	80	0.2625000
NODE_12379_length_791_cov_12.547688	338	418	0	16	80	0.2000000
NODE_12379_length_791_cov_12.547688	338	418	2	13	80	0.1625000
NODE_12379_length_791_cov_12.547688	338	418	4	51	80	0.6375000
NODE_12379_length_791_cov_12.547688	391	471	4	54	80	0.6750000
NODE_12379_length_791_cov_12.547688	391	471	5	2	80	0.0250000
NODE_12379_length_791_cov_12.547688	391	471	6	24	80	0.3000000
NODE_12380_length_791_cov_11.791908	440	520	0	74	80	0.9250000
NODE_12380_length_791_cov_11.791908	440	520	2	6	80	0.0750000
NODE_12380_length_791_cov_11.791908	493	573	0	23	80	0.2875000
NODE_12380_length_791_cov_11.791908	493	573	2	57	80	0.7125000
NODE_12381_length_791_cov_11.011561	337	417	0	80	80	1.0000000
NODE_12381_length_791_cov_11.011561	390	470	0	80	80	1.0000000
NODE_12382_length_791_cov_8.757225	325	405	0	45	80	0.5625000
NODE_12382_length_791_cov_8.757225	325	405	2	35	80	0.4375000
NODE_12382_length_791_cov_8.757225	378	458	0	9	80	0.1125000
NODE_12382_length_791_cov_8.757225	378	458	2	71	80	0.8875000
NODE_12384_length_791_cov_8.125723	416	496	0	80	80	1.0000000
NODE_12384_length_791_cov_8.125723	469	549	0	80	80	1.0000000
NODE_12409_length_790_cov_48.021708	526	606	0	23	80	0.2875000
NODE_12409_length_790_cov_48.021708	526	606	2	42	80	0.5250000
NODE_12409_length_790_cov_48.021708	526	606	4	15	80	0.1875000
NODE_12409_length_790_cov_48.021708	579	659	0	76	80	0.9500000
NODE_12409_length_790_cov_48.021708	579	659	2	4	80	0.0500000
NODE_12410_length_790_cov_44.151954	343	423	0	21	80	0.2625000
NODE_12410_length_790_cov_44.151954	343	423	2	59	80	0.7375000
NODE_12410_length_790_cov_44.151954	396	438	2	42	42	1.0000000
NODE_12410_length_790_cov_44.151954	696	776	4	5	80	0.0625000
NODE_12410_length_790_cov_44.151954	696	776	10	5	80	0.0625000
NODE_12410_length_790_cov_44.151954	696	776	14	2	80	0.0250000
NODE_12410_length_790_cov_44.151954	696	776	18	32	80	0.4000000
NODE_12410_length_790_cov_44.151954	696	776	20	36	80	0.4500000
NODE_12411_length_790_cov_27.144718	291	371	0	80	80	1.0000000
NODE_12411_length_790_cov_27.144718	344	424	0	80	80	1.0000000
NODE_12412_length_790_cov_16.973951	232	312	0	80	80	1.0000000
NODE_12412_length_790_cov_16.973951	285	365	0	80	80	1.0000000
NODE_12413_length_790_cov_13.374819	204	284	0	80	80	1.0000000
NODE_12413_length_790_cov_13.374819	257	337	0	80	80	1.0000000
NODE_12415_length_790_cov_10.613603	302	382	0	25	80	0.3125000
NODE_12415_length_790_cov_10.613603	302	382	2	55	80	0.6875000
NODE_12415_length_790_cov_10.613603	355	435	2	62	80	0.7750000
NODE_12415_length_790_cov_10.613603	355	435	4	18	80	0.2250000
NODE_12418_length_790_cov_5.493488	271	351	0	80	80	1.0000000
NODE_12418_length_790_cov_5.493488	324	404	0	80	80	1.0000000
NODE_12434_length_790_cov_1.463097	313	376	0	63	63	1.0000000
NODE_12452_length_789_cov_39.123188	226	306	0	80	80	1.0000000
NODE_12452_length_789_cov_39.123188	279	359	0	80	80	1.0000000
NODE_12453_length_789_cov_37.205797	423	503	0	80	80	1.0000000
NODE_12453_length_789_cov_37.205797	476	556	0	80	80	1.0000000
NODE_12454_length_789_cov_31.311594	223	303	0	72	80	0.9000000
NODE_12454_length_789_cov_31.311594	223	303	2	8	80	0.1000000
NODE_12454_length_789_cov_31.311594	276	356	0	19	80	0.2375000
NODE_12454_length_789_cov_31.311594	276	356	2	61	80	0.7625000
NODE_12455_length_789_cov_30.536232	306	386	0	5	80	0.0625000
NODE_12455_length_789_cov_30.536232	306	386	2	14	80	0.1750000
NODE_12455_length_789_cov_30.536232	306	386	4	4	80	0.0500000
NODE_12455_length_789_cov_30.536232	306	386	6	35	80	0.4375000
NODE_12455_length_789_cov_30.536232	306	386	8	3	80	0.0375000
NODE_12455_length_789_cov_30.536232	306	386	10	19	80	0.2375000
NODE_12455_length_789_cov_30.536232	359	439	0	58	80	0.7250000
NODE_12455_length_789_cov_30.536232	359	439	2	14	80	0.1750000
NODE_12455_length_789_cov_30.536232	359	439	4	4	80	0.0500000
NODE_12455_length_789_cov_30.536232	359	439	6	4	80	0.0500000
NODE_12456_length_789_cov_24.886957	343	423	0	80	80	1.0000000
NODE_12456_length_789_cov_24.886957	396	476	0	80	80	1.0000000
NODE_12457_length_789_cov_23.539130	357	437	0	57	80	0.7125000
NODE_12457_length_789_cov_23.539130	357	437	2	23	80	0.2875000
NODE_12457_length_789_cov_23.539130	410	490	0	4	80	0.0500000
NODE_12457_length_789_cov_23.539130	410	490	2	76	80	0.9500000
NODE_12458_length_789_cov_16.169565	392	472	0	80	80	1.0000000
NODE_12458_length_789_cov_16.169565	445	525	0	80	80	1.0000000
NODE_12459_length_789_cov_15.175362	242	322	0	80	80	1.0000000
NODE_12459_length_789_cov_15.175362	295	375	0	80	80	1.0000000
NODE_12459_length_789_cov_15.175362	371	451	0	61	80	0.7625000
NODE_12459_length_789_cov_15.175362	371	451	2	19	80	0.2375000
NODE_12459_length_789_cov_15.175362	424	504	0	8	80	0.1000000
NODE_12459_length_789_cov_15.175362	424	504	2	36	80	0.4500000
NODE_12459_length_789_cov_15.175362	424	504	4	36	80	0.4500000
NODE_12460_length_789_cov_7.276812	306	386	0	80	80	1.0000000
NODE_12460_length_789_cov_7.276812	359	439	0	80	80	1.0000000
NODE_12482_length_788_cov_43.091437	335	415	0	53	80	0.6625000
NODE_12482_length_788_cov_43.091437	335	415	2	27	80	0.3375000
NODE_12482_length_788_cov_43.091437	388	460	2	72	72	1.0000000
NODE_12483_length_788_cov_38.914369	345	425	0	26	80	0.3250000
NODE_12483_length_788_cov_38.914369	345	425	2	44	80	0.5500000
NODE_12483_length_788_cov_38.914369	345	425	4	2	80	0.0250000
NODE_12483_length_788_cov_38.914369	345	425	6	8	80	0.1000000
NODE_12483_length_788_cov_38.914369	398	478	2	17	80	0.2125000
NODE_12483_length_788_cov_38.914369	398	478	4	2	80	0.0250000
NODE_12483_length_788_cov_38.914369	398	478	6	13	80	0.1625000
NODE_12483_length_788_cov_38.914369	398	478	8	14	80	0.1750000
NODE_12483_length_788_cov_38.914369	398	478	10	25	80	0.3125000
NODE_12483_length_788_cov_38.914369	398	478	12	9	80	0.1125000
NODE_12484_length_788_cov_36.148041	320	400	0	15	80	0.1875000
NODE_12484_length_788_cov_36.148041	320	400	2	10	80	0.1250000
NODE_12484_length_788_cov_36.148041	320	400	4	55	80	0.6875000
NODE_12484_length_788_cov_36.148041	373	453	0	8	80	0.1000000
NODE_12484_length_788_cov_36.148041	373	453	4	72	80	0.9000000
NODE_12485_length_788_cov_35.460087	346	426	0	80	80	1.0000000
NODE_12485_length_788_cov_35.460087	399	479	0	80	80	1.0000000
NODE_12486_length_788_cov_30.785196	278	358	2	4	80	0.0500000
NODE_12486_length_788_cov_30.785196	278	358	4	17	80	0.2125000
NODE_12486_length_788_cov_30.785196	278	358	7	15	80	0.1875000
NODE_12486_length_788_cov_30.785196	278	358	8	9	80	0.1125000
NODE_12486_length_788_cov_30.785196	278	358	9	35	80	0.4375000
NODE_12486_length_788_cov_30.785196	331	411	4	13	80	0.1625000
NODE_12486_length_788_cov_30.785196	331	411	7	17	80	0.2125000
NODE_12486_length_788_cov_30.785196	331	411	8	29	80	0.3625000
NODE_12486_length_788_cov_30.785196	331	411	9	12	80	0.1500000
NODE_12486_length_788_cov_30.785196	331	411	10	9	80	0.1125000
NODE_12488_length_788_cov_20.867925	300	380	2	27	80	0.3375000
NODE_12488_length_788_cov_20.867925	300	380	3	4	80	0.0500000
NODE_12488_length_788_cov_20.867925	300	380	4	11	80	0.1375000
NODE_12488_length_788_cov_20.867925	300	380	5	3	80	0.0375000
NODE_12488_length_788_cov_20.867925	300	380	7	35	80	0.4375000
NODE_12488_length_788_cov_20.867925	353	430	4	16	77	0.2077922
NODE_12488_length_788_cov_20.867925	353	430	6	11	77	0.1428571
NODE_12488_length_788_cov_20.867925	353	430	7	50	77	0.6493506
NODE_12489_length_788_cov_20.821480	322	402	0	80	80	1.0000000
NODE_12489_length_788_cov_20.821480	375	455	0	80	80	1.0000000
NODE_12490_length_788_cov_15.570392	342	422	0	59	80	0.7375000
NODE_12490_length_788_cov_15.570392	342	422	2	21	80	0.2625000
NODE_12490_length_788_cov_15.570392	395	475	0	6	80	0.0750000
NODE_12490_length_788_cov_15.570392	395	475	2	74	80	0.9250000
NODE_12491_length_788_cov_12.235123	241	321	0	80	80	1.0000000
NODE_12491_length_788_cov_12.235123	294	374	0	80	80	1.0000000
NODE_12492_length_788_cov_10.509434	405	480	0	44	75	0.5866666
NODE_12492_length_788_cov_10.509434	405	480	2	31	75	0.4133333
NODE_12493_length_788_cov_9.737300	310	390	0	8	80	0.1000000
NODE_12493_length_788_cov_9.737300	310	390	6	55	80	0.6875000
NODE_12493_length_788_cov_9.737300	310	390	10	17	80	0.2125000
NODE_12493_length_788_cov_9.737300	363	443	4	44	80	0.5500000
NODE_12493_length_788_cov_9.737300	363	443	6	10	80	0.1250000
NODE_12493_length_788_cov_9.737300	363	443	10	26	80	0.3250000
NODE_12494_length_788_cov_8.872279	280	360	0	80	80	1.0000000
NODE_12494_length_788_cov_8.872279	333	413	0	80	80	1.0000000
NODE_12516_length_787_cov_34.683140	274	335	0	61	61	1.0000000
NODE_12516_length_787_cov_34.683140	319	380	0	55	61	0.9016393
NODE_12516_length_787_cov_34.683140	319	380	2	6	61	0.0983607
NODE_12517_length_787_cov_28.039244	252	329	0	34	77	0.4415585
NODE_12517_length_787_cov_28.039244	252	329	2	43	77	0.5584416
NODE_12517_length_787_cov_28.039244	302	370	2	68	68	1.0000000
NODE_12518_length_787_cov_25.422965	351	431	0	80	80	1.0000000
NODE_12518_length_787_cov_25.422965	404	484	0	80	80	1.0000000
NODE_12519_length_787_cov_24.857558	319	399	0	72	80	0.9000000
NODE_12519_length_787_cov_24.857558	319	399	2	8	80	0.1000000
NODE_12519_length_787_cov_24.857558	372	452	0	80	80	1.0000000
NODE_12520_length_787_cov_21.357558	291	371	0	45	80	0.5625000
NODE_12520_length_787_cov_21.357558	291	371	2	35	80	0.4375000
NODE_12520_length_787_cov_21.357558	344	424	0	18	80	0.2250000
NODE_12520_length_787_cov_21.357558	344	424	2	62	80	0.7750000
NODE_12521_length_787_cov_17.360465	396	476	0	80	80	1.0000000
NODE_12521_length_787_cov_17.360465	449	529	0	46	80	0.5750000
NODE_12521_length_787_cov_17.360465	449	529	2	34	80	0.4250000
NODE_12522_length_787_cov_14.677326	178	258	4	55	80	0.6875000
NODE_12522_length_787_cov_14.677326	178	258	6	25	80	0.3125000
NODE_12522_length_787_cov_14.677326	231	311	4	38	80	0.4750000
NODE_12522_length_787_cov_14.677326	231	311	6	42	80	0.5250000
NODE_12523_length_787_cov_12.959302	331	411	2	10	80	0.1250000
NODE_12523_length_787_cov_12.959302	331	411	3	70	80	0.8750000
NODE_12523_length_787_cov_12.959302	384	464	3	40	80	0.5000000
NODE_12523_length_787_cov_12.959302	384	464	4	33	80	0.4125000
NODE_12523_length_787_cov_12.959302	384	464	5	7	80	0.0875000
NODE_12524_length_787_cov_12.748547	426	506	0	80	80	1.0000000
NODE_12524_length_787_cov_12.748547	479	559	0	80	80	1.0000000
NODE_12525_length_787_cov_12.369186	338	418	2	51	80	0.6375000
NODE_12525_length_787_cov_12.369186	338	418	4	16	80	0.2000000
NODE_12525_length_787_cov_12.369186	338	418	6	13	80	0.1625000
NODE_12525_length_787_cov_12.369186	391	471	0	49	80	0.6125000
NODE_12525_length_787_cov_12.369186	391	471	2	31	80	0.3875000
NODE_12526_length_787_cov_9.213663	376	456	0	12	80	0.1500000
NODE_12526_length_787_cov_9.213663	376	456	2	68	80	0.8500000
NODE_12527_length_787_cov_8.857558	344	424	0	23	80	0.2875000
NODE_12527_length_787_cov_8.857558	344	424	2	1	80	0.0125000
NODE_12527_length_787_cov_8.857558	344	424	4	56	80	0.7000000
NODE_12527_length_787_cov_8.857558	397	477	3	8	80	0.1000000
NODE_12527_length_787_cov_8.857558	397	477	4	69	80	0.8625000
NODE_12527_length_787_cov_8.857558	397	477	5	3	80	0.0375000
NODE_12529_length_787_cov_8.186047	508	552	0	44	44	1.0000000
NODE_12541_length_787_cov_2.188953	505	552	0	47	47	1.0000000
NODE_12562_length_786_cov_36.441048	431	511	0	80	80	1.0000000
NODE_12562_length_786_cov_36.441048	484	564	0	80	80	1.0000000
NODE_12563_length_786_cov_23.771470	235	315	0	80	80	1.0000000
NODE_12563_length_786_cov_23.771470	288	368	0	80	80	1.0000000
NODE_12564_length_786_cov_23.333333	361	436	0	25	75	0.3333333
NODE_12564_length_786_cov_23.333333	361	436	2	9	75	0.1200000
NODE_12564_length_786_cov_23.333333	361	436	4	7	75	0.0933333
NODE_12564_length_786_cov_23.333333	361	436	7	16	75	0.2133333
NODE_12564_length_786_cov_23.333333	361	436	9	5	75	0.0666667
NODE_12564_length_786_cov_23.333333	361	436	12	1	75	0.0133333
NODE_12564_length_786_cov_23.333333	361	436	13	1	75	0.0133333
NODE_12564_length_786_cov_23.333333	361	436	14	11	75	0.1466667
NODE_12564_length_786_cov_23.333333	362	436	0	24	74	0.3243243
NODE_12564_length_786_cov_23.333333	362	436	2	9	74	0.1216216
NODE_12564_length_786_cov_23.333333	362	436	4	7	74	0.0945946
NODE_12564_length_786_cov_23.333333	362	436	7	16	74	0.2162162
NODE_12564_length_786_cov_23.333333	362	436	9	5	74	0.0675676
NODE_12564_length_786_cov_23.333333	362	436	12	1	74	0.0135135
NODE_12564_length_786_cov_23.333333	362	436	13	1	74	0.0135135
NODE_12564_length_786_cov_23.333333	362	436	14	11	74	0.1486486
NODE_12564_length_786_cov_23.333333	375	436	0	11	61	0.1803279
NODE_12564_length_786_cov_23.333333	375	436	2	9	61	0.1475410
NODE_12564_length_786_cov_23.333333	375	436	4	7	61	0.1147541
NODE_12564_length_786_cov_23.333333	375	436	7	16	61	0.2622951
NODE_12564_length_786_cov_23.333333	375	436	9	5	61	0.0819672
NODE_12564_length_786_cov_23.333333	375	436	12	1	61	0.0163934
NODE_12564_length_786_cov_23.333333	375	436	13	1	61	0.0163934
NODE_12564_length_786_cov_23.333333	375	436	14	11	61	0.1803279
NODE_12564_length_786_cov_23.333333	414	489	7	4	75	0.0533333
NODE_12564_length_786_cov_23.333333	414	489	9	5	75	0.0666667
NODE_12564_length_786_cov_23.333333	414	489	10	27	75	0.3600000
NODE_12564_length_786_cov_23.333333	414	489	12	5	75	0.0666667
NODE_12564_length_786_cov_23.333333	414	489	13	1	75	0.0133333
NODE_12564_length_786_cov_23.333333	414	489	14	33	75	0.4400000
NODE_12564_length_786_cov_23.333333	414	489	7	4	75	0.0533333
NODE_12564_length_786_cov_23.333333	414	489	9	5	75	0.0666667
NODE_12564_length_786_cov_23.333333	414	489	10	27	75	0.3600000
NODE_12564_length_786_cov_23.333333	414	489	12	5	75	0.0666667
NODE_12564_length_786_cov_23.333333	414	489	13	1	75	0.0133333
NODE_12564_length_786_cov_23.333333	414	489	14	33	75	0.4400000
NODE_12564_length_786_cov_23.333333	414	489	7	4	75	0.0533333
NODE_12564_length_786_cov_23.333333	414	489	9	5	75	0.0666667
NODE_12564_length_786_cov_23.333333	414	489	10	27	75	0.3600000
NODE_12564_length_786_cov_23.333333	414	489	12	5	75	0.0666667
NODE_12564_length_786_cov_23.333333	414	489	13	1	75	0.0133333
NODE_12564_length_786_cov_23.333333	414	489	14	33	75	0.4400000
NODE_12564_length_786_cov_23.333333	490	564	7	1	74	0.0135135
NODE_12564_length_786_cov_23.333333	490	564	8	1	74	0.0135135
NODE_12564_length_786_cov_23.333333	490	564	9	8	74	0.1081081
NODE_12564_length_786_cov_23.333333	490	564	10	13	74	0.1756757
NODE_12564_length_786_cov_23.333333	490	564	12	25	74	0.3378378
NODE_12564_length_786_cov_23.333333	490	564	14	26	74	0.3513514
NODE_12565_length_786_cov_19.279476	310	375	0	17	65	0.2615385
NODE_12565_length_786_cov_19.279476	310	375	2	48	65	0.7384616
NODE_12565_length_786_cov_19.279476	371	441	0	17	70	0.2428571
NODE_12565_length_786_cov_19.279476	371	441	2	53	70	0.7571428
NODE_12565_length_786_cov_19.279476	371	451	0	17	80	0.2125000
NODE_12565_length_786_cov_19.279476	371	451	2	63	80	0.7875000
NODE_12565_length_786_cov_19.279476	424	491	0	38	67	0.5671642
NODE_12565_length_786_cov_19.279476	424	491	2	29	67	0.4328358
NODE_12566_length_786_cov_18.652111	251	331	0	2	80	0.0250000
NODE_12566_length_786_cov_18.652111	251	331	2	78	80	0.9750000
NODE_12566_length_786_cov_18.652111	304	384	0	19	80	0.2375000
NODE_12566_length_786_cov_18.652111	304	384	2	45	80	0.5625000
NODE_12566_length_786_cov_18.652111	304	384	4	16	80	0.2000000
NODE_12567_length_786_cov_16.704512	319	399	0	80	80	1.0000000
NODE_12567_length_786_cov_16.704512	372	452	0	80	80	1.0000000
NODE_12568_length_786_cov_16.254731	378	458	0	19	80	0.2375000
NODE_12568_length_786_cov_16.254731	378	458	2	61	80	0.7625000
NODE_12568_length_786_cov_16.254731	431	511	0	72	80	0.9000000
NODE_12568_length_786_cov_16.254731	431	511	2	8	80	0.1000000
NODE_12571_length_786_cov_10.053857	381	461	0	80	80	1.0000000
NODE_12571_length_786_cov_10.053857	434	514	0	80	80	1.0000000
NODE_12572_length_786_cov_7.455604	400	473	0	73	73	1.0000000
NODE_12572_length_786_cov_7.455604	453	533	0	80	80	1.0000000
NODE_12573_length_786_cov_7.119360	276	356	0	80	80	1.0000000
NODE_12573_length_786_cov_7.119360	329	409	0	80	80	1.0000000
NODE_12575_length_786_cov_6.771470	382	462	0	80	80	1.0000000
NODE_12575_length_786_cov_6.771470	435	515	0	44	80	0.5500000
NODE_12575_length_786_cov_6.771470	435	515	2	36	80	0.4500000
NODE_12603_length_785_cov_83.972303	315	395	0	19	80	0.2375000
NODE_12603_length_785_cov_83.972303	315	395	2	11	80	0.1375000
NODE_12603_length_785_cov_83.972303	315	395	6	50	80	0.6250000
NODE_12603_length_785_cov_83.972303	368	448	0	6	80	0.0750000
NODE_12603_length_785_cov_83.972303	368	448	4	18	80	0.2250000
NODE_12603_length_785_cov_83.972303	368	448	6	56	80	0.7000000
NODE_12604_length_785_cov_33.911079	477	557	4	80	80	1.0000000
NODE_12604_length_785_cov_33.911079	530	610	4	80	80	1.0000000
NODE_12605_length_785_cov_21.174927	265	299	0	34	34	1.0000000
NODE_12605_length_785_cov_21.174927	295	375	0	31	80	0.3875000
NODE_12605_length_785_cov_21.174927	295	375	2	3	80	0.0375000
NODE_12605_length_785_cov_21.174927	295	375	4	25	80	0.3125000
NODE_12605_length_785_cov_21.174927	295	375	8	21	80	0.2625000
NODE_12605_length_785_cov_21.174927	348	428	4	6	80	0.0750000
NODE_12605_length_785_cov_21.174927	348	428	8	37	80	0.4625000
NODE_12605_length_785_cov_21.174927	348	428	10	20	80	0.2500000
NODE_12605_length_785_cov_21.174927	348	428	12	17	80	0.2125000
NODE_12606_length_785_cov_18.612245	291	371	0	80	80	1.0000000
NODE_12606_length_785_cov_18.612245	344	424	0	80	80	1.0000000
NODE_12606_length_785_cov_18.612245	684	705	0	21	21	1.0000000
NODE_12607_length_785_cov_9.893586	153	233	0	16	80	0.2000000
NODE_12607_length_785_cov_9.893586	153	233	2	36	80	0.4500000
NODE_12607_length_785_cov_9.893586	153	233	4	28	80	0.3500000
NODE_12607_length_785_cov_9.893586	206	286	0	69	80	0.8625000
NODE_12607_length_785_cov_9.893586	206	286	2	11	80	0.1375000
NODE_12645_length_784_cov_203.604380	5	85	16	5	80	0.0625000
NODE_12645_length_784_cov_203.604380	5	85	20	5	80	0.0625000
NODE_12645_length_784_cov_203.604380	5	85	23	3	80	0.0375000
NODE_12645_length_784_cov_203.604380	5	85	25	3	80	0.0375000
NODE_12645_length_784_cov_203.604380	5	85	36	2	80	0.0250000
NODE_12645_length_784_cov_203.604380	5	85	38	3	80	0.0375000
NODE_12645_length_784_cov_203.604380	5	85	42	1	80	0.0125000
NODE_12645_length_784_cov_203.604380	5	85	43	3	80	0.0375000
NODE_12645_length_784_cov_203.604380	5	85	45	9	80	0.1125000
NODE_12645_length_784_cov_203.604380	5	85	47	1	80	0.0125000
NODE_12645_length_784_cov_203.604380	5	85	49	1	80	0.0125000
NODE_12645_length_784_cov_203.604380	5	85	51	1	80	0.0125000
NODE_12645_length_784_cov_203.604380	5	85	55	5	80	0.0625000
NODE_12645_length_784_cov_203.604380	5	85	57	30	80	0.3750000
NODE_12645_length_784_cov_203.604380	5	85	58	1	80	0.0125000
NODE_12645_length_784_cov_203.604380	5	85	59	1	80	0.0125000
NODE_12645_length_784_cov_203.604380	5	85	60	3	80	0.0375000
NODE_12645_length_784_cov_203.604380	5	85	64	1	80	0.0125000
NODE_12645_length_784_cov_203.604380	5	85	66	1	80	0.0125000
NODE_12645_length_784_cov_203.604380	5	85	69	1	80	0.0125000
NODE_12645_length_784_cov_203.604380	58	138	57	19	80	0.2375000
NODE_12645_length_784_cov_203.604380	58	138	58	1	80	0.0125000
NODE_12645_length_784_cov_203.604380	58	138	59	1	80	0.0125000
NODE_12645_length_784_cov_203.604380	58	138	60	3	80	0.0375000
NODE_12645_length_784_cov_203.604380	58	138	64	1	80	0.0125000
NODE_12645_length_784_cov_203.604380	58	138	66	1	80	0.0125000
NODE_12645_length_784_cov_203.604380	58	138	68	1	80	0.0125000
NODE_12645_length_784_cov_203.604380	58	138	69	4	80	0.0500000
NODE_12645_length_784_cov_203.604380	58	138	71	1	80	0.0125000
NODE_12645_length_784_cov_203.604380	58	138	72	18	80	0.2250000
NODE_12645_length_784_cov_203.604380	58	138	74	10	80	0.1250000
NODE_12645_length_784_cov_203.604380	58	138	76	5	80	0.0625000
NODE_12645_length_784_cov_203.604380	58	138	78	8	80	0.1000000
NODE_12645_length_784_cov_203.604380	58	138	80	4	80	0.0500000
NODE_12645_length_784_cov_203.604380	58	138	82	3	80	0.0375000
NODE_12646_length_784_cov_45.210219	49	129	0	80	80	1.0000000
NODE_12646_length_784_cov_45.210219	102	182	0	80	80	1.0000000
NODE_12646_length_784_cov_45.210219	218	298	0	80	80	1.0000000
NODE_12646_length_784_cov_45.210219	271	351	0	80	80	1.0000000
NODE_12646_length_784_cov_45.210219	347	427	0	80	80	1.0000000
NODE_12646_length_784_cov_45.210219	347	427	0	80	80	1.0000000
NODE_12646_length_784_cov_45.210219	347	427	0	80	80	1.0000000
NODE_12646_length_784_cov_45.210219	400	447	0	47	47	1.0000000
NODE_12646_length_784_cov_45.210219	400	480	0	80	80	1.0000000
NODE_12646_length_784_cov_45.210219	400	455	0	55	55	1.0000000
NODE_12647_length_784_cov_33.543066	405	485	1	72	80	0.9000000
NODE_12647_length_784_cov_33.543066	405	485	2	8	80	0.1000000
NODE_12647_length_784_cov_33.543066	458	538	0	33	80	0.4125000
NODE_12647_length_784_cov_33.543066	458	538	1	44	80	0.5500000
NODE_12647_length_784_cov_33.543066	458	538	2	3	80	0.0375000
NODE_12648_length_784_cov_21.762044	318	398	0	80	80	1.0000000
NODE_12648_length_784_cov_21.762044	371	451	0	80	80	1.0000000
NODE_12649_length_784_cov_20.583942	286	366	0	45	80	0.5625000
NODE_12649_length_784_cov_20.583942	286	366	1	35	80	0.4375000
NODE_12649_length_784_cov_20.583942	339	419	0	44	80	0.5500000
NODE_12649_length_784_cov_20.583942	339	419	1	36	80	0.4500000
NODE_12649_length_784_cov_20.583942	415	495	0	80	80	1.0000000
NODE_12649_length_784_cov_20.583942	468	548	0	80	80	1.0000000
NODE_12650_length_784_cov_19.448175	217	297	0	76	80	0.9500000
NODE_12650_length_784_cov_19.448175	217	297	2	4	80	0.0500000
NODE_12650_length_784_cov_19.448175	270	350	0	23	80	0.2875000
NODE_12650_length_784_cov_19.448175	270	350	2	57	80	0.7125000
NODE_12652_length_784_cov_12.480292	297	377	2	80	80	1.0000000
NODE_12652_length_784_cov_12.480292	350	430	0	48	80	0.6000000
NODE_12652_length_784_cov_12.480292	350	430	2	32	80	0.4000000
NODE_12653_length_784_cov_9.296350	250	330	0	80	80	1.0000000
NODE_12653_length_784_cov_9.296350	303	383	0	80	80	1.0000000
NODE_12653_length_784_cov_9.296350	379	459	0	75	80	0.9375000
NODE_12653_length_784_cov_9.296350	379	459	2	5	80	0.0625000
NODE_12653_length_784_cov_9.296350	432	512	0	22	80	0.2750000
NODE_12653_length_784_cov_9.296350	432	512	2	58	80	0.7250000
NODE_12654_length_784_cov_6.316788	274	354	0	61	80	0.7625000
NODE_12654_length_784_cov_6.316788	274	354	2	19	80	0.2375000
NODE_12654_length_784_cov_6.316788	327	407	0	8	80	0.1000000
NODE_12654_length_784_cov_6.316788	327	407	2	72	80	0.9000000
NODE_12688_length_783_cov_41.849415	459	539	0	80	80	1.0000000
NODE_12688_length_783_cov_41.849415	512	592	0	80	80	1.0000000
NODE_12689_length_783_cov_39.881579	230	310	0	80	80	1.0000000
NODE_12689_length_783_cov_39.881579	283	363	0	80	80	1.0000000
NODE_12689_length_783_cov_39.881579	359	439	0	57	80	0.7125000
NODE_12689_length_783_cov_39.881579	359	439	4	23	80	0.2875000
NODE_12689_length_783_cov_39.881579	412	492	0	4	80	0.0500000
NODE_12689_length_783_cov_39.881579	412	492	4	76	80	0.9500000
NODE_12690_length_783_cov_35.967836	229	309	0	22	80	0.2750000
NODE_12690_length_783_cov_35.967836	229	309	2	58	80	0.7250000
NODE_12690_length_783_cov_35.967836	282	362	2	80	80	1.0000000
NODE_12691_length_783_cov_28.203216	292	372	0	12	80	0.1500000
NODE_12691_length_783_cov_28.203216	292	372	2	12	80	0.1500000
NODE_12691_length_783_cov_28.203216	292	372	6	35	80	0.4375000
NODE_12691_length_783_cov_28.203216	292	372	8	21	80	0.2625000
NODE_12691_length_783_cov_28.203216	345	425	2	17	80	0.2125000
NODE_12691_length_783_cov_28.203216	345	425	6	12	80	0.1500000
NODE_12691_length_783_cov_28.203216	345	425	8	51	80	0.6375000
NODE_12692_length_783_cov_16.695906	393	473	0	80	80	1.0000000
NODE_12692_length_783_cov_16.695906	446	526	0	80	80	1.0000000
NODE_12693_length_783_cov_15.656433	418	498	0	56	80	0.7000000
NODE_12693_length_783_cov_15.656433	418	498	2	24	80	0.3000000
NODE_12693_length_783_cov_15.656433	471	551	0	45	80	0.5625000
NODE_12693_length_783_cov_15.656433	471	551	1	10	80	0.1250000
NODE_12693_length_783_cov_15.656433	471	551	3	18	80	0.2250000
NODE_12693_length_783_cov_15.656433	471	551	4	7	80	0.0875000
NODE_12694_length_783_cov_14.904971	321	401	4	35	80	0.4375000
NODE_12694_length_783_cov_14.904971	321	401	5	1	80	0.0125000
NODE_12694_length_783_cov_14.904971	321	401	6	10	80	0.1250000
NODE_12694_length_783_cov_14.904971	321	401	7	4	80	0.0500000
NODE_12694_length_783_cov_14.904971	321	401	8	30	80	0.3750000
NODE_12694_length_783_cov_14.904971	374	454	7	16	80	0.2000000
NODE_12694_length_783_cov_14.904971	374	454	8	48	80	0.6000000
NODE_12694_length_783_cov_14.904971	374	454	10	16	80	0.2000000
NODE_12728_length_782_cov_22.461201	347	427	2	80	80	1.0000000
NODE_12728_length_782_cov_22.461201	400	480	0	45	80	0.5625000
NODE_12728_length_782_cov_22.461201	400	480	2	35	80	0.4375000
NODE_12729_length_782_cov_19.163982	306	386	0	80	80	1.0000000
NODE_12729_length_782_cov_19.163982	382	462	0	9	80	0.1125000
NODE_12729_length_782_cov_19.163982	382	462	2	17	80	0.2125000
NODE_12729_length_782_cov_19.163982	382	462	4	54	80	0.6750000
NODE_12729_length_782_cov_19.163982	435	515	2	8	80	0.1000000
NODE_12729_length_782_cov_19.163982	435	515	4	57	80	0.7125000
NODE_12729_length_782_cov_19.163982	435	515	6	15	80	0.1875000
NODE_12730_length_782_cov_19.090776	295	375	0	12	80	0.1500000
NODE_12730_length_782_cov_19.090776	295	375	2	14	80	0.1750000
NODE_12730_length_782_cov_19.090776	295	375	4	54	80	0.6750000
NODE_12730_length_782_cov_19.090776	348	428	0	10	80	0.1250000
NODE_12730_length_782_cov_19.090776	348	428	2	16	80	0.2000000
NODE_12730_length_782_cov_19.090776	348	428	4	54	80	0.6750000
NODE_12731_length_782_cov_13.509517	323	403	0	45	80	0.5625000
NODE_12731_length_782_cov_13.509517	323	403	2	35	80	0.4375000
NODE_12731_length_782_cov_13.509517	376	456	0	11	80	0.1375000
NODE_12731_length_782_cov_13.509517	376	456	2	69	80	0.8625000
NODE_12732_length_782_cov_11.364568	367	447	0	80	80	1.0000000
NODE_12732_length_782_cov_11.364568	420	500	0	80	80	1.0000000
NODE_12735_length_782_cov_7.976574	245	325	0	80	80	1.0000000
NODE_12735_length_782_cov_7.976574	298	378	0	80	80	1.0000000
NODE_12737_length_782_cov_5.500732	384	464	0	80	80	1.0000000
NODE_12737_length_782_cov_5.500732	437	517	0	80	80	1.0000000
NODE_12739_length_782_cov_4.434846	309	389	0	80	80	1.0000000
NODE_12739_length_782_cov_4.434846	362	442	0	52	80	0.6500000
NODE_12739_length_782_cov_4.434846	362	442	2	28	80	0.3500000
NODE_12740_length_782_cov_3.352855	177	196	10	19	19	1.0000000
NODE_12741_length_782_cov_3.231332	160	240	0	1	80	0.0125000
NODE_12741_length_782_cov_3.231332	160	240	1	3	80	0.0375000
NODE_12741_length_782_cov_3.231332	160	240	2	76	80	0.9500000
NODE_12741_length_782_cov_3.231332	213	298	0	59	85	0.6941177
NODE_12741_length_782_cov_3.231332	213	298	1	3	85	0.0352941
NODE_12741_length_782_cov_3.231332	213	298	2	23	85	0.2705882
NODE_12765_length_781_cov_34.247801	174	254	0	80	80	1.0000000
NODE_12765_length_781_cov_34.247801	227	307	0	80	80	1.0000000
NODE_12766_length_781_cov_27.530792	490	570	2	6	80	0.0750000
NODE_12766_length_781_cov_27.530792	490	570	4	56	80	0.7000000
NODE_12766_length_781_cov_27.530792	490	570	6	18	80	0.2250000
NODE_12766_length_781_cov_27.530792	543	623	2	18	80	0.2250000
NODE_12766_length_781_cov_27.530792	543	623	4	57	80	0.7125000
NODE_12766_length_781_cov_27.530792	543	623	6	5	80	0.0625000
NODE_12766_length_781_cov_27.530792	619	699	0	18	80	0.2250000
NODE_12766_length_781_cov_27.530792	619	699	2	6	80	0.0750000
NODE_12766_length_781_cov_27.530792	619	699	4	56	80	0.7000000
NODE_12766_length_781_cov_27.530792	672	752	0	71	80	0.8875000
NODE_12766_length_781_cov_27.530792	672	752	2	6	80	0.0750000
NODE_12766_length_781_cov_27.530792	672	752	4	3	80	0.0375000
NODE_12767_length_781_cov_22.768328	427	507	0	80	80	1.0000000
NODE_12767_length_781_cov_22.768328	480	560	0	80	80	1.0000000
NODE_12768_length_781_cov_17.894428	411	491	0	24	80	0.3000000
NODE_12768_length_781_cov_17.894428	411	491	2	56	80	0.7000000
NODE_12768_length_781_cov_17.894428	464	544	0	14	80	0.1750000
NODE_12768_length_781_cov_17.894428	464	544	2	66	80	0.8250000
NODE_12769_length_781_cov_14.922287	486	565	0	37	79	0.4683544
NODE_12769_length_781_cov_14.922287	486	565	2	42	79	0.5316456
NODE_12769_length_781_cov_14.922287	538	618	0	6	80	0.0750000
NODE_12769_length_781_cov_14.922287	538	618	2	74	80	0.9250000
NODE_12770_length_781_cov_12.529326	318	398	4	67	80	0.8375000
NODE_12770_length_781_cov_12.529326	318	398	6	13	80	0.1625000
NODE_12770_length_781_cov_12.529326	371	451	2	23	80	0.2875000
NODE_12770_length_781_cov_12.529326	371	451	4	57	80	0.7125000
NODE_12771_length_781_cov_10.303519	444	524	6	2	80	0.0250000
NODE_12771_length_781_cov_10.303519	444	524	8	33	80	0.4125000
NODE_12771_length_781_cov_10.303519	444	524	10	4	80	0.0500000
NODE_12771_length_781_cov_10.303519	444	524	12	41	80	0.5125000
NODE_12772_length_781_cov_9.851906	374	454	0	80	80	1.0000000
NODE_12772_length_781_cov_9.851906	427	507	0	80	80	1.0000000
NODE_12775_length_781_cov_8.557185	113	194	0	81	81	1.0000000
NODE_12775_length_781_cov_8.557185	166	239	0	73	73	1.0000000
NODE_12778_length_781_cov_4.734604	30	110	0	77	80	0.9625000
NODE_12778_length_781_cov_4.734604	30	110	2	3	80	0.0375000
NODE_12778_length_781_cov_4.734604	83	163	0	24	80	0.3000000
NODE_12778_length_781_cov_4.734604	83	163	2	56	80	0.7000000
NODE_12780_length_781_cov_4.077713	269	349	0	6	80	0.0750000
NODE_12780_length_781_cov_4.077713	269	349	4	74	80	0.9250000
NODE_12780_length_781_cov_4.077713	322	402	0	37	80	0.4625000
NODE_12780_length_781_cov_4.077713	322	402	4	43	80	0.5375000
NODE_12812_length_780_cov_37.693098	165	245	0	10	80	0.1250000
NODE_12812_length_780_cov_37.693098	165	245	3	1	80	0.0125000
NODE_12812_length_780_cov_37.693098	165	245	4	38	80	0.4750000
NODE_12812_length_780_cov_37.693098	165	245	6	12	80	0.1500000
NODE_12812_length_780_cov_37.693098	165	245	8	4	80	0.0500000
NODE_12812_length_780_cov_37.693098	165	245	9	1	80	0.0125000
NODE_12812_length_780_cov_37.693098	165	245	10	4	80	0.0500000
NODE_12812_length_780_cov_37.693098	165	245	12	10	80	0.1250000
NODE_12812_length_780_cov_37.693098	218	298	6	8	80	0.1000000
NODE_12812_length_780_cov_37.693098	218	298	8	4	80	0.0500000
NODE_12812_length_780_cov_37.693098	218	298	9	1	80	0.0125000
NODE_12812_length_780_cov_37.693098	218	298	10	4	80	0.0500000
NODE_12812_length_780_cov_37.693098	218	298	12	63	80	0.7875000
NODE_12813_length_780_cov_22.132159	407	487	0	8	80	0.1000000
NODE_12813_length_780_cov_22.132159	407	487	1	67	80	0.8375000
NODE_12813_length_780_cov_22.132159	407	487	2	5	80	0.0625000
NODE_12813_length_780_cov_22.132159	460	540	1	22	80	0.2750000
NODE_12813_length_780_cov_22.132159	460	540	2	58	80	0.7250000
NODE_12814_length_780_cov_21.831131	299	379	0	58	80	0.7250000
NODE_12814_length_780_cov_21.831131	299	379	2	22	80	0.2750000
NODE_12814_length_780_cov_21.831131	352	432	0	5	80	0.0625000
NODE_12814_length_780_cov_21.831131	352	432	2	75	80	0.9375000
NODE_12815_length_780_cov_16.722467	165	245	0	80	80	1.0000000
NODE_12815_length_780_cov_16.722467	218	298	0	80	80	1.0000000
NODE_12816_length_780_cov_13.189427	150	254	0	104	104	1.0000000
NODE_12816_length_780_cov_13.189427	227	307	0	80	80	1.0000000
NODE_12817_length_780_cov_12.910426	276	356	2	80	80	1.0000000
NODE_12817_length_780_cov_12.910426	329	409	0	42	80	0.5250000
NODE_12817_length_780_cov_12.910426	329	409	2	38	80	0.4750000
NODE_12818_length_780_cov_8.455213	141	221	0	42	80	0.5250000
NODE_12818_length_780_cov_8.455213	141	221	2	7	80	0.0875000
NODE_12818_length_780_cov_8.455213	141	221	4	31	80	0.3875000
NODE_12818_length_780_cov_8.455213	194	274	0	12	80	0.1500000
NODE_12818_length_780_cov_8.455213	194	274	2	1	80	0.0125000
NODE_12818_length_780_cov_8.455213	194	274	4	67	80	0.8375000
NODE_12848_length_779_cov_51.022059	8	43	2	2	35	0.0571429
NODE_12848_length_779_cov_51.022059	8	43	4	1	35	0.0285714
NODE_12848_length_779_cov_51.022059	8	43	6	2	35	0.0571429
NODE_12848_length_779_cov_51.022059	8	43	8	30	35	0.8571429
NODE_12848_length_779_cov_51.022059	53	96	8	43	43	1.0000000
NODE_12848_length_779_cov_51.022059	97	177	0	15	80	0.1875000
NODE_12848_length_779_cov_51.022059	97	177	2	53	80	0.6625000
NODE_12848_length_779_cov_51.022059	97	177	4	2	80	0.0250000
NODE_12848_length_779_cov_51.022059	97	177	6	2	80	0.0250000
NODE_12848_length_779_cov_51.022059	97	177	8	8	80	0.1000000
NODE_12848_length_779_cov_51.022059	150	230	2	38	80	0.4750000
NODE_12848_length_779_cov_51.022059	150	230	3	3	80	0.0375000
NODE_12848_length_779_cov_51.022059	150	230	4	39	80	0.4875000
NODE_12849_length_779_cov_23.682353	362	442	0	55	80	0.6875000
NODE_12849_length_779_cov_23.682353	362	442	2	15	80	0.1875000
NODE_12849_length_779_cov_23.682353	362	442	4	10	80	0.1250000
NODE_12849_length_779_cov_23.682353	415	495	0	2	80	0.0250000
NODE_12849_length_779_cov_23.682353	415	495	2	39	80	0.4875000
NODE_12849_length_779_cov_23.682353	415	495	4	39	80	0.4875000
NODE_12850_length_779_cov_15.994118	320	400	0	80	80	1.0000000
NODE_12850_length_779_cov_15.994118	373	453	0	80	80	1.0000000
NODE_12851_length_779_cov_14.386765	258	320	8	5	62	0.0806452
NODE_12851_length_779_cov_14.386765	258	320	10	5	62	0.0806452
NODE_12851_length_779_cov_14.386765	258	320	16	2	62	0.0322581
NODE_12851_length_779_cov_14.386765	258	320	20	32	62	0.5161290
NODE_12851_length_779_cov_14.386765	258	320	22	15	62	0.2419355
NODE_12851_length_779_cov_14.386765	258	320	24	3	62	0.0483871
NODE_12851_length_779_cov_14.386765	293	368	20	10	75	0.1333333
NODE_12851_length_779_cov_14.386765	293	368	21	1	75	0.0133333
NODE_12851_length_779_cov_14.386765	293	368	22	22	75	0.2933333
NODE_12851_length_779_cov_14.386765	293	368	24	41	75	0.5466667
NODE_12851_length_779_cov_14.386765	293	368	26	1	75	0.0133333
NODE_12851_length_779_cov_14.386765	369	443	18	15	74	0.2027027
NODE_12851_length_779_cov_14.386765	369	443	20	7	74	0.0945946
NODE_12851_length_779_cov_14.386765	369	443	22	9	74	0.1216216
NODE_12851_length_779_cov_14.386765	369	443	24	11	74	0.1486486
NODE_12851_length_779_cov_14.386765	369	443	26	4	74	0.0540541
NODE_12851_length_779_cov_14.386765	369	443	28	26	74	0.3513514
NODE_12851_length_779_cov_14.386765	369	443	30	2	74	0.0270270
NODE_12852_length_779_cov_11.861765	180	263	0	83	83	1.0000000
NODE_12852_length_779_cov_11.861765	236	316	0	30	80	0.3750000
NODE_12852_length_779_cov_11.861765	236	316	2	50	80	0.6250000
NODE_12852_length_779_cov_11.861765	312	392	0	6	80	0.0750000
NODE_12852_length_779_cov_11.861765	312	392	2	74	80	0.9250000
NODE_12852_length_779_cov_11.861765	365	445	0	59	80	0.7375000
NODE_12852_length_779_cov_11.861765	365	445	2	21	80	0.2625000
NODE_12853_length_779_cov_11.735294	285	365	0	80	80	1.0000000
NODE_12853_length_779_cov_11.735294	338	418	0	80	80	1.0000000
NODE_12854_length_779_cov_7.211765	333	413	0	80	80	1.0000000
NODE_12854_length_779_cov_7.211765	386	466	0	80	80	1.0000000
NODE_12857_length_779_cov_5.611765	271	351	0	80	80	1.0000000
NODE_12857_length_779_cov_5.611765	324	404	0	80	80	1.0000000
NODE_12859_length_779_cov_4.695588	216	296	2	80	80	1.0000000
NODE_12859_length_779_cov_4.695588	269	349	2	46	80	0.5750000
NODE_12859_length_779_cov_4.695588	269	349	3	1	80	0.0125000
NODE_12859_length_779_cov_4.695588	269	349	4	33	80	0.4125000
NODE_12863_length_779_cov_2.329412	615	672	4	57	57	1.0000000
NODE_12883_length_778_cov_21.615611	325	405	0	20	80	0.2500000
NODE_12883_length_778_cov_21.615611	325	405	2	60	80	0.7500000
NODE_12883_length_778_cov_21.615611	378	458	0	12	80	0.1500000
NODE_12883_length_778_cov_21.615611	378	458	2	68	80	0.8500000
NODE_12884_length_778_cov_19.549337	348	428	0	80	80	1.0000000
NODE_12884_length_778_cov_19.549337	401	481	0	80	80	1.0000000
NODE_12885_length_778_cov_15.403535	312	392	2	8	80	0.1000000
NODE_12885_length_778_cov_15.403535	312	392	4	14	80	0.1750000
NODE_12885_length_778_cov_15.403535	312	392	6	58	80	0.7250000
NODE_12885_length_778_cov_15.403535	365	445	0	15	80	0.1875000
NODE_12885_length_778_cov_15.403535	365	445	2	1	80	0.0125000
NODE_12885_length_778_cov_15.403535	365	445	4	33	80	0.4125000
NODE_12885_length_778_cov_15.403535	365	445	6	31	80	0.3875000
NODE_12886_length_778_cov_14.614138	101	181	0	80	80	1.0000000
NODE_12886_length_778_cov_14.614138	154	234	0	80	80	1.0000000
NODE_12887_length_778_cov_13.368189	256	336	0	32	80	0.4000000
NODE_12887_length_778_cov_13.368189	256	336	2	48	80	0.6000000
NODE_12887_length_778_cov_13.368189	309	389	0	6	80	0.0750000
NODE_12887_length_778_cov_13.368189	309	389	2	74	80	0.9250000
NODE_12891_length_778_cov_6.307806	349	429	1	67	80	0.8375000
NODE_12891_length_778_cov_6.307806	349	429	2	13	80	0.1625000
NODE_12891_length_778_cov_6.307806	402	482	1	75	80	0.9375000
NODE_12891_length_778_cov_6.307806	402	482	2	5	80	0.0625000
NODE_12893_length_778_cov_5.985272	385	465	0	80	80	1.0000000
NODE_12893_length_778_cov_5.985272	438	518	0	80	80	1.0000000
NODE_12928_length_777_cov_25.504425	323	403	0	80	80	1.0000000
NODE_12928_length_777_cov_25.504425	376	456	0	80	80	1.0000000
NODE_12929_length_777_cov_25.410029	346	426	0	15	80	0.1875000
NODE_12929_length_777_cov_25.410029	346	426	2	65	80	0.8125000
NODE_12929_length_777_cov_25.410029	399	479	0	28	80	0.3500000
NODE_12929_length_777_cov_25.410029	399	479	2	52	80	0.6500000
NODE_12930_length_777_cov_25.333333	97	177	0	10	80	0.1250000
NODE_12930_length_777_cov_25.333333	97	177	1	70	80	0.8750000
NODE_12930_length_777_cov_25.333333	150	230	0	51	80	0.6375000
NODE_12930_length_777_cov_25.333333	150	230	1	29	80	0.3625000
NODE_12931_length_777_cov_21.600295	408	485	0	77	77	1.0000000
NODE_12931_length_777_cov_21.600295	458	538	0	80	80	1.0000000
NODE_12932_length_777_cov_19.561947	343	423	1	80	80	1.0000000
NODE_12932_length_777_cov_19.561947	396	476	1	69	80	0.8625000
NODE_12932_length_777_cov_19.561947	396	476	2	11	80	0.1375000
NODE_12933_length_777_cov_16.961652	264	344	0	23	80	0.2875000
NODE_12933_length_777_cov_16.961652	264	344	2	16	80	0.2000000
NODE_12933_length_777_cov_16.961652	264	344	4	3	80	0.0375000
NODE_12933_length_777_cov_16.961652	264	344	8	38	80	0.4750000
NODE_12933_length_777_cov_16.961652	317	397	0	3	80	0.0375000
NODE_12933_length_777_cov_16.961652	317	397	3	1	80	0.0125000
NODE_12933_length_777_cov_16.961652	317	397	4	15	80	0.1875000
NODE_12933_length_777_cov_16.961652	317	397	6	3	80	0.0375000
NODE_12933_length_777_cov_16.961652	317	397	8	58	80	0.7250000
NODE_12934_length_777_cov_16.081121	299	379	12	6	80	0.0750000
NODE_12934_length_777_cov_16.081121	299	379	14	2	80	0.0250000
NODE_12934_length_777_cov_16.081121	299	379	16	15	80	0.1875000
NODE_12934_length_777_cov_16.081121	299	379	17	10	80	0.1250000
NODE_12934_length_777_cov_16.081121	299	379	18	47	80	0.5875000
NODE_12934_length_777_cov_16.081121	352	432	4	20	80	0.2500000
NODE_12934_length_777_cov_16.081121	352	432	6	6	80	0.0750000
NODE_12934_length_777_cov_16.081121	352	432	8	3	80	0.0375000
NODE_12934_length_777_cov_16.081121	352	432	12	6	80	0.0750000
NODE_12934_length_777_cov_16.081121	352	432	14	2	80	0.0250000
NODE_12934_length_777_cov_16.081121	352	432	16	3	80	0.0375000
NODE_12934_length_777_cov_16.081121	352	432	17	28	80	0.3500000
NODE_12934_length_777_cov_16.081121	352	432	18	12	80	0.1500000
NODE_12935_length_777_cov_13.827434	380	460	2	42	80	0.5250000
NODE_12935_length_777_cov_13.827434	380	460	4	38	80	0.4750000
NODE_12935_length_777_cov_13.827434	433	513	0	12	80	0.1500000
NODE_12935_length_777_cov_13.827434	433	513	1	13	80	0.1625000
NODE_12935_length_777_cov_13.827434	433	513	2	55	80	0.6875000
NODE_12936_length_777_cov_12.497050	413	493	0	30	80	0.3750000
NODE_12936_length_777_cov_12.497050	413	493	2	50	80	0.6250000
NODE_12936_length_777_cov_12.497050	466	546	2	80	80	1.0000000
NODE_12937_length_777_cov_10.787611	213	286	0	59	73	0.8082192
NODE_12937_length_777_cov_10.787611	213	286	2	14	73	0.1917808
NODE_12938_length_777_cov_8.530973	362	422	0	30	60	0.5000000
NODE_12938_length_777_cov_8.530973	362	422	2	30	60	0.5000000
NODE_12939_length_777_cov_7.634218	79	159	0	80	80	1.0000000
NODE_12939_length_777_cov_7.634218	132	212	0	80	80	1.0000000
NODE_12940_length_777_cov_6.963127	256	336	0	80	80	1.0000000
NODE_12940_length_777_cov_6.963127	309	389	0	80	80	1.0000000
NODE_12941_length_777_cov_6.417404	565	638	0	73	73	1.0000000
NODE_12942_length_777_cov_5.868732	443	523	1	12	80	0.1500000
NODE_12942_length_777_cov_5.868732	443	523	2	68	80	0.8500000
NODE_12942_length_777_cov_5.868732	496	576	1	65	80	0.8125000
NODE_12942_length_777_cov_5.868732	496	576	2	15	80	0.1875000
NODE_12971_length_776_cov_81.002954	237	317	0	66	80	0.8250000
NODE_12971_length_776_cov_81.002954	237	317	3	1	80	0.0125000
NODE_12971_length_776_cov_81.002954	237	317	10	1	80	0.0125000
NODE_12971_length_776_cov_81.002954	237	317	13	2	80	0.0250000
NODE_12971_length_776_cov_81.002954	237	317	14	1	80	0.0125000
NODE_12971_length_776_cov_81.002954	237	317	24	1	80	0.0125000
NODE_12971_length_776_cov_81.002954	237	317	26	2	80	0.0250000
NODE_12971_length_776_cov_81.002954	237	317	34	1	80	0.0125000
NODE_12971_length_776_cov_81.002954	237	317	37	1	80	0.0125000
NODE_12971_length_776_cov_81.002954	237	317	39	2	80	0.0250000
NODE_12971_length_776_cov_81.002954	237	317	41	2	80	0.0250000
NODE_12971_length_776_cov_81.002954	290	370	0	80	80	1.0000000
NODE_12972_length_776_cov_40.502216	345	425	6	9	80	0.1125000
NODE_12972_length_776_cov_40.502216	345	425	8	71	80	0.8875000
NODE_12972_length_776_cov_40.502216	398	478	0	33	80	0.4125000
NODE_12972_length_776_cov_40.502216	398	478	2	14	80	0.1750000
NODE_12972_length_776_cov_40.502216	398	478	5	1	80	0.0125000
NODE_12972_length_776_cov_40.502216	398	478	8	32	80	0.4000000
NODE_12973_length_776_cov_34.921713	204	284	2	71	80	0.8875000
NODE_12973_length_776_cov_34.921713	204	284	4	9	80	0.1125000
NODE_12973_length_776_cov_34.921713	257	337	0	6	80	0.0750000
NODE_12973_length_776_cov_34.921713	257	337	2	74	80	0.9250000
NODE_12974_length_776_cov_29.998523	177	257	2	54	80	0.6750000
NODE_12974_length_776_cov_29.998523	177	257	4	4	80	0.0500000
NODE_12974_length_776_cov_29.998523	177	257	6	22	80	0.2750000
NODE_12974_length_776_cov_29.998523	230	310	2	17	80	0.2125000
NODE_12974_length_776_cov_29.998523	230	310	4	36	80	0.4500000
NODE_12974_length_776_cov_29.998523	230	310	6	27	80	0.3375000
NODE_12975_length_776_cov_25.683900	417	497	3	35	80	0.4375000
NODE_12975_length_776_cov_25.683900	417	497	4	45	80	0.5625000
NODE_12975_length_776_cov_25.683900	470	550	1	22	80	0.2750000
NODE_12975_length_776_cov_25.683900	470	550	2	18	80	0.2250000
NODE_12975_length_776_cov_25.683900	470	550	4	40	80	0.5000000
NODE_12976_length_776_cov_22.276219	367	447	0	4	80	0.0500000
NODE_12976_length_776_cov_22.276219	367	447	2	76	80	0.9500000
NODE_12976_length_776_cov_22.276219	420	500	0	28	80	0.3500000
NODE_12976_length_776_cov_22.276219	420	500	2	52	80	0.6500000
NODE_12977_length_776_cov_19.574594	242	322	0	58	80	0.7250000
NODE_12977_length_776_cov_19.574594	242	322	2	20	80	0.2500000
NODE_12977_length_776_cov_19.574594	242	322	4	2	80	0.0250000
NODE_12977_length_776_cov_19.574594	295	375	0	5	80	0.0625000
NODE_12977_length_776_cov_19.574594	295	375	2	20	80	0.2500000
NODE_12977_length_776_cov_19.574594	295	375	4	55	80	0.6875000
NODE_12978_length_776_cov_18.262925	384	464	1	34	80	0.4250000
NODE_12978_length_776_cov_18.262925	384	464	2	46	80	0.5750000
NODE_12978_length_776_cov_18.262925	437	517	1	80	80	1.0000000
NODE_12979_length_776_cov_16.023634	334	414	2	63	80	0.7875000
NODE_12979_length_776_cov_16.023634	334	414	4	17	80	0.2125000
NODE_12979_length_776_cov_16.023634	387	467	0	40	80	0.5000000
NODE_12979_length_776_cov_16.023634	387	467	2	40	80	0.5000000
NODE_12980_length_776_cov_15.841950	282	362	0	74	80	0.9250000
NODE_12980_length_776_cov_15.841950	282	362	2	6	80	0.0750000
NODE_12980_length_776_cov_15.841950	335	415	0	21	80	0.2625000
NODE_12980_length_776_cov_15.841950	335	415	2	59	80	0.7375000
NODE_12981_length_776_cov_14.131462	240	320	0	80	80	1.0000000
NODE_12981_length_776_cov_14.131462	293	373	0	80	80	1.0000000
NODE_12981_length_776_cov_14.131462	369	449	0	80	80	1.0000000
NODE_12981_length_776_cov_14.131462	422	502	0	80	80	1.0000000
NODE_12983_length_776_cov_13.890694	302	382	0	12	80	0.1500000
NODE_12983_length_776_cov_13.890694	302	382	2	17	80	0.2125000
NODE_12983_length_776_cov_13.890694	302	382	4	51	80	0.6375000
NODE_12983_length_776_cov_13.890694	355	435	2	19	80	0.2375000
NODE_12983_length_776_cov_13.890694	355	435	4	61	80	0.7625000
NODE_12984_length_776_cov_12.097489	488	568	0	80	80	1.0000000
NODE_12984_length_776_cov_12.097489	541	621	0	80	80	1.0000000
NODE_12985_length_776_cov_11.923191	422	498	0	76	76	1.0000000
NODE_12985_length_776_cov_11.923191	475	551	0	76	76	1.0000000
NODE_12986_length_776_cov_11.163959	312	392	0	80	80	1.0000000
NODE_12986_length_776_cov_11.163959	365	445	0	80	80	1.0000000
NODE_12987_length_776_cov_9.754801	370	450	0	80	80	1.0000000
NODE_12987_length_776_cov_9.754801	423	503	0	80	80	1.0000000
NODE_12989_length_776_cov_8.271787	332	412	4	15	80	0.1875000
NODE_12989_length_776_cov_8.271787	332	412	5	37	80	0.4625000
NODE_12989_length_776_cov_8.271787	332	412	6	28	80	0.3500000
NODE_12989_length_776_cov_8.271787	385	465	0	36	80	0.4500000
NODE_12989_length_776_cov_8.271787	385	465	2	2	80	0.0250000
NODE_12989_length_776_cov_8.271787	385	465	4	30	80	0.3750000
NODE_12989_length_776_cov_8.271787	385	465	5	12	80	0.1500000
NODE_12990_length_776_cov_4.874446	330	410	0	80	80	1.0000000
NODE_12990_length_776_cov_4.874446	383	463	0	80	80	1.0000000
NODE_13022_length_775_cov_33.612426	372	452	0	3	80	0.0375000
NODE_13022_length_775_cov_33.612426	372	452	4	25	80	0.3125000
NODE_13022_length_775_cov_33.612426	372	452	6	52	80	0.6500000
NODE_13022_length_775_cov_33.612426	425	505	0	17	80	0.2125000
NODE_13022_length_775_cov_33.612426	425	505	4	13	80	0.1625000
NODE_13022_length_775_cov_33.612426	425	505	6	50	80	0.6250000
NODE_13023_length_775_cov_25.500000	361	434	0	17	73	0.2328767
NODE_13023_length_775_cov_25.500000	361	434	2	56	73	0.7671233
NODE_13023_length_775_cov_25.500000	413	487	0	1	74	0.0135135
NODE_13023_length_775_cov_25.500000	413	487	2	73	74	0.9864865
NODE_13024_length_775_cov_24.128698	220	300	0	80	80	1.0000000
NODE_13024_length_775_cov_24.128698	273	353	0	80	80	1.0000000
NODE_13026_length_775_cov_16.165680	358	438	0	39	80	0.4875000
NODE_13026_length_775_cov_16.165680	358	438	1	7	80	0.0875000
NODE_13026_length_775_cov_16.165680	358	438	2	34	80	0.4250000
NODE_13026_length_775_cov_16.165680	411	491	2	80	80	1.0000000
NODE_13027_length_775_cov_8.522189	440	520	0	16	80	0.2000000
NODE_13027_length_775_cov_8.522189	440	520	2	16	80	0.2000000
NODE_13027_length_775_cov_8.522189	440	520	4	48	80	0.6000000
NODE_13027_length_775_cov_8.522189	493	573	0	17	80	0.2125000
NODE_13027_length_775_cov_8.522189	493	573	2	10	80	0.1250000
NODE_13027_length_775_cov_8.522189	493	573	4	53	80	0.6625000
NODE_13028_length_775_cov_8.258876	247	327	0	11	80	0.1375000
NODE_13028_length_775_cov_8.258876	247	327	2	69	80	0.8625000
NODE_13028_length_775_cov_8.258876	300	380	0	64	80	0.8000000
NODE_13028_length_775_cov_8.258876	300	380	2	16	80	0.2000000
NODE_13031_length_775_cov_3.786982	299	379	0	73	80	0.9125000
NODE_13031_length_775_cov_3.786982	299	379	2	7	80	0.0875000
NODE_13031_length_775_cov_3.786982	352	432	0	80	80	1.0000000
NODE_13059_length_774_cov_27.386667	433	514	0	17	81	0.2098765
NODE_13059_length_774_cov_27.386667	433	514	4	35	81	0.4320988
NODE_13059_length_774_cov_27.386667	433	514	6	29	81	0.3580247
NODE_13059_length_774_cov_27.386667	487	567	2	9	80	0.1125000
NODE_13059_length_774_cov_27.386667	487	567	6	71	80	0.8875000
NODE_13060_length_774_cov_19.721481	239	319	0	6	80	0.0750000
NODE_13060_length_774_cov_19.721481	239	319	2	40	80	0.5000000
NODE_13060_length_774_cov_19.721481	239	319	6	9	80	0.1125000
NODE_13060_length_774_cov_19.721481	239	319	8	25	80	0.3125000
NODE_13060_length_774_cov_19.721481	292	372	6	43	80	0.5375000
NODE_13060_length_774_cov_19.721481	292	372	8	37	80	0.4625000
NODE_13063_length_774_cov_4.594074	216	294	6	23	78	0.2948718
NODE_13063_length_774_cov_4.594074	216	294	8	55	78	0.7051282
NODE_13063_length_774_cov_4.594074	269	347	0	18	78	0.2307692
NODE_13063_length_774_cov_4.594074	269	347	2	25	78	0.3205128
NODE_13063_length_774_cov_4.594074	269	347	8	35	78	0.4487180
NODE_13063_length_774_cov_4.594074	405	485	0	8	80	0.1000000
NODE_13063_length_774_cov_4.594074	405	485	2	72	80	0.9000000
NODE_13103_length_773_cov_60.566766	249	328	2	29	79	0.3670886
NODE_13103_length_773_cov_60.566766	249	328	4	50	79	0.6329114
NODE_13103_length_773_cov_60.566766	304	381	0	33	77	0.4285714
NODE_13103_length_773_cov_60.566766	304	381	2	44	77	0.5714286
NODE_13104_length_773_cov_27.299703	230	310	0	15	80	0.1875000
NODE_13104_length_773_cov_27.299703	230	310	2	50	80	0.6250000
NODE_13104_length_773_cov_27.299703	230	310	4	15	80	0.1875000
NODE_13104_length_773_cov_27.299703	283	363	2	12	80	0.1500000
NODE_13104_length_773_cov_27.299703	283	363	4	68	80	0.8500000
NODE_13105_length_773_cov_24.250742	392	470	4	32	78	0.4102564
NODE_13105_length_773_cov_24.250742	392	470	6	46	78	0.5897436
NODE_13105_length_773_cov_24.250742	443	523	0	31	80	0.3875000
NODE_13105_length_773_cov_24.250742	443	523	2	13	80	0.1625000
NODE_13105_length_773_cov_24.250742	443	523	4	7	80	0.0875000
NODE_13105_length_773_cov_24.250742	443	523	6	29	80	0.3625000
NODE_13106_length_773_cov_20.683976	367	447	4	80	80	1.0000000
NODE_13106_length_773_cov_20.683976	420	500	0	49	80	0.6125000
NODE_13106_length_773_cov_20.683976	420	500	4	31	80	0.3875000
NODE_13107_length_773_cov_18.498516	248	328	4	7	80	0.0875000
NODE_13107_length_773_cov_18.498516	248	328	8	13	80	0.1625000
NODE_13107_length_773_cov_18.498516	248	328	10	21	80	0.2625000
NODE_13107_length_773_cov_18.498516	248	328	11	17	80	0.2125000
NODE_13107_length_773_cov_18.498516	248	328	12	22	80	0.2750000
NODE_13107_length_773_cov_18.498516	301	381	2	2	80	0.0250000
NODE_13107_length_773_cov_18.498516	301	381	6	12	80	0.1500000
NODE_13107_length_773_cov_18.498516	301	381	8	7	80	0.0875000
NODE_13107_length_773_cov_18.498516	301	381	9	11	80	0.1375000
NODE_13107_length_773_cov_18.498516	301	381	10	8	80	0.1000000
NODE_13107_length_773_cov_18.498516	301	381	11	19	80	0.2375000
NODE_13107_length_773_cov_18.498516	301	381	12	21	80	0.2625000
NODE_13108_length_773_cov_14.063798	405	485	0	9	80	0.1125000
NODE_13108_length_773_cov_14.063798	405	485	6	71	80	0.8875000
NODE_13108_length_773_cov_14.063798	458	538	0	62	80	0.7750000
NODE_13108_length_773_cov_14.063798	458	538	6	18	80	0.2250000
NODE_13109_length_773_cov_12.482196	421	501	0	6	80	0.0750000
NODE_13109_length_773_cov_12.482196	421	501	2	73	80	0.9125000
NODE_13109_length_773_cov_12.482196	421	501	4	1	80	0.0125000
NODE_13109_length_773_cov_12.482196	474	554	2	56	80	0.7000000
NODE_13109_length_773_cov_12.482196	474	554	4	24	80	0.3000000
NODE_13114_length_773_cov_9.136499	214	294	0	80	80	1.0000000
NODE_13114_length_773_cov_9.136499	267	347	0	50	80	0.6250000
NODE_13114_length_773_cov_9.136499	267	347	2	30	80	0.3750000
NODE_13115_length_773_cov_8.609792	461	541	2	20	80	0.2500000
NODE_13115_length_773_cov_8.609792	461	541	4	60	80	0.7500000
NODE_13115_length_773_cov_8.609792	514	594	0	24	80	0.3000000
NODE_13115_length_773_cov_8.609792	514	594	2	34	80	0.4250000
NODE_13115_length_773_cov_8.609792	514	594	4	22	80	0.2750000
NODE_13116_length_773_cov_7.224036	200	280	0	80	80	1.0000000
NODE_13116_length_773_cov_7.224036	253	333	0	80	80	1.0000000
NODE_13117_length_773_cov_6.910979	522	615	0	90	93	0.9677419
NODE_13117_length_773_cov_6.910979	522	615	2	3	93	0.0322581
NODE_13117_length_773_cov_6.910979	588	668	0	80	80	1.0000000
NODE_13147_length_772_cov_28.044577	231	311	0	80	80	1.0000000
NODE_13147_length_772_cov_28.044577	284	364	0	80	80	1.0000000
NODE_13149_length_772_cov_9.523031	288	368	0	80	80	1.0000000
NODE_13149_length_772_cov_9.523031	341	421	0	80	80	1.0000000
NODE_13150_length_772_cov_8.778603	133	213	0	25	80	0.3125000
NODE_13150_length_772_cov_8.778603	133	213	2	10	80	0.1250000
NODE_13150_length_772_cov_8.778603	133	213	4	45	80	0.5625000
NODE_13150_length_772_cov_8.778603	186	266	4	80	80	1.0000000
NODE_13151_length_772_cov_7.921248	351	431	0	80	80	1.0000000
NODE_13151_length_772_cov_7.921248	404	480	0	73	76	0.9605263
NODE_13151_length_772_cov_7.921248	404	480	2	3	76	0.0394737
NODE_13152_length_772_cov_7.059435	276	356	0	80	80	1.0000000
NODE_13152_length_772_cov_7.059435	329	409	0	38	80	0.4750000
NODE_13152_length_772_cov_7.059435	329	409	2	42	80	0.5250000
NODE_13153_length_772_cov_5.536404	269	299	0	30	30	1.0000000
NODE_13153_length_772_cov_5.536404	272	341	0	68	69	0.9855072
NODE_13153_length_772_cov_5.536404	272	341	2	1	69	0.0144928
NODE_13156_length_772_cov_4.838039	430	510	0	80	80	1.0000000
NODE_13156_length_772_cov_4.838039	483	563	0	80	80	1.0000000
NODE_13162_length_772_cov_3.041605	339	419	0	80	80	1.0000000
NODE_13162_length_772_cov_3.041605	392	472	0	80	80	1.0000000
NODE_13195_length_771_cov_36.729167	223	304	0	81	81	1.0000000
NODE_13195_length_771_cov_36.729167	277	357	0	80	80	1.0000000
NODE_13195_length_771_cov_36.729167	353	434	0	81	81	1.0000000
NODE_13195_length_771_cov_36.729167	407	487	0	80	80	1.0000000
NODE_13196_length_771_cov_28.903274	337	417	0	12	80	0.1500000
NODE_13196_length_771_cov_28.903274	337	417	2	68	80	0.8500000
NODE_13196_length_771_cov_28.903274	390	470	0	65	80	0.8125000
NODE_13196_length_771_cov_28.903274	390	470	2	15	80	0.1875000
NODE_13197_length_771_cov_28.165179	453	533	0	55	80	0.6875000
NODE_13197_length_771_cov_28.165179	453	533	2	25	80	0.3125000
NODE_13197_length_771_cov_28.165179	506	586	0	2	80	0.0250000
NODE_13197_length_771_cov_28.165179	506	586	2	78	80	0.9750000
NODE_13198_length_771_cov_14.336310	259	339	0	76	80	0.9500000
NODE_13198_length_771_cov_14.336310	259	339	2	4	80	0.0500000
NODE_13198_length_771_cov_14.336310	312	392	0	23	80	0.2875000
NODE_13198_length_771_cov_14.336310	312	392	2	46	80	0.5750000
NODE_13198_length_771_cov_14.336310	312	392	4	11	80	0.1375000
NODE_13199_length_771_cov_13.592262	428	508	2	48	80	0.6000000
NODE_13199_length_771_cov_13.592262	428	508	4	32	80	0.4000000
NODE_13199_length_771_cov_13.592262	481	561	2	59	80	0.7375000
NODE_13199_length_771_cov_13.592262	481	561	4	21	80	0.2625000
NODE_13200_length_771_cov_12.226190	407	487	0	63	80	0.7875000
NODE_13200_length_771_cov_12.226190	407	487	2	17	80	0.2125000
NODE_13200_length_771_cov_12.226190	460	540	0	10	80	0.1250000
NODE_13200_length_771_cov_12.226190	460	540	2	70	80	0.8750000
NODE_13201_length_771_cov_11.188988	348	428	0	11	80	0.1375000
NODE_13201_length_771_cov_11.188988	348	428	4	69	80	0.8625000
NODE_13201_length_771_cov_11.188988	401	481	0	8	80	0.1000000
NODE_13201_length_771_cov_11.188988	401	481	4	72	80	0.9000000
NODE_13202_length_771_cov_10.525298	171	251	0	77	80	0.9625000
NODE_13202_length_771_cov_10.525298	171	251	2	3	80	0.0375000
NODE_13202_length_771_cov_10.525298	224	304	0	24	80	0.3000000
NODE_13202_length_771_cov_10.525298	224	304	2	56	80	0.7000000
NODE_13207_length_771_cov_3.357143	238	318	0	5	80	0.0625000
NODE_13207_length_771_cov_3.357143	238	318	2	75	80	0.9375000
NODE_13207_length_771_cov_3.357143	291	371	0	10	80	0.1250000
NODE_13207_length_771_cov_3.357143	291	371	2	70	80	0.8750000
NODE_13209_length_771_cov_3.129464	476	518	0	42	42	1.0000000
NODE_13238_length_770_cov_45.312966	212	292	0	5	80	0.0625000
NODE_13238_length_770_cov_45.312966	212	292	2	75	80	0.9375000
NODE_13238_length_770_cov_45.312966	265	345	0	30	80	0.3750000
NODE_13238_length_770_cov_45.312966	265	345	2	50	80	0.6250000
NODE_13239_length_770_cov_23.153502	348	428	2	52	80	0.6500000
NODE_13239_length_770_cov_23.153502	348	428	8	28	80	0.3500000
NODE_13239_length_770_cov_23.153502	401	481	8	36	80	0.4500000
NODE_13239_length_770_cov_23.153502	401	481	10	28	80	0.3500000
NODE_13239_length_770_cov_23.153502	401	481	11	14	80	0.1750000
NODE_13239_length_770_cov_23.153502	401	481	12	2	80	0.0250000
NODE_13240_length_770_cov_22.463487	340	420	0	80	80	1.0000000
NODE_13240_length_770_cov_22.463487	393	473	0	28	80	0.3500000
NODE_13240_length_770_cov_22.463487	393	473	2	52	80	0.6500000
NODE_13241_length_770_cov_18.594635	335	416	0	38	81	0.4691358
NODE_13241_length_770_cov_18.594635	335	416	4	13	81	0.1604938
NODE_13241_length_770_cov_18.594635	335	416	6	30	81	0.3703704
NODE_13241_length_770_cov_18.594635	389	469	5	6	80	0.0750000
NODE_13241_length_770_cov_18.594635	389	469	6	74	80	0.9250000
NODE_13242_length_770_cov_18.092399	292	372	0	32	80	0.4000000
NODE_13242_length_770_cov_18.092399	292	372	2	48	80	0.6000000
NODE_13242_length_770_cov_18.092399	345	425	2	72	80	0.9000000
NODE_13242_length_770_cov_18.092399	345	425	4	8	80	0.1000000
NODE_13243_length_770_cov_7.064083	294	374	0	80	80	1.0000000
NODE_13243_length_770_cov_7.064083	347	426	0	79	79	1.0000000
NODE_13246_length_770_cov_5.184799	341	421	0	75	80	0.9375000
NODE_13246_length_770_cov_5.184799	341	421	2	5	80	0.0625000
NODE_13246_length_770_cov_5.184799	394	474	0	80	80	1.0000000
NODE_13250_length_770_cov_4.120715	325	405	0	80	80	1.0000000
NODE_13250_length_770_cov_4.120715	378	458	0	80	80	1.0000000
NODE_13272_length_769_cov_11.008955	355	435	0	10	80	0.1250000
NODE_13272_length_769_cov_11.008955	355	435	2	70	80	0.8750000
NODE_13272_length_769_cov_11.008955	408	488	0	8	80	0.1000000
NODE_13272_length_769_cov_11.008955	408	488	2	72	80	0.9000000
NODE_13274_length_769_cov_9.077612	263	343	8	4	80	0.0500000
NODE_13274_length_769_cov_9.077612	263	343	10	13	80	0.1625000
NODE_13274_length_769_cov_9.077612	263	343	12	8	80	0.1000000
NODE_13274_length_769_cov_9.077612	263	343	16	16	80	0.2000000
NODE_13274_length_769_cov_9.077612	263	343	20	39	80	0.4875000
NODE_13274_length_769_cov_9.077612	316	396	10	2	80	0.0250000
NODE_13274_length_769_cov_9.077612	316	396	13	1	80	0.0125000
NODE_13274_length_769_cov_9.077612	316	396	14	5	80	0.0625000
NODE_13274_length_769_cov_9.077612	316	396	16	1	80	0.0125000
NODE_13274_length_769_cov_9.077612	316	396	20	62	80	0.7750000
NODE_13274_length_769_cov_9.077612	316	396	22	9	80	0.1125000
NODE_13275_length_769_cov_7.034328	289	367	0	78	78	1.0000000
NODE_13275_length_769_cov_7.034328	340	420	0	80	80	1.0000000
NODE_13307_length_769_cov_1.262687	620	668	0	39	48	0.8125000
NODE_13307_length_769_cov_1.262687	620	668	2	9	48	0.1875000
NODE_13316_length_768_cov_19.195815	266	346	0	54	80	0.6750000
NODE_13316_length_768_cov_19.195815	266	346	2	26	80	0.3250000
NODE_13316_length_768_cov_19.195815	319	399	0	80	80	1.0000000
NODE_13316_length_768_cov_19.195815	395	475	0	80	80	1.0000000
NODE_13316_length_768_cov_19.195815	448	528	0	80	80	1.0000000
NODE_13317_length_768_cov_16.420030	246	326	0	34	80	0.4250000
NODE_13317_length_768_cov_16.420030	246	326	4	28	80	0.3500000
NODE_13317_length_768_cov_16.420030	246	326	6	18	80	0.2250000
NODE_13317_length_768_cov_16.420030	299	379	2	21	80	0.2625000
NODE_13317_length_768_cov_16.420030	299	379	4	9	80	0.1125000
NODE_13317_length_768_cov_16.420030	299	379	6	50	80	0.6250000
NODE_13318_length_768_cov_14.508221	309	389	0	80	80	1.0000000
NODE_13318_length_768_cov_14.508221	362	442	0	80	80	1.0000000
NODE_13319_length_768_cov_11.635277	309	389	0	80	80	1.0000000
NODE_13319_length_768_cov_11.635277	362	442	0	80	80	1.0000000
NODE_13321_length_768_cov_9.064275	392	472	0	80	80	1.0000000
NODE_13321_length_768_cov_9.064275	445	525	0	80	80	1.0000000
NODE_13324_length_768_cov_3.605381	512	592	0	80	80	1.0000000
NODE_13324_length_768_cov_3.605381	565	645	0	80	80	1.0000000
NODE_13354_length_767_cov_38.161677	28	108	8	2	80	0.0250000
NODE_13354_length_767_cov_38.161677	28	108	14	1	80	0.0125000
NODE_13354_length_767_cov_38.161677	28	108	18	4	80	0.0500000
NODE_13354_length_767_cov_38.161677	28	108	20	1	80	0.0125000
NODE_13354_length_767_cov_38.161677	28	108	22	4	80	0.0500000
NODE_13354_length_767_cov_38.161677	28	108	24	68	80	0.8500000
NODE_13354_length_767_cov_38.161677	254	334	0	59	80	0.7375000
NODE_13354_length_767_cov_38.161677	254	334	4	21	80	0.2625000
NODE_13354_length_767_cov_38.161677	307	387	0	6	80	0.0750000
NODE_13354_length_767_cov_38.161677	307	387	4	69	80	0.8625000
NODE_13354_length_767_cov_38.161677	307	387	5	1	80	0.0125000
NODE_13354_length_767_cov_38.161677	307	387	6	4	80	0.0500000
NODE_13355_length_767_cov_24.107784	279	359	0	9	80	0.1125000
NODE_13355_length_767_cov_24.107784	279	359	2	8	80	0.1000000
NODE_13355_length_767_cov_24.107784	279	359	4	63	80	0.7875000
NODE_13355_length_767_cov_24.107784	332	412	0	11	80	0.1375000
NODE_13355_length_767_cov_24.107784	332	412	2	27	80	0.3375000
NODE_13355_length_767_cov_24.107784	332	412	4	42	80	0.5250000
NODE_13356_length_767_cov_22.823353	286	366	0	68	80	0.8500000
NODE_13356_length_767_cov_22.823353	286	366	4	12	80	0.1500000
NODE_13356_length_767_cov_22.823353	339	419	0	15	80	0.1875000
NODE_13356_length_767_cov_22.823353	339	419	4	65	80	0.8125000
NODE_13357_length_767_cov_20.898204	312	392	0	21	80	0.2625000
NODE_13357_length_767_cov_20.898204	312	392	2	59	80	0.7375000
NODE_13357_length_767_cov_20.898204	365	445	0	59	80	0.7375000
NODE_13357_length_767_cov_20.898204	365	445	2	21	80	0.2625000
NODE_13358_length_767_cov_20.058383	357	439	0	82	82	1.0000000
NODE_13358_length_767_cov_20.058383	410	490	0	80	80	1.0000000
NODE_13359_length_767_cov_20.020958	191	271	2	26	80	0.3250000
NODE_13359_length_767_cov_20.020958	191	271	4	13	80	0.1625000
NODE_13359_length_767_cov_20.020958	191	271	6	41	80	0.5125000
NODE_13359_length_767_cov_20.020958	244	324	0	8	80	0.1000000
NODE_13359_length_767_cov_20.020958	244	324	4	52	80	0.6500000
NODE_13359_length_767_cov_20.020958	244	324	6	20	80	0.2500000
NODE_13360_length_767_cov_18.687126	270	350	0	15	80	0.1875000
NODE_13360_length_767_cov_18.687126	270	350	2	65	80	0.8125000
NODE_13360_length_767_cov_18.687126	323	403	0	51	80	0.6375000
NODE_13360_length_767_cov_18.687126	323	403	2	29	80	0.3625000
NODE_13362_length_767_cov_13.323353	45	125	0	80	80	1.0000000
NODE_13362_length_767_cov_13.323353	98	178	0	80	80	1.0000000
NODE_13366_length_767_cov_8.787425	377	447	0	70	70	1.0000000
NODE_13366_length_767_cov_8.787425	420	500	0	80	80	1.0000000
NODE_13367_length_767_cov_7.206587	306	386	2	13	80	0.1625000
NODE_13367_length_767_cov_7.206587	306	386	3	9	80	0.1125000
NODE_13367_length_767_cov_7.206587	306	386	4	42	80	0.5250000
NODE_13367_length_767_cov_7.206587	306	386	5	16	80	0.2000000
NODE_13367_length_767_cov_7.206587	359	440	0	5	81	0.0617284
NODE_13367_length_767_cov_7.206587	359	440	2	62	81	0.7654321
NODE_13367_length_767_cov_7.206587	359	440	3	4	81	0.0493827
NODE_13367_length_767_cov_7.206587	359	440	5	10	81	0.1234568
NODE_13403_length_766_cov_59.388306	322	402	0	80	80	1.0000000
NODE_13403_length_766_cov_59.388306	375	455	0	80	80	1.0000000
NODE_13403_length_766_cov_59.388306	451	531	0	80	80	1.0000000
NODE_13403_length_766_cov_59.388306	504	584	0	80	80	1.0000000
NODE_13404_length_766_cov_23.361319	308	388	4	80	80	1.0000000
NODE_13404_length_766_cov_23.361319	361	441	0	22	80	0.2750000
NODE_13404_length_766_cov_23.361319	361	441	2	9	80	0.1125000
NODE_13404_length_766_cov_23.361319	361	441	4	49	80	0.6125000
NODE_13405_length_766_cov_22.751124	229	309	0	74	80	0.9250000
NODE_13405_length_766_cov_22.751124	229	309	2	6	80	0.0750000
NODE_13405_length_766_cov_22.751124	282	362	0	21	80	0.2625000
NODE_13405_length_766_cov_22.751124	282	362	2	43	80	0.5375000
NODE_13405_length_766_cov_22.751124	282	362	4	16	80	0.2000000
NODE_13406_length_766_cov_20.011994	285	363	2	78	78	1.0000000
NODE_13406_length_766_cov_20.011994	336	416	0	11	80	0.1375000
NODE_13406_length_766_cov_20.011994	336	416	2	64	80	0.8000000
NODE_13406_length_766_cov_20.011994	336	416	3	1	80	0.0125000
NODE_13406_length_766_cov_20.011994	336	416	4	4	80	0.0500000
NODE_13407_length_766_cov_18.685157	288	368	3	20	80	0.2500000
NODE_13407_length_766_cov_18.685157	288	368	4	16	80	0.2000000
NODE_13407_length_766_cov_18.685157	288	368	6	17	80	0.2125000
NODE_13407_length_766_cov_18.685157	288	368	7	27	80	0.3375000
NODE_13407_length_766_cov_18.685157	341	421	2	27	80	0.3375000
NODE_13407_length_766_cov_18.685157	341	421	4	9	80	0.1125000
NODE_13407_length_766_cov_18.685157	341	421	6	41	80	0.5125000
NODE_13407_length_766_cov_18.685157	341	421	7	3	80	0.0375000
NODE_13408_length_766_cov_13.131934	271	351	0	80	80	1.0000000
NODE_13408_length_766_cov_13.131934	324	404	0	80	80	1.0000000
NODE_13410_length_766_cov_9.479760	274	354	0	54	80	0.6750000
NODE_13410_length_766_cov_9.479760	274	354	2	26	80	0.3250000
NODE_13410_length_766_cov_9.479760	327	407	0	80	80	1.0000000
NODE_13415_length_766_cov_4.500750	333	413	0	9	80	0.1125000
NODE_13415_length_766_cov_4.500750	333	413	2	26	80	0.3250000
NODE_13415_length_766_cov_4.500750	333	413	4	10	80	0.1250000
NODE_13415_length_766_cov_4.500750	333	413	6	35	80	0.4375000
NODE_13415_length_766_cov_4.500750	369	404	4	9	35	0.2571429
NODE_13415_length_766_cov_4.500750	369	404	6	26	35	0.7428572
NODE_13415_length_766_cov_4.500750	371	413	4	7	42	0.1666667
NODE_13415_length_766_cov_4.500750	371	413	6	35	42	0.8333333
NODE_13415_length_766_cov_4.500750	397	466	4	12	69	0.1739130
NODE_13415_length_766_cov_4.500750	397	466	6	55	69	0.7971014
NODE_13415_length_766_cov_4.500750	397	466	8	2	69	0.0289855
NODE_13447_length_765_cov_92.851351	16	96	16	20	80	0.2500000
NODE_13447_length_765_cov_92.851351	16	96	18	1	80	0.0125000
NODE_13447_length_765_cov_92.851351	16	96	20	1	80	0.0125000
NODE_13447_length_765_cov_92.851351	16	96	22	4	80	0.0500000
NODE_13447_length_765_cov_92.851351	16	96	26	2	80	0.0250000
NODE_13447_length_765_cov_92.851351	16	96	28	5	80	0.0625000
NODE_13447_length_765_cov_92.851351	16	96	31	4	80	0.0500000
NODE_13447_length_765_cov_92.851351	16	96	32	3	80	0.0375000
NODE_13447_length_765_cov_92.851351	16	96	34	7	80	0.0875000
NODE_13447_length_765_cov_92.851351	16	96	38	4	80	0.0500000
NODE_13447_length_765_cov_92.851351	16	96	42	1	80	0.0125000
NODE_13447_length_765_cov_92.851351	16	96	44	17	80	0.2125000
NODE_13447_length_765_cov_92.851351	16	96	46	2	80	0.0250000
NODE_13447_length_765_cov_92.851351	16	96	48	5	80	0.0625000
NODE_13447_length_765_cov_92.851351	16	96	49	3	80	0.0375000
NODE_13447_length_765_cov_92.851351	16	96	50	1	80	0.0125000
NODE_13448_length_765_cov_36.345345	504	584	0	75	80	0.9375000
NODE_13448_length_765_cov_36.345345	504	584	1	5	80	0.0625000
NODE_13448_length_765_cov_36.345345	557	637	0	80	80	1.0000000
NODE_13449_length_765_cov_27.334835	370	450	0	80	80	1.0000000
NODE_13449_length_765_cov_27.334835	423	503	0	44	80	0.5500000
NODE_13449_length_765_cov_27.334835	423	503	2	36	80	0.4500000
NODE_13450_length_765_cov_23.355856	251	331	0	10	80	0.1250000
NODE_13450_length_765_cov_23.355856	251	331	2	70	80	0.8750000
NODE_13450_length_765_cov_23.355856	304	384	2	80	80	1.0000000
NODE_13450_length_765_cov_23.355856	380	460	0	12	80	0.1500000
NODE_13450_length_765_cov_23.355856	380	460	2	68	80	0.8500000
NODE_13450_length_765_cov_23.355856	433	506	0	58	73	0.7945206
NODE_13450_length_765_cov_23.355856	433	506	2	15	73	0.2054795
NODE_13451_length_765_cov_23.322823	256	336	0	78	80	0.9750000
NODE_13451_length_765_cov_23.322823	256	336	2	2	80	0.0250000
NODE_13451_length_765_cov_23.322823	309	389	0	25	80	0.3125000
NODE_13451_length_765_cov_23.322823	309	389	2	55	80	0.6875000
NODE_13452_length_765_cov_21.741742	379	452	0	73	73	1.0000000
NODE_13452_length_765_cov_21.741742	425	505	0	67	80	0.8375000
NODE_13452_length_765_cov_21.741742	425	505	2	13	80	0.1625000
NODE_13453_length_765_cov_14.253754	450	530	2	2	80	0.0250000
NODE_13453_length_765_cov_14.253754	450	530	3	1	80	0.0125000
NODE_13453_length_765_cov_14.253754	450	530	4	32	80	0.4000000
NODE_13453_length_765_cov_14.253754	450	530	6	4	80	0.0500000
NODE_13453_length_765_cov_14.253754	450	530	8	41	80	0.5125000
NODE_13453_length_765_cov_14.253754	503	583	5	19	80	0.2375000
NODE_13453_length_765_cov_14.253754	503	583	6	38	80	0.4750000
NODE_13453_length_765_cov_14.253754	503	583	8	23	80	0.2875000
NODE_13454_length_765_cov_13.627628	313	393	0	65	80	0.8125000
NODE_13454_length_765_cov_13.627628	313	393	5	6	80	0.0750000
NODE_13454_length_765_cov_13.627628	313	393	6	9	80	0.1125000
NODE_13454_length_765_cov_13.627628	366	446	0	12	80	0.1500000
NODE_13454_length_765_cov_13.627628	366	446	5	6	80	0.0750000
NODE_13454_length_765_cov_13.627628	366	446	6	62	80	0.7750000
NODE_13455_length_765_cov_5.561562	319	349	0	30	30	1.0000000
NODE_13458_length_765_cov_4.367868	433	513	0	76	80	0.9500000
NODE_13458_length_765_cov_4.367868	433	513	2	4	80	0.0500000
NODE_13458_length_765_cov_4.367868	486	566	0	23	80	0.2875000
NODE_13458_length_765_cov_4.367868	486	566	2	57	80	0.7125000
NODE_13483_length_764_cov_30.096241	436	516	1	12	80	0.1500000
NODE_13483_length_764_cov_30.096241	436	516	3	17	80	0.2125000
NODE_13483_length_764_cov_30.096241	436	516	5	51	80	0.6375000
NODE_13483_length_764_cov_30.096241	489	569	1	65	80	0.8125000
NODE_13483_length_764_cov_30.096241	489	569	3	15	80	0.1875000
NODE_13484_length_764_cov_29.218045	304	384	2	57	80	0.7125000
NODE_13484_length_764_cov_29.218045	304	384	4	23	80	0.2875000
NODE_13484_length_764_cov_29.218045	357	437	2	24	80	0.3000000
NODE_13484_length_764_cov_29.218045	357	437	4	16	80	0.2000000
NODE_13484_length_764_cov_29.218045	357	437	6	40	80	0.5000000
NODE_13485_length_764_cov_25.951880	421	501	0	80	80	1.0000000
NODE_13485_length_764_cov_25.951880	474	554	0	80	80	1.0000000
NODE_13486_length_764_cov_23.590977	204	284	0	80	80	1.0000000
NODE_13486_length_764_cov_23.590977	257	337	0	80	80	1.0000000
NODE_13488_length_764_cov_6.804511	281	361	0	80	80	1.0000000
NODE_13488_length_764_cov_6.804511	334	414	0	80	80	1.0000000
NODE_13489_length_764_cov_6.700752	392	458	0	66	66	1.0000000
NODE_13508_length_764_cov_1.171429	475	537	0	27	62	0.4354839
NODE_13508_length_764_cov_1.171429	475	537	2	35	62	0.5645161
NODE_13520_length_763_cov_28.807229	311	391	0	80	80	1.0000000
NODE_13520_length_763_cov_28.807229	364	444	0	80	80	1.0000000
NODE_13521_length_763_cov_25.299699	598	673	0	11	75	0.1466667
NODE_13521_length_763_cov_25.299699	598	673	2	1	75	0.0133333
NODE_13521_length_763_cov_25.299699	598	673	4	63	75	0.8400000
NODE_13521_length_763_cov_25.299699	598	678	0	11	80	0.1375000
NODE_13521_length_763_cov_25.299699	598	678	2	1	80	0.0125000
NODE_13521_length_763_cov_25.299699	598	678	4	68	80	0.8500000
NODE_13521_length_763_cov_25.299699	605	675	0	4	70	0.0571429
NODE_13521_length_763_cov_25.299699	605	675	2	1	70	0.0142857
NODE_13521_length_763_cov_25.299699	605	675	4	65	70	0.9285714
NODE_13521_length_763_cov_25.299699	607	678	0	2	71	0.0281690
NODE_13521_length_763_cov_25.299699	607	678	2	1	71	0.0140845
NODE_13521_length_763_cov_25.299699	607	678	4	68	71	0.9577465
NODE_13521_length_763_cov_25.299699	651	731	4	80	80	1.0000000
NODE_13521_length_763_cov_25.299699	651	731	4	80	80	1.0000000
NODE_13521_length_763_cov_25.299699	651	731	4	80	80	1.0000000
NODE_13521_length_763_cov_25.299699	651	731	4	80	80	1.0000000
NODE_13522_length_763_cov_12.887048	336	416	0	80	80	1.0000000
NODE_13522_length_763_cov_12.887048	389	469	0	80	80	1.0000000
NODE_13523_length_763_cov_11.599398	547	627	0	26	80	0.3250000
NODE_13523_length_763_cov_11.599398	547	627	2	54	80	0.6750000
NODE_13523_length_763_cov_11.599398	600	680	0	1	80	0.0125000
NODE_13523_length_763_cov_11.599398	600	680	2	30	80	0.3750000
NODE_13523_length_763_cov_11.599398	600	680	4	49	80	0.6125000
NODE_13524_length_763_cov_9.378012	297	377	0	80	80	1.0000000
NODE_13524_length_763_cov_9.378012	350	430	0	35	80	0.4375000
NODE_13524_length_763_cov_9.378012	350	430	2	45	80	0.5625000
NODE_13526_length_763_cov_7.246988	368	448	0	80	80	1.0000000
NODE_13526_length_763_cov_7.246988	421	501	0	64	80	0.8000000
NODE_13526_length_763_cov_7.246988	421	501	2	16	80	0.2000000
NODE_13527_length_763_cov_6.414157	371	451	0	80	80	1.0000000
NODE_13527_length_763_cov_6.414157	424	504	0	56	80	0.7000000
NODE_13527_length_763_cov_6.414157	424	504	1	24	80	0.3000000
NODE_13558_length_762_cov_21.236802	368	448	4	37	80	0.4625000
NODE_13558_length_762_cov_21.236802	368	448	10	10	80	0.1250000
NODE_13558_length_762_cov_21.236802	368	448	12	33	80	0.4125000
NODE_13558_length_762_cov_21.236802	421	501	8	19	80	0.2375000
NODE_13558_length_762_cov_21.236802	421	501	12	61	80	0.7625000
NODE_13559_length_762_cov_19.984917	327	407	0	28	80	0.3500000
NODE_13559_length_762_cov_19.984917	327	407	2	18	80	0.2250000
NODE_13559_length_762_cov_19.984917	327	407	4	34	80	0.4250000
NODE_13559_length_762_cov_19.984917	380	460	2	28	80	0.3500000
NODE_13559_length_762_cov_19.984917	380	460	4	52	80	0.6500000
NODE_13560_length_762_cov_15.975867	318	398	0	20	80	0.2500000
NODE_13560_length_762_cov_15.975867	318	398	2	47	80	0.5875000
NODE_13560_length_762_cov_15.975867	318	398	4	5	80	0.0625000
NODE_13560_length_762_cov_15.975867	318	398	6	8	80	0.1000000
NODE_13560_length_762_cov_15.975867	371	439	2	14	68	0.2058824
NODE_13560_length_762_cov_15.975867	371	439	4	5	68	0.0735294
NODE_13560_length_762_cov_15.975867	371	439	6	20	68	0.2941177
NODE_13560_length_762_cov_15.975867	371	439	8	29	68	0.4264706
NODE_13561_length_762_cov_12.728507	381	461	2	9	80	0.1125000
NODE_13561_length_762_cov_12.728507	381	461	4	37	80	0.4625000
NODE_13561_length_762_cov_12.728507	381	461	6	34	80	0.4250000
NODE_13561_length_762_cov_12.728507	434	514	0	30	80	0.3750000
NODE_13561_length_762_cov_12.728507	434	514	2	2	80	0.0250000
NODE_13561_length_762_cov_12.728507	434	514	4	41	80	0.5125000
NODE_13561_length_762_cov_12.728507	434	514	6	7	80	0.0875000
NODE_13562_length_762_cov_10.078431	277	357	0	12	80	0.1500000
NODE_13562_length_762_cov_10.078431	277	357	2	68	80	0.8500000
NODE_13562_length_762_cov_10.078431	330	410	0	65	80	0.8125000
NODE_13562_length_762_cov_10.078431	330	410	2	15	80	0.1875000
NODE_13563_length_762_cov_9.705882	339	419	0	18	80	0.2250000
NODE_13563_length_762_cov_9.705882	339	419	2	62	80	0.7750000
NODE_13563_length_762_cov_9.705882	392	472	0	17	80	0.2125000
NODE_13563_length_762_cov_9.705882	392	472	2	63	80	0.7875000
NODE_13564_length_762_cov_7.276018	316	395	0	79	79	1.0000000
NODE_13564_length_762_cov_7.276018	368	448	0	51	80	0.6375000
NODE_13564_length_762_cov_7.276018	368	448	2	22	80	0.2750000
NODE_13564_length_762_cov_7.276018	368	448	4	7	80	0.0875000
NODE_13565_length_762_cov_6.168929	222	302	0	1	80	0.0125000
NODE_13565_length_762_cov_6.168929	222	302	4	79	80	0.9875000
NODE_13565_length_762_cov_6.168929	275	355	0	54	80	0.6750000
NODE_13565_length_762_cov_6.168929	275	355	4	26	80	0.3250000
NODE_13613_length_761_cov_44.243202	531	582	8	8	51	0.1568628
NODE_13613_length_761_cov_44.243202	531	582	10	32	51	0.6274510
NODE_13613_length_761_cov_44.243202	531	582	12	11	51	0.2156863
NODE_13614_length_761_cov_38.809668	342	422	8	5	80	0.0625000
NODE_13614_length_761_cov_38.809668	342	422	14	44	80	0.5500000
NODE_13614_length_761_cov_38.809668	342	422	16	3	80	0.0375000
NODE_13614_length_761_cov_38.809668	342	422	18	28	80	0.3500000
NODE_13614_length_761_cov_38.809668	395	475	2	42	80	0.5250000
NODE_13614_length_761_cov_38.809668	395	475	6	3	80	0.0375000
NODE_13614_length_761_cov_38.809668	395	475	8	13	80	0.1625000
NODE_13614_length_761_cov_38.809668	395	475	14	22	80	0.2750000
NODE_13615_length_761_cov_38.694864	314	394	8	13	80	0.1625000
NODE_13615_length_761_cov_38.694864	314	394	12	6	80	0.0750000
NODE_13615_length_761_cov_38.694864	314	394	14	49	80	0.6125000
NODE_13615_length_761_cov_38.694864	314	394	16	12	80	0.1500000
NODE_13615_length_761_cov_38.694864	367	447	0	17	80	0.2125000
NODE_13615_length_761_cov_38.694864	367	447	7	1	80	0.0125000
NODE_13615_length_761_cov_38.694864	367	447	8	48	80	0.6000000
NODE_13615_length_761_cov_38.694864	367	447	12	6	80	0.0750000
NODE_13615_length_761_cov_38.694864	367	447	16	8	80	0.1000000
NODE_13616_length_761_cov_32.382175	432	512	0	3	80	0.0375000
NODE_13616_length_761_cov_32.382175	432	512	2	77	80	0.9625000
NODE_13616_length_761_cov_32.382175	485	565	0	51	80	0.6375000
NODE_13616_length_761_cov_32.382175	485	565	2	29	80	0.3625000
NODE_13617_length_761_cov_31.444109	323	403	0	12	80	0.1500000
NODE_13617_length_761_cov_31.444109	323	403	2	14	80	0.1750000
NODE_13617_length_761_cov_31.444109	323	403	4	5	80	0.0625000
NODE_13617_length_761_cov_31.444109	323	403	6	1	80	0.0125000
NODE_13617_length_761_cov_31.444109	323	403	8	48	80	0.6000000
NODE_13617_length_761_cov_31.444109	376	467	4	23	91	0.2527473
NODE_13617_length_761_cov_31.444109	376	467	6	39	91	0.4285714
NODE_13617_length_761_cov_31.444109	376	467	8	29	91	0.3186813
NODE_13618_length_761_cov_14.004532	366	446	4	8	80	0.1000000
NODE_13618_length_761_cov_14.004532	366	446	7	3	80	0.0375000
NODE_13618_length_761_cov_14.004532	366	446	8	46	80	0.5750000
NODE_13618_length_761_cov_14.004532	366	446	10	23	80	0.2875000
NODE_13618_length_761_cov_14.004532	419	499	3	1	80	0.0125000
NODE_13618_length_761_cov_14.004532	419	499	4	60	80	0.7500000
NODE_13618_length_761_cov_14.004532	419	499	7	1	80	0.0125000
NODE_13618_length_761_cov_14.004532	419	499	8	18	80	0.2250000
NODE_13619_length_761_cov_13.287009	336	415	2	1	79	0.0126582
NODE_13619_length_761_cov_13.287009	336	415	4	78	79	0.9873418
NODE_13619_length_761_cov_13.287009	388	468	0	16	80	0.2000000
NODE_13619_length_761_cov_13.287009	388	468	2	35	80	0.4375000
NODE_13619_length_761_cov_13.287009	388	468	4	29	80	0.3625000
NODE_13621_length_761_cov_9.654079	274	354	0	80	80	1.0000000
NODE_13621_length_761_cov_9.654079	327	407	0	80	80	1.0000000
NODE_13622_length_761_cov_7.306647	308	388	0	80	80	1.0000000
NODE_13622_length_761_cov_7.306647	361	441	0	80	80	1.0000000
NODE_13625_length_761_cov_4.314199	354	434	0	17	80	0.2125000
NODE_13625_length_761_cov_4.314199	354	434	4	44	80	0.5500000
NODE_13625_length_761_cov_4.314199	354	434	6	19	80	0.2375000
NODE_13625_length_761_cov_4.314199	407	487	4	71	80	0.8875000
NODE_13625_length_761_cov_4.314199	407	487	6	9	80	0.1125000
NODE_13658_length_760_cov_48.290469	215	295	11	8	80	0.1000000
NODE_13658_length_760_cov_48.290469	215	295	12	7	80	0.0875000
NODE_13658_length_760_cov_48.290469	215	295	14	14	80	0.1750000
NODE_13658_length_760_cov_48.290469	215	295	16	7	80	0.0875000
NODE_13658_length_760_cov_48.290469	215	295	20	11	80	0.1375000
NODE_13658_length_760_cov_48.290469	215	295	22	33	80	0.4125000
NODE_13658_length_760_cov_48.290469	268	348	5	7	80	0.0875000
NODE_13658_length_760_cov_48.290469	268	348	7	9	80	0.1125000
NODE_13658_length_760_cov_48.290469	268	348	11	3	80	0.0375000
NODE_13658_length_760_cov_48.290469	268	348	15	20	80	0.2500000
NODE_13658_length_760_cov_48.290469	268	348	17	1	80	0.0125000
NODE_13658_length_760_cov_48.290469	268	348	20	10	80	0.1250000
NODE_13658_length_760_cov_48.290469	268	348	21	8	80	0.1000000
NODE_13658_length_760_cov_48.290469	268	348	22	22	80	0.2750000
NODE_13658_length_760_cov_48.290469	344	424	2	22	80	0.2750000
NODE_13658_length_760_cov_48.290469	344	424	4	29	80	0.3625000
NODE_13658_length_760_cov_48.290469	344	424	5	27	80	0.3375000
NODE_13658_length_760_cov_48.290469	344	424	7	2	80	0.0250000
NODE_13658_length_760_cov_48.290469	397	477	2	55	80	0.6875000
NODE_13658_length_760_cov_48.290469	397	477	4	25	80	0.3125000
NODE_13659_length_760_cov_28.314675	384	464	8	5	80	0.0625000
NODE_13659_length_760_cov_28.314675	384	464	12	12	80	0.1500000
NODE_13659_length_760_cov_28.314675	384	464	14	63	80	0.7875000
NODE_13659_length_760_cov_28.314675	437	517	0	10	80	0.1250000
NODE_13659_length_760_cov_28.314675	437	517	2	31	80	0.3875000
NODE_13659_length_760_cov_28.314675	437	517	4	4	80	0.0500000
NODE_13659_length_760_cov_28.314675	437	517	5	1	80	0.0125000
NODE_13659_length_760_cov_28.314675	437	517	7	2	80	0.0250000
NODE_13659_length_760_cov_28.314675	437	517	8	10	80	0.1250000
NODE_13659_length_760_cov_28.314675	437	517	14	22	80	0.2750000
NODE_13660_length_760_cov_27.981846	432	512	2	6	80	0.0750000
NODE_13660_length_760_cov_27.981846	432	512	4	61	80	0.7625000
NODE_13660_length_760_cov_27.981846	432	512	6	13	80	0.1625000
NODE_13660_length_760_cov_27.981846	485	565	0	9	80	0.1125000
NODE_13660_length_760_cov_27.981846	485	565	2	22	80	0.2750000
NODE_13660_length_760_cov_27.981846	485	565	4	49	80	0.6125000
NODE_13661_length_760_cov_17.500756	372	452	0	2	80	0.0250000
NODE_13661_length_760_cov_17.500756	372	452	2	62	80	0.7750000
NODE_13661_length_760_cov_17.500756	372	452	4	16	80	0.2000000
NODE_13661_length_760_cov_17.500756	425	505	0	8	80	0.1000000
NODE_13661_length_760_cov_17.500756	425	505	2	27	80	0.3375000
NODE_13661_length_760_cov_17.500756	425	505	4	45	80	0.5625000
NODE_13662_length_760_cov_17.420575	183	263	2	3	80	0.0375000
NODE_13662_length_760_cov_17.420575	183	263	4	73	80	0.9125000
NODE_13662_length_760_cov_17.420575	183	263	6	4	80	0.0500000
NODE_13662_length_760_cov_17.420575	236	316	4	23	80	0.2875000
NODE_13662_length_760_cov_17.420575	236	316	6	49	80	0.6125000
NODE_13662_length_760_cov_17.420575	236	316	8	8	80	0.1000000
NODE_13663_length_760_cov_13.444781	357	437	0	48	80	0.6000000
NODE_13663_length_760_cov_13.444781	357	437	2	32	80	0.4000000
NODE_13663_length_760_cov_13.444781	410	490	2	80	80	1.0000000
NODE_13664_length_760_cov_13.196672	282	362	0	65	80	0.8125000
NODE_13664_length_760_cov_13.196672	282	362	4	15	80	0.1875000
NODE_13664_length_760_cov_13.196672	335	415	0	12	80	0.1500000
NODE_13664_length_760_cov_13.196672	335	415	4	26	80	0.3250000
NODE_13664_length_760_cov_13.196672	335	415	6	42	80	0.5250000
NODE_13665_length_760_cov_12.692890	295	375	0	21	80	0.2625000
NODE_13665_length_760_cov_12.692890	295	375	2	14	80	0.1750000
NODE_13665_length_760_cov_12.692890	295	375	4	45	80	0.5625000
NODE_13665_length_760_cov_12.692890	348	428	2	32	80	0.4000000
NODE_13665_length_760_cov_12.692890	348	428	4	48	80	0.6000000
NODE_13671_length_760_cov_4.282905	388	468	0	24	80	0.3000000
NODE_13671_length_760_cov_4.282905	388	468	2	56	80	0.7000000
NODE_13671_length_760_cov_4.282905	441	521	2	29	80	0.3625000
NODE_13671_length_760_cov_4.282905	441	521	4	51	80	0.6375000
NODE_13671_length_760_cov_4.282905	517	597	2	35	80	0.4375000
NODE_13671_length_760_cov_4.282905	517	597	4	17	80	0.2125000
NODE_13671_length_760_cov_4.282905	517	597	5	28	80	0.3500000
NODE_13683_length_760_cov_1.990923	490	570	0	71	80	0.8875000
NODE_13683_length_760_cov_1.990923	490	570	2	1	80	0.0125000
NODE_13683_length_760_cov_1.990923	490	570	4	8	80	0.1000000
NODE_13683_length_760_cov_1.990923	543	623	0	18	80	0.2250000
NODE_13683_length_760_cov_1.990923	543	623	2	1	80	0.0125000
NODE_13683_length_760_cov_1.990923	543	623	4	13	80	0.1625000
NODE_13683_length_760_cov_1.990923	543	623	6	9	80	0.1125000
NODE_13683_length_760_cov_1.990923	543	623	8	2	80	0.0250000
NODE_13683_length_760_cov_1.990923	543	623	12	6	80	0.0750000
NODE_13683_length_760_cov_1.990923	543	623	18	7	80	0.0875000
NODE_13683_length_760_cov_1.990923	543	623	20	24	80	0.3000000
NODE_13709_length_759_cov_24.757576	376	456	4	16	80	0.2000000
NODE_13709_length_759_cov_24.757576	376	456	6	64	80	0.8000000
NODE_13709_length_759_cov_24.757576	429	509	0	35	80	0.4375000
NODE_13709_length_759_cov_24.757576	429	509	2	18	80	0.2250000
NODE_13709_length_759_cov_24.757576	429	509	4	14	80	0.1750000
NODE_13709_length_759_cov_24.757576	429	509	6	13	80	0.1625000
NODE_13710_length_759_cov_14.356061	210	290	0	12	80	0.1500000
NODE_13710_length_759_cov_14.356061	210	290	3	12	80	0.1500000
NODE_13710_length_759_cov_14.356061	210	290	5	56	80	0.7000000
NODE_13710_length_759_cov_14.356061	263	343	4	27	80	0.3375000
NODE_13710_length_759_cov_14.356061	263	343	5	42	80	0.5250000
NODE_13710_length_759_cov_14.356061	263	343	6	11	80	0.1375000
NODE_13711_length_759_cov_10.956061	328	408	0	30	80	0.3750000
NODE_13711_length_759_cov_10.956061	328	408	2	8	80	0.1000000
NODE_13711_length_759_cov_10.956061	328	408	4	42	80	0.5250000
NODE_13711_length_759_cov_10.956061	381	461	0	80	80	1.0000000
NODE_13712_length_759_cov_10.639394	330	410	0	31	80	0.3875000
NODE_13712_length_759_cov_10.639394	330	410	2	49	80	0.6125000
NODE_13712_length_759_cov_10.639394	383	463	2	80	80	1.0000000
NODE_13713_length_759_cov_9.192424	209	290	20	3	81	0.0370370
NODE_13713_length_759_cov_9.192424	209	290	22	1	81	0.0123457
NODE_13713_length_759_cov_9.192424	209	290	24	4	81	0.0493827
NODE_13713_length_759_cov_9.192424	209	290	26	1	81	0.0123457
NODE_13713_length_759_cov_9.192424	209	290	28	1	81	0.0123457
NODE_13713_length_759_cov_9.192424	209	290	30	1	81	0.0123457
NODE_13713_length_759_cov_9.192424	209	290	32	1	81	0.0123457
NODE_13713_length_759_cov_9.192424	209	290	38	1	81	0.0123457
NODE_13713_length_759_cov_9.192424	209	290	39	1	81	0.0123457
NODE_13713_length_759_cov_9.192424	209	290	41	2	81	0.0246914
NODE_13713_length_759_cov_9.192424	209	290	43	1	81	0.0123457
NODE_13713_length_759_cov_9.192424	209	290	44	5	81	0.0617284
NODE_13713_length_759_cov_9.192424	209	290	46	4	81	0.0493827
NODE_13713_length_759_cov_9.192424	209	290	48	1	81	0.0123457
NODE_13713_length_759_cov_9.192424	209	290	50	6	81	0.0740741
NODE_13713_length_759_cov_9.192424	209	290	54	1	81	0.0123457
NODE_13713_length_759_cov_9.192424	209	290	56	6	81	0.0740741
NODE_13713_length_759_cov_9.192424	209	290	58	3	81	0.0370370
NODE_13713_length_759_cov_9.192424	209	290	59	1	81	0.0123457
NODE_13713_length_759_cov_9.192424	209	290	61	1	81	0.0123457
NODE_13713_length_759_cov_9.192424	209	290	65	2	81	0.0246914
NODE_13713_length_759_cov_9.192424	209	290	66	6	81	0.0740741
NODE_13713_length_759_cov_9.192424	209	290	68	7	81	0.0864198
NODE_13713_length_759_cov_9.192424	209	290	72	1	81	0.0123457
NODE_13713_length_759_cov_9.192424	209	290	76	1	81	0.0123457
NODE_13713_length_759_cov_9.192424	209	290	78	12	81	0.1481481
NODE_13713_length_759_cov_9.192424	209	290	80	2	81	0.0246914
NODE_13713_length_759_cov_9.192424	209	290	83	1	81	0.0123457
NODE_13713_length_759_cov_9.192424	209	290	85	1	81	0.0123457
NODE_13713_length_759_cov_9.192424	209	290	87	2	81	0.0246914
NODE_13713_length_759_cov_9.192424	209	290	91	1	81	0.0123457
NODE_13713_length_759_cov_9.192424	262	310	5	4	48	0.0833333
NODE_13713_length_759_cov_9.192424	262	310	7	1	48	0.0208333
NODE_13713_length_759_cov_9.192424	262	310	8	1	48	0.0208333
NODE_13713_length_759_cov_9.192424	262	310	9	1	48	0.0208333
NODE_13713_length_759_cov_9.192424	262	310	10	1	48	0.0208333
NODE_13713_length_759_cov_9.192424	262	310	12	6	48	0.1250000
NODE_13713_length_759_cov_9.192424	262	310	13	3	48	0.0625000
NODE_13713_length_759_cov_9.192424	262	310	16	1	48	0.0208333
NODE_13713_length_759_cov_9.192424	262	310	20	5	48	0.1041667
NODE_13713_length_759_cov_9.192424	262	310	22	1	48	0.0208333
NODE_13713_length_759_cov_9.192424	262	310	24	4	48	0.0833333
NODE_13713_length_759_cov_9.192424	262	310	26	1	48	0.0208333
NODE_13713_length_759_cov_9.192424	262	310	28	1	48	0.0208333
NODE_13713_length_759_cov_9.192424	262	310	30	1	48	0.0208333
NODE_13713_length_759_cov_9.192424	262	310	32	1	48	0.0208333
NODE_13713_length_759_cov_9.192424	262	310	38	1	48	0.0208333
NODE_13713_length_759_cov_9.192424	262	310	39	1	48	0.0208333
NODE_13713_length_759_cov_9.192424	262	310	41	2	48	0.0416667
NODE_13713_length_759_cov_9.192424	262	310	43	1	48	0.0208333
NODE_13713_length_759_cov_9.192424	262	310	44	5	48	0.1041667
NODE_13713_length_759_cov_9.192424	262	310	46	4	48	0.0833333
NODE_13713_length_759_cov_9.192424	262	310	48	1	48	0.0208333
NODE_13713_length_759_cov_9.192424	262	310	50	1	48	0.0208333
NODE_13714_length_759_cov_8.771212	292	372	2	43	80	0.5375000
NODE_13714_length_759_cov_8.771212	292	372	4	37	80	0.4625000
NODE_13714_length_759_cov_8.771212	345	425	0	25	80	0.3125000
NODE_13714_length_759_cov_8.771212	345	425	2	34	80	0.4250000
NODE_13714_length_759_cov_8.771212	345	425	4	21	80	0.2625000
NODE_13715_length_759_cov_8.650000	324	404	0	80	80	1.0000000
NODE_13715_length_759_cov_8.650000	377	457	0	51	80	0.6375000
NODE_13715_length_759_cov_8.650000	377	457	2	23	80	0.2875000
NODE_13715_length_759_cov_8.650000	377	457	5	6	80	0.0750000
NODE_13716_length_759_cov_8.268182	604	684	2	80	80	1.0000000
NODE_13716_length_759_cov_8.268182	657	737	0	10	80	0.1250000
NODE_13716_length_759_cov_8.268182	657	737	1	2	80	0.0250000
NODE_13716_length_759_cov_8.268182	657	737	2	68	80	0.8500000
NODE_13717_length_759_cov_6.833333	381	461	0	80	80	1.0000000
NODE_13717_length_759_cov_6.833333	434	515	0	81	81	1.0000000
NODE_13718_length_759_cov_6.407576	319	399	0	80	80	1.0000000
NODE_13718_length_759_cov_6.407576	372	452	0	80	80	1.0000000
NODE_13725_length_759_cov_3.400000	355	435	0	80	80	1.0000000
NODE_13725_length_759_cov_3.400000	408	488	0	80	80	1.0000000
NODE_13726_length_759_cov_3.346970	240	322	0	82	82	1.0000000
NODE_13760_length_758_cov_38.414264	215	295	2	11	80	0.1375000
NODE_13760_length_758_cov_38.414264	215	295	4	69	80	0.8625000
NODE_13760_length_758_cov_38.414264	268	348	0	51	80	0.6375000
NODE_13760_length_758_cov_38.414264	268	348	2	13	80	0.1625000
NODE_13760_length_758_cov_38.414264	268	348	4	16	80	0.2000000
NODE_13760_length_758_cov_38.414264	344	424	0	80	80	1.0000000
NODE_13760_length_758_cov_38.414264	397	477	0	80	80	1.0000000
NODE_13761_length_758_cov_36.722307	331	411	2	11	80	0.1375000
NODE_13761_length_758_cov_36.722307	331	411	6	69	80	0.8625000
NODE_13761_length_758_cov_36.722307	384	464	0	16	80	0.2000000
NODE_13761_length_758_cov_36.722307	384	464	2	48	80	0.6000000
NODE_13761_length_758_cov_36.722307	384	464	6	16	80	0.2000000
NODE_13762_length_758_cov_29.910470	235	315	0	19	80	0.2375000
NODE_13762_length_758_cov_29.910470	235	315	2	61	80	0.7625000
NODE_13762_length_758_cov_29.910470	288	368	0	10	80	0.1250000
NODE_13762_length_758_cov_29.910470	288	368	2	48	80	0.6000000
NODE_13762_length_758_cov_29.910470	288	368	4	22	80	0.2750000
NODE_13763_length_758_cov_16.226100	386	466	0	80	80	1.0000000
NODE_13763_length_758_cov_16.226100	439	519	0	80	80	1.0000000
NODE_13764_length_758_cov_16.097117	311	391	0	15	80	0.1875000
NODE_13764_length_758_cov_16.097117	311	391	2	65	80	0.8125000
NODE_13764_length_758_cov_16.097117	364	444	0	68	80	0.8500000
NODE_13764_length_758_cov_16.097117	364	444	2	12	80	0.1500000
NODE_13765_length_758_cov_15.525038	260	340	0	8	80	0.1000000
NODE_13765_length_758_cov_15.525038	260	340	4	7	80	0.0875000
NODE_13765_length_758_cov_15.525038	260	340	6	65	80	0.8125000
NODE_13765_length_758_cov_15.525038	313	393	0	2	80	0.0250000
NODE_13765_length_758_cov_15.525038	313	393	4	15	80	0.1875000
NODE_13765_length_758_cov_15.525038	313	393	6	63	80	0.7875000
NODE_13768_length_758_cov_9.153263	224	299	0	75	75	1.0000000
NODE_13771_length_758_cov_4.241275	508	588	2	80	80	1.0000000
NODE_13772_length_758_cov_3.902883	346	426	0	80	80	1.0000000
NODE_13772_length_758_cov_3.902883	399	479	0	80	80	1.0000000
NODE_13794_length_757_cov_49.057751	155	235	0	18	80	0.2250000
NODE_13794_length_757_cov_49.057751	155	235	4	41	80	0.5125000
NODE_13794_length_757_cov_49.057751	155	235	8	21	80	0.2625000
NODE_13794_length_757_cov_49.057751	208	288	4	6	80	0.0750000
NODE_13794_length_757_cov_49.057751	208	288	8	74	80	0.9250000
NODE_13795_length_757_cov_29.954407	181	262	0	81	81	1.0000000
NODE_13795_length_757_cov_29.954407	235	315	0	80	80	1.0000000
NODE_13795_length_757_cov_29.954407	311	391	0	80	80	1.0000000
NODE_13795_length_757_cov_29.954407	364	444	0	80	80	1.0000000
NODE_13796_length_757_cov_25.565350	352	432	2	80	80	1.0000000
NODE_13796_length_757_cov_25.565350	405	483	0	7	78	0.0897436
NODE_13796_length_757_cov_25.565350	405	483	2	71	78	0.9102564
NODE_13797_length_757_cov_18.338906	264	344	0	61	80	0.7625000
NODE_13797_length_757_cov_18.338906	264	344	2	19	80	0.2375000
NODE_13797_length_757_cov_18.338906	317	397	0	22	80	0.2750000
NODE_13797_length_757_cov_18.338906	317	397	2	58	80	0.7250000
NODE_13798_length_757_cov_15.879939	58	138	0	80	80	1.0000000
NODE_13798_length_757_cov_15.879939	111	191	0	80	80	1.0000000
NODE_13800_length_757_cov_15.291793	314	394	2	3	80	0.0375000
NODE_13800_length_757_cov_15.291793	314	394	6	2	80	0.0250000
NODE_13800_length_757_cov_15.291793	314	394	8	75	80	0.9375000
NODE_13800_length_757_cov_15.291793	367	447	2	46	80	0.5750000
NODE_13800_length_757_cov_15.291793	367	447	8	34	80	0.4250000
NODE_13807_length_757_cov_3.182371	423	503	0	80	80	1.0000000
NODE_13807_length_757_cov_3.182371	476	556	0	80	80	1.0000000
NODE_13832_length_756_cov_26.441400	287	367	0	46	80	0.5750000
NODE_13832_length_756_cov_26.441400	287	367	2	34	80	0.4250000
NODE_13832_length_756_cov_26.441400	340	420	2	80	80	1.0000000
NODE_13834_length_756_cov_13.097412	154	234	5	19	80	0.2375000
NODE_13834_length_756_cov_13.097412	154	234	6	16	80	0.2000000
NODE_13834_length_756_cov_13.097412	154	234	7	26	80	0.3250000
NODE_13834_length_756_cov_13.097412	154	234	8	1	80	0.0125000
NODE_13834_length_756_cov_13.097412	154	234	9	18	80	0.2250000
NODE_13834_length_756_cov_13.097412	207	287	4	25	80	0.3125000
NODE_13834_length_756_cov_13.097412	207	287	7	32	80	0.4000000
NODE_13834_length_756_cov_13.097412	207	287	8	22	80	0.2750000
NODE_13834_length_756_cov_13.097412	207	287	9	1	80	0.0125000
NODE_13835_length_756_cov_12.732116	377	457	2	18	80	0.2250000
NODE_13835_length_756_cov_12.732116	377	457	4	62	80	0.7750000
NODE_13836_length_756_cov_9.254186	241	321	2	24	80	0.3000000
NODE_13836_length_756_cov_9.254186	241	321	4	56	80	0.7000000
NODE_13836_length_756_cov_9.254186	294	374	0	30	80	0.3750000
NODE_13836_length_756_cov_9.254186	294	374	1	4	80	0.0500000
NODE_13836_length_756_cov_9.254186	294	374	2	43	80	0.5375000
NODE_13836_length_756_cov_9.254186	294	374	4	3	80	0.0375000
NODE_13837_length_756_cov_8.304414	363	409	0	46	46	1.0000000
NODE_13838_length_756_cov_8.105023	271	351	0	12	80	0.1500000
NODE_13838_length_756_cov_8.105023	271	351	2	68	80	0.8500000
NODE_13838_length_756_cov_8.105023	324	404	0	26	80	0.3250000
NODE_13838_length_756_cov_8.105023	324	404	2	54	80	0.6750000
NODE_13840_length_756_cov_6.622527	431	511	4	3	80	0.0375000
NODE_13840_length_756_cov_6.622527	431	511	6	69	80	0.8625000
NODE_13840_length_756_cov_6.622527	431	511	8	8	80	0.1000000
NODE_13840_length_756_cov_6.622527	484	565	0	10	81	0.1234568
NODE_13840_length_756_cov_6.622527	484	565	3	1	81	0.0123457
NODE_13840_length_756_cov_6.622527	484	565	4	16	81	0.1975309
NODE_13840_length_756_cov_6.622527	484	565	6	54	81	0.6666667
NODE_13888_length_755_cov_64.705793	303	383	0	14	80	0.1750000
NODE_13888_length_755_cov_64.705793	303	383	2	12	80	0.1500000
NODE_13888_length_755_cov_64.705793	303	383	6	24	80	0.3000000
NODE_13888_length_755_cov_64.705793	303	383	8	30	80	0.3750000
NODE_13888_length_755_cov_64.705793	356	436	4	3	80	0.0375000
NODE_13888_length_755_cov_64.705793	356	436	6	7	80	0.0875000
NODE_13888_length_755_cov_64.705793	356	436	8	70	80	0.8750000
NODE_13889_length_755_cov_58.214939	425	505	0	80	80	1.0000000
NODE_13889_length_755_cov_58.214939	425	505	0	80	80	1.0000000
NODE_13889_length_755_cov_58.214939	478	556	0	78	78	1.0000000
NODE_13889_length_755_cov_58.214939	478	556	0	78	78	1.0000000
NODE_13890_length_755_cov_25.945122	237	317	0	12	80	0.1500000
NODE_13890_length_755_cov_25.945122	237	317	2	8	80	0.1000000
NODE_13890_length_755_cov_25.945122	237	317	4	17	80	0.2125000
NODE_13890_length_755_cov_25.945122	237	317	6	43	80	0.5375000
NODE_13890_length_755_cov_25.945122	290	370	4	21	80	0.2625000
NODE_13890_length_755_cov_25.945122	290	370	6	59	80	0.7375000
NODE_13891_length_755_cov_24.263720	334	414	0	80	80	1.0000000
NODE_13891_length_755_cov_24.263720	387	467	0	80	80	1.0000000
NODE_13892_length_755_cov_15.559451	306	386	0	14	80	0.1750000
NODE_13892_length_755_cov_15.559451	306	386	2	66	80	0.8250000
NODE_13892_length_755_cov_15.559451	359	439	0	19	80	0.2375000
NODE_13892_length_755_cov_15.559451	359	439	2	61	80	0.7625000
NODE_13894_length_755_cov_10.196646	332	412	0	80	80	1.0000000
NODE_13894_length_755_cov_10.196646	385	465	0	80	80	1.0000000
NODE_13895_length_755_cov_9.772866	210	290	0	74	80	0.9250000
NODE_13895_length_755_cov_9.772866	210	290	2	6	80	0.0750000
NODE_13895_length_755_cov_9.772866	263	343	0	21	80	0.2625000
NODE_13895_length_755_cov_9.772866	263	343	2	38	80	0.4750000
NODE_13895_length_755_cov_9.772866	263	343	4	21	80	0.2625000
NODE_13936_length_754_cov_87.432061	208	288	0	80	80	1.0000000
NODE_13936_length_754_cov_87.432061	261	341	0	80	80	1.0000000
NODE_13937_length_754_cov_16.549618	156	236	0	80	80	1.0000000
NODE_13937_length_754_cov_16.549618	209	289	0	80	80	1.0000000
NODE_13939_length_754_cov_9.068702	316	396	0	80	80	1.0000000
NODE_13939_length_754_cov_9.068702	369	449	0	80	80	1.0000000
NODE_13940_length_754_cov_5.925191	287	367	0	6	80	0.0750000
NODE_13940_length_754_cov_5.925191	287	367	2	74	80	0.9250000
NODE_13940_length_754_cov_5.925191	340	420	0	59	80	0.7375000
NODE_13940_length_754_cov_5.925191	340	420	2	21	80	0.2625000
NODE_13974_length_753_cov_10.434251	386	466	4	21	80	0.2625000
NODE_13974_length_753_cov_10.434251	386	466	6	59	80	0.7375000
NODE_13974_length_753_cov_10.434251	439	519	2	19	80	0.2375000
NODE_13974_length_753_cov_10.434251	439	519	4	45	80	0.5625000
NODE_13974_length_753_cov_10.434251	439	519	6	16	80	0.2000000
NODE_13976_length_753_cov_7.056575	344	424	0	80	80	1.0000000
NODE_13976_length_753_cov_7.056575	397	477	0	80	80	1.0000000
NODE_13977_length_753_cov_4.597859	321	401	0	80	80	1.0000000
NODE_13977_length_753_cov_4.597859	374	454	0	80	80	1.0000000
NODE_14003_length_752_cov_66.281776	617	697	12	2	80	0.0250000
NODE_14003_length_752_cov_66.281776	617	697	14	1	80	0.0125000
NODE_14003_length_752_cov_66.281776	617	697	16	11	80	0.1375000
NODE_14003_length_752_cov_66.281776	617	697	20	1	80	0.0125000
NODE_14003_length_752_cov_66.281776	617	697	22	13	80	0.1625000
NODE_14003_length_752_cov_66.281776	617	697	24	8	80	0.1000000
NODE_14003_length_752_cov_66.281776	617	697	26	6	80	0.0750000
NODE_14003_length_752_cov_66.281776	617	697	28	16	80	0.2000000
NODE_14003_length_752_cov_66.281776	617	697	30	11	80	0.1375000
NODE_14003_length_752_cov_66.281776	617	697	32	11	80	0.1375000
NODE_14003_length_752_cov_66.281776	670	751	0	10	81	0.1234568
NODE_14003_length_752_cov_66.281776	670	751	2	5	81	0.0617284
NODE_14003_length_752_cov_66.281776	670	751	4	29	81	0.3580247
NODE_14003_length_752_cov_66.281776	670	751	6	5	81	0.0617284
NODE_14003_length_752_cov_66.281776	670	751	12	7	81	0.0864198
NODE_14003_length_752_cov_66.281776	670	751	14	1	81	0.0123457
NODE_14003_length_752_cov_66.281776	670	751	16	11	81	0.1358025
NODE_14003_length_752_cov_66.281776	670	751	20	1	81	0.0123457
NODE_14003_length_752_cov_66.281776	670	751	22	12	81	0.1481481
NODE_14004_length_752_cov_60.274119	193	273	2	30	80	0.3750000
NODE_14004_length_752_cov_60.274119	193	273	4	22	80	0.2750000
NODE_14004_length_752_cov_60.274119	193	273	7	2	80	0.0250000
NODE_14004_length_752_cov_60.274119	193	273	8	2	80	0.0250000
NODE_14004_length_752_cov_60.274119	193	273	9	14	80	0.1750000
NODE_14004_length_752_cov_60.274119	193	273	10	10	80	0.1250000
NODE_14004_length_752_cov_60.274119	246	326	7	2	80	0.0250000
NODE_14004_length_752_cov_60.274119	246	326	8	1	80	0.0125000
NODE_14004_length_752_cov_60.274119	246	326	9	14	80	0.1750000
NODE_14004_length_752_cov_60.274119	246	326	10	56	80	0.7000000
NODE_14004_length_752_cov_60.274119	246	326	12	7	80	0.0875000
NODE_14005_length_752_cov_19.811639	299	379	0	22	80	0.2750000
NODE_14005_length_752_cov_19.811639	299	379	2	58	80	0.7250000
NODE_14005_length_752_cov_19.811639	352	432	0	8	80	0.1000000
NODE_14005_length_752_cov_19.811639	352	432	2	72	80	0.9000000
NODE_14006_length_752_cov_17.661562	118	198	2	80	80	1.0000000
NODE_14006_length_752_cov_17.661562	171	251	0	38	80	0.4750000
NODE_14006_length_752_cov_17.661562	171	251	2	42	80	0.5250000
NODE_14007_length_752_cov_13.275651	241	321	2	5	80	0.0625000
NODE_14007_length_752_cov_13.275651	241	321	5	1	80	0.0125000
NODE_14007_length_752_cov_13.275651	241	321	6	20	80	0.2500000
NODE_14007_length_752_cov_13.275651	241	321	8	39	80	0.4875000
NODE_14007_length_752_cov_13.275651	241	321	10	15	80	0.1875000
NODE_14007_length_752_cov_13.275651	294	374	8	19	80	0.2375000
NODE_14007_length_752_cov_13.275651	294	374	10	59	80	0.7375000
NODE_14007_length_752_cov_13.275651	294	374	11	1	80	0.0125000
NODE_14007_length_752_cov_13.275651	294	374	12	1	80	0.0125000
NODE_14008_length_752_cov_10.928025	313	393	2	15	80	0.1875000
NODE_14008_length_752_cov_10.928025	313	393	4	7	80	0.0875000
NODE_14008_length_752_cov_10.928025	313	393	6	25	80	0.3125000
NODE_14008_length_752_cov_10.928025	313	393	8	33	80	0.4125000
NODE_14011_length_752_cov_9.558959	249	329	0	80	80	1.0000000
NODE_14011_length_752_cov_9.558959	302	382	0	36	80	0.4500000
NODE_14011_length_752_cov_9.558959	302	382	2	44	80	0.5500000
NODE_14014_length_752_cov_8.281776	237	317	2	50	80	0.6250000
NODE_14014_length_752_cov_8.281776	237	317	4	30	80	0.3750000
NODE_14014_length_752_cov_8.281776	290	370	2	43	80	0.5375000
NODE_14014_length_752_cov_8.281776	290	370	4	37	80	0.4625000
NODE_14015_length_752_cov_8.082695	352	432	0	80	80	1.0000000
NODE_14015_length_752_cov_8.082695	405	485	0	80	80	1.0000000
NODE_14044_length_751_cov_20.730061	238	318	2	80	80	1.0000000
NODE_14044_length_751_cov_20.730061	291	371	0	53	80	0.6625000
NODE_14044_length_751_cov_20.730061	291	371	2	27	80	0.3375000
NODE_14045_length_751_cov_18.478528	328	409	0	81	81	1.0000000
NODE_14045_length_751_cov_18.478528	382	462	0	80	80	1.0000000
NODE_14046_length_751_cov_13.016871	172	252	0	80	80	1.0000000
NODE_14046_length_751_cov_13.016871	225	305	0	80	80	1.0000000
NODE_14047_length_751_cov_12.363497	397	477	0	19	80	0.2375000
NODE_14047_length_751_cov_12.363497	397	477	3	61	80	0.7625000
NODE_14047_length_751_cov_12.363497	450	530	3	42	80	0.5250000
NODE_14047_length_751_cov_12.363497	450	530	6	38	80	0.4750000
NODE_14085_length_750_cov_46.371736	396	476	4	4	80	0.0500000
NODE_14085_length_750_cov_46.371736	396	476	8	1	80	0.0125000
NODE_14085_length_750_cov_46.371736	396	476	10	54	80	0.6750000
NODE_14085_length_750_cov_46.371736	396	476	12	21	80	0.2625000
NODE_14085_length_750_cov_46.371736	449	529	2	25	80	0.3125000
NODE_14085_length_750_cov_46.371736	449	529	6	15	80	0.1875000
NODE_14085_length_750_cov_46.371736	449	529	10	19	80	0.2375000
NODE_14085_length_750_cov_46.371736	449	529	12	21	80	0.2625000
NODE_14086_length_750_cov_24.428571	524	604	34	1	80	0.0125000
NODE_14086_length_750_cov_24.428571	524	604	38	1	80	0.0125000
NODE_14086_length_750_cov_24.428571	524	604	42	1	80	0.0125000
NODE_14086_length_750_cov_24.428571	524	604	44	1	80	0.0125000
NODE_14086_length_750_cov_24.428571	524	604	49	1	80	0.0125000
NODE_14086_length_750_cov_24.428571	524	604	51	1	80	0.0125000
NODE_14086_length_750_cov_24.428571	524	604	53	2	80	0.0250000
NODE_14086_length_750_cov_24.428571	524	604	54	18	80	0.2250000
NODE_14086_length_750_cov_24.428571	524	604	56	2	80	0.0250000
NODE_14086_length_750_cov_24.428571	524	604	58	5	80	0.0625000
NODE_14086_length_750_cov_24.428571	524	604	60	12	80	0.1500000
NODE_14086_length_750_cov_24.428571	524	604	62	11	80	0.1375000
NODE_14086_length_750_cov_24.428571	524	604	63	6	80	0.0750000
NODE_14086_length_750_cov_24.428571	524	604	64	3	80	0.0375000
NODE_14086_length_750_cov_24.428571	524	604	65	4	80	0.0500000
NODE_14086_length_750_cov_24.428571	524	604	67	11	80	0.1375000
NODE_14086_length_750_cov_24.428571	683	746	0	63	63	1.0000000
NODE_14087_length_750_cov_24.311828	325	405	0	26	80	0.3250000
NODE_14087_length_750_cov_24.311828	325	405	2	54	80	0.6750000
NODE_14087_length_750_cov_24.311828	378	458	0	66	80	0.8250000
NODE_14087_length_750_cov_24.311828	378	458	2	14	80	0.1750000
NODE_14089_length_750_cov_8.529954	336	416	0	25	80	0.3125000
NODE_14089_length_750_cov_8.529954	336	416	2	55	80	0.6875000
NODE_14089_length_750_cov_8.529954	395	469	2	74	74	1.0000000
NODE_14137_length_749_cov_18.986154	221	301	0	80	80	1.0000000
NODE_14137_length_749_cov_18.986154	274	354	0	80	80	1.0000000
NODE_14138_length_749_cov_18.836923	273	355	0	82	82	1.0000000
NODE_14138_length_749_cov_18.836923	328	408	0	80	80	1.0000000
NODE_14138_length_749_cov_18.836923	404	484	0	42	80	0.5250000
NODE_14138_length_749_cov_18.836923	404	484	2	10	80	0.1250000
NODE_14138_length_749_cov_18.836923	404	484	4	28	80	0.3500000
NODE_14138_length_749_cov_18.836923	457	535	4	32	78	0.4102564
NODE_14138_length_749_cov_18.836923	457	535	8	1	78	0.0128205
NODE_14138_length_749_cov_18.836923	457	535	10	45	78	0.5769231
NODE_14139_length_749_cov_16.160000	232	253	8	11	21	0.5238096
NODE_14139_length_749_cov_16.160000	232	253	10	10	21	0.4761905
NODE_14139_length_749_cov_16.160000	232	306	8	11	74	0.1486486
NODE_14139_length_749_cov_16.160000	232	306	10	17	74	0.2297297
NODE_14139_length_749_cov_16.160000	232	306	11	10	74	0.1351351
NODE_14139_length_749_cov_16.160000	232	306	12	36	74	0.4864865
NODE_14140_length_749_cov_16.115385	307	387	0	33	80	0.4125000
NODE_14140_length_749_cov_16.115385	307	387	2	47	80	0.5875000
NODE_14140_length_749_cov_16.115385	360	440	0	15	80	0.1875000
NODE_14140_length_749_cov_16.115385	360	440	2	65	80	0.8125000
NODE_14141_length_749_cov_11.210769	340	420	0	80	80	1.0000000
NODE_14141_length_749_cov_11.210769	393	473	0	80	80	1.0000000
NODE_14142_length_749_cov_8.424615	372	452	0	80	80	1.0000000
NODE_14142_length_749_cov_8.424615	425	505	0	80	80	1.0000000
NODE_14145_length_749_cov_4.521538	550	630	0	80	80	1.0000000
NODE_14145_length_749_cov_4.521538	603	683	0	80	80	1.0000000
NODE_14185_length_748_cov_55.348228	393	473	0	27	80	0.3375000
NODE_14185_length_748_cov_55.348228	393	473	2	10	80	0.1250000
NODE_14185_length_748_cov_55.348228	393	473	4	1	80	0.0125000
NODE_14185_length_748_cov_55.348228	393	473	6	11	80	0.1375000
NODE_14185_length_748_cov_55.348228	393	473	8	31	80	0.3875000
NODE_14185_length_748_cov_55.348228	446	526	4	5	80	0.0625000
NODE_14185_length_748_cov_55.348228	446	526	6	1	80	0.0125000
NODE_14185_length_748_cov_55.348228	446	526	8	74	80	0.9250000
NODE_14186_length_748_cov_51.838213	369	449	0	55	80	0.6875000
NODE_14186_length_748_cov_51.838213	369	449	2	9	80	0.1125000
NODE_14186_length_748_cov_51.838213	369	449	12	6	80	0.0750000
NODE_14186_length_748_cov_51.838213	369	449	17	1	80	0.0125000
NODE_14186_length_748_cov_51.838213	369	449	18	9	80	0.1125000
NODE_14186_length_748_cov_51.838213	422	502	0	2	80	0.0250000
NODE_14186_length_748_cov_51.838213	422	502	2	9	80	0.1125000
NODE_14186_length_748_cov_51.838213	422	502	12	6	80	0.0750000
NODE_14186_length_748_cov_51.838213	422	502	17	1	80	0.0125000
NODE_14186_length_748_cov_51.838213	422	502	18	62	80	0.7750000
NODE_14187_length_748_cov_46.952234	293	373	0	4	80	0.0500000
NODE_14187_length_748_cov_46.952234	293	373	2	14	80	0.1750000
NODE_14187_length_748_cov_46.952234	293	373	10	14	80	0.1750000
NODE_14187_length_748_cov_46.952234	293	373	11	7	80	0.0875000
NODE_14187_length_748_cov_46.952234	293	373	12	41	80	0.5125000
NODE_14187_length_748_cov_46.952234	346	426	7	12	80	0.1500000
NODE_14187_length_748_cov_46.952234	346	426	9	18	80	0.2250000
NODE_14187_length_748_cov_46.952234	346	426	11	30	80	0.3750000
NODE_14187_length_748_cov_46.952234	346	426	12	20	80	0.2500000
NODE_14188_length_748_cov_45.001541	272	352	0	80	80	1.0000000
NODE_14188_length_748_cov_45.001541	325	405	0	80	80	1.0000000
NODE_14189_length_748_cov_34.355932	488	568	2	34	80	0.4250000
NODE_14189_length_748_cov_34.355932	488	568	4	5	80	0.0625000
NODE_14189_length_748_cov_34.355932	488	568	6	8	80	0.1000000
NODE_14189_length_748_cov_34.355932	488	568	8	3	80	0.0375000
NODE_14189_length_748_cov_34.355932	488	568	12	17	80	0.2125000
NODE_14189_length_748_cov_34.355932	488	568	14	13	80	0.1625000
NODE_14189_length_748_cov_34.355932	541	621	6	4	80	0.0500000
NODE_14189_length_748_cov_34.355932	541	621	8	10	80	0.1250000
NODE_14189_length_748_cov_34.355932	541	621	10	10	80	0.1250000
NODE_14189_length_748_cov_34.355932	541	621	12	43	80	0.5375000
NODE_14189_length_748_cov_34.355932	541	621	14	13	80	0.1625000
NODE_14190_length_748_cov_25.972265	297	377	4	2	80	0.0250000
NODE_14190_length_748_cov_25.972265	297	377	8	47	80	0.5875000
NODE_14190_length_748_cov_25.972265	297	377	10	2	80	0.0250000
NODE_14190_length_748_cov_25.972265	297	377	12	29	80	0.3625000
NODE_14190_length_748_cov_25.972265	350	430	0	5	80	0.0625000
NODE_14190_length_748_cov_25.972265	350	430	4	50	80	0.6250000
NODE_14190_length_748_cov_25.972265	350	430	8	11	80	0.1375000
NODE_14190_length_748_cov_25.972265	350	430	10	2	80	0.0250000
NODE_14190_length_748_cov_25.972265	350	430	12	12	80	0.1500000
NODE_14191_length_748_cov_21.050847	362	442	0	67	80	0.8375000
NODE_14191_length_748_cov_21.050847	362	442	3	1	80	0.0125000
NODE_14191_length_748_cov_21.050847	362	442	4	12	80	0.1500000
NODE_14191_length_748_cov_21.050847	415	495	0	14	80	0.1750000
NODE_14191_length_748_cov_21.050847	415	495	3	1	80	0.0125000
NODE_14191_length_748_cov_21.050847	415	495	4	65	80	0.8125000
NODE_14192_length_748_cov_20.682589	353	433	0	9	80	0.1125000
NODE_14192_length_748_cov_20.682589	353	433	2	71	80	0.8875000
NODE_14192_length_748_cov_20.682589	406	486	1	37	80	0.4625000
NODE_14192_length_748_cov_20.682589	406	486	2	43	80	0.5375000
NODE_14193_length_748_cov_19.081664	261	341	0	80	80	1.0000000
NODE_14193_length_748_cov_19.081664	314	394	0	80	80	1.0000000
NODE_14193_length_748_cov_19.081664	390	470	0	44	80	0.5500000
NODE_14193_length_748_cov_19.081664	390	470	2	36	80	0.4500000
NODE_14193_length_748_cov_19.081664	443	522	0	13	79	0.1645570
NODE_14193_length_748_cov_19.081664	443	522	2	66	79	0.8354430
NODE_14194_length_748_cov_16.579353	81	161	2	20	80	0.2500000
NODE_14194_length_748_cov_16.579353	81	161	4	60	80	0.7500000
NODE_14194_length_748_cov_16.579353	134	214	0	44	80	0.5500000
NODE_14194_length_748_cov_16.579353	134	214	2	13	80	0.1625000
NODE_14194_length_748_cov_16.579353	134	214	4	23	80	0.2875000
NODE_14194_length_748_cov_16.579353	210	290	0	80	80	1.0000000
NODE_14194_length_748_cov_16.579353	263	343	0	80	80	1.0000000
NODE_14196_length_748_cov_11.983051	375	455	0	80	80	1.0000000
NODE_14196_length_748_cov_11.983051	428	508	0	54	80	0.6750000
NODE_14196_length_748_cov_11.983051	428	508	2	26	80	0.3250000
NODE_14197_length_748_cov_11.474576	257	337	0	80	80	1.0000000
NODE_14197_length_748_cov_11.474576	310	390	0	80	80	1.0000000
NODE_14200_length_748_cov_7.979969	223	303	0	24	80	0.3000000
NODE_14200_length_748_cov_7.979969	223	303	2	17	80	0.2125000
NODE_14200_length_748_cov_7.979969	223	303	4	39	80	0.4875000
NODE_14200_length_748_cov_7.979969	276	356	0	77	80	0.9625000
NODE_14200_length_748_cov_7.979969	276	356	2	3	80	0.0375000
NODE_14240_length_747_cov_24.279321	205	285	2	13	80	0.1625000
NODE_14240_length_747_cov_24.279321	205	285	6	29	80	0.3625000
NODE_14240_length_747_cov_24.279321	205	285	8	38	80	0.4750000
NODE_14240_length_747_cov_24.279321	258	338	0	20	80	0.2500000
NODE_14240_length_747_cov_24.279321	258	338	2	3	80	0.0375000
NODE_14240_length_747_cov_24.279321	258	338	6	19	80	0.2375000
NODE_14240_length_747_cov_24.279321	258	338	8	38	80	0.4750000
NODE_14241_length_747_cov_15.438272	352	432	0	80	80	1.0000000
NODE_14241_length_747_cov_15.438272	405	485	0	80	80	1.0000000
NODE_14244_length_747_cov_7.979938	237	317	0	34	80	0.4250000
NODE_14244_length_747_cov_7.979938	237	317	1	1	80	0.0125000
NODE_14244_length_747_cov_7.979938	237	317	3	6	80	0.0750000
NODE_14244_length_747_cov_7.979938	237	317	5	13	80	0.1625000
NODE_14244_length_747_cov_7.979938	237	317	6	26	80	0.3250000
NODE_14244_length_747_cov_7.979938	290	370	0	80	80	1.0000000
NODE_14248_length_747_cov_4.918210	157	237	0	80	80	1.0000000
NODE_14248_length_747_cov_4.918210	210	290	0	60	80	0.7500000
NODE_14248_length_747_cov_4.918210	210	290	2	14	80	0.1750000
NODE_14248_length_747_cov_4.918210	210	290	4	6	80	0.0750000
NODE_14277_length_746_cov_44.041731	153	233	6	80	80	1.0000000
NODE_14277_length_746_cov_44.041731	206	286	0	51	80	0.6375000
NODE_14277_length_746_cov_44.041731	206	286	6	29	80	0.3625000
NODE_14278_length_746_cov_24.435858	334	414	0	2	80	0.0250000
NODE_14278_length_746_cov_24.435858	334	414	2	78	80	0.9750000
NODE_14278_length_746_cov_24.435858	387	467	0	55	80	0.6875000
NODE_14278_length_746_cov_24.435858	387	467	2	25	80	0.3125000
NODE_14279_length_746_cov_20.225657	114	194	1	80	80	1.0000000
NODE_14279_length_746_cov_20.225657	167	247	1	28	80	0.3500000
NODE_14279_length_746_cov_20.225657	167	247	2	52	80	0.6500000
NODE_14280_length_746_cov_17.919629	330	410	0	19	80	0.2375000
NODE_14280_length_746_cov_17.919629	330	410	2	61	80	0.7625000
NODE_14280_length_746_cov_17.919629	383	463	0	10	80	0.1250000
NODE_14280_length_746_cov_17.919629	383	463	2	70	80	0.8750000
NODE_14281_length_746_cov_17.523957	292	372	0	80	80	1.0000000
NODE_14281_length_746_cov_17.523957	345	425	0	80	80	1.0000000
NODE_14282_length_746_cov_17.214838	306	386	4	80	80	1.0000000
NODE_14282_length_746_cov_17.214838	359	439	2	41	80	0.5125000
NODE_14282_length_746_cov_17.214838	359	439	4	39	80	0.4875000
NODE_14283_length_746_cov_16.765070	344	424	2	80	80	1.0000000
NODE_14283_length_746_cov_16.765070	397	477	2	80	80	1.0000000
NODE_14284_length_746_cov_13.153014	126	206	0	80	80	1.0000000
NODE_14284_length_746_cov_13.153014	179	259	0	80	80	1.0000000
NODE_14284_length_746_cov_13.153014	244	263	0	19	19	1.0000000
NODE_14285_length_746_cov_12.316847	364	442	0	78	78	1.0000000
NODE_14286_length_746_cov_11.301391	349	429	4	29	80	0.3625000
NODE_14286_length_746_cov_11.301391	349	429	6	25	80	0.3125000
NODE_14286_length_746_cov_11.301391	349	429	8	26	80	0.3250000
NODE_14286_length_746_cov_11.301391	402	482	4	2	80	0.0250000
NODE_14286_length_746_cov_11.301391	402	482	6	78	80	0.9750000
NODE_14302_length_746_cov_2.639876	331	411	5	4	80	0.0500000
NODE_14302_length_746_cov_2.639876	331	411	7	18	80	0.2250000
NODE_14302_length_746_cov_2.639876	331	411	8	45	80	0.5625000
NODE_14302_length_746_cov_2.639876	331	411	10	13	80	0.1625000
NODE_14307_length_746_cov_1.879444	435	502	0	67	67	1.0000000
NODE_14310_length_746_cov_1.727975	65	121	0	56	56	1.0000000
NODE_14310_length_746_cov_1.727975	494	540	0	46	46	1.0000000
NODE_14329_length_745_cov_40.360681	257	337	0	32	80	0.4000000
NODE_14329_length_745_cov_40.360681	257	337	5	48	80	0.6000000
NODE_14329_length_745_cov_40.360681	310	390	5	46	80	0.5750000
NODE_14329_length_745_cov_40.360681	310	390	6	34	80	0.4250000
NODE_14330_length_745_cov_30.817337	339	419	0	36	80	0.4500000
NODE_14330_length_745_cov_30.817337	339	419	2	44	80	0.5500000
NODE_14330_length_745_cov_30.817337	392	459	0	67	67	1.0000000
NODE_14335_length_745_cov_8.620743	225	275	0	50	50	1.0000000
NODE_14335_length_745_cov_8.620743	248	328	0	80	80	1.0000000
NODE_14343_length_745_cov_3.922601	249	280	24	2	31	0.0645161
NODE_14343_length_745_cov_3.922601	249	280	26	23	31	0.7419355
NODE_14343_length_745_cov_3.922601	249	280	28	6	31	0.1935484
NODE_14343_length_745_cov_3.922601	253	333	10	3	80	0.0375000
NODE_14343_length_745_cov_3.922601	253	333	11	9	80	0.1125000
NODE_14343_length_745_cov_3.922601	253	333	12	5	80	0.0625000
NODE_14343_length_745_cov_3.922601	253	333	14	4	80	0.0500000
NODE_14343_length_745_cov_3.922601	253	333	16	2	80	0.0250000
NODE_14343_length_745_cov_3.922601	253	333	18	6	80	0.0750000
NODE_14343_length_745_cov_3.922601	253	333	20	4	80	0.0500000
NODE_14343_length_745_cov_3.922601	253	333	24	10	80	0.1250000
NODE_14343_length_745_cov_3.922601	253	333	26	27	80	0.3375000
NODE_14343_length_745_cov_3.922601	253	333	28	10	80	0.1250000
NODE_14381_length_744_cov_44.953488	553	633	0	80	80	1.0000000
NODE_14381_length_744_cov_44.953488	553	633	0	80	80	1.0000000
NODE_14381_length_744_cov_44.953488	553	633	0	80	80	1.0000000
NODE_14381_length_744_cov_44.953488	553	633	0	80	80	1.0000000
NODE_14382_length_744_cov_35.333333	163	243	0	80	80	1.0000000
NODE_14382_length_744_cov_35.333333	216	296	0	80	80	1.0000000
NODE_14382_length_744_cov_35.333333	292	372	0	69	80	0.8625000
NODE_14382_length_744_cov_35.333333	292	372	2	11	80	0.1375000
NODE_14382_length_744_cov_35.333333	345	425	0	16	80	0.2000000
NODE_14382_length_744_cov_35.333333	345	425	2	18	80	0.2250000
NODE_14382_length_744_cov_35.333333	345	425	4	46	80	0.5750000
NODE_14383_length_744_cov_34.503876	294	374	2	2	80	0.0250000
NODE_14383_length_744_cov_34.503876	294	374	4	78	80	0.9750000
NODE_14383_length_744_cov_34.503876	347	427	0	13	80	0.1625000
NODE_14383_length_744_cov_34.503876	347	427	2	4	80	0.0500000
NODE_14383_length_744_cov_34.503876	347	427	4	63	80	0.7875000
NODE_14384_length_744_cov_32.282171	333	403	0	70	70	1.0000000
NODE_14384_length_744_cov_32.282171	440	520	0	80	80	1.0000000
NODE_14384_length_744_cov_32.282171	493	573	0	80	80	1.0000000
NODE_14390_length_744_cov_4.537984	260	340	0	68	80	0.8500000
NODE_14390_length_744_cov_4.537984	260	340	1	9	80	0.1125000
NODE_14390_length_744_cov_4.537984	260	340	2	3	80	0.0375000
NODE_14390_length_744_cov_4.537984	313	393	0	15	80	0.1875000
NODE_14390_length_744_cov_4.537984	313	393	1	9	80	0.1125000
NODE_14390_length_744_cov_4.537984	313	393	2	56	80	0.7000000
NODE_14396_length_744_cov_2.784496	335	387	2	52	52	1.0000000
NODE_14396_length_744_cov_2.784496	360	437	0	40	77	0.5194805
NODE_14396_length_744_cov_2.784496	360	437	2	37	77	0.4805195
NODE_14427_length_743_cov_26.369565	354	434	0	66	80	0.8250000
NODE_14427_length_743_cov_26.369565	354	434	2	5	80	0.0625000
NODE_14427_length_743_cov_26.369565	354	434	3	4	80	0.0500000
NODE_14427_length_743_cov_26.369565	354	434	4	5	80	0.0625000
NODE_14427_length_743_cov_26.369565	407	487	0	18	80	0.2250000
NODE_14427_length_743_cov_26.369565	407	487	3	4	80	0.0500000
NODE_14427_length_743_cov_26.369565	407	487	4	58	80	0.7250000
NODE_14428_length_743_cov_21.759317	138	218	0	34	80	0.4250000
NODE_14428_length_743_cov_21.759317	138	218	4	3	80	0.0375000
NODE_14428_length_743_cov_21.759317	138	218	6	1	80	0.0125000
NODE_14428_length_743_cov_21.759317	138	218	9	20	80	0.2500000
NODE_14428_length_743_cov_21.759317	138	218	11	10	80	0.1250000
NODE_14428_length_743_cov_21.759317	138	218	12	12	80	0.1500000
NODE_14428_length_743_cov_21.759317	191	271	9	5	80	0.0625000
NODE_14428_length_743_cov_21.759317	191	271	11	10	80	0.1250000
NODE_14428_length_743_cov_21.759317	191	271	12	65	80	0.8125000
NODE_14429_length_743_cov_18.173913	213	293	0	78	80	0.9750000
NODE_14429_length_743_cov_18.173913	213	293	2	2	80	0.0250000
NODE_14429_length_743_cov_18.173913	266	346	0	25	80	0.3125000
NODE_14429_length_743_cov_18.173913	266	346	2	55	80	0.6875000
NODE_14431_length_743_cov_17.066770	400	480	2	61	80	0.7625000
NODE_14431_length_743_cov_17.066770	400	480	4	19	80	0.2375000
NODE_14431_length_743_cov_17.066770	453	532	0	1	79	0.0126582
NODE_14431_length_743_cov_17.066770	453	532	2	78	79	0.9873418
NODE_14432_length_743_cov_16.354037	350	430	0	59	80	0.7375000
NODE_14432_length_743_cov_16.354037	350	430	2	9	80	0.1125000
NODE_14432_length_743_cov_16.354037	350	430	4	12	80	0.1500000
NODE_14432_length_743_cov_16.354037	403	483	0	6	80	0.0750000
NODE_14432_length_743_cov_16.354037	403	483	2	9	80	0.1125000
NODE_14432_length_743_cov_16.354037	403	483	4	65	80	0.8125000
NODE_14433_length_743_cov_15.667702	220	300	2	80	80	1.0000000
NODE_14433_length_743_cov_15.667702	273	353	0	40	80	0.5000000
NODE_14433_length_743_cov_15.667702	273	353	2	40	80	0.5000000
NODE_14433_length_743_cov_15.667702	349	429	0	80	80	1.0000000
NODE_14433_length_743_cov_15.667702	402	482	0	80	80	1.0000000
NODE_14434_length_743_cov_14.975155	289	362	8	9	73	0.1232877
NODE_14434_length_743_cov_14.975155	289	362	10	10	73	0.1369863
NODE_14434_length_743_cov_14.975155	289	362	12	54	73	0.7397260
NODE_14435_length_743_cov_14.100932	232	312	0	20	80	0.2500000
NODE_14435_length_743_cov_14.100932	232	312	2	46	80	0.5750000
NODE_14435_length_743_cov_14.100932	232	312	4	14	80	0.1750000
NODE_14435_length_743_cov_14.100932	285	365	0	13	80	0.1625000
NODE_14435_length_743_cov_14.100932	285	365	4	53	80	0.6625000
NODE_14435_length_743_cov_14.100932	285	365	6	14	80	0.1750000
NODE_14435_length_743_cov_14.100932	361	441	2	35	80	0.4375000
NODE_14435_length_743_cov_14.100932	361	441	6	45	80	0.5625000
NODE_14435_length_743_cov_14.100932	414	494	2	60	80	0.7500000
NODE_14435_length_743_cov_14.100932	414	494	4	20	80	0.2500000
NODE_14436_length_743_cov_12.968944	268	348	6	10	80	0.1250000
NODE_14436_length_743_cov_12.968944	268	348	8	13	80	0.1625000
NODE_14436_length_743_cov_12.968944	268	348	10	20	80	0.2500000
NODE_14436_length_743_cov_12.968944	268	348	12	37	80	0.4625000
NODE_14436_length_743_cov_12.968944	321	401	0	4	80	0.0500000
NODE_14436_length_743_cov_12.968944	321	401	6	13	80	0.1625000
NODE_14436_length_743_cov_12.968944	321	401	8	12	80	0.1500000
NODE_14436_length_743_cov_12.968944	321	401	10	6	80	0.0750000
NODE_14436_length_743_cov_12.968944	321	401	12	45	80	0.5625000
NODE_14437_length_743_cov_12.847826	485	565	2	80	80	1.0000000
NODE_14437_length_743_cov_12.847826	538	618	0	49	80	0.6125000
NODE_14437_length_743_cov_12.847826	538	618	2	31	80	0.3875000
NODE_14438_length_743_cov_11.871118	403	483	0	53	80	0.6625000
NODE_14438_length_743_cov_11.871118	403	483	2	27	80	0.3375000
NODE_14438_length_743_cov_11.871118	456	536	2	80	80	1.0000000
NODE_14439_length_743_cov_11.760870	337	417	0	58	80	0.7250000
NODE_14439_length_743_cov_11.760870	337	417	2	1	80	0.0125000
NODE_14439_length_743_cov_11.760870	337	417	3	21	80	0.2625000
NODE_14439_length_743_cov_11.760870	390	470	0	5	80	0.0625000
NODE_14439_length_743_cov_11.760870	390	470	2	1	80	0.0125000
NODE_14439_length_743_cov_11.760870	390	470	3	74	80	0.9250000
NODE_14440_length_743_cov_9.006211	351	431	0	80	80	1.0000000
NODE_14440_length_743_cov_9.006211	404	484	0	80	80	1.0000000
NODE_14441_length_743_cov_8.063665	290	370	0	80	80	1.0000000
NODE_14441_length_743_cov_8.063665	343	423	0	80	80	1.0000000
NODE_14456_length_743_cov_2.029503	260	284	0	24	24	1.0000000
NODE_14456_length_743_cov_2.029503	301	363	0	62	62	1.0000000
NODE_14473_length_743_cov_0.989130	592	670	2	4	78	0.0512821
NODE_14473_length_743_cov_0.989130	592	670	4	2	78	0.0256410
NODE_14473_length_743_cov_0.989130	592	670	8	3	78	0.0384615
NODE_14473_length_743_cov_0.989130	592	670	14	4	78	0.0512821
NODE_14473_length_743_cov_0.989130	592	670	18	1	78	0.0128205
NODE_14473_length_743_cov_0.989130	592	670	20	1	78	0.0128205
NODE_14473_length_743_cov_0.989130	592	670	28	3	78	0.0384615
NODE_14473_length_743_cov_0.989130	592	670	30	13	78	0.1666667
NODE_14473_length_743_cov_0.989130	592	670	32	2	78	0.0256410
NODE_14473_length_743_cov_0.989130	592	670	36	13	78	0.1666667
NODE_14473_length_743_cov_0.989130	592	670	38	32	78	0.4102564
NODE_14477_length_742_cov_23.664075	271	351	0	80	80	1.0000000
NODE_14477_length_742_cov_23.664075	324	404	0	80	80	1.0000000
NODE_14478_length_742_cov_19.488336	288	368	0	41	80	0.5125000
NODE_14478_length_742_cov_19.488336	288	368	2	39	80	0.4875000
NODE_14478_length_742_cov_19.488336	341	421	2	80	80	1.0000000
NODE_14479_length_742_cov_18.528771	319	399	0	80	80	1.0000000
NODE_14479_length_742_cov_18.528771	372	452	0	80	80	1.0000000
NODE_14480_length_742_cov_17.401244	126	206	0	80	80	1.0000000
NODE_14480_length_742_cov_17.401244	179	259	0	80	80	1.0000000
NODE_14482_length_742_cov_7.679627	274	354	0	80	80	1.0000000
NODE_14482_length_742_cov_7.679627	327	407	0	80	80	1.0000000
NODE_14521_length_741_cov_12.168224	316	392	0	23	76	0.3026316
NODE_14521_length_741_cov_12.168224	316	392	2	2	76	0.0263158
NODE_14521_length_741_cov_12.168224	316	392	4	1	76	0.0131579
NODE_14521_length_741_cov_12.168224	316	392	6	6	76	0.0789474
NODE_14521_length_741_cov_12.168224	316	392	7	22	76	0.2894737
NODE_14521_length_741_cov_12.168224	316	392	8	22	76	0.2894737
NODE_14521_length_741_cov_12.168224	598	663	0	61	65	0.9384615
NODE_14521_length_741_cov_12.168224	598	663	2	4	65	0.0615385
NODE_14522_length_741_cov_8.542056	198	278	0	30	80	0.3750000
NODE_14522_length_741_cov_8.542056	198	278	4	50	80	0.6250000
NODE_14522_length_741_cov_8.542056	251	331	0	20	80	0.2500000
NODE_14522_length_741_cov_8.542056	251	331	4	60	80	0.7500000
NODE_14525_length_741_cov_5.989097	457	538	2	19	81	0.2345679
NODE_14525_length_741_cov_5.989097	457	538	4	4	81	0.0493827
NODE_14525_length_741_cov_5.989097	457	538	6	58	81	0.7160494
NODE_14536_length_741_cov_2.556075	212	289	2	76	77	0.9870130
NODE_14536_length_741_cov_2.556075	212	289	8	1	77	0.0129870
NODE_14571_length_740_cov_54.372855	192	272	2	23	80	0.2875000
NODE_14571_length_740_cov_54.372855	192	272	3	2	80	0.0250000
NODE_14571_length_740_cov_54.372855	192	272	4	55	80	0.6875000
NODE_14571_length_740_cov_54.372855	245	325	0	6	80	0.0750000
NODE_14571_length_740_cov_54.372855	245	325	2	36	80	0.4500000
NODE_14571_length_740_cov_54.372855	245	325	3	13	80	0.1625000
NODE_14571_length_740_cov_54.372855	245	325	4	25	80	0.3125000
NODE_14571_length_740_cov_54.372855	321	401	0	52	80	0.6500000
NODE_14571_length_740_cov_54.372855	321	401	2	28	80	0.3500000
NODE_14571_length_740_cov_54.372855	374	454	2	80	80	1.0000000
NODE_14572_length_740_cov_51.758190	194	274	0	80	80	1.0000000
NODE_14572_length_740_cov_51.758190	247	327	0	80	80	1.0000000
NODE_14573_length_740_cov_34.185647	359	439	0	3	80	0.0375000
NODE_14573_length_740_cov_34.185647	359	439	2	18	80	0.2250000
NODE_14573_length_740_cov_34.185647	359	439	5	1	80	0.0125000
NODE_14573_length_740_cov_34.185647	359	439	6	58	80	0.7250000
NODE_14573_length_740_cov_34.185647	412	492	4	37	80	0.4625000
NODE_14573_length_740_cov_34.185647	412	492	6	43	80	0.5375000
NODE_14574_length_740_cov_24.794072	286	366	0	80	80	1.0000000
NODE_14574_length_740_cov_24.794072	339	419	0	80	80	1.0000000
NODE_14575_length_740_cov_20.361934	316	396	0	10	80	0.1250000
NODE_14575_length_740_cov_20.361934	316	396	2	70	80	0.8750000
NODE_14575_length_740_cov_20.361934	369	449	0	49	80	0.6125000
NODE_14575_length_740_cov_20.361934	369	449	2	31	80	0.3875000
NODE_14576_length_740_cov_18.982839	266	348	2	82	82	1.0000000
NODE_14576_length_740_cov_18.982839	321	401	0	52	80	0.6500000
NODE_14576_length_740_cov_18.982839	321	401	2	28	80	0.3500000
NODE_14577_length_740_cov_16.755070	354	434	0	80	80	1.0000000
NODE_14577_length_740_cov_16.755070	407	487	0	80	80	1.0000000
NODE_14579_length_740_cov_7.585023	206	286	0	80	80	1.0000000
NODE_14579_length_740_cov_7.585023	259	339	0	80	80	1.0000000
NODE_14580_length_740_cov_7.174727	165	245	0	71	80	0.8875000
NODE_14580_length_740_cov_7.174727	165	245	5	9	80	0.1125000
NODE_14580_length_740_cov_7.174727	218	298	0	18	80	0.2250000
NODE_14580_length_740_cov_7.174727	218	298	5	34	80	0.4250000
NODE_14580_length_740_cov_7.174727	218	298	6	28	80	0.3500000
NODE_14614_length_739_cov_52.970312	346	426	2	21	80	0.2625000
NODE_14614_length_739_cov_52.970312	346	426	3	7	80	0.0875000
NODE_14614_length_739_cov_52.970312	346	426	4	24	80	0.3000000
NODE_14614_length_739_cov_52.970312	346	426	5	17	80	0.2125000
NODE_14614_length_739_cov_52.970312	346	426	7	5	80	0.0625000
NODE_14614_length_739_cov_52.970312	346	426	9	6	80	0.0750000
NODE_14614_length_739_cov_52.970312	399	479	5	16	80	0.2000000
NODE_14614_length_739_cov_52.970312	399	479	7	5	80	0.0625000
NODE_14614_length_739_cov_52.970312	399	479	9	9	80	0.1125000
NODE_14614_length_739_cov_52.970312	399	479	10	26	80	0.3250000
NODE_14614_length_739_cov_52.970312	399	479	11	24	80	0.3000000
NODE_14615_length_739_cov_31.175000	204	284	2	15	80	0.1875000
NODE_14615_length_739_cov_31.175000	204	284	4	65	80	0.8125000
NODE_14615_length_739_cov_31.175000	257	337	0	9	80	0.1125000
NODE_14615_length_739_cov_31.175000	257	337	4	71	80	0.8875000
NODE_14616_length_739_cov_25.482813	487	567	0	80	80	1.0000000
NODE_14616_length_739_cov_25.482813	540	620	0	80	80	1.0000000
NODE_14617_length_739_cov_24.871875	191	271	0	80	80	1.0000000
NODE_14617_length_739_cov_24.871875	244	324	0	55	80	0.6875000
NODE_14617_length_739_cov_24.871875	244	324	2	25	80	0.3125000
NODE_14618_length_739_cov_18.360937	146	226	0	80	80	1.0000000
NODE_14618_length_739_cov_18.360937	199	279	0	80	80	1.0000000
NODE_14619_length_739_cov_13.195312	273	353	0	38	80	0.4750000
NODE_14619_length_739_cov_13.195312	273	353	2	25	80	0.3125000
NODE_14619_length_739_cov_13.195312	273	353	4	17	80	0.2125000
NODE_14619_length_739_cov_13.195312	326	406	0	22	80	0.2750000
NODE_14619_length_739_cov_13.195312	326	406	2	17	80	0.2125000
NODE_14619_length_739_cov_13.195312	326	406	4	41	80	0.5125000
NODE_14620_length_739_cov_10.314063	231	311	0	80	80	1.0000000
NODE_14620_length_739_cov_10.314063	284	364	0	80	80	1.0000000
NODE_14622_length_739_cov_8.523438	468	548	0	71	80	0.8875000
NODE_14622_length_739_cov_8.523438	468	548	2	9	80	0.1125000
NODE_14622_length_739_cov_8.523438	521	600	0	18	79	0.2278481
NODE_14622_length_739_cov_8.523438	521	600	2	61	79	0.7721519
NODE_14623_length_739_cov_7.398438	342	422	0	58	80	0.7250000
NODE_14623_length_739_cov_7.398438	342	422	2	22	80	0.2750000
NODE_14623_length_739_cov_7.398438	395	475	0	80	80	1.0000000
NODE_14625_length_739_cov_5.826562	252	332	0	80	80	1.0000000
NODE_14625_length_739_cov_5.826562	305	385	0	80	80	1.0000000
NODE_14634_length_739_cov_3.232813	355	435	0	80	80	1.0000000
NODE_14634_length_739_cov_3.232813	408	488	0	80	80	1.0000000
NODE_14679_length_738_cov_35.278560	274	318	66	1	44	0.0227273
NODE_14679_length_738_cov_35.278560	274	318	67	4	44	0.0909091
NODE_14679_length_738_cov_35.278560	274	318	68	15	44	0.3409091
NODE_14679_length_738_cov_35.278560	274	318	70	2	44	0.0454545
NODE_14679_length_738_cov_35.278560	274	318	71	5	44	0.1136364
NODE_14679_length_738_cov_35.278560	274	318	72	6	44	0.1363636
NODE_14679_length_738_cov_35.278560	274	318	74	2	44	0.0454545
NODE_14679_length_738_cov_35.278560	274	318	76	5	44	0.1136364
NODE_14679_length_738_cov_35.278560	274	318	78	3	44	0.0681818
NODE_14679_length_738_cov_35.278560	274	318	80	1	44	0.0227273
NODE_14680_length_738_cov_21.672926	208	288	1	54	80	0.6750000
NODE_14680_length_738_cov_21.672926	208	288	2	20	80	0.2500000
NODE_14680_length_738_cov_21.672926	208	288	4	6	80	0.0750000
NODE_14680_length_738_cov_21.672926	261	341	1	1	80	0.0125000
NODE_14680_length_738_cov_21.672926	261	341	2	20	80	0.2500000
NODE_14680_length_738_cov_21.672926	261	341	3	1	80	0.0125000
NODE_14680_length_738_cov_21.672926	261	341	4	58	80	0.7250000
NODE_14681_length_738_cov_15.665102	302	382	0	36	80	0.4500000
NODE_14681_length_738_cov_15.665102	302	382	4	7	80	0.0875000
NODE_14681_length_738_cov_15.665102	302	382	6	37	80	0.4625000
NODE_14681_length_738_cov_15.665102	355	435	4	26	80	0.3250000
NODE_14681_length_738_cov_15.665102	355	435	6	54	80	0.6750000
NODE_14682_length_738_cov_15.661972	338	418	0	80	80	1.0000000
NODE_14682_length_738_cov_15.661972	391	471	0	80	80	1.0000000
NODE_14683_length_738_cov_12.594679	49	129	4	2	80	0.0250000
NODE_14683_length_738_cov_12.594679	49	129	8	44	80	0.5500000
NODE_14683_length_738_cov_12.594679	49	129	10	34	80	0.4250000
NODE_14683_length_738_cov_12.594679	102	182	0	12	80	0.1500000
NODE_14683_length_738_cov_12.594679	102	182	2	22	80	0.2750000
NODE_14683_length_738_cov_12.594679	102	182	4	17	80	0.2125000
NODE_14683_length_738_cov_12.594679	102	182	6	4	80	0.0500000
NODE_14683_length_738_cov_12.594679	102	182	8	19	80	0.2375000
NODE_14683_length_738_cov_12.594679	102	182	10	6	80	0.0750000
NODE_14683_length_738_cov_12.594679	178	258	6	80	80	1.0000000
NODE_14683_length_738_cov_12.594679	231	311	6	80	80	1.0000000
NODE_14691_length_738_cov_4.056338	254	326	0	72	72	1.0000000
NODE_14691_length_738_cov_4.056338	437	528	0	20	91	0.2197802
NODE_14691_length_738_cov_4.056338	437	528	2	16	91	0.1758242
NODE_14691_length_738_cov_4.056338	437	528	4	44	91	0.4835165
NODE_14691_length_738_cov_4.056338	437	528	8	11	91	0.1208791
NODE_14724_length_737_cov_22.363636	303	383	0	80	80	1.0000000
NODE_14724_length_737_cov_22.363636	356	436	0	80	80	1.0000000
NODE_14725_length_737_cov_21.318182	208	288	2	17	80	0.2125000
NODE_14725_length_737_cov_21.318182	208	288	4	63	80	0.7875000
NODE_14725_length_737_cov_21.318182	261	341	2	63	80	0.7875000
NODE_14725_length_737_cov_21.318182	261	341	4	17	80	0.2125000
NODE_14726_length_737_cov_17.161442	346	426	0	10	80	0.1250000
NODE_14726_length_737_cov_17.161442	346	426	2	9	80	0.1125000
NODE_14726_length_737_cov_17.161442	346	426	3	3	80	0.0375000
NODE_14726_length_737_cov_17.161442	346	426	4	58	80	0.7250000
NODE_14726_length_737_cov_17.161442	399	479	2	1	80	0.0125000
NODE_14726_length_737_cov_17.161442	399	479	4	51	80	0.6375000
NODE_14726_length_737_cov_17.161442	399	479	6	28	80	0.3500000
NODE_14727_length_737_cov_11.835423	211	291	2	8	80	0.1000000
NODE_14727_length_737_cov_11.835423	211	291	4	49	80	0.6125000
NODE_14727_length_737_cov_11.835423	211	291	6	23	80	0.2875000
NODE_14727_length_737_cov_11.835423	264	344	0	4	80	0.0500000
NODE_14727_length_737_cov_11.835423	264	344	2	57	80	0.7125000
NODE_14727_length_737_cov_11.835423	264	344	4	19	80	0.2375000
NODE_14729_length_737_cov_6.782132	488	548	0	60	60	1.0000000
NODE_14732_length_737_cov_6.089342	241	321	7	17	80	0.2125000
NODE_14732_length_737_cov_6.089342	241	321	8	8	80	0.1000000
NODE_14732_length_737_cov_6.089342	241	321	9	19	80	0.2375000
NODE_14732_length_737_cov_6.089342	241	321	10	36	80	0.4500000
NODE_14732_length_737_cov_6.089342	294	374	0	28	80	0.3500000
NODE_14732_length_737_cov_6.089342	294	374	2	4	80	0.0500000
NODE_14732_length_737_cov_6.089342	294	374	4	4	80	0.0500000
NODE_14732_length_737_cov_6.089342	294	374	5	1	80	0.0125000
NODE_14732_length_737_cov_6.089342	294	374	7	26	80	0.3250000
NODE_14732_length_737_cov_6.089342	294	374	9	17	80	0.2125000
NODE_14747_length_737_cov_2.548589	386	416	0	30	30	1.0000000
NODE_14781_length_736_cov_46.601256	226	306	0	64	80	0.8000000
NODE_14781_length_736_cov_46.601256	226	306	2	16	80	0.2000000
NODE_14781_length_736_cov_46.601256	279	359	0	11	80	0.1375000
NODE_14781_length_736_cov_46.601256	279	359	2	69	80	0.8625000
NODE_14782_length_736_cov_32.442700	215	295	0	80	80	1.0000000
NODE_14782_length_736_cov_32.442700	268	350	0	82	82	1.0000000
NODE_14783_length_736_cov_26.364207	220	300	0	16	80	0.2000000
NODE_14783_length_736_cov_26.364207	220	300	2	50	80	0.6250000
NODE_14783_length_736_cov_26.364207	220	300	6	14	80	0.1750000
NODE_14783_length_736_cov_26.364207	273	353	2	13	80	0.1625000
NODE_14783_length_736_cov_26.364207	273	353	4	17	80	0.2125000
NODE_14783_length_736_cov_26.364207	273	353	6	50	80	0.6250000
NODE_14785_length_736_cov_10.317111	313	393	0	42	80	0.5250000
NODE_14785_length_736_cov_10.317111	313	393	2	38	80	0.4750000
NODE_14785_length_736_cov_10.317111	366	446	0	39	80	0.4875000
NODE_14785_length_736_cov_10.317111	366	446	2	37	80	0.4625000
NODE_14785_length_736_cov_10.317111	366	446	3	4	80	0.0500000
NODE_14786_length_736_cov_9.188383	292	372	0	80	80	1.0000000
NODE_14786_length_736_cov_9.188383	345	425	0	80	80	1.0000000
NODE_14787_length_736_cov_8.149137	315	391	0	49	76	0.6447368
NODE_14787_length_736_cov_8.149137	315	391	2	27	76	0.3552631
NODE_14787_length_736_cov_8.149137	365	445	2	80	80	1.0000000
NODE_14788_length_736_cov_8.103611	295	375	0	80	80	1.0000000
NODE_14788_length_736_cov_8.103611	348	428	0	80	80	1.0000000
NODE_14789_length_736_cov_7.513344	239	319	0	34	80	0.4250000
NODE_14789_length_736_cov_7.513344	239	319	2	13	80	0.1625000
NODE_14789_length_736_cov_7.513344	239	319	4	33	80	0.4125000
NODE_14789_length_736_cov_7.513344	292	372	0	80	80	1.0000000
NODE_14792_length_736_cov_5.967033	253	333	0	49	80	0.6125000
NODE_14792_length_736_cov_5.967033	253	333	1	11	80	0.1375000
NODE_14792_length_736_cov_5.967033	253	333	2	20	80	0.2500000
NODE_14792_length_736_cov_5.967033	306	386	1	7	80	0.0875000
NODE_14792_length_736_cov_5.967033	306	386	2	73	80	0.9125000
NODE_14795_length_736_cov_4.908948	258	338	0	40	80	0.5000000
NODE_14795_length_736_cov_4.908948	258	338	2	28	80	0.3500000
NODE_14795_length_736_cov_4.908948	258	338	6	12	80	0.1500000
NODE_14795_length_736_cov_4.908948	311	391	2	80	80	1.0000000
NODE_14825_length_735_cov_21.099057	265	345	0	80	80	1.0000000
NODE_14825_length_735_cov_21.099057	318	398	0	80	80	1.0000000
NODE_14826_length_735_cov_16.696541	190	270	0	32	80	0.4000000
NODE_14826_length_735_cov_16.696541	190	270	2	17	80	0.2125000
NODE_14826_length_735_cov_16.696541	190	270	4	31	80	0.3875000
NODE_14826_length_735_cov_16.696541	243	323	4	35	80	0.4375000
NODE_14826_length_735_cov_16.696541	243	323	6	13	80	0.1625000
NODE_14826_length_735_cov_16.696541	243	323	7	8	80	0.1000000
NODE_14826_length_735_cov_16.696541	243	323	8	20	80	0.2500000
NODE_14826_length_735_cov_16.696541	243	323	11	4	80	0.0500000
NODE_14826_length_735_cov_16.696541	479	538	0	29	59	0.4915254
NODE_14826_length_735_cov_16.696541	479	538	2	30	59	0.5084746
NODE_14827_length_735_cov_13.143082	231	311	0	80	80	1.0000000
NODE_14827_length_735_cov_13.143082	284	364	0	80	80	1.0000000
NODE_14828_length_735_cov_12.415094	434	514	2	6	80	0.0750000
NODE_14828_length_735_cov_12.415094	434	514	4	24	80	0.3000000
NODE_14828_length_735_cov_12.415094	434	514	6	50	80	0.6250000
NODE_14828_length_735_cov_12.415094	487	567	5	3	80	0.0375000
NODE_14828_length_735_cov_12.415094	487	567	6	46	80	0.5750000
NODE_14828_length_735_cov_12.415094	487	567	7	31	80	0.3875000
NODE_14836_length_735_cov_5.603774	326	394	0	68	68	1.0000000
NODE_14836_length_735_cov_5.603774	367	409	0	42	42	1.0000000
NODE_14880_length_734_cov_26.787402	209	289	2	80	80	1.0000000
NODE_14880_length_734_cov_26.787402	262	342	0	48	80	0.6000000
NODE_14880_length_734_cov_26.787402	262	342	2	32	80	0.4000000
NODE_14881_length_734_cov_23.214173	200	280	0	3	80	0.0375000
NODE_14881_length_734_cov_23.214173	200	280	2	7	80	0.0875000
NODE_14881_length_734_cov_23.214173	200	280	4	70	80	0.8750000
NODE_14881_length_734_cov_23.214173	253	333	2	27	80	0.3375000
NODE_14881_length_734_cov_23.214173	253	333	4	53	80	0.6625000
NODE_14883_length_734_cov_21.645669	245	325	0	80	80	1.0000000
NODE_14883_length_734_cov_21.645669	298	378	0	80	80	1.0000000
NODE_14884_length_734_cov_14.393701	249	329	0	6	80	0.0750000
NODE_14884_length_734_cov_14.393701	249	329	2	51	80	0.6375000
NODE_14884_length_734_cov_14.393701	249	329	7	23	80	0.2875000
NODE_14884_length_734_cov_14.393701	302	382	2	4	80	0.0500000
NODE_14884_length_734_cov_14.393701	302	382	5	2	80	0.0250000
NODE_14884_length_734_cov_14.393701	302	382	7	50	80	0.6250000
NODE_14884_length_734_cov_14.393701	302	382	11	19	80	0.2375000
NODE_14884_length_734_cov_14.393701	302	382	12	5	80	0.0625000
NODE_14885_length_734_cov_11.324409	133	196	3	18	63	0.2857143
NODE_14885_length_734_cov_11.324409	133	196	4	45	63	0.7142857
NODE_14885_length_734_cov_11.324409	169	229	2	18	60	0.3000000
NODE_14885_length_734_cov_11.324409	169	229	4	42	60	0.7000000
NODE_14886_length_734_cov_10.872441	302	331	0	12	29	0.4137931
NODE_14886_length_734_cov_10.872441	302	331	4	17	29	0.5862069
NODE_14890_length_734_cov_6.352756	371	451	0	80	80	1.0000000
NODE_14890_length_734_cov_6.352756	424	504	0	80	80	1.0000000
NODE_14896_length_734_cov_2.705512	231	302	0	71	71	1.0000000
NODE_14934_length_733_cov_35.041009	268	348	0	80	80	1.0000000
NODE_14934_length_733_cov_35.041009	321	402	0	81	81	1.0000000
NODE_14935_length_733_cov_29.810726	28	108	0	4	80	0.0500000
NODE_14935_length_733_cov_29.810726	28	108	2	34	80	0.4250000
NODE_14935_length_733_cov_29.810726	28	108	3	3	80	0.0375000
NODE_14935_length_733_cov_29.810726	28	108	4	39	80	0.4875000
NODE_14935_length_733_cov_29.810726	81	161	2	48	80	0.6000000
NODE_14935_length_733_cov_29.810726	81	161	4	32	80	0.4000000
NODE_14935_length_733_cov_29.810726	157	237	2	24	80	0.3000000
NODE_14935_length_733_cov_29.810726	157	237	3	3	80	0.0375000
NODE_14935_length_733_cov_29.810726	157	237	4	53	80	0.6625000
NODE_14935_length_733_cov_29.810726	210	290	0	34	80	0.4250000
NODE_14935_length_733_cov_29.810726	210	290	2	36	80	0.4500000
NODE_14935_length_733_cov_29.810726	210	290	3	3	80	0.0375000
NODE_14935_length_733_cov_29.810726	210	290	4	7	80	0.0875000
NODE_14936_length_733_cov_13.738170	333	413	0	7	80	0.0875000
NODE_14936_length_733_cov_13.738170	333	413	4	73	80	0.9125000
NODE_14936_length_733_cov_13.738170	386	466	0	60	80	0.7500000
NODE_14936_length_733_cov_13.738170	386	466	4	20	80	0.2500000
NODE_14937_length_733_cov_11.471609	314	389	0	75	75	1.0000000
NODE_14938_length_733_cov_11.321767	245	325	0	48	80	0.6000000
NODE_14938_length_733_cov_11.321767	245	325	2	32	80	0.4000000
NODE_14938_length_733_cov_11.321767	298	378	0	80	80	1.0000000
NODE_14940_length_733_cov_8.481073	318	395	0	62	77	0.8051948
NODE_14940_length_733_cov_8.481073	318	395	2	15	77	0.1948052
NODE_14940_length_733_cov_8.481073	371	451	0	34	80	0.4250000
NODE_14940_length_733_cov_8.481073	371	451	2	46	80	0.5750000
NODE_14944_length_733_cov_5.485804	659	715	58	1	56	0.0178571
NODE_14944_length_733_cov_5.485804	659	715	60	15	56	0.2678571
NODE_14944_length_733_cov_5.485804	659	715	62	4	56	0.0714286
NODE_14944_length_733_cov_5.485804	659	715	64	2	56	0.0357143
NODE_14944_length_733_cov_5.485804	659	715	65	3	56	0.0535714
NODE_14944_length_733_cov_5.485804	659	715	66	5	56	0.0892857
NODE_14944_length_733_cov_5.485804	659	715	68	11	56	0.1964286
NODE_14944_length_733_cov_5.485804	659	715	69	5	56	0.0892857
NODE_14944_length_733_cov_5.485804	659	715	70	5	56	0.0892857
NODE_14944_length_733_cov_5.485804	659	715	76	1	56	0.0178571
NODE_14944_length_733_cov_5.485804	659	715	78	4	56	0.0714286
NODE_14944_length_733_cov_5.485804	696	733	30	2	37	0.0540541
NODE_14944_length_733_cov_5.485804	696	733	32	1	37	0.0270270
NODE_14944_length_733_cov_5.485804	696	733	34	1	37	0.0270270
NODE_14944_length_733_cov_5.485804	696	733	38	1	37	0.0270270
NODE_14944_length_733_cov_5.485804	696	733	42	3	37	0.0810811
NODE_14944_length_733_cov_5.485804	696	733	46	1	37	0.0270270
NODE_14944_length_733_cov_5.485804	696	733	48	5	37	0.1351351
NODE_14944_length_733_cov_5.485804	696	733	51	1	37	0.0270270
NODE_14944_length_733_cov_5.485804	696	733	52	1	37	0.0270270
NODE_14944_length_733_cov_5.485804	696	733	55	2	37	0.0540541
NODE_14944_length_733_cov_5.485804	696	733	58	1	37	0.0270270
NODE_14944_length_733_cov_5.485804	696	733	60	15	37	0.4054054
NODE_14944_length_733_cov_5.485804	696	733	62	3	37	0.0810811
NODE_14957_length_733_cov_2.272871	312	392	0	80	80	1.0000000
NODE_14957_length_733_cov_2.272871	365	445	0	80	80	1.0000000
NODE_14975_length_732_cov_19.519747	229	309	0	6	80	0.0750000
NODE_14975_length_732_cov_19.519747	229	309	8	74	80	0.9250000
NODE_14975_length_732_cov_19.519747	282	362	8	80	80	1.0000000
NODE_14976_length_732_cov_10.846761	247	327	0	40	80	0.5000000
NODE_14976_length_732_cov_10.846761	247	327	2	40	80	0.5000000
NODE_14976_length_732_cov_10.846761	300	380	0	4	80	0.0500000
NODE_14976_length_732_cov_10.846761	300	380	2	76	80	0.9500000
NODE_14977_length_732_cov_9.807267	276	356	0	80	80	1.0000000
NODE_14977_length_732_cov_9.807267	329	409	0	80	80	1.0000000
NODE_14978_length_732_cov_8.053712	415	495	0	80	80	1.0000000
NODE_14978_length_732_cov_8.053712	468	548	0	80	80	1.0000000
NODE_14980_length_732_cov_5.194313	319	399	0	80	80	1.0000000
NODE_14980_length_732_cov_5.194313	372	452	0	80	80	1.0000000
NODE_14981_length_732_cov_4.998420	293	373	0	80	80	1.0000000
NODE_14981_length_732_cov_4.998420	346	426	0	80	80	1.0000000
NODE_14983_length_732_cov_4.758294	483	524	0	41	41	1.0000000
NODE_15021_length_731_cov_36.123418	464	544	0	80	80	1.0000000
NODE_15021_length_731_cov_36.123418	517	597	0	80	80	1.0000000
NODE_15022_length_731_cov_27.721519	294	374	2	14	80	0.1750000
NODE_15022_length_731_cov_27.721519	294	374	4	66	80	0.8250000
NODE_15022_length_731_cov_27.721519	347	427	2	67	80	0.8375000
NODE_15022_length_731_cov_27.721519	347	427	4	13	80	0.1625000
NODE_15023_length_731_cov_19.655063	394	474	0	80	80	1.0000000
NODE_15023_length_731_cov_19.655063	447	527	0	80	80	1.0000000
NODE_15024_length_731_cov_16.346519	429	509	0	53	80	0.6625000
NODE_15024_length_731_cov_16.346519	429	509	4	5	80	0.0625000
NODE_15024_length_731_cov_16.346519	429	509	6	22	80	0.2750000
NODE_15024_length_731_cov_16.346519	482	562	4	5	80	0.0625000
NODE_15024_length_731_cov_16.346519	482	562	6	75	80	0.9375000
NODE_15025_length_731_cov_13.892405	321	401	0	80	80	1.0000000
NODE_15025_length_731_cov_13.892405	374	454	0	80	80	1.0000000
NODE_15027_length_731_cov_8.800633	218	298	1	80	80	1.0000000
NODE_15027_length_731_cov_8.800633	271	352	0	16	81	0.1975309
NODE_15027_length_731_cov_8.800633	271	352	1	65	81	0.8024691
NODE_15028_length_731_cov_7.658228	335	406	0	35	71	0.4929577
NODE_15028_length_731_cov_7.658228	335	406	2	4	71	0.0563380
NODE_15028_length_731_cov_7.658228	335	406	6	32	71	0.4507042
NODE_15028_length_731_cov_7.658228	387	468	4	6	81	0.0740741
NODE_15028_length_731_cov_7.658228	387	468	6	32	81	0.3950617
NODE_15028_length_731_cov_7.658228	387	468	8	13	81	0.1604938
NODE_15028_length_731_cov_7.658228	387	468	10	30	81	0.3703704
NODE_15031_length_731_cov_5.471519	261	341	0	48	80	0.6000000
NODE_15031_length_731_cov_5.471519	261	341	2	32	80	0.4000000
NODE_15031_length_731_cov_5.471519	314	394	2	80	80	1.0000000
NODE_15034_length_731_cov_4.083861	361	441	2	20	80	0.2500000
NODE_15034_length_731_cov_4.083861	361	441	3	1	80	0.0125000
NODE_15034_length_731_cov_4.083861	361	441	4	52	80	0.6500000
NODE_15034_length_731_cov_4.083861	361	441	6	7	80	0.0875000
NODE_15034_length_731_cov_4.083861	458	482	0	16	24	0.6666667
NODE_15034_length_731_cov_4.083861	458	482	2	8	24	0.3333333
NODE_15050_length_731_cov_2.226266	466	548	2	82	82	1.0000000
NODE_15077_length_730_cov_51.556260	349	429	4	80	80	1.0000000
NODE_15077_length_730_cov_51.556260	402	482	0	42	80	0.5250000
NODE_15077_length_730_cov_51.556260	402	482	4	38	80	0.4750000
NODE_15078_length_730_cov_39.862124	370	450	0	56	80	0.7000000
NODE_15078_length_730_cov_39.862124	370	450	2	24	80	0.3000000
NODE_15078_length_730_cov_39.862124	423	503	0	3	80	0.0375000
NODE_15078_length_730_cov_39.862124	423	503	2	77	80	0.9625000
NODE_15079_length_730_cov_15.801902	261	341	4	2	80	0.0250000
NODE_15079_length_730_cov_15.801902	261	341	6	6	80	0.0750000
NODE_15079_length_730_cov_15.801902	261	341	9	1	80	0.0125000
NODE_15079_length_730_cov_15.801902	261	341	12	29	80	0.3625000
NODE_15079_length_730_cov_15.801902	261	341	14	9	80	0.1125000
NODE_15079_length_730_cov_15.801902	261	341	15	17	80	0.2125000
NODE_15079_length_730_cov_15.801902	261	341	16	16	80	0.2000000
NODE_15079_length_730_cov_15.801902	314	394	6	11	80	0.1375000
NODE_15079_length_730_cov_15.801902	314	394	8	31	80	0.3875000
NODE_15079_length_730_cov_15.801902	314	394	12	2	80	0.0250000
NODE_15079_length_730_cov_15.801902	314	394	14	1	80	0.0125000
NODE_15079_length_730_cov_15.801902	314	394	15	11	80	0.1375000
NODE_15079_length_730_cov_15.801902	314	394	16	24	80	0.3000000
NODE_15080_length_730_cov_11.746434	242	322	2	29	80	0.3625000
NODE_15080_length_730_cov_11.746434	242	322	6	20	80	0.2500000
NODE_15080_length_730_cov_11.746434	242	322	8	20	80	0.2500000
NODE_15080_length_730_cov_11.746434	242	322	10	11	80	0.1375000
NODE_15080_length_730_cov_11.746434	295	375	8	19	80	0.2375000
NODE_15080_length_730_cov_11.746434	295	375	9	21	80	0.2625000
NODE_15080_length_730_cov_11.746434	295	375	10	40	80	0.5000000
NODE_15081_length_730_cov_9.209192	358	438	0	44	80	0.5500000
NODE_15081_length_730_cov_9.209192	358	438	4	36	80	0.4500000
NODE_15081_length_730_cov_9.209192	411	483	4	67	72	0.9305556
NODE_15081_length_730_cov_9.209192	411	483	6	5	72	0.0694444
NODE_15131_length_729_cov_44.188889	418	498	0	3	80	0.0375000
NODE_15131_length_729_cov_44.188889	418	498	2	58	80	0.7250000
NODE_15131_length_729_cov_44.188889	418	498	4	19	80	0.2375000
NODE_15131_length_729_cov_44.188889	471	551	2	26	80	0.3250000
NODE_15131_length_729_cov_44.188889	471	551	4	54	80	0.6750000
NODE_15132_length_729_cov_40.390476	330	410	0	80	80	1.0000000
NODE_15132_length_729_cov_40.390476	383	463	0	80	80	1.0000000
NODE_15133_length_729_cov_35.973016	231	311	0	28	80	0.3500000
NODE_15133_length_729_cov_35.973016	231	311	2	52	80	0.6500000
NODE_15133_length_729_cov_35.973016	284	363	0	64	79	0.8101266
NODE_15133_length_729_cov_35.973016	284	363	2	15	79	0.1898734
NODE_15134_length_729_cov_18.357143	170	250	0	39	80	0.4875000
NODE_15134_length_729_cov_18.357143	170	250	2	15	80	0.1875000
NODE_15134_length_729_cov_18.357143	170	250	4	24	80	0.3000000
NODE_15134_length_729_cov_18.357143	170	250	6	2	80	0.0250000
NODE_15134_length_729_cov_18.357143	223	303	2	5	80	0.0625000
NODE_15134_length_729_cov_18.357143	223	303	4	44	80	0.5500000
NODE_15134_length_729_cov_18.357143	223	303	6	31	80	0.3875000
NODE_15135_length_729_cov_17.928571	194	274	0	80	80	1.0000000
NODE_15135_length_729_cov_17.928571	247	327	0	80	80	1.0000000
NODE_15136_length_729_cov_17.373016	369	449	0	80	80	1.0000000
NODE_15136_length_729_cov_17.373016	422	502	0	80	80	1.0000000
NODE_15137_length_729_cov_12.452381	347	427	0	80	80	1.0000000
NODE_15137_length_729_cov_12.452381	400	480	0	58	80	0.7250000
NODE_15137_length_729_cov_12.452381	400	480	2	22	80	0.2750000
NODE_15138_length_729_cov_10.388889	296	376	0	80	80	1.0000000
NODE_15138_length_729_cov_10.388889	349	429	0	80	80	1.0000000
NODE_15185_length_728_cov_23.503975	338	418	2	74	80	0.9250000
NODE_15185_length_728_cov_23.503975	338	418	4	6	80	0.0750000
NODE_15185_length_728_cov_23.503975	391	471	0	52	80	0.6500000
NODE_15185_length_728_cov_23.503975	391	471	2	28	80	0.3500000
NODE_15186_length_728_cov_22.496025	310	390	0	80	80	1.0000000
NODE_15186_length_728_cov_22.496025	363	443	0	80	80	1.0000000
NODE_15187_length_728_cov_16.596184	257	337	2	80	80	1.0000000
NODE_15187_length_728_cov_16.596184	310	387	1	11	77	0.1428571
NODE_15187_length_728_cov_16.596184	310	387	2	66	77	0.8571429
NODE_15188_length_728_cov_16.114467	192	272	0	8	80	0.1000000
NODE_15188_length_728_cov_16.114467	192	272	4	72	80	0.9000000
NODE_15188_length_728_cov_16.114467	245	325	0	2	80	0.0250000
NODE_15188_length_728_cov_16.114467	245	325	4	78	80	0.9750000
NODE_15189_length_728_cov_15.128776	298	377	0	34	79	0.4303797
NODE_15189_length_728_cov_15.128776	298	377	2	45	79	0.5696203
NODE_15189_length_728_cov_15.128776	350	430	0	80	80	1.0000000
NODE_15190_length_728_cov_10.613672	269	349	0	80	80	1.0000000
NODE_15190_length_728_cov_10.613672	322	402	0	80	80	1.0000000
NODE_15191_length_728_cov_7.613672	408	488	4	20	80	0.2500000
NODE_15191_length_728_cov_7.613672	408	488	6	60	80	0.7500000
NODE_15191_length_728_cov_7.613672	461	541	0	23	80	0.2875000
NODE_15191_length_728_cov_7.613672	461	541	2	26	80	0.3250000
NODE_15191_length_728_cov_7.613672	461	541	4	24	80	0.3000000
NODE_15191_length_728_cov_7.613672	461	541	6	7	80	0.0875000
NODE_15196_length_728_cov_3.405405	335	415	0	80	80	1.0000000
NODE_15244_length_727_cov_34.883758	57	137	0	11	80	0.1375000
NODE_15244_length_727_cov_34.883758	57	137	4	40	80	0.5000000
NODE_15244_length_727_cov_34.883758	57	137	6	29	80	0.3625000
NODE_15244_length_727_cov_34.883758	57	137	0	11	80	0.1375000
NODE_15244_length_727_cov_34.883758	57	137	4	40	80	0.5000000
NODE_15244_length_727_cov_34.883758	57	137	6	29	80	0.3625000
NODE_15244_length_727_cov_34.883758	57	137	0	11	80	0.1375000
NODE_15244_length_727_cov_34.883758	57	137	4	40	80	0.5000000
NODE_15244_length_727_cov_34.883758	57	137	6	29	80	0.3625000
NODE_15244_length_727_cov_34.883758	110	190	6	80	80	1.0000000
NODE_15244_length_727_cov_34.883758	110	190	6	80	80	1.0000000
NODE_15245_length_727_cov_32.025478	275	355	0	23	80	0.2875000
NODE_15245_length_727_cov_32.025478	275	355	6	12	80	0.1500000
NODE_15245_length_727_cov_32.025478	275	355	8	45	80	0.5625000
NODE_15245_length_727_cov_32.025478	328	408	0	3	80	0.0375000
NODE_15245_length_727_cov_32.025478	328	408	6	26	80	0.3250000
NODE_15245_length_727_cov_32.025478	328	408	8	51	80	0.6375000
NODE_15246_length_727_cov_28.523885	307	381	0	74	74	1.0000000
NODE_15246_length_727_cov_28.523885	360	381	0	21	21	1.0000000
NODE_15246_length_727_cov_28.523885	378	415	0	37	37	1.0000000
NODE_15247_length_727_cov_25.826433	325	405	0	80	80	1.0000000
NODE_15247_length_727_cov_25.826433	378	458	0	52	80	0.6500000
NODE_15247_length_727_cov_25.826433	378	458	2	28	80	0.3500000
NODE_15248_length_727_cov_22.253185	150	230	0	14	80	0.1750000
NODE_15248_length_727_cov_22.253185	150	230	2	66	80	0.8250000
NODE_15248_length_727_cov_22.253185	203	283	0	39	80	0.4875000
NODE_15248_length_727_cov_22.253185	203	283	2	41	80	0.5125000
NODE_15249_length_727_cov_18.972930	263	343	2	32	80	0.4000000
NODE_15249_length_727_cov_18.972930	263	343	4	11	80	0.1375000
NODE_15249_length_727_cov_18.972930	263	343	6	33	80	0.4125000
NODE_15249_length_727_cov_18.972930	263	343	8	4	80	0.0500000
NODE_15249_length_727_cov_18.972930	316	396	0	15	80	0.1875000
NODE_15249_length_727_cov_18.972930	316	396	2	65	80	0.8125000
NODE_15250_length_727_cov_15.531847	269	349	0	51	80	0.6375000
NODE_15250_length_727_cov_15.531847	269	349	2	29	80	0.3625000
NODE_15250_length_727_cov_15.531847	322	402	2	80	80	1.0000000
NODE_15252_length_727_cov_10.178344	280	360	0	80	80	1.0000000
NODE_15252_length_727_cov_10.178344	333	413	0	80	80	1.0000000
NODE_15258_length_727_cov_4.955414	360	440	0	80	80	1.0000000
NODE_15258_length_727_cov_4.955414	413	493	0	80	80	1.0000000
NODE_15287_length_726_cov_52.923445	415	495	2	77	80	0.9625000
NODE_15287_length_726_cov_52.923445	415	495	4	3	80	0.0375000
NODE_15287_length_726_cov_52.923445	468	548	2	77	80	0.9625000
NODE_15287_length_726_cov_52.923445	468	548	4	3	80	0.0375000
NODE_15288_length_726_cov_35.896332	108	188	0	20	80	0.2500000
NODE_15288_length_726_cov_35.896332	108	188	2	60	80	0.7500000
NODE_15288_length_726_cov_35.896332	161	241	0	24	80	0.3000000
NODE_15288_length_726_cov_35.896332	161	241	2	56	80	0.7000000
NODE_15288_length_726_cov_35.896332	237	317	0	4	80	0.0500000
NODE_15288_length_726_cov_35.896332	237	317	2	76	80	0.9500000
NODE_15288_length_726_cov_35.896332	290	370	0	57	80	0.7125000
NODE_15288_length_726_cov_35.896332	290	370	2	23	80	0.2875000
NODE_15291_length_726_cov_8.534290	355	435	2	6	80	0.0750000
NODE_15291_length_726_cov_8.534290	355	435	4	74	80	0.9250000
NODE_15291_length_726_cov_8.534290	408	488	0	27	80	0.3375000
NODE_15291_length_726_cov_8.534290	408	488	2	28	80	0.3500000
NODE_15291_length_726_cov_8.534290	408	488	4	25	80	0.3125000
NODE_15330_length_725_cov_40.856230	203	283	0	80	80	1.0000000
NODE_15330_length_725_cov_40.856230	256	336	0	64	80	0.8000000
NODE_15330_length_725_cov_40.856230	256	336	2	16	80	0.2000000
NODE_15330_length_725_cov_40.856230	332	412	2	38	80	0.4750000
NODE_15330_length_725_cov_40.856230	332	412	3	18	80	0.2250000
NODE_15330_length_725_cov_40.856230	332	412	9	13	80	0.1625000
NODE_15330_length_725_cov_40.856230	332	412	10	11	80	0.1375000
NODE_15330_length_725_cov_40.856230	385	465	3	3	80	0.0375000
NODE_15330_length_725_cov_40.856230	385	465	8	10	80	0.1250000
NODE_15330_length_725_cov_40.856230	385	465	9	13	80	0.1625000
NODE_15330_length_725_cov_40.856230	385	465	10	17	80	0.2125000
NODE_15330_length_725_cov_40.856230	385	465	12	37	80	0.4625000
NODE_15331_length_725_cov_25.036741	366	446	0	29	80	0.3625000
NODE_15331_length_725_cov_25.036741	366	446	4	51	80	0.6375000
NODE_15331_length_725_cov_25.036741	419	499	4	80	80	1.0000000
NODE_15332_length_725_cov_23.009585	455	536	0	1	81	0.0123457
NODE_15332_length_725_cov_23.009585	455	536	2	28	81	0.3456790
NODE_15332_length_725_cov_23.009585	455	536	4	52	81	0.6419753
NODE_15333_length_725_cov_20.474441	112	192	0	26	80	0.3250000
NODE_15333_length_725_cov_20.474441	112	192	2	36	80	0.4500000
NODE_15333_length_725_cov_20.474441	112	192	3	18	80	0.2250000
NODE_15333_length_725_cov_20.474441	165	245	1	12	80	0.1500000
NODE_15333_length_725_cov_20.474441	165	245	2	26	80	0.3250000
NODE_15333_length_725_cov_20.474441	165	245	3	42	80	0.5250000
NODE_15334_length_725_cov_15.455272	106	186	0	80	80	1.0000000
NODE_15334_length_725_cov_15.455272	159	239	0	80	80	1.0000000
NODE_15334_length_725_cov_15.455272	235	315	0	11	80	0.1375000
NODE_15334_length_725_cov_15.455272	235	315	2	69	80	0.8625000
NODE_15334_length_725_cov_15.455272	288	368	0	39	80	0.4875000
NODE_15334_length_725_cov_15.455272	288	368	2	41	80	0.5125000
NODE_15335_length_725_cov_10.426518	289	369	0	55	80	0.6875000
NODE_15335_length_725_cov_10.426518	289	369	2	25	80	0.3125000
NODE_15335_length_725_cov_10.426518	342	422	0	8	80	0.1000000
NODE_15335_length_725_cov_10.426518	342	422	2	72	80	0.9000000
NODE_15337_length_725_cov_7.781150	189	269	0	80	80	1.0000000
NODE_15337_length_725_cov_7.781150	242	322	0	80	80	1.0000000
NODE_15388_length_724_cov_28.132800	354	434	2	80	80	1.0000000
NODE_15388_length_724_cov_28.132800	407	473	0	35	66	0.5303030
NODE_15388_length_724_cov_28.132800	407	473	2	31	66	0.4696970
NODE_15389_length_724_cov_24.710400	376	461	6	85	85	1.0000000
NODE_15389_length_724_cov_24.710400	434	514	0	40	80	0.5000000
NODE_15389_length_724_cov_24.710400	434	514	6	40	80	0.5000000
NODE_15390_length_724_cov_13.960000	152	232	2	80	80	1.0000000
NODE_15390_length_724_cov_13.960000	205	248	2	43	43	1.0000000
NODE_15390_length_724_cov_13.960000	237	286	0	37	49	0.7551020
NODE_15390_length_724_cov_13.960000	237	286	2	12	49	0.2448980
NODE_15390_length_724_cov_13.960000	259	302	0	43	43	1.0000000
NODE_15390_length_724_cov_13.960000	288	340	0	52	52	1.0000000
NODE_15390_length_724_cov_13.960000	313	393	0	80	80	1.0000000
NODE_15391_length_724_cov_13.065600	215	295	0	80	80	1.0000000
NODE_15391_length_724_cov_13.065600	268	347	0	79	79	1.0000000
NODE_15393_length_724_cov_10.358400	257	337	0	80	80	1.0000000
NODE_15393_length_724_cov_10.358400	310	385	0	75	75	1.0000000
NODE_15396_length_724_cov_6.451200	151	231	0	45	80	0.5625000
NODE_15396_length_724_cov_6.451200	151	231	2	35	80	0.4375000
NODE_15396_length_724_cov_6.451200	202	282	0	80	80	1.0000000
NODE_15397_length_724_cov_5.921600	165	213	2	4	48	0.0833333
NODE_15397_length_724_cov_5.921600	165	213	4	44	48	0.9166667
NODE_15399_length_724_cov_5.028800	416	469	0	53	53	1.0000000
NODE_15399_length_724_cov_5.028800	488	526	0	38	38	1.0000000
NODE_15403_length_724_cov_3.315200	166	246	2	80	80	1.0000000
NODE_15403_length_724_cov_3.315200	219	299	0	24	80	0.3000000
NODE_15403_length_724_cov_3.315200	219	299	2	56	80	0.7000000
NODE_15442_length_723_cov_81.453526	205	285	0	20	80	0.2500000
NODE_15442_length_723_cov_81.453526	205	285	2	60	80	0.7500000
NODE_15442_length_723_cov_81.453526	258	338	0	68	80	0.8500000
NODE_15442_length_723_cov_81.453526	258	338	2	12	80	0.1500000
NODE_15443_length_723_cov_33.075321	254	329	2	75	75	1.0000000
NODE_15443_length_723_cov_33.075321	307	387	1	56	80	0.7000000
NODE_15443_length_723_cov_33.075321	307	387	2	24	80	0.3000000
NODE_15444_length_723_cov_25.410256	291	371	1	8	80	0.1000000
NODE_15444_length_723_cov_25.410256	291	371	2	2	80	0.0250000
NODE_15444_length_723_cov_25.410256	291	371	3	17	80	0.2125000
NODE_15444_length_723_cov_25.410256	291	371	4	53	80	0.6625000
NODE_15444_length_723_cov_25.410256	344	424	1	61	80	0.7625000
NODE_15444_length_723_cov_25.410256	344	424	2	2	80	0.0250000
NODE_15444_length_723_cov_25.410256	344	424	4	17	80	0.2125000
NODE_15445_length_723_cov_18.097756	233	313	11	29	80	0.3625000
NODE_15445_length_723_cov_18.097756	233	313	12	43	80	0.5375000
NODE_15445_length_723_cov_18.097756	233	313	13	8	80	0.1000000
NODE_15445_length_723_cov_18.097756	286	351	2	4	65	0.0615385
NODE_15445_length_723_cov_18.097756	286	351	8	6	65	0.0923077
NODE_15445_length_723_cov_18.097756	286	351	10	3	65	0.0461538
NODE_15445_length_723_cov_18.097756	286	351	12	52	65	0.8000000
NODE_15446_length_723_cov_14.113782	311	391	0	80	80	1.0000000
NODE_15446_length_723_cov_14.113782	364	444	0	80	80	1.0000000
NODE_15447_length_723_cov_11.634615	299	379	2	18	80	0.2250000
NODE_15447_length_723_cov_11.634615	299	379	4	9	80	0.1125000
NODE_15447_length_723_cov_11.634615	299	379	6	53	80	0.6625000
NODE_15447_length_723_cov_11.634615	352	432	2	28	80	0.3500000
NODE_15447_length_723_cov_11.634615	352	432	6	52	80	0.6500000
NODE_15448_length_723_cov_8.342949	357	437	0	59	80	0.7375000
NODE_15448_length_723_cov_8.342949	357	437	2	21	80	0.2625000
NODE_15448_length_723_cov_8.342949	410	490	0	80	80	1.0000000
NODE_15455_length_723_cov_2.711538	379	422	0	43	43	1.0000000
NODE_15459_length_723_cov_2.573718	383	413	0	30	30	1.0000000
NODE_15495_length_722_cov_19.182986	180	260	0	13	80	0.1625000
NODE_15495_length_722_cov_19.182986	180	260	2	27	80	0.3375000
NODE_15495_length_722_cov_19.182986	180	260	4	40	80	0.5000000
NODE_15495_length_722_cov_19.182986	233	313	2	52	80	0.6500000
NODE_15495_length_722_cov_19.182986	233	313	4	28	80	0.3500000
NODE_15496_length_722_cov_13.582665	192	272	0	50	80	0.6250000
NODE_15496_length_722_cov_13.582665	192	272	2	30	80	0.3750000
NODE_15496_length_722_cov_13.582665	245	326	0	4	81	0.0493827
NODE_15496_length_722_cov_13.582665	245	326	2	77	81	0.9506173
NODE_15497_length_722_cov_9.202247	347	427	0	80	80	1.0000000
NODE_15497_length_722_cov_9.202247	400	480	0	80	80	1.0000000
NODE_15500_length_722_cov_6.707865	343	423	2	41	80	0.5125000
NODE_15500_length_722_cov_6.707865	343	423	4	39	80	0.4875000
NODE_15500_length_722_cov_6.707865	396	476	0	31	80	0.3875000
NODE_15500_length_722_cov_6.707865	396	476	2	21	80	0.2625000
NODE_15500_length_722_cov_6.707865	396	476	4	28	80	0.3500000
NODE_15504_length_722_cov_4.985554	332	393	0	61	61	1.0000000
NODE_15508_length_722_cov_3.977528	217	297	0	80	80	1.0000000
NODE_15508_length_722_cov_3.977528	270	350	0	80	80	1.0000000
NODE_15553_length_721_cov_105.927653	425	505	0	80	80	1.0000000
NODE_15553_length_721_cov_105.927653	478	558	0	42	80	0.5250000
NODE_15553_length_721_cov_105.927653	478	558	1	11	80	0.1375000
NODE_15553_length_721_cov_105.927653	478	558	2	23	80	0.2875000
NODE_15553_length_721_cov_105.927653	478	558	4	4	80	0.0500000
NODE_15554_length_721_cov_49.660772	304	384	0	63	80	0.7875000
NODE_15554_length_721_cov_49.660772	304	384	2	17	80	0.2125000
NODE_15554_length_721_cov_49.660772	357	437	0	10	80	0.1250000
NODE_15554_length_721_cov_49.660772	357	437	2	70	80	0.8750000
NODE_15555_length_721_cov_46.991961	341	421	2	6	80	0.0750000
NODE_15555_length_721_cov_46.991961	341	421	10	55	80	0.6875000
NODE_15555_length_721_cov_46.991961	341	421	11	18	80	0.2250000
NODE_15555_length_721_cov_46.991961	341	421	12	1	80	0.0125000
NODE_15555_length_721_cov_46.991961	394	474	8	43	80	0.5375000
NODE_15555_length_721_cov_46.991961	394	474	10	13	80	0.1625000
NODE_15555_length_721_cov_46.991961	394	474	11	18	80	0.2250000
NODE_15555_length_721_cov_46.991961	394	474	12	6	80	0.0750000
NODE_15556_length_721_cov_38.864952	208	288	0	80	80	1.0000000
NODE_15556_length_721_cov_38.864952	269	341	0	65	72	0.9027778
NODE_15556_length_721_cov_38.864952	269	341	2	7	72	0.0972222
NODE_15556_length_721_cov_38.864952	337	417	2	80	80	1.0000000
NODE_15556_length_721_cov_38.864952	390	467	0	41	77	0.5324675
NODE_15556_length_721_cov_38.864952	390	467	2	36	77	0.4675325
NODE_15557_length_721_cov_29.016077	192	272	0	64	80	0.8000000
NODE_15557_length_721_cov_29.016077	192	272	2	16	80	0.2000000
NODE_15557_length_721_cov_29.016077	251	325	0	5	74	0.0675676
NODE_15557_length_721_cov_29.016077	251	325	2	69	74	0.9324324
NODE_15558_length_721_cov_26.196141	398	478	0	1	80	0.0125000
NODE_15558_length_721_cov_26.196141	398	478	2	16	80	0.2000000
NODE_15558_length_721_cov_26.196141	398	478	4	63	80	0.7875000
NODE_15558_length_721_cov_26.196141	451	531	0	26	80	0.3250000
NODE_15558_length_721_cov_26.196141	451	531	2	29	80	0.3625000
NODE_15558_length_721_cov_26.196141	451	531	4	25	80	0.3125000
NODE_15560_length_721_cov_20.054662	178	258	2	57	80	0.7125000
NODE_15560_length_721_cov_20.054662	178	258	4	23	80	0.2875000
NODE_15560_length_721_cov_20.054662	231	311	2	57	80	0.7125000
NODE_15560_length_721_cov_20.054662	231	311	4	23	80	0.2875000
NODE_15561_length_721_cov_13.670418	263	343	0	80	80	1.0000000
NODE_15561_length_721_cov_13.670418	316	396	0	80	80	1.0000000
NODE_15562_length_721_cov_13.652733	268	350	4	31	82	0.3780488
NODE_15562_length_721_cov_13.652733	268	350	6	51	82	0.6219512
NODE_15562_length_721_cov_13.652733	321	403	2	40	82	0.4878049
NODE_15562_length_721_cov_13.652733	321	403	4	1	82	0.0121951
NODE_15562_length_721_cov_13.652733	321	403	6	41	82	0.5000000
NODE_15563_length_721_cov_13.120579	312	392	4	19	80	0.2375000
NODE_15563_length_721_cov_13.120579	312	392	5	11	80	0.1375000
NODE_15563_length_721_cov_13.120579	312	392	6	13	80	0.1625000
NODE_15563_length_721_cov_13.120579	312	392	8	34	80	0.4250000
NODE_15563_length_721_cov_13.120579	312	392	12	3	80	0.0375000
NODE_15563_length_721_cov_13.120579	365	445	8	69	80	0.8625000
NODE_15563_length_721_cov_13.120579	365	445	10	8	80	0.1000000
NODE_15563_length_721_cov_13.120579	365	445	12	3	80	0.0375000
NODE_15572_length_721_cov_4.491961	210	280	2	4	70	0.0571429
NODE_15572_length_721_cov_4.491961	210	280	4	11	70	0.1571429
NODE_15572_length_721_cov_4.491961	210	280	6	17	70	0.2428571
NODE_15572_length_721_cov_4.491961	210	280	10	36	70	0.5142857
NODE_15572_length_721_cov_4.491961	210	280	12	2	70	0.0285714
NODE_15572_length_721_cov_4.491961	253	333	2	1	80	0.0125000
NODE_15572_length_721_cov_4.491961	253	333	4	9	80	0.1125000
NODE_15572_length_721_cov_4.491961	253	333	6	17	80	0.2125000
NODE_15572_length_721_cov_4.491961	253	333	8	5	80	0.0625000
NODE_15572_length_721_cov_4.491961	253	333	10	46	80	0.5750000
NODE_15572_length_721_cov_4.491961	253	333	12	2	80	0.0250000
NODE_15572_length_721_cov_4.491961	470	521	0	5	51	0.0980392
NODE_15572_length_721_cov_4.491961	470	521	2	46	51	0.9019608
NODE_15608_length_720_cov_17.449275	267	347	0	29	80	0.3625000
NODE_15608_length_720_cov_17.449275	267	347	2	51	80	0.6375000
NODE_15608_length_720_cov_17.449275	320	400	0	9	80	0.1125000
NODE_15608_length_720_cov_17.449275	320	400	2	71	80	0.8875000
NODE_15609_length_720_cov_14.814815	261	341	2	80	80	1.0000000
NODE_15609_length_720_cov_14.814815	314	394	0	42	80	0.5250000
NODE_15609_length_720_cov_14.814815	314	394	2	38	80	0.4750000
NODE_15610_length_720_cov_14.107890	290	370	0	80	80	1.0000000
NODE_15610_length_720_cov_14.107890	343	423	0	80	80	1.0000000
NODE_15612_length_720_cov_12.924316	314	394	0	25	80	0.3125000
NODE_15612_length_720_cov_12.924316	314	394	4	27	80	0.3375000
NODE_15612_length_720_cov_12.924316	314	394	6	28	80	0.3500000
NODE_15612_length_720_cov_12.924316	367	447	6	80	80	1.0000000
NODE_15614_length_720_cov_10.389694	435	515	0	80	80	1.0000000
NODE_15614_length_720_cov_10.389694	488	568	0	78	80	0.9750000
NODE_15614_length_720_cov_10.389694	488	568	2	2	80	0.0250000
NODE_15620_length_720_cov_5.278583	309	389	0	80	80	1.0000000
NODE_15620_length_720_cov_5.278583	362	442	0	80	80	1.0000000
NODE_15624_length_720_cov_3.792271	157	235	0	8	78	0.1025641
NODE_15624_length_720_cov_3.792271	157	235	2	70	78	0.8974359
NODE_15624_length_720_cov_3.792271	215	265	0	38	50	0.7600000
NODE_15624_length_720_cov_3.792271	215	265	2	12	50	0.2400000
NODE_15658_length_719_cov_30.256452	279	359	0	20	80	0.2500000
NODE_15658_length_719_cov_30.256452	279	359	2	13	80	0.1625000
NODE_15658_length_719_cov_30.256452	279	359	4	5	80	0.0625000
NODE_15658_length_719_cov_30.256452	279	359	5	1	80	0.0125000
NODE_15658_length_719_cov_30.256452	279	359	6	41	80	0.5125000
NODE_15658_length_719_cov_30.256452	332	412	0	3	80	0.0375000
NODE_15658_length_719_cov_30.256452	332	412	2	14	80	0.1750000
NODE_15658_length_719_cov_30.256452	332	412	3	1	80	0.0125000
NODE_15658_length_719_cov_30.256452	332	412	4	6	80	0.0750000
NODE_15658_length_719_cov_30.256452	332	412	6	56	80	0.7000000
NODE_15659_length_719_cov_29.093548	310	390	0	60	80	0.7500000
NODE_15659_length_719_cov_29.093548	310	390	2	20	80	0.2500000
NODE_15659_length_719_cov_29.093548	363	443	0	7	80	0.0875000
NODE_15659_length_719_cov_29.093548	363	443	2	73	80	0.9125000
NODE_15660_length_719_cov_10.988710	195	275	4	27	80	0.3375000
NODE_15660_length_719_cov_10.988710	195	275	6	53	80	0.6625000
NODE_15660_length_719_cov_10.988710	248	328	1	3	80	0.0375000
NODE_15660_length_719_cov_10.988710	248	328	4	7	80	0.0875000
NODE_15660_length_719_cov_10.988710	248	328	5	5	80	0.0625000
NODE_15660_length_719_cov_10.988710	248	328	6	65	80	0.8125000
NODE_15661_length_719_cov_10.837097	259	339	0	80	80	1.0000000
NODE_15661_length_719_cov_10.837097	312	392	0	80	80	1.0000000
NODE_15662_length_719_cov_7.622581	288	368	0	80	80	1.0000000
NODE_15662_length_719_cov_7.622581	341	421	0	80	80	1.0000000
NODE_15663_length_719_cov_7.570968	351	431	0	6	80	0.0750000
NODE_15663_length_719_cov_7.570968	351	431	2	65	80	0.8125000
NODE_15663_length_719_cov_7.570968	351	431	4	9	80	0.1125000
NODE_15663_length_719_cov_7.570968	404	484	0	25	80	0.3125000
NODE_15663_length_719_cov_7.570968	404	484	2	55	80	0.6875000
NODE_15672_length_719_cov_4.264516	251	281	0	30	30	1.0000000
NODE_15684_length_719_cov_1.629032	88	163	6	21	75	0.2800000
NODE_15684_length_719_cov_1.629032	88	163	7	20	75	0.2666667
NODE_15684_length_719_cov_1.629032	88	163	8	27	75	0.3600000
NODE_15684_length_719_cov_1.629032	88	163	9	7	75	0.0933333
NODE_15706_length_718_cov_35.382876	296	376	0	49	80	0.6125000
NODE_15706_length_718_cov_35.382876	296	376	4	31	80	0.3875000
NODE_15706_length_718_cov_35.382876	296	376	0	49	80	0.6125000
NODE_15706_length_718_cov_35.382876	296	376	4	31	80	0.3875000
NODE_15706_length_718_cov_35.382876	349	429	0	80	80	1.0000000
NODE_15706_length_718_cov_35.382876	349	429	0	80	80	1.0000000
NODE_15707_length_718_cov_24.211632	313	393	0	80	80	1.0000000
NODE_15707_length_718_cov_24.211632	366	446	0	80	80	1.0000000
NODE_15708_length_718_cov_18.300485	217	297	2	25	80	0.3125000
NODE_15708_length_718_cov_18.300485	217	297	4	55	80	0.6875000
NODE_15708_length_718_cov_18.300485	270	350	0	15	80	0.1875000
NODE_15708_length_718_cov_18.300485	270	350	2	48	80	0.6000000
NODE_15708_length_718_cov_18.300485	270	350	4	17	80	0.2125000
NODE_15709_length_718_cov_14.757674	383	463	0	80	80	1.0000000
NODE_15709_length_718_cov_14.757674	436	516	0	80	80	1.0000000
NODE_15710_length_718_cov_14.355412	254	334	1	21	80	0.2625000
NODE_15710_length_718_cov_14.355412	254	334	3	4	80	0.0500000
NODE_15710_length_718_cov_14.355412	254	334	4	29	80	0.3625000
NODE_15710_length_718_cov_14.355412	254	334	5	10	80	0.1250000
NODE_15710_length_718_cov_14.355412	254	334	6	16	80	0.2000000
NODE_15710_length_718_cov_14.355412	307	387	4	34	80	0.4250000
NODE_15710_length_718_cov_14.355412	307	387	5	10	80	0.1250000
NODE_15710_length_718_cov_14.355412	307	387	6	36	80	0.4500000
NODE_15715_length_718_cov_4.804523	263	343	0	80	80	1.0000000
NODE_15715_length_718_cov_4.804523	316	396	0	80	80	1.0000000
NODE_15750_length_717_cov_28.377023	335	415	10	16	80	0.2000000
NODE_15750_length_717_cov_28.377023	335	415	12	64	80	0.8000000
NODE_15750_length_717_cov_28.377023	388	468	0	53	80	0.6625000
NODE_15750_length_717_cov_28.377023	388	468	10	16	80	0.2000000
NODE_15750_length_717_cov_28.377023	388	468	12	11	80	0.1375000
NODE_15751_length_717_cov_23.275081	162	242	2	80	80	1.0000000
NODE_15751_length_717_cov_23.275081	215	295	0	50	80	0.6250000
NODE_15751_length_717_cov_23.275081	215	295	2	30	80	0.3750000
NODE_15752_length_717_cov_18.564725	319	399	0	5	80	0.0625000
NODE_15752_length_717_cov_18.564725	319	399	2	75	80	0.9375000
NODE_15752_length_717_cov_18.564725	372	452	0	44	80	0.5500000
NODE_15752_length_717_cov_18.564725	372	452	2	36	80	0.4500000
NODE_15753_length_717_cov_18.389968	358	438	0	80	80	1.0000000
NODE_15753_length_717_cov_18.389968	411	491	0	80	80	1.0000000
NODE_15754_length_717_cov_17.932039	241	321	6	7	80	0.0875000
NODE_15754_length_717_cov_17.932039	241	321	8	26	80	0.3250000
NODE_15754_length_717_cov_17.932039	241	321	10	17	80	0.2125000
NODE_15754_length_717_cov_17.932039	241	321	12	30	80	0.3750000
NODE_15754_length_717_cov_17.932039	294	374	0	21	80	0.2625000
NODE_15754_length_717_cov_17.932039	294	374	5	31	80	0.3875000
NODE_15754_length_717_cov_17.932039	294	374	8	1	80	0.0125000
NODE_15754_length_717_cov_17.932039	294	374	10	17	80	0.2125000
NODE_15754_length_717_cov_17.932039	294	374	12	10	80	0.1250000
NODE_15755_length_717_cov_14.637540	298	378	0	51	80	0.6375000
NODE_15755_length_717_cov_14.637540	298	378	2	29	80	0.3625000
NODE_15755_length_717_cov_14.637540	351	431	2	60	80	0.7500000
NODE_15755_length_717_cov_14.637540	351	431	4	15	80	0.1875000
NODE_15755_length_717_cov_14.637540	351	431	6	5	80	0.0625000
NODE_15756_length_717_cov_12.279935	113	196	1	13	83	0.1566265
NODE_15756_length_717_cov_12.279935	113	196	2	70	83	0.8433735
NODE_15756_length_717_cov_12.279935	169	249	1	18	80	0.2250000
NODE_15756_length_717_cov_12.279935	169	249	2	62	80	0.7750000
NODE_15757_length_717_cov_10.711974	353	431	0	78	78	1.0000000
NODE_15758_length_717_cov_9.399676	331	411	0	80	80	1.0000000
NODE_15758_length_717_cov_9.399676	384	464	0	43	80	0.5375000
NODE_15758_length_717_cov_9.399676	384	464	1	5	80	0.0625000
NODE_15758_length_717_cov_9.399676	384	464	2	32	80	0.4000000
NODE_15762_length_717_cov_5.341424	475	555	0	16	80	0.2000000
NODE_15762_length_717_cov_5.341424	475	555	2	64	80	0.8000000
NODE_15762_length_717_cov_5.341424	528	608	0	2	80	0.0250000
NODE_15762_length_717_cov_5.341424	528	608	2	78	80	0.9750000
NODE_15770_length_717_cov_3.187702	285	322	0	37	37	1.0000000
NODE_15805_length_716_cov_16.800648	430	510	0	80	80	1.0000000
NODE_15805_length_716_cov_16.800648	483	563	0	80	80	1.0000000
NODE_15806_length_716_cov_12.565640	356	436	0	12	80	0.1500000
NODE_15806_length_716_cov_12.565640	356	436	2	68	80	0.8500000
NODE_15806_length_716_cov_12.565640	409	489	0	34	80	0.4250000
NODE_15806_length_716_cov_12.565640	409	489	2	46	80	0.5750000
NODE_15807_length_716_cov_9.277147	385	465	0	80	80	1.0000000
NODE_15807_length_716_cov_9.277147	438	518	0	80	80	1.0000000
NODE_15808_length_716_cov_9.257699	302	382	0	80	80	1.0000000
NODE_15808_length_716_cov_9.257699	355	435	0	80	80	1.0000000
NODE_15809_length_716_cov_6.761750	263	343	0	80	80	1.0000000
NODE_15809_length_716_cov_6.761750	316	396	0	80	80	1.0000000
NODE_15812_length_716_cov_4.909238	236	316	0	25	80	0.3125000
NODE_15812_length_716_cov_4.909238	236	316	2	55	80	0.6875000
NODE_15812_length_716_cov_4.909238	289	369	2	80	80	1.0000000
NODE_15824_length_716_cov_2.068071	453	481	0	28	28	1.0000000
NODE_15853_length_715_cov_38.795455	260	340	0	21	80	0.2625000
NODE_15853_length_715_cov_38.795455	260	340	4	18	80	0.2250000
NODE_15853_length_715_cov_38.795455	260	340	6	41	80	0.5125000
NODE_15853_length_715_cov_38.795455	313	393	6	80	80	1.0000000
NODE_15854_length_715_cov_30.344156	316	396	4	14	80	0.1750000
NODE_15854_length_715_cov_30.344156	316	396	5	66	80	0.8250000
NODE_15854_length_715_cov_30.344156	369	449	0	43	80	0.5375000
NODE_15854_length_715_cov_30.344156	369	449	4	24	80	0.3000000
NODE_15854_length_715_cov_30.344156	369	449	5	13	80	0.1625000
NODE_15857_length_715_cov_11.209416	484	564	0	31	80	0.3875000
NODE_15857_length_715_cov_11.209416	484	564	2	49	80	0.6125000
NODE_15857_length_715_cov_11.209416	537	617	0	26	80	0.3250000
NODE_15857_length_715_cov_11.209416	537	617	2	54	80	0.6750000
NODE_15858_length_715_cov_10.894481	189	242	4	53	53	1.0000000
NODE_15859_length_715_cov_10.628247	502	582	0	33	80	0.4125000
NODE_15859_length_715_cov_10.628247	502	582	2	47	80	0.5875000
NODE_15859_length_715_cov_10.628247	555	635	0	11	80	0.1375000
NODE_15859_length_715_cov_10.628247	555	635	2	69	80	0.8625000
NODE_15860_length_715_cov_8.647727	138	218	0	80	80	1.0000000
NODE_15860_length_715_cov_8.647727	191	271	0	55	80	0.6875000
NODE_15860_length_715_cov_8.647727	191	271	2	25	80	0.3125000
NODE_15861_length_715_cov_8.412338	364	444	0	65	80	0.8125000
NODE_15861_length_715_cov_8.412338	364	444	2	15	80	0.1875000
NODE_15861_length_715_cov_8.412338	417	497	0	12	80	0.1500000
NODE_15861_length_715_cov_8.412338	417	497	2	68	80	0.8500000
NODE_15864_length_715_cov_5.373377	318	398	0	46	80	0.5750000
NODE_15864_length_715_cov_5.373377	318	398	4	34	80	0.4250000
NODE_15864_length_715_cov_5.373377	371	451	0	80	80	1.0000000
NODE_15898_length_715_cov_1.271104	331	397	0	66	66	1.0000000
NODE_15910_length_714_cov_18.621138	297	377	2	9	80	0.1125000
NODE_15910_length_714_cov_18.621138	297	377	4	52	80	0.6500000
NODE_15910_length_714_cov_18.621138	297	377	6	19	80	0.2375000
NODE_15910_length_714_cov_18.621138	350	430	2	40	80	0.5000000
NODE_15910_length_714_cov_18.621138	350	430	4	21	80	0.2625000
NODE_15910_length_714_cov_18.621138	350	430	6	19	80	0.2375000
NODE_15911_length_714_cov_15.468293	268	348	0	60	80	0.7500000
NODE_15911_length_714_cov_15.468293	268	348	2	20	80	0.2500000
NODE_15911_length_714_cov_15.468293	321	401	0	7	80	0.0875000
NODE_15911_length_714_cov_15.468293	321	401	2	73	80	0.9125000
NODE_15913_length_714_cov_10.530081	218	298	0	80	80	1.0000000
NODE_15913_length_714_cov_10.530081	271	351	0	80	80	1.0000000
NODE_15913_length_714_cov_10.530081	354	434	0	80	80	1.0000000
NODE_15913_length_714_cov_10.530081	407	487	0	80	80	1.0000000
NODE_15914_length_714_cov_8.365854	285	365	0	80	80	1.0000000
NODE_15914_length_714_cov_8.365854	338	418	0	80	80	1.0000000
NODE_15919_length_714_cov_6.993496	263	343	4	2	80	0.0250000
NODE_15919_length_714_cov_6.993496	263	343	6	54	80	0.6750000
NODE_15919_length_714_cov_6.993496	263	343	8	24	80	0.3000000
NODE_15919_length_714_cov_6.993496	316	384	2	3	68	0.0441176
NODE_15919_length_714_cov_6.993496	316	384	4	12	68	0.1764706
NODE_15919_length_714_cov_6.993496	316	384	6	53	68	0.7794118
NODE_15921_length_714_cov_4.224390	218	288	0	70	70	1.0000000
NODE_15921_length_714_cov_4.224390	271	351	0	80	80	1.0000000
NODE_15969_length_713_cov_19.304560	271	351	2	58	80	0.7250000
NODE_15969_length_713_cov_19.304560	271	351	4	22	80	0.2750000
NODE_15969_length_713_cov_19.304560	324	404	0	18	80	0.2250000
NODE_15969_length_713_cov_19.304560	324	404	2	62	80	0.7750000
NODE_15970_length_713_cov_16.926710	262	342	0	80	80	1.0000000
NODE_15970_length_713_cov_16.926710	315	395	0	80	80	1.0000000
NODE_15973_length_713_cov_7.159609	351	431	0	80	80	1.0000000
NODE_15973_length_713_cov_7.159609	404	484	0	80	80	1.0000000
NODE_15974_length_713_cov_6.723127	379	427	2	4	48	0.0833333
NODE_15974_length_713_cov_6.723127	379	427	4	2	48	0.0416667
NODE_15974_length_713_cov_6.723127	379	427	8	9	48	0.1875000
NODE_15974_length_713_cov_6.723127	379	427	10	3	48	0.0625000
NODE_15974_length_713_cov_6.723127	379	427	12	12	48	0.2500000
NODE_15974_length_713_cov_6.723127	379	427	14	18	48	0.3750000
NODE_15975_length_713_cov_4.954397	90	171	0	81	81	1.0000000
NODE_15975_length_713_cov_4.954397	144	224	0	58	80	0.7250000
NODE_15975_length_713_cov_4.954397	144	224	2	22	80	0.2750000
NODE_15980_length_713_cov_4.302932	402	482	2	13	80	0.1625000
NODE_15980_length_713_cov_4.302932	402	482	6	67	80	0.8375000
NODE_15980_length_713_cov_4.302932	455	535	4	29	80	0.3625000
NODE_15980_length_713_cov_4.302932	455	535	6	51	80	0.6375000
NODE_16004_length_713_cov_1.939739	15	75	0	60	60	1.0000000
NODE_16010_length_713_cov_1.605863	81	161	0	80	80	1.0000000
NODE_16010_length_713_cov_1.605863	134	214	0	80	80	1.0000000
NODE_16052_length_712_cov_32.931485	289	369	0	80	80	1.0000000
NODE_16052_length_712_cov_32.931485	342	422	0	80	80	1.0000000
NODE_16053_length_712_cov_31.752039	185	251	0	13	66	0.1969697
NODE_16053_length_712_cov_31.752039	185	251	2	53	66	0.8030303
NODE_16053_length_712_cov_31.752039	228	307	0	33	79	0.4177215
NODE_16053_length_712_cov_31.752039	228	307	2	46	79	0.5822785
NODE_16054_length_712_cov_22.567700	228	308	0	80	80	1.0000000
NODE_16054_length_712_cov_22.567700	281	361	0	80	80	1.0000000
NODE_16055_length_712_cov_19.306688	238	318	0	5	80	0.0625000
NODE_16055_length_712_cov_19.306688	238	318	2	75	80	0.9375000
NODE_16055_length_712_cov_19.306688	291	371	0	58	80	0.7250000
NODE_16055_length_712_cov_19.306688	291	371	2	22	80	0.2750000
NODE_16056_length_712_cov_14.929853	332	412	0	80	80	1.0000000
NODE_16056_length_712_cov_14.929853	385	465	0	80	80	1.0000000
NODE_16057_length_712_cov_14.228385	250	330	2	78	80	0.9750000
NODE_16057_length_712_cov_14.228385	250	330	8	2	80	0.0250000
NODE_16057_length_712_cov_14.228385	303	383	2	25	80	0.3125000
NODE_16057_length_712_cov_14.228385	303	383	6	36	80	0.4500000
NODE_16057_length_712_cov_14.228385	303	383	8	19	80	0.2375000
NODE_16059_length_712_cov_9.221860	326	406	4	52	80	0.6500000
NODE_16059_length_712_cov_9.221860	326	406	6	28	80	0.3500000
NODE_16059_length_712_cov_9.221860	379	463	2	43	84	0.5119048
NODE_16059_length_712_cov_9.221860	379	463	6	41	84	0.4880952
NODE_16060_length_712_cov_8.368679	331	411	0	80	80	1.0000000
NODE_16060_length_712_cov_8.368679	384	464	0	80	80	1.0000000
NODE_16079_length_712_cov_2.350734	466	510	0	43	44	0.9772727
NODE_16079_length_712_cov_2.350734	466	510	2	1	44	0.0227273
NODE_16118_length_711_cov_36.459150	146	223	2	77	77	1.0000000
NODE_16118_length_711_cov_36.459150	199	280	0	49	81	0.6049383
NODE_16118_length_711_cov_36.459150	199	280	2	32	81	0.3950617
NODE_16119_length_711_cov_26.702614	460	540	0	80	80	1.0000000
NODE_16119_length_711_cov_26.702614	513	593	0	80	80	1.0000000
NODE_16120_length_711_cov_19.632353	329	409	2	80	80	1.0000000
NODE_16120_length_711_cov_19.632353	382	462	0	41	80	0.5125000
NODE_16120_length_711_cov_19.632353	382	462	2	39	80	0.4875000
NODE_16121_length_711_cov_19.267974	283	363	0	20	80	0.2500000
NODE_16121_length_711_cov_19.267974	283	363	2	18	80	0.2250000
NODE_16121_length_711_cov_19.267974	283	363	4	22	80	0.2750000
NODE_16121_length_711_cov_19.267974	283	363	6	20	80	0.2500000
NODE_16121_length_711_cov_19.267974	336	416	3	2	80	0.0250000
NODE_16121_length_711_cov_19.267974	336	416	4	37	80	0.4625000
NODE_16121_length_711_cov_19.267974	336	416	6	41	80	0.5125000
NODE_16122_length_711_cov_12.813725	255	334	0	15	79	0.1898734
NODE_16122_length_711_cov_12.813725	255	334	2	33	79	0.4177215
NODE_16122_length_711_cov_12.813725	255	334	4	31	79	0.3924051
NODE_16123_length_711_cov_12.147059	314	394	0	80	80	1.0000000
NODE_16123_length_711_cov_12.147059	367	447	0	80	80	1.0000000
NODE_16124_length_711_cov_10.009804	336	415	0	79	79	1.0000000
NODE_16127_length_711_cov_5.619281	276	356	0	50	80	0.6250000
NODE_16127_length_711_cov_5.619281	276	356	2	30	80	0.3750000
NODE_16127_length_711_cov_5.619281	329	409	0	80	80	1.0000000
NODE_16130_length_711_cov_4.040850	165	245	0	28	80	0.3500000
NODE_16130_length_711_cov_4.040850	165	245	2	52	80	0.6500000
NODE_16130_length_711_cov_4.040850	218	298	0	5	80	0.0625000
NODE_16130_length_711_cov_4.040850	218	298	2	75	80	0.9375000
NODE_16167_length_710_cov_73.721768	626	706	0	80	80	1.0000000
NODE_16168_length_710_cov_21.772504	292	372	0	11	80	0.1375000
NODE_16168_length_710_cov_21.772504	292	372	2	69	80	0.8625000
NODE_16168_length_710_cov_21.772504	345	425	0	50	80	0.6250000
NODE_16168_length_710_cov_21.772504	345	425	2	30	80	0.3750000
NODE_16169_length_710_cov_21.597381	18	54	0	33	36	0.9166667
NODE_16169_length_710_cov_21.597381	18	54	4	3	36	0.0833333
NODE_16170_length_710_cov_13.155483	306	386	2	80	80	1.0000000
NODE_16170_length_710_cov_13.155483	359	439	0	2	80	0.0250000
NODE_16170_length_710_cov_13.155483	359	439	2	78	80	0.9750000
NODE_16173_length_710_cov_8.031097	316	396	0	64	80	0.8000000
NODE_16173_length_710_cov_8.031097	316	396	2	16	80	0.2000000
NODE_16173_length_710_cov_8.031097	369	449	0	80	80	1.0000000
NODE_16175_length_710_cov_6.664484	264	344	0	45	80	0.5625000
NODE_16175_length_710_cov_6.664484	264	344	2	35	80	0.4375000
NODE_16178_length_710_cov_5.590835	352	421	0	42	69	0.6086956
NODE_16178_length_710_cov_5.590835	352	421	4	27	69	0.3913043
NODE_16178_length_710_cov_5.590835	394	474	4	80	80	1.0000000
NODE_16180_length_710_cov_5.356792	248	328	1	4	80	0.0500000
NODE_16180_length_710_cov_5.356792	248	328	3	1	80	0.0125000
NODE_16180_length_710_cov_5.356792	248	328	4	1	80	0.0125000
NODE_16180_length_710_cov_5.356792	248	328	7	18	80	0.2250000
NODE_16180_length_710_cov_5.356792	248	328	9	3	80	0.0375000
NODE_16180_length_710_cov_5.356792	248	328	11	17	80	0.2125000
NODE_16180_length_710_cov_5.356792	248	328	13	19	80	0.2375000
NODE_16180_length_710_cov_5.356792	248	328	17	17	80	0.2125000
NODE_16180_length_710_cov_5.356792	301	381	13	10	80	0.1250000
NODE_16180_length_710_cov_5.356792	301	381	16	6	80	0.0750000
NODE_16180_length_710_cov_5.356792	301	381	17	21	80	0.2625000
NODE_16180_length_710_cov_5.356792	301	381	18	8	80	0.1000000
NODE_16180_length_710_cov_5.356792	301	381	19	11	80	0.1375000
NODE_16180_length_710_cov_5.356792	301	381	20	3	80	0.0375000
NODE_16180_length_710_cov_5.356792	301	381	21	18	80	0.2250000
NODE_16180_length_710_cov_5.356792	301	381	23	3	80	0.0375000
NODE_16233_length_709_cov_12.227869	347	427	0	80	80	1.0000000
NODE_16233_length_709_cov_12.227869	400	480	0	80	80	1.0000000
NODE_16234_length_709_cov_10.531148	279	359	2	14	80	0.1750000
NODE_16234_length_709_cov_10.531148	279	359	3	66	80	0.8250000
NODE_16234_length_709_cov_10.531148	332	412	0	25	80	0.3125000
NODE_16234_length_709_cov_10.531148	332	412	2	8	80	0.1000000
NODE_16234_length_709_cov_10.531148	332	412	3	47	80	0.5875000
NODE_16238_length_709_cov_7.181967	225	305	0	38	80	0.4750000
NODE_16238_length_709_cov_7.181967	225	305	2	42	80	0.5250000
NODE_16238_length_709_cov_7.181967	279	312	2	33	33	1.0000000
NODE_16241_length_709_cov_5.888525	239	319	0	69	80	0.8625000
NODE_16241_length_709_cov_5.888525	239	319	1	11	80	0.1375000
NODE_16241_length_709_cov_5.888525	292	372	0	80	80	1.0000000
NODE_16294_length_708_cov_42.435140	307	387	5	2	80	0.0250000
NODE_16294_length_708_cov_42.435140	307	387	7	17	80	0.2125000
NODE_16294_length_708_cov_42.435140	307	387	8	35	80	0.4375000
NODE_16294_length_708_cov_42.435140	307	387	10	26	80	0.3250000
NODE_16294_length_708_cov_42.435140	360	440	3	1	80	0.0125000
NODE_16294_length_708_cov_42.435140	360	440	5	30	80	0.3750000
NODE_16294_length_708_cov_42.435140	360	440	8	22	80	0.2750000
NODE_16294_length_708_cov_42.435140	360	440	10	27	80	0.3375000
NODE_16296_length_708_cov_33.412151	235	315	2	1	80	0.0125000
NODE_16296_length_708_cov_33.412151	235	315	6	43	80	0.5375000
NODE_16296_length_708_cov_33.412151	235	315	8	36	80	0.4500000
NODE_16296_length_708_cov_33.412151	288	368	0	18	80	0.2250000
NODE_16296_length_708_cov_33.412151	288	368	2	36	80	0.4500000
NODE_16296_length_708_cov_33.412151	288	368	8	26	80	0.3250000
NODE_16297_length_708_cov_23.034483	316	396	0	6	80	0.0750000
NODE_16297_length_708_cov_23.034483	316	396	1	30	80	0.3750000
NODE_16297_length_708_cov_23.034483	316	396	2	44	80	0.5500000
NODE_16297_length_708_cov_23.034483	369	449	0	59	80	0.7375000
NODE_16297_length_708_cov_23.034483	369	449	1	21	80	0.2625000
NODE_16298_length_708_cov_20.449918	254	334	0	25	80	0.3125000
NODE_16298_length_708_cov_20.449918	254	334	2	55	80	0.6875000
NODE_16298_length_708_cov_20.449918	307	387	0	5	80	0.0625000
NODE_16298_length_708_cov_20.449918	307	387	2	75	80	0.9375000
NODE_16299_length_708_cov_19.998358	238	318	0	80	80	1.0000000
NODE_16299_length_708_cov_19.998358	291	371	0	80	80	1.0000000
NODE_16300_length_708_cov_19.021346	366	446	0	80	80	1.0000000
NODE_16300_length_708_cov_19.021346	419	499	0	80	80	1.0000000
NODE_16302_length_708_cov_12.228243	181	263	2	82	82	1.0000000
NODE_16302_length_708_cov_12.228243	188	268	2	80	80	1.0000000
NODE_16302_length_708_cov_12.228243	236	316	0	22	80	0.2750000
NODE_16302_length_708_cov_12.228243	236	316	2	58	80	0.7250000
NODE_16302_length_708_cov_12.228243	312	392	0	80	80	1.0000000
NODE_16302_length_708_cov_12.228243	312	392	0	80	80	1.0000000
NODE_16302_length_708_cov_12.228243	365	445	0	80	80	1.0000000
NODE_16303_length_708_cov_11.338259	255	335	0	9	80	0.1125000
NODE_16303_length_708_cov_11.338259	255	335	2	71	80	0.8875000
NODE_16303_length_708_cov_11.338259	308	388	0	62	80	0.7750000
NODE_16303_length_708_cov_11.338259	308	388	2	18	80	0.2250000
NODE_16305_length_708_cov_9.676519	219	299	0	8	80	0.1000000
NODE_16305_length_708_cov_9.676519	219	299	1	1	80	0.0125000
NODE_16305_length_708_cov_9.676519	219	299	2	71	80	0.8875000
NODE_16305_length_708_cov_9.676519	272	352	0	61	80	0.7625000
NODE_16305_length_708_cov_9.676519	272	352	1	1	80	0.0125000
NODE_16305_length_708_cov_9.676519	272	352	2	18	80	0.2250000
NODE_16306_length_708_cov_8.638752	324	399	0	75	75	1.0000000
NODE_16330_length_708_cov_2.699507	358	398	2	40	40	1.0000000
NODE_16370_length_707_cov_30.067434	325	405	0	21	80	0.2625000
NODE_16370_length_707_cov_30.067434	325	405	5	1	80	0.0125000
NODE_16370_length_707_cov_30.067434	325	405	6	58	80	0.7250000
NODE_16370_length_707_cov_30.067434	378	458	0	36	80	0.4500000
NODE_16370_length_707_cov_30.067434	378	458	6	44	80	0.5500000
NODE_16371_length_707_cov_26.555921	241	321	0	75	80	0.9375000
NODE_16371_length_707_cov_26.555921	241	321	2	5	80	0.0625000
NODE_16371_length_707_cov_26.555921	294	374	0	22	80	0.2750000
NODE_16371_length_707_cov_26.555921	294	374	2	58	80	0.7250000
NODE_16372_length_707_cov_23.972039	322	402	4	26	80	0.3250000
NODE_16372_length_707_cov_23.972039	322	402	6	54	80	0.6750000
NODE_16372_length_707_cov_23.972039	375	455	0	34	80	0.4250000
NODE_16372_length_707_cov_23.972039	375	455	2	2	80	0.0250000
NODE_16372_length_707_cov_23.972039	375	455	4	35	80	0.4375000
NODE_16372_length_707_cov_23.972039	375	455	6	9	80	0.1125000
NODE_16373_length_707_cov_20.348684	157	237	0	22	80	0.2750000
NODE_16373_length_707_cov_20.348684	157	237	2	58	80	0.7250000
NODE_16373_length_707_cov_20.348684	210	281	2	62	71	0.8732395
NODE_16373_length_707_cov_20.348684	210	281	4	9	71	0.1267606
NODE_16374_length_707_cov_18.970395	253	333	2	80	80	1.0000000
NODE_16374_length_707_cov_18.970395	306	386	0	31	80	0.3875000
NODE_16374_length_707_cov_18.970395	306	386	2	49	80	0.6125000
NODE_16375_length_707_cov_14.324013	302	382	0	80	80	1.0000000
NODE_16375_length_707_cov_14.324013	355	435	0	80	80	1.0000000
NODE_16378_length_707_cov_5.062500	313	393	0	14	80	0.1750000
NODE_16378_length_707_cov_5.062500	313	393	2	66	80	0.8250000
NODE_16441_length_706_cov_34.116969	272	352	0	26	80	0.3250000
NODE_16441_length_706_cov_34.116969	272	352	2	54	80	0.6750000
NODE_16441_length_706_cov_34.116969	325	405	0	64	80	0.8000000
NODE_16441_length_706_cov_34.116969	325	405	2	16	80	0.2000000
NODE_16442_length_706_cov_27.220758	229	309	0	53	80	0.6625000
NODE_16442_length_706_cov_27.220758	229	309	2	22	80	0.2750000
NODE_16442_length_706_cov_27.220758	229	309	10	5	80	0.0625000
NODE_16442_length_706_cov_27.220758	282	362	2	22	80	0.2750000
NODE_16442_length_706_cov_27.220758	282	362	10	35	80	0.4375000
NODE_16442_length_706_cov_27.220758	282	362	12	23	80	0.2875000
NODE_16443_length_706_cov_20.380560	264	344	0	61	80	0.7625000
NODE_16443_length_706_cov_20.380560	264	344	2	19	80	0.2375000
NODE_16443_length_706_cov_20.380560	317	397	0	8	80	0.1000000
NODE_16443_length_706_cov_20.380560	317	397	2	72	80	0.9000000
NODE_16444_length_706_cov_19.525535	289	369	0	80	80	1.0000000
NODE_16444_length_706_cov_19.525535	342	422	0	80	80	1.0000000
NODE_16454_length_706_cov_3.344316	465	545	0	67	80	0.8375000
NODE_16454_length_706_cov_3.344316	465	545	2	13	80	0.1625000
NODE_16454_length_706_cov_3.344316	518	598	0	80	80	1.0000000
NODE_16494_length_705_cov_19.211221	118	198	6	17	80	0.2125000
NODE_16494_length_705_cov_19.211221	118	198	7	2	80	0.0250000
NODE_16494_length_705_cov_19.211221	118	198	8	4	80	0.0500000
NODE_16494_length_705_cov_19.211221	118	198	9	24	80	0.3000000
NODE_16494_length_705_cov_19.211221	118	198	10	33	80	0.4125000
NODE_16494_length_705_cov_19.211221	171	250	0	8	79	0.1012658
NODE_16494_length_705_cov_19.211221	171	250	2	13	79	0.1645570
NODE_16494_length_705_cov_19.211221	171	250	3	1	79	0.0126582
NODE_16494_length_705_cov_19.211221	171	250	5	10	79	0.1265823
NODE_16494_length_705_cov_19.211221	171	250	7	22	79	0.2784810
NODE_16494_length_705_cov_19.211221	171	250	9	24	79	0.3037975
NODE_16494_length_705_cov_19.211221	171	250	10	1	79	0.0126582
NODE_16495_length_705_cov_16.338284	291	339	0	48	48	1.0000000
NODE_16495_length_705_cov_16.338284	336	406	0	70	70	1.0000000
NODE_16496_length_705_cov_14.354785	209	289	0	80	80	1.0000000
NODE_16496_length_705_cov_14.354785	262	342	0	80	80	1.0000000
NODE_16497_length_705_cov_12.231023	293	373	0	66	80	0.8250000
NODE_16497_length_705_cov_12.231023	293	373	2	14	80	0.1750000
NODE_16497_length_705_cov_12.231023	346	426	0	13	80	0.1625000
NODE_16497_length_705_cov_12.231023	346	426	2	67	80	0.8375000
NODE_16498_length_705_cov_11.836634	390	470	0	80	80	1.0000000
NODE_16498_length_705_cov_11.836634	443	523	0	80	80	1.0000000
NODE_16499_length_705_cov_10.049505	382	479	1	72	97	0.7422680
NODE_16499_length_705_cov_10.049505	382	479	5	25	97	0.2577319
NODE_16499_length_705_cov_10.049505	452	532	1	2	80	0.0250000
NODE_16499_length_705_cov_10.049505	452	532	4	12	80	0.1500000
NODE_16499_length_705_cov_10.049505	452	532	5	66	80	0.8250000
NODE_16507_length_705_cov_4.275578	358	438	0	80	80	1.0000000
NODE_16507_length_705_cov_4.275578	411	491	0	80	80	1.0000000
NODE_16509_length_705_cov_4.018152	306	364	4	23	58	0.3965517
NODE_16509_length_705_cov_4.018152	306	364	6	11	58	0.1896552
NODE_16509_length_705_cov_4.018152	306	364	8	24	58	0.4137931
NODE_16509_length_705_cov_4.018152	337	410	2	1	73	0.0136986
NODE_16509_length_705_cov_4.018152	337	410	4	41	73	0.5616438
NODE_16509_length_705_cov_4.018152	337	410	6	3	73	0.0410959
NODE_16509_length_705_cov_4.018152	337	410	8	28	73	0.3835616
NODE_16511_length_705_cov_3.620462	253	315	6	1	62	0.0161290
NODE_16511_length_705_cov_3.620462	253	315	8	3	62	0.0483871
NODE_16511_length_705_cov_3.620462	253	315	15	1	62	0.0161290
NODE_16511_length_705_cov_3.620462	253	315	16	7	62	0.1129032
NODE_16511_length_705_cov_3.620462	253	315	18	34	62	0.5483871
NODE_16511_length_705_cov_3.620462	253	315	19	15	62	0.2419355
NODE_16511_length_705_cov_3.620462	253	315	21	1	62	0.0161290
NODE_16511_length_705_cov_3.620462	308	368	12	1	60	0.0166667
NODE_16511_length_705_cov_3.620462	308	368	15	6	60	0.1000000
NODE_16511_length_705_cov_3.620462	308	368	17	1	60	0.0166667
NODE_16511_length_705_cov_3.620462	308	368	18	30	60	0.5000000
NODE_16511_length_705_cov_3.620462	308	368	19	21	60	0.3500000
NODE_16511_length_705_cov_3.620462	308	368	21	1	60	0.0166667
NODE_16527_length_705_cov_1.607261	462	531	2	43	69	0.6231884
NODE_16527_length_705_cov_1.607261	462	531	4	11	69	0.1594203
NODE_16527_length_705_cov_1.607261	462	531	6	13	69	0.1884058
NODE_16527_length_705_cov_1.607261	462	531	8	2	69	0.0289855
NODE_16549_length_705_cov_0.529703	33	97	4	13	64	0.2031250
NODE_16549_length_705_cov_0.529703	33	97	6	24	64	0.3750000
NODE_16549_length_705_cov_0.529703	33	97	7	6	64	0.0937500
NODE_16549_length_705_cov_0.529703	33	97	8	21	64	0.3281250
NODE_16549_length_705_cov_0.529703	86	150	4	7	64	0.1093750
NODE_16549_length_705_cov_0.529703	86	150	6	24	64	0.3750000
NODE_16549_length_705_cov_0.529703	86	150	8	33	64	0.5156250
NODE_16550_length_704_cov_18.256198	295	375	4	80	80	1.0000000
NODE_16550_length_704_cov_18.256198	348	428	0	53	80	0.6625000
NODE_16550_length_704_cov_18.256198	348	428	4	27	80	0.3375000
NODE_16552_length_704_cov_16.662810	264	344	2	25	80	0.3125000
NODE_16552_length_704_cov_16.662810	264	344	4	21	80	0.2625000
NODE_16552_length_704_cov_16.662810	264	344	6	15	80	0.1875000
NODE_16552_length_704_cov_16.662810	264	344	7	9	80	0.1125000
NODE_16552_length_704_cov_16.662810	264	344	11	8	80	0.1000000
NODE_16552_length_704_cov_16.662810	264	344	12	2	80	0.0250000
NODE_16552_length_704_cov_16.662810	317	397	6	8	80	0.1000000
NODE_16552_length_704_cov_16.662810	317	397	7	9	80	0.1125000
NODE_16552_length_704_cov_16.662810	317	397	8	13	80	0.1625000
NODE_16552_length_704_cov_16.662810	317	397	10	13	80	0.1625000
NODE_16552_length_704_cov_16.662810	317	397	11	8	80	0.1000000
NODE_16552_length_704_cov_16.662810	317	397	12	29	80	0.3625000
NODE_16553_length_704_cov_12.641322	294	374	1	14	80	0.1750000
NODE_16553_length_704_cov_12.641322	294	374	2	66	80	0.8250000
NODE_16553_length_704_cov_12.641322	347	427	0	41	80	0.5125000
NODE_16553_length_704_cov_12.641322	347	427	1	26	80	0.3250000
NODE_16553_length_704_cov_12.641322	347	427	2	13	80	0.1625000
NODE_16557_length_704_cov_5.603306	440	498	0	17	58	0.2931035
NODE_16557_length_704_cov_5.603306	440	498	2	41	58	0.7068965
NODE_16564_length_704_cov_3.535537	303	383	0	1	80	0.0125000
NODE_16564_length_704_cov_3.535537	303	383	4	4	80	0.0500000
NODE_16564_length_704_cov_3.535537	303	383	6	75	80	0.9375000
NODE_16564_length_704_cov_3.535537	369	436	0	9	67	0.1343284
NODE_16564_length_704_cov_3.535537	369	436	2	3	67	0.0447761
NODE_16564_length_704_cov_3.535537	369	436	6	55	67	0.8208955
NODE_16578_length_704_cov_1.963636	345	425	0	26	80	0.3250000
NODE_16578_length_704_cov_1.963636	345	425	2	54	80	0.6750000
NODE_16578_length_704_cov_1.963636	398	478	0	21	80	0.2625000
NODE_16578_length_704_cov_1.963636	398	478	2	59	80	0.7375000
NODE_16598_length_703_cov_44.102649	514	594	0	80	80	1.0000000
NODE_16598_length_703_cov_44.102649	567	647	0	80	80	1.0000000
NODE_16599_length_703_cov_33.067881	521	594	89	1	73	0.0136986
NODE_16599_length_703_cov_33.067881	521	594	91	1	73	0.0136986
NODE_16599_length_703_cov_33.067881	521	594	93	6	73	0.0821918
NODE_16599_length_703_cov_33.067881	521	594	95	7	73	0.0958904
NODE_16599_length_703_cov_33.067881	521	594	96	1	73	0.0136986
NODE_16599_length_703_cov_33.067881	521	594	97	18	73	0.2465753
NODE_16599_length_703_cov_33.067881	521	594	98	1	73	0.0136986
NODE_16599_length_703_cov_33.067881	521	594	99	4	73	0.0547945
NODE_16599_length_703_cov_33.067881	521	594	100	1	73	0.0136986
NODE_16599_length_703_cov_33.067881	521	594	101	10	73	0.1369863
NODE_16599_length_703_cov_33.067881	521	594	102	3	73	0.0410959
NODE_16599_length_703_cov_33.067881	521	594	103	5	73	0.0684932
NODE_16599_length_703_cov_33.067881	521	594	104	2	73	0.0273973
NODE_16599_length_703_cov_33.067881	521	594	105	2	73	0.0273973
NODE_16599_length_703_cov_33.067881	521	594	107	2	73	0.0273973
NODE_16599_length_703_cov_33.067881	521	594	108	3	73	0.0410959
NODE_16599_length_703_cov_33.067881	521	594	109	4	73	0.0547945
NODE_16599_length_703_cov_33.067881	521	594	111	1	73	0.0136986
NODE_16599_length_703_cov_33.067881	521	594	113	1	73	0.0136986
NODE_16599_length_703_cov_33.067881	561	602	95	3	41	0.0731707
NODE_16599_length_703_cov_33.067881	561	602	96	1	41	0.0243902
NODE_16599_length_703_cov_33.067881	561	602	97	2	41	0.0487805
NODE_16599_length_703_cov_33.067881	561	602	99	2	41	0.0487805
NODE_16599_length_703_cov_33.067881	561	602	100	1	41	0.0243902
NODE_16599_length_703_cov_33.067881	561	602	101	11	41	0.2682927
NODE_16599_length_703_cov_33.067881	561	602	102	3	41	0.0731707
NODE_16599_length_703_cov_33.067881	561	602	103	3	41	0.0731707
NODE_16599_length_703_cov_33.067881	561	602	104	2	41	0.0487805
NODE_16599_length_703_cov_33.067881	561	602	105	3	41	0.0731707
NODE_16599_length_703_cov_33.067881	561	602	107	4	41	0.0975610
NODE_16599_length_703_cov_33.067881	561	602	108	3	41	0.0731707
NODE_16599_length_703_cov_33.067881	561	602	109	3	41	0.0731707
NODE_16600_length_703_cov_30.266556	312	392	2	80	80	1.0000000
NODE_16600_length_703_cov_30.266556	365	445	0	26	80	0.3250000
NODE_16600_length_703_cov_30.266556	365	445	2	54	80	0.6750000
NODE_16601_length_703_cov_17.006623	449	529	0	80	80	1.0000000
NODE_16601_length_703_cov_17.006623	502	582	0	80	80	1.0000000
NODE_16602_length_703_cov_14.801325	383	463	0	80	80	1.0000000
NODE_16602_length_703_cov_14.801325	436	516	0	80	80	1.0000000
NODE_16603_length_703_cov_11.766556	308	388	2	68	80	0.8500000
NODE_16603_length_703_cov_11.766556	308	388	4	12	80	0.1500000
NODE_16603_length_703_cov_11.766556	361	441	2	68	80	0.8500000
NODE_16603_length_703_cov_11.766556	361	441	4	12	80	0.1500000
NODE_16604_length_703_cov_10.405629	213	293	4	7	80	0.0875000
NODE_16604_length_703_cov_10.405629	213	293	6	17	80	0.2125000
NODE_16604_length_703_cov_10.405629	213	293	8	1	80	0.0125000
NODE_16604_length_703_cov_10.405629	213	293	10	16	80	0.2000000
NODE_16604_length_703_cov_10.405629	213	293	12	36	80	0.4500000
NODE_16604_length_703_cov_10.405629	213	293	14	2	80	0.0250000
NODE_16604_length_703_cov_10.405629	213	293	18	1	80	0.0125000
NODE_16604_length_703_cov_10.405629	266	301	4	15	35	0.4285714
NODE_16604_length_703_cov_10.405629	266	301	6	17	35	0.4857143
NODE_16604_length_703_cov_10.405629	266	301	8	1	35	0.0285714
NODE_16604_length_703_cov_10.405629	266	301	10	2	35	0.0571429
NODE_16605_length_703_cov_6.966887	381	440	0	59	59	1.0000000
NODE_16616_length_703_cov_3.491722	256	309	0	53	53	1.0000000
NODE_16616_length_703_cov_3.491722	257	337	0	80	80	1.0000000
NODE_16616_length_703_cov_3.491722	305	362	0	57	57	1.0000000
NODE_16624_length_703_cov_2.687086	216	296	0	80	80	1.0000000
NODE_16624_length_703_cov_2.687086	269	349	0	80	80	1.0000000
NODE_16663_length_702_cov_49.784411	221	299	0	78	78	1.0000000
NODE_16663_length_702_cov_49.784411	277	352	0	75	75	1.0000000
NODE_16664_length_702_cov_26.570481	201	281	0	61	80	0.7625000
NODE_16664_length_702_cov_26.570481	201	281	2	19	80	0.2375000
NODE_16664_length_702_cov_26.570481	254	334	0	80	80	1.0000000
NODE_16665_length_702_cov_23.971808	139	219	4	49	80	0.6125000
NODE_16665_length_702_cov_23.971808	139	219	6	31	80	0.3875000
NODE_16665_length_702_cov_23.971808	192	272	0	22	80	0.2750000
NODE_16665_length_702_cov_23.971808	192	272	1	15	80	0.1875000
NODE_16665_length_702_cov_23.971808	192	272	3	9	80	0.1125000
NODE_16665_length_702_cov_23.971808	192	272	4	34	80	0.4250000
NODE_16665_length_702_cov_23.971808	268	348	0	80	80	1.0000000
NODE_16665_length_702_cov_23.971808	321	401	0	80	80	1.0000000
NODE_16666_length_702_cov_23.827529	448	528	0	26	80	0.3250000
NODE_16666_length_702_cov_23.827529	448	528	2	54	80	0.6750000
NODE_16666_length_702_cov_23.827529	501	581	0	26	80	0.3250000
NODE_16666_length_702_cov_23.827529	501	581	2	54	80	0.6750000
NODE_16667_length_702_cov_14.661692	424	504	4	80	80	1.0000000
NODE_16667_length_702_cov_14.661692	477	557	0	36	80	0.4500000
NODE_16667_length_702_cov_14.661692	477	557	2	10	80	0.1250000
NODE_16667_length_702_cov_14.661692	477	557	4	34	80	0.4250000
NODE_16668_length_702_cov_13.908789	259	304	0	35	45	0.7777778
NODE_16668_length_702_cov_13.908789	259	304	2	1	45	0.0222222
NODE_16668_length_702_cov_13.908789	259	304	4	9	45	0.2000000
NODE_16668_length_702_cov_13.908789	277	357	0	17	80	0.2125000
NODE_16668_length_702_cov_13.908789	277	357	2	1	80	0.0125000
NODE_16668_length_702_cov_13.908789	277	357	4	12	80	0.1500000
NODE_16668_length_702_cov_13.908789	277	357	6	50	80	0.6250000
NODE_16668_length_702_cov_13.908789	289	357	0	5	68	0.0735294
NODE_16668_length_702_cov_13.908789	289	357	2	1	68	0.0147059
NODE_16668_length_702_cov_13.908789	289	357	4	12	68	0.1764706
NODE_16668_length_702_cov_13.908789	289	357	6	50	68	0.7352941
NODE_16669_length_702_cov_8.502488	337	417	0	80	80	1.0000000
NODE_16669_length_702_cov_8.502488	390	470	0	80	80	1.0000000
NODE_16671_length_702_cov_6.470978	209	289	0	80	80	1.0000000
NODE_16671_length_702_cov_6.470978	262	342	0	80	80	1.0000000
NODE_16729_length_701_cov_38.715947	178	258	2	10	80	0.1250000
NODE_16729_length_701_cov_38.715947	178	258	4	20	80	0.2500000
NODE_16729_length_701_cov_38.715947	178	258	6	41	80	0.5125000
NODE_16729_length_701_cov_38.715947	178	258	7	9	80	0.1125000
NODE_16729_length_701_cov_38.715947	231	311	5	3	80	0.0375000
NODE_16729_length_701_cov_38.715947	231	311	6	18	80	0.2250000
NODE_16729_length_701_cov_38.715947	231	311	7	9	80	0.1125000
NODE_16729_length_701_cov_38.715947	231	311	9	50	80	0.6250000
NODE_16729_length_701_cov_38.715947	307	387	1	30	80	0.3750000
NODE_16729_length_701_cov_38.715947	307	387	3	11	80	0.1375000
NODE_16729_length_701_cov_38.715947	307	387	7	34	80	0.4250000
NODE_16729_length_701_cov_38.715947	307	387	9	5	80	0.0625000
NODE_16729_length_701_cov_38.715947	360	440	1	40	80	0.5000000
NODE_16729_length_701_cov_38.715947	360	440	2	6	80	0.0750000
NODE_16729_length_701_cov_38.715947	360	440	3	34	80	0.4250000
NODE_16730_length_701_cov_28.059801	432	513	0	32	81	0.3950617
NODE_16730_length_701_cov_28.059801	432	513	2	49	81	0.6049383
NODE_16730_length_701_cov_28.059801	486	566	2	80	80	1.0000000
NODE_16731_length_701_cov_18.387043	258	338	4	80	80	1.0000000
NODE_16731_length_701_cov_18.387043	311	391	4	80	80	1.0000000
NODE_16732_length_701_cov_17.122924	295	367	8	7	72	0.0972222
NODE_16732_length_701_cov_17.122924	295	367	10	19	72	0.2638889
NODE_16732_length_701_cov_17.122924	295	367	12	8	72	0.1111111
NODE_16732_length_701_cov_17.122924	295	367	14	1	72	0.0138889
NODE_16732_length_701_cov_17.122924	295	367	16	37	72	0.5138889
NODE_16733_length_701_cov_16.114618	242	322	0	59	80	0.7375000
NODE_16733_length_701_cov_16.114618	242	322	2	21	80	0.2625000
NODE_16733_length_701_cov_16.114618	295	375	0	6	80	0.0750000
NODE_16733_length_701_cov_16.114618	295	375	2	74	80	0.9250000
NODE_16734_length_701_cov_15.588040	399	479	0	25	80	0.3125000
NODE_16734_length_701_cov_15.588040	399	479	2	35	80	0.4375000
NODE_16734_length_701_cov_15.588040	399	479	4	20	80	0.2500000
NODE_16734_length_701_cov_15.588040	452	532	0	1	80	0.0125000
NODE_16734_length_701_cov_15.588040	452	532	2	18	80	0.2250000
NODE_16734_length_701_cov_15.588040	452	532	4	61	80	0.7625000
NODE_16736_length_701_cov_11.420266	229	309	0	80	80	1.0000000
NODE_16736_length_701_cov_11.420266	282	362	0	80	80	1.0000000
NODE_16737_length_701_cov_10.411960	202	283	0	81	81	1.0000000
NODE_16737_length_701_cov_10.411960	256	336	0	80	80	1.0000000
NODE_16738_length_701_cov_9.107973	400	480	0	80	80	1.0000000
NODE_16738_length_701_cov_9.107973	453	533	0	80	80	1.0000000
NODE_16739_length_701_cov_8.877076	283	363	0	80	80	1.0000000
NODE_16739_length_701_cov_8.877076	336	416	0	80	80	1.0000000
NODE_16740_length_701_cov_8.543189	341	421	0	80	80	1.0000000
NODE_16740_length_701_cov_8.543189	394	474	0	80	80	1.0000000
NODE_16742_length_701_cov_6.317276	273	353	2	39	80	0.4875000
NODE_16742_length_701_cov_6.317276	273	353	4	41	80	0.5125000
NODE_16742_length_701_cov_6.317276	326	382	2	16	56	0.2857143
NODE_16742_length_701_cov_6.317276	326	382	4	40	56	0.7142857
NODE_16747_length_701_cov_5.081395	318	374	10	20	56	0.3571429
NODE_16747_length_701_cov_5.081395	318	374	12	36	56	0.6428571
NODE_16752_length_701_cov_3.320598	207	287	0	80	80	1.0000000
NODE_16752_length_701_cov_3.320598	260	340	0	80	80	1.0000000
NODE_16794_length_700_cov_22.241265	326	406	10	13	80	0.1625000
NODE_16794_length_700_cov_22.241265	326	406	12	11	80	0.1375000
NODE_16794_length_700_cov_22.241265	326	406	13	11	80	0.1375000
NODE_16794_length_700_cov_22.241265	326	406	15	2	80	0.0250000
NODE_16794_length_700_cov_22.241265	326	406	17	8	80	0.1000000
NODE_16794_length_700_cov_22.241265	326	406	19	2	80	0.0250000
NODE_16794_length_700_cov_22.241265	326	406	21	4	80	0.0500000
NODE_16794_length_700_cov_22.241265	326	406	22	6	80	0.0750000
NODE_16794_length_700_cov_22.241265	326	406	24	10	80	0.1250000
NODE_16794_length_700_cov_22.241265	326	406	26	2	80	0.0250000
NODE_16794_length_700_cov_22.241265	326	406	30	11	80	0.1375000
NODE_16796_length_700_cov_11.730449	294	374	0	80	80	1.0000000
NODE_16796_length_700_cov_11.730449	347	427	0	60	80	0.7500000
NODE_16796_length_700_cov_11.730449	347	427	2	20	80	0.2500000
NODE_16800_length_700_cov_7.291181	317	397	0	1	80	0.0125000
NODE_16800_length_700_cov_7.291181	317	397	2	79	80	0.9875000
NODE_16800_length_700_cov_7.291181	370	450	0	35	80	0.4375000
NODE_16800_length_700_cov_7.291181	370	450	2	45	80	0.5625000
NODE_16801_length_700_cov_6.557404	353	404	0	14	51	0.2745098
NODE_16801_length_700_cov_6.557404	353	404	4	37	51	0.7254902
NODE_16802_length_700_cov_5.475874	301	381	0	80	80	1.0000000
NODE_16802_length_700_cov_5.475874	354	434	0	80	80	1.0000000
NODE_16803_length_700_cov_3.960067	158	234	0	76	76	1.0000000
NODE_16803_length_700_cov_3.960067	209	291	0	62	82	0.7560976
NODE_16803_length_700_cov_3.960067	209	291	2	20	82	0.2439024
NODE_16822_length_700_cov_1.517471	324	404	0	80	80	1.0000000
NODE_16822_length_700_cov_1.517471	377	457	0	80	80	1.0000000
NODE_16844_length_699_cov_18.446667	185	265	0	59	80	0.7375000
NODE_16844_length_699_cov_18.446667	185	265	2	21	80	0.2625000
NODE_16844_length_699_cov_18.446667	238	318	0	80	80	1.0000000
NODE_16845_length_699_cov_18.383333	258	338	2	40	80	0.5000000
NODE_16845_length_699_cov_18.383333	258	338	4	40	80	0.5000000
NODE_16845_length_699_cov_18.383333	311	391	0	13	80	0.1625000
NODE_16845_length_699_cov_18.383333	311	391	2	45	80	0.5625000
NODE_16845_length_699_cov_18.383333	311	391	4	22	80	0.2750000
NODE_16846_length_699_cov_18.103333	218	298	0	80	80	1.0000000
NODE_16846_length_699_cov_18.103333	271	351	0	80	80	1.0000000
NODE_16847_length_699_cov_15.636667	279	359	0	80	80	1.0000000
NODE_16847_length_699_cov_15.636667	332	412	0	80	80	1.0000000
NODE_16848_length_699_cov_15.113333	313	393	0	80	80	1.0000000
NODE_16848_length_699_cov_15.113333	366	446	0	80	80	1.0000000
NODE_16849_length_699_cov_10.070000	233	313	0	80	80	1.0000000
NODE_16849_length_699_cov_10.070000	286	366	0	80	80	1.0000000
NODE_16849_length_699_cov_10.070000	362	442	0	80	80	1.0000000
NODE_16849_length_699_cov_10.070000	415	495	0	80	80	1.0000000
NODE_16850_length_699_cov_8.083333	347	427	0	80	80	1.0000000
NODE_16850_length_699_cov_8.083333	400	480	0	80	80	1.0000000
NODE_16851_length_699_cov_7.758333	307	387	0	47	80	0.5875000
NODE_16851_length_699_cov_7.758333	307	387	2	33	80	0.4125000
NODE_16851_length_699_cov_7.758333	360	440	0	80	80	1.0000000
NODE_16852_length_699_cov_7.713333	252	332	0	49	80	0.6125000
NODE_16852_length_699_cov_7.713333	252	332	2	31	80	0.3875000
NODE_16852_length_699_cov_7.713333	305	385	2	72	80	0.9000000
NODE_16852_length_699_cov_7.713333	305	385	4	8	80	0.1000000
NODE_16853_length_699_cov_7.186667	271	332	0	6	61	0.0983607
NODE_16853_length_699_cov_7.186667	271	332	4	41	61	0.6721311
NODE_16853_length_699_cov_7.186667	271	332	6	2	61	0.0327869
NODE_16853_length_699_cov_7.186667	271	332	8	12	61	0.1967213
NODE_16853_length_699_cov_7.186667	348	428	4	28	80	0.3500000
NODE_16853_length_699_cov_7.186667	348	428	6	18	80	0.2250000
NODE_16853_length_699_cov_7.186667	348	428	8	34	80	0.4250000
NODE_16857_length_699_cov_5.815000	243	316	2	60	73	0.8219178
NODE_16857_length_699_cov_5.815000	243	316	4	13	73	0.1780822
NODE_16857_length_699_cov_5.815000	293	374	2	79	81	0.9753087
NODE_16857_length_699_cov_5.815000	293	374	6	2	81	0.0246914
NODE_16858_length_699_cov_5.520000	302	382	0	80	80	1.0000000
NODE_16858_length_699_cov_5.520000	355	435	0	80	80	1.0000000
NODE_16860_length_699_cov_4.051667	289	369	0	69	80	0.8625000
NODE_16860_length_699_cov_4.051667	289	369	2	11	80	0.1375000
NODE_16860_length_699_cov_4.051667	342	422	0	16	80	0.2000000
NODE_16860_length_699_cov_4.051667	342	422	2	41	80	0.5125000
NODE_16860_length_699_cov_4.051667	342	422	4	23	80	0.2875000
NODE_16868_length_699_cov_2.498333	204	284	0	80	80	1.0000000
NODE_16868_length_699_cov_2.498333	257	337	0	74	80	0.9250000
NODE_16868_length_699_cov_2.498333	257	337	4	1	80	0.0125000
NODE_16868_length_699_cov_2.498333	257	337	6	5	80	0.0625000
NODE_16908_length_698_cov_47.350584	321	401	21	2	80	0.0250000
NODE_16908_length_698_cov_47.350584	321	401	22	32	80	0.4000000
NODE_16908_length_698_cov_47.350584	321	401	23	8	80	0.1000000
NODE_16908_length_698_cov_47.350584	321	401	24	38	80	0.4750000
NODE_16908_length_698_cov_47.350584	374	454	0	18	80	0.2250000
NODE_16908_length_698_cov_47.350584	374	454	11	11	80	0.1375000
NODE_16908_length_698_cov_47.350584	374	454	22	41	80	0.5125000
NODE_16908_length_698_cov_47.350584	374	454	24	10	80	0.1250000
NODE_16909_length_698_cov_42.848080	255	335	0	80	80	1.0000000
NODE_16909_length_698_cov_42.848080	308	388	0	80	80	1.0000000
NODE_16910_length_698_cov_36.697830	366	446	0	4	80	0.0500000
NODE_16910_length_698_cov_36.697830	366	446	2	8	80	0.1000000
NODE_16910_length_698_cov_36.697830	366	446	4	68	80	0.8500000
NODE_16910_length_698_cov_36.697830	419	484	2	26	65	0.4000000
NODE_16910_length_698_cov_36.697830	419	484	4	39	65	0.6000000
NODE_16911_length_698_cov_23.874791	222	302	0	29	80	0.3625000
NODE_16911_length_698_cov_23.874791	222	302	4	51	80	0.6375000
NODE_16911_length_698_cov_23.874791	275	355	0	2	80	0.0250000
NODE_16911_length_698_cov_23.874791	275	355	4	78	80	0.9750000
NODE_16912_length_698_cov_7.133556	360	440	0	80	80	1.0000000
NODE_16912_length_698_cov_7.133556	413	493	0	80	80	1.0000000
NODE_16913_length_698_cov_6.520868	267	347	0	5	80	0.0625000
NODE_16913_length_698_cov_6.520868	267	347	6	58	80	0.7250000
NODE_16913_length_698_cov_6.520868	267	347	7	17	80	0.2125000
NODE_16913_length_698_cov_6.520868	320	400	6	10	80	0.1250000
NODE_16913_length_698_cov_6.520868	320	400	7	17	80	0.2125000
NODE_16913_length_698_cov_6.520868	320	400	8	53	80	0.6625000
NODE_16917_length_698_cov_4.762938	329	359	0	8	30	0.2666667
NODE_16917_length_698_cov_4.762938	329	359	2	11	30	0.3666667
NODE_16917_length_698_cov_4.762938	329	359	4	11	30	0.3666667
NODE_16926_length_698_cov_2.577629	309	389	0	80	80	1.0000000
NODE_16926_length_698_cov_2.577629	362	442	0	80	80	1.0000000
NODE_16962_length_697_cov_16.013378	305	385	0	80	80	1.0000000
NODE_16962_length_697_cov_16.013378	358	438	0	80	80	1.0000000
NODE_16963_length_697_cov_14.411371	440	520	4	31	80	0.3875000
NODE_16963_length_697_cov_14.411371	440	520	5	1	80	0.0125000
NODE_16963_length_697_cov_14.411371	440	520	6	48	80	0.6000000
NODE_16963_length_697_cov_14.411371	493	573	2	38	80	0.4750000
NODE_16963_length_697_cov_14.411371	493	573	4	10	80	0.1250000
NODE_16963_length_697_cov_14.411371	493	573	6	32	80	0.4000000
NODE_16964_length_697_cov_14.282609	257	354	0	97	97	1.0000000
NODE_16964_length_697_cov_14.282609	327	385	0	58	58	1.0000000
NODE_16965_length_697_cov_9.969900	360	440	0	78	80	0.9750000
NODE_16965_length_697_cov_9.969900	360	440	2	2	80	0.0250000
NODE_16965_length_697_cov_9.969900	413	493	0	80	80	1.0000000
NODE_16968_length_697_cov_6.117057	236	316	0	12	80	0.1500000
NODE_16968_length_697_cov_6.117057	236	316	2	68	80	0.8500000
NODE_16968_length_697_cov_6.117057	289	369	2	80	80	1.0000000
NODE_17025_length_696_cov_28.360134	319	399	0	13	80	0.1625000
NODE_17025_length_696_cov_28.360134	319	399	2	67	80	0.8375000
NODE_17025_length_696_cov_28.360134	372	452	0	19	80	0.2375000
NODE_17025_length_696_cov_28.360134	372	452	2	61	80	0.7625000
NODE_17026_length_696_cov_18.708543	367	447	0	26	80	0.3250000
NODE_17026_length_696_cov_18.708543	367	447	2	54	80	0.6750000
NODE_17026_length_696_cov_18.708543	420	500	2	80	80	1.0000000
NODE_17027_length_696_cov_18.170854	390	470	2	80	80	1.0000000
NODE_17027_length_696_cov_18.170854	443	523	0	40	80	0.5000000
NODE_17027_length_696_cov_18.170854	443	523	2	40	80	0.5000000
NODE_17028_length_696_cov_13.738693	266	346	0	80	80	1.0000000
NODE_17028_length_696_cov_13.738693	319	399	0	80	80	1.0000000
NODE_17030_length_696_cov_10.693467	239	266	0	11	27	0.4074074
NODE_17030_length_696_cov_10.693467	239	266	2	16	27	0.5925926
NODE_17031_length_696_cov_9.949749	248	328	0	80	80	1.0000000
NODE_17031_length_696_cov_9.949749	301	381	0	80	80	1.0000000
NODE_17032_length_696_cov_8.658291	247	327	2	80	80	1.0000000
NODE_17032_length_696_cov_8.658291	300	380	0	53	80	0.6625000
NODE_17032_length_696_cov_8.658291	300	380	2	27	80	0.3375000
NODE_17032_length_696_cov_8.658291	376	456	0	80	80	1.0000000
NODE_17032_length_696_cov_8.658291	429	509	0	80	80	1.0000000
NODE_17068_length_696_cov_1.675042	498	543	0	45	45	1.0000000
NODE_17100_length_695_cov_24.112416	388	468	2	20	80	0.2500000
NODE_17100_length_695_cov_24.112416	388	468	4	60	80	0.7500000
NODE_17100_length_695_cov_24.112416	441	521	0	22	80	0.2750000
NODE_17100_length_695_cov_24.112416	441	521	2	50	80	0.6250000
NODE_17100_length_695_cov_24.112416	441	521	4	8	80	0.1000000
NODE_17101_length_695_cov_12.152685	349	429	0	8	80	0.1000000
NODE_17101_length_695_cov_12.152685	349	429	1	1	80	0.0125000
NODE_17101_length_695_cov_12.152685	349	429	4	9	80	0.1125000
NODE_17101_length_695_cov_12.152685	349	429	5	52	80	0.6500000
NODE_17101_length_695_cov_12.152685	349	429	6	10	80	0.1250000
NODE_17101_length_695_cov_12.152685	402	482	2	28	80	0.3500000
NODE_17101_length_695_cov_12.152685	402	482	5	17	80	0.2125000
NODE_17101_length_695_cov_12.152685	402	482	6	35	80	0.4375000
NODE_17103_length_695_cov_8.466443	345	425	0	16	80	0.2000000
NODE_17103_length_695_cov_8.466443	345	425	3	1	80	0.0125000
NODE_17103_length_695_cov_8.466443	345	425	4	63	80	0.7875000
NODE_17103_length_695_cov_8.466443	398	478	0	21	80	0.2625000
NODE_17103_length_695_cov_8.466443	398	478	3	29	80	0.3625000
NODE_17103_length_695_cov_8.466443	398	478	4	30	80	0.3750000
NODE_17106_length_695_cov_5.661074	283	363	0	80	80	1.0000000
NODE_17106_length_695_cov_5.661074	346	416	0	70	70	1.0000000
NODE_17124_length_695_cov_2.050336	36	112	0	76	76	1.0000000
NODE_17161_length_694_cov_46.675630	30	110	0	80	80	1.0000000
NODE_17161_length_694_cov_46.675630	83	163	0	80	80	1.0000000
NODE_17161_length_694_cov_46.675630	159	239	0	80	80	1.0000000
NODE_17161_length_694_cov_46.675630	212	292	0	80	80	1.0000000
NODE_17162_length_694_cov_12.850420	326	406	2	11	80	0.1375000
NODE_17162_length_694_cov_12.850420	326	406	8	18	80	0.2250000
NODE_17162_length_694_cov_12.850420	326	406	10	51	80	0.6375000
NODE_17162_length_694_cov_12.850420	379	459	0	52	80	0.6500000
NODE_17162_length_694_cov_12.850420	379	459	8	19	80	0.2375000
NODE_17162_length_694_cov_12.850420	379	459	10	9	80	0.1125000
NODE_17163_length_694_cov_7.236975	318	396	4	51	78	0.6538461
NODE_17163_length_694_cov_7.236975	318	396	6	27	78	0.3461539
NODE_17163_length_694_cov_7.236975	371	450	2	27	79	0.3417721
NODE_17163_length_694_cov_7.236975	371	450	4	52	79	0.6582279
NODE_17166_length_694_cov_5.554622	404	484	0	80	80	1.0000000
NODE_17166_length_694_cov_5.554622	457	537	0	80	80	1.0000000
NODE_17168_length_694_cov_5.373109	152	232	0	22	80	0.2750000
NODE_17168_length_694_cov_5.373109	152	232	2	58	80	0.7250000
NODE_17168_length_694_cov_5.373109	205	285	0	23	80	0.2875000
NODE_17168_length_694_cov_5.373109	205	285	2	57	80	0.7125000
NODE_17227_length_693_cov_26.616162	435	515	0	80	80	1.0000000
NODE_17227_length_693_cov_26.616162	488	568	0	80	80	1.0000000
NODE_17228_length_693_cov_23.552189	193	273	2	20	80	0.2500000
NODE_17228_length_693_cov_23.552189	193	273	4	60	80	0.7500000
NODE_17228_length_693_cov_23.552189	246	326	0	36	80	0.4500000
NODE_17228_length_693_cov_23.552189	246	326	2	20	80	0.2500000
NODE_17228_length_693_cov_23.552189	246	326	4	24	80	0.3000000
NODE_17229_length_693_cov_22.848485	231	311	2	11	80	0.1375000
NODE_17229_length_693_cov_22.848485	231	311	4	61	80	0.7625000
NODE_17229_length_693_cov_22.848485	231	311	6	8	80	0.1000000
NODE_17229_length_693_cov_22.848485	284	364	2	18	80	0.2250000
NODE_17229_length_693_cov_22.848485	284	364	4	23	80	0.2875000
NODE_17229_length_693_cov_22.848485	284	364	6	39	80	0.4875000
NODE_17230_length_693_cov_13.616162	219	299	2	6	80	0.0750000
NODE_17230_length_693_cov_13.616162	219	299	6	74	80	0.9250000
NODE_17230_length_693_cov_13.616162	272	352	2	8	80	0.1000000
NODE_17230_length_693_cov_13.616162	272	352	6	50	80	0.6250000
NODE_17230_length_693_cov_13.616162	272	352	10	16	80	0.2000000
NODE_17230_length_693_cov_13.616162	272	352	12	6	80	0.0750000
NODE_17231_length_693_cov_12.382155	305	385	0	4	80	0.0500000
NODE_17231_length_693_cov_12.382155	305	385	2	24	80	0.3000000
NODE_17231_length_693_cov_12.382155	305	385	4	52	80	0.6500000
NODE_17231_length_693_cov_12.382155	358	424	4	66	66	1.0000000
NODE_17232_length_693_cov_10.053872	279	359	0	4	80	0.0500000
NODE_17232_length_693_cov_10.053872	279	359	4	28	80	0.3500000
NODE_17232_length_693_cov_10.053872	279	359	6	22	80	0.2750000
NODE_17232_length_693_cov_10.053872	279	359	8	26	80	0.3250000
NODE_17232_length_693_cov_10.053872	332	412	2	17	80	0.2125000
NODE_17232_length_693_cov_10.053872	332	412	4	36	80	0.4500000
NODE_17232_length_693_cov_10.053872	332	412	6	1	80	0.0125000
NODE_17232_length_693_cov_10.053872	332	412	8	26	80	0.3250000
NODE_17233_length_693_cov_9.659933	247	327	0	65	80	0.8125000
NODE_17233_length_693_cov_9.659933	247	327	2	12	80	0.1500000
NODE_17233_length_693_cov_9.659933	247	327	4	3	80	0.0375000
NODE_17233_length_693_cov_9.659933	300	380	0	12	80	0.1500000
NODE_17233_length_693_cov_9.659933	300	380	2	12	80	0.1500000
NODE_17233_length_693_cov_9.659933	300	380	4	56	80	0.7000000
NODE_17235_length_693_cov_8.077441	343	423	0	17	80	0.2125000
NODE_17235_length_693_cov_8.077441	343	423	2	63	80	0.7875000
NODE_17235_length_693_cov_8.077441	396	476	0	68	80	0.8500000
NODE_17235_length_693_cov_8.077441	396	476	2	12	80	0.1500000
NODE_17243_length_693_cov_3.680135	250	321	0	11	71	0.1549296
NODE_17243_length_693_cov_3.680135	250	321	2	29	71	0.4084507
NODE_17243_length_693_cov_3.680135	250	321	4	31	71	0.4366197
NODE_17280_length_692_cov_33.416526	462	542	4	14	80	0.1750000
NODE_17280_length_692_cov_33.416526	462	542	6	7	80	0.0875000
NODE_17280_length_692_cov_33.416526	462	542	8	6	80	0.0750000
NODE_17280_length_692_cov_33.416526	462	542	10	18	80	0.2250000
NODE_17280_length_692_cov_33.416526	462	542	12	35	80	0.4375000
NODE_17280_length_692_cov_33.416526	515	595	0	19	80	0.2375000
NODE_17280_length_692_cov_33.416526	515	595	6	19	80	0.2375000
NODE_17280_length_692_cov_33.416526	515	595	10	33	80	0.4125000
NODE_17280_length_692_cov_33.416526	515	595	12	9	80	0.1125000
NODE_17281_length_692_cov_17.559865	291	371	2	80	80	1.0000000
NODE_17282_length_692_cov_15.070826	304	375	0	22	71	0.3098592
NODE_17282_length_692_cov_15.070826	304	375	4	49	71	0.6901408
NODE_17283_length_692_cov_13.279933	308	388	0	5	80	0.0625000
NODE_17283_length_692_cov_13.279933	308	388	2	23	80	0.2875000
NODE_17283_length_692_cov_13.279933	308	388	4	52	80	0.6500000
NODE_17283_length_692_cov_13.279933	361	441	2	50	80	0.6250000
NODE_17283_length_692_cov_13.279933	361	441	4	30	80	0.3750000
NODE_17285_length_692_cov_10.750422	317	397	0	80	80	1.0000000
NODE_17287_length_692_cov_7.497470	175	255	0	80	80	1.0000000
NODE_17287_length_692_cov_7.497470	228	312	0	84	84	1.0000000
NODE_17289_length_692_cov_7.370995	235	315	8	21	80	0.2625000
NODE_17289_length_692_cov_7.370995	235	315	11	1	80	0.0125000
NODE_17289_length_692_cov_7.370995	235	315	12	58	80	0.7250000
NODE_17289_length_692_cov_7.370995	288	369	0	6	81	0.0740741
NODE_17289_length_692_cov_7.370995	288	369	2	46	81	0.5679013
NODE_17289_length_692_cov_7.370995	288	369	7	1	81	0.0123457
NODE_17289_length_692_cov_7.370995	288	369	8	22	81	0.2716049
NODE_17289_length_692_cov_7.370995	288	369	11	1	81	0.0123457
NODE_17289_length_692_cov_7.370995	288	369	12	5	81	0.0617284
NODE_17328_length_692_cov_1.514334	404	484	2	21	80	0.2625000
NODE_17328_length_692_cov_1.514334	404	484	6	1	80	0.0125000
NODE_17328_length_692_cov_1.514334	404	484	10	30	80	0.3750000
NODE_17328_length_692_cov_1.514334	404	484	12	18	80	0.2250000
NODE_17328_length_692_cov_1.514334	404	484	14	10	80	0.1250000
NODE_17350_length_691_cov_115.233108	276	356	6	3	80	0.0375000
NODE_17350_length_691_cov_115.233108	276	356	8	4	80	0.0500000
NODE_17350_length_691_cov_115.233108	276	356	16	16	80	0.2000000
NODE_17350_length_691_cov_115.233108	276	356	18	25	80	0.3125000
NODE_17350_length_691_cov_115.233108	276	356	20	8	80	0.1000000
NODE_17350_length_691_cov_115.233108	276	356	22	24	80	0.3000000
NODE_17350_length_691_cov_115.233108	329	409	12	27	80	0.3375000
NODE_17350_length_691_cov_115.233108	329	409	14	17	80	0.2125000
NODE_17350_length_691_cov_115.233108	329	409	16	25	80	0.3125000
NODE_17350_length_691_cov_115.233108	329	409	18	11	80	0.1375000
NODE_17350_length_691_cov_115.233108	405	485	0	6	80	0.0750000
NODE_17350_length_691_cov_115.233108	405	485	2	6	80	0.0750000
NODE_17350_length_691_cov_115.233108	405	485	6	2	80	0.0250000
NODE_17350_length_691_cov_115.233108	405	485	8	10	80	0.1250000
NODE_17350_length_691_cov_115.233108	405	485	10	10	80	0.1250000
NODE_17350_length_691_cov_115.233108	405	485	12	12	80	0.1500000
NODE_17350_length_691_cov_115.233108	405	485	14	4	80	0.0500000
NODE_17350_length_691_cov_115.233108	405	485	16	2	80	0.0250000
NODE_17350_length_691_cov_115.233108	405	485	18	1	80	0.0125000
NODE_17350_length_691_cov_115.233108	405	485	20	1	80	0.0125000
NODE_17350_length_691_cov_115.233108	405	485	22	1	80	0.0125000
NODE_17350_length_691_cov_115.233108	405	485	24	3	80	0.0375000
NODE_17350_length_691_cov_115.233108	405	485	25	1	80	0.0125000
NODE_17350_length_691_cov_115.233108	405	485	28	1	80	0.0125000
NODE_17350_length_691_cov_115.233108	405	485	30	5	80	0.0625000
NODE_17350_length_691_cov_115.233108	405	485	36	3	80	0.0375000
NODE_17350_length_691_cov_115.233108	405	485	40	7	80	0.0875000
NODE_17350_length_691_cov_115.233108	405	485	44	5	80	0.0625000
NODE_17350_length_691_cov_115.233108	458	538	20	1	80	0.0125000
NODE_17350_length_691_cov_115.233108	458	538	22	1	80	0.0125000
NODE_17350_length_691_cov_115.233108	458	538	24	3	80	0.0375000
NODE_17350_length_691_cov_115.233108	458	538	25	1	80	0.0125000
NODE_17350_length_691_cov_115.233108	458	538	28	1	80	0.0125000
NODE_17350_length_691_cov_115.233108	458	538	30	5	80	0.0625000
NODE_17350_length_691_cov_115.233108	458	538	36	3	80	0.0375000
NODE_17350_length_691_cov_115.233108	458	538	40	7	80	0.0875000
NODE_17350_length_691_cov_115.233108	458	538	44	12	80	0.1500000
NODE_17350_length_691_cov_115.233108	458	538	48	2	80	0.0250000
NODE_17350_length_691_cov_115.233108	458	538	50	4	80	0.0500000
NODE_17350_length_691_cov_115.233108	458	538	52	3	80	0.0375000
NODE_17350_length_691_cov_115.233108	458	538	53	1	80	0.0125000
NODE_17350_length_691_cov_115.233108	458	538	54	22	80	0.2750000
NODE_17350_length_691_cov_115.233108	458	538	57	3	80	0.0375000
NODE_17350_length_691_cov_115.233108	458	538	59	1	80	0.0125000
NODE_17350_length_691_cov_115.233108	458	538	60	6	80	0.0750000
NODE_17350_length_691_cov_115.233108	458	538	62	2	80	0.0250000
NODE_17350_length_691_cov_115.233108	458	538	64	1	80	0.0125000
NODE_17350_length_691_cov_115.233108	458	538	65	1	80	0.0125000
NODE_17351_length_691_cov_26.076014	188	268	0	21	80	0.2625000
NODE_17351_length_691_cov_26.076014	188	268	4	59	80	0.7375000
NODE_17351_length_691_cov_26.076014	241	321	0	1	80	0.0125000
NODE_17351_length_691_cov_26.076014	241	321	4	79	80	0.9875000
NODE_17352_length_691_cov_21.991554	288	368	0	80	80	1.0000000
NODE_17352_length_691_cov_21.991554	341	419	0	78	78	1.0000000
NODE_17353_length_691_cov_14.908784	226	306	0	18	80	0.2250000
NODE_17353_length_691_cov_14.908784	226	306	2	6	80	0.0750000
NODE_17353_length_691_cov_14.908784	226	306	4	56	80	0.7000000
NODE_17353_length_691_cov_14.908784	279	359	2	21	80	0.2625000
NODE_17353_length_691_cov_14.908784	279	359	4	59	80	0.7375000
NODE_17358_length_691_cov_5.670608	325	402	0	77	77	1.0000000
NODE_17358_length_691_cov_5.670608	375	455	0	80	80	1.0000000
NODE_17361_length_691_cov_4.866554	103	183	0	80	80	1.0000000
NODE_17361_length_691_cov_4.866554	156	236	0	80	80	1.0000000
NODE_17367_length_691_cov_3.388514	304	384	0	14	80	0.1750000
NODE_17367_length_691_cov_3.388514	304	384	4	66	80	0.8250000
NODE_17367_length_691_cov_3.388514	357	437	0	67	80	0.8375000
NODE_17367_length_691_cov_3.388514	357	437	4	13	80	0.1625000
NODE_17415_length_690_cov_39.538071	563	612	0	49	49	1.0000000
NODE_17415_length_690_cov_39.538071	598	678	0	80	80	1.0000000
NODE_17415_length_690_cov_39.538071	651	690	0	39	39	1.0000000
NODE_17417_length_690_cov_30.336717	319	394	2	38	75	0.5066667
NODE_17417_length_690_cov_30.336717	319	394	3	37	75	0.4933333
NODE_17417_length_690_cov_30.336717	372	453	1	23	81	0.2839506
NODE_17417_length_690_cov_30.336717	372	453	3	58	81	0.7160494
NODE_17417_length_690_cov_30.336717	449	529	0	22	80	0.2750000
NODE_17417_length_690_cov_30.336717	449	529	1	58	80	0.7250000
NODE_17417_length_690_cov_30.336717	502	582	0	75	80	0.9375000
NODE_17417_length_690_cov_30.336717	502	582	1	5	80	0.0625000
NODE_17418_length_690_cov_26.888325	270	350	2	80	80	1.0000000
NODE_17418_length_690_cov_26.888325	323	403	0	33	80	0.4125000
NODE_17418_length_690_cov_26.888325	323	403	2	47	80	0.5875000
NODE_17419_length_690_cov_23.360406	131	211	0	26	80	0.3250000
NODE_17419_length_690_cov_23.360406	131	211	2	54	80	0.6750000
NODE_17419_length_690_cov_23.360406	188	264	2	49	76	0.6447368
NODE_17419_length_690_cov_23.360406	188	264	4	27	76	0.3552631
NODE_17420_length_690_cov_18.737733	316	396	0	35	80	0.4375000
NODE_17420_length_690_cov_18.737733	316	396	2	7	80	0.0875000
NODE_17420_length_690_cov_18.737733	316	396	4	15	80	0.1875000
NODE_17420_length_690_cov_18.737733	316	396	6	6	80	0.0750000
NODE_17420_length_690_cov_18.737733	316	396	8	17	80	0.2125000
NODE_17420_length_690_cov_18.737733	369	449	4	4	80	0.0500000
NODE_17420_length_690_cov_18.737733	369	449	6	6	80	0.0750000
NODE_17420_length_690_cov_18.737733	369	449	8	70	80	0.8750000
NODE_17421_length_690_cov_16.593909	364	444	0	55	80	0.6875000
NODE_17421_length_690_cov_16.593909	364	444	2	25	80	0.3125000
NODE_17421_length_690_cov_16.593909	417	497	0	80	80	1.0000000
NODE_17422_length_690_cov_12.896785	320	400	0	21	80	0.2625000
NODE_17422_length_690_cov_12.896785	320	400	2	59	80	0.7375000
NODE_17422_length_690_cov_12.896785	373	453	0	74	80	0.9250000
NODE_17422_length_690_cov_12.896785	373	453	2	6	80	0.0750000
NODE_17423_length_690_cov_10.818951	349	429	0	3	80	0.0375000
NODE_17423_length_690_cov_10.818951	349	429	2	77	80	0.9625000
NODE_17424_length_690_cov_7.015228	273	353	0	4	80	0.0500000
NODE_17424_length_690_cov_7.015228	273	353	5	1	80	0.0125000
NODE_17424_length_690_cov_7.015228	273	353	6	11	80	0.1375000
NODE_17424_length_690_cov_7.015228	273	353	10	64	80	0.8000000
NODE_17424_length_690_cov_7.015228	326	406	0	39	80	0.4875000
NODE_17424_length_690_cov_7.015228	326	406	6	1	80	0.0125000
NODE_17424_length_690_cov_7.015228	326	406	10	40	80	0.5000000
NODE_17429_length_690_cov_4.793570	316	365	60	5	49	0.1020408
NODE_17429_length_690_cov_4.793570	316	365	62	2	49	0.0408163
NODE_17429_length_690_cov_4.793570	316	365	64	6	49	0.1224490
NODE_17429_length_690_cov_4.793570	316	365	66	3	49	0.0612245
NODE_17429_length_690_cov_4.793570	316	365	68	3	49	0.0612245
NODE_17429_length_690_cov_4.793570	316	365	70	1	49	0.0204082
NODE_17429_length_690_cov_4.793570	316	365	72	11	49	0.2244898
NODE_17429_length_690_cov_4.793570	316	365	74	4	49	0.0816327
NODE_17429_length_690_cov_4.793570	316	365	76	12	49	0.2448980
NODE_17429_length_690_cov_4.793570	316	365	78	2	49	0.0408163
NODE_17430_length_690_cov_4.717428	316	396	2	80	80	1.0000000
NODE_17430_length_690_cov_4.717428	369	449	0	52	80	0.6500000
NODE_17430_length_690_cov_4.717428	369	449	2	28	80	0.3500000
NODE_17484_length_689_cov_45.984746	244	322	0	78	78	1.0000000
NODE_17484_length_689_cov_45.984746	297	377	0	80	80	1.0000000
NODE_17485_length_689_cov_35.705085	436	516	0	17	80	0.2125000
NODE_17485_length_689_cov_35.705085	436	516	4	63	80	0.7875000
NODE_17485_length_689_cov_35.705085	489	569	0	34	80	0.4250000
NODE_17485_length_689_cov_35.705085	489	569	4	46	80	0.5750000
NODE_17486_length_689_cov_25.372881	211	291	0	80	80	1.0000000
NODE_17486_length_689_cov_25.372881	264	344	0	80	80	1.0000000
NODE_17487_length_689_cov_20.138983	319	399	2	55	80	0.6875000
NODE_17487_length_689_cov_20.138983	319	399	4	25	80	0.3125000
NODE_17487_length_689_cov_20.138983	372	452	0	11	80	0.1375000
NODE_17487_length_689_cov_20.138983	372	452	2	69	80	0.8625000
NODE_17488_length_689_cov_14.377966	351	431	6	24	80	0.3000000
NODE_17488_length_689_cov_14.377966	351	431	8	56	80	0.7000000
NODE_17488_length_689_cov_14.377966	404	484	0	23	80	0.2875000
NODE_17488_length_689_cov_14.377966	404	484	2	17	80	0.2125000
NODE_17488_length_689_cov_14.377966	404	484	6	5	80	0.0625000
NODE_17488_length_689_cov_14.377966	404	484	8	35	80	0.4375000
NODE_17489_length_689_cov_9.477966	201	281	4	29	80	0.3625000
NODE_17489_length_689_cov_9.477966	201	281	6	51	80	0.6375000
NODE_17489_length_689_cov_9.477966	254	334	0	5	80	0.0625000
NODE_17489_length_689_cov_9.477966	254	334	2	33	80	0.4125000
NODE_17489_length_689_cov_9.477966	254	334	6	42	80	0.5250000
NODE_17491_length_689_cov_7.367797	122	207	0	12	85	0.1411765
NODE_17491_length_689_cov_7.367797	122	207	2	15	85	0.1764706
NODE_17491_length_689_cov_7.367797	122	207	4	5	85	0.0588235
NODE_17491_length_689_cov_7.367797	122	207	8	53	85	0.6235294
NODE_17492_length_689_cov_6.649153	242	322	0	80	80	1.0000000
NODE_17492_length_689_cov_6.649153	295	375	0	80	80	1.0000000
NODE_17504_length_689_cov_2.788136	128	208	0	51	80	0.6375000
NODE_17504_length_689_cov_2.788136	128	208	2	29	80	0.3625000
NODE_17504_length_689_cov_2.788136	181	261	0	80	80	1.0000000
NODE_17548_length_688_cov_52.256367	198	278	0	72	80	0.9000000
NODE_17548_length_688_cov_52.256367	198	278	4	8	80	0.1000000
NODE_17548_length_688_cov_52.256367	251	331	0	19	80	0.2375000
NODE_17548_length_688_cov_52.256367	251	331	4	61	80	0.7625000
NODE_17549_length_688_cov_37.563667	373	453	2	18	80	0.2250000
NODE_17549_length_688_cov_37.563667	373	453	4	7	80	0.0875000
NODE_17549_length_688_cov_37.563667	373	453	6	3	80	0.0375000
NODE_17549_length_688_cov_37.563667	373	453	8	19	80	0.2375000
NODE_17549_length_688_cov_37.563667	373	453	10	33	80	0.4125000
NODE_17549_length_688_cov_37.563667	426	506	2	1	80	0.0125000
NODE_17549_length_688_cov_37.563667	426	506	3	6	80	0.0750000
NODE_17549_length_688_cov_37.563667	426	506	4	3	80	0.0375000
NODE_17549_length_688_cov_37.563667	426	506	5	15	80	0.1875000
NODE_17549_length_688_cov_37.563667	426	506	6	8	80	0.1000000
NODE_17549_length_688_cov_37.563667	426	506	8	14	80	0.1750000
NODE_17549_length_688_cov_37.563667	426	506	10	33	80	0.4125000
NODE_17549_length_688_cov_37.563667	514	594	4	16	80	0.2000000
NODE_17549_length_688_cov_37.563667	514	594	5	16	80	0.2000000
NODE_17549_length_688_cov_37.563667	514	594	6	1	80	0.0125000
NODE_17549_length_688_cov_37.563667	514	594	8	47	80	0.5875000
NODE_17549_length_688_cov_37.563667	514	594	4	16	80	0.2000000
NODE_17549_length_688_cov_37.563667	514	594	5	16	80	0.2000000
NODE_17549_length_688_cov_37.563667	514	594	6	1	80	0.0125000
NODE_17549_length_688_cov_37.563667	514	594	8	47	80	0.5875000
NODE_17549_length_688_cov_37.563667	514	584	4	6	70	0.0857143
NODE_17549_length_688_cov_37.563667	514	584	5	16	70	0.2285714
NODE_17549_length_688_cov_37.563667	514	584	6	1	70	0.0142857
NODE_17549_length_688_cov_37.563667	514	584	8	47	70	0.6714286
NODE_17549_length_688_cov_37.563667	567	647	0	6	80	0.0750000
NODE_17549_length_688_cov_37.563667	567	647	2	10	80	0.1250000
NODE_17549_length_688_cov_37.563667	567	647	4	53	80	0.6625000
NODE_17549_length_688_cov_37.563667	567	647	8	11	80	0.1375000
NODE_17549_length_688_cov_37.563667	567	646	0	5	79	0.0632911
NODE_17549_length_688_cov_37.563667	567	646	2	10	79	0.1265823
NODE_17549_length_688_cov_37.563667	567	646	4	53	79	0.6708861
NODE_17549_length_688_cov_37.563667	567	646	8	11	79	0.1392405
NODE_17550_length_688_cov_33.898132	373	453	2	8	80	0.1000000
NODE_17550_length_688_cov_33.898132	373	453	4	31	80	0.3875000
NODE_17550_length_688_cov_33.898132	373	453	6	4	80	0.0500000
NODE_17550_length_688_cov_33.898132	373	453	12	16	80	0.2000000
NODE_17550_length_688_cov_33.898132	373	453	14	21	80	0.2625000
NODE_17550_length_688_cov_33.898132	426	506	4	2	80	0.0250000
NODE_17550_length_688_cov_33.898132	426	506	10	32	80	0.4000000
NODE_17550_length_688_cov_33.898132	426	506	12	25	80	0.3125000
NODE_17550_length_688_cov_33.898132	426	506	14	21	80	0.2625000
NODE_17551_length_688_cov_26.769100	457	537	2	80	80	1.0000000
NODE_17551_length_688_cov_26.769100	510	590	0	49	80	0.6125000
NODE_17551_length_688_cov_26.769100	510	590	2	31	80	0.3875000
NODE_17552_length_688_cov_22.517827	332	412	0	64	80	0.8000000
NODE_17552_length_688_cov_22.517827	332	412	2	14	80	0.1750000
NODE_17552_length_688_cov_22.517827	332	412	4	2	80	0.0250000
NODE_17552_length_688_cov_22.517827	385	465	0	11	80	0.1375000
NODE_17552_length_688_cov_22.517827	385	465	2	14	80	0.1750000
NODE_17552_length_688_cov_22.517827	385	465	4	9	80	0.1125000
NODE_17552_length_688_cov_22.517827	385	465	6	46	80	0.5750000
NODE_17553_length_688_cov_16.796265	225	305	3	6	80	0.0750000
NODE_17553_length_688_cov_16.796265	225	305	4	37	80	0.4625000
NODE_17553_length_688_cov_16.796265	225	305	6	37	80	0.4625000
NODE_17553_length_688_cov_16.796265	278	358	0	40	80	0.5000000
NODE_17553_length_688_cov_16.796265	278	358	3	19	80	0.2375000
NODE_17553_length_688_cov_16.796265	278	358	4	21	80	0.2625000
NODE_17555_length_688_cov_13.758913	378	458	2	71	80	0.8875000
NODE_17555_length_688_cov_13.758913	378	458	4	9	80	0.1125000
NODE_17555_length_688_cov_13.758913	431	511	0	29	80	0.3625000
NODE_17555_length_688_cov_13.758913	431	511	2	51	80	0.6375000
NODE_17556_length_688_cov_12.511036	330	410	0	80	80	1.0000000
NODE_17556_length_688_cov_12.511036	383	463	0	80	80	1.0000000
NODE_17561_length_688_cov_5.446520	366	414	0	48	48	1.0000000
NODE_17567_length_688_cov_3.692699	265	345	0	4	80	0.0500000
NODE_17567_length_688_cov_3.692699	265	345	2	76	80	0.9500000
NODE_17567_length_688_cov_3.692699	322	380	2	58	58	1.0000000
NODE_17621_length_687_cov_50.214286	430	510	6	80	80	1.0000000
NODE_17621_length_687_cov_50.214286	483	563	0	25	80	0.3125000
NODE_17621_length_687_cov_50.214286	483	563	5	1	80	0.0125000
NODE_17621_length_687_cov_50.214286	483	563	6	54	80	0.6750000
NODE_17622_length_687_cov_32.564626	204	284	2	12	80	0.1500000
NODE_17622_length_687_cov_32.564626	204	284	4	1	80	0.0125000
NODE_17622_length_687_cov_32.564626	204	284	6	67	80	0.8375000
NODE_17622_length_687_cov_32.564626	257	337	2	41	80	0.5125000
NODE_17622_length_687_cov_32.564626	257	337	4	7	80	0.0875000
NODE_17622_length_687_cov_32.564626	257	337	6	32	80	0.4000000
NODE_17623_length_687_cov_22.365646	231	311	2	80	80	1.0000000
NODE_17623_length_687_cov_22.365646	284	364	0	26	80	0.3250000
NODE_17623_length_687_cov_22.365646	284	364	2	54	80	0.6750000
NODE_17626_length_687_cov_11.943878	233	313	0	80	80	1.0000000
NODE_17626_length_687_cov_11.943878	286	366	0	80	80	1.0000000
NODE_17627_length_687_cov_7.865646	311	391	0	56	80	0.7000000
NODE_17627_length_687_cov_7.865646	311	391	2	24	80	0.3000000
NODE_17627_length_687_cov_7.865646	364	444	0	31	80	0.3875000
NODE_17627_length_687_cov_7.865646	364	444	3	8	80	0.1000000
NODE_17627_length_687_cov_7.865646	364	444	4	41	80	0.5125000
NODE_17628_length_687_cov_7.353741	286	366	0	17	80	0.2125000
NODE_17628_length_687_cov_7.353741	286	366	2	49	80	0.6125000
NODE_17628_length_687_cov_7.353741	286	366	4	14	80	0.1750000
NODE_17628_length_687_cov_7.353741	339	419	2	13	80	0.1625000
NODE_17628_length_687_cov_7.353741	339	419	4	67	80	0.8375000
NODE_17631_length_687_cov_5.903061	369	449	0	80	80	1.0000000
NODE_17631_length_687_cov_5.903061	422	502	0	80	80	1.0000000
NODE_17695_length_686_cov_34.642249	355	440	0	85	85	1.0000000
NODE_17695_length_686_cov_34.642249	413	493	0	80	80	1.0000000
NODE_17697_length_686_cov_26.357751	413	493	0	57	80	0.7125000
NODE_17697_length_686_cov_26.357751	413	493	2	23	80	0.2875000
NODE_17697_length_686_cov_26.357751	466	546	0	9	80	0.1125000
NODE_17697_length_686_cov_26.357751	466	546	2	71	80	0.8875000
NODE_17698_length_686_cov_16.715503	400	480	0	62	80	0.7750000
NODE_17698_length_686_cov_16.715503	400	480	1	18	80	0.2250000
NODE_17698_length_686_cov_16.715503	453	533	0	80	80	1.0000000
NODE_17757_length_685_cov_8.769625	178	258	0	80	80	1.0000000
NODE_17757_length_685_cov_8.769625	222	250	0	28	28	1.0000000
NODE_17757_length_685_cov_8.769625	231	311	0	80	80	1.0000000
NODE_17764_length_685_cov_4.447099	249	329	7	53	80	0.6625000
NODE_17764_length_685_cov_4.447099	249	329	8	1	80	0.0125000
NODE_17764_length_685_cov_4.447099	249	329	9	26	80	0.3250000
NODE_17764_length_685_cov_4.447099	302	382	1	3	80	0.0375000
NODE_17764_length_685_cov_4.447099	302	382	2	15	80	0.1875000
NODE_17764_length_685_cov_4.447099	302	382	4	10	80	0.1250000
NODE_17764_length_685_cov_4.447099	302	382	6	8	80	0.1000000
NODE_17764_length_685_cov_4.447099	302	382	7	1	80	0.0125000
NODE_17764_length_685_cov_4.447099	302	382	8	17	80	0.2125000
NODE_17764_length_685_cov_4.447099	302	382	9	26	80	0.3250000
NODE_17768_length_685_cov_3.556314	338	418	2	80	80	1.0000000
NODE_17768_length_685_cov_3.556314	391	471	0	39	80	0.4875000
NODE_17768_length_685_cov_3.556314	391	471	2	41	80	0.5125000
NODE_17821_length_684_cov_7.521368	189	269	0	25	80	0.3125000
NODE_17821_length_684_cov_7.521368	189	269	2	55	80	0.6875000
NODE_17821_length_684_cov_7.521368	242	322	2	41	80	0.5125000
NODE_17821_length_684_cov_7.521368	242	322	4	37	80	0.4625000
NODE_17821_length_684_cov_7.521368	242	322	6	2	80	0.0250000
NODE_17832_length_684_cov_3.639316	306	386	0	80	80	1.0000000
NODE_17832_length_684_cov_3.639316	359	439	0	80	80	1.0000000
NODE_17866_length_683_cov_27.493151	346	426	4	17	80	0.2125000
NODE_17866_length_683_cov_27.493151	346	426	6	13	80	0.1625000
NODE_17866_length_683_cov_27.493151	346	426	9	22	80	0.2750000
NODE_17866_length_683_cov_27.493151	346	426	10	28	80	0.3500000
NODE_17866_length_683_cov_27.493151	399	479	4	39	80	0.4875000
NODE_17866_length_683_cov_27.493151	399	479	6	8	80	0.1000000
NODE_17866_length_683_cov_27.493151	399	479	10	33	80	0.4125000
NODE_17867_length_683_cov_12.880137	242	321	2	12	79	0.1518987
NODE_17867_length_683_cov_12.880137	242	321	4	45	79	0.5696203
NODE_17867_length_683_cov_12.880137	242	321	6	22	79	0.2784810
NODE_17868_length_683_cov_11.772260	218	274	0	56	56	1.0000000
NODE_17868_length_683_cov_11.772260	247	333	0	86	86	1.0000000
NODE_17869_length_683_cov_9.936644	435	515	0	80	80	1.0000000
NODE_17869_length_683_cov_9.936644	488	568	0	80	80	1.0000000
NODE_17871_length_683_cov_9.017123	296	364	0	68	68	1.0000000
NODE_17871_length_683_cov_9.017123	337	417	0	80	80	1.0000000
NODE_17873_length_683_cov_6.797945	359	415	0	56	56	1.0000000
NODE_17884_length_683_cov_3.176370	113	186	0	73	73	1.0000000
NODE_17947_length_682_cov_33.516295	423	503	0	80	80	1.0000000
NODE_17947_length_682_cov_33.516295	476	556	0	80	80	1.0000000
NODE_17948_length_682_cov_27.022298	479	559	0	59	80	0.7375000
NODE_17948_length_682_cov_27.022298	479	559	2	3	80	0.0375000
NODE_17948_length_682_cov_27.022298	479	559	4	1	80	0.0125000
NODE_17948_length_682_cov_27.022298	479	559	6	1	80	0.0125000
NODE_17948_length_682_cov_27.022298	479	559	10	8	80	0.1000000
NODE_17948_length_682_cov_27.022298	479	559	12	8	80	0.1000000
NODE_17948_length_682_cov_27.022298	532	612	0	6	80	0.0750000
NODE_17948_length_682_cov_27.022298	532	612	2	3	80	0.0375000
NODE_17948_length_682_cov_27.022298	532	612	4	1	80	0.0125000
NODE_17948_length_682_cov_27.022298	532	612	6	1	80	0.0125000
NODE_17948_length_682_cov_27.022298	532	612	10	8	80	0.1000000
NODE_17948_length_682_cov_27.022298	532	612	12	9	80	0.1125000
NODE_17948_length_682_cov_27.022298	532	612	14	26	80	0.3250000
NODE_17948_length_682_cov_27.022298	532	612	16	26	80	0.3250000
NODE_17949_length_682_cov_19.612350	434	514	2	80	80	1.0000000
NODE_17949_length_682_cov_19.612350	487	567	0	33	80	0.4125000
NODE_17949_length_682_cov_19.612350	487	567	2	47	80	0.5875000
NODE_17950_length_682_cov_16.620926	261	341	0	80	80	1.0000000
NODE_17950_length_682_cov_16.620926	314	394	0	80	80	1.0000000
NODE_17951_length_682_cov_13.735849	251	331	0	80	80	1.0000000
NODE_17951_length_682_cov_13.735849	304	384	0	80	80	1.0000000
NODE_17952_length_682_cov_12.835334	228	308	4	80	80	1.0000000
NODE_17952_length_682_cov_12.835334	281	361	0	43	80	0.5375000
NODE_17952_length_682_cov_12.835334	281	361	4	37	80	0.4625000
NODE_17956_length_682_cov_7.504288	224	304	0	59	80	0.7375000
NODE_17956_length_682_cov_7.504288	224	304	2	21	80	0.2625000
NODE_17956_length_682_cov_7.504288	277	357	0	80	80	1.0000000
NODE_17960_length_682_cov_5.102916	314	351	0	37	37	1.0000000
NODE_17963_length_682_cov_4.579760	152	232	0	80	80	1.0000000
NODE_17963_length_682_cov_4.579760	205	285	0	28	80	0.3500000
NODE_17963_length_682_cov_4.579760	205	285	4	52	80	0.6500000
NODE_17967_length_682_cov_4.006861	317	397	0	42	80	0.5250000
NODE_17967_length_682_cov_4.006861	317	397	1	31	80	0.3875000
NODE_17967_length_682_cov_4.006861	317	397	2	7	80	0.0875000
NODE_17967_length_682_cov_4.006861	370	450	1	20	80	0.2500000
NODE_17967_length_682_cov_4.006861	370	450	2	60	80	0.7500000
NODE_17968_length_682_cov_3.859348	160	240	0	80	80	1.0000000
NODE_17968_length_682_cov_3.859348	213	293	0	80	80	1.0000000
NODE_18010_length_681_cov_51.810997	181	261	0	80	80	1.0000000
NODE_18010_length_681_cov_51.810997	234	316	0	82	82	1.0000000
NODE_18011_length_681_cov_32.128866	347	427	0	77	80	0.9625000
NODE_18011_length_681_cov_32.128866	347	427	4	3	80	0.0375000
NODE_18011_length_681_cov_32.128866	400	475	0	75	75	1.0000000
NODE_18012_length_681_cov_19.079038	282	362	0	37	80	0.4625000
NODE_18012_length_681_cov_19.079038	282	362	2	43	80	0.5375000
NODE_18012_length_681_cov_19.079038	335	415	2	29	80	0.3625000
NODE_18012_length_681_cov_19.079038	335	415	4	51	80	0.6375000
NODE_18013_length_681_cov_17.053265	294	374	0	22	80	0.2750000
NODE_18013_length_681_cov_17.053265	294	374	2	58	80	0.7250000
NODE_18013_length_681_cov_17.053265	347	427	0	75	80	0.9375000
NODE_18013_length_681_cov_17.053265	347	427	2	5	80	0.0625000
NODE_18014_length_681_cov_11.183849	306	386	0	36	80	0.4500000
NODE_18014_length_681_cov_11.183849	306	386	2	44	80	0.5500000
NODE_18014_length_681_cov_11.183849	359	439	0	80	80	1.0000000
NODE_18015_length_681_cov_8.065292	236	316	0	22	80	0.2750000
NODE_18015_length_681_cov_8.065292	236	316	2	58	80	0.7250000
NODE_18015_length_681_cov_8.065292	289	369	0	7	80	0.0875000
NODE_18015_length_681_cov_8.065292	289	369	2	73	80	0.9125000
NODE_18017_length_681_cov_6.888316	344	424	0	80	80	1.0000000
NODE_18017_length_681_cov_6.888316	397	477	0	80	80	1.0000000
NODE_18080_length_680_cov_35.695353	348	428	6	11	80	0.1375000
NODE_18080_length_680_cov_35.695353	348	428	8	69	80	0.8625000
NODE_18080_length_680_cov_35.695353	401	481	0	26	80	0.3250000
NODE_18080_length_680_cov_35.695353	401	481	3	1	80	0.0125000
NODE_18080_length_680_cov_35.695353	401	481	4	22	80	0.2750000
NODE_18080_length_680_cov_35.695353	401	481	6	9	80	0.1125000
NODE_18080_length_680_cov_35.695353	401	481	8	22	80	0.2750000
NODE_18081_length_680_cov_17.500861	296	376	0	80	80	1.0000000
NODE_18081_length_680_cov_17.500861	349	429	0	80	80	1.0000000
NODE_18082_length_680_cov_16.685026	260	340	0	80	80	1.0000000
NODE_18082_length_680_cov_16.685026	313	393	0	80	80	1.0000000
NODE_18083_length_680_cov_15.345955	332	412	0	80	80	1.0000000
NODE_18083_length_680_cov_15.345955	385	465	0	80	80	1.0000000
NODE_18089_length_680_cov_3.858864	458	538	0	80	80	1.0000000
NODE_18107_length_680_cov_1.879518	236	256	0	20	20	1.0000000
NODE_18146_length_679_cov_52.046552	367	447	2	4	80	0.0500000
NODE_18146_length_679_cov_52.046552	367	447	4	7	80	0.0875000
NODE_18146_length_679_cov_52.046552	367	447	6	69	80	0.8625000
NODE_18146_length_679_cov_52.046552	420	500	0	38	80	0.4750000
NODE_18146_length_679_cov_52.046552	420	500	1	1	80	0.0125000
NODE_18146_length_679_cov_52.046552	420	500	2	18	80	0.2250000
NODE_18146_length_679_cov_52.046552	420	500	4	7	80	0.0875000
NODE_18146_length_679_cov_52.046552	420	500	6	16	80	0.2000000
NODE_18147_length_679_cov_40.353448	179	259	2	80	80	1.0000000
NODE_18147_length_679_cov_40.353448	232	312	0	52	80	0.6500000
NODE_18147_length_679_cov_40.353448	232	312	1	1	80	0.0125000
NODE_18147_length_679_cov_40.353448	232	312	2	27	80	0.3375000
NODE_18148_length_679_cov_38.144828	364	428	2	2	64	0.0312500
NODE_18148_length_679_cov_38.144828	364	428	4	60	64	0.9375000
NODE_18148_length_679_cov_38.144828	364	428	6	2	64	0.0312500
NODE_18148_length_679_cov_38.144828	401	481	0	23	80	0.2875000
NODE_18148_length_679_cov_38.144828	401	481	2	32	80	0.4000000
NODE_18148_length_679_cov_38.144828	401	481	4	25	80	0.3125000
NODE_18149_length_679_cov_17.134483	277	357	0	80	80	1.0000000
NODE_18149_length_679_cov_17.134483	330	410	0	80	80	1.0000000
NODE_18150_length_679_cov_15.046552	310	375	0	65	65	1.0000000
NODE_18151_length_679_cov_12.586207	247	327	0	80	80	1.0000000
NODE_18151_length_679_cov_12.586207	303	381	0	78	78	1.0000000
NODE_18152_length_679_cov_12.282759	337	417	3	28	80	0.3500000
NODE_18152_length_679_cov_12.282759	337	417	4	52	80	0.6500000
NODE_18152_length_679_cov_12.282759	390	470	1	40	80	0.5000000
NODE_18152_length_679_cov_12.282759	390	470	3	33	80	0.4125000
NODE_18152_length_679_cov_12.282759	390	470	4	7	80	0.0875000
NODE_18153_length_679_cov_11.532759	205	285	0	8	80	0.1000000
NODE_18153_length_679_cov_11.532759	205	285	2	32	80	0.4000000
NODE_18153_length_679_cov_11.532759	205	285	4	40	80	0.5000000
NODE_18153_length_679_cov_11.532759	258	338	4	42	80	0.5250000
NODE_18153_length_679_cov_11.532759	258	338	6	38	80	0.4750000
NODE_18155_length_679_cov_8.043103	269	341	0	72	72	1.0000000
NODE_18155_length_679_cov_8.043103	314	394	0	80	80	1.0000000
NODE_18156_length_679_cov_7.267241	191	271	0	25	80	0.3125000
NODE_18156_length_679_cov_7.267241	191	271	2	55	80	0.6875000
NODE_18156_length_679_cov_7.267241	244	324	0	27	80	0.3375000
NODE_18156_length_679_cov_7.267241	244	324	2	53	80	0.6625000
NODE_18162_length_679_cov_5.391379	279	331	0	1	52	0.0192308
NODE_18162_length_679_cov_5.391379	279	331	2	51	52	0.9807692
NODE_18164_length_679_cov_3.813793	10	69	3	16	59	0.2711864
NODE_18164_length_679_cov_3.813793	10	69	4	43	59	0.7288136
NODE_18164_length_679_cov_3.813793	48	122	0	22	74	0.2972973
NODE_18164_length_679_cov_3.813793	48	122	2	20	74	0.2702703
NODE_18164_length_679_cov_3.813793	48	122	4	32	74	0.4324324
NODE_18217_length_678_cov_38.910190	252	332	1	80	80	1.0000000
NODE_18217_length_678_cov_38.910190	305	385	1	50	80	0.6250000
NODE_18217_length_678_cov_38.910190	305	385	3	19	80	0.2375000
NODE_18217_length_678_cov_38.910190	305	385	5	6	80	0.0750000
NODE_18217_length_678_cov_38.910190	305	385	6	5	80	0.0625000
NODE_18217_length_678_cov_38.910190	381	461	5	67	80	0.8375000
NODE_18217_length_678_cov_38.910190	381	461	6	13	80	0.1625000
NODE_18217_length_678_cov_38.910190	434	514	1	22	80	0.2750000
NODE_18217_length_678_cov_38.910190	434	514	3	30	80	0.3750000
NODE_18217_length_678_cov_38.910190	434	514	5	28	80	0.3500000
NODE_18218_length_678_cov_20.663212	243	323	0	20	80	0.2500000
NODE_18218_length_678_cov_20.663212	243	323	2	60	80	0.7500000
NODE_18218_length_678_cov_20.663212	296	376	2	80	80	1.0000000
NODE_18219_length_678_cov_12.081174	243	323	0	80	80	1.0000000
NODE_18219_length_678_cov_12.081174	296	376	0	80	80	1.0000000
NODE_18224_length_678_cov_6.559585	195	264	0	69	69	1.0000000
NODE_18224_length_678_cov_6.559585	237	317	0	80	80	1.0000000
NODE_18228_length_678_cov_4.462867	133	213	0	80	80	1.0000000
NODE_18228_length_678_cov_4.462867	186	266	0	80	80	1.0000000
NODE_18239_length_678_cov_2.716753	351	431	0	80	80	1.0000000
NODE_18239_length_678_cov_2.716753	404	484	0	80	80	1.0000000
NODE_18289_length_677_cov_22.235294	274	354	0	80	80	1.0000000
NODE_18289_length_677_cov_22.235294	327	407	0	80	80	1.0000000
NODE_18290_length_677_cov_16.410035	124	206	0	82	82	1.0000000
NODE_18290_length_677_cov_16.410035	177	261	0	84	84	1.0000000
NODE_18291_length_677_cov_11.031142	393	473	2	40	80	0.5000000
NODE_18291_length_677_cov_11.031142	393	473	4	14	80	0.1750000
NODE_18291_length_677_cov_11.031142	393	473	6	26	80	0.3250000
NODE_18291_length_677_cov_11.031142	446	526	2	80	80	1.0000000
NODE_18292_length_677_cov_10.129758	258	338	0	22	80	0.2750000
NODE_18292_length_677_cov_10.129758	258	338	2	58	80	0.7250000
NODE_18292_length_677_cov_10.129758	311	391	0	72	80	0.9000000
NODE_18292_length_677_cov_10.129758	311	391	2	8	80	0.1000000
NODE_18295_length_677_cov_6.660900	217	297	35	2	80	0.0250000
NODE_18295_length_677_cov_6.660900	217	297	38	2	80	0.0250000
NODE_18295_length_677_cov_6.660900	217	297	42	2	80	0.0250000
NODE_18295_length_677_cov_6.660900	217	297	44	2	80	0.0250000
NODE_18295_length_677_cov_6.660900	217	297	48	9	80	0.1125000
NODE_18295_length_677_cov_6.660900	217	297	50	2	80	0.0250000
NODE_18295_length_677_cov_6.660900	217	297	54	1	80	0.0125000
NODE_18295_length_677_cov_6.660900	217	297	56	2	80	0.0250000
NODE_18295_length_677_cov_6.660900	217	297	60	2	80	0.0250000
NODE_18295_length_677_cov_6.660900	217	297	62	10	80	0.1250000
NODE_18295_length_677_cov_6.660900	217	297	64	46	80	0.5750000
NODE_18297_length_677_cov_5.228374	366	446	0	34	80	0.4250000
NODE_18297_length_677_cov_5.228374	366	446	1	6	80	0.0750000
NODE_18297_length_677_cov_5.228374	366	446	2	40	80	0.5000000
NODE_18312_length_677_cov_2.306228	230	278	0	48	48	1.0000000
NODE_18329_length_677_cov_1.709343	369	449	0	38	80	0.4750000
NODE_18329_length_677_cov_1.709343	369	449	2	20	80	0.2500000
NODE_18329_length_677_cov_1.709343	369	449	4	22	80	0.2750000
NODE_18329_length_677_cov_1.709343	422	502	2	5	80	0.0625000
NODE_18329_length_677_cov_1.709343	422	502	4	75	80	0.9375000
NODE_18368_length_676_cov_66.473137	286	366	1	19	80	0.2375000
NODE_18368_length_676_cov_66.473137	286	366	2	61	80	0.7625000
NODE_18368_length_676_cov_66.473137	339	419	2	45	80	0.5625000
NODE_18368_length_676_cov_66.473137	339	419	4	2	80	0.0250000
NODE_18368_length_676_cov_66.473137	339	419	6	5	80	0.0625000
NODE_18368_length_676_cov_66.473137	339	419	10	1	80	0.0125000
NODE_18368_length_676_cov_66.473137	339	419	12	4	80	0.0500000
NODE_18368_length_676_cov_66.473137	339	419	18	23	80	0.2875000
NODE_18368_length_676_cov_66.473137	383	419	2	1	36	0.0277778
NODE_18368_length_676_cov_66.473137	383	419	4	2	36	0.0555556
NODE_18368_length_676_cov_66.473137	383	419	6	5	36	0.1388889
NODE_18368_length_676_cov_66.473137	383	419	10	1	36	0.0277778
NODE_18368_length_676_cov_66.473137	383	419	12	4	36	0.1111111
NODE_18368_length_676_cov_66.473137	383	419	18	23	36	0.6388889
NODE_18368_length_676_cov_66.473137	383	419	2	1	36	0.0277778
NODE_18368_length_676_cov_66.473137	383	419	4	2	36	0.0555556
NODE_18368_length_676_cov_66.473137	383	419	6	5	36	0.1388889
NODE_18368_length_676_cov_66.473137	383	419	10	1	36	0.0277778
NODE_18368_length_676_cov_66.473137	383	419	12	4	36	0.1111111
NODE_18368_length_676_cov_66.473137	383	419	18	23	36	0.6388889
NODE_18368_length_676_cov_66.473137	398	419	18	21	21	1.0000000
NODE_18369_length_676_cov_14.429809	259	330	0	6	71	0.0845070
NODE_18369_length_676_cov_14.429809	259	330	2	11	71	0.1549296
NODE_18369_length_676_cov_14.429809	259	330	3	54	71	0.7605634
NODE_18370_length_676_cov_13.882149	292	372	0	63	80	0.7875000
NODE_18370_length_676_cov_13.882149	292	372	2	17	80	0.2125000
NODE_18370_length_676_cov_13.882149	345	425	0	10	80	0.1250000
NODE_18370_length_676_cov_13.882149	345	425	2	47	80	0.5875000
NODE_18370_length_676_cov_13.882149	345	425	4	23	80	0.2875000
NODE_18374_length_676_cov_7.225303	363	443	0	80	80	1.0000000
NODE_18374_length_676_cov_7.225303	416	496	0	80	80	1.0000000
NODE_18375_length_676_cov_6.740035	373	433	0	60	60	1.0000000
NODE_18375_length_676_cov_6.740035	406	486	0	29	80	0.3625000
NODE_18375_length_676_cov_6.740035	406	486	2	51	80	0.6375000
NODE_18378_length_676_cov_4.658579	167	240	0	61	73	0.8356164
NODE_18378_length_676_cov_4.658579	167	240	2	12	73	0.1643836
NODE_18397_length_676_cov_2.292894	146	226	1	5	80	0.0625000
NODE_18397_length_676_cov_2.292894	146	226	2	75	80	0.9375000
NODE_18401_length_676_cov_2.157712	175	226	0	51	51	1.0000000
NODE_18417_length_676_cov_1.547660	133	164	0	31	31	1.0000000
NODE_18447_length_675_cov_27.574653	190	270	0	80	80	1.0000000
NODE_18447_length_675_cov_27.574653	243	323	0	80	80	1.0000000
NODE_18448_length_675_cov_11.895833	336	416	0	80	80	1.0000000
NODE_18448_length_675_cov_11.895833	389	469	0	80	80	1.0000000
NODE_18449_length_675_cov_8.157986	414	494	0	80	80	1.0000000
NODE_18449_length_675_cov_8.157986	467	547	0	80	80	1.0000000
NODE_18450_length_675_cov_8.026042	320	400	0	80	80	1.0000000
NODE_18450_length_675_cov_8.026042	373	453	0	80	80	1.0000000
NODE_18451_length_675_cov_7.277778	317	397	0	80	80	1.0000000
NODE_18455_length_675_cov_5.666667	142	222	2	80	80	1.0000000
NODE_18455_length_675_cov_5.666667	195	275	0	39	80	0.4875000
NODE_18455_length_675_cov_5.666667	195	275	2	41	80	0.5125000
NODE_18464_length_675_cov_2.751736	67	122	4	5	55	0.0909091
NODE_18464_length_675_cov_2.751736	67	122	6	12	55	0.2181818
NODE_18464_length_675_cov_2.751736	67	122	8	38	55	0.6909091
NODE_18467_length_675_cov_2.623264	251	289	4	38	38	1.0000000
NODE_18467_length_675_cov_2.623264	279	343	2	36	64	0.5625000
NODE_18467_length_675_cov_2.623264	279	343	4	20	64	0.3125000
NODE_18467_length_675_cov_2.623264	279	343	6	8	64	0.1250000
NODE_18467_length_675_cov_2.623264	432	494	0	62	62	1.0000000
NODE_18515_length_674_cov_38.401739	225	305	2	80	80	1.0000000
NODE_18515_length_674_cov_38.401739	278	358	0	51	80	0.6375000
NODE_18515_length_674_cov_38.401739	278	358	2	29	80	0.3625000
NODE_18516_length_674_cov_30.215652	519	599	24	1	80	0.0125000
NODE_18516_length_674_cov_30.215652	519	599	26	11	80	0.1375000
NODE_18516_length_674_cov_30.215652	519	599	28	5	80	0.0625000
NODE_18516_length_674_cov_30.215652	519	599	32	6	80	0.0750000
NODE_18516_length_674_cov_30.215652	519	599	34	6	80	0.0750000
NODE_18516_length_674_cov_30.215652	519	599	35	1	80	0.0125000
NODE_18516_length_674_cov_30.215652	519	599	36	14	80	0.1750000
NODE_18516_length_674_cov_30.215652	519	599	40	36	80	0.4500000
NODE_18516_length_674_cov_30.215652	572	602	22	1	30	0.0333333
NODE_18516_length_674_cov_30.215652	572	602	24	3	30	0.1000000
NODE_18516_length_674_cov_30.215652	572	602	26	11	30	0.3666667
NODE_18516_length_674_cov_30.215652	572	602	28	5	30	0.1666667
NODE_18516_length_674_cov_30.215652	572	602	32	6	30	0.2000000
NODE_18516_length_674_cov_30.215652	572	602	35	1	30	0.0333333
NODE_18516_length_674_cov_30.215652	572	602	40	3	30	0.1000000
NODE_18517_length_674_cov_19.636522	283	363	0	40	80	0.5000000
NODE_18517_length_674_cov_19.636522	283	363	2	40	80	0.5000000
NODE_18517_length_674_cov_19.636522	336	416	2	59	80	0.7375000
NODE_18517_length_674_cov_19.636522	336	416	4	21	80	0.2625000
NODE_18518_length_674_cov_19.436522	81	161	1	16	80	0.2000000
NODE_18518_length_674_cov_19.436522	81	161	2	1	80	0.0125000
NODE_18518_length_674_cov_19.436522	81	161	4	63	80	0.7875000
NODE_18518_length_674_cov_19.436522	134	214	2	30	80	0.3750000
NODE_18518_length_674_cov_19.436522	134	214	4	50	80	0.6250000
NODE_18519_length_674_cov_16.819130	185	265	2	15	80	0.1875000
NODE_18519_length_674_cov_16.819130	185	265	4	53	80	0.6625000
NODE_18519_length_674_cov_16.819130	185	265	6	12	80	0.1500000
NODE_18519_length_674_cov_16.819130	238	318	4	27	80	0.3375000
NODE_18519_length_674_cov_16.819130	238	318	6	53	80	0.6625000
NODE_18520_length_674_cov_14.733913	169	249	0	39	80	0.4875000
NODE_18520_length_674_cov_14.733913	169	249	2	34	80	0.4250000
NODE_18520_length_674_cov_14.733913	169	249	4	7	80	0.0875000
NODE_18520_length_674_cov_14.733913	222	302	0	12	80	0.1500000
NODE_18520_length_674_cov_14.733913	222	302	2	8	80	0.1000000
NODE_18520_length_674_cov_14.733913	222	302	4	60	80	0.7500000
NODE_18524_length_674_cov_7.086957	357	437	0	80	80	1.0000000
NODE_18524_length_674_cov_7.086957	410	490	0	80	80	1.0000000
NODE_18528_length_674_cov_4.808696	262	342	4	48	80	0.6000000
NODE_18528_length_674_cov_4.808696	262	342	6	32	80	0.4000000
NODE_18528_length_674_cov_4.808696	315	395	2	34	80	0.4250000
NODE_18528_length_674_cov_4.808696	315	395	6	46	80	0.5750000
NODE_18592_length_673_cov_47.109756	405	485	0	80	80	1.0000000
NODE_18592_length_673_cov_47.109756	458	538	0	80	80	1.0000000
NODE_18593_length_673_cov_20.548780	214	294	0	17	80	0.2125000
NODE_18593_length_673_cov_20.548780	214	294	2	63	80	0.7875000
NODE_18593_length_673_cov_20.548780	267	347	0	70	80	0.8750000
NODE_18593_length_673_cov_20.548780	267	347	2	10	80	0.1250000
NODE_18596_length_673_cov_8.306620	337	426	0	17	89	0.1910112
NODE_18596_length_673_cov_8.306620	337	426	2	24	89	0.2696629
NODE_18596_length_673_cov_8.306620	337	426	4	48	89	0.5393258
NODE_18607_length_673_cov_3.041812	196	276	0	10	80	0.1250000
NODE_18607_length_673_cov_3.041812	196	276	2	70	80	0.8750000
NODE_18607_length_673_cov_3.041812	249	329	0	38	80	0.4750000
NODE_18607_length_673_cov_3.041812	249	329	2	42	80	0.5250000
NODE_18660_length_672_cov_15.380454	282	362	0	80	80	1.0000000
NODE_18660_length_672_cov_15.380454	335	415	0	80	80	1.0000000
NODE_18661_length_672_cov_9.902269	328	408	0	45	80	0.5625000
NODE_18661_length_672_cov_9.902269	328	408	2	35	80	0.4375000
NODE_18661_length_672_cov_9.902269	381	461	0	80	80	1.0000000
NODE_18662_length_672_cov_9.462478	309	389	0	80	80	1.0000000
NODE_18662_length_672_cov_9.462478	362	442	0	80	80	1.0000000
NODE_18666_length_672_cov_6.516579	354	434	0	80	80	1.0000000
NODE_18666_length_672_cov_6.516579	407	487	0	80	80	1.0000000
NODE_18668_length_672_cov_6.108202	135	215	0	80	80	1.0000000
NODE_18668_length_672_cov_6.108202	188	268	0	80	80	1.0000000
NODE_18670_length_672_cov_4.949389	115	152	0	37	37	1.0000000
NODE_18670_length_672_cov_4.949389	125	205	0	80	80	1.0000000
NODE_18670_length_672_cov_4.949389	278	326	0	48	48	1.0000000
NODE_18672_length_672_cov_4.753927	378	450	2	31	72	0.4305556
NODE_18672_length_672_cov_4.753927	378	450	6	41	72	0.5694444
NODE_18704_length_672_cov_1.713787	340	401	0	60	61	0.9836066
NODE_18704_length_672_cov_1.713787	340	401	2	1	61	0.0163934
NODE_18742_length_671_cov_28.874126	306	387	0	23	81	0.2839506
NODE_18742_length_671_cov_28.874126	306	387	2	2	81	0.0246914
NODE_18742_length_671_cov_28.874126	306	387	4	47	81	0.5802469
NODE_18742_length_671_cov_28.874126	306	387	8	9	81	0.1111111
NODE_18742_length_671_cov_28.874126	360	440	4	18	80	0.2250000
NODE_18742_length_671_cov_28.874126	360	440	8	62	80	0.7750000
NODE_18744_length_671_cov_18.526224	294	333	0	39	39	1.0000000
NODE_18744_length_671_cov_18.526224	331	404	0	73	73	1.0000000
NODE_18744_length_671_cov_18.526224	331	351	0	20	20	1.0000000
NODE_18745_length_671_cov_16.094406	417	497	0	80	80	1.0000000
NODE_18745_length_671_cov_16.094406	470	550	0	46	80	0.5750000
NODE_18745_length_671_cov_16.094406	470	550	2	26	80	0.3250000
NODE_18745_length_671_cov_16.094406	470	550	4	8	80	0.1000000
NODE_18746_length_671_cov_11.756993	337	417	0	66	80	0.8250000
NODE_18746_length_671_cov_11.756993	337	417	3	4	80	0.0500000
NODE_18746_length_671_cov_11.756993	337	417	9	10	80	0.1250000
NODE_18746_length_671_cov_11.756993	390	470	0	80	80	1.0000000
NODE_18747_length_671_cov_9.237762	305	382	0	77	77	1.0000000
NODE_18748_length_671_cov_8.491259	298	379	0	68	81	0.8395061
NODE_18748_length_671_cov_8.491259	298	379	2	9	81	0.1111111
NODE_18748_length_671_cov_8.491259	298	379	4	4	81	0.0493827
NODE_18748_length_671_cov_8.491259	352	430	0	78	78	1.0000000
NODE_18749_length_671_cov_8.241259	97	128	0	31	31	1.0000000
NODE_18752_length_671_cov_7.201049	368	448	0	80	80	1.0000000
NODE_18752_length_671_cov_7.201049	421	501	0	80	80	1.0000000
NODE_18753_length_671_cov_5.680070	370	450	2	24	80	0.3000000
NODE_18753_length_671_cov_5.680070	370	450	6	46	80	0.5750000
NODE_18753_length_671_cov_5.680070	370	450	8	10	80	0.1250000
NODE_18753_length_671_cov_5.680070	423	503	6	79	80	0.9875000
NODE_18753_length_671_cov_5.680070	423	503	8	1	80	0.0125000
NODE_18754_length_671_cov_4.769231	362	414	0	52	52	1.0000000
NODE_18760_length_671_cov_3.804196	360	440	4	1	80	0.0125000
NODE_18760_length_671_cov_3.804196	360	440	6	43	80	0.5375000
NODE_18760_length_671_cov_3.804196	360	440	10	10	80	0.1250000
NODE_18760_length_671_cov_3.804196	360	440	12	10	80	0.1250000
NODE_18760_length_671_cov_3.804196	360	440	16	10	80	0.1250000
NODE_18760_length_671_cov_3.804196	360	440	18	6	80	0.0750000
NODE_18812_length_670_cov_21.017513	443	523	0	18	80	0.2250000
NODE_18812_length_670_cov_21.017513	443	523	3	12	80	0.1500000
NODE_18812_length_670_cov_21.017513	443	523	4	17	80	0.2125000
NODE_18812_length_670_cov_21.017513	443	523	6	33	80	0.4125000
NODE_18812_length_670_cov_21.017513	496	576	0	10	80	0.1250000
NODE_18812_length_670_cov_21.017513	496	576	4	70	80	0.8750000
NODE_18813_length_670_cov_20.346760	372	452	0	32	80	0.4000000
NODE_18813_length_670_cov_20.346760	372	452	4	48	80	0.6000000
NODE_18813_length_670_cov_20.346760	425	505	4	80	80	1.0000000
NODE_18814_length_670_cov_15.728546	157	237	0	80	80	1.0000000
NODE_18814_length_670_cov_15.728546	210	290	0	80	80	1.0000000
NODE_18814_length_670_cov_15.728546	286	366	0	80	80	1.0000000
NODE_18814_length_670_cov_15.728546	339	419	0	80	80	1.0000000
NODE_18818_length_670_cov_6.499124	390	470	0	52	80	0.6500000
NODE_18818_length_670_cov_6.499124	390	470	2	28	80	0.3500000
NODE_18834_length_670_cov_3.099825	159	217	4	38	58	0.6551724
NODE_18834_length_670_cov_3.099825	159	217	6	20	58	0.3448276
NODE_18838_length_670_cov_2.700525	252	332	7	15	80	0.1875000
NODE_18838_length_670_cov_2.700525	252	332	8	65	80	0.8125000
NODE_18838_length_670_cov_2.700525	305	385	0	12	80	0.1500000
NODE_18838_length_670_cov_2.700525	305	385	1	15	80	0.1875000
NODE_18838_length_670_cov_2.700525	305	385	2	2	80	0.0250000
NODE_18838_length_670_cov_2.700525	305	385	8	51	80	0.6375000
NODE_18883_length_669_cov_13.307018	432	512	0	34	80	0.4250000
NODE_18883_length_669_cov_13.307018	432	512	2	46	80	0.5750000
NODE_18883_length_669_cov_13.307018	485	565	0	26	80	0.3250000
NODE_18883_length_669_cov_13.307018	485	565	2	54	80	0.6750000
NODE_18886_length_669_cov_6.921053	245	325	0	23	80	0.2875000
NODE_18886_length_669_cov_6.921053	245	325	6	46	80	0.5750000
NODE_18886_length_669_cov_6.921053	245	325	8	11	80	0.1375000
NODE_18886_length_669_cov_6.921053	298	370	6	16	72	0.2222222
NODE_18886_length_669_cov_6.921053	298	370	8	56	72	0.7777778
NODE_18901_length_669_cov_3.633333	277	347	0	70	70	1.0000000
NODE_18909_length_669_cov_2.361404	434	490	0	56	56	1.0000000
NODE_18958_length_668_cov_23.131810	275	355	0	24	80	0.3000000
NODE_18958_length_668_cov_23.131810	275	355	1	7	80	0.0875000
NODE_18958_length_668_cov_23.131810	275	355	2	4	80	0.0500000
NODE_18958_length_668_cov_23.131810	275	355	6	4	80	0.0500000
NODE_18958_length_668_cov_23.131810	275	355	8	32	80	0.4000000
NODE_18958_length_668_cov_23.131810	275	355	10	9	80	0.1125000
NODE_18958_length_668_cov_23.131810	328	408	8	18	80	0.2250000
NODE_18958_length_668_cov_23.131810	328	408	10	54	80	0.6750000
NODE_18958_length_668_cov_23.131810	328	408	12	8	80	0.1000000
NODE_18959_length_668_cov_14.978910	324	404	2	68	80	0.8500000
NODE_18959_length_668_cov_14.978910	324	404	4	12	80	0.1500000
NODE_18959_length_668_cov_14.978910	377	457	2	64	80	0.8000000
NODE_18959_length_668_cov_14.978910	377	457	4	16	80	0.2000000
NODE_18962_length_668_cov_11.184534	187	267	4	16	80	0.2000000
NODE_18962_length_668_cov_11.184534	187	267	6	64	80	0.8000000
NODE_18962_length_668_cov_11.184534	240	320	2	20	80	0.2500000
NODE_18962_length_668_cov_11.184534	240	320	4	13	80	0.1625000
NODE_18962_length_668_cov_11.184534	240	320	6	47	80	0.5875000
NODE_18963_length_668_cov_10.548330	211	291	0	80	80	1.0000000
NODE_18963_length_668_cov_10.548330	264	344	0	80	80	1.0000000
NODE_18964_length_668_cov_10.370826	226	308	0	82	82	1.0000000
NODE_18964_length_668_cov_10.370826	279	361	0	82	82	1.0000000
NODE_18965_length_668_cov_10.223199	238	318	0	80	80	1.0000000
NODE_18965_length_668_cov_10.223199	291	371	0	80	80	1.0000000
NODE_18967_length_668_cov_9.340949	310	390	0	80	80	1.0000000
NODE_18967_length_668_cov_9.340949	363	443	0	80	80	1.0000000
NODE_18975_length_668_cov_4.077329	304	384	8	18	80	0.2250000
NODE_18975_length_668_cov_4.077329	304	384	9	1	80	0.0125000
NODE_18975_length_668_cov_4.077329	304	384	10	58	80	0.7250000
NODE_18975_length_668_cov_4.077329	304	384	12	3	80	0.0375000
NODE_18975_length_668_cov_4.077329	338	367	10	26	29	0.8965517
NODE_18975_length_668_cov_4.077329	338	367	12	3	29	0.1034483
NODE_18975_length_668_cov_4.077329	358	427	6	4	69	0.0579710
NODE_18975_length_668_cov_4.077329	358	427	8	22	69	0.3188406
NODE_18975_length_668_cov_4.077329	358	427	10	16	69	0.2318841
NODE_18975_length_668_cov_4.077329	358	427	12	25	69	0.3623188
NODE_18975_length_668_cov_4.077329	358	427	14	2	69	0.0289855
NODE_19032_length_667_cov_33.848592	168	248	2	80	80	1.0000000
NODE_19032_length_667_cov_33.848592	221	301	0	44	80	0.5500000
NODE_19032_length_667_cov_33.848592	221	301	2	36	80	0.4500000
NODE_19033_length_667_cov_21.218310	270	350	0	80	80	1.0000000
NODE_19033_length_667_cov_21.218310	323	403	0	80	80	1.0000000
NODE_19034_length_667_cov_19.204225	258	338	0	9	80	0.1125000
NODE_19034_length_667_cov_19.204225	258	338	2	19	80	0.2375000
NODE_19034_length_667_cov_19.204225	258	338	4	52	80	0.6500000
NODE_19034_length_667_cov_19.204225	311	391	0	62	80	0.7750000
NODE_19034_length_667_cov_19.204225	311	391	2	18	80	0.2250000
NODE_19036_length_667_cov_8.264085	299	379	0	80	80	1.0000000
NODE_19036_length_667_cov_8.264085	352	432	0	80	80	1.0000000
NODE_19037_length_667_cov_8.248239	76	156	0	80	80	1.0000000
NODE_19037_length_667_cov_8.248239	129	209	0	80	80	1.0000000
NODE_19038_length_667_cov_8.207746	257	323	0	66	66	1.0000000
NODE_19038_length_667_cov_8.207746	296	376	0	80	80	1.0000000
NODE_19039_length_667_cov_7.232394	357	437	0	80	80	1.0000000
NODE_19039_length_667_cov_7.232394	410	490	0	80	80	1.0000000
NODE_19042_length_667_cov_4.941901	199	279	0	80	80	1.0000000
NODE_19042_length_667_cov_4.941901	252	332	0	80	80	1.0000000
NODE_19053_length_667_cov_3.404930	501	536	8	8	35	0.2285714
NODE_19053_length_667_cov_3.404930	501	536	10	27	35	0.7714286
NODE_19053_length_667_cov_3.404930	503	533	8	5	30	0.1666667
NODE_19053_length_667_cov_3.404930	503	533	10	25	30	0.8333333
NODE_19100_length_666_cov_24.811287	179	254	0	9	75	0.1200000
NODE_19100_length_666_cov_24.811287	179	254	1	6	75	0.0800000
NODE_19100_length_666_cov_24.811287	179	254	3	55	75	0.7333333
NODE_19100_length_666_cov_24.811287	179	254	4	5	75	0.0666667
NODE_19100_length_666_cov_24.811287	182	254	0	9	72	0.1250000
NODE_19100_length_666_cov_24.811287	182	254	1	6	72	0.0833333
NODE_19100_length_666_cov_24.811287	182	254	3	52	72	0.7222222
NODE_19100_length_666_cov_24.811287	182	254	4	5	72	0.0694444
NODE_19100_length_666_cov_24.811287	227	307	0	47	80	0.5875000
NODE_19100_length_666_cov_24.811287	227	307	1	6	80	0.0750000
NODE_19100_length_666_cov_24.811287	227	307	3	12	80	0.1500000
NODE_19100_length_666_cov_24.811287	227	307	4	15	80	0.1875000
NODE_19100_length_666_cov_24.811287	227	307	0	47	80	0.5875000
NODE_19100_length_666_cov_24.811287	227	307	1	6	80	0.0750000
NODE_19100_length_666_cov_24.811287	227	307	3	12	80	0.1500000
NODE_19100_length_666_cov_24.811287	227	307	4	15	80	0.1875000
NODE_19100_length_666_cov_24.811287	303	383	4	10	80	0.1250000
NODE_19100_length_666_cov_24.811287	303	383	9	3	80	0.0375000
NODE_19100_length_666_cov_24.811287	303	383	13	2	80	0.0250000
NODE_19100_length_666_cov_24.811287	303	383	14	4	80	0.0500000
NODE_19100_length_666_cov_24.811287	303	383	20	5	80	0.0625000
NODE_19100_length_666_cov_24.811287	303	383	21	4	80	0.0500000
NODE_19100_length_666_cov_24.811287	303	383	24	1	80	0.0125000
NODE_19100_length_666_cov_24.811287	303	383	25	2	80	0.0250000
NODE_19100_length_666_cov_24.811287	303	383	31	1	80	0.0125000
NODE_19100_length_666_cov_24.811287	303	383	32	3	80	0.0375000
NODE_19100_length_666_cov_24.811287	303	383	34	1	80	0.0125000
NODE_19100_length_666_cov_24.811287	303	383	35	1	80	0.0125000
NODE_19100_length_666_cov_24.811287	303	383	37	3	80	0.0375000
NODE_19100_length_666_cov_24.811287	303	383	38	1	80	0.0125000
NODE_19100_length_666_cov_24.811287	303	383	48	4	80	0.0500000
NODE_19100_length_666_cov_24.811287	303	383	50	1	80	0.0125000
NODE_19100_length_666_cov_24.811287	303	383	56	2	80	0.0250000
NODE_19100_length_666_cov_24.811287	303	383	58	2	80	0.0250000
NODE_19100_length_666_cov_24.811287	303	383	60	1	80	0.0125000
NODE_19100_length_666_cov_24.811287	303	383	61	1	80	0.0125000
NODE_19100_length_666_cov_24.811287	303	383	63	2	80	0.0250000
NODE_19100_length_666_cov_24.811287	303	383	65	2	80	0.0250000
NODE_19100_length_666_cov_24.811287	303	383	66	3	80	0.0375000
NODE_19100_length_666_cov_24.811287	303	383	67	5	80	0.0625000
NODE_19100_length_666_cov_24.811287	303	383	68	16	80	0.2000000
NODE_19100_length_666_cov_24.811287	356	436	31	6	80	0.0750000
NODE_19100_length_666_cov_24.811287	356	436	33	2	80	0.0250000
NODE_19100_length_666_cov_24.811287	356	436	35	1	80	0.0125000
NODE_19100_length_666_cov_24.811287	356	436	55	2	80	0.0250000
NODE_19100_length_666_cov_24.811287	356	436	59	1	80	0.0125000
NODE_19100_length_666_cov_24.811287	356	436	60	1	80	0.0125000
NODE_19100_length_666_cov_24.811287	356	436	61	13	80	0.1625000
NODE_19100_length_666_cov_24.811287	356	436	63	6	80	0.0750000
NODE_19100_length_666_cov_24.811287	356	436	64	2	80	0.0250000
NODE_19100_length_666_cov_24.811287	356	436	65	2	80	0.0250000
NODE_19100_length_666_cov_24.811287	356	436	66	3	80	0.0375000
NODE_19100_length_666_cov_24.811287	356	436	67	5	80	0.0625000
NODE_19100_length_666_cov_24.811287	356	436	68	36	80	0.4500000
NODE_19102_length_666_cov_20.114638	172	252	0	80	80	1.0000000
NODE_19102_length_666_cov_20.114638	225	305	0	62	80	0.7750000
NODE_19102_length_666_cov_20.114638	225	305	2	18	80	0.2250000
NODE_19103_length_666_cov_16.813051	220	286	0	22	66	0.3333333
NODE_19103_length_666_cov_16.813051	220	286	2	44	66	0.6666667
NODE_19103_length_666_cov_16.813051	259	344	2	52	85	0.6117647
NODE_19103_length_666_cov_16.813051	259	344	4	33	85	0.3882353
NODE_19104_length_666_cov_15.384480	306	386	0	35	80	0.4375000
NODE_19104_length_666_cov_15.384480	306	386	1	17	80	0.2125000
NODE_19104_length_666_cov_15.384480	306	386	2	19	80	0.2375000
NODE_19104_length_666_cov_15.384480	306	386	3	9	80	0.1125000
NODE_19104_length_666_cov_15.384480	359	439	2	18	80	0.2250000
NODE_19104_length_666_cov_15.384480	359	439	3	62	80	0.7750000
NODE_19105_length_666_cov_14.195767	485	565	0	80	80	1.0000000
NODE_19105_length_666_cov_14.195767	538	618	0	80	80	1.0000000
NODE_19108_length_666_cov_7.770723	226	306	0	31	80	0.3875000
NODE_19108_length_666_cov_7.770723	226	306	2	49	80	0.6125000
NODE_19108_length_666_cov_7.770723	279	359	0	29	80	0.3625000
NODE_19108_length_666_cov_7.770723	279	359	2	51	80	0.6375000
NODE_19163_length_665_cov_28.786219	391	471	2	46	80	0.5750000
NODE_19163_length_665_cov_28.786219	391	471	4	34	80	0.4250000
NODE_19163_length_665_cov_28.786219	444	524	2	3	80	0.0375000
NODE_19163_length_665_cov_28.786219	444	524	4	77	80	0.9625000
NODE_19164_length_665_cov_21.740283	311	391	0	13	80	0.1625000
NODE_19164_length_665_cov_21.740283	311	391	1	48	80	0.6000000
NODE_19164_length_665_cov_21.740283	311	391	2	19	80	0.2375000
NODE_19164_length_665_cov_21.740283	364	444	1	8	80	0.1000000
NODE_19164_length_665_cov_21.740283	364	444	2	72	80	0.9000000
NODE_19165_length_665_cov_15.904594	390	470	0	13	80	0.1625000
NODE_19165_length_665_cov_15.904594	390	470	2	21	80	0.2625000
NODE_19165_length_665_cov_15.904594	390	470	6	46	80	0.5750000
NODE_19165_length_665_cov_15.904594	443	523	0	66	80	0.8250000
NODE_19165_length_665_cov_15.904594	443	523	2	14	80	0.1750000
NODE_19224_length_664_cov_27.208850	259	339	0	80	80	1.0000000
NODE_19224_length_664_cov_27.208850	345	404	0	11	59	0.1864407
NODE_19224_length_664_cov_27.208850	345	404	2	8	59	0.1355932
NODE_19224_length_664_cov_27.208850	345	404	4	40	59	0.6779661
NODE_19225_length_664_cov_16.116814	241	321	0	24	80	0.3000000
NODE_19225_length_664_cov_16.116814	241	321	2	1	80	0.0125000
NODE_19225_length_664_cov_16.116814	241	321	4	55	80	0.6875000
NODE_19225_length_664_cov_16.116814	294	374	4	54	80	0.6750000
NODE_19225_length_664_cov_16.116814	294	374	6	26	80	0.3250000
NODE_19227_length_664_cov_14.185841	332	412	0	79	80	0.9875000
NODE_19227_length_664_cov_14.185841	332	412	2	1	80	0.0125000
NODE_19227_length_664_cov_14.185841	385	465	0	80	80	1.0000000
NODE_19228_length_664_cov_12.256637	325	405	2	80	80	1.0000000
NODE_19228_length_664_cov_12.256637	378	454	2	27	76	0.3552631
NODE_19228_length_664_cov_12.256637	378	454	4	49	76	0.6447368
NODE_19229_length_664_cov_8.378761	252	332	2	80	80	1.0000000
NODE_19229_length_664_cov_8.378761	305	385	0	43	80	0.5375000
NODE_19229_length_664_cov_8.378761	305	385	2	37	80	0.4625000
NODE_19229_length_664_cov_8.378761	381	461	0	37	80	0.4625000
NODE_19229_length_664_cov_8.378761	381	461	2	43	80	0.5375000
NODE_19229_length_664_cov_8.378761	434	514	2	80	80	1.0000000
NODE_19254_length_664_cov_1.922124	393	434	1	41	41	1.0000000
NODE_19298_length_663_cov_26.601064	398	478	0	80	80	1.0000000
NODE_19298_length_663_cov_26.601064	451	531	0	80	80	1.0000000
NODE_19299_length_663_cov_16.948582	368	448	0	28	80	0.3500000
NODE_19299_length_663_cov_16.948582	368	448	2	34	80	0.4250000
NODE_19299_length_663_cov_16.948582	368	448	4	18	80	0.2250000
NODE_19299_length_663_cov_16.948582	421	501	2	44	80	0.5500000
NODE_19299_length_663_cov_16.948582	421	501	4	36	80	0.4500000
NODE_19300_length_663_cov_16.225177	118	198	0	80	80	1.0000000
NODE_19300_length_663_cov_16.225177	171	251	0	80	80	1.0000000
NODE_19302_length_663_cov_13.748227	277	357	0	24	80	0.3000000
NODE_19302_length_663_cov_13.748227	277	357	2	53	80	0.6625000
NODE_19302_length_663_cov_13.748227	277	357	4	3	80	0.0375000
NODE_19302_length_663_cov_13.748227	330	410	2	29	80	0.3625000
NODE_19302_length_663_cov_13.748227	330	410	4	51	80	0.6375000
NODE_19303_length_663_cov_10.377660	300	380	2	2	80	0.0250000
NODE_19303_length_663_cov_10.377660	300	380	6	1	80	0.0125000
NODE_19303_length_663_cov_10.377660	300	380	8	3	80	0.0375000
NODE_19303_length_663_cov_10.377660	300	380	10	6	80	0.0750000
NODE_19303_length_663_cov_10.377660	300	380	12	1	80	0.0125000
NODE_19303_length_663_cov_10.377660	300	380	14	20	80	0.2500000
NODE_19303_length_663_cov_10.377660	300	380	16	15	80	0.1875000
NODE_19303_length_663_cov_10.377660	300	380	18	32	80	0.4000000
NODE_19304_length_663_cov_9.549645	199	279	2	80	80	1.0000000
NODE_19304_length_663_cov_9.549645	252	332	0	37	80	0.4625000
NODE_19304_length_663_cov_9.549645	252	332	2	43	80	0.5375000
NODE_19305_length_663_cov_7.397163	151	231	0	1	80	0.0125000
NODE_19305_length_663_cov_7.397163	151	231	1	33	80	0.4125000
NODE_19305_length_663_cov_7.397163	151	231	2	24	80	0.3000000
NODE_19305_length_663_cov_7.397163	151	231	3	5	80	0.0625000
NODE_19305_length_663_cov_7.397163	151	231	4	17	80	0.2125000
NODE_19305_length_663_cov_7.397163	204	284	1	11	80	0.1375000
NODE_19305_length_663_cov_7.397163	204	284	2	69	80	0.8625000
NODE_19307_length_663_cov_5.081560	317	397	0	12	80	0.1500000
NODE_19307_length_663_cov_5.081560	317	397	2	68	80	0.8500000
NODE_19368_length_662_cov_29.218472	233	313	2	16	80	0.2000000
NODE_19368_length_662_cov_29.218472	233	313	4	26	80	0.3250000
NODE_19368_length_662_cov_29.218472	233	313	6	27	80	0.3375000
NODE_19368_length_662_cov_29.218472	233	313	8	6	80	0.0750000
NODE_19368_length_662_cov_29.218472	233	313	12	5	80	0.0625000
NODE_19368_length_662_cov_29.218472	286	366	6	16	80	0.2000000
NODE_19368_length_662_cov_29.218472	286	366	8	6	80	0.0750000
NODE_19368_length_662_cov_29.218472	286	366	10	34	80	0.4250000
NODE_19368_length_662_cov_29.218472	286	366	12	24	80	0.3000000
NODE_19369_length_662_cov_18.717584	193	273	0	80	80	1.0000000
NODE_19369_length_662_cov_18.717584	246	326	0	80	80	1.0000000
NODE_19370_length_662_cov_16.358792	258	338	0	16	80	0.2000000
NODE_19370_length_662_cov_16.358792	258	338	2	30	80	0.3750000
NODE_19370_length_662_cov_16.358792	258	338	4	34	80	0.4250000
NODE_19370_length_662_cov_16.358792	311	391	4	39	80	0.4875000
NODE_19370_length_662_cov_16.358792	311	391	6	41	80	0.5125000
NODE_19371_length_662_cov_12.845471	259	339	0	80	80	1.0000000
NODE_19371_length_662_cov_12.845471	312	392	0	80	80	1.0000000
NODE_19372_length_662_cov_12.476021	299	379	0	35	80	0.4375000
NODE_19372_length_662_cov_12.476021	299	379	2	45	80	0.5625000
NODE_19372_length_662_cov_12.476021	352	432	0	80	80	1.0000000
NODE_19373_length_662_cov_10.252220	239	319	0	80	80	1.0000000
NODE_19373_length_662_cov_10.252220	292	372	0	80	80	1.0000000
NODE_19376_length_662_cov_6.335702	267	347	0	26	80	0.3250000
NODE_19376_length_662_cov_6.335702	267	347	2	54	80	0.6750000
NODE_19376_length_662_cov_6.335702	320	400	2	80	80	1.0000000
NODE_19378_length_662_cov_5.738899	295	331	0	16	36	0.4444444
NODE_19378_length_662_cov_5.738899	295	331	2	20	36	0.5555556
NODE_19378_length_662_cov_5.738899	301	322	0	7	21	0.3333333
NODE_19378_length_662_cov_5.738899	301	322	2	14	21	0.6666667
NODE_19402_length_662_cov_1.905861	150	230	0	80	80	1.0000000
NODE_19402_length_662_cov_1.905861	203	277	0	74	74	1.0000000
NODE_19441_length_661_cov_55.176157	236	316	6	33	80	0.4125000
NODE_19441_length_661_cov_55.176157	236	316	8	47	80	0.5875000
NODE_19441_length_661_cov_55.176157	289	369	0	42	80	0.5250000
NODE_19441_length_661_cov_55.176157	289	369	3	2	80	0.0250000
NODE_19441_length_661_cov_55.176157	289	369	6	36	80	0.4500000
NODE_19442_length_661_cov_38.501779	231	311	0	80	80	1.0000000
NODE_19442_length_661_cov_38.501779	284	364	0	80	80	1.0000000
NODE_19442_length_661_cov_38.501779	360	440	0	15	80	0.1875000
NODE_19442_length_661_cov_38.501779	360	440	2	65	80	0.8125000
NODE_19442_length_661_cov_38.501779	413	493	2	72	80	0.9000000
NODE_19442_length_661_cov_38.501779	413	493	4	8	80	0.1000000
NODE_19443_length_661_cov_31.460854	128	208	0	80	80	1.0000000
NODE_19443_length_661_cov_31.460854	181	261	0	80	80	1.0000000
NODE_19444_length_661_cov_18.960854	216	296	0	80	80	1.0000000
NODE_19444_length_661_cov_18.960854	269	349	0	80	80	1.0000000
NODE_19445_length_661_cov_16.035587	201	281	0	80	80	1.0000000
NODE_19445_length_661_cov_16.035587	254	334	0	80	80	1.0000000
NODE_19447_length_661_cov_13.005338	281	343	0	62	62	1.0000000
NODE_19447_length_661_cov_13.005338	353	433	0	80	80	1.0000000
NODE_19447_length_661_cov_13.005338	406	486	0	80	80	1.0000000
NODE_19452_length_661_cov_5.670819	374	454	2	80	80	1.0000000
NODE_19452_length_661_cov_5.670819	427	507	0	21	80	0.2625000
NODE_19452_length_661_cov_5.670819	427	507	2	59	80	0.7375000
NODE_19457_length_661_cov_4.601423	319	395	0	46	76	0.6052632
NODE_19457_length_661_cov_4.601423	319	395	2	18	76	0.2368421
NODE_19457_length_661_cov_4.601423	319	395	4	12	76	0.1578947
NODE_19459_length_661_cov_3.532028	282	362	0	24	80	0.3000000
NODE_19459_length_661_cov_3.532028	282	362	1	30	80	0.3750000
NODE_19459_length_661_cov_3.532028	282	362	2	26	80	0.3250000
NODE_19459_length_661_cov_3.532028	335	415	0	77	80	0.9625000
NODE_19459_length_661_cov_3.532028	335	415	1	3	80	0.0375000
NODE_19515_length_660_cov_20.741533	343	423	2	9	80	0.1125000
NODE_19515_length_660_cov_20.741533	343	423	16	8	80	0.1000000
NODE_19515_length_660_cov_20.741533	343	423	20	27	80	0.3375000
NODE_19515_length_660_cov_20.741533	343	423	22	36	80	0.4500000
NODE_19515_length_660_cov_20.741533	396	476	13	18	80	0.2250000
NODE_19515_length_660_cov_20.741533	396	476	15	10	80	0.1250000
NODE_19515_length_660_cov_20.741533	396	476	19	13	80	0.1625000
NODE_19515_length_660_cov_20.741533	396	476	20	12	80	0.1500000
NODE_19515_length_660_cov_20.741533	396	476	22	27	80	0.3375000
NODE_19516_length_660_cov_15.089127	148	228	0	80	80	1.0000000
NODE_19516_length_660_cov_15.089127	201	281	0	80	80	1.0000000
NODE_19518_length_660_cov_13.301248	276	356	0	80	80	1.0000000
NODE_19518_length_660_cov_13.301248	329	409	0	80	80	1.0000000
NODE_19519_length_660_cov_12.393939	234	314	0	80	80	1.0000000
NODE_19519_length_660_cov_12.393939	287	367	0	80	80	1.0000000
NODE_19521_length_660_cov_11.495544	399	479	0	80	80	1.0000000
NODE_19521_length_660_cov_11.495544	452	532	0	80	80	1.0000000
NODE_19522_length_660_cov_10.522282	177	257	0	80	80	1.0000000
NODE_19522_length_660_cov_10.522282	230	311	0	81	81	1.0000000
NODE_19524_length_660_cov_8.887701	254	325	2	71	71	1.0000000
NODE_19527_length_660_cov_7.278075	225	305	0	80	80	1.0000000
NODE_19527_length_660_cov_7.278075	278	358	0	80	80	1.0000000
NODE_19529_length_660_cov_6.577540	350	430	2	74	80	0.9250000
NODE_19529_length_660_cov_6.577540	350	430	4	6	80	0.0750000
NODE_19529_length_660_cov_6.577540	403	483	2	57	80	0.7125000
NODE_19529_length_660_cov_6.577540	403	483	4	23	80	0.2875000
NODE_19549_length_660_cov_2.354724	421	470	4	34	49	0.6938776
NODE_19549_length_660_cov_2.354724	421	470	6	15	49	0.3061225
NODE_19594_length_659_cov_43.587500	2	82	0	80	80	1.0000000
NODE_19594_length_659_cov_43.587500	55	135	0	80	80	1.0000000
NODE_19594_length_659_cov_43.587500	131	211	0	80	80	1.0000000
NODE_19594_length_659_cov_43.587500	184	264	0	80	80	1.0000000
NODE_19595_length_659_cov_23.330357	236	316	0	6	80	0.0750000
NODE_19595_length_659_cov_23.330357	236	316	2	20	80	0.2500000
NODE_19595_length_659_cov_23.330357	236	316	3	54	80	0.6750000
NODE_19595_length_659_cov_23.330357	289	369	2	26	80	0.3250000
NODE_19595_length_659_cov_23.330357	289	369	3	54	80	0.6750000
NODE_19596_length_659_cov_12.775000	255	335	1	22	80	0.2750000
NODE_19596_length_659_cov_12.775000	255	335	3	5	80	0.0625000
NODE_19596_length_659_cov_12.775000	255	335	5	41	80	0.5125000
NODE_19596_length_659_cov_12.775000	255	335	6	12	80	0.1500000
NODE_19596_length_659_cov_12.775000	308	388	5	17	80	0.2125000
NODE_19596_length_659_cov_12.775000	308	388	6	63	80	0.7875000
NODE_19598_length_659_cov_9.683929	220	298	0	78	78	1.0000000
NODE_19598_length_659_cov_9.683929	271	351	0	80	80	1.0000000
NODE_19613_length_659_cov_3.658929	305	385	0	57	80	0.7125000
NODE_19613_length_659_cov_3.658929	305	385	2	23	80	0.2875000
NODE_19613_length_659_cov_3.658929	358	438	0	16	80	0.2000000
NODE_19613_length_659_cov_3.658929	358	438	2	64	80	0.8000000
NODE_19678_length_658_cov_38.479428	289	369	0	61	80	0.7625000
NODE_19678_length_658_cov_38.479428	289	369	2	19	80	0.2375000
NODE_19678_length_658_cov_38.479428	342	422	0	8	80	0.1000000
NODE_19678_length_658_cov_38.479428	342	422	2	72	80	0.9000000
NODE_19679_length_658_cov_35.409660	242	322	8	16	80	0.2000000
NODE_19679_length_658_cov_35.409660	242	322	10	8	80	0.1000000
NODE_19679_length_658_cov_35.409660	242	322	12	56	80	0.7000000
NODE_19679_length_658_cov_35.409660	295	375	0	36	80	0.4500000
NODE_19679_length_658_cov_35.409660	295	375	2	6	80	0.0750000
NODE_19679_length_658_cov_35.409660	295	375	8	21	80	0.2625000
NODE_19679_length_658_cov_35.409660	295	375	12	17	80	0.2125000
NODE_19680_length_658_cov_20.322004	191	271	0	22	80	0.2750000
NODE_19680_length_658_cov_20.322004	191	271	2	58	80	0.7250000
NODE_19680_length_658_cov_20.322004	244	321	0	72	77	0.9350649
NODE_19680_length_658_cov_20.322004	244	321	2	5	77	0.0649351
NODE_19680_length_658_cov_20.322004	317	397	0	80	80	1.0000000
NODE_19680_length_658_cov_20.322004	370	449	0	79	79	1.0000000
NODE_19681_length_658_cov_11.352415	324	404	0	80	80	1.0000000
NODE_19681_length_658_cov_11.352415	377	457	0	80	80	1.0000000
NODE_19685_length_658_cov_8.241503	227	307	0	54	80	0.6750000
NODE_19685_length_658_cov_8.241503	227	307	2	26	80	0.3250000
NODE_19685_length_658_cov_8.241503	280	360	0	1	80	0.0125000
NODE_19685_length_658_cov_8.241503	280	360	2	79	80	0.9875000
NODE_19689_length_658_cov_5.477639	450	530	2	37	80	0.4625000
NODE_19689_length_658_cov_5.477639	450	530	4	43	80	0.5375000
NODE_19705_length_658_cov_2.277281	286	366	0	80	80	1.0000000
NODE_19705_length_658_cov_2.277281	339	419	0	67	80	0.8375000
NODE_19705_length_658_cov_2.277281	339	419	1	13	80	0.1625000
NODE_19750_length_657_cov_71.087814	306	372	0	66	66	1.0000000
NODE_19750_length_657_cov_71.087814	382	462	0	3	80	0.0375000
NODE_19750_length_657_cov_71.087814	382	462	2	11	80	0.1375000
NODE_19750_length_657_cov_71.087814	382	462	3	1	80	0.0125000
NODE_19750_length_657_cov_71.087814	382	462	4	4	80	0.0500000
NODE_19750_length_657_cov_71.087814	382	462	6	2	80	0.0250000
NODE_19750_length_657_cov_71.087814	382	462	12	59	80	0.7375000
NODE_19750_length_657_cov_71.087814	382	462	0	3	80	0.0375000
NODE_19750_length_657_cov_71.087814	382	462	2	11	80	0.1375000
NODE_19750_length_657_cov_71.087814	382	462	3	1	80	0.0125000
NODE_19750_length_657_cov_71.087814	382	462	4	4	80	0.0500000
NODE_19750_length_657_cov_71.087814	382	462	6	2	80	0.0250000
NODE_19750_length_657_cov_71.087814	382	462	12	59	80	0.7375000
NODE_19750_length_657_cov_71.087814	435	515	0	17	80	0.2125000
NODE_19750_length_657_cov_71.087814	435	515	2	3	80	0.0375000
NODE_19750_length_657_cov_71.087814	435	515	4	4	80	0.0500000
NODE_19750_length_657_cov_71.087814	435	515	8	14	80	0.1750000
NODE_19750_length_657_cov_71.087814	435	515	12	42	80	0.5250000
NODE_19750_length_657_cov_71.087814	440	515	0	17	75	0.2266667
NODE_19750_length_657_cov_71.087814	440	515	2	3	75	0.0400000
NODE_19750_length_657_cov_71.087814	440	515	4	4	75	0.0533333
NODE_19750_length_657_cov_71.087814	440	515	8	14	75	0.1866667
NODE_19750_length_657_cov_71.087814	440	515	12	37	75	0.4933333
NODE_19751_length_657_cov_67.408602	98	178	0	27	80	0.3375000
NODE_19751_length_657_cov_67.408602	98	178	2	53	80	0.6625000
NODE_19751_length_657_cov_67.408602	151	231	0	80	80	1.0000000
NODE_19752_length_657_cov_15.568100	265	345	0	80	80	1.0000000
NODE_19752_length_657_cov_15.568100	341	421	0	80	80	1.0000000
NODE_19759_length_657_cov_5.161290	185	256	0	71	71	1.0000000
NODE_19759_length_657_cov_5.161290	229	309	0	80	80	1.0000000
NODE_19824_length_656_cov_37.023339	470	550	2	38	80	0.4750000
NODE_19824_length_656_cov_37.023339	470	550	4	42	80	0.5250000
NODE_19824_length_656_cov_37.023339	523	603	0	11	80	0.1375000
NODE_19824_length_656_cov_37.023339	523	603	1	28	80	0.3500000
NODE_19824_length_656_cov_37.023339	523	603	2	41	80	0.5125000
NODE_19825_length_656_cov_22.804309	173	253	8	13	80	0.1625000
NODE_19825_length_656_cov_22.804309	173	253	10	37	80	0.4625000
NODE_19825_length_656_cov_22.804309	173	253	12	2	80	0.0250000
NODE_19825_length_656_cov_22.804309	173	253	14	28	80	0.3500000
NODE_19825_length_656_cov_22.804309	226	306	4	8	80	0.1000000
NODE_19825_length_656_cov_22.804309	226	306	6	33	80	0.4125000
NODE_19825_length_656_cov_22.804309	226	306	14	39	80	0.4875000
NODE_19826_length_656_cov_19.280072	345	425	0	80	80	1.0000000
NODE_19826_length_656_cov_19.280072	398	478	0	80	80	1.0000000
NODE_19827_length_656_cov_18.267504	272	352	0	13	80	0.1625000
NODE_19827_length_656_cov_18.267504	272	352	2	67	80	0.8375000
NODE_19827_length_656_cov_18.267504	325	405	0	23	80	0.2875000
NODE_19827_length_656_cov_18.267504	325	405	2	57	80	0.7125000
NODE_19828_length_656_cov_15.928187	223	303	0	80	80	1.0000000
NODE_19829_length_656_cov_15.091562	297	377	0	80	80	1.0000000
NODE_19829_length_656_cov_15.091562	350	430	0	80	80	1.0000000
NODE_19830_length_656_cov_12.773788	269	349	0	22	80	0.2750000
NODE_19830_length_656_cov_12.773788	269	349	2	11	80	0.1375000
NODE_19830_length_656_cov_12.773788	269	349	4	47	80	0.5875000
NODE_19830_length_656_cov_12.773788	322	399	0	17	77	0.2207792
NODE_19830_length_656_cov_12.773788	322	399	2	1	77	0.0129870
NODE_19830_length_656_cov_12.773788	322	399	4	59	77	0.7662337
NODE_19831_length_656_cov_12.493716	212	292	2	2	80	0.0250000
NODE_19831_length_656_cov_12.493716	212	292	4	78	80	0.9750000
NODE_19831_length_656_cov_12.493716	265	345	0	2	80	0.0250000
NODE_19831_length_656_cov_12.493716	265	345	2	45	80	0.5625000
NODE_19831_length_656_cov_12.493716	265	345	4	33	80	0.4125000
NODE_19832_length_656_cov_10.946140	197	277	2	80	80	1.0000000
NODE_19832_length_656_cov_10.946140	250	330	0	12	80	0.1500000
NODE_19832_length_656_cov_10.946140	250	330	2	68	80	0.8500000
NODE_19833_length_656_cov_9.412926	295	375	0	80	80	1.0000000
NODE_19833_length_656_cov_9.412926	348	428	0	80	80	1.0000000
NODE_19904_length_655_cov_31.019784	212	292	2	2	80	0.0250000
NODE_19904_length_655_cov_31.019784	212	292	4	26	80	0.3250000
NODE_19904_length_655_cov_31.019784	212	292	6	9	80	0.1125000
NODE_19904_length_655_cov_31.019784	212	292	8	43	80	0.5375000
NODE_19904_length_655_cov_31.019784	265	345	0	15	80	0.1875000
NODE_19904_length_655_cov_31.019784	265	345	2	40	80	0.5000000
NODE_19904_length_655_cov_31.019784	265	345	4	25	80	0.3125000
NODE_19907_length_655_cov_8.672662	216	296	0	43	80	0.5375000
NODE_19907_length_655_cov_8.672662	216	296	2	37	80	0.4625000
NODE_19907_length_655_cov_8.672662	269	349	0	80	80	1.0000000
NODE_19908_length_655_cov_8.250000	204	234	0	30	30	1.0000000
NODE_19909_length_655_cov_7.910072	366	446	0	80	80	1.0000000
NODE_19909_length_655_cov_7.910072	419	499	0	80	80	1.0000000
NODE_19916_length_655_cov_5.478417	178	255	0	77	77	1.0000000
NODE_19916_length_655_cov_5.478417	178	221	0	43	43	1.0000000
NODE_19919_length_655_cov_5.174460	347	428	2	49	81	0.6049383
NODE_19919_length_655_cov_5.174460	347	428	6	32	81	0.3950617
NODE_19919_length_655_cov_5.174460	401	481	0	50	80	0.6250000
NODE_19919_length_655_cov_5.174460	401	481	2	30	80	0.3750000
NODE_19979_length_654_cov_17.086486	323	403	0	80	80	1.0000000
NODE_19979_length_654_cov_17.086486	376	456	0	80	80	1.0000000
NODE_19980_length_654_cov_16.194595	318	398	0	10	80	0.1250000
NODE_19980_length_654_cov_16.194595	318	398	2	70	80	0.8750000
NODE_19980_length_654_cov_16.194595	371	451	0	63	80	0.7875000
NODE_19980_length_654_cov_16.194595	371	451	2	17	80	0.2125000
NODE_19983_length_654_cov_5.556757	341	412	0	71	71	1.0000000
NODE_19990_length_654_cov_3.236036	105	181	0	76	76	1.0000000
NODE_19990_length_654_cov_3.236036	158	236	0	78	78	1.0000000
NODE_19998_length_654_cov_2.549550	279	366	0	60	87	0.6896552
NODE_19998_length_654_cov_2.549550	279	366	2	27	87	0.3103448
NODE_20013_length_654_cov_1.790991	480	560	0	1	80	0.0125000
NODE_20013_length_654_cov_1.790991	480	560	2	1	80	0.0125000
NODE_20013_length_654_cov_1.790991	480	560	4	78	80	0.9750000
NODE_20044_length_653_cov_70.296029	277	357	2	4	80	0.0500000
NODE_20044_length_653_cov_70.296029	277	357	8	40	80	0.5000000
NODE_20044_length_653_cov_70.296029	277	357	10	9	80	0.1125000
NODE_20044_length_653_cov_70.296029	277	357	11	12	80	0.1500000
NODE_20044_length_653_cov_70.296029	277	357	13	11	80	0.1375000
NODE_20044_length_653_cov_70.296029	277	357	15	4	80	0.0500000
NODE_20044_length_653_cov_70.296029	330	410	4	25	80	0.3125000
NODE_20044_length_653_cov_70.296029	330	410	6	21	80	0.2625000
NODE_20044_length_653_cov_70.296029	330	410	11	12	80	0.1500000
NODE_20044_length_653_cov_70.296029	330	410	13	18	80	0.2250000
NODE_20044_length_653_cov_70.296029	330	410	15	4	80	0.0500000
NODE_20045_length_653_cov_28.072202	302	382	0	80	80	1.0000000
NODE_20045_length_653_cov_28.072202	355	435	0	80	80	1.0000000
NODE_20046_length_653_cov_18.382671	214	294	0	38	80	0.4750000
NODE_20046_length_653_cov_18.382671	214	294	2	42	80	0.5250000
NODE_20046_length_653_cov_18.382671	267	347	0	17	80	0.2125000
NODE_20046_length_653_cov_18.382671	267	347	2	63	80	0.7875000
NODE_20047_length_653_cov_8.821300	292	372	0	80	80	1.0000000
NODE_20047_length_653_cov_8.821300	345	425	0	80	80	1.0000000
NODE_20048_length_653_cov_8.660650	200	280	0	80	80	1.0000000
NODE_20048_length_653_cov_8.660650	253	333	0	80	80	1.0000000
NODE_20052_length_653_cov_5.777978	308	383	0	52	75	0.6933333
NODE_20052_length_653_cov_5.777978	308	383	12	23	75	0.3066667
NODE_20052_length_653_cov_5.777978	361	435	12	74	74	1.0000000
NODE_20054_length_653_cov_5.193141	304	356	0	52	52	1.0000000
NODE_20058_length_653_cov_4.823105	178	251	0	1	73	0.0136986
NODE_20058_length_653_cov_4.823105	178	251	2	29	73	0.3972603
NODE_20058_length_653_cov_4.823105	178	251	4	2	73	0.0273973
NODE_20058_length_653_cov_4.823105	178	251	6	6	73	0.0821918
NODE_20058_length_653_cov_4.823105	178	251	8	35	73	0.4794520
NODE_20058_length_653_cov_4.823105	178	256	0	1	78	0.0128205
NODE_20058_length_653_cov_4.823105	178	256	2	29	78	0.3717949
NODE_20058_length_653_cov_4.823105	178	256	4	2	78	0.0256410
NODE_20058_length_653_cov_4.823105	178	256	6	6	78	0.0769231
NODE_20058_length_653_cov_4.823105	178	256	8	40	78	0.5128205
NODE_20058_length_653_cov_4.823105	229	309	3	17	80	0.2125000
NODE_20058_length_653_cov_4.823105	229	309	4	14	80	0.1750000
NODE_20058_length_653_cov_4.823105	229	309	5	2	80	0.0250000
NODE_20058_length_653_cov_4.823105	229	309	6	10	80	0.1250000
NODE_20058_length_653_cov_4.823105	229	309	8	37	80	0.4625000
NODE_20058_length_653_cov_4.823105	229	309	3	17	80	0.2125000
NODE_20058_length_653_cov_4.823105	229	309	4	14	80	0.1750000
NODE_20058_length_653_cov_4.823105	229	309	5	2	80	0.0250000
NODE_20058_length_653_cov_4.823105	229	309	6	10	80	0.1250000
NODE_20058_length_653_cov_4.823105	229	309	8	37	80	0.4625000
NODE_20058_length_653_cov_4.823105	239	309	3	17	70	0.2428571
NODE_20058_length_653_cov_4.823105	239	309	4	14	70	0.2000000
NODE_20058_length_653_cov_4.823105	239	309	5	2	70	0.0285714
NODE_20058_length_653_cov_4.823105	239	309	6	10	70	0.1428571
NODE_20058_length_653_cov_4.823105	239	309	8	27	70	0.3857143
NODE_20127_length_652_cov_215.211573	185	248	9	14	63	0.2222222
NODE_20127_length_652_cov_215.211573	185	248	11	3	63	0.0476190
NODE_20127_length_652_cov_215.211573	185	248	12	1	63	0.0158730
NODE_20127_length_652_cov_215.211573	185	248	14	1	63	0.0158730
NODE_20127_length_652_cov_215.211573	185	248	16	2	63	0.0317460
NODE_20127_length_652_cov_215.211573	185	248	17	27	63	0.4285714
NODE_20127_length_652_cov_215.211573	185	248	19	4	63	0.0634921
NODE_20127_length_652_cov_215.211573	185	248	21	11	63	0.1746032
NODE_20127_length_652_cov_215.211573	221	301	17	12	80	0.1500000
NODE_20127_length_652_cov_215.211573	221	301	19	6	80	0.0750000
NODE_20127_length_652_cov_215.211573	221	301	21	18	80	0.2250000
NODE_20127_length_652_cov_215.211573	221	301	23	25	80	0.3125000
NODE_20127_length_652_cov_215.211573	221	301	25	16	80	0.2000000
NODE_20127_length_652_cov_215.211573	221	301	26	1	80	0.0125000
NODE_20127_length_652_cov_215.211573	221	301	27	2	80	0.0250000
NODE_20128_length_652_cov_21.267631	299	379	0	80	80	1.0000000
NODE_20128_length_652_cov_21.267631	352	432	0	80	80	1.0000000
NODE_20138_length_652_cov_4.622061	266	315	0	49	49	1.0000000
NODE_20138_length_652_cov_4.622061	288	368	0	80	80	1.0000000
NODE_20210_length_651_cov_49.981884	425	505	7	16	80	0.2000000
NODE_20210_length_651_cov_49.981884	425	505	8	9	80	0.1125000
NODE_20210_length_651_cov_49.981884	425	505	9	32	80	0.4000000
NODE_20210_length_651_cov_49.981884	425	505	10	17	80	0.2125000
NODE_20210_length_651_cov_49.981884	425	505	11	6	80	0.0750000
NODE_20210_length_651_cov_49.981884	425	505	7	16	80	0.2000000
NODE_20210_length_651_cov_49.981884	425	505	8	9	80	0.1125000
NODE_20210_length_651_cov_49.981884	425	505	9	32	80	0.4000000
NODE_20210_length_651_cov_49.981884	425	505	10	17	80	0.2125000
NODE_20210_length_651_cov_49.981884	425	505	11	6	80	0.0750000
NODE_20210_length_651_cov_49.981884	425	505	7	16	80	0.2000000
NODE_20210_length_651_cov_49.981884	425	505	8	9	80	0.1125000
NODE_20210_length_651_cov_49.981884	425	505	9	32	80	0.4000000
NODE_20210_length_651_cov_49.981884	425	505	10	17	80	0.2125000
NODE_20210_length_651_cov_49.981884	425	505	11	6	80	0.0750000
NODE_20210_length_651_cov_49.981884	425	505	7	16	80	0.2000000
NODE_20210_length_651_cov_49.981884	425	505	8	9	80	0.1125000
NODE_20210_length_651_cov_49.981884	425	505	9	32	80	0.4000000
NODE_20210_length_651_cov_49.981884	425	505	10	17	80	0.2125000
NODE_20210_length_651_cov_49.981884	425	505	11	6	80	0.0750000
NODE_20210_length_651_cov_49.981884	478	540	5	6	62	0.0967742
NODE_20210_length_651_cov_49.981884	478	540	7	22	62	0.3548387
NODE_20210_length_651_cov_49.981884	478	540	8	27	62	0.4354839
NODE_20210_length_651_cov_49.981884	478	540	9	7	62	0.1129032
NODE_20210_length_651_cov_49.981884	478	540	5	6	62	0.0967742
NODE_20210_length_651_cov_49.981884	478	540	7	22	62	0.3548387
NODE_20210_length_651_cov_49.981884	478	540	8	27	62	0.4354839
NODE_20210_length_651_cov_49.981884	478	540	9	7	62	0.1129032
NODE_20210_length_651_cov_49.981884	478	540	5	6	62	0.0967742
NODE_20210_length_651_cov_49.981884	478	540	7	22	62	0.3548387
NODE_20210_length_651_cov_49.981884	478	540	8	27	62	0.4354839
NODE_20210_length_651_cov_49.981884	478	540	9	7	62	0.1129032
NODE_20210_length_651_cov_49.981884	478	542	4	2	64	0.0312500
NODE_20210_length_651_cov_49.981884	478	542	5	6	64	0.0937500
NODE_20210_length_651_cov_49.981884	478	542	7	22	64	0.3437500
NODE_20210_length_651_cov_49.981884	478	542	8	27	64	0.4218750
NODE_20210_length_651_cov_49.981884	478	542	9	7	64	0.1093750
NODE_20211_length_651_cov_36.121377	422	502	2	12	80	0.1500000
NODE_20211_length_651_cov_36.121377	422	502	10	21	80	0.2625000
NODE_20211_length_651_cov_36.121377	422	502	12	22	80	0.2750000
NODE_20211_length_651_cov_36.121377	422	502	14	25	80	0.3125000
NODE_20211_length_651_cov_36.121377	475	555	0	53	80	0.6625000
NODE_20211_length_651_cov_36.121377	475	555	2	12	80	0.1500000
NODE_20211_length_651_cov_36.121377	475	555	10	15	80	0.1875000
NODE_20212_length_651_cov_20.045290	252	332	3	30	80	0.3750000
NODE_20212_length_651_cov_20.045290	252	332	5	2	80	0.0250000
NODE_20212_length_651_cov_20.045290	252	332	6	7	80	0.0875000
NODE_20212_length_651_cov_20.045290	252	332	7	5	80	0.0625000
NODE_20212_length_651_cov_20.045290	252	332	8	36	80	0.4500000
NODE_20212_length_651_cov_20.045290	305	385	5	8	80	0.1000000
NODE_20212_length_651_cov_20.045290	305	385	6	52	80	0.6500000
NODE_20212_length_651_cov_20.045290	305	385	8	20	80	0.2500000
NODE_20213_length_651_cov_12.704710	264	344	0	80	80	1.0000000
NODE_20213_length_651_cov_12.704710	317	397	0	29	80	0.3625000
NODE_20213_length_651_cov_12.704710	317	397	1	21	80	0.2625000
NODE_20213_length_651_cov_12.704710	317	397	3	30	80	0.3750000
NODE_20214_length_651_cov_11.632246	205	285	0	80	80	1.0000000
NODE_20214_length_651_cov_11.632246	258	338	0	80	80	1.0000000
NODE_20215_length_651_cov_10.074275	369	449	0	28	80	0.3500000
NODE_20215_length_651_cov_10.074275	369	449	1	1	80	0.0125000
NODE_20215_length_651_cov_10.074275	369	449	4	7	80	0.0875000
NODE_20215_length_651_cov_10.074275	369	449	6	44	80	0.5500000
NODE_20215_length_651_cov_10.074275	422	502	4	6	80	0.0750000
NODE_20215_length_651_cov_10.074275	422	502	5	1	80	0.0125000
NODE_20215_length_651_cov_10.074275	422	502	6	73	80	0.9125000
NODE_20216_length_651_cov_9.699275	199	279	0	80	80	1.0000000
NODE_20216_length_651_cov_9.699275	252	332	0	80	80	1.0000000
NODE_20219_length_651_cov_8.309783	217	296	0	79	79	1.0000000
NODE_20219_length_651_cov_8.309783	269	349	0	80	80	1.0000000
NODE_20220_length_651_cov_5.621377	148	228	0	80	80	1.0000000
NODE_20220_length_651_cov_5.621377	201	281	0	80	80	1.0000000
NODE_20221_length_651_cov_5.610507	342	422	0	72	80	0.9000000
NODE_20221_length_651_cov_5.610507	342	422	2	8	80	0.1000000
NODE_20221_length_651_cov_5.610507	395	475	0	19	80	0.2375000
NODE_20221_length_651_cov_5.610507	395	475	2	61	80	0.7625000
NODE_20225_length_651_cov_4.246377	299	359	0	55	60	0.9166667
NODE_20225_length_651_cov_4.246377	299	359	2	5	60	0.0833333
NODE_20238_length_651_cov_2.744565	340	421	2	32	81	0.3950617
NODE_20238_length_651_cov_2.744565	340	421	4	49	81	0.6049383
NODE_20252_length_651_cov_2.016304	280	311	0	31	31	1.0000000
NODE_20292_length_650_cov_22.644283	233	313	0	27	80	0.3375000
NODE_20292_length_650_cov_22.644283	233	313	2	32	80	0.4000000
NODE_20292_length_650_cov_22.644283	233	313	4	1	80	0.0125000
NODE_20292_length_650_cov_22.644283	233	313	6	2	80	0.0250000
NODE_20292_length_650_cov_22.644283	233	313	8	18	80	0.2250000
NODE_20292_length_650_cov_22.644283	286	366	0	80	80	1.0000000
NODE_20293_length_650_cov_22.156080	269	349	0	80	80	1.0000000
NODE_20293_length_650_cov_22.156080	322	402	0	80	80	1.0000000
NODE_20294_length_650_cov_20.012704	186	266	0	80	80	1.0000000
NODE_20294_length_650_cov_20.012704	239	319	0	80	80	1.0000000
NODE_20295_length_650_cov_17.626134	52	132	0	80	80	1.0000000
NODE_20295_length_650_cov_17.626134	105	185	0	74	80	0.9250000
NODE_20295_length_650_cov_17.626134	105	185	2	6	80	0.0750000
NODE_20297_length_650_cov_10.687840	289	369	0	80	80	1.0000000
NODE_20297_length_650_cov_10.687840	342	422	0	80	80	1.0000000
NODE_20301_length_650_cov_6.519056	312	365	6	36	53	0.6792453
NODE_20301_length_650_cov_6.519056	312	365	8	2	53	0.0377358
NODE_20301_length_650_cov_6.519056	312	365	10	4	53	0.0754717
NODE_20301_length_650_cov_6.519056	312	365	12	2	53	0.0377358
NODE_20301_length_650_cov_6.519056	312	365	14	9	53	0.1698113
NODE_20301_length_650_cov_6.519056	338	417	6	10	79	0.1265823
NODE_20301_length_650_cov_6.519056	338	417	8	2	79	0.0253165
NODE_20301_length_650_cov_6.519056	338	417	10	13	79	0.1645570
NODE_20301_length_650_cov_6.519056	338	417	12	39	79	0.4936709
NODE_20301_length_650_cov_6.519056	338	417	14	15	79	0.1898734
NODE_20302_length_650_cov_6.159710	243	323	4	52	80	0.6500000
NODE_20302_length_650_cov_6.159710	243	323	6	25	80	0.3125000
NODE_20302_length_650_cov_6.159710	243	323	10	3	80	0.0375000
NODE_20302_length_650_cov_6.159710	296	376	6	78	80	0.9750000
NODE_20302_length_650_cov_6.159710	296	376	10	2	80	0.0250000
NODE_20318_length_650_cov_2.488203	213	266	0	53	53	1.0000000
NODE_20370_length_649_cov_20.780000	111	140	1	6	29	0.2068966
NODE_20370_length_649_cov_20.780000	111	140	3	15	29	0.5172414
NODE_20370_length_649_cov_20.780000	111	140	5	8	29	0.2758621
NODE_20370_length_649_cov_20.780000	111	191	1	6	80	0.0750000
NODE_20370_length_649_cov_20.780000	111	191	3	15	80	0.1875000
NODE_20370_length_649_cov_20.780000	111	191	5	18	80	0.2250000
NODE_20370_length_649_cov_20.780000	111	191	7	41	80	0.5125000
NODE_20370_length_649_cov_20.780000	138	161	5	12	23	0.5217391
NODE_20370_length_649_cov_20.780000	138	161	7	11	23	0.4782609
NODE_20370_length_649_cov_20.780000	138	214	5	12	76	0.1578947
NODE_20370_length_649_cov_20.780000	138	214	7	59	76	0.7763158
NODE_20370_length_649_cov_20.780000	138	214	9	5	76	0.0657895
NODE_20370_length_649_cov_20.780000	164	244	7	69	80	0.8625000
NODE_20370_length_649_cov_20.780000	164	244	9	11	80	0.1375000
NODE_20371_length_649_cov_17.938182	162	242	0	80	80	1.0000000
NODE_20371_length_649_cov_17.938182	215	295	0	80	80	1.0000000
NODE_20372_length_649_cov_16.761818	395	475	2	3	80	0.0375000
NODE_20372_length_649_cov_16.761818	395	475	5	23	80	0.2875000
NODE_20372_length_649_cov_16.761818	395	475	6	54	80	0.6750000
NODE_20372_length_649_cov_16.761818	448	528	0	20	80	0.2500000
NODE_20372_length_649_cov_16.761818	448	528	4	17	80	0.2125000
NODE_20372_length_649_cov_16.761818	448	528	5	39	80	0.4875000
NODE_20372_length_649_cov_16.761818	448	528	6	4	80	0.0500000
NODE_20373_length_649_cov_15.632727	226	306	0	22	80	0.2750000
NODE_20373_length_649_cov_15.632727	226	306	2	16	80	0.2000000
NODE_20373_length_649_cov_15.632727	226	306	4	20	80	0.2500000
NODE_20373_length_649_cov_15.632727	226	306	6	22	80	0.2750000
NODE_20373_length_649_cov_15.632727	279	359	0	42	80	0.5250000
NODE_20373_length_649_cov_15.632727	279	359	2	38	80	0.4750000
NODE_20374_length_649_cov_15.516364	329	409	4	8	80	0.1000000
NODE_20374_length_649_cov_15.516364	329	409	6	14	80	0.1750000
NODE_20374_length_649_cov_15.516364	329	409	8	58	80	0.7250000
NODE_20374_length_649_cov_15.516364	382	462	2	6	80	0.0750000
NODE_20374_length_649_cov_15.516364	382	462	4	11	80	0.1375000
NODE_20374_length_649_cov_15.516364	382	462	6	2	80	0.0250000
NODE_20374_length_649_cov_15.516364	382	462	8	61	80	0.7625000
NODE_20375_length_649_cov_10.374545	453	533	2	80	80	1.0000000
NODE_20375_length_649_cov_10.374545	506	586	0	23	80	0.2875000
NODE_20375_length_649_cov_10.374545	506	586	2	57	80	0.7125000
NODE_20382_length_649_cov_4.403636	213	293	0	80	80	1.0000000
NODE_20382_length_649_cov_4.403636	266	346	0	80	80	1.0000000
NODE_20454_length_648_cov_34.287796	343	423	0	80	80	1.0000000
NODE_20454_length_648_cov_34.287796	396	476	0	80	80	1.0000000
NODE_20454_length_648_cov_34.287796	472	552	0	80	80	1.0000000
NODE_20454_length_648_cov_34.287796	525	605	0	80	80	1.0000000
NODE_20455_length_648_cov_19.433515	259	339	0	21	80	0.2625000
NODE_20455_length_648_cov_19.433515	259	339	2	59	80	0.7375000
NODE_20455_length_648_cov_19.433515	312	392	0	25	80	0.3125000
NODE_20455_length_648_cov_19.433515	312	392	2	55	80	0.6875000
NODE_20457_length_648_cov_8.391621	206	286	0	80	80	1.0000000
NODE_20457_length_648_cov_8.391621	259	339	0	80	80	1.0000000
NODE_20459_length_648_cov_6.573770	293	373	0	45	80	0.5625000
NODE_20459_length_648_cov_6.573770	293	373	2	35	80	0.4375000
NODE_20459_length_648_cov_6.573770	346	426	0	1	80	0.0125000
NODE_20459_length_648_cov_6.573770	346	426	2	79	80	0.9875000
NODE_20460_length_648_cov_6.431694	285	328	0	43	43	1.0000000
NODE_20463_length_648_cov_6.085610	257	337	0	80	80	1.0000000
NODE_20463_length_648_cov_6.085610	310	390	0	80	80	1.0000000
NODE_20483_length_648_cov_2.333333	19	86	0	66	67	0.9850746
NODE_20483_length_648_cov_2.333333	19	86	2	1	67	0.0149254
NODE_20531_length_647_cov_18.489051	295	375	0	42	80	0.5250000
NODE_20531_length_647_cov_18.489051	295	375	1	8	80	0.1000000
NODE_20531_length_647_cov_18.489051	295	375	3	4	80	0.0500000
NODE_20531_length_647_cov_18.489051	295	375	4	26	80	0.3250000
NODE_20531_length_647_cov_18.489051	348	428	3	1	80	0.0125000
NODE_20531_length_647_cov_18.489051	348	428	4	79	80	0.9875000
NODE_20532_length_647_cov_14.677007	286	366	0	34	80	0.4250000
NODE_20532_length_647_cov_14.677007	286	366	2	21	80	0.2625000
NODE_20532_length_647_cov_14.677007	286	366	4	25	80	0.3125000
NODE_20532_length_647_cov_14.677007	339	419	0	19	80	0.2375000
NODE_20532_length_647_cov_14.677007	339	419	2	8	80	0.1000000
NODE_20532_length_647_cov_14.677007	339	419	4	53	80	0.6625000
NODE_20533_length_647_cov_10.895985	231	311	0	80	80	1.0000000
NODE_20533_length_647_cov_10.895985	284	364	0	80	80	1.0000000
NODE_20534_length_647_cov_9.116788	372	452	0	80	80	1.0000000
NODE_20534_length_647_cov_9.116788	425	505	0	80	80	1.0000000
NODE_20536_length_647_cov_6.410584	150	221	0	8	71	0.1126761
NODE_20536_length_647_cov_6.410584	150	221	2	63	71	0.8873239
NODE_20536_length_647_cov_6.410584	194	274	0	61	80	0.7625000
NODE_20536_length_647_cov_6.410584	194	274	2	19	80	0.2375000
NODE_20539_length_647_cov_5.567518	239	319	0	7	80	0.0875000
NODE_20539_length_647_cov_5.567518	239	319	2	10	80	0.1250000
NODE_20539_length_647_cov_5.567518	239	319	4	2	80	0.0250000
NODE_20539_length_647_cov_5.567518	239	319	6	6	80	0.0750000
NODE_20539_length_647_cov_5.567518	239	319	8	2	80	0.0250000
NODE_20539_length_647_cov_5.567518	239	319	10	53	80	0.6625000
NODE_20539_length_647_cov_5.567518	292	355	10	51	63	0.8095238
NODE_20539_length_647_cov_5.567518	292	355	12	9	63	0.1428571
NODE_20539_length_647_cov_5.567518	292	355	14	2	63	0.0317460
NODE_20539_length_647_cov_5.567518	292	355	16	1	63	0.0158730
NODE_20539_length_647_cov_5.567518	348	416	12	62	68	0.9117647
NODE_20539_length_647_cov_5.567518	348	416	14	5	68	0.0735294
NODE_20539_length_647_cov_5.567518	348	416	16	1	68	0.0147059
NODE_20539_length_647_cov_5.567518	401	469	12	68	68	1.0000000
NODE_20544_length_647_cov_3.775547	356	399	0	43	43	1.0000000
NODE_20550_length_647_cov_2.678832	239	319	0	80	80	1.0000000
NODE_20550_length_647_cov_2.678832	292	372	0	80	80	1.0000000
NODE_20561_length_647_cov_1.937956	254	304	2	23	50	0.4600000
NODE_20561_length_647_cov_1.937956	254	304	4	27	50	0.5400000
NODE_20607_length_646_cov_56.226691	267	347	0	74	80	0.9250000
NODE_20607_length_646_cov_56.226691	267	347	2	6	80	0.0750000
NODE_20607_length_646_cov_56.226691	320	400	0	21	80	0.2625000
NODE_20607_length_646_cov_56.226691	320	400	2	59	80	0.7375000
NODE_20608_length_646_cov_23.747715	76	153	0	77	77	1.0000000
NODE_20608_length_646_cov_23.747715	129	209	0	80	80	1.0000000
NODE_20609_length_646_cov_22.740402	326	406	0	1	80	0.0125000
NODE_20609_length_646_cov_22.740402	326	406	2	79	80	0.9875000
NODE_20609_length_646_cov_22.740402	379	459	0	1	80	0.0125000
NODE_20609_length_646_cov_22.740402	379	459	2	79	80	0.9875000
NODE_20610_length_646_cov_15.160878	363	443	0	80	80	1.0000000
NODE_20610_length_646_cov_15.160878	416	496	0	80	80	1.0000000
NODE_20611_length_646_cov_9.429616	309	389	0	80	80	1.0000000
NODE_20611_length_646_cov_9.429616	362	442	0	28	80	0.3500000
NODE_20611_length_646_cov_9.429616	362	442	2	52	80	0.6500000
NODE_20612_length_646_cov_9.246801	149	221	0	72	72	1.0000000
NODE_20613_length_646_cov_7.539305	227	307	0	80	80	1.0000000
NODE_20613_length_646_cov_7.539305	280	360	0	80	80	1.0000000
NODE_20614_length_646_cov_6.756856	236	316	0	80	80	1.0000000
NODE_20614_length_646_cov_6.756856	289	369	0	80	80	1.0000000
NODE_20615_length_646_cov_6.480804	373	437	0	64	64	1.0000000
NODE_20615_length_646_cov_6.480804	410	490	0	55	80	0.6875000
NODE_20615_length_646_cov_6.480804	410	490	2	25	80	0.3125000
NODE_20616_length_646_cov_6.396709	194	274	0	80	80	1.0000000
NODE_20616_length_646_cov_6.396709	254	327	0	73	73	1.0000000
NODE_20619_length_646_cov_4.652651	265	345	0	30	80	0.3750000
NODE_20619_length_646_cov_4.652651	265	345	2	45	80	0.5625000
NODE_20619_length_646_cov_4.652651	265	345	4	5	80	0.0625000
NODE_20623_length_646_cov_4.122486	401	452	2	5	51	0.0980392
NODE_20623_length_646_cov_4.122486	401	452	4	32	51	0.6274510
NODE_20623_length_646_cov_4.122486	401	452	5	10	51	0.1960784
NODE_20623_length_646_cov_4.122486	401	452	7	4	51	0.0784314
NODE_20688_length_645_cov_95.882784	179	259	0	11	80	0.1375000
NODE_20688_length_645_cov_95.882784	179	259	1	57	80	0.7125000
NODE_20688_length_645_cov_95.882784	179	259	3	5	80	0.0625000
NODE_20688_length_645_cov_95.882784	179	259	4	7	80	0.0875000
NODE_20688_length_645_cov_95.882784	232	312	1	15	80	0.1875000
NODE_20688_length_645_cov_95.882784	232	312	2	5	80	0.0625000
NODE_20688_length_645_cov_95.882784	232	312	3	5	80	0.0625000
NODE_20688_length_645_cov_95.882784	232	312	4	55	80	0.6875000
NODE_20689_length_645_cov_12.985348	343	423	0	80	80	1.0000000
NODE_20689_length_645_cov_12.985348	396	476	0	80	80	1.0000000
NODE_20691_length_645_cov_9.228938	254	334	0	80	80	1.0000000
NODE_20691_length_645_cov_9.228938	307	387	0	80	80	1.0000000
NODE_20692_length_645_cov_9.172161	293	373	0	80	80	1.0000000
NODE_20692_length_645_cov_9.172161	346	426	0	80	80	1.0000000
NODE_20697_length_645_cov_5.609890	461	541	0	48	80	0.6000000
NODE_20697_length_645_cov_5.609890	461	541	2	32	80	0.4000000
NODE_20697_length_645_cov_5.609890	514	594	0	12	80	0.1500000
NODE_20697_length_645_cov_5.609890	514	594	2	68	80	0.8500000
NODE_20698_length_645_cov_4.743590	237	317	0	80	80	1.0000000
NODE_20698_length_645_cov_4.743590	290	370	0	80	80	1.0000000
NODE_20716_length_645_cov_2.177656	373	416	0	43	43	1.0000000
NODE_20762_length_644_cov_59.286239	323	401	137	2	78	0.0256410
NODE_20762_length_644_cov_59.286239	323	401	143	1	78	0.0128205
NODE_20762_length_644_cov_59.286239	323	401	145	1	78	0.0128205
NODE_20762_length_644_cov_59.286239	323	401	147	2	78	0.0256410
NODE_20762_length_644_cov_59.286239	323	401	149	2	78	0.0256410
NODE_20762_length_644_cov_59.286239	323	401	153	2	78	0.0256410
NODE_20762_length_644_cov_59.286239	323	401	155	1	78	0.0128205
NODE_20762_length_644_cov_59.286239	323	401	156	2	78	0.0256410
NODE_20762_length_644_cov_59.286239	323	401	158	2	78	0.0256410
NODE_20762_length_644_cov_59.286239	323	401	160	1	78	0.0128205
NODE_20762_length_644_cov_59.286239	323	401	161	2	78	0.0256410
NODE_20762_length_644_cov_59.286239	323	401	170	1	78	0.0128205
NODE_20762_length_644_cov_59.286239	323	401	173	1	78	0.0128205
NODE_20762_length_644_cov_59.286239	323	401	175	2	78	0.0256410
NODE_20762_length_644_cov_59.286239	323	401	181	1	78	0.0128205
NODE_20762_length_644_cov_59.286239	323	401	187	1	78	0.0128205
NODE_20762_length_644_cov_59.286239	323	401	189	1	78	0.0128205
NODE_20762_length_644_cov_59.286239	323	401	196	2	78	0.0256410
NODE_20762_length_644_cov_59.286239	323	401	200	1	78	0.0128205
NODE_20762_length_644_cov_59.286239	323	401	202	1	78	0.0128205
NODE_20762_length_644_cov_59.286239	323	401	204	1	78	0.0128205
NODE_20762_length_644_cov_59.286239	323	401	208	2	78	0.0256410
NODE_20762_length_644_cov_59.286239	323	401	212	2	78	0.0256410
NODE_20762_length_644_cov_59.286239	323	401	218	1	78	0.0128205
NODE_20762_length_644_cov_59.286239	323	401	220	1	78	0.0128205
NODE_20762_length_644_cov_59.286239	323	401	221	1	78	0.0128205
NODE_20762_length_644_cov_59.286239	323	401	223	3	78	0.0384615
NODE_20762_length_644_cov_59.286239	323	401	225	1	78	0.0128205
NODE_20762_length_644_cov_59.286239	323	401	226	1	78	0.0128205
NODE_20762_length_644_cov_59.286239	323	401	231	3	78	0.0384615
NODE_20762_length_644_cov_59.286239	323	401	235	1	78	0.0128205
NODE_20762_length_644_cov_59.286239	323	401	241	1	78	0.0128205
NODE_20762_length_644_cov_59.286239	323	401	244	1	78	0.0128205
NODE_20762_length_644_cov_59.286239	323	401	248	1	78	0.0128205
NODE_20762_length_644_cov_59.286239	323	401	251	1	78	0.0128205
NODE_20762_length_644_cov_59.286239	323	401	254	1	78	0.0128205
NODE_20762_length_644_cov_59.286239	323	401	257	1	78	0.0128205
NODE_20762_length_644_cov_59.286239	323	401	259	1	78	0.0128205
NODE_20762_length_644_cov_59.286239	323	401	263	2	78	0.0256410
NODE_20762_length_644_cov_59.286239	323	401	269	1	78	0.0128205
NODE_20762_length_644_cov_59.286239	323	401	271	2	78	0.0256410
NODE_20762_length_644_cov_59.286239	323	401	275	1	78	0.0128205
NODE_20762_length_644_cov_59.286239	323	401	276	1	78	0.0128205
NODE_20762_length_644_cov_59.286239	323	401	278	2	78	0.0256410
NODE_20762_length_644_cov_59.286239	323	401	283	1	78	0.0128205
NODE_20762_length_644_cov_59.286239	323	401	285	1	78	0.0128205
NODE_20762_length_644_cov_59.286239	323	401	291	2	78	0.0256410
NODE_20762_length_644_cov_59.286239	323	401	293	1	78	0.0128205
NODE_20762_length_644_cov_59.286239	323	401	297	1	78	0.0128205
NODE_20762_length_644_cov_59.286239	323	401	300	1	78	0.0128205
NODE_20762_length_644_cov_59.286239	323	401	306	1	78	0.0128205
NODE_20762_length_644_cov_59.286239	323	401	308	1	78	0.0128205
NODE_20762_length_644_cov_59.286239	323	401	312	1	78	0.0128205
NODE_20762_length_644_cov_59.286239	323	401	316	1	78	0.0128205
NODE_20762_length_644_cov_59.286239	323	401	317	1	78	0.0128205
NODE_20762_length_644_cov_59.286239	323	401	319	3	78	0.0384615
NODE_20762_length_644_cov_59.286239	323	401	320	1	78	0.0128205
NODE_20763_length_644_cov_27.577982	63	143	2	80	80	1.0000000
NODE_20763_length_644_cov_27.577982	116	196	0	23	80	0.2875000
NODE_20763_length_644_cov_27.577982	116	196	2	57	80	0.7125000
NODE_20765_length_644_cov_10.073394	284	364	0	44	80	0.5500000
NODE_20765_length_644_cov_10.073394	284	364	2	36	80	0.4500000
NODE_20765_length_644_cov_10.073394	337	417	0	80	80	1.0000000
NODE_20845_length_643_cov_27.562500	201	281	0	80	80	1.0000000
NODE_20845_length_643_cov_27.562500	254	334	0	80	80	1.0000000
NODE_20845_length_643_cov_27.562500	330	410	0	80	80	1.0000000
NODE_20845_length_643_cov_27.562500	383	463	0	28	80	0.3500000
NODE_20845_length_643_cov_27.562500	383	463	2	52	80	0.6500000
NODE_20846_length_643_cov_12.895221	203	283	0	80	80	1.0000000
NODE_20846_length_643_cov_12.895221	256	336	0	80	80	1.0000000
NODE_20847_length_643_cov_10.501838	280	360	0	16	80	0.2000000
NODE_20847_length_643_cov_10.501838	280	360	2	64	80	0.8000000
NODE_20847_length_643_cov_10.501838	333	413	0	23	80	0.2875000
NODE_20847_length_643_cov_10.501838	333	413	2	57	80	0.7125000
NODE_20848_length_643_cov_9.136029	307	385	2	32	78	0.4102564
NODE_20848_length_643_cov_9.136029	307	385	3	11	78	0.1410256
NODE_20848_length_643_cov_9.136029	307	385	4	15	78	0.1923077
NODE_20848_length_643_cov_9.136029	307	385	5	20	78	0.2564103
NODE_20848_length_643_cov_9.136029	358	438	3	8	80	0.1000000
NODE_20848_length_643_cov_9.136029	358	438	4	52	80	0.6500000
NODE_20848_length_643_cov_9.136029	358	438	5	20	80	0.2500000
NODE_20849_length_643_cov_8.264706	202	282	0	80	80	1.0000000
NODE_20849_length_643_cov_8.264706	255	335	0	80	80	1.0000000
NODE_20851_length_643_cov_7.137868	173	253	0	75	80	0.9375000
NODE_20851_length_643_cov_7.137868	173	253	2	5	80	0.0625000
NODE_20851_length_643_cov_7.137868	226	306	0	22	80	0.2750000
NODE_20851_length_643_cov_7.137868	226	306	2	58	80	0.7250000
NODE_20855_length_643_cov_5.851103	255	335	6	3	80	0.0375000
NODE_20855_length_643_cov_5.851103	255	335	8	4	80	0.0500000
NODE_20855_length_643_cov_5.851103	255	335	14	3	80	0.0375000
NODE_20855_length_643_cov_5.851103	255	335	16	8	80	0.1000000
NODE_20855_length_643_cov_5.851103	255	335	18	11	80	0.1375000
NODE_20855_length_643_cov_5.851103	255	335	20	4	80	0.0500000
NODE_20855_length_643_cov_5.851103	255	335	22	11	80	0.1375000
NODE_20855_length_643_cov_5.851103	255	335	24	7	80	0.0875000
NODE_20855_length_643_cov_5.851103	255	335	26	3	80	0.0375000
NODE_20855_length_643_cov_5.851103	255	335	28	8	80	0.1000000
NODE_20855_length_643_cov_5.851103	255	335	30	5	80	0.0625000
NODE_20855_length_643_cov_5.851103	255	335	32	13	80	0.1625000
NODE_20855_length_643_cov_5.851103	308	388	0	32	80	0.4000000
NODE_20855_length_643_cov_5.851103	308	388	2	16	80	0.2000000
NODE_20855_length_643_cov_5.851103	308	388	4	5	80	0.0625000
NODE_20855_length_643_cov_5.851103	308	388	6	3	80	0.0375000
NODE_20855_length_643_cov_5.851103	308	388	8	4	80	0.0500000
NODE_20855_length_643_cov_5.851103	308	388	14	3	80	0.0375000
NODE_20855_length_643_cov_5.851103	308	388	16	8	80	0.1000000
NODE_20855_length_643_cov_5.851103	308	388	18	9	80	0.1125000
NODE_20869_length_643_cov_3.121324	283	348	1	19	65	0.2923077
NODE_20869_length_643_cov_3.121324	283	348	2	46	65	0.7076923
NODE_20872_length_643_cov_2.806985	387	451	0	64	64	1.0000000
NODE_20942_length_642_cov_36.309392	156	236	0	14	80	0.1750000
NODE_20942_length_642_cov_36.309392	156	236	4	66	80	0.8250000
NODE_20942_length_642_cov_36.309392	209	289	0	28	80	0.3500000
NODE_20942_length_642_cov_36.309392	209	289	4	52	80	0.6500000
NODE_20943_length_642_cov_27.046041	154	234	0	80	80	1.0000000
NODE_20943_length_642_cov_27.046041	207	287	0	80	80	1.0000000
NODE_20944_length_642_cov_26.290976	209	289	0	16	80	0.2000000
NODE_20944_length_642_cov_26.290976	209	289	4	64	80	0.8000000
NODE_20944_length_642_cov_26.290976	262	342	0	42	80	0.5250000
NODE_20944_length_642_cov_26.290976	262	342	4	38	80	0.4750000
NODE_20945_length_642_cov_11.651934	309	389	0	21	80	0.2625000
NODE_20945_length_642_cov_11.651934	309	389	2	59	80	0.7375000
NODE_20945_length_642_cov_11.651934	362	442	0	20	80	0.2500000
NODE_20945_length_642_cov_11.651934	362	442	2	60	80	0.7500000
NODE_20947_length_642_cov_6.692449	453	533	0	33	80	0.4125000
NODE_20947_length_642_cov_6.692449	453	533	2	47	80	0.5875000
NODE_20947_length_642_cov_6.692449	506	586	0	80	80	1.0000000
NODE_20951_length_642_cov_5.933702	260	340	0	80	80	1.0000000
NODE_20951_length_642_cov_5.933702	313	391	0	78	78	1.0000000
NODE_20967_length_642_cov_2.823204	115	158	4	16	43	0.3720930
NODE_20967_length_642_cov_2.823204	115	158	5	1	43	0.0232558
NODE_20967_length_642_cov_2.823204	115	158	6	23	43	0.5348837
NODE_20967_length_642_cov_2.823204	115	158	8	3	43	0.0697674
NODE_20967_length_642_cov_2.823204	245	300	14	5	55	0.0909091
NODE_20967_length_642_cov_2.823204	245	300	16	5	55	0.0909091
NODE_20967_length_642_cov_2.823204	245	300	18	4	55	0.0727273
NODE_20967_length_642_cov_2.823204	245	300	20	9	55	0.1636364
NODE_20967_length_642_cov_2.823204	245	300	22	1	55	0.0181818
NODE_20967_length_642_cov_2.823204	245	300	24	2	55	0.0363636
NODE_20967_length_642_cov_2.823204	245	300	26	3	55	0.0545455
NODE_20967_length_642_cov_2.823204	245	300	27	2	55	0.0363636
NODE_20967_length_642_cov_2.823204	245	300	28	1	55	0.0181818
NODE_20967_length_642_cov_2.823204	245	300	29	12	55	0.2181818
NODE_20967_length_642_cov_2.823204	245	300	30	4	55	0.0727273
NODE_20967_length_642_cov_2.823204	245	300	31	3	55	0.0545455
NODE_20967_length_642_cov_2.823204	245	300	32	4	55	0.0727273
NODE_20967_length_642_cov_2.823204	329	410	12	1	81	0.0123457
NODE_20967_length_642_cov_2.823204	329	410	13	10	81	0.1234568
NODE_20967_length_642_cov_2.823204	329	410	14	2	81	0.0246914
NODE_20967_length_642_cov_2.823204	329	410	15	25	81	0.3086420
NODE_20967_length_642_cov_2.823204	329	410	16	19	81	0.2345679
NODE_20967_length_642_cov_2.823204	329	410	17	19	81	0.2345679
NODE_20967_length_642_cov_2.823204	329	410	18	5	81	0.0617284
NODE_20991_length_642_cov_1.357274	0	75	0	75	75	1.0000000
NODE_21018_length_641_cov_38.675277	284	345	11	4	61	0.0655738
NODE_21018_length_641_cov_38.675277	284	345	12	2	61	0.0327869
NODE_21018_length_641_cov_38.675277	284	345	14	5	61	0.0819672
NODE_21018_length_641_cov_38.675277	284	345	15	12	61	0.1967213
NODE_21018_length_641_cov_38.675277	284	345	16	2	61	0.0327869
NODE_21018_length_641_cov_38.675277	284	345	18	4	61	0.0655738
NODE_21018_length_641_cov_38.675277	284	345	20	15	61	0.2459016
NODE_21018_length_641_cov_38.675277	284	345	26	4	61	0.0655738
NODE_21018_length_641_cov_38.675277	284	345	28	1	61	0.0163934
NODE_21018_length_641_cov_38.675277	284	345	30	1	61	0.0163934
NODE_21018_length_641_cov_38.675277	284	345	32	11	61	0.1803279
NODE_21018_length_641_cov_38.675277	318	369	20	10	51	0.1960784
NODE_21018_length_641_cov_38.675277	318	369	26	4	51	0.0784314
NODE_21018_length_641_cov_38.675277	318	369	28	1	51	0.0196078
NODE_21018_length_641_cov_38.675277	318	369	30	1	51	0.0196078
NODE_21018_length_641_cov_38.675277	318	369	32	35	51	0.6862745
NODE_21019_length_641_cov_15.271218	260	340	0	80	80	1.0000000
NODE_21019_length_641_cov_15.271218	313	393	0	80	80	1.0000000
NODE_21021_length_641_cov_12.584871	363	443	0	80	80	1.0000000
NODE_21021_length_641_cov_12.584871	416	496	0	80	80	1.0000000
NODE_21022_length_641_cov_11.125461	38	118	3	3	80	0.0375000
NODE_21022_length_641_cov_11.125461	38	118	5	63	80	0.7875000
NODE_21022_length_641_cov_11.125461	38	118	6	14	80	0.1750000
NODE_21022_length_641_cov_11.125461	91	171	1	9	80	0.1125000
NODE_21022_length_641_cov_11.125461	91	171	2	25	80	0.3125000
NODE_21022_length_641_cov_11.125461	91	171	4	11	80	0.1375000
NODE_21022_length_641_cov_11.125461	91	171	5	13	80	0.1625000
NODE_21022_length_641_cov_11.125461	91	171	6	22	80	0.2750000
NODE_21025_length_641_cov_7.719557	84	138	0	54	54	1.0000000
NODE_21025_length_641_cov_7.719557	113	193	0	63	80	0.7875000
NODE_21025_length_641_cov_7.719557	113	193	2	17	80	0.2125000
NODE_21026_length_641_cov_7.675277	232	312	0	7	80	0.0875000
NODE_21026_length_641_cov_7.675277	232	312	2	44	80	0.5500000
NODE_21026_length_641_cov_7.675277	232	312	4	29	80	0.3625000
NODE_21026_length_641_cov_7.675277	285	365	0	19	80	0.2375000
NODE_21026_length_641_cov_7.675277	285	365	2	26	80	0.3250000
NODE_21026_length_641_cov_7.675277	285	365	4	35	80	0.4375000
NODE_21027_length_641_cov_7.675277	255	335	4	56	80	0.7000000
NODE_21027_length_641_cov_7.675277	255	335	6	23	80	0.2875000
NODE_21027_length_641_cov_7.675277	255	335	8	1	80	0.0125000
NODE_21027_length_641_cov_7.675277	308	388	2	32	80	0.4000000
NODE_21027_length_641_cov_7.675277	308	388	4	48	80	0.6000000
NODE_21028_length_641_cov_7.627306	262	342	0	37	80	0.4625000
NODE_21028_length_641_cov_7.627306	262	342	2	43	80	0.5375000
NODE_21028_length_641_cov_7.627306	315	395	0	80	80	1.0000000
NODE_21029_length_641_cov_7.282288	247	300	0	50	53	0.9433962
NODE_21029_length_641_cov_7.282288	247	300	4	3	53	0.0566038
NODE_21031_length_641_cov_5.029520	138	218	2	80	80	1.0000000
NODE_21031_length_641_cov_5.029520	191	271	0	43	80	0.5375000
NODE_21031_length_641_cov_5.029520	191	271	2	37	80	0.4625000
NODE_21034_length_641_cov_4.701107	238	282	2	44	44	1.0000000
NODE_21109_length_640_cov_39.676525	524	597	31	5	73	0.0684932
NODE_21109_length_640_cov_39.676525	524	597	33	6	73	0.0821918
NODE_21109_length_640_cov_39.676525	524	597	35	8	73	0.1095890
NODE_21109_length_640_cov_39.676525	524	597	38	2	73	0.0273973
NODE_21109_length_640_cov_39.676525	524	597	44	2	73	0.0273973
NODE_21109_length_640_cov_39.676525	524	597	46	4	73	0.0547945
NODE_21109_length_640_cov_39.676525	524	597	48	2	73	0.0273973
NODE_21109_length_640_cov_39.676525	524	597	49	2	73	0.0273973
NODE_21109_length_640_cov_39.676525	524	597	50	6	73	0.0821918
NODE_21109_length_640_cov_39.676525	524	597	51	1	73	0.0136986
NODE_21109_length_640_cov_39.676525	524	597	53	1	73	0.0136986
NODE_21109_length_640_cov_39.676525	524	597	55	1	73	0.0136986
NODE_21109_length_640_cov_39.676525	524	597	56	4	73	0.0547945
NODE_21109_length_640_cov_39.676525	524	597	58	4	73	0.0547945
NODE_21109_length_640_cov_39.676525	524	597	66	2	73	0.0273973
NODE_21109_length_640_cov_39.676525	524	597	68	4	73	0.0547945
NODE_21109_length_640_cov_39.676525	524	597	69	4	73	0.0547945
NODE_21109_length_640_cov_39.676525	524	597	70	3	73	0.0410959
NODE_21109_length_640_cov_39.676525	524	597	71	6	73	0.0821918
NODE_21109_length_640_cov_39.676525	524	597	73	4	73	0.0547945
NODE_21109_length_640_cov_39.676525	524	597	75	2	73	0.0273973
NODE_21109_length_640_cov_39.676525	564	605	23	1	41	0.0243902
NODE_21109_length_640_cov_39.676525	564	605	25	4	41	0.0975610
NODE_21109_length_640_cov_39.676525	564	605	29	1	41	0.0243902
NODE_21109_length_640_cov_39.676525	564	605	31	7	41	0.1707317
NODE_21109_length_640_cov_39.676525	564	605	33	6	41	0.1463415
NODE_21109_length_640_cov_39.676525	564	605	35	8	41	0.1951219
NODE_21109_length_640_cov_39.676525	564	605	38	2	41	0.0487805
NODE_21109_length_640_cov_39.676525	564	605	44	2	41	0.0487805
NODE_21109_length_640_cov_39.676525	564	605	46	4	41	0.0975610
NODE_21109_length_640_cov_39.676525	564	605	48	2	41	0.0487805
NODE_21109_length_640_cov_39.676525	564	605	49	2	41	0.0487805
NODE_21109_length_640_cov_39.676525	564	605	50	2	41	0.0487805
NODE_21110_length_640_cov_19.578558	273	353	0	40	80	0.5000000
NODE_21110_length_640_cov_19.578558	273	353	2	40	80	0.5000000
NODE_21110_length_640_cov_19.578558	326	406	2	80	80	1.0000000
NODE_21111_length_640_cov_15.717190	178	258	0	80	80	1.0000000
NODE_21111_length_640_cov_15.717190	231	311	0	80	80	1.0000000
NODE_21112_length_640_cov_15.338262	319	399	0	80	80	1.0000000
NODE_21112_length_640_cov_15.338262	372	452	0	80	80	1.0000000
NODE_21113_length_640_cov_9.523105	20	43	0	23	23	1.0000000
NODE_21118_length_640_cov_5.123845	272	335	1	48	63	0.7619048
NODE_21118_length_640_cov_5.123845	272	335	2	15	63	0.2380952
NODE_21121_length_640_cov_4.410351	254	334	0	80	80	1.0000000
NODE_21121_length_640_cov_4.410351	307	387	0	80	80	1.0000000
NODE_21129_length_640_cov_3.406654	244	324	0	80	80	1.0000000
NODE_21140_length_640_cov_2.316081	21	57	0	36	36	1.0000000
NODE_21190_length_639_cov_58.092593	302	377	0	75	75	1.0000000
NODE_21190_length_639_cov_58.092593	350	430	0	80	80	1.0000000
NODE_21191_length_639_cov_32.951852	213	293	0	20	80	0.2500000
NODE_21191_length_639_cov_32.951852	213	293	2	46	80	0.5750000
NODE_21191_length_639_cov_32.951852	213	293	3	1	80	0.0125000
NODE_21191_length_639_cov_32.951852	213	293	4	13	80	0.1625000
NODE_21191_length_639_cov_32.951852	266	346	0	13	80	0.1625000
NODE_21191_length_639_cov_32.951852	266	346	3	1	80	0.0125000
NODE_21191_length_639_cov_32.951852	266	346	4	66	80	0.8250000
NODE_21192_length_639_cov_24.564815	290	370	0	28	80	0.3500000
NODE_21192_length_639_cov_24.564815	290	370	2	52	80	0.6500000
NODE_21192_length_639_cov_24.564815	343	423	0	20	80	0.2500000
NODE_21192_length_639_cov_24.564815	343	423	2	60	80	0.7500000
NODE_21193_length_639_cov_14.448148	288	368	0	80	80	1.0000000
NODE_21193_length_639_cov_14.448148	341	421	0	80	80	1.0000000
NODE_21195_length_639_cov_9.001852	265	345	0	20	80	0.2500000
NODE_21195_length_639_cov_9.001852	265	345	2	34	80	0.4250000
NODE_21195_length_639_cov_9.001852	265	345	4	26	80	0.3250000
NODE_21195_length_639_cov_9.001852	318	398	2	1	80	0.0125000
NODE_21195_length_639_cov_9.001852	318	398	4	79	80	0.9875000
NODE_21197_length_639_cov_8.444444	161	241	0	80	80	1.0000000
NODE_21197_length_639_cov_8.444444	214	294	0	80	80	1.0000000
NODE_21202_length_639_cov_6.283333	157	176	0	19	19	1.0000000
NODE_21207_length_639_cov_4.188889	258	335	0	77	77	1.0000000
NODE_21207_length_639_cov_4.188889	308	354	0	46	46	1.0000000
NODE_21213_length_639_cov_3.448148	126	206	0	39	80	0.4875000
NODE_21213_length_639_cov_3.448148	126	206	2	41	80	0.5125000
NODE_21213_length_639_cov_3.448148	179	259	0	43	80	0.5375000
NODE_21213_length_639_cov_3.448148	179	259	2	37	80	0.4625000
NODE_21223_length_639_cov_2.683333	256	288	4	32	32	1.0000000
NODE_21224_length_639_cov_2.555556	189	240	6	3	51	0.0588235
NODE_21224_length_639_cov_2.555556	189	240	8	10	51	0.1960784
NODE_21224_length_639_cov_2.555556	189	240	12	38	51	0.7450981
NODE_21225_length_639_cov_2.477778	562	635	0	1	73	0.0136986
NODE_21225_length_639_cov_2.477778	562	635	2	12	73	0.1643836
NODE_21225_length_639_cov_2.477778	562	635	4	45	73	0.6164383
NODE_21225_length_639_cov_2.477778	562	635	6	15	73	0.2054795
NODE_21265_length_639_cov_1.179630	542	564	0	22	22	1.0000000
NODE_21269_length_639_cov_1.051852	404	455	2	46	51	0.9019608
NODE_21269_length_639_cov_1.051852	404	455	4	5	51	0.0980392
NODE_21278_length_638_cov_13.018553	273	353	2	1	80	0.0125000
NODE_21278_length_638_cov_13.018553	273	353	4	4	80	0.0500000
NODE_21278_length_638_cov_13.018553	273	353	6	43	80	0.5375000
NODE_21278_length_638_cov_13.018553	273	353	8	4	80	0.0500000
NODE_21278_length_638_cov_13.018553	273	353	10	28	80	0.3500000
NODE_21278_length_638_cov_13.018553	326	406	8	47	80	0.5875000
NODE_21278_length_638_cov_13.018553	326	406	10	33	80	0.4125000
NODE_21279_length_638_cov_12.656772	343	423	0	80	80	1.0000000
NODE_21279_length_638_cov_12.656772	396	476	0	80	80	1.0000000
NODE_21280_length_638_cov_11.877551	298	378	0	32	80	0.4000000
NODE_21280_length_638_cov_11.877551	298	378	2	1	80	0.0125000
NODE_21280_length_638_cov_11.877551	298	378	6	10	80	0.1250000
NODE_21280_length_638_cov_11.877551	298	378	8	28	80	0.3500000
NODE_21280_length_638_cov_11.877551	298	378	10	9	80	0.1125000
NODE_21280_length_638_cov_11.877551	351	431	0	80	80	1.0000000
NODE_21281_length_638_cov_8.779221	330	408	0	78	78	1.0000000
NODE_21281_length_638_cov_8.779221	383	461	0	78	78	1.0000000
NODE_21284_length_638_cov_5.543599	315	395	0	80	80	1.0000000
NODE_21290_length_638_cov_3.966605	307	387	0	80	80	1.0000000
NODE_21301_length_638_cov_2.786642	157	208	0	51	51	1.0000000
NODE_21301_length_638_cov_2.786642	181	261	0	80	80	1.0000000
NODE_21364_length_637_cov_67.157993	285	365	0	15	80	0.1875000
NODE_21364_length_637_cov_67.157993	285	365	2	21	80	0.2625000
NODE_21364_length_637_cov_67.157993	285	365	4	44	80	0.5500000
NODE_21364_length_637_cov_67.157993	338	418	0	13	80	0.1625000
NODE_21364_length_637_cov_67.157993	338	418	2	2	80	0.0250000
NODE_21364_length_637_cov_67.157993	338	418	4	65	80	0.8125000
NODE_21364_length_637_cov_67.157993	414	494	0	80	80	1.0000000
NODE_21364_length_637_cov_67.157993	467	547	0	80	80	1.0000000
NODE_21365_length_637_cov_63.029740	195	275	0	1	80	0.0125000
NODE_21365_length_637_cov_63.029740	195	275	1	16	80	0.2000000
NODE_21365_length_637_cov_63.029740	195	275	2	63	80	0.7875000
NODE_21365_length_637_cov_63.029740	248	328	2	80	80	1.0000000
NODE_21366_length_637_cov_44.923792	53	133	2	9	80	0.1125000
NODE_21366_length_637_cov_44.923792	53	133	4	71	80	0.8875000
NODE_21366_length_637_cov_44.923792	54	133	2	8	79	0.1012658
NODE_21366_length_637_cov_44.923792	54	133	4	71	79	0.8987342
NODE_21366_length_637_cov_44.923792	106	186	0	31	80	0.3875000
NODE_21366_length_637_cov_44.923792	106	186	2	25	80	0.3125000
NODE_21366_length_637_cov_44.923792	106	186	4	24	80	0.3000000
NODE_21366_length_637_cov_44.923792	106	186	0	31	80	0.3875000
NODE_21366_length_637_cov_44.923792	106	186	2	25	80	0.3125000
NODE_21366_length_637_cov_44.923792	106	186	4	24	80	0.3000000
NODE_21366_length_637_cov_44.923792	182	262	0	80	80	1.0000000
NODE_21366_length_637_cov_44.923792	235	315	0	80	80	1.0000000
NODE_21367_length_637_cov_44.193309	193	273	2	46	80	0.5750000
NODE_21367_length_637_cov_44.193309	193	273	6	28	80	0.3500000
NODE_21367_length_637_cov_44.193309	193	273	8	6	80	0.0750000
NODE_21367_length_637_cov_44.193309	246	326	2	5	80	0.0625000
NODE_21367_length_637_cov_44.193309	246	326	6	55	80	0.6875000
NODE_21367_length_637_cov_44.193309	246	326	8	20	80	0.2500000
NODE_21368_length_637_cov_37.855019	215	295	4	54	80	0.6750000
NODE_21368_length_637_cov_37.855019	215	295	6	14	80	0.1750000
NODE_21368_length_637_cov_37.855019	215	295	8	12	80	0.1500000
NODE_21368_length_637_cov_37.855019	268	347	0	6	79	0.0759494
NODE_21368_length_637_cov_37.855019	268	347	2	13	79	0.1645570
NODE_21368_length_637_cov_37.855019	268	347	4	60	79	0.7594936
NODE_21369_length_637_cov_33.957249	332	412	0	80	80	1.0000000
NODE_21369_length_637_cov_33.957249	385	465	0	80	80	1.0000000
NODE_21370_length_637_cov_23.682156	275	355	2	6	80	0.0750000
NODE_21370_length_637_cov_23.682156	275	355	6	8	80	0.1000000
NODE_21370_length_637_cov_23.682156	275	355	8	66	80	0.8250000
NODE_21370_length_637_cov_23.682156	328	408	0	2	80	0.0250000
NODE_21370_length_637_cov_23.682156	328	408	2	57	80	0.7125000
NODE_21370_length_637_cov_23.682156	328	408	6	8	80	0.1000000
NODE_21370_length_637_cov_23.682156	328	408	8	13	80	0.1625000
NODE_21371_length_637_cov_19.676580	267	347	0	33	80	0.4125000
NODE_21371_length_637_cov_19.676580	267	347	2	47	80	0.5875000
NODE_21371_length_637_cov_19.676580	320	400	2	80	80	1.0000000
NODE_21373_length_637_cov_9.182156	226	276	2	9	50	0.1800000
NODE_21373_length_637_cov_9.182156	226	276	4	27	50	0.5400000
NODE_21373_length_637_cov_9.182156	226	276	6	9	50	0.1800000
NODE_21373_length_637_cov_9.182156	226	276	8	5	50	0.1000000
NODE_21373_length_637_cov_9.182156	312	357	0	8	45	0.1777778
NODE_21373_length_637_cov_9.182156	312	357	2	37	45	0.8222222
NODE_21374_length_637_cov_9.078067	276	357	0	36	81	0.4444444
NODE_21374_length_637_cov_9.078067	276	357	2	6	81	0.0740741
NODE_21374_length_637_cov_9.078067	276	357	4	7	81	0.0864198
NODE_21374_length_637_cov_9.078067	276	357	5	32	81	0.3950617
NODE_21374_length_637_cov_9.078067	330	410	0	80	80	1.0000000
NODE_21375_length_637_cov_8.566914	235	315	0	80	80	1.0000000
NODE_21375_length_637_cov_8.566914	288	368	0	80	80	1.0000000
NODE_21378_length_637_cov_6.652416	337	415	0	78	78	1.0000000
NODE_21378_length_637_cov_6.652416	390	472	0	82	82	1.0000000
NODE_21385_length_637_cov_4.522305	284	364	0	80	80	1.0000000
NODE_21385_length_637_cov_4.522305	337	417	0	80	80	1.0000000
NODE_21389_length_637_cov_4.131970	292	370	0	78	78	1.0000000
NODE_21389_length_637_cov_4.131970	343	423	0	80	80	1.0000000
NODE_21457_length_636_cov_19.938547	214	294	0	80	80	1.0000000
NODE_21457_length_636_cov_19.938547	267	347	0	80	80	1.0000000
NODE_21458_length_636_cov_12.283054	295	375	2	69	80	0.8625000
NODE_21458_length_636_cov_12.283054	295	375	4	11	80	0.1375000
NODE_21458_length_636_cov_12.283054	348	428	2	80	80	1.0000000
NODE_21460_length_636_cov_8.312849	346	413	0	33	67	0.4925373
NODE_21460_length_636_cov_8.312849	346	413	2	34	67	0.5074627
NODE_21460_length_636_cov_8.312849	399	479	2	80	80	1.0000000
NODE_21467_length_636_cov_4.324022	185	251	2	25	66	0.3787879
NODE_21467_length_636_cov_4.324022	185	251	4	32	66	0.4848485
NODE_21467_length_636_cov_4.324022	185	251	6	9	66	0.1363636
NODE_21467_length_636_cov_4.324022	224	266	4	18	42	0.4285714
NODE_21467_length_636_cov_4.324022	224	266	6	24	42	0.5714286
NODE_21467_length_636_cov_4.324022	224	264	4	18	40	0.4500000
NODE_21467_length_636_cov_4.324022	224	264	6	22	40	0.5500000
NODE_21539_length_635_cov_45.483209	195	239	143	3	44	0.0681818
NODE_21539_length_635_cov_45.483209	195	239	145	4	44	0.0909091
NODE_21539_length_635_cov_45.483209	195	239	147	5	44	0.1136364
NODE_21539_length_635_cov_45.483209	195	239	148	1	44	0.0227273
NODE_21539_length_635_cov_45.483209	195	239	149	5	44	0.1136364
NODE_21539_length_635_cov_45.483209	195	239	150	2	44	0.0454545
NODE_21539_length_635_cov_45.483209	195	239	152	2	44	0.0454545
NODE_21539_length_635_cov_45.483209	195	239	153	1	44	0.0227273
NODE_21539_length_635_cov_45.483209	195	239	154	10	44	0.2272727
NODE_21539_length_635_cov_45.483209	195	239	155	2	44	0.0454545
NODE_21539_length_635_cov_45.483209	195	239	156	4	44	0.0909091
NODE_21539_length_635_cov_45.483209	195	239	157	5	44	0.1136364
NODE_21539_length_635_cov_45.483209	225	268	98	5	43	0.1162791
NODE_21539_length_635_cov_45.483209	225	268	100	3	43	0.0697674
NODE_21539_length_635_cov_45.483209	225	268	104	1	43	0.0232558
NODE_21539_length_635_cov_45.483209	225	268	110	1	43	0.0232558
NODE_21539_length_635_cov_45.483209	225	268	124	2	43	0.0465116
NODE_21539_length_635_cov_45.483209	225	268	130	1	43	0.0232558
NODE_21539_length_635_cov_45.483209	225	268	132	6	43	0.1395349
NODE_21539_length_635_cov_45.483209	225	268	136	1	43	0.0232558
NODE_21539_length_635_cov_45.483209	225	268	138	1	43	0.0232558
NODE_21539_length_635_cov_45.483209	225	268	142	2	43	0.0465116
NODE_21539_length_635_cov_45.483209	225	268	143	3	43	0.0697674
NODE_21539_length_635_cov_45.483209	225	268	144	5	43	0.1162791
NODE_21539_length_635_cov_45.483209	225	268	145	4	43	0.0930233
NODE_21539_length_635_cov_45.483209	225	268	146	1	43	0.0232558
NODE_21539_length_635_cov_45.483209	225	268	147	3	43	0.0697674
NODE_21539_length_635_cov_45.483209	225	268	149	2	43	0.0465116
NODE_21539_length_635_cov_45.483209	225	268	153	1	43	0.0232558
NODE_21539_length_635_cov_45.483209	225	268	155	1	43	0.0232558
NODE_21539_length_635_cov_45.483209	248	298	57	1	50	0.0200000
NODE_21539_length_635_cov_45.483209	248	298	59	2	50	0.0400000
NODE_21539_length_635_cov_45.483209	248	298	63	2	50	0.0400000
NODE_21539_length_635_cov_45.483209	248	298	67	1	50	0.0200000
NODE_21539_length_635_cov_45.483209	248	298	69	1	50	0.0200000
NODE_21539_length_635_cov_45.483209	248	298	71	3	50	0.0600000
NODE_21539_length_635_cov_45.483209	248	298	73	4	50	0.0800000
NODE_21539_length_635_cov_45.483209	248	298	75	1	50	0.0200000
NODE_21539_length_635_cov_45.483209	248	298	77	5	50	0.1000000
NODE_21539_length_635_cov_45.483209	248	298	79	1	50	0.0200000
NODE_21539_length_635_cov_45.483209	248	298	81	1	50	0.0200000
NODE_21539_length_635_cov_45.483209	248	298	91	1	50	0.0200000
NODE_21539_length_635_cov_45.483209	248	298	95	2	50	0.0400000
NODE_21539_length_635_cov_45.483209	248	298	97	1	50	0.0200000
NODE_21539_length_635_cov_45.483209	248	298	98	6	50	0.1200000
NODE_21539_length_635_cov_45.483209	248	298	99	2	50	0.0400000
NODE_21539_length_635_cov_45.483209	248	298	100	3	50	0.0600000
NODE_21539_length_635_cov_45.483209	248	298	101	1	50	0.0200000
NODE_21539_length_635_cov_45.483209	248	298	104	1	50	0.0200000
NODE_21539_length_635_cov_45.483209	248	298	110	1	50	0.0200000
NODE_21539_length_635_cov_45.483209	248	298	124	2	50	0.0400000
NODE_21539_length_635_cov_45.483209	248	298	130	1	50	0.0200000
NODE_21539_length_635_cov_45.483209	248	298	132	6	50	0.1200000
NODE_21539_length_635_cov_45.483209	248	298	136	1	50	0.0200000
NODE_21541_length_635_cov_23.895522	179	259	0	36	80	0.4500000
NODE_21541_length_635_cov_23.895522	179	259	2	15	80	0.1875000
NODE_21541_length_635_cov_23.895522	179	259	4	29	80	0.3625000
NODE_21541_length_635_cov_23.895522	232	312	4	80	80	1.0000000
NODE_21543_length_635_cov_14.772388	48	128	0	80	80	1.0000000
NODE_21543_length_635_cov_14.772388	101	181	0	80	80	1.0000000
NODE_21549_length_635_cov_6.180970	276	356	0	80	80	1.0000000
NODE_21549_length_635_cov_6.180970	329	409	0	80	80	1.0000000
NODE_21554_length_635_cov_4.421642	442	522	0	80	80	1.0000000
NODE_21560_length_635_cov_2.985075	296	376	23	1	80	0.0125000
NODE_21560_length_635_cov_2.985075	296	376	25	4	80	0.0500000
NODE_21560_length_635_cov_2.985075	296	376	27	1	80	0.0125000
NODE_21560_length_635_cov_2.985075	296	376	29	3	80	0.0375000
NODE_21560_length_635_cov_2.985075	296	376	31	16	80	0.2000000
NODE_21560_length_635_cov_2.985075	296	376	33	17	80	0.2125000
NODE_21560_length_635_cov_2.985075	296	376	35	25	80	0.3125000
NODE_21560_length_635_cov_2.985075	296	376	36	13	80	0.1625000
NODE_21625_length_634_cov_53.315888	349	429	4	16	80	0.2000000
NODE_21625_length_634_cov_53.315888	349	429	8	64	80	0.8000000
NODE_21625_length_634_cov_53.315888	402	482	0	50	80	0.6250000
NODE_21625_length_634_cov_53.315888	402	482	3	1	80	0.0125000
NODE_21625_length_634_cov_53.315888	402	482	4	18	80	0.2250000
NODE_21625_length_634_cov_53.315888	402	482	8	11	80	0.1375000
NODE_21626_length_634_cov_28.530841	156	236	0	23	80	0.2875000
NODE_21626_length_634_cov_28.530841	156	236	2	57	80	0.7125000
NODE_21626_length_634_cov_28.530841	209	289	0	58	80	0.7250000
NODE_21626_length_634_cov_28.530841	209	289	2	22	80	0.2750000
NODE_21627_length_634_cov_19.117757	151	229	0	78	78	1.0000000
NODE_21627_length_634_cov_19.117757	204	268	0	64	64	1.0000000
NODE_21628_length_634_cov_18.762617	84	164	0	4	80	0.0500000
NODE_21628_length_634_cov_18.762617	84	164	2	76	80	0.9500000
NODE_21628_length_634_cov_18.762617	137	217	0	16	80	0.2000000
NODE_21628_length_634_cov_18.762617	137	217	2	64	80	0.8000000
NODE_21629_length_634_cov_18.136449	162	242	0	80	80	1.0000000
NODE_21629_length_634_cov_18.136449	215	295	0	80	80	1.0000000
NODE_21635_length_634_cov_9.988785	508	553	2	45	45	1.0000000
NODE_21636_length_634_cov_9.381308	267	353	8	2	86	0.0232558
NODE_21636_length_634_cov_9.381308	267	353	10	2	86	0.0232558
NODE_21636_length_634_cov_9.381308	267	353	12	1	86	0.0116279
NODE_21636_length_634_cov_9.381308	267	353	14	37	86	0.4302326
NODE_21636_length_634_cov_9.381308	267	353	16	29	86	0.3372093
NODE_21636_length_634_cov_9.381308	267	353	18	15	86	0.1744186
NODE_21636_length_634_cov_9.381308	324	404	0	21	80	0.2625000
NODE_21636_length_634_cov_9.381308	324	404	4	21	80	0.2625000
NODE_21636_length_634_cov_9.381308	324	404	8	1	80	0.0125000
NODE_21636_length_634_cov_9.381308	324	404	10	1	80	0.0125000
NODE_21636_length_634_cov_9.381308	324	404	14	24	80	0.3000000
NODE_21636_length_634_cov_9.381308	324	404	16	11	80	0.1375000
NODE_21636_length_634_cov_9.381308	324	404	18	1	80	0.0125000
NODE_21651_length_634_cov_3.702804	460	532	0	72	72	1.0000000
NODE_21720_length_633_cov_30.076779	180	214	0	34	34	1.0000000
NODE_21720_length_633_cov_30.076779	187	267	0	80	80	1.0000000
NODE_21720_length_633_cov_30.076779	263	343	0	27	80	0.3375000
NODE_21720_length_633_cov_30.076779	263	343	2	53	80	0.6625000
NODE_21720_length_633_cov_30.076779	316	396	2	80	80	1.0000000
NODE_21721_length_633_cov_17.595506	282	362	0	41	80	0.5125000
NODE_21721_length_633_cov_17.595506	282	362	2	39	80	0.4875000
NODE_21721_length_633_cov_17.595506	335	415	2	80	80	1.0000000
NODE_21722_length_633_cov_17.327715	228	308	0	80	80	1.0000000
NODE_21722_length_633_cov_17.327715	281	361	0	80	80	1.0000000
NODE_21723_length_633_cov_9.689139	79	147	6	7	68	0.1029412
NODE_21723_length_633_cov_9.689139	79	147	8	11	68	0.1617647
NODE_21723_length_633_cov_9.689139	79	147	10	2	68	0.0294118
NODE_21723_length_633_cov_9.689139	79	147	12	9	68	0.1323529
NODE_21723_length_633_cov_9.689139	79	147	14	36	68	0.5294118
NODE_21723_length_633_cov_9.689139	79	147	16	2	68	0.0294118
NODE_21723_length_633_cov_9.689139	79	147	18	1	68	0.0147059
NODE_21729_length_633_cov_7.018727	309	389	0	80	80	1.0000000
NODE_21729_length_633_cov_7.018727	362	442	0	80	80	1.0000000
NODE_21755_length_633_cov_2.644195	166	240	2	30	74	0.4054054
NODE_21755_length_633_cov_2.644195	166	240	4	44	74	0.5945946
NODE_21816_length_632_cov_25.425891	332	412	0	21	80	0.2625000
NODE_21816_length_632_cov_25.425891	332	412	2	26	80	0.3250000
NODE_21816_length_632_cov_25.425891	332	412	4	33	80	0.4125000
NODE_21816_length_632_cov_25.425891	385	465	0	74	80	0.9250000
NODE_21816_length_632_cov_25.425891	385	465	2	6	80	0.0750000
NODE_21817_length_632_cov_21.613508	243	323	0	80	80	1.0000000
NODE_21817_length_632_cov_21.613508	296	376	0	80	80	1.0000000
NODE_21818_length_632_cov_16.465291	293	373	2	10	80	0.1250000
NODE_21818_length_632_cov_16.465291	293	373	4	70	80	0.8750000
NODE_21818_length_632_cov_16.465291	346	426	0	35	80	0.4375000
NODE_21818_length_632_cov_16.465291	346	426	2	28	80	0.3500000
NODE_21818_length_632_cov_16.465291	346	426	4	17	80	0.2125000
NODE_21819_length_632_cov_13.260788	232	312	0	80	80	1.0000000
NODE_21819_length_632_cov_13.260788	285	365	0	80	80	1.0000000
NODE_21821_length_632_cov_9.106942	188	268	0	80	80	1.0000000
NODE_21821_length_632_cov_9.106942	241	321	0	80	80	1.0000000
NODE_21834_length_632_cov_4.135084	229	309	0	80	80	1.0000000
NODE_21834_length_632_cov_4.135084	282	359	0	77	77	1.0000000
NODE_21841_length_632_cov_2.939962	216	274	2	19	58	0.3275862
NODE_21841_length_632_cov_2.939962	216	274	4	4	58	0.0689655
NODE_21841_length_632_cov_2.939962	216	274	8	35	58	0.6034483
NODE_21841_length_632_cov_2.939962	247	327	8	80	80	1.0000000
NODE_21848_length_632_cov_2.330206	57	76	0	19	19	1.0000000
NODE_21912_length_631_cov_31.469925	321	396	0	8	75	0.1066667
NODE_21912_length_631_cov_31.469925	321	396	2	1	75	0.0133333
NODE_21912_length_631_cov_31.469925	321	396	4	44	75	0.5866666
NODE_21912_length_631_cov_31.469925	321	396	6	22	75	0.2933333
NODE_21912_length_631_cov_31.469925	369	449	0	61	80	0.7625000
NODE_21912_length_631_cov_31.469925	369	449	2	1	80	0.0125000
NODE_21912_length_631_cov_31.469925	369	449	4	18	80	0.2250000
NODE_21913_length_631_cov_26.453008	383	463	0	11	80	0.1375000
NODE_21913_length_631_cov_26.453008	383	463	2	69	80	0.8625000
NODE_21913_length_631_cov_26.453008	436	516	0	64	80	0.8000000
NODE_21913_length_631_cov_26.453008	436	516	2	16	80	0.2000000
NODE_21917_length_631_cov_8.374060	318	398	0	80	80	1.0000000
NODE_21917_length_631_cov_8.374060	371	451	0	28	80	0.3500000
NODE_21917_length_631_cov_8.374060	371	451	4	52	80	0.6500000
NODE_21924_length_631_cov_5.507519	335	386	4	6	51	0.1176471
NODE_21924_length_631_cov_5.507519	335	386	5	45	51	0.8823529
NODE_21927_length_631_cov_5.227444	443	523	0	71	80	0.8875000
NODE_21927_length_631_cov_5.227444	443	523	2	9	80	0.1125000
NODE_21927_length_631_cov_5.227444	496	576	0	80	80	1.0000000
NODE_21942_length_631_cov_2.926692	307	354	0	47	47	1.0000000
NODE_21983_length_631_cov_1.383459	248	267	0	18	19	0.9473684
NODE_21983_length_631_cov_1.383459	248	267	2	1	19	0.0526316
NODE_22011_length_630_cov_41.728814	6	86	0	57	80	0.7125000
NODE_22011_length_630_cov_41.728814	6	86	2	2	80	0.0250000
NODE_22011_length_630_cov_41.728814	6	86	4	21	80	0.2625000
NODE_22011_length_630_cov_41.728814	59	139	0	4	80	0.0500000
NODE_22011_length_630_cov_41.728814	59	139	2	2	80	0.0250000
NODE_22011_length_630_cov_41.728814	59	139	4	74	80	0.9250000
NODE_22012_length_630_cov_24.856874	421	501	2	29	80	0.3625000
NODE_22012_length_630_cov_24.856874	421	501	4	51	80	0.6375000
NODE_22012_length_630_cov_24.856874	474	554	0	20	80	0.2500000
NODE_22012_length_630_cov_24.856874	474	554	2	26	80	0.3250000
NODE_22012_length_630_cov_24.856874	474	554	4	34	80	0.4250000
NODE_22013_length_630_cov_14.323917	196	276	0	17	80	0.2125000
NODE_22013_length_630_cov_14.323917	196	276	2	44	80	0.5500000
NODE_22013_length_630_cov_14.323917	196	276	4	19	80	0.2375000
NODE_22013_length_630_cov_14.323917	249	329	2	30	80	0.3750000
NODE_22013_length_630_cov_14.323917	249	329	4	50	80	0.6250000
NODE_22014_length_630_cov_9.964218	284	364	0	6	80	0.0750000
NODE_22014_length_630_cov_9.964218	284	364	2	2	80	0.0250000
NODE_22014_length_630_cov_9.964218	284	364	4	72	80	0.9000000
NODE_22014_length_630_cov_9.964218	337	417	0	59	80	0.7375000
NODE_22014_length_630_cov_9.964218	337	417	2	2	80	0.0250000
NODE_22014_length_630_cov_9.964218	337	417	4	19	80	0.2375000
NODE_22086_length_629_cov_38.271698	288	368	0	15	80	0.1875000
NODE_22086_length_629_cov_38.271698	288	368	5	8	80	0.1000000
NODE_22086_length_629_cov_38.271698	288	368	9	17	80	0.2125000
NODE_22086_length_629_cov_38.271698	288	368	11	36	80	0.4500000
NODE_22086_length_629_cov_38.271698	288	368	12	4	80	0.0500000
NODE_22086_length_629_cov_38.271698	341	421	5	3	80	0.0375000
NODE_22086_length_629_cov_38.271698	341	421	6	18	80	0.2250000
NODE_22086_length_629_cov_38.271698	341	421	8	3	80	0.0375000
NODE_22086_length_629_cov_38.271698	341	421	11	23	80	0.2875000
NODE_22086_length_629_cov_38.271698	341	421	12	33	80	0.4125000
NODE_22087_length_629_cov_27.556604	212	292	0	4	80	0.0500000
NODE_22087_length_629_cov_27.556604	212	292	2	76	80	0.9500000
NODE_22087_length_629_cov_27.556604	265	345	2	63	80	0.7875000
NODE_22087_length_629_cov_27.556604	265	345	4	7	80	0.0875000
NODE_22087_length_629_cov_27.556604	265	345	6	1	80	0.0125000
NODE_22087_length_629_cov_27.556604	265	345	9	9	80	0.1125000
NODE_22088_length_629_cov_24.150943	356	436	2	80	80	1.0000000
NODE_22088_length_629_cov_24.150943	409	489	0	42	80	0.5250000
NODE_22088_length_629_cov_24.150943	409	489	2	38	80	0.4750000
NODE_22091_length_629_cov_13.641509	176	256	0	80	80	1.0000000
NODE_22091_length_629_cov_13.641509	229	309	0	64	80	0.8000000
NODE_22091_length_629_cov_13.641509	229	309	4	16	80	0.2000000
NODE_22101_length_629_cov_4.264151	362	442	2	80	80	1.0000000
NODE_22188_length_628_cov_5.015123	210	274	0	10	64	0.1562500
NODE_22188_length_628_cov_5.015123	210	274	6	17	64	0.2656250
NODE_22188_length_628_cov_5.015123	210	274	8	5	64	0.0781250
NODE_22188_length_628_cov_5.015123	210	274	10	32	64	0.5000000
NODE_22257_length_627_cov_24.500000	217	297	4	2	80	0.0250000
NODE_22257_length_627_cov_24.500000	217	297	6	78	80	0.9750000
NODE_22257_length_627_cov_24.500000	270	350	0	45	80	0.5625000
NODE_22257_length_627_cov_24.500000	270	350	4	10	80	0.1250000
NODE_22257_length_627_cov_24.500000	270	350	6	25	80	0.3125000
NODE_22258_length_627_cov_20.395833	84	164	0	80	80	1.0000000
NODE_22258_length_627_cov_20.395833	137	217	0	80	80	1.0000000
NODE_22259_length_627_cov_19.676136	308	388	0	15	80	0.1875000
NODE_22259_length_627_cov_19.676136	308	388	2	10	80	0.1250000
NODE_22259_length_627_cov_19.676136	308	388	4	16	80	0.2000000
NODE_22259_length_627_cov_19.676136	308	388	10	15	80	0.1875000
NODE_22259_length_627_cov_19.676136	308	388	12	24	80	0.3000000
NODE_22259_length_627_cov_19.676136	361	441	6	6	80	0.0750000
NODE_22259_length_627_cov_19.676136	361	441	8	12	80	0.1500000
NODE_22259_length_627_cov_19.676136	361	441	10	3	80	0.0375000
NODE_22259_length_627_cov_19.676136	361	441	11	1	80	0.0125000
NODE_22259_length_627_cov_19.676136	361	441	12	58	80	0.7250000
NODE_22260_length_627_cov_17.634470	264	296	0	16	32	0.5000000
NODE_22260_length_627_cov_17.634470	264	296	4	14	32	0.4375000
NODE_22260_length_627_cov_17.634470	264	296	6	2	32	0.0625000
NODE_22260_length_627_cov_17.634470	360	385	2	4	25	0.1600000
NODE_22260_length_627_cov_17.634470	360	385	6	21	25	0.8400000
NODE_22260_length_627_cov_17.634470	365	385	2	4	20	0.2000000
NODE_22260_length_627_cov_17.634470	365	385	6	16	20	0.8000000
NODE_22260_length_627_cov_17.634470	385	424	0	39	39	1.0000000
NODE_22267_length_627_cov_5.634470	298	346	2	2	48	0.0416667
NODE_22267_length_627_cov_5.634470	298	346	4	32	48	0.6666667
NODE_22267_length_627_cov_5.634470	298	346	7	1	48	0.0208333
NODE_22267_length_627_cov_5.634470	298	346	8	13	48	0.2708333
NODE_22274_length_627_cov_4.517045	323	403	0	14	80	0.1750000
NODE_22274_length_627_cov_4.517045	323	403	2	61	80	0.7625000
NODE_22274_length_627_cov_4.517045	323	403	6	5	80	0.0625000
NODE_22274_length_627_cov_4.517045	376	456	0	67	80	0.8375000
NODE_22274_length_627_cov_4.517045	376	456	2	13	80	0.1625000
NODE_22357_length_626_cov_24.184061	140	220	0	16	80	0.2000000
NODE_22357_length_626_cov_24.184061	140	220	2	64	80	0.8000000
NODE_22357_length_626_cov_24.184061	193	273	0	69	80	0.8625000
NODE_22357_length_626_cov_24.184061	193	273	2	11	80	0.1375000
NODE_22358_length_626_cov_21.189753	342	419	2	39	77	0.5064935
NODE_22358_length_626_cov_21.189753	342	419	4	25	77	0.3246753
NODE_22358_length_626_cov_21.189753	342	419	6	13	77	0.1688312
NODE_22358_length_626_cov_21.189753	342	419	2	39	77	0.5064935
NODE_22358_length_626_cov_21.189753	342	419	4	25	77	0.3246753
NODE_22358_length_626_cov_21.189753	342	419	6	13	77	0.1688312
NODE_22358_length_626_cov_21.189753	392	453	2	21	61	0.3442623
NODE_22358_length_626_cov_21.189753	392	453	4	12	61	0.1967213
NODE_22358_length_626_cov_21.189753	392	453	5	28	61	0.4590164
NODE_22364_length_626_cov_7.100569	236	311	0	75	75	1.0000000
NODE_22364_length_626_cov_7.100569	284	364	0	71	80	0.8875000
NODE_22364_length_626_cov_7.100569	284	364	2	7	80	0.0875000
NODE_22364_length_626_cov_7.100569	284	364	4	2	80	0.0250000
NODE_22366_length_626_cov_6.296015	193	273	2	80	80	1.0000000
NODE_22366_length_626_cov_6.296015	246	326	0	40	80	0.5000000
NODE_22366_length_626_cov_6.296015	246	326	2	40	80	0.5000000
NODE_22367_length_626_cov_6.163188	257	337	0	80	80	1.0000000
NODE_22367_length_626_cov_6.163188	310	390	0	80	80	1.0000000
NODE_22438_length_625_cov_33.100760	239	319	0	80	80	1.0000000
NODE_22438_length_625_cov_33.100760	292	372	0	80	80	1.0000000
NODE_22438_length_625_cov_33.100760	368	448	0	70	80	0.8750000
NODE_22438_length_625_cov_33.100760	368	448	2	10	80	0.1250000
NODE_22438_length_625_cov_33.100760	421	501	0	17	80	0.2125000
NODE_22438_length_625_cov_33.100760	421	501	2	63	80	0.7875000
NODE_22439_length_625_cov_21.062738	267	347	0	39	80	0.4875000
NODE_22439_length_625_cov_21.062738	267	347	2	41	80	0.5125000
NODE_22439_length_625_cov_21.062738	320	400	0	4	80	0.0500000
NODE_22439_length_625_cov_21.062738	320	400	2	76	80	0.9500000
NODE_22440_length_625_cov_14.237643	28	108	0	20	80	0.2500000
NODE_22440_length_625_cov_14.237643	28	108	2	4	80	0.0500000
NODE_22440_length_625_cov_14.237643	28	108	4	12	80	0.1500000
NODE_22440_length_625_cov_14.237643	28	108	8	44	80	0.5500000
NODE_22440_length_625_cov_14.237643	81	161	6	39	80	0.4875000
NODE_22440_length_625_cov_14.237643	81	161	8	41	80	0.5125000
NODE_22441_length_625_cov_14.207224	358	438	0	80	80	1.0000000
NODE_22441_length_625_cov_14.207224	411	491	0	80	80	1.0000000
NODE_22455_length_625_cov_4.157795	548	600	0	52	52	1.0000000
NODE_22466_length_625_cov_2.929658	118	198	0	80	80	1.0000000
NODE_22466_length_625_cov_2.929658	171	251	0	80	80	1.0000000
NODE_22491_length_625_cov_1.570342	471	502	0	31	31	1.0000000
NODE_22542_length_624_cov_9.598095	77	126	1	5	49	0.1020408
NODE_22542_length_624_cov_9.598095	77	126	2	9	49	0.1836735
NODE_22542_length_624_cov_9.598095	77	126	4	35	49	0.7142857
NODE_22542_length_624_cov_9.598095	103	183	1	6	80	0.0750000
NODE_22542_length_624_cov_9.598095	103	183	2	64	80	0.8000000
NODE_22542_length_624_cov_9.598095	103	183	3	1	80	0.0125000
NODE_22542_length_624_cov_9.598095	103	183	4	9	80	0.1125000
NODE_22544_length_624_cov_8.485714	271	351	0	25	80	0.3125000
NODE_22544_length_624_cov_8.485714	271	351	2	33	80	0.4125000
NODE_22544_length_624_cov_8.485714	271	351	4	22	80	0.2750000
NODE_22544_length_624_cov_8.485714	324	404	2	5	80	0.0625000
NODE_22544_length_624_cov_8.485714	324	404	4	39	80	0.4875000
NODE_22544_length_624_cov_8.485714	324	404	8	36	80	0.4500000
NODE_22546_length_624_cov_6.691429	386	466	0	80	80	1.0000000
NODE_22546_length_624_cov_6.691429	439	519	0	80	80	1.0000000
NODE_22547_length_624_cov_5.592381	312	387	0	54	75	0.7200000
NODE_22547_length_624_cov_5.592381	312	387	2	9	75	0.1200000
NODE_22547_length_624_cov_5.592381	312	387	4	2	75	0.0266667
NODE_22547_length_624_cov_5.592381	312	387	6	10	75	0.1333333
NODE_22551_length_624_cov_4.638095	328	388	3	10	60	0.1666667
NODE_22551_length_624_cov_4.638095	328	388	4	11	60	0.1833333
NODE_22551_length_624_cov_4.638095	328	388	5	39	60	0.6500000
NODE_22642_length_623_cov_41.877863	419	499	0	80	80	1.0000000
NODE_22642_length_623_cov_41.877863	472	552	0	80	80	1.0000000
NODE_22643_length_623_cov_31.875954	148	228	0	80	80	1.0000000
NODE_22643_length_623_cov_31.875954	201	281	0	32	80	0.4000000
NODE_22643_length_623_cov_31.875954	201	281	2	13	80	0.1625000
NODE_22643_length_623_cov_31.875954	201	281	4	35	80	0.4375000
NODE_22644_length_623_cov_31.192748	313	393	0	46	80	0.5750000
NODE_22644_length_623_cov_31.192748	313	393	2	34	80	0.4250000
NODE_22644_length_623_cov_31.192748	366	446	2	80	80	1.0000000
NODE_22645_length_623_cov_20.187023	287	367	0	80	80	1.0000000
NODE_22645_length_623_cov_20.187023	340	420	0	80	80	1.0000000
NODE_22646_length_623_cov_12.045802	377	457	0	80	80	1.0000000
NODE_22646_length_623_cov_12.045802	430	510	0	80	80	1.0000000
NODE_22668_length_623_cov_2.891221	457	535	0	20	78	0.2564103
NODE_22668_length_623_cov_2.891221	457	535	2	58	78	0.7435898
NODE_22725_length_622_cov_19.042065	368	448	2	40	80	0.5000000
NODE_22725_length_622_cov_19.042065	368	448	4	40	80	0.5000000
NODE_22725_length_622_cov_19.042065	421	501	0	35	80	0.4375000
NODE_22725_length_622_cov_19.042065	421	501	2	2	80	0.0250000
NODE_22725_length_622_cov_19.042065	421	501	4	43	80	0.5375000
NODE_22726_length_622_cov_13.470363	109	189	4	36	80	0.4500000
NODE_22726_length_622_cov_13.470363	109	189	5	8	80	0.1000000
NODE_22726_length_622_cov_13.470363	109	189	6	36	80	0.4500000
NODE_22726_length_622_cov_13.470363	162	242	2	18	80	0.2250000
NODE_22726_length_622_cov_13.470363	162	242	4	24	80	0.3000000
NODE_22726_length_622_cov_13.470363	162	242	6	38	80	0.4750000
NODE_22752_length_622_cov_2.407266	94	170	0	76	76	1.0000000
NODE_22796_length_622_cov_1.353728	346	376	0	30	30	1.0000000
NODE_22819_length_621_cov_46.247126	0	52	0	52	52	1.0000000
NODE_22819_length_621_cov_46.247126	25	105	0	80	80	1.0000000
NODE_22819_length_621_cov_46.247126	101	181	0	80	80	1.0000000
NODE_22819_length_621_cov_46.247126	154	234	0	80	80	1.0000000
NODE_22820_length_621_cov_45.764368	344	424	0	80	80	1.0000000
NODE_22820_length_621_cov_45.764368	397	477	0	80	80	1.0000000
NODE_22821_length_621_cov_35.147510	393	473	0	3	80	0.0375000
NODE_22821_length_621_cov_35.147510	393	473	4	6	80	0.0750000
NODE_22821_length_621_cov_35.147510	393	473	6	12	80	0.1500000
NODE_22821_length_621_cov_35.147510	393	473	8	10	80	0.1250000
NODE_22821_length_621_cov_35.147510	393	473	9	1	80	0.0125000
NODE_22821_length_621_cov_35.147510	393	473	10	17	80	0.2125000
NODE_22821_length_621_cov_35.147510	393	473	12	31	80	0.3875000
NODE_22821_length_621_cov_35.147510	446	526	4	29	80	0.3625000
NODE_22821_length_621_cov_35.147510	446	526	6	28	80	0.3500000
NODE_22821_length_621_cov_35.147510	446	526	8	7	80	0.0875000
NODE_22821_length_621_cov_35.147510	446	526	12	16	80	0.2000000
NODE_22822_length_621_cov_13.842912	231	311	0	80	80	1.0000000
NODE_22822_length_621_cov_13.842912	284	364	0	80	80	1.0000000
NODE_22825_length_621_cov_6.279693	376	406	0	30	30	1.0000000
NODE_22845_length_621_cov_2.645594	367	426	0	6	59	0.1016949
NODE_22845_length_621_cov_2.645594	367	426	2	53	59	0.8983051
NODE_22914_length_620_cov_23.913628	433	513	2	13	80	0.1625000
NODE_22914_length_620_cov_23.913628	433	513	4	6	80	0.0750000
NODE_22914_length_620_cov_23.913628	433	513	6	24	80	0.3000000
NODE_22914_length_620_cov_23.913628	433	513	8	37	80	0.4625000
NODE_22914_length_620_cov_23.913628	486	566	0	20	80	0.2500000
NODE_22914_length_620_cov_23.913628	486	566	2	15	80	0.1875000
NODE_22914_length_620_cov_23.913628	486	566	6	25	80	0.3125000
NODE_22914_length_620_cov_23.913628	486	566	8	20	80	0.2500000
NODE_22915_length_620_cov_9.222649	186	266	0	48	80	0.6000000
NODE_22915_length_620_cov_9.222649	186	266	2	5	80	0.0625000
NODE_22915_length_620_cov_9.222649	186	266	4	27	80	0.3375000
NODE_22915_length_620_cov_9.222649	239	319	0	80	80	1.0000000
NODE_22919_length_620_cov_7.804223	57	137	0	3	80	0.0375000
NODE_22919_length_620_cov_7.804223	57	137	2	77	80	0.9625000
NODE_22919_length_620_cov_7.804223	110	190	0	56	80	0.7000000
NODE_22919_length_620_cov_7.804223	110	190	2	24	80	0.3000000
NODE_22920_length_620_cov_6.909789	199	279	0	6	80	0.0750000
NODE_22920_length_620_cov_6.909789	199	279	2	32	80	0.4000000
NODE_22920_length_620_cov_6.909789	199	279	4	42	80	0.5250000
NODE_22920_length_620_cov_6.909789	252	332	1	3	80	0.0375000
NODE_22920_length_620_cov_6.909789	252	332	3	20	80	0.2500000
NODE_22920_length_620_cov_6.909789	252	332	4	43	80	0.5375000
NODE_22920_length_620_cov_6.909789	252	332	5	14	80	0.1750000
NODE_22930_length_620_cov_4.560461	309	347	20	3	38	0.0789474
NODE_22930_length_620_cov_4.560461	309	347	22	35	38	0.9210526
NODE_22930_length_620_cov_4.560461	395	421	0	26	26	1.0000000
NODE_22930_length_620_cov_4.560461	395	451	0	28	56	0.5000000
NODE_22930_length_620_cov_4.560461	395	451	2	7	56	0.1250000
NODE_22930_length_620_cov_4.560461	395	451	3	3	56	0.0535714
NODE_22930_length_620_cov_4.560461	395	451	5	2	56	0.0357143
NODE_22930_length_620_cov_4.560461	395	451	6	2	56	0.0357143
NODE_22930_length_620_cov_4.560461	395	451	8	14	56	0.2500000
NODE_23031_length_619_cov_26.309615	118	198	0	15	80	0.1875000
NODE_23031_length_619_cov_26.309615	118	198	4	2	80	0.0250000
NODE_23031_length_619_cov_26.309615	118	198	5	63	80	0.7875000
NODE_23031_length_619_cov_26.309615	171	251	5	80	80	1.0000000
NODE_23033_length_619_cov_10.417308	427	487	0	18	60	0.3000000
NODE_23033_length_619_cov_10.417308	427	487	2	42	60	0.7000000
NODE_23034_length_619_cov_7.944231	213	293	0	80	80	1.0000000
NODE_23034_length_619_cov_7.944231	266	346	0	80	80	1.0000000
NODE_23135_length_618_cov_14.477842	223	299	0	9	76	0.1184211
NODE_23135_length_618_cov_14.477842	223	299	2	17	76	0.2236842
NODE_23135_length_618_cov_14.477842	223	299	4	4	76	0.0526316
NODE_23135_length_618_cov_14.477842	223	299	6	18	76	0.2368421
NODE_23135_length_618_cov_14.477842	223	299	7	13	76	0.1710526
NODE_23135_length_618_cov_14.477842	223	299	8	15	76	0.1973684
NODE_23135_length_618_cov_14.477842	223	299	0	9	76	0.1184211
NODE_23135_length_618_cov_14.477842	223	299	2	17	76	0.2236842
NODE_23135_length_618_cov_14.477842	223	299	4	4	76	0.0526316
NODE_23135_length_618_cov_14.477842	223	299	6	18	76	0.2368421
NODE_23135_length_618_cov_14.477842	223	299	7	13	76	0.1710526
NODE_23135_length_618_cov_14.477842	223	299	8	15	76	0.1973684
NODE_23135_length_618_cov_14.477842	276	337	7	8	61	0.1311475
NODE_23135_length_618_cov_14.477842	276	337	8	51	61	0.8360656
NODE_23135_length_618_cov_14.477842	276	337	10	2	61	0.0327869
NODE_23136_length_618_cov_13.840077	377	457	0	80	80	1.0000000
NODE_23136_length_618_cov_13.840077	430	510	0	80	80	1.0000000
NODE_23137_length_618_cov_12.048170	348	428	0	11	80	0.1375000
NODE_23137_length_618_cov_12.048170	348	428	2	69	80	0.8625000
NODE_23137_length_618_cov_12.048170	401	481	0	63	80	0.7875000
NODE_23137_length_618_cov_12.048170	401	481	2	17	80	0.2125000
NODE_23138_length_618_cov_8.799615	353	433	0	54	80	0.6750000
NODE_23138_length_618_cov_8.799615	353	433	2	26	80	0.3250000
NODE_23138_length_618_cov_8.799615	406	486	0	14	80	0.1750000
NODE_23138_length_618_cov_8.799615	406	486	2	66	80	0.8250000
NODE_23147_length_618_cov_3.793834	412	478	0	66	66	1.0000000
NODE_23148_length_618_cov_3.761079	305	385	0	80	80	1.0000000
NODE_23252_length_617_cov_29.565637	378	458	2	8	80	0.1000000
NODE_23252_length_617_cov_29.565637	378	458	4	20	80	0.2500000
NODE_23252_length_617_cov_29.565637	378	458	6	52	80	0.6500000
NODE_23252_length_617_cov_29.565637	431	511	0	11	80	0.1375000
NODE_23252_length_617_cov_29.565637	431	511	2	17	80	0.2125000
NODE_23252_length_617_cov_29.565637	431	511	4	13	80	0.1625000
NODE_23252_length_617_cov_29.565637	431	511	6	39	80	0.4875000
NODE_23253_length_617_cov_16.781853	253	333	0	80	80	1.0000000
NODE_23253_length_617_cov_16.781853	306	386	0	80	80	1.0000000
NODE_23254_length_617_cov_9.175676	373	453	0	14	80	0.1750000
NODE_23254_length_617_cov_9.175676	373	453	2	66	80	0.8250000
NODE_23254_length_617_cov_9.175676	426	506	0	67	80	0.8375000
NODE_23254_length_617_cov_9.175676	426	506	2	13	80	0.1625000
NODE_23255_length_617_cov_8.774131	320	406	0	42	86	0.4883721
NODE_23255_length_617_cov_8.774131	320	406	4	29	86	0.3372093
NODE_23255_length_617_cov_8.774131	320	406	6	15	86	0.1744186
NODE_23255_length_617_cov_8.774131	379	458	4	33	79	0.4177215
NODE_23255_length_617_cov_8.774131	379	458	6	46	79	0.5822785
NODE_23257_length_617_cov_8.416988	359	439	0	32	80	0.4000000
NODE_23257_length_617_cov_8.416988	359	439	2	48	80	0.6000000
NODE_23257_length_617_cov_8.416988	412	492	0	80	80	1.0000000
NODE_23259_length_617_cov_7.683398	197	275	0	45	78	0.5769231
NODE_23259_length_617_cov_7.683398	197	275	2	33	78	0.4230769
NODE_23259_length_617_cov_7.683398	250	330	0	7	80	0.0875000
NODE_23259_length_617_cov_7.683398	250	330	2	73	80	0.9125000
NODE_23263_length_617_cov_5.330116	288	360	0	72	72	1.0000000
NODE_23263_length_617_cov_5.330116	333	413	0	80	80	1.0000000
NODE_23302_length_617_cov_1.967181	384	430	0	46	46	1.0000000
NODE_23311_length_617_cov_1.847490	273	344	0	3	71	0.0422535
NODE_23311_length_617_cov_1.847490	273	344	4	68	71	0.9577465
NODE_23331_length_617_cov_1.322394	269	318	44	7	49	0.1428571
NODE_23331_length_617_cov_1.322394	269	318	45	4	49	0.0816327
NODE_23331_length_617_cov_1.322394	269	318	46	4	49	0.0816327
NODE_23331_length_617_cov_1.322394	269	318	47	9	49	0.1836735
NODE_23331_length_617_cov_1.322394	269	318	48	6	49	0.1224490
NODE_23331_length_617_cov_1.322394	269	318	49	1	49	0.0204082
NODE_23331_length_617_cov_1.322394	269	318	50	16	49	0.3265306
NODE_23331_length_617_cov_1.322394	269	318	52	2	49	0.0408163
NODE_23365_length_616_cov_15.914894	292	370	0	78	78	1.0000000
NODE_23365_length_616_cov_15.914894	343	423	0	80	80	1.0000000
NODE_23366_length_616_cov_14.276596	191	271	0	80	80	1.0000000
NODE_23366_length_616_cov_14.276596	244	319	0	34	75	0.4533333
NODE_23366_length_616_cov_14.276596	244	319	2	41	75	0.5466667
NODE_23366_length_616_cov_14.276596	368	448	0	65	80	0.8125000
NODE_23366_length_616_cov_14.276596	368	448	2	15	80	0.1875000
NODE_23367_length_616_cov_12.119923	273	353	0	58	80	0.7250000
NODE_23367_length_616_cov_12.119923	273	353	2	22	80	0.2750000
NODE_23367_length_616_cov_12.119923	326	406	0	80	80	1.0000000
NODE_23373_length_616_cov_6.379110	305	385	0	80	80	1.0000000
NODE_23373_length_616_cov_6.379110	358	438	0	39	80	0.4875000
NODE_23373_length_616_cov_6.379110	358	438	7	1	80	0.0125000
NODE_23373_length_616_cov_6.379110	358	438	8	40	80	0.5000000
NODE_23381_length_616_cov_4.441006	286	350	0	64	64	1.0000000
NODE_23381_length_616_cov_4.441006	286	306	0	20	20	1.0000000
NODE_23400_length_616_cov_2.541586	375	415	0	7	40	0.1750000
NODE_23400_length_616_cov_2.541586	375	415	2	33	40	0.8250000
NODE_23430_length_616_cov_1.491296	105	183	0	11	78	0.1410256
NODE_23430_length_616_cov_1.491296	105	183	1	12	78	0.1538462
NODE_23430_length_616_cov_1.491296	105	183	2	55	78	0.7051282
NODE_23474_length_615_cov_27.519380	302	382	0	13	80	0.1625000
NODE_23474_length_615_cov_27.519380	302	382	2	67	80	0.8375000
NODE_23474_length_615_cov_27.519380	355	435	0	66	80	0.8250000
NODE_23474_length_615_cov_27.519380	355	435	2	14	80	0.1750000
NODE_23475_length_615_cov_17.792636	239	319	0	80	80	1.0000000
NODE_23475_length_615_cov_17.792636	292	372	0	80	80	1.0000000
NODE_23477_length_615_cov_11.835271	240	320	0	80	80	1.0000000
NODE_23477_length_615_cov_11.835271	293	373	0	80	80	1.0000000
NODE_23478_length_615_cov_8.591085	287	367	0	80	80	1.0000000
NODE_23478_length_615_cov_8.591085	340	420	0	80	80	1.0000000
NODE_23513_length_615_cov_2.461240	429	509	0	80	80	1.0000000
NODE_23513_length_615_cov_2.461240	482	562	0	80	80	1.0000000
NODE_23516_length_615_cov_2.379845	405	467	0	14	62	0.2258064
NODE_23516_length_615_cov_2.379845	405	467	2	48	62	0.7741935
NODE_23516_length_615_cov_2.379845	440	520	0	31	80	0.3875000
NODE_23516_length_615_cov_2.379845	440	520	2	49	80	0.6125000
NODE_23517_length_615_cov_2.294574	205	268	0	63	63	1.0000000
NODE_23554_length_615_cov_1.122093	255	335	0	80	80	1.0000000
NODE_23566_length_615_cov_0.887597	561	582	0	21	21	1.0000000
NODE_23575_length_614_cov_17.772816	257	337	0	80	80	1.0000000
NODE_23575_length_614_cov_17.772816	310	390	0	80	80	1.0000000
NODE_23576_length_614_cov_10.706796	425	505	4	7	80	0.0875000
NODE_23576_length_614_cov_10.706796	425	505	6	2	80	0.0250000
NODE_23576_length_614_cov_10.706796	425	505	8	71	80	0.8875000
NODE_23576_length_614_cov_10.706796	478	558	0	30	80	0.3750000
NODE_23576_length_614_cov_10.706796	478	558	2	7	80	0.0875000
NODE_23576_length_614_cov_10.706796	478	558	4	23	80	0.2875000
NODE_23576_length_614_cov_10.706796	478	558	6	2	80	0.0250000
NODE_23576_length_614_cov_10.706796	478	558	8	18	80	0.2250000
NODE_23578_length_614_cov_8.545631	193	273	0	52	80	0.6500000
NODE_23578_length_614_cov_8.545631	193	273	4	2	80	0.0250000
NODE_23578_length_614_cov_8.545631	193	273	8	11	80	0.1375000
NODE_23578_length_614_cov_8.545631	193	273	10	14	80	0.1750000
NODE_23578_length_614_cov_8.545631	193	273	12	1	80	0.0125000
NODE_23578_length_614_cov_8.545631	246	326	0	63	80	0.7875000
NODE_23578_length_614_cov_8.545631	246	326	1	6	80	0.0750000
NODE_23578_length_614_cov_8.545631	246	326	3	11	80	0.1375000
NODE_23604_length_614_cov_2.450485	315	393	0	60	78	0.7692308
NODE_23604_length_614_cov_2.450485	315	393	2	18	78	0.2307692
NODE_23604_length_614_cov_2.450485	355	383	0	28	28	1.0000000
NODE_23604_length_614_cov_2.450485	368	448	0	80	80	1.0000000
NODE_23604_length_614_cov_2.450485	379	448	0	69	69	1.0000000
NODE_23662_length_613_cov_18.075875	211	291	0	25	80	0.3125000
NODE_23662_length_613_cov_18.075875	211	291	2	55	80	0.6875000
NODE_23662_length_613_cov_18.075875	264	344	2	74	80	0.9250000
NODE_23662_length_613_cov_18.075875	264	344	4	6	80	0.0750000
NODE_23663_length_613_cov_16.118677	283	363	2	72	80	0.9000000
NODE_23663_length_613_cov_16.118677	283	363	4	8	80	0.1000000
NODE_23663_length_613_cov_16.118677	336	416	0	52	80	0.6500000
NODE_23663_length_613_cov_16.118677	336	416	2	28	80	0.3500000
NODE_23665_length_613_cov_12.883268	155	235	6	20	80	0.2500000
NODE_23665_length_613_cov_12.883268	155	235	8	60	80	0.7500000
NODE_23665_length_613_cov_12.883268	208	288	0	21	80	0.2625000
NODE_23665_length_613_cov_12.883268	208	288	2	14	80	0.1750000
NODE_23665_length_613_cov_12.883268	208	288	4	2	80	0.0250000
NODE_23665_length_613_cov_12.883268	208	288	6	4	80	0.0500000
NODE_23665_length_613_cov_12.883268	208	288	8	39	80	0.4875000
NODE_23674_length_613_cov_3.857977	167	247	0	56	80	0.7000000
NODE_23674_length_613_cov_3.857977	167	247	2	24	80	0.3000000
NODE_23674_length_613_cov_3.857977	220	300	0	80	80	1.0000000
NODE_23771_length_612_cov_24.023392	173	253	0	80	80	1.0000000
NODE_23771_length_612_cov_24.023392	226	306	0	58	80	0.7250000
NODE_23771_length_612_cov_24.023392	226	306	2	22	80	0.2750000
NODE_23772_length_612_cov_23.846004	141	221	6	23	80	0.2875000
NODE_23772_length_612_cov_23.846004	141	221	8	18	80	0.2250000
NODE_23772_length_612_cov_23.846004	141	221	10	1	80	0.0125000
NODE_23772_length_612_cov_23.846004	141	221	11	2	80	0.0250000
NODE_23772_length_612_cov_23.846004	141	221	12	36	80	0.4500000
NODE_23772_length_612_cov_23.846004	194	274	0	11	80	0.1375000
NODE_23772_length_612_cov_23.846004	194	274	2	5	80	0.0625000
NODE_23772_length_612_cov_23.846004	194	274	5	1	80	0.0125000
NODE_23772_length_612_cov_23.846004	194	274	6	40	80	0.5000000
NODE_23772_length_612_cov_23.846004	194	274	8	6	80	0.0750000
NODE_23772_length_612_cov_23.846004	194	274	10	1	80	0.0125000
NODE_23772_length_612_cov_23.846004	194	274	12	16	80	0.2000000
NODE_23773_length_612_cov_12.448343	244	324	2	80	80	1.0000000
NODE_23773_length_612_cov_12.448343	297	377	0	43	80	0.5375000
NODE_23773_length_612_cov_12.448343	297	377	2	37	80	0.4625000
NODE_23774_length_612_cov_12.068226	267	347	0	80	80	1.0000000
NODE_23774_length_612_cov_12.068226	320	400	0	80	80	1.0000000
NODE_23779_length_612_cov_6.393762	242	322	0	1	80	0.0125000
NODE_23779_length_612_cov_6.393762	242	322	2	41	80	0.5125000
NODE_23779_length_612_cov_6.393762	242	322	3	7	80	0.0875000
NODE_23779_length_612_cov_6.393762	242	322	5	31	80	0.3875000
NODE_23779_length_612_cov_6.393762	295	375	4	5	80	0.0625000
NODE_23779_length_612_cov_6.393762	295	375	5	32	80	0.4000000
NODE_23779_length_612_cov_6.393762	295	375	6	25	80	0.3125000
NODE_23779_length_612_cov_6.393762	295	375	7	1	80	0.0125000
NODE_23779_length_612_cov_6.393762	295	375	8	17	80	0.2125000
NODE_23814_length_612_cov_1.904483	288	354	0	66	66	1.0000000
NODE_23869_length_611_cov_38.705078	132	212	0	80	80	1.0000000
NODE_23869_length_611_cov_38.705078	185	262	0	77	77	1.0000000
NODE_23869_length_611_cov_38.705078	185	262	0	77	77	1.0000000
NODE_23871_length_611_cov_12.669922	264	344	0	64	80	0.8000000
NODE_23871_length_611_cov_12.669922	264	344	2	16	80	0.2000000
NODE_23871_length_611_cov_12.669922	317	397	0	11	80	0.1375000
NODE_23871_length_611_cov_12.669922	317	397	2	69	80	0.8625000
NODE_23880_length_611_cov_4.943359	27	107	0	46	80	0.5750000
NODE_23880_length_611_cov_4.943359	27	107	2	34	80	0.4250000
NODE_23880_length_611_cov_4.943359	80	137	2	57	57	1.0000000
NODE_23880_length_611_cov_4.943359	143	209	0	2	66	0.0303030
NODE_23880_length_611_cov_4.943359	143	209	2	64	66	0.9696970
NODE_23880_length_611_cov_4.943359	182	262	2	64	80	0.8000000
NODE_23880_length_611_cov_4.943359	182	262	4	16	80	0.2000000
NODE_23894_length_611_cov_3.294922	271	300	6	29	29	1.0000000
NODE_23894_length_611_cov_3.294922	434	469	4	10	35	0.2857143
NODE_23894_length_611_cov_3.294922	434	469	6	25	35	0.7142857
NODE_23897_length_611_cov_3.162109	313	342	2	29	29	1.0000000
NODE_23973_length_610_cov_20.673190	87	167	2	20	80	0.2500000
NODE_23973_length_610_cov_20.673190	87	167	4	60	80	0.7500000
NODE_23973_length_610_cov_20.673190	140	220	2	47	80	0.5875000
NODE_23973_length_610_cov_20.673190	140	220	4	33	80	0.4125000
NODE_23974_length_610_cov_10.191781	250	330	0	80	80	1.0000000
NODE_23974_length_610_cov_10.191781	303	383	0	80	80	1.0000000
NODE_23980_length_610_cov_4.998043	129	181	2	52	52	1.0000000
NODE_23980_length_610_cov_4.998043	182	234	0	43	52	0.8269231
NODE_23980_length_610_cov_4.998043	182	234	2	9	52	0.1730769
NODE_23989_length_610_cov_3.479452	215	267	0	52	52	1.0000000
NODE_24059_length_609_cov_21.117647	80	160	0	17	80	0.2125000
NODE_24059_length_609_cov_21.117647	80	160	4	63	80	0.7875000
NODE_24059_length_609_cov_21.117647	133	213	0	18	80	0.2250000
NODE_24059_length_609_cov_21.117647	133	213	2	4	80	0.0500000
NODE_24059_length_609_cov_21.117647	133	213	3	1	80	0.0125000
NODE_24059_length_609_cov_21.117647	133	213	4	57	80	0.7125000
NODE_24060_length_609_cov_11.300000	218	298	0	39	80	0.4875000
NODE_24060_length_609_cov_11.300000	218	298	2	41	80	0.5125000
NODE_24060_length_609_cov_11.300000	271	351	0	18	80	0.2250000
NODE_24060_length_609_cov_11.300000	271	351	2	62	80	0.7750000
NODE_24061_length_609_cov_10.778431	239	319	0	6	80	0.0750000
NODE_24061_length_609_cov_10.778431	239	319	2	74	80	0.9250000
NODE_24061_length_609_cov_10.778431	292	372	0	10	80	0.1250000
NODE_24061_length_609_cov_10.778431	292	372	2	70	80	0.8750000
NODE_24062_length_609_cov_10.298039	340	420	0	80	80	1.0000000
NODE_24062_length_609_cov_10.298039	393	473	0	80	80	1.0000000
NODE_24062_length_609_cov_10.298039	469	537	0	68	68	1.0000000
NODE_24063_length_609_cov_10.270588	217	297	0	15	80	0.1875000
NODE_24063_length_609_cov_10.270588	217	297	2	38	80	0.4750000
NODE_24063_length_609_cov_10.270588	217	297	4	27	80	0.3375000
NODE_24063_length_609_cov_10.270588	270	353	1	39	83	0.4698795
NODE_24063_length_609_cov_10.270588	270	353	2	11	83	0.1325301
NODE_24063_length_609_cov_10.270588	270	353	4	33	83	0.3975904
NODE_24064_length_609_cov_8.345098	408	488	0	80	80	1.0000000
NODE_24064_length_609_cov_8.345098	461	515	0	54	54	1.0000000
NODE_24064_length_609_cov_8.345098	537	566	0	29	29	1.0000000
NODE_24066_length_609_cov_6.054902	219	299	0	42	80	0.5250000
NODE_24066_length_609_cov_6.054902	219	299	2	16	80	0.2000000
NODE_24066_length_609_cov_6.054902	219	299	4	22	80	0.2750000
NODE_24066_length_609_cov_6.054902	272	352	2	15	80	0.1875000
NODE_24066_length_609_cov_6.054902	272	352	4	65	80	0.8125000
NODE_24067_length_609_cov_5.986275	219	299	0	80	80	1.0000000
NODE_24067_length_609_cov_5.986275	272	352	0	60	80	0.7500000
NODE_24067_length_609_cov_5.986275	272	352	1	5	80	0.0625000
NODE_24067_length_609_cov_5.986275	272	352	2	15	80	0.1875000
NODE_24160_length_608_cov_76.257367	300	380	2	27	80	0.3375000
NODE_24160_length_608_cov_76.257367	300	380	4	29	80	0.3625000
NODE_24160_length_608_cov_76.257367	300	380	6	7	80	0.0875000
NODE_24160_length_608_cov_76.257367	300	380	8	17	80	0.2125000
NODE_24160_length_608_cov_76.257367	353	433	4	28	80	0.3500000
NODE_24160_length_608_cov_76.257367	353	433	6	35	80	0.4375000
NODE_24160_length_608_cov_76.257367	353	433	8	17	80	0.2125000
NODE_24161_length_608_cov_13.271120	252	332	0	16	80	0.2000000
NODE_24161_length_608_cov_13.271120	252	332	2	27	80	0.3375000
NODE_24161_length_608_cov_13.271120	252	332	4	11	80	0.1375000
NODE_24161_length_608_cov_13.271120	252	332	6	26	80	0.3250000
NODE_24161_length_608_cov_13.271120	305	385	4	13	80	0.1625000
NODE_24161_length_608_cov_13.271120	305	385	6	67	80	0.8375000
NODE_24162_length_608_cov_11.583497	63	139	0	76	76	1.0000000
NODE_24162_length_608_cov_11.583497	112	192	0	80	80	1.0000000
NODE_24164_length_608_cov_8.076621	53	133	34	2	80	0.0250000
NODE_24164_length_608_cov_8.076621	53	133	36	6	80	0.0750000
NODE_24164_length_608_cov_8.076621	53	133	40	1	80	0.0125000
NODE_24164_length_608_cov_8.076621	53	133	44	1	80	0.0125000
NODE_24164_length_608_cov_8.076621	53	133	46	1	80	0.0125000
NODE_24164_length_608_cov_8.076621	53	133	50	2	80	0.0250000
NODE_24164_length_608_cov_8.076621	53	133	56	3	80	0.0375000
NODE_24164_length_608_cov_8.076621	53	133	58	8	80	0.1000000
NODE_24164_length_608_cov_8.076621	53	133	60	3	80	0.0375000
NODE_24164_length_608_cov_8.076621	53	133	73	2	80	0.0250000
NODE_24164_length_608_cov_8.076621	53	133	75	1	80	0.0125000
NODE_24164_length_608_cov_8.076621	53	133	79	1	80	0.0125000
NODE_24164_length_608_cov_8.076621	53	133	81	11	80	0.1375000
NODE_24164_length_608_cov_8.076621	53	133	83	4	80	0.0500000
NODE_24164_length_608_cov_8.076621	53	133	85	19	80	0.2375000
NODE_24164_length_608_cov_8.076621	53	133	87	15	80	0.1875000
NODE_24164_length_608_cov_8.076621	106	186	2	26	80	0.3250000
NODE_24164_length_608_cov_8.076621	106	186	7	1	80	0.0125000
NODE_24164_length_608_cov_8.076621	106	186	8	1	80	0.0125000
NODE_24164_length_608_cov_8.076621	106	186	10	1	80	0.0125000
NODE_24164_length_608_cov_8.076621	106	186	11	1	80	0.0125000
NODE_24164_length_608_cov_8.076621	106	186	13	3	80	0.0375000
NODE_24164_length_608_cov_8.076621	106	186	15	1	80	0.0125000
NODE_24164_length_608_cov_8.076621	106	186	17	3	80	0.0375000
NODE_24164_length_608_cov_8.076621	106	186	19	9	80	0.1125000
NODE_24164_length_608_cov_8.076621	106	186	21	2	80	0.0250000
NODE_24164_length_608_cov_8.076621	106	186	25	1	80	0.0125000
NODE_24164_length_608_cov_8.076621	106	186	32	2	80	0.0250000
NODE_24164_length_608_cov_8.076621	106	186	33	2	80	0.0250000
NODE_24164_length_608_cov_8.076621	106	186	34	2	80	0.0250000
NODE_24164_length_608_cov_8.076621	106	186	36	6	80	0.0750000
NODE_24164_length_608_cov_8.076621	106	186	40	1	80	0.0125000
NODE_24164_length_608_cov_8.076621	106	186	44	1	80	0.0125000
NODE_24164_length_608_cov_8.076621	106	186	46	1	80	0.0125000
NODE_24164_length_608_cov_8.076621	106	186	50	2	80	0.0250000
NODE_24164_length_608_cov_8.076621	106	186	56	3	80	0.0375000
NODE_24164_length_608_cov_8.076621	106	186	58	8	80	0.1000000
NODE_24164_length_608_cov_8.076621	106	186	60	3	80	0.0375000
NODE_24165_length_608_cov_7.994106	279	326	0	47	47	1.0000000
NODE_24165_length_608_cov_7.994106	348	373	0	25	25	1.0000000
NODE_24166_length_608_cov_7.939096	247	277	0	30	30	1.0000000
NODE_24177_length_608_cov_3.829077	313	393	0	80	80	1.0000000
NODE_24177_length_608_cov_3.829077	366	446	0	80	80	1.0000000
NODE_24251_length_608_cov_1.064833	472	512	0	9	40	0.2250000
NODE_24251_length_608_cov_1.064833	472	512	2	31	40	0.7750000
NODE_24281_length_607_cov_61.316929	347	427	8	27	80	0.3375000
NODE_24281_length_607_cov_61.316929	347	427	10	23	80	0.2875000
NODE_24281_length_607_cov_61.316929	347	427	11	1	80	0.0125000
NODE_24281_length_607_cov_61.316929	347	427	12	6	80	0.0750000
NODE_24281_length_607_cov_61.316929	347	427	14	5	80	0.0625000
NODE_24281_length_607_cov_61.316929	347	427	16	18	80	0.2250000
NODE_24281_length_607_cov_61.316929	347	427	8	27	80	0.3375000
NODE_24281_length_607_cov_61.316929	347	427	10	23	80	0.2875000
NODE_24281_length_607_cov_61.316929	347	427	11	1	80	0.0125000
NODE_24281_length_607_cov_61.316929	347	427	12	6	80	0.0750000
NODE_24281_length_607_cov_61.316929	347	427	14	5	80	0.0625000
NODE_24281_length_607_cov_61.316929	347	427	16	18	80	0.2250000
NODE_24281_length_607_cov_61.316929	347	427	8	27	80	0.3375000
NODE_24281_length_607_cov_61.316929	347	427	10	23	80	0.2875000
NODE_24281_length_607_cov_61.316929	347	427	11	1	80	0.0125000
NODE_24281_length_607_cov_61.316929	347	427	12	6	80	0.0750000
NODE_24281_length_607_cov_61.316929	347	427	14	5	80	0.0625000
NODE_24281_length_607_cov_61.316929	347	427	16	18	80	0.2250000
NODE_24281_length_607_cov_61.316929	364	427	8	15	63	0.2380952
NODE_24281_length_607_cov_61.316929	364	427	10	18	63	0.2857143
NODE_24281_length_607_cov_61.316929	364	427	11	1	63	0.0158730
NODE_24281_length_607_cov_61.316929	364	427	12	6	63	0.0952381
NODE_24281_length_607_cov_61.316929	364	427	14	5	63	0.0793651
NODE_24281_length_607_cov_61.316929	364	427	16	18	63	0.2857143
NODE_24281_length_607_cov_61.316929	400	480	10	32	80	0.4000000
NODE_24281_length_607_cov_61.316929	400	480	12	22	80	0.2750000
NODE_24281_length_607_cov_61.316929	400	480	14	8	80	0.1000000
NODE_24281_length_607_cov_61.316929	400	480	16	18	80	0.2250000
NODE_24281_length_607_cov_61.316929	400	480	10	32	80	0.4000000
NODE_24281_length_607_cov_61.316929	400	480	12	22	80	0.2750000
NODE_24281_length_607_cov_61.316929	400	480	14	8	80	0.1000000
NODE_24281_length_607_cov_61.316929	400	480	16	18	80	0.2250000
NODE_24281_length_607_cov_61.316929	400	480	10	32	80	0.4000000
NODE_24281_length_607_cov_61.316929	400	480	12	22	80	0.2750000
NODE_24281_length_607_cov_61.316929	400	480	14	8	80	0.1000000
NODE_24281_length_607_cov_61.316929	400	480	16	18	80	0.2250000
NODE_24281_length_607_cov_61.316929	400	480	10	32	80	0.4000000
NODE_24281_length_607_cov_61.316929	400	480	12	22	80	0.2750000
NODE_24281_length_607_cov_61.316929	400	480	14	8	80	0.1000000
NODE_24281_length_607_cov_61.316929	400	480	16	18	80	0.2250000
NODE_24281_length_607_cov_61.316929	476	556	12	5	80	0.0625000
NODE_24281_length_607_cov_61.316929	476	556	14	13	80	0.1625000
NODE_24281_length_607_cov_61.316929	476	556	15	1	80	0.0125000
NODE_24281_length_607_cov_61.316929	476	556	16	29	80	0.3625000
NODE_24281_length_607_cov_61.316929	476	556	18	32	80	0.4000000
NODE_24281_length_607_cov_61.316929	476	556	12	5	80	0.0625000
NODE_24281_length_607_cov_61.316929	476	556	14	13	80	0.1625000
NODE_24281_length_607_cov_61.316929	476	556	15	1	80	0.0125000
NODE_24281_length_607_cov_61.316929	476	556	16	29	80	0.3625000
NODE_24281_length_607_cov_61.316929	476	556	18	32	80	0.4000000
NODE_24281_length_607_cov_61.316929	476	556	12	5	80	0.0625000
NODE_24281_length_607_cov_61.316929	476	556	14	13	80	0.1625000
NODE_24281_length_607_cov_61.316929	476	556	15	1	80	0.0125000
NODE_24281_length_607_cov_61.316929	476	556	16	29	80	0.3625000
NODE_24281_length_607_cov_61.316929	476	556	18	32	80	0.4000000
NODE_24281_length_607_cov_61.316929	529	595	2	5	66	0.0757576
NODE_24281_length_607_cov_61.316929	529	595	4	3	66	0.0454545
NODE_24281_length_607_cov_61.316929	529	595	6	3	66	0.0454545
NODE_24281_length_607_cov_61.316929	529	595	8	6	66	0.0909091
NODE_24281_length_607_cov_61.316929	529	595	10	13	66	0.1969697
NODE_24281_length_607_cov_61.316929	529	595	12	7	66	0.1060606
NODE_24281_length_607_cov_61.316929	529	595	14	10	66	0.1515152
NODE_24281_length_607_cov_61.316929	529	595	15	1	66	0.0151515
NODE_24281_length_607_cov_61.316929	529	595	16	18	66	0.2727273
NODE_24281_length_607_cov_61.316929	529	607	0	5	78	0.0641026
NODE_24281_length_607_cov_61.316929	529	607	2	12	78	0.1538462
NODE_24281_length_607_cov_61.316929	529	607	4	3	78	0.0384615
NODE_24281_length_607_cov_61.316929	529	607	6	3	78	0.0384615
NODE_24281_length_607_cov_61.316929	529	607	8	6	78	0.0769231
NODE_24281_length_607_cov_61.316929	529	607	10	13	78	0.1666667
NODE_24281_length_607_cov_61.316929	529	607	12	7	78	0.0897436
NODE_24281_length_607_cov_61.316929	529	607	14	10	78	0.1282051
NODE_24281_length_607_cov_61.316929	529	607	15	1	78	0.0128205
NODE_24281_length_607_cov_61.316929	529	607	16	18	78	0.2307692
NODE_24281_length_607_cov_61.316929	529	600	2	10	71	0.1408451
NODE_24281_length_607_cov_61.316929	529	600	4	3	71	0.0422535
NODE_24281_length_607_cov_61.316929	529	600	6	3	71	0.0422535
NODE_24281_length_607_cov_61.316929	529	600	8	6	71	0.0845070
NODE_24281_length_607_cov_61.316929	529	600	10	13	71	0.1830986
NODE_24281_length_607_cov_61.316929	529	600	12	7	71	0.0985916
NODE_24281_length_607_cov_61.316929	529	600	14	10	71	0.1408451
NODE_24281_length_607_cov_61.316929	529	600	15	1	71	0.0140845
NODE_24281_length_607_cov_61.316929	529	600	16	18	71	0.2535211
NODE_24281_length_607_cov_61.316929	534	607	0	5	73	0.0684932
NODE_24281_length_607_cov_61.316929	534	607	2	12	73	0.1643836
NODE_24281_length_607_cov_61.316929	534	607	4	3	73	0.0410959
NODE_24281_length_607_cov_61.316929	534	607	6	3	73	0.0410959
NODE_24281_length_607_cov_61.316929	534	607	8	6	73	0.0821918
NODE_24281_length_607_cov_61.316929	534	607	10	13	73	0.1780822
NODE_24281_length_607_cov_61.316929	534	607	12	7	73	0.0958904
NODE_24281_length_607_cov_61.316929	534	607	14	10	73	0.1369863
NODE_24281_length_607_cov_61.316929	534	607	15	1	73	0.0136986
NODE_24281_length_607_cov_61.316929	534	607	16	13	73	0.1780822
NODE_24282_length_607_cov_16.852362	383	463	0	13	80	0.1625000
NODE_24282_length_607_cov_16.852362	383	463	4	65	80	0.8125000
NODE_24282_length_607_cov_16.852362	383	463	5	2	80	0.0250000
NODE_24282_length_607_cov_16.852362	436	516	0	66	80	0.8250000
NODE_24282_length_607_cov_16.852362	436	516	4	14	80	0.1750000
NODE_24283_length_607_cov_12.889764	67	147	0	80	80	1.0000000
NODE_24283_length_607_cov_12.889764	120	200	0	80	80	1.0000000
NODE_24284_length_607_cov_11.023622	122	202	0	80	80	1.0000000
NODE_24284_length_607_cov_11.023622	175	255	0	80	80	1.0000000
NODE_24285_length_607_cov_10.690945	199	279	0	2	80	0.0250000
NODE_24285_length_607_cov_10.690945	199	279	1	24	80	0.3000000
NODE_24285_length_607_cov_10.690945	199	279	2	54	80	0.6750000
NODE_24285_length_607_cov_10.690945	252	332	0	35	80	0.4375000
NODE_24285_length_607_cov_10.690945	252	332	1	24	80	0.3000000
NODE_24285_length_607_cov_10.690945	252	332	2	21	80	0.2625000
NODE_24290_length_607_cov_5.818898	301	386	0	85	85	1.0000000
NODE_24291_length_607_cov_5.771654	278	358	0	80	80	1.0000000
NODE_24291_length_607_cov_5.771654	331	411	0	80	80	1.0000000
NODE_24295_length_607_cov_4.816929	282	362	0	80	80	1.0000000
NODE_24295_length_607_cov_4.816929	335	415	0	80	80	1.0000000
NODE_24300_length_607_cov_4.015748	295	354	0	53	59	0.8983051
NODE_24300_length_607_cov_4.015748	295	354	2	6	59	0.1016949
NODE_24310_length_607_cov_3.088583	107	158	0	51	51	1.0000000
NODE_24331_length_607_cov_1.791339	204	247	2	22	43	0.5116279
NODE_24331_length_607_cov_1.791339	204	247	4	21	43	0.4883721
NODE_24400_length_606_cov_42.264300	182	262	0	45	80	0.5625000
NODE_24400_length_606_cov_42.264300	182	262	2	32	80	0.4000000
NODE_24400_length_606_cov_42.264300	182	262	6	3	80	0.0375000
NODE_24400_length_606_cov_42.264300	235	315	2	24	80	0.3000000
NODE_24400_length_606_cov_42.264300	235	315	4	9	80	0.1125000
NODE_24400_length_606_cov_42.264300	235	315	6	47	80	0.5875000
NODE_24402_length_606_cov_26.341223	371	451	0	80	80	1.0000000
NODE_24402_length_606_cov_26.341223	424	504	0	80	80	1.0000000
NODE_24403_length_606_cov_14.895464	308	388	0	6	80	0.0750000
NODE_24403_length_606_cov_14.895464	308	388	2	74	80	0.9250000
NODE_24403_length_606_cov_14.895464	361	441	0	38	80	0.4750000
NODE_24403_length_606_cov_14.895464	361	441	2	42	80	0.5250000
NODE_24406_length_606_cov_7.934911	412	492	0	80	80	1.0000000
NODE_24406_length_606_cov_7.934911	465	545	0	80	80	1.0000000
NODE_24407_length_606_cov_7.481262	250	330	0	6	80	0.0750000
NODE_24407_length_606_cov_7.481262	250	330	2	74	80	0.9250000
NODE_24407_length_606_cov_7.481262	303	383	0	2	80	0.0250000
NODE_24407_length_606_cov_7.481262	303	383	2	49	80	0.6125000
NODE_24407_length_606_cov_7.481262	303	383	4	3	80	0.0375000
NODE_24407_length_606_cov_7.481262	303	383	5	1	80	0.0125000
NODE_24407_length_606_cov_7.481262	303	383	6	9	80	0.1125000
NODE_24407_length_606_cov_7.481262	303	383	10	3	80	0.0375000
NODE_24407_length_606_cov_7.481262	303	383	12	1	80	0.0125000
NODE_24407_length_606_cov_7.481262	303	383	20	5	80	0.0625000
NODE_24407_length_606_cov_7.481262	303	383	22	5	80	0.0625000
NODE_24407_length_606_cov_7.481262	303	383	24	2	80	0.0250000
NODE_24409_length_606_cov_6.842209	139	219	0	80	80	1.0000000
NODE_24409_length_606_cov_6.842209	192	272	0	80	80	1.0000000
NODE_24428_length_606_cov_3.384615	156	206	0	50	50	1.0000000
NODE_24433_length_606_cov_2.670611	113	193	0	4	80	0.0500000
NODE_24433_length_606_cov_2.670611	113	193	2	42	80	0.5250000
NODE_24433_length_606_cov_2.670611	113	193	4	34	80	0.4250000
NODE_24525_length_605_cov_63.343874	7	83	0	3	76	0.0394737
NODE_24525_length_605_cov_63.343874	7	83	2	56	76	0.7368421
NODE_24525_length_605_cov_63.343874	7	83	4	17	76	0.2236842
NODE_24525_length_605_cov_63.343874	12	83	2	54	71	0.7605634
NODE_24525_length_605_cov_63.343874	12	83	4	17	71	0.2394366
NODE_24525_length_605_cov_63.343874	17	83	2	49	66	0.7424242
NODE_24525_length_605_cov_63.343874	17	83	4	17	66	0.2575758
NODE_24525_length_605_cov_63.343874	56	136	2	30	80	0.3750000
NODE_24525_length_605_cov_63.343874	56	136	4	42	80	0.5250000
NODE_24525_length_605_cov_63.343874	56	136	6	8	80	0.1000000
NODE_24525_length_605_cov_63.343874	56	136	2	30	80	0.3750000
NODE_24525_length_605_cov_63.343874	56	136	4	42	80	0.5250000
NODE_24525_length_605_cov_63.343874	56	136	6	8	80	0.1000000
NODE_24525_length_605_cov_63.343874	56	136	2	30	80	0.3750000
NODE_24525_length_605_cov_63.343874	56	136	4	42	80	0.5250000
NODE_24525_length_605_cov_63.343874	56	136	6	8	80	0.1000000
NODE_24525_length_605_cov_63.343874	132	212	6	7	80	0.0875000
NODE_24525_length_605_cov_63.343874	132	212	8	5	80	0.0625000
NODE_24525_length_605_cov_63.343874	132	212	10	9	80	0.1125000
NODE_24525_length_605_cov_63.343874	132	212	12	41	80	0.5125000
NODE_24525_length_605_cov_63.343874	132	212	14	18	80	0.2250000
NODE_24525_length_605_cov_63.343874	132	212	6	7	80	0.0875000
NODE_24525_length_605_cov_63.343874	132	212	8	5	80	0.0625000
NODE_24525_length_605_cov_63.343874	132	212	10	9	80	0.1125000
NODE_24525_length_605_cov_63.343874	132	212	12	41	80	0.5125000
NODE_24525_length_605_cov_63.343874	132	212	14	18	80	0.2250000
NODE_24525_length_605_cov_63.343874	132	210	6	7	78	0.0897436
NODE_24525_length_605_cov_63.343874	132	210	8	5	78	0.0641026
NODE_24525_length_605_cov_63.343874	132	210	10	9	78	0.1153846
NODE_24525_length_605_cov_63.343874	132	210	12	39	78	0.5000000
NODE_24525_length_605_cov_63.343874	132	210	14	18	78	0.2307692
NODE_24525_length_605_cov_63.343874	132	212	6	7	80	0.0875000
NODE_24525_length_605_cov_63.343874	132	212	8	5	80	0.0625000
NODE_24525_length_605_cov_63.343874	132	212	10	9	80	0.1125000
NODE_24525_length_605_cov_63.343874	132	212	12	41	80	0.5125000
NODE_24525_length_605_cov_63.343874	132	212	14	18	80	0.2250000
NODE_24525_length_605_cov_63.343874	132	212	6	7	80	0.0875000
NODE_24525_length_605_cov_63.343874	132	212	8	5	80	0.0625000
NODE_24525_length_605_cov_63.343874	132	212	10	9	80	0.1125000
NODE_24525_length_605_cov_63.343874	132	212	12	41	80	0.5125000
NODE_24525_length_605_cov_63.343874	132	212	14	18	80	0.2250000
NODE_24525_length_605_cov_63.343874	185	265	0	16	80	0.2000000
NODE_24525_length_605_cov_63.343874	185	265	4	22	80	0.2750000
NODE_24525_length_605_cov_63.343874	185	265	6	3	80	0.0375000
NODE_24525_length_605_cov_63.343874	185	265	8	3	80	0.0375000
NODE_24525_length_605_cov_63.343874	185	265	10	5	80	0.0625000
NODE_24525_length_605_cov_63.343874	185	265	12	31	80	0.3875000
NODE_24526_length_605_cov_48.191700	298	374	0	76	76	1.0000000
NODE_24526_length_605_cov_48.191700	347	427	0	80	80	1.0000000
NODE_24528_length_605_cov_33.328063	57	137	168	1	80	0.0125000
NODE_24528_length_605_cov_33.328063	57	137	170	3	80	0.0375000
NODE_24528_length_605_cov_33.328063	57	137	174	1	80	0.0125000
NODE_24528_length_605_cov_33.328063	57	137	178	1	80	0.0125000
NODE_24528_length_605_cov_33.328063	57	137	180	4	80	0.0500000
NODE_24528_length_605_cov_33.328063	57	137	186	1	80	0.0125000
NODE_24528_length_605_cov_33.328063	57	137	187	3	80	0.0375000
NODE_24528_length_605_cov_33.328063	57	137	189	1	80	0.0125000
NODE_24528_length_605_cov_33.328063	57	137	193	1	80	0.0125000
NODE_24528_length_605_cov_33.328063	57	137	195	1	80	0.0125000
NODE_24528_length_605_cov_33.328063	57	137	197	1	80	0.0125000
NODE_24528_length_605_cov_33.328063	57	137	199	1	80	0.0125000
NODE_24528_length_605_cov_33.328063	57	137	201	1	80	0.0125000
NODE_24528_length_605_cov_33.328063	57	137	203	2	80	0.0250000
NODE_24528_length_605_cov_33.328063	57	137	205	1	80	0.0125000
NODE_24528_length_605_cov_33.328063	57	137	208	1	80	0.0125000
NODE_24528_length_605_cov_33.328063	57	137	210	1	80	0.0125000
NODE_24528_length_605_cov_33.328063	57	137	212	1	80	0.0125000
NODE_24528_length_605_cov_33.328063	57	137	216	1	80	0.0125000
NODE_24528_length_605_cov_33.328063	57	137	218	1	80	0.0125000
NODE_24528_length_605_cov_33.328063	57	137	220	1	80	0.0125000
NODE_24528_length_605_cov_33.328063	57	137	224	2	80	0.0250000
NODE_24528_length_605_cov_33.328063	57	137	228	1	80	0.0125000
NODE_24528_length_605_cov_33.328063	57	137	236	1	80	0.0125000
NODE_24528_length_605_cov_33.328063	57	137	238	1	80	0.0125000
NODE_24528_length_605_cov_33.328063	57	137	239	1	80	0.0125000
NODE_24528_length_605_cov_33.328063	57	137	244	1	80	0.0125000
NODE_24528_length_605_cov_33.328063	57	137	247	1	80	0.0125000
NODE_24528_length_605_cov_33.328063	57	137	249	1	80	0.0125000
NODE_24528_length_605_cov_33.328063	57	137	252	2	80	0.0250000
NODE_24528_length_605_cov_33.328063	57	137	254	3	80	0.0375000
NODE_24528_length_605_cov_33.328063	57	137	256	1	80	0.0125000
NODE_24528_length_605_cov_33.328063	57	137	263	1	80	0.0125000
NODE_24528_length_605_cov_33.328063	57	137	267	1	80	0.0125000
NODE_24528_length_605_cov_33.328063	57	137	271	2	80	0.0250000
NODE_24528_length_605_cov_33.328063	57	137	273	1	80	0.0125000
NODE_24528_length_605_cov_33.328063	57	137	275	1	80	0.0125000
NODE_24528_length_605_cov_33.328063	57	137	277	1	80	0.0125000
NODE_24528_length_605_cov_33.328063	57	137	278	1	80	0.0125000
NODE_24528_length_605_cov_33.328063	57	137	280	2	80	0.0250000
NODE_24528_length_605_cov_33.328063	57	137	281	2	80	0.0250000
NODE_24528_length_605_cov_33.328063	57	137	282	1	80	0.0125000
NODE_24528_length_605_cov_33.328063	57	137	283	1	80	0.0125000
NODE_24528_length_605_cov_33.328063	57	137	284	2	80	0.0250000
NODE_24528_length_605_cov_33.328063	57	137	285	1	80	0.0125000
NODE_24528_length_605_cov_33.328063	57	137	286	1	80	0.0125000
NODE_24528_length_605_cov_33.328063	57	137	287	2	80	0.0250000
NODE_24528_length_605_cov_33.328063	57	137	288	2	80	0.0250000
NODE_24528_length_605_cov_33.328063	57	137	290	3	80	0.0375000
NODE_24528_length_605_cov_33.328063	57	137	291	2	80	0.0250000
NODE_24528_length_605_cov_33.328063	57	137	292	4	80	0.0500000
NODE_24528_length_605_cov_33.328063	57	137	293	1	80	0.0125000
NODE_24528_length_605_cov_33.328063	57	137	294	2	80	0.0250000
NODE_24528_length_605_cov_33.328063	57	137	295	1	80	0.0125000
NODE_24528_length_605_cov_33.328063	57	137	296	1	80	0.0125000
NODE_24528_length_605_cov_33.328063	140	175	376	1	35	0.0285714
NODE_24528_length_605_cov_33.328063	140	175	380	2	35	0.0571429
NODE_24528_length_605_cov_33.328063	140	175	383	1	35	0.0285714
NODE_24528_length_605_cov_33.328063	140	175	384	1	35	0.0285714
NODE_24528_length_605_cov_33.328063	140	175	385	2	35	0.0571429
NODE_24528_length_605_cov_33.328063	140	175	386	1	35	0.0285714
NODE_24528_length_605_cov_33.328063	140	175	395	1	35	0.0285714
NODE_24528_length_605_cov_33.328063	140	175	407	1	35	0.0285714
NODE_24528_length_605_cov_33.328063	140	175	413	1	35	0.0285714
NODE_24528_length_605_cov_33.328063	140	175	414	1	35	0.0285714
NODE_24528_length_605_cov_33.328063	140	175	417	1	35	0.0285714
NODE_24528_length_605_cov_33.328063	140	175	422	1	35	0.0285714
NODE_24528_length_605_cov_33.328063	140	175	430	1	35	0.0285714
NODE_24528_length_605_cov_33.328063	140	175	444	1	35	0.0285714
NODE_24528_length_605_cov_33.328063	140	175	454	1	35	0.0285714
NODE_24528_length_605_cov_33.328063	140	175	455	1	35	0.0285714
NODE_24528_length_605_cov_33.328063	140	175	475	1	35	0.0285714
NODE_24528_length_605_cov_33.328063	140	175	482	1	35	0.0285714
NODE_24528_length_605_cov_33.328063	140	175	483	1	35	0.0285714
NODE_24528_length_605_cov_33.328063	140	175	485	1	35	0.0285714
NODE_24528_length_605_cov_33.328063	140	175	488	1	35	0.0285714
NODE_24528_length_605_cov_33.328063	140	175	489	2	35	0.0571429
NODE_24528_length_605_cov_33.328063	140	175	494	1	35	0.0285714
NODE_24528_length_605_cov_33.328063	140	175	498	1	35	0.0285714
NODE_24528_length_605_cov_33.328063	140	175	500	1	35	0.0285714
NODE_24528_length_605_cov_33.328063	140	175	501	1	35	0.0285714
NODE_24528_length_605_cov_33.328063	140	175	505	1	35	0.0285714
NODE_24528_length_605_cov_33.328063	140	175	510	1	35	0.0285714
NODE_24528_length_605_cov_33.328063	140	175	511	1	35	0.0285714
NODE_24528_length_605_cov_33.328063	140	175	515	1	35	0.0285714
NODE_24528_length_605_cov_33.328063	140	175	517	1	35	0.0285714
NODE_24528_length_605_cov_33.328063	140	175	530	1	35	0.0285714
NODE_24529_length_605_cov_26.717391	353	433	0	19	80	0.2375000
NODE_24529_length_605_cov_26.717391	353	433	2	61	80	0.7625000
NODE_24529_length_605_cov_26.717391	406	486	0	21	80	0.2625000
NODE_24529_length_605_cov_26.717391	406	486	2	59	80	0.7375000
NODE_24530_length_605_cov_17.677866	215	295	0	80	80	1.0000000
NODE_24530_length_605_cov_17.677866	268	348	0	80	80	1.0000000
NODE_24531_length_605_cov_15.225296	144	224	4	19	80	0.2375000
NODE_24531_length_605_cov_15.225296	144	224	6	61	80	0.7625000
NODE_24531_length_605_cov_15.225296	197	277	0	48	80	0.6000000
NODE_24531_length_605_cov_15.225296	197	277	4	24	80	0.3000000
NODE_24531_length_605_cov_15.225296	197	277	6	8	80	0.1000000
NODE_24532_length_605_cov_14.990119	136	216	1	62	80	0.7750000
NODE_24532_length_605_cov_14.990119	136	216	2	18	80	0.2250000
NODE_24532_length_605_cov_14.990119	189	269	0	37	80	0.4625000
NODE_24532_length_605_cov_14.990119	189	269	1	9	80	0.1125000
NODE_24532_length_605_cov_14.990119	189	269	2	34	80	0.4250000
NODE_24533_length_605_cov_10.835968	103	183	0	80	80	1.0000000
NODE_24533_length_605_cov_10.835968	156	236	0	80	80	1.0000000
NODE_24534_length_605_cov_9.169960	306	377	0	23	71	0.3239437
NODE_24534_length_605_cov_9.169960	306	377	2	6	71	0.0845070
NODE_24534_length_605_cov_9.169960	306	377	4	42	71	0.5915493
NODE_24534_length_605_cov_9.169960	359	432	2	16	73	0.2191781
NODE_24534_length_605_cov_9.169960	359	432	4	57	73	0.7808219
NODE_24546_length_605_cov_4.308300	159	239	0	80	80	1.0000000
NODE_24546_length_605_cov_4.308300	271	338	14	2	67	0.0298507
NODE_24546_length_605_cov_4.308300	271	338	16	6	67	0.0895522
NODE_24546_length_605_cov_4.308300	271	338	18	35	67	0.5223880
NODE_24546_length_605_cov_4.308300	271	338	20	24	67	0.3582090
NODE_24546_length_605_cov_4.308300	275	350	14	1	75	0.0133333
NODE_24546_length_605_cov_4.308300	275	350	16	5	75	0.0666667
NODE_24546_length_605_cov_4.308300	275	350	18	45	75	0.6000000
NODE_24546_length_605_cov_4.308300	275	350	20	24	75	0.3200000
NODE_24546_length_605_cov_4.308300	315	372	4	1	57	0.0175439
NODE_24546_length_605_cov_4.308300	315	372	6	1	57	0.0175439
NODE_24546_length_605_cov_4.308300	315	372	12	11	57	0.1929825
NODE_24546_length_605_cov_4.308300	315	372	14	10	57	0.1754386
NODE_24546_length_605_cov_4.308300	315	372	16	1	57	0.0175439
NODE_24546_length_605_cov_4.308300	315	372	18	29	57	0.5087720
NODE_24546_length_605_cov_4.308300	315	372	20	4	57	0.0701754
NODE_24546_length_605_cov_4.308300	328	373	4	2	45	0.0444444
NODE_24546_length_605_cov_4.308300	328	373	6	1	45	0.0222222
NODE_24546_length_605_cov_4.308300	328	373	12	11	45	0.2444444
NODE_24546_length_605_cov_4.308300	328	373	14	10	45	0.2222222
NODE_24546_length_605_cov_4.308300	328	373	16	1	45	0.0222222
NODE_24546_length_605_cov_4.308300	328	373	18	20	45	0.4444444
NODE_24558_length_605_cov_3.120553	216	287	0	71	71	1.0000000
NODE_24561_length_605_cov_2.909091	408	487	4	11	79	0.1392405
NODE_24561_length_605_cov_2.909091	408	487	6	3	79	0.0379747
NODE_24561_length_605_cov_2.909091	408	487	8	20	79	0.2531646
NODE_24561_length_605_cov_2.909091	408	487	10	4	79	0.0506329
NODE_24561_length_605_cov_2.909091	408	487	11	25	79	0.3164557
NODE_24561_length_605_cov_2.909091	408	487	13	16	79	0.2025317
NODE_24577_length_605_cov_1.897233	230	273	0	43	43	1.0000000
NODE_24603_length_605_cov_1.339921	168	210	3	21	42	0.5000000
NODE_24603_length_605_cov_1.339921	168	210	6	7	42	0.1666667
NODE_24603_length_605_cov_1.339921	168	210	8	14	42	0.3333333
NODE_24636_length_604_cov_30.411881	93	173	0	80	80	1.0000000
NODE_24636_length_604_cov_30.411881	146	226	0	80	80	1.0000000
NODE_24637_length_604_cov_20.099010	414	494	0	15	80	0.1875000
NODE_24637_length_604_cov_20.099010	414	494	2	65	80	0.8125000
NODE_24637_length_604_cov_20.099010	467	547	0	68	80	0.8500000
NODE_24637_length_604_cov_20.099010	467	547	2	12	80	0.1500000
NODE_24639_length_604_cov_10.291089	184	264	0	80	80	1.0000000
NODE_24639_length_604_cov_10.291089	237	317	0	80	80	1.0000000
NODE_24646_length_604_cov_6.033663	265	345	0	2	80	0.0250000
NODE_24646_length_604_cov_6.033663	265	345	2	5	80	0.0625000
NODE_24646_length_604_cov_6.033663	265	345	4	70	80	0.8750000
NODE_24646_length_604_cov_6.033663	265	345	6	3	80	0.0375000
NODE_24646_length_604_cov_6.033663	318	397	4	24	79	0.3037975
NODE_24646_length_604_cov_6.033663	318	397	6	5	79	0.0632911
NODE_24646_length_604_cov_6.033663	318	397	8	50	79	0.6329114
NODE_24654_length_604_cov_4.316832	40	106	0	10	66	0.1515152
NODE_24654_length_604_cov_4.316832	40	106	2	56	66	0.8484849
NODE_24654_length_604_cov_4.316832	377	435	0	58	58	1.0000000
NODE_24692_length_604_cov_1.805941	299	380	0	41	81	0.5061728
NODE_24692_length_604_cov_1.805941	299	380	2	40	81	0.4938272
NODE_24692_length_604_cov_1.805941	353	433	0	27	80	0.3375000
NODE_24692_length_604_cov_1.805941	353	433	2	53	80	0.6625000
NODE_24732_length_603_cov_18.761905	108	188	0	80	80	1.0000000
NODE_24732_length_603_cov_18.761905	161	241	0	80	80	1.0000000
NODE_24734_length_603_cov_8.996032	163	243	0	53	80	0.6625000
NODE_24734_length_603_cov_8.996032	163	243	2	27	80	0.3375000
NODE_24734_length_603_cov_8.996032	216	296	2	80	80	1.0000000
NODE_24735_length_603_cov_8.970238	413	493	0	80	80	1.0000000
NODE_24736_length_603_cov_7.212302	324	404	0	80	80	1.0000000
NODE_24736_length_603_cov_7.212302	377	457	0	80	80	1.0000000
NODE_24739_length_603_cov_5.831349	351	385	0	34	34	1.0000000
NODE_24744_length_603_cov_4.744048	103	183	0	5	80	0.0625000
NODE_24744_length_603_cov_4.744048	103	183	1	3	80	0.0375000
NODE_24744_length_603_cov_4.744048	103	183	2	72	80	0.9000000
NODE_24744_length_603_cov_4.744048	156	236	0	20	80	0.2500000
NODE_24744_length_603_cov_4.744048	156	236	2	60	80	0.7500000
NODE_24748_length_603_cov_4.115079	219	259	0	40	40	1.0000000
NODE_24755_length_603_cov_3.269841	186	223	0	37	37	1.0000000
NODE_24755_length_603_cov_3.269841	196	276	0	80	80	1.0000000
NODE_24755_length_603_cov_3.269841	367	441	0	48	74	0.6486486
NODE_24755_length_603_cov_3.269841	367	441	2	26	74	0.3513514
NODE_24843_length_602_cov_33.208748	106	186	0	24	80	0.3000000
NODE_24843_length_602_cov_33.208748	106	186	2	56	80	0.7000000
NODE_24843_length_602_cov_33.208748	159	239	0	35	80	0.4375000
NODE_24843_length_602_cov_33.208748	159	239	2	45	80	0.5625000
NODE_24844_length_602_cov_28.922465	319	399	4	19	80	0.2375000
NODE_24844_length_602_cov_28.922465	319	399	5	5	80	0.0625000
NODE_24844_length_602_cov_28.922465	319	399	7	56	80	0.7000000
NODE_24844_length_602_cov_28.922465	372	452	2	35	80	0.4375000
NODE_24844_length_602_cov_28.922465	372	452	4	37	80	0.4625000
NODE_24844_length_602_cov_28.922465	372	452	7	8	80	0.1000000
NODE_24846_length_602_cov_10.930417	248	328	0	80	80	1.0000000
NODE_24846_length_602_cov_10.930417	301	381	0	80	80	1.0000000
NODE_24847_length_602_cov_10.447316	148	207	2	9	59	0.1525424
NODE_24847_length_602_cov_10.447316	148	207	3	7	59	0.1186441
NODE_24847_length_602_cov_10.447316	148	207	4	42	59	0.7118644
NODE_24847_length_602_cov_10.447316	148	207	5	1	59	0.0169492
NODE_24847_length_602_cov_10.447316	181	207	4	26	26	1.0000000
NODE_24847_length_602_cov_10.447316	259	291	2	32	32	1.0000000
NODE_24851_length_602_cov_7.787276	544	565	0	21	21	1.0000000
NODE_24875_length_602_cov_3.332008	157	239	4	13	82	0.1585366
NODE_24875_length_602_cov_3.332008	157	239	6	35	82	0.4268293
NODE_24875_length_602_cov_3.332008	157	239	8	34	82	0.4146341
NODE_24957_length_601_cov_14.952191	183	263	0	80	80	1.0000000
NODE_24957_length_601_cov_14.952191	236	316	0	80	80	1.0000000
NODE_24958_length_601_cov_14.747012	324	404	0	80	80	1.0000000
NODE_24958_length_601_cov_14.747012	377	457	0	68	80	0.8500000
NODE_24958_length_601_cov_14.747012	377	457	2	12	80	0.1500000
NODE_24959_length_601_cov_11.561753	226	306	2	80	80	1.0000000
NODE_24959_length_601_cov_11.561753	279	359	0	46	80	0.5750000
NODE_24959_length_601_cov_11.561753	279	359	2	34	80	0.4250000
NODE_24960_length_601_cov_10.826693	320	388	0	68	68	1.0000000
NODE_24961_length_601_cov_10.392430	243	323	0	80	80	1.0000000
NODE_24961_length_601_cov_10.392430	296	375	0	79	79	1.0000000
NODE_24965_length_601_cov_7.037849	236	316	0	80	80	1.0000000
NODE_24965_length_601_cov_7.037849	289	369	0	80	80	1.0000000
NODE_24969_length_601_cov_5.798805	290	361	0	28	71	0.3943662
NODE_24969_length_601_cov_5.798805	290	361	2	43	71	0.6056338
NODE_24970_length_601_cov_5.657371	228	308	0	80	80	1.0000000
NODE_24973_length_601_cov_5.039841	395	462	6	11	67	0.1641791
NODE_24973_length_601_cov_5.039841	395	462	8	56	67	0.8358209
NODE_24975_length_601_cov_4.735060	184	247	0	63	63	1.0000000
NODE_24995_length_601_cov_2.599602	371	430	0	59	59	1.0000000
NODE_24995_length_601_cov_2.599602	441	494	0	53	53	1.0000000
NODE_25090_length_600_cov_6.341317	125	147	4	22	22	1.0000000
NODE_25103_length_600_cov_3.754491	142	222	2	5	80	0.0625000
NODE_25103_length_600_cov_3.754491	142	222	6	3	80	0.0375000
NODE_25103_length_600_cov_3.754491	142	222	8	2	80	0.0250000
NODE_25103_length_600_cov_3.754491	142	222	10	8	80	0.1000000
NODE_25103_length_600_cov_3.754491	142	222	12	12	80	0.1500000
NODE_25103_length_600_cov_3.754491	142	222	15	13	80	0.1625000
NODE_25103_length_600_cov_3.754491	142	222	17	6	80	0.0750000
NODE_25103_length_600_cov_3.754491	142	222	19	14	80	0.1750000
NODE_25103_length_600_cov_3.754491	142	222	21	17	80	0.2125000
NODE_25126_length_600_cov_2.081836	282	328	0	23	46	0.5000000
NODE_25126_length_600_cov_2.081836	282	328	2	23	46	0.5000000
NODE_25141_length_600_cov_1.728543	381	423	0	42	42	1.0000000
NODE_25190_length_599_cov_36.488000	25	105	40	1	80	0.0125000
NODE_25190_length_599_cov_36.488000	25	105	42	4	80	0.0500000
NODE_25190_length_599_cov_36.488000	25	105	44	1	80	0.0125000
NODE_25190_length_599_cov_36.488000	25	105	46	2	80	0.0250000
NODE_25190_length_599_cov_36.488000	25	105	50	2	80	0.0250000
NODE_25190_length_599_cov_36.488000	25	105	52	1	80	0.0125000
NODE_25190_length_599_cov_36.488000	25	105	54	7	80	0.0875000
NODE_25190_length_599_cov_36.488000	25	105	56	62	80	0.7750000
NODE_25191_length_599_cov_27.870000	255	335	2	80	80	1.0000000
NODE_25191_length_599_cov_27.870000	308	388	0	30	80	0.3750000
NODE_25191_length_599_cov_27.870000	308	388	2	50	80	0.6250000
NODE_25192_length_599_cov_22.640000	229	309	0	11	80	0.1375000
NODE_25192_length_599_cov_22.640000	229	309	2	1	80	0.0125000
NODE_25192_length_599_cov_22.640000	229	309	4	68	80	0.8500000
NODE_25192_length_599_cov_22.640000	229	309	0	11	80	0.1375000
NODE_25192_length_599_cov_22.640000	229	309	2	1	80	0.0125000
NODE_25192_length_599_cov_22.640000	229	309	4	68	80	0.8500000
NODE_25192_length_599_cov_22.640000	229	309	0	11	80	0.1375000
NODE_25192_length_599_cov_22.640000	229	309	2	1	80	0.0125000
NODE_25192_length_599_cov_22.640000	229	309	4	68	80	0.8500000
NODE_25192_length_599_cov_22.640000	229	309	0	11	80	0.1375000
NODE_25192_length_599_cov_22.640000	229	309	2	1	80	0.0125000
NODE_25192_length_599_cov_22.640000	229	309	4	68	80	0.8500000
NODE_25192_length_599_cov_22.640000	229	309	0	11	80	0.1375000
NODE_25192_length_599_cov_22.640000	229	309	2	1	80	0.0125000
NODE_25192_length_599_cov_22.640000	229	309	4	68	80	0.8500000
NODE_25192_length_599_cov_22.640000	282	362	0	64	80	0.8000000
NODE_25192_length_599_cov_22.640000	282	362	2	1	80	0.0125000
NODE_25192_length_599_cov_22.640000	282	362	4	15	80	0.1875000
NODE_25192_length_599_cov_22.640000	282	362	0	64	80	0.8000000
NODE_25192_length_599_cov_22.640000	282	362	2	1	80	0.0125000
NODE_25192_length_599_cov_22.640000	282	362	4	15	80	0.1875000
NODE_25192_length_599_cov_22.640000	282	353	0	55	71	0.7746479
NODE_25192_length_599_cov_22.640000	282	353	2	1	71	0.0140845
NODE_25192_length_599_cov_22.640000	282	353	4	15	71	0.2112676
NODE_25192_length_599_cov_22.640000	285	355	0	57	70	0.8142857
NODE_25192_length_599_cov_22.640000	285	355	2	1	70	0.0142857
NODE_25192_length_599_cov_22.640000	285	355	4	12	70	0.1714286
NODE_25192_length_599_cov_22.640000	287	362	0	64	75	0.8533334
NODE_25192_length_599_cov_22.640000	287	362	2	1	75	0.0133333
NODE_25192_length_599_cov_22.640000	287	362	4	10	75	0.1333333
NODE_25193_length_599_cov_14.618000	279	359	0	36	80	0.4500000
NODE_25193_length_599_cov_14.618000	279	359	2	44	80	0.5500000
NODE_25193_length_599_cov_14.618000	332	412	0	80	80	1.0000000
NODE_25195_length_599_cov_10.308000	245	325	0	80	80	1.0000000
NODE_25195_length_599_cov_10.308000	298	378	0	80	80	1.0000000
NODE_25196_length_599_cov_9.224000	160	240	2	58	80	0.7250000
NODE_25196_length_599_cov_9.224000	160	240	4	22	80	0.2750000
NODE_25196_length_599_cov_9.224000	213	297	0	27	84	0.3214286
NODE_25196_length_599_cov_9.224000	213	297	2	57	84	0.6785714
NODE_25201_length_599_cov_5.536000	58	112	0	54	54	1.0000000
NODE_25208_length_599_cov_3.810000	271	334	0	38	63	0.6031746
NODE_25208_length_599_cov_3.810000	271	334	2	25	63	0.3968254
NODE_25208_length_599_cov_3.810000	324	390	0	66	66	1.0000000
NODE_25211_length_599_cov_3.598000	238	318	0	30	80	0.3750000
NODE_25211_length_599_cov_3.598000	238	318	2	50	80	0.6250000
NODE_25211_length_599_cov_3.598000	291	371	0	5	80	0.0625000
NODE_25211_length_599_cov_3.598000	291	371	2	75	80	0.9375000
NODE_25308_length_598_cov_54.450902	264	344	0	80	80	1.0000000
NODE_25308_length_598_cov_54.450902	317	397	0	80	80	1.0000000
NODE_25309_length_598_cov_8.326653	204	284	0	80	80	1.0000000
NODE_25309_length_598_cov_8.326653	257	337	0	80	80	1.0000000
NODE_25316_length_598_cov_5.623246	169	240	2	12	71	0.1690141
NODE_25316_length_598_cov_5.623246	169	240	4	12	71	0.1690141
NODE_25316_length_598_cov_5.623246	169	240	8	7	71	0.0985916
NODE_25316_length_598_cov_5.623246	169	240	12	3	71	0.0422535
NODE_25316_length_598_cov_5.623246	169	240	14	8	71	0.1126761
NODE_25316_length_598_cov_5.623246	169	240	16	29	71	0.4084507
NODE_25320_length_598_cov_4.929860	73	153	0	80	80	1.0000000
NODE_25320_length_598_cov_4.929860	126	206	0	80	80	1.0000000
NODE_25421_length_597_cov_15.142570	197	277	2	4	80	0.0500000
NODE_25421_length_597_cov_15.142570	197	277	4	4	80	0.0500000
NODE_25421_length_597_cov_15.142570	197	277	6	1	80	0.0125000
NODE_25421_length_597_cov_15.142570	197	277	7	16	80	0.2000000
NODE_25421_length_597_cov_15.142570	197	277	8	9	80	0.1125000
NODE_25421_length_597_cov_15.142570	197	277	9	25	80	0.3125000
NODE_25421_length_597_cov_15.142570	197	277	10	21	80	0.2625000
NODE_25421_length_597_cov_15.142570	250	330	2	12	80	0.1500000
NODE_25421_length_597_cov_15.142570	250	330	4	11	80	0.1375000
NODE_25421_length_597_cov_15.142570	250	330	6	35	80	0.4375000
NODE_25421_length_597_cov_15.142570	250	330	7	16	80	0.2000000
NODE_25421_length_597_cov_15.142570	250	330	9	4	80	0.0500000
NODE_25421_length_597_cov_15.142570	250	330	10	2	80	0.0250000
NODE_25422_length_597_cov_12.387550	118	198	0	54	80	0.6750000
NODE_25422_length_597_cov_12.387550	118	198	2	26	80	0.3250000
NODE_25422_length_597_cov_12.387550	171	251	0	80	80	1.0000000
NODE_25423_length_597_cov_7.016064	213	293	0	80	80	1.0000000
NODE_25423_length_597_cov_7.016064	266	346	0	80	80	1.0000000
NODE_25426_length_597_cov_6.212851	374	449	0	1	75	0.0133333
NODE_25426_length_597_cov_6.212851	374	449	2	74	75	0.9866667
NODE_25434_length_597_cov_4.273092	368	448	0	80	80	1.0000000
NODE_25434_length_597_cov_4.273092	421	507	0	86	86	1.0000000
NODE_25464_length_597_cov_2.162651	92	172	0	80	80	1.0000000
NODE_25464_length_597_cov_2.162651	145	225	0	80	80	1.0000000
NODE_25467_length_597_cov_2.096386	440	509	0	15	69	0.2173913
NODE_25467_length_597_cov_2.096386	440	509	2	54	69	0.7826087
NODE_25469_length_597_cov_1.977912	392	472	4	10	80	0.1250000
NODE_25469_length_597_cov_1.977912	392	472	6	4	80	0.0500000
NODE_25469_length_597_cov_1.977912	392	472	8	23	80	0.2875000
NODE_25469_length_597_cov_1.977912	392	472	10	22	80	0.2750000
NODE_25469_length_597_cov_1.977912	392	472	12	21	80	0.2625000
NODE_25469_length_597_cov_1.977912	437	494	6	17	57	0.2982456
NODE_25469_length_597_cov_1.977912	437	494	10	27	57	0.4736842
NODE_25469_length_597_cov_1.977912	437	494	12	13	57	0.2280702
NODE_25469_length_597_cov_1.977912	445	525	0	15	80	0.1875000
NODE_25469_length_597_cov_1.977912	445	525	4	12	80	0.1500000
NODE_25469_length_597_cov_1.977912	445	525	6	21	80	0.2625000
NODE_25469_length_597_cov_1.977912	445	525	10	27	80	0.3375000
NODE_25469_length_597_cov_1.977912	445	525	12	5	80	0.0625000
NODE_25552_length_596_cov_32.293763	221	301	0	80	80	1.0000000
NODE_25552_length_596_cov_32.293763	274	354	0	80	80	1.0000000
NODE_25552_length_596_cov_32.293763	351	406	0	55	55	1.0000000
NODE_25552_length_596_cov_32.293763	381	459	0	78	78	1.0000000
NODE_25553_length_596_cov_26.891348	199	279	0	52	80	0.6500000
NODE_25553_length_596_cov_26.891348	199	279	2	28	80	0.3500000
NODE_25553_length_596_cov_26.891348	252	332	0	80	80	1.0000000
NODE_25554_length_596_cov_17.082495	179	259	6	19	80	0.2375000
NODE_25554_length_596_cov_17.082495	179	259	8	61	80	0.7625000
NODE_25554_length_596_cov_17.082495	232	312	0	5	80	0.0625000
NODE_25554_length_596_cov_17.082495	232	312	2	23	80	0.2875000
NODE_25554_length_596_cov_17.082495	232	312	4	8	80	0.1000000
NODE_25554_length_596_cov_17.082495	232	312	8	44	80	0.5500000
NODE_25555_length_596_cov_10.372233	354	434	0	67	80	0.8375000
NODE_25555_length_596_cov_10.372233	354	434	2	13	80	0.1625000
NODE_25555_length_596_cov_10.372233	407	487	0	14	80	0.1750000
NODE_25555_length_596_cov_10.372233	407	487	2	66	80	0.8250000
NODE_25557_length_596_cov_6.955734	142	222	2	80	80	1.0000000
NODE_25558_length_596_cov_6.225352	242	322	0	80	80	1.0000000
NODE_25558_length_596_cov_6.225352	308	375	0	67	67	1.0000000
NODE_25567_length_596_cov_4.197183	369	444	0	22	75	0.2933333
NODE_25567_length_596_cov_4.197183	369	444	1	15	75	0.2000000
NODE_25567_length_596_cov_4.197183	369	444	3	20	75	0.2666667
NODE_25567_length_596_cov_4.197183	369	444	4	5	75	0.0666667
NODE_25567_length_596_cov_4.197183	369	444	6	3	75	0.0400000
NODE_25567_length_596_cov_4.197183	369	444	8	3	75	0.0400000
NODE_25567_length_596_cov_4.197183	369	444	10	7	75	0.0933333
NODE_25593_length_596_cov_2.066398	534	583	0	49	49	1.0000000
NODE_25666_length_595_cov_52.532258	248	328	0	7	80	0.0875000
NODE_25666_length_595_cov_52.532258	248	328	2	53	80	0.6625000
NODE_25666_length_595_cov_52.532258	248	328	3	20	80	0.2500000
NODE_25666_length_595_cov_52.532258	301	381	2	7	80	0.0875000
NODE_25666_length_595_cov_52.532258	301	381	3	20	80	0.2500000
NODE_25666_length_595_cov_52.532258	301	381	4	22	80	0.2750000
NODE_25666_length_595_cov_52.532258	301	381	6	19	80	0.2375000
NODE_25666_length_595_cov_52.532258	301	381	8	12	80	0.1500000
NODE_25667_length_595_cov_38.584677	122	202	0	58	80	0.7250000
NODE_25667_length_595_cov_38.584677	122	202	2	22	80	0.2750000
NODE_25667_length_595_cov_38.584677	175	255	0	10	80	0.1250000
NODE_25667_length_595_cov_38.584677	175	255	2	70	80	0.8750000
NODE_25669_length_595_cov_10.576613	323	403	0	25	80	0.3125000
NODE_25669_length_595_cov_10.576613	323	403	2	55	80	0.6875000
NODE_25669_length_595_cov_10.576613	376	456	2	60	80	0.7500000
NODE_25669_length_595_cov_10.576613	376	456	3	16	80	0.2000000
NODE_25669_length_595_cov_10.576613	376	456	4	4	80	0.0500000
NODE_25672_length_595_cov_7.917339	342	415	2	24	73	0.3287671
NODE_25672_length_595_cov_7.917339	342	415	4	4	73	0.0547945
NODE_25672_length_595_cov_7.917339	342	415	6	12	73	0.1643836
NODE_25672_length_595_cov_7.917339	342	415	8	9	73	0.1232877
NODE_25672_length_595_cov_7.917339	342	415	10	4	73	0.0547945
NODE_25672_length_595_cov_7.917339	342	415	14	14	73	0.1917808
NODE_25672_length_595_cov_7.917339	342	415	18	6	73	0.0821918
NODE_25672_length_595_cov_7.917339	388	438	8	3	50	0.0600000
NODE_25672_length_595_cov_7.917339	388	438	10	4	50	0.0800000
NODE_25672_length_595_cov_7.917339	388	438	12	2	50	0.0400000
NODE_25672_length_595_cov_7.917339	388	438	14	17	50	0.3400000
NODE_25672_length_595_cov_7.917339	388	438	16	8	50	0.1600000
NODE_25672_length_595_cov_7.917339	388	438	18	16	50	0.3200000
NODE_25702_length_595_cov_2.792339	178	258	2	39	80	0.4875000
NODE_25702_length_595_cov_2.792339	178	258	4	41	80	0.5125000
NODE_25702_length_595_cov_2.792339	231	311	0	21	80	0.2625000
NODE_25702_length_595_cov_2.792339	231	311	2	59	80	0.7375000
NODE_25807_length_594_cov_34.157576	283	363	2	8	80	0.1000000
NODE_25807_length_594_cov_34.157576	283	363	6	8	80	0.1000000
NODE_25807_length_594_cov_34.157576	283	363	8	10	80	0.1250000
NODE_25807_length_594_cov_34.157576	283	363	10	54	80	0.6750000
NODE_25807_length_594_cov_34.157576	336	416	2	14	80	0.1750000
NODE_25807_length_594_cov_34.157576	336	416	6	8	80	0.1000000
NODE_25807_length_594_cov_34.157576	336	416	8	2	80	0.0250000
NODE_25807_length_594_cov_34.157576	336	416	10	56	80	0.7000000
NODE_25811_length_594_cov_8.933333	258	338	0	80	80	1.0000000
NODE_25811_length_594_cov_8.933333	311	389	0	78	78	1.0000000
NODE_25815_length_594_cov_5.759596	82	118	2	36	36	1.0000000
NODE_25815_length_594_cov_5.759596	114	194	0	31	80	0.3875000
NODE_25815_length_594_cov_5.759596	114	194	2	49	80	0.6125000
NODE_25815_length_594_cov_5.759596	167	242	0	75	75	1.0000000
NODE_25825_length_594_cov_3.913131	275	355	2	8	80	0.1000000
NODE_25825_length_594_cov_3.913131	275	355	4	5	80	0.0625000
NODE_25825_length_594_cov_3.913131	275	355	6	14	80	0.1750000
NODE_25825_length_594_cov_3.913131	275	355	8	53	80	0.6625000
NODE_25844_length_594_cov_2.470707	209	247	0	13	38	0.3421053
NODE_25844_length_594_cov_2.470707	209	247	2	25	38	0.6578947
NODE_25919_length_594_cov_0.698990	33	73	2	40	40	1.0000000
NODE_25928_length_593_cov_124.985830	247	285	29	5	38	0.1315790
NODE_25928_length_593_cov_124.985830	247	285	30	3	38	0.0789474
NODE_25928_length_593_cov_124.985830	247	285	35	2	38	0.0526316
NODE_25928_length_593_cov_124.985830	247	285	41	1	38	0.0263158
NODE_25928_length_593_cov_124.985830	247	285	43	11	38	0.2894737
NODE_25928_length_593_cov_124.985830	247	285	44	1	38	0.0263158
NODE_25928_length_593_cov_124.985830	247	285	48	1	38	0.0263158
NODE_25928_length_593_cov_124.985830	247	285	50	1	38	0.0263158
NODE_25928_length_593_cov_124.985830	247	285	54	4	38	0.1052632
NODE_25928_length_593_cov_124.985830	247	285	64	2	38	0.0526316
NODE_25928_length_593_cov_124.985830	247	285	72	1	38	0.0263158
NODE_25928_length_593_cov_124.985830	247	285	74	4	38	0.1052632
NODE_25928_length_593_cov_124.985830	247	285	82	2	38	0.0526316
NODE_25929_length_593_cov_36.161943	150	230	4	24	80	0.3000000
NODE_25929_length_593_cov_36.161943	150	230	6	56	80	0.7000000
NODE_25929_length_593_cov_36.161943	203	283	0	12	80	0.1500000
NODE_25929_length_593_cov_36.161943	203	283	1	16	80	0.2000000
NODE_25929_length_593_cov_36.161943	203	283	2	4	80	0.0500000
NODE_25929_length_593_cov_36.161943	203	283	4	45	80	0.5625000
NODE_25929_length_593_cov_36.161943	203	283	6	3	80	0.0375000
NODE_25930_length_593_cov_14.979757	219	299	0	80	80	1.0000000
NODE_25930_length_593_cov_14.979757	272	352	0	80	80	1.0000000
NODE_25931_length_593_cov_11.018219	324	404	0	80	80	1.0000000
NODE_25931_length_593_cov_11.018219	377	457	0	80	80	1.0000000
NODE_25946_length_593_cov_3.232794	210	273	4	17	63	0.2698413
NODE_25946_length_593_cov_3.232794	210	273	5	13	63	0.2063492
NODE_25946_length_593_cov_3.232794	210	273	6	33	63	0.5238096
NODE_25946_length_593_cov_3.232794	263	326	4	24	63	0.3809524
NODE_25946_length_593_cov_3.232794	263	326	6	39	63	0.6190476
NODE_25996_length_593_cov_1.261134	227	249	0	22	22	1.0000000
NODE_26033_length_592_cov_18.908722	163	243	1	39	80	0.4875000
NODE_26033_length_592_cov_18.908722	163	243	7	41	80	0.5125000
NODE_26033_length_592_cov_18.908722	230	296	6	38	66	0.5757576
NODE_26033_length_592_cov_18.908722	230	296	7	28	66	0.4242424
NODE_26034_length_592_cov_7.531440	232	312	0	80	80	1.0000000
NODE_26034_length_592_cov_7.531440	285	361	0	76	76	1.0000000
NODE_26035_length_592_cov_7.000000	77	157	0	39	80	0.4875000
NODE_26035_length_592_cov_7.000000	77	157	2	41	80	0.5125000
NODE_26035_length_592_cov_7.000000	130	210	0	25	80	0.3125000
NODE_26035_length_592_cov_7.000000	130	210	2	55	80	0.6875000
NODE_26040_length_592_cov_5.036511	270	349	10	2	79	0.0253165
NODE_26040_length_592_cov_5.036511	270	349	12	3	79	0.0379747
NODE_26040_length_592_cov_5.036511	270	349	16	6	79	0.0759494
NODE_26040_length_592_cov_5.036511	270	349	18	36	79	0.4556962
NODE_26040_length_592_cov_5.036511	270	349	20	32	79	0.4050633
NODE_26041_length_592_cov_5.024341	205	285	0	80	80	1.0000000
NODE_26041_length_592_cov_5.024341	258	309	0	51	51	1.0000000
NODE_26062_length_592_cov_2.866126	61	127	0	40	66	0.6060606
NODE_26062_length_592_cov_2.866126	61	127	1	26	66	0.3939394
NODE_26069_length_592_cov_2.361055	476	526	6	3	50	0.0600000
NODE_26069_length_592_cov_2.361055	476	526	8	15	50	0.3000000
NODE_26069_length_592_cov_2.361055	476	526	12	32	50	0.6400000
NODE_26142_length_591_cov_11.286585	245	325	0	80	80	1.0000000
NODE_26142_length_591_cov_11.286585	298	378	0	80	80	1.0000000
NODE_26143_length_591_cov_9.432927	241	321	2	80	80	1.0000000
NODE_26143_length_591_cov_9.432927	294	374	0	35	80	0.4375000
NODE_26143_length_591_cov_9.432927	294	374	2	45	80	0.5625000
NODE_26184_length_591_cov_2.365854	396	476	0	80	80	1.0000000
NODE_26184_length_591_cov_2.365854	449	529	0	80	80	1.0000000
NODE_26272_length_590_cov_29.661914	26	106	0	80	80	1.0000000
NODE_26272_length_590_cov_29.661914	79	159	0	80	80	1.0000000
NODE_26272_length_590_cov_29.661914	155	235	0	80	80	1.0000000
NODE_26272_length_590_cov_29.661914	208	288	0	80	80	1.0000000
NODE_26273_length_590_cov_21.360489	178	258	4	21	80	0.2625000
NODE_26273_length_590_cov_21.360489	178	258	6	4	80	0.0500000
NODE_26273_length_590_cov_21.360489	178	258	8	55	80	0.6875000
NODE_26273_length_590_cov_21.360489	231	311	0	19	80	0.2375000
NODE_26273_length_590_cov_21.360489	231	311	2	27	80	0.3375000
NODE_26273_length_590_cov_21.360489	231	311	4	22	80	0.2750000
NODE_26273_length_590_cov_21.360489	231	311	8	12	80	0.1500000
NODE_26274_length_590_cov_18.395112	161	241	0	80	80	1.0000000
NODE_26274_length_590_cov_18.395112	214	294	0	80	80	1.0000000
NODE_26275_length_590_cov_17.376782	238	318	0	9	80	0.1125000
NODE_26275_length_590_cov_17.376782	238	318	2	71	80	0.8875000
NODE_26275_length_590_cov_17.376782	291	371	0	32	80	0.4000000
NODE_26275_length_590_cov_17.376782	291	371	2	48	80	0.6000000
NODE_26279_length_590_cov_6.205703	262	333	0	41	71	0.5774648
NODE_26279_length_590_cov_6.205703	262	333	2	30	71	0.4225352
NODE_26283_length_590_cov_5.319756	224	304	0	5	80	0.0625000
NODE_26283_length_590_cov_5.319756	224	304	4	5	80	0.0625000
NODE_26283_length_590_cov_5.319756	224	304	8	70	80	0.8750000
NODE_26283_length_590_cov_5.319756	277	357	0	13	80	0.1625000
NODE_26283_length_590_cov_5.319756	277	357	4	4	80	0.0500000
NODE_26283_length_590_cov_5.319756	277	357	8	63	80	0.7875000
NODE_26366_length_590_cov_0.971487	0	32	0	29	32	0.9062500
NODE_26366_length_590_cov_0.971487	0	32	2	3	32	0.0937500
NODE_26390_length_589_cov_15.810204	384	464	0	80	80	1.0000000
NODE_26390_length_589_cov_15.810204	437	517	0	80	80	1.0000000
NODE_26391_length_589_cov_13.855102	320	400	0	80	80	1.0000000
NODE_26391_length_589_cov_13.855102	373	453	0	80	80	1.0000000
NODE_26395_length_589_cov_6.297959	186	266	0	80	80	1.0000000
NODE_26395_length_589_cov_6.297959	239	319	0	80	80	1.0000000
NODE_26430_length_589_cov_2.320408	431	511	2	79	80	0.9875000
NODE_26430_length_589_cov_2.320408	431	511	4	1	80	0.0125000
NODE_26515_length_588_cov_49.936605	264	341	0	77	77	1.0000000
NODE_26515_length_588_cov_49.936605	314	394	0	80	80	1.0000000
NODE_26516_length_588_cov_33.691207	273	353	0	80	80	1.0000000
NODE_26516_length_588_cov_33.691207	326	406	0	80	80	1.0000000
NODE_26517_length_588_cov_16.564417	245	325	0	28	80	0.3500000
NODE_26517_length_588_cov_16.564417	245	325	2	52	80	0.6500000
NODE_26517_length_588_cov_16.564417	298	378	0	17	80	0.2125000
NODE_26517_length_588_cov_16.564417	298	378	2	63	80	0.7875000
NODE_26518_length_588_cov_14.595092	266	346	0	24	80	0.3000000
NODE_26518_length_588_cov_14.595092	266	346	2	56	80	0.7000000
NODE_26518_length_588_cov_14.595092	319	399	0	2	80	0.0250000
NODE_26518_length_588_cov_14.595092	319	399	2	78	80	0.9750000
NODE_26522_length_588_cov_7.439673	155	235	0	50	80	0.6250000
NODE_26522_length_588_cov_7.439673	155	235	2	30	80	0.3750000
NODE_26522_length_588_cov_7.439673	208	288	2	80	80	1.0000000
NODE_26523_length_588_cov_7.094070	191	263	2	5	72	0.0694444
NODE_26523_length_588_cov_7.094070	191	263	4	12	72	0.1666667
NODE_26523_length_588_cov_7.094070	191	263	6	14	72	0.1944444
NODE_26523_length_588_cov_7.094070	191	263	8	41	72	0.5694444
NODE_26523_length_588_cov_7.094070	244	310	0	46	66	0.6969697
NODE_26523_length_588_cov_7.094070	244	310	2	4	66	0.0606061
NODE_26523_length_588_cov_7.094070	244	310	4	3	66	0.0454545
NODE_26523_length_588_cov_7.094070	244	310	6	12	66	0.1818182
NODE_26523_length_588_cov_7.094070	244	310	8	1	66	0.0151515
NODE_26523_length_588_cov_7.094070	439	519	0	80	80	1.0000000
NODE_26523_length_588_cov_7.094070	492	572	0	80	80	1.0000000
NODE_26534_length_588_cov_4.167689	65	122	2	52	57	0.9122807
NODE_26534_length_588_cov_4.167689	65	122	4	5	57	0.0877193
NODE_26634_length_587_cov_39.782787	123	203	1	9	80	0.1125000
NODE_26634_length_587_cov_39.782787	123	203	3	13	80	0.1625000
NODE_26634_length_587_cov_39.782787	123	203	4	43	80	0.5375000
NODE_26634_length_587_cov_39.782787	123	203	5	15	80	0.1875000
NODE_26634_length_587_cov_39.782787	176	256	1	29	80	0.3625000
NODE_26634_length_587_cov_39.782787	176	256	2	33	80	0.4125000
NODE_26634_length_587_cov_39.782787	176	256	3	13	80	0.1625000
NODE_26634_length_587_cov_39.782787	176	256	5	5	80	0.0625000
NODE_26634_length_587_cov_39.782787	252	332	2	37	80	0.4625000
NODE_26634_length_587_cov_39.782787	252	332	4	8	80	0.1000000
NODE_26634_length_587_cov_39.782787	252	332	6	13	80	0.1625000
NODE_26634_length_587_cov_39.782787	252	332	7	11	80	0.1375000
NODE_26634_length_587_cov_39.782787	252	332	8	3	80	0.0375000
NODE_26634_length_587_cov_39.782787	252	332	9	8	80	0.1000000
NODE_26634_length_587_cov_39.782787	305	385	6	7	80	0.0875000
NODE_26634_length_587_cov_39.782787	305	385	7	11	80	0.1375000
NODE_26634_length_587_cov_39.782787	305	385	8	13	80	0.1625000
NODE_26634_length_587_cov_39.782787	305	385	9	49	80	0.6125000
NODE_26635_length_587_cov_31.807377	141	221	0	80	80	1.0000000
NODE_26635_length_587_cov_31.807377	194	274	0	80	80	1.0000000
NODE_26636_length_587_cov_12.629098	219	299	2	14	80	0.1750000
NODE_26636_length_587_cov_12.629098	219	299	3	1	80	0.0125000
NODE_26636_length_587_cov_12.629098	219	299	4	11	80	0.1375000
NODE_26636_length_587_cov_12.629098	219	299	6	12	80	0.1500000
NODE_26636_length_587_cov_12.629098	219	299	8	25	80	0.3125000
NODE_26636_length_587_cov_12.629098	219	299	10	17	80	0.2125000
NODE_26636_length_587_cov_12.629098	272	352	2	14	80	0.1750000
NODE_26636_length_587_cov_12.629098	272	352	3	1	80	0.0125000
NODE_26636_length_587_cov_12.629098	272	352	4	55	80	0.6875000
NODE_26636_length_587_cov_12.629098	272	352	6	10	80	0.1250000
NODE_26639_length_587_cov_9.067623	203	283	0	6	80	0.0750000
NODE_26639_length_587_cov_9.067623	203	283	1	3	80	0.0375000
NODE_26639_length_587_cov_9.067623	203	283	2	47	80	0.5875000
NODE_26639_length_587_cov_9.067623	203	283	4	24	80	0.3000000
NODE_26639_length_587_cov_9.067623	256	336	2	3	80	0.0375000
NODE_26639_length_587_cov_9.067623	256	336	4	77	80	0.9625000
NODE_26640_length_587_cov_8.411885	253	311	0	58	58	1.0000000
NODE_26656_length_587_cov_3.231557	201	256	18	31	55	0.5636364
NODE_26656_length_587_cov_3.231557	201	256	20	24	55	0.4363636
NODE_26665_length_587_cov_2.850410	255	288	2	26	33	0.7878788
NODE_26665_length_587_cov_2.850410	255	288	4	7	33	0.2121212
NODE_26749_length_586_cov_37.843943	268	348	0	6	80	0.0750000
NODE_26749_length_586_cov_37.843943	268	348	2	5	80	0.0625000
NODE_26749_length_586_cov_37.843943	268	348	4	69	80	0.8625000
NODE_26749_length_586_cov_37.843943	321	401	2	33	80	0.4125000
NODE_26749_length_586_cov_37.843943	321	401	4	47	80	0.5875000
NODE_26749_length_586_cov_37.843943	397	477	2	80	80	1.0000000
NODE_26749_length_586_cov_37.843943	450	531	0	41	81	0.5061728
NODE_26749_length_586_cov_37.843943	450	531	2	40	81	0.4938272
NODE_26750_length_586_cov_12.831622	186	266	0	32	80	0.4000000
NODE_26750_length_586_cov_12.831622	186	266	2	48	80	0.6000000
NODE_26750_length_586_cov_12.831622	239	319	0	80	80	1.0000000
NODE_26752_length_586_cov_11.264887	108	188	0	23	80	0.2875000
NODE_26752_length_586_cov_11.264887	108	188	2	57	80	0.7125000
NODE_26752_length_586_cov_11.264887	161	241	0	38	80	0.4750000
NODE_26752_length_586_cov_11.264887	161	241	2	42	80	0.5250000
NODE_26754_length_586_cov_9.624230	299	360	2	27	61	0.4426230
NODE_26754_length_586_cov_9.624230	299	360	4	34	61	0.5573770
NODE_26754_length_586_cov_9.624230	299	360	2	27	61	0.4426230
NODE_26754_length_586_cov_9.624230	299	360	4	34	61	0.5573770
NODE_26754_length_586_cov_9.624230	299	360	2	27	61	0.4426230
NODE_26754_length_586_cov_9.624230	299	360	4	34	61	0.5573770
NODE_26754_length_586_cov_9.624230	301	360	2	25	59	0.4237288
NODE_26754_length_586_cov_9.624230	301	360	4	34	59	0.5762712
NODE_26756_length_586_cov_8.591376	273	353	0	80	80	1.0000000
NODE_26756_length_586_cov_8.591376	326	406	0	80	80	1.0000000
NODE_26758_length_586_cov_6.135524	334	375	0	41	41	1.0000000
NODE_26758_length_586_cov_6.135524	334	375	0	41	41	1.0000000
NODE_26760_length_586_cov_5.634497	150	230	0	80	80	1.0000000
NODE_26760_length_586_cov_5.634497	203	283	0	80	80	1.0000000
NODE_26765_length_586_cov_4.626283	296	362	0	66	66	1.0000000
NODE_26765_length_586_cov_4.626283	453	533	2	21	80	0.2625000
NODE_26765_length_586_cov_4.626283	453	533	3	2	80	0.0250000
NODE_26765_length_586_cov_4.626283	453	533	4	57	80	0.7125000
NODE_26885_length_585_cov_112.094650	456	536	59	2	80	0.0250000
NODE_26885_length_585_cov_112.094650	456	536	60	1	80	0.0125000
NODE_26885_length_585_cov_112.094650	456	536	61	2	80	0.0250000
NODE_26885_length_585_cov_112.094650	456	536	63	2	80	0.0250000
NODE_26885_length_585_cov_112.094650	456	536	65	3	80	0.0375000
NODE_26885_length_585_cov_112.094650	456	536	67	3	80	0.0375000
NODE_26885_length_585_cov_112.094650	456	536	69	1	80	0.0125000
NODE_26885_length_585_cov_112.094650	456	536	71	2	80	0.0250000
NODE_26885_length_585_cov_112.094650	456	536	73	2	80	0.0250000
NODE_26885_length_585_cov_112.094650	456	536	75	3	80	0.0375000
NODE_26885_length_585_cov_112.094650	456	536	77	1	80	0.0125000
NODE_26885_length_585_cov_112.094650	456	536	78	1	80	0.0125000
NODE_26885_length_585_cov_112.094650	456	536	79	1	80	0.0125000
NODE_26885_length_585_cov_112.094650	456	536	80	2	80	0.0250000
NODE_26885_length_585_cov_112.094650	456	536	82	2	80	0.0250000
NODE_26885_length_585_cov_112.094650	456	536	84	4	80	0.0500000
NODE_26885_length_585_cov_112.094650	456	536	85	17	80	0.2125000
NODE_26885_length_585_cov_112.094650	456	536	87	1	80	0.0125000
NODE_26885_length_585_cov_112.094650	456	536	88	9	80	0.1125000
NODE_26885_length_585_cov_112.094650	456	536	89	5	80	0.0625000
NODE_26885_length_585_cov_112.094650	456	536	90	1	80	0.0125000
NODE_26885_length_585_cov_112.094650	456	536	92	12	80	0.1500000
NODE_26885_length_585_cov_112.094650	456	536	93	1	80	0.0125000
NODE_26885_length_585_cov_112.094650	456	536	94	2	80	0.0250000
NODE_26885_length_585_cov_112.094650	509	585	6	1	76	0.0131579
NODE_26885_length_585_cov_112.094650	509	585	8	2	76	0.0263158
NODE_26885_length_585_cov_112.094650	509	585	10	10	76	0.1315790
NODE_26885_length_585_cov_112.094650	509	585	12	1	76	0.0131579
NODE_26885_length_585_cov_112.094650	509	585	13	3	76	0.0394737
NODE_26885_length_585_cov_112.094650	509	585	15	4	76	0.0526316
NODE_26885_length_585_cov_112.094650	509	585	17	3	76	0.0394737
NODE_26885_length_585_cov_112.094650	509	585	19	1	76	0.0131579
NODE_26885_length_585_cov_112.094650	509	585	25	2	76	0.0263158
NODE_26885_length_585_cov_112.094650	509	585	27	3	76	0.0394737
NODE_26885_length_585_cov_112.094650	509	585	29	1	76	0.0131579
NODE_26885_length_585_cov_112.094650	509	585	35	1	76	0.0131579
NODE_26885_length_585_cov_112.094650	509	585	37	1	76	0.0131579
NODE_26885_length_585_cov_112.094650	509	585	39	3	76	0.0394737
NODE_26885_length_585_cov_112.094650	509	585	41	3	76	0.0394737
NODE_26885_length_585_cov_112.094650	509	585	43	1	76	0.0131579
NODE_26885_length_585_cov_112.094650	509	585	47	3	76	0.0394737
NODE_26885_length_585_cov_112.094650	509	585	49	2	76	0.0263158
NODE_26885_length_585_cov_112.094650	509	585	59	4	76	0.0526316
NODE_26885_length_585_cov_112.094650	509	585	73	2	76	0.0263158
NODE_26885_length_585_cov_112.094650	509	585	75	3	76	0.0394737
NODE_26885_length_585_cov_112.094650	509	585	77	1	76	0.0131579
NODE_26885_length_585_cov_112.094650	509	585	79	1	76	0.0131579
NODE_26885_length_585_cov_112.094650	509	585	85	17	76	0.2236842
NODE_26885_length_585_cov_112.094650	509	585	87	1	76	0.0131579
NODE_26885_length_585_cov_112.094650	509	585	89	2	76	0.0263158
NODE_26886_length_585_cov_23.872428	168	248	0	80	80	1.0000000
NODE_26886_length_585_cov_23.872428	222	301	0	79	79	1.0000000
NODE_26887_length_585_cov_18.981481	360	440	0	80	80	1.0000000
NODE_26887_length_585_cov_18.981481	413	493	0	80	80	1.0000000
NODE_26888_length_585_cov_13.967078	323	387	0	64	64	1.0000000
NODE_26889_length_585_cov_10.555556	229	309	2	29	80	0.3625000
NODE_26889_length_585_cov_10.555556	229	309	8	51	80	0.6375000
NODE_26889_length_585_cov_10.555556	282	362	0	13	80	0.1625000
NODE_26889_length_585_cov_10.555556	282	362	2	7	80	0.0875000
NODE_26889_length_585_cov_10.555556	282	362	8	60	80	0.7500000
NODE_26891_length_585_cov_9.216049	233	313	0	80	80	1.0000000
NODE_26891_length_585_cov_9.216049	286	366	0	80	80	1.0000000
NODE_26894_length_585_cov_8.090535	292	372	0	9	80	0.1125000
NODE_26894_length_585_cov_8.090535	292	372	2	71	80	0.8875000
NODE_26894_length_585_cov_8.090535	345	425	0	62	80	0.7750000
NODE_26894_length_585_cov_8.090535	345	425	2	18	80	0.2250000
NODE_26895_length_585_cov_8.018519	339	381	0	42	42	1.0000000
NODE_26895_length_585_cov_8.018519	354	419	0	65	65	1.0000000
NODE_26900_length_585_cov_4.954733	147	227	0	49	80	0.6125000
NODE_26900_length_585_cov_4.954733	147	227	2	31	80	0.3875000
NODE_26912_length_585_cov_3.751029	288	368	0	3	80	0.0375000
NODE_26912_length_585_cov_3.751029	288	368	2	1	80	0.0125000
NODE_26912_length_585_cov_3.751029	288	368	4	76	80	0.9500000
NODE_26912_length_585_cov_3.751029	341	421	4	80	80	1.0000000
NODE_27019_length_584_cov_21.657732	57	137	2	44	80	0.5500000
NODE_27019_length_584_cov_21.657732	57	137	4	36	80	0.4500000
NODE_27019_length_584_cov_21.657732	110	190	4	69	80	0.8625000
NODE_27019_length_584_cov_21.657732	110	190	6	11	80	0.1375000
NODE_27020_length_584_cov_11.915464	280	360	0	80	80	1.0000000
NODE_27020_length_584_cov_11.915464	333	413	0	80	80	1.0000000
NODE_27021_length_584_cov_11.197938	217	297	0	12	80	0.1500000
NODE_27021_length_584_cov_11.197938	217	297	2	68	80	0.8500000
NODE_27021_length_584_cov_11.197938	270	350	0	37	80	0.4625000
NODE_27021_length_584_cov_11.197938	270	350	2	43	80	0.5375000
NODE_27022_length_584_cov_9.824742	375	441	0	66	66	1.0000000
NODE_27022_length_584_cov_9.824742	375	441	0	66	66	1.0000000
NODE_27023_length_584_cov_9.160825	369	449	0	7	80	0.0875000
NODE_27023_length_584_cov_9.160825	369	449	2	73	80	0.9125000
NODE_27023_length_584_cov_9.160825	422	502	0	32	80	0.4000000
NODE_27023_length_584_cov_9.160825	422	502	2	48	80	0.6000000
NODE_27023_length_584_cov_9.160825	422	502	0	32	80	0.4000000
NODE_27023_length_584_cov_9.160825	422	502	2	48	80	0.6000000
NODE_27026_length_584_cov_7.736082	51	131	0	80	80	1.0000000
NODE_27026_length_584_cov_7.736082	104	184	0	80	80	1.0000000
NODE_27031_length_584_cov_7.113402	213	293	0	16	80	0.2000000
NODE_27031_length_584_cov_7.113402	213	293	2	43	80	0.5375000
NODE_27031_length_584_cov_7.113402	213	293	4	21	80	0.2625000
NODE_27031_length_584_cov_7.113402	266	346	2	20	80	0.2500000
NODE_27031_length_584_cov_7.113402	266	346	4	45	80	0.5625000
NODE_27031_length_584_cov_7.113402	266	346	6	15	80	0.1875000
NODE_27035_length_584_cov_5.843299	281	341	0	2	60	0.0333333
NODE_27035_length_584_cov_5.843299	281	341	2	2	60	0.0333333
NODE_27035_length_584_cov_5.843299	281	341	4	56	60	0.9333333
NODE_27039_length_584_cov_5.032990	240	320	0	14	80	0.1750000
NODE_27039_length_584_cov_5.032990	240	320	2	23	80	0.2875000
NODE_27039_length_584_cov_5.032990	240	320	4	43	80	0.5375000
NODE_27039_length_584_cov_5.032990	293	373	0	12	80	0.1500000
NODE_27039_length_584_cov_5.032990	293	373	2	2	80	0.0250000
NODE_27039_length_584_cov_5.032990	293	373	4	66	80	0.8250000
NODE_27061_length_584_cov_2.707216	186	257	0	58	71	0.8169014
NODE_27061_length_584_cov_2.707216	186	257	2	13	71	0.1830986
NODE_27147_length_583_cov_7.973140	232	312	0	80	80	1.0000000
NODE_27147_length_583_cov_7.973140	285	365	0	32	80	0.4000000
NODE_27147_length_583_cov_7.973140	285	365	2	48	80	0.6000000
NODE_27148_length_583_cov_6.731405	328	408	0	23	80	0.2875000
NODE_27148_length_583_cov_6.731405	328	408	2	5	80	0.0625000
NODE_27148_length_583_cov_6.731405	328	408	4	52	80	0.6500000
NODE_27148_length_583_cov_6.731405	381	461	0	76	80	0.9500000
NODE_27148_length_583_cov_6.731405	381	461	2	4	80	0.0500000
NODE_27149_length_583_cov_6.363636	161	231	0	37	70	0.5285714
NODE_27149_length_583_cov_6.363636	161	231	2	33	70	0.4714286
NODE_27152_length_583_cov_5.766529	132	186	0	54	54	1.0000000
NODE_27263_length_583_cov_0.762397	9	50	0	41	41	1.0000000
NODE_27278_length_582_cov_74.269151	295	375	6	14	80	0.1750000
NODE_27278_length_582_cov_74.269151	295	375	7	4	80	0.0500000
NODE_27278_length_582_cov_74.269151	295	375	8	3	80	0.0375000
NODE_27278_length_582_cov_74.269151	295	375	9	4	80	0.0500000
NODE_27278_length_582_cov_74.269151	295	375	10	12	80	0.1500000
NODE_27278_length_582_cov_74.269151	295	375	12	14	80	0.1750000
NODE_27278_length_582_cov_74.269151	295	375	13	29	80	0.3625000
NODE_27278_length_582_cov_74.269151	348	428	6	39	80	0.4875000
NODE_27278_length_582_cov_74.269151	348	428	7	9	80	0.1125000
NODE_27278_length_582_cov_74.269151	348	428	9	9	80	0.1125000
NODE_27278_length_582_cov_74.269151	348	428	10	4	80	0.0500000
NODE_27278_length_582_cov_74.269151	348	428	13	19	80	0.2375000
NODE_27279_length_582_cov_53.093168	11	91	0	80	80	1.0000000
NODE_27279_length_582_cov_53.093168	64	144	0	80	80	1.0000000
NODE_27279_length_582_cov_53.093168	140	220	0	80	80	1.0000000
NODE_27279_length_582_cov_53.093168	193	273	0	80	80	1.0000000
NODE_27280_length_582_cov_47.393375	345	425	2	80	80	1.0000000
NODE_27280_length_582_cov_47.393375	398	478	0	42	80	0.5250000
NODE_27280_length_582_cov_47.393375	398	478	2	38	80	0.4750000
NODE_27281_length_582_cov_16.358178	297	377	0	80	80	1.0000000
NODE_27281_length_582_cov_16.358178	350	431	0	81	81	1.0000000
NODE_27282_length_582_cov_14.107660	128	208	0	80	80	1.0000000
NODE_27282_length_582_cov_14.107660	181	261	0	80	80	1.0000000
NODE_27283_length_582_cov_7.923395	208	287	0	79	79	1.0000000
NODE_27283_length_582_cov_7.923395	262	340	0	78	78	1.0000000
NODE_27284_length_582_cov_7.722567	216	296	0	80	80	1.0000000
NODE_27284_length_582_cov_7.722567	269	349	0	80	80	1.0000000
NODE_27289_length_582_cov_4.956522	294	325	0	31	31	1.0000000
NODE_27295_length_582_cov_4.308489	151	192	4	35	41	0.8536586
NODE_27295_length_582_cov_4.308489	151	192	6	6	41	0.1463415
NODE_27297_length_582_cov_3.838509	223	299	0	5	76	0.0657895
NODE_27297_length_582_cov_3.838509	223	299	2	71	76	0.9342105
NODE_27297_length_582_cov_3.838509	272	354	0	11	82	0.1341463
NODE_27297_length_582_cov_3.838509	272	354	2	71	82	0.8658537
NODE_27350_length_582_cov_1.650104	375	450	0	75	75	1.0000000
NODE_27405_length_581_cov_16.890041	244	316	0	72	72	1.0000000
NODE_27413_length_581_cov_6.340249	262	342	0	80	80	1.0000000
NODE_27413_length_581_cov_6.340249	315	395	0	80	80	1.0000000
NODE_27416_length_581_cov_5.827801	122	192	0	25	70	0.3571429
NODE_27416_length_581_cov_5.827801	122	192	2	21	70	0.3000000
NODE_27416_length_581_cov_5.827801	122	192	4	24	70	0.3428572
NODE_27420_length_581_cov_5.072614	392	466	0	74	74	1.0000000
NODE_27420_length_581_cov_5.072614	424	444	0	20	20	1.0000000
NODE_27464_length_581_cov_1.881743	474	538	0	64	64	1.0000000
NODE_27541_length_580_cov_39.353430	358	438	0	62	80	0.7750000
NODE_27541_length_580_cov_39.353430	358	438	2	18	80	0.2250000
NODE_27541_length_580_cov_39.353430	411	491	0	33	80	0.4125000
NODE_27541_length_580_cov_39.353430	411	491	4	8	80	0.1000000
NODE_27541_length_580_cov_39.353430	411	491	8	5	80	0.0625000
NODE_27541_length_580_cov_39.353430	411	491	10	2	80	0.0250000
NODE_27541_length_580_cov_39.353430	411	491	14	13	80	0.1625000
NODE_27541_length_580_cov_39.353430	411	491	15	1	80	0.0125000
NODE_27541_length_580_cov_39.353430	411	491	16	18	80	0.2250000
NODE_27541_length_580_cov_39.353430	487	567	10	5	80	0.0625000
NODE_27541_length_580_cov_39.353430	487	567	12	5	80	0.0625000
NODE_27541_length_580_cov_39.353430	487	567	16	70	80	0.8750000
NODE_27541_length_580_cov_39.353430	487	567	10	5	80	0.0625000
NODE_27541_length_580_cov_39.353430	487	567	12	5	80	0.0625000
NODE_27541_length_580_cov_39.353430	487	567	16	70	80	0.8750000
NODE_27541_length_580_cov_39.353430	487	567	10	5	80	0.0625000
NODE_27541_length_580_cov_39.353430	487	567	12	5	80	0.0625000
NODE_27541_length_580_cov_39.353430	487	567	16	70	80	0.8750000
NODE_27541_length_580_cov_39.353430	487	567	10	5	80	0.0625000
NODE_27541_length_580_cov_39.353430	487	567	12	5	80	0.0625000
NODE_27541_length_580_cov_39.353430	487	567	16	70	80	0.8750000
NODE_27541_length_580_cov_39.353430	487	567	10	5	80	0.0625000
NODE_27541_length_580_cov_39.353430	487	567	12	5	80	0.0625000
NODE_27541_length_580_cov_39.353430	487	567	16	70	80	0.8750000
NODE_27541_length_580_cov_39.353430	487	567	10	5	80	0.0625000
NODE_27541_length_580_cov_39.353430	487	567	12	5	80	0.0625000
NODE_27541_length_580_cov_39.353430	487	567	16	70	80	0.8750000
NODE_27544_length_580_cov_8.925156	198	238	0	40	40	1.0000000
NODE_27544_length_580_cov_8.925156	258	338	0	80	80	1.0000000
NODE_27545_length_580_cov_8.634096	197	277	4	15	80	0.1875000
NODE_27545_length_580_cov_8.634096	197	277	5	10	80	0.1250000
NODE_27545_length_580_cov_8.634096	197	277	6	15	80	0.1875000
NODE_27545_length_580_cov_8.634096	197	277	7	40	80	0.5000000
NODE_27545_length_580_cov_8.634096	250	330	3	39	80	0.4875000
NODE_27545_length_580_cov_8.634096	250	330	5	24	80	0.3000000
NODE_27545_length_580_cov_8.634096	250	330	7	17	80	0.2125000
NODE_27551_length_580_cov_6.291060	356	398	0	42	42	1.0000000
NODE_27554_length_580_cov_5.494802	110	190	0	80	80	1.0000000
NODE_27554_length_580_cov_5.494802	163	243	0	80	80	1.0000000
NODE_27559_length_580_cov_4.563410	231	292	0	11	61	0.1803279
NODE_27559_length_580_cov_4.563410	231	292	2	50	61	0.8196721
NODE_27559_length_580_cov_4.563410	322	357	0	26	35	0.7428572
NODE_27559_length_580_cov_4.563410	322	357	2	9	35	0.2571429
NODE_27590_length_580_cov_2.264033	215	277	0	62	62	1.0000000
NODE_27597_length_580_cov_2.116424	265	345	0	80	80	1.0000000
NODE_27659_length_579_cov_24.231250	159	239	2	80	80	1.0000000
NODE_27659_length_579_cov_24.231250	212	287	0	29	75	0.3866667
NODE_27659_length_579_cov_24.231250	212	287	2	46	75	0.6133333
NODE_27660_length_579_cov_12.602083	246	326	2	80	80	1.0000000
NODE_27660_length_579_cov_12.602083	299	377	0	38	78	0.4871795
NODE_27660_length_579_cov_12.602083	299	377	2	40	78	0.5128205
NODE_27663_length_579_cov_9.195833	254	334	2	4	80	0.0500000
NODE_27663_length_579_cov_9.195833	254	334	4	7	80	0.0875000
NODE_27663_length_579_cov_9.195833	254	334	6	21	80	0.2625000
NODE_27663_length_579_cov_9.195833	254	334	8	1	80	0.0125000
NODE_27663_length_579_cov_9.195833	254	334	10	2	80	0.0250000
NODE_27663_length_579_cov_9.195833	254	334	12	35	80	0.4375000
NODE_27663_length_579_cov_9.195833	254	334	14	10	80	0.1250000
NODE_27663_length_579_cov_9.195833	307	387	6	11	80	0.1375000
NODE_27663_length_579_cov_9.195833	307	387	8	4	80	0.0500000
NODE_27663_length_579_cov_9.195833	307	387	10	37	80	0.4625000
NODE_27663_length_579_cov_9.195833	307	387	12	18	80	0.2250000
NODE_27663_length_579_cov_9.195833	307	387	14	10	80	0.1250000
NODE_27663_length_579_cov_9.195833	383	463	0	28	80	0.3500000
NODE_27663_length_579_cov_9.195833	383	463	2	6	80	0.0750000
NODE_27663_length_579_cov_9.195833	383	463	4	9	80	0.1125000
NODE_27663_length_579_cov_9.195833	383	463	6	37	80	0.4625000
NODE_27664_length_579_cov_6.600000	169	249	0	80	80	1.0000000
NODE_27664_length_579_cov_6.600000	222	302	0	34	80	0.4250000
NODE_27664_length_579_cov_6.600000	222	302	2	46	80	0.5750000
NODE_27667_length_579_cov_5.956250	225	295	6	2	70	0.0285714
NODE_27667_length_579_cov_5.956250	225	295	8	2	70	0.0285714
NODE_27667_length_579_cov_5.956250	225	295	12	8	70	0.1142857
NODE_27667_length_579_cov_5.956250	225	295	16	58	70	0.8285714
NODE_27667_length_579_cov_5.956250	279	316	8	7	37	0.1891892
NODE_27667_length_579_cov_5.956250	279	316	12	2	37	0.0540541
NODE_27667_length_579_cov_5.956250	279	316	14	3	37	0.0810811
NODE_27667_length_579_cov_5.956250	279	316	16	25	37	0.6756757
NODE_27674_length_579_cov_4.850000	105	185	0	80	80	1.0000000
NODE_27674_length_579_cov_4.850000	158	238	0	80	80	1.0000000
NODE_27688_length_579_cov_3.291667	290	343	2	53	53	1.0000000
NODE_27695_length_579_cov_2.420833	251	331	0	16	80	0.2000000
NODE_27695_length_579_cov_2.420833	251	331	2	32	80	0.4000000
NODE_27695_length_579_cov_2.420833	251	331	4	32	80	0.4000000
NODE_27695_length_579_cov_2.420833	304	384	0	69	80	0.8625000
NODE_27695_length_579_cov_2.420833	304	384	2	11	80	0.1375000
NODE_27724_length_579_cov_1.435417	463	497	4	34	34	1.0000000
NODE_27781_length_578_cov_70.192067	100	180	0	80	80	1.0000000
NODE_27781_length_578_cov_70.192067	153	233	0	29	80	0.3625000
NODE_27781_length_578_cov_70.192067	153	233	2	40	80	0.5000000
NODE_27781_length_578_cov_70.192067	153	233	4	2	80	0.0250000
NODE_27781_length_578_cov_70.192067	153	233	6	9	80	0.1125000
NODE_27782_length_578_cov_51.676409	129	209	0	80	80	1.0000000
NODE_27782_length_578_cov_51.676409	182	262	0	80	80	1.0000000
NODE_27783_length_578_cov_32.152401	310	390	0	72	80	0.9000000
NODE_27783_length_578_cov_32.152401	310	390	2	8	80	0.1000000
NODE_27783_length_578_cov_32.152401	363	443	0	19	80	0.2375000
NODE_27783_length_578_cov_32.152401	363	443	2	61	80	0.7625000
NODE_27784_length_578_cov_30.484342	215	295	0	80	80	1.0000000
NODE_27784_length_578_cov_30.484342	268	348	0	80	80	1.0000000
NODE_27785_length_578_cov_15.983299	213	265	9	5	52	0.0961538
NODE_27785_length_578_cov_15.983299	213	265	10	12	52	0.2307692
NODE_27785_length_578_cov_15.983299	213	265	11	1	52	0.0192308
NODE_27785_length_578_cov_15.983299	213	265	12	34	52	0.6538461
NODE_27786_length_578_cov_14.968685	147	227	0	29	80	0.3625000
NODE_27786_length_578_cov_14.968685	147	227	2	51	80	0.6375000
NODE_27786_length_578_cov_14.968685	200	280	2	80	80	1.0000000
NODE_27787_length_578_cov_9.567850	273	328	0	7	55	0.1272727
NODE_27787_length_578_cov_9.567850	273	328	2	48	55	0.8727273
NODE_27792_length_578_cov_6.670146	273	353	0	41	80	0.5125000
NODE_27792_length_578_cov_6.670146	273	353	2	39	80	0.4875000
NODE_27792_length_578_cov_6.670146	326	406	2	80	80	1.0000000
NODE_27793_length_578_cov_6.465553	320	400	0	80	80	1.0000000
NODE_27793_length_578_cov_6.465553	373	453	0	80	80	1.0000000
NODE_27863_length_578_cov_1.480167	185	265	0	80	80	1.0000000
NODE_27863_length_578_cov_1.480167	238	318	0	80	80	1.0000000
NODE_27935_length_577_cov_11.638075	312	392	0	8	80	0.1000000
NODE_27935_length_577_cov_11.638075	312	392	2	72	80	0.9000000
NODE_27942_length_577_cov_4.912134	218	249	8	31	31	1.0000000
NODE_27942_length_577_cov_4.912134	301	330	4	6	29	0.2068966
NODE_27942_length_577_cov_4.912134	301	330	6	9	29	0.3103448
NODE_27942_length_577_cov_4.912134	301	330	8	14	29	0.4827586
NODE_27961_length_577_cov_2.970711	78	126	10	1	48	0.0208333
NODE_27961_length_577_cov_2.970711	78	126	12	3	48	0.0625000
NODE_27961_length_577_cov_2.970711	78	126	15	1	48	0.0208333
NODE_27961_length_577_cov_2.970711	78	126	16	12	48	0.2500000
NODE_27961_length_577_cov_2.970711	78	126	18	4	48	0.0833333
NODE_27961_length_577_cov_2.970711	78	126	20	27	48	0.5625000
NODE_27968_length_577_cov_2.631799	169	253	10	9	84	0.1071429
NODE_27968_length_577_cov_2.631799	169	253	12	8	84	0.0952381
NODE_27968_length_577_cov_2.631799	169	253	14	33	84	0.3928571
NODE_27968_length_577_cov_2.631799	169	253	16	6	84	0.0714286
NODE_27968_length_577_cov_2.631799	169	253	17	3	84	0.0357143
NODE_27968_length_577_cov_2.631799	169	253	18	23	84	0.2738095
NODE_27968_length_577_cov_2.631799	169	253	19	1	84	0.0119048
NODE_27968_length_577_cov_2.631799	169	253	20	1	84	0.0119048
NODE_27968_length_577_cov_2.631799	226	269	16	4	43	0.0930233
NODE_27968_length_577_cov_2.631799	226	269	17	10	43	0.2325581
NODE_27968_length_577_cov_2.631799	226	269	18	24	43	0.5581396
NODE_27968_length_577_cov_2.631799	226	269	19	5	43	0.1162791
NODE_28003_length_577_cov_1.468619	71	146	0	75	75	1.0000000
NODE_28003_length_577_cov_1.468619	119	199	0	80	80	1.0000000
NODE_28058_length_576_cov_10.903564	194	274	2	80	80	1.0000000
NODE_28059_length_576_cov_9.039832	271	351	0	80	80	1.0000000
NODE_28059_length_576_cov_9.039832	324	404	0	80	80	1.0000000
NODE_28060_length_576_cov_8.490566	338	418	0	22	80	0.2750000
NODE_28060_length_576_cov_8.490566	338	418	2	1	80	0.0125000
NODE_28060_length_576_cov_8.490566	338	418	6	57	80	0.7125000
NODE_28060_length_576_cov_8.490566	391	471	0	21	80	0.2625000
NODE_28060_length_576_cov_8.490566	391	471	4	18	80	0.2250000
NODE_28060_length_576_cov_8.490566	391	471	6	41	80	0.5125000
NODE_28061_length_576_cov_7.002096	157	237	0	80	80	1.0000000
NODE_28061_length_576_cov_7.002096	210	290	0	80	80	1.0000000
NODE_28076_length_576_cov_3.322851	118	183	7	15	65	0.2307692
NODE_28076_length_576_cov_3.322851	118	183	9	2	65	0.0307692
NODE_28076_length_576_cov_3.322851	118	183	11	9	65	0.1384615
NODE_28076_length_576_cov_3.322851	118	183	12	15	65	0.2307692
NODE_28076_length_576_cov_3.322851	118	183	14	24	65	0.3692308
NODE_28102_length_576_cov_1.964361	148	228	2	80	80	1.0000000
NODE_28102_length_576_cov_1.964361	201	281	1	14	80	0.1750000
NODE_28102_length_576_cov_1.964361	201	281	2	56	80	0.7000000
NODE_28102_length_576_cov_1.964361	201	281	3	10	80	0.1250000
NODE_28104_length_576_cov_1.951782	159	239	0	80	80	1.0000000
NODE_28104_length_576_cov_1.951782	212	292	0	47	80	0.5875000
NODE_28104_length_576_cov_1.951782	212	292	3	1	80	0.0125000
NODE_28104_length_576_cov_1.951782	212	292	4	32	80	0.4000000
NODE_28116_length_576_cov_1.584906	381	455	2	70	74	0.9459459
NODE_28116_length_576_cov_1.584906	381	455	4	4	74	0.0540541
NODE_28179_length_575_cov_15.319328	319	399	0	10	80	0.1250000
NODE_28179_length_575_cov_15.319328	319	399	2	70	80	0.8750000
NODE_28179_length_575_cov_15.319328	372	452	0	37	80	0.4625000
NODE_28179_length_575_cov_15.319328	372	452	2	43	80	0.5375000
NODE_28181_length_575_cov_8.254202	286	366	0	80	80	1.0000000
NODE_28181_length_575_cov_8.254202	339	419	0	80	80	1.0000000
NODE_28182_length_575_cov_7.558824	300	380	0	80	80	1.0000000
NODE_28313_length_574_cov_6.282105	185	265	2	52	80	0.6500000
NODE_28313_length_574_cov_6.282105	185	265	3	28	80	0.3500000
NODE_28313_length_574_cov_6.282105	238	318	0	50	80	0.6250000
NODE_28313_length_574_cov_6.282105	238	318	2	30	80	0.3750000
NODE_28330_length_574_cov_2.993684	215	234	0	19	19	1.0000000
NODE_28438_length_573_cov_53.668776	393	473	0	80	80	1.0000000
NODE_28438_length_573_cov_53.668776	446	526	0	80	80	1.0000000
NODE_28439_length_573_cov_30.658228	451	531	2	78	80	0.9750000
NODE_28439_length_573_cov_30.658228	451	531	4	2	80	0.0250000
NODE_28440_length_573_cov_30.116034	435	515	14	17	80	0.2125000
NODE_28440_length_573_cov_30.116034	435	515	15	1	80	0.0125000
NODE_28440_length_573_cov_30.116034	435	515	16	1	80	0.0125000
NODE_28440_length_573_cov_30.116034	435	515	18	7	80	0.0875000
NODE_28440_length_573_cov_30.116034	435	515	22	6	80	0.0750000
NODE_28440_length_573_cov_30.116034	435	515	24	12	80	0.1500000
NODE_28440_length_573_cov_30.116034	435	515	25	1	80	0.0125000
NODE_28440_length_573_cov_30.116034	435	515	26	5	80	0.0625000
NODE_28440_length_573_cov_30.116034	435	515	27	8	80	0.1000000
NODE_28440_length_573_cov_30.116034	435	515	28	6	80	0.0750000
NODE_28440_length_573_cov_30.116034	435	515	29	1	80	0.0125000
NODE_28440_length_573_cov_30.116034	435	515	30	10	80	0.1250000
NODE_28440_length_573_cov_30.116034	435	515	32	1	80	0.0125000
NODE_28440_length_573_cov_30.116034	435	515	33	1	80	0.0125000
NODE_28440_length_573_cov_30.116034	435	515	35	1	80	0.0125000
NODE_28440_length_573_cov_30.116034	435	515	37	2	80	0.0250000
NODE_28440_length_573_cov_30.116034	488	568	0	5	80	0.0625000
NODE_28440_length_573_cov_30.116034	488	568	2	2	80	0.0250000
NODE_28440_length_573_cov_30.116034	488	568	4	9	80	0.1125000
NODE_28440_length_573_cov_30.116034	488	568	8	15	80	0.1875000
NODE_28440_length_573_cov_30.116034	488	568	12	17	80	0.2125000
NODE_28440_length_573_cov_30.116034	488	568	14	22	80	0.2750000
NODE_28440_length_573_cov_30.116034	488	568	15	1	80	0.0125000
NODE_28440_length_573_cov_30.116034	488	568	16	1	80	0.0125000
NODE_28440_length_573_cov_30.116034	488	568	18	7	80	0.0875000
NODE_28440_length_573_cov_30.116034	488	568	22	1	80	0.0125000
NODE_28441_length_573_cov_24.234177	210	290	0	37	80	0.4625000
NODE_28441_length_573_cov_24.234177	210	290	2	43	80	0.5375000
NODE_28441_length_573_cov_24.234177	263	343	2	80	80	1.0000000
NODE_28442_length_573_cov_13.464135	278	358	0	80	80	1.0000000
NODE_28442_length_573_cov_13.464135	331	411	0	80	80	1.0000000
NODE_28443_length_573_cov_8.761603	124	204	0	6	80	0.0750000
NODE_28443_length_573_cov_8.761603	124	204	2	27	80	0.3375000
NODE_28443_length_573_cov_8.761603	124	204	8	47	80	0.5875000
NODE_28443_length_573_cov_8.761603	177	257	0	59	80	0.7375000
NODE_28443_length_573_cov_8.761603	177	257	2	21	80	0.2625000
NODE_28456_length_573_cov_3.364979	365	398	31	2	33	0.0606061
NODE_28456_length_573_cov_3.364979	365	398	32	8	33	0.2424242
NODE_28456_length_573_cov_3.364979	365	398	33	10	33	0.3030303
NODE_28456_length_573_cov_3.364979	365	398	34	10	33	0.3030303
NODE_28456_length_573_cov_3.364979	365	398	35	3	33	0.0909091
NODE_28565_length_572_cov_17.530655	312	392	0	36	80	0.4500000
NODE_28565_length_572_cov_17.530655	312	392	2	44	80	0.5500000
NODE_28565_length_572_cov_17.530655	365	445	2	80	80	1.0000000
NODE_28567_length_572_cov_8.059197	250	321	0	71	71	1.0000000
NODE_28568_length_572_cov_7.873150	134	214	0	80	80	1.0000000
NODE_28568_length_572_cov_7.873150	187	267	0	80	80	1.0000000
NODE_28570_length_572_cov_6.706131	365	445	0	33	80	0.4125000
NODE_28570_length_572_cov_6.706131	365	445	2	47	80	0.5875000
NODE_28570_length_572_cov_6.706131	418	498	0	80	80	1.0000000
NODE_28573_length_572_cov_5.625793	137	217	2	80	80	1.0000000
NODE_28573_length_572_cov_5.625793	190	270	0	49	80	0.6125000
NODE_28573_length_572_cov_5.625793	190	270	2	31	80	0.3875000
NODE_28574_length_572_cov_5.617336	331	401	0	24	70	0.3428572
NODE_28574_length_572_cov_5.617336	331	401	2	5	70	0.0714286
NODE_28574_length_572_cov_5.617336	331	401	6	1	70	0.0142857
NODE_28574_length_572_cov_5.617336	331	401	8	16	70	0.2285714
NODE_28574_length_572_cov_5.617336	331	401	12	12	70	0.1714286
NODE_28574_length_572_cov_5.617336	331	401	13	2	70	0.0285714
NODE_28574_length_572_cov_5.617336	331	401	14	10	70	0.1428571
NODE_28578_length_572_cov_4.596195	212	288	0	76	76	1.0000000
NODE_28578_length_572_cov_4.596195	261	341	0	80	80	1.0000000
NODE_28585_length_572_cov_3.843552	210	290	2	11	80	0.1375000
NODE_28585_length_572_cov_3.843552	210	290	4	69	80	0.8625000
NODE_28585_length_572_cov_3.843552	263	343	1	9	80	0.1125000
NODE_28585_length_572_cov_3.843552	263	343	2	46	80	0.5750000
NODE_28585_length_572_cov_3.843552	263	343	3	9	80	0.1125000
NODE_28585_length_572_cov_3.843552	263	343	4	16	80	0.2000000
NODE_28621_length_572_cov_2.319239	357	431	0	74	74	1.0000000
NODE_28621_length_572_cov_2.319239	410	478	0	68	68	1.0000000
NODE_28625_length_572_cov_2.107822	184	254	0	9	70	0.1285714
NODE_28625_length_572_cov_2.107822	184	254	2	61	70	0.8714285
NODE_28625_length_572_cov_2.107822	415	493	0	35	78	0.4487180
NODE_28625_length_572_cov_2.107822	415	493	2	43	78	0.5512820
NODE_28631_length_572_cov_1.947146	327	363	0	36	36	1.0000000
NODE_28631_length_572_cov_1.947146	328	354	0	26	26	1.0000000
NODE_28700_length_571_cov_14.262712	237	317	0	80	80	1.0000000
NODE_28700_length_571_cov_14.262712	290	370	0	80	80	1.0000000
NODE_28717_length_571_cov_4.033898	154	234	0	80	80	1.0000000
NODE_28717_length_571_cov_4.033898	207	273	0	66	66	1.0000000
NODE_28809_length_570_cov_28.269639	487	559	25	2	72	0.0277778
NODE_28809_length_570_cov_28.269639	487	559	27	3	72	0.0416667
NODE_28809_length_570_cov_28.269639	487	559	29	1	72	0.0138889
NODE_28809_length_570_cov_28.269639	487	559	31	1	72	0.0138889
NODE_28809_length_570_cov_28.269639	487	559	37	7	72	0.0972222
NODE_28809_length_570_cov_28.269639	487	559	39	1	72	0.0138889
NODE_28809_length_570_cov_28.269639	487	559	45	12	72	0.1666667
NODE_28809_length_570_cov_28.269639	487	559	47	25	72	0.3472222
NODE_28809_length_570_cov_28.269639	487	559	48	20	72	0.2777778
NODE_28812_length_570_cov_10.161359	167	247	6	67	80	0.8375000
NODE_28812_length_570_cov_10.161359	167	247	12	13	80	0.1625000
NODE_28812_length_570_cov_10.161359	220	256	6	36	36	1.0000000
NODE_28819_length_570_cov_5.010616	179	216	2	37	37	1.0000000
NODE_28819_length_570_cov_5.010616	189	269	0	11	80	0.1375000
NODE_28819_length_570_cov_5.010616	189	269	2	69	80	0.8625000
NODE_28828_length_570_cov_3.898089	236	316	0	80	80	1.0000000
NODE_28828_length_570_cov_3.898089	289	369	0	80	80	1.0000000
NODE_28840_length_570_cov_2.938429	202	280	4	21	78	0.2692308
NODE_28840_length_570_cov_2.938429	202	280	6	24	78	0.3076923
NODE_28840_length_570_cov_2.938429	202	280	8	11	78	0.1410256
NODE_28840_length_570_cov_2.938429	202	280	12	22	78	0.2820513
NODE_28840_length_570_cov_2.938429	262	333	1	7	71	0.0985916
NODE_28840_length_570_cov_2.938429	262	333	2	13	71	0.1830986
NODE_28840_length_570_cov_2.938429	262	333	3	28	71	0.3943662
NODE_28840_length_570_cov_2.938429	262	333	4	23	71	0.3239437
NODE_28842_length_570_cov_2.891720	204	260	0	56	56	1.0000000
NODE_28950_length_569_cov_20.559574	275	355	0	80	80	1.0000000
NODE_28950_length_569_cov_20.559574	328	408	0	80	80	1.0000000
NODE_28951_length_569_cov_15.282979	272	352	0	54	80	0.6750000
NODE_28951_length_569_cov_15.282979	272	352	2	26	80	0.3250000
NODE_28951_length_569_cov_15.282979	325	405	0	1	80	0.0125000
NODE_28951_length_569_cov_15.282979	325	405	2	78	80	0.9750000
NODE_28951_length_569_cov_15.282979	325	405	6	1	80	0.0125000
NODE_28952_length_569_cov_11.023404	280	360	0	28	80	0.3500000
NODE_28952_length_569_cov_11.023404	280	360	2	24	80	0.3000000
NODE_28952_length_569_cov_11.023404	280	360	4	28	80	0.3500000
NODE_28952_length_569_cov_11.023404	333	413	0	80	80	1.0000000
NODE_28953_length_569_cov_9.310638	231	277	0	7	46	0.1521739
NODE_28953_length_569_cov_9.310638	231	277	2	12	46	0.2608696
NODE_28953_length_569_cov_9.310638	231	277	4	27	46	0.5869565
NODE_28956_length_569_cov_6.989362	258	338	0	10	80	0.1250000
NODE_28956_length_569_cov_6.989362	258	338	2	2	80	0.0250000
NODE_28956_length_569_cov_6.989362	258	338	4	68	80	0.8500000
NODE_28956_length_569_cov_6.989362	294	329	0	1	35	0.0285714
NODE_28956_length_569_cov_6.989362	294	329	2	2	35	0.0571429
NODE_28956_length_569_cov_6.989362	294	329	4	32	35	0.9142857
NODE_28956_length_569_cov_6.989362	296	338	0	10	42	0.2380952
NODE_28956_length_569_cov_6.989362	296	338	2	2	42	0.0476190
NODE_28956_length_569_cov_6.989362	296	338	4	30	42	0.7142857
NODE_28957_length_569_cov_6.978723	264	344	2	80	80	1.0000000
NODE_28957_length_569_cov_6.978723	317	397	0	19	80	0.2375000
NODE_28957_length_569_cov_6.978723	317	397	2	61	80	0.7625000
NODE_28960_length_569_cov_6.434043	228	308	0	80	80	1.0000000
NODE_28973_length_569_cov_3.353191	340	419	0	79	79	1.0000000
NODE_28981_length_569_cov_3.027660	277	348	0	71	71	1.0000000
NODE_29072_length_568_cov_59.729211	124	204	4	9	80	0.1125000
NODE_29072_length_568_cov_59.729211	124	204	6	25	80	0.3125000
NODE_29072_length_568_cov_59.729211	124	204	8	46	80	0.5750000
NODE_29072_length_568_cov_59.729211	177	257	0	28	80	0.3500000
NODE_29072_length_568_cov_59.729211	177	257	2	6	80	0.0750000
NODE_29072_length_568_cov_59.729211	177	257	4	26	80	0.3250000
NODE_29072_length_568_cov_59.729211	177	257	6	17	80	0.2125000
NODE_29072_length_568_cov_59.729211	177	257	8	3	80	0.0375000
NODE_29075_length_568_cov_7.763326	215	294	0	79	79	1.0000000
NODE_29075_length_568_cov_7.763326	267	347	0	80	80	1.0000000
NODE_29078_length_568_cov_6.257996	397	471	0	74	74	1.0000000
NODE_29091_length_568_cov_3.748401	170	236	0	2	66	0.0303030
NODE_29091_length_568_cov_3.748401	170	236	2	64	66	0.9696970
NODE_29091_length_568_cov_3.748401	262	311	0	49	49	1.0000000
NODE_29133_length_568_cov_1.769723	192	233	0	41	41	1.0000000
NODE_29160_length_568_cov_1.358209	355	432	4	1	77	0.0129870
NODE_29160_length_568_cov_1.358209	355	432	6	12	77	0.1558442
NODE_29160_length_568_cov_1.358209	355	432	8	21	77	0.2727273
NODE_29160_length_568_cov_1.358209	355	432	10	43	77	0.5584416
NODE_29182_length_568_cov_1.038380	195	275	0	80	80	1.0000000
NODE_29216_length_567_cov_21.155983	347	427	0	80	80	1.0000000
NODE_29216_length_567_cov_21.155983	400	480	0	80	80	1.0000000
NODE_29217_length_567_cov_18.292735	367	447	0	80	80	1.0000000
NODE_29217_length_567_cov_18.292735	420	500	0	80	80	1.0000000
NODE_29218_length_567_cov_17.579060	259	339	0	80	80	1.0000000
NODE_29218_length_567_cov_17.579060	312	392	0	80	80	1.0000000
NODE_29220_length_567_cov_15.457265	276	356	0	80	80	1.0000000
NODE_29220_length_567_cov_15.457265	329	409	0	80	80	1.0000000
NODE_29221_length_567_cov_14.393162	270	350	0	80	80	1.0000000
NODE_29221_length_567_cov_14.393162	323	403	0	80	80	1.0000000
NODE_29225_length_567_cov_6.611111	356	436	0	80	80	1.0000000
NODE_29225_length_567_cov_6.611111	409	489	0	77	80	0.9625000
NODE_29225_length_567_cov_6.611111	409	489	2	3	80	0.0375000
NODE_29245_length_567_cov_2.884615	204	284	0	80	80	1.0000000
NODE_29245_length_567_cov_2.884615	204	254	0	50	50	1.0000000
NODE_29245_length_567_cov_2.884615	266	297	0	31	31	1.0000000
NODE_29363_length_566_cov_47.747323	157	237	2	3	80	0.0375000
NODE_29363_length_566_cov_47.747323	157	237	4	49	80	0.6125000
NODE_29363_length_566_cov_47.747323	157	237	6	28	80	0.3500000
NODE_29363_length_566_cov_47.747323	210	290	2	28	80	0.3500000
NODE_29363_length_566_cov_47.747323	210	290	4	10	80	0.1250000
NODE_29363_length_566_cov_47.747323	210	290	6	42	80	0.5250000
NODE_29364_length_566_cov_44.824411	14	94	10	1	80	0.0125000
NODE_29364_length_566_cov_44.824411	14	94	16	1	80	0.0125000
NODE_29364_length_566_cov_44.824411	14	94	18	6	80	0.0750000
NODE_29364_length_566_cov_44.824411	14	94	20	2	80	0.0250000
NODE_29364_length_566_cov_44.824411	14	94	22	1	80	0.0125000
NODE_29364_length_566_cov_44.824411	14	94	35	1	80	0.0125000
NODE_29364_length_566_cov_44.824411	14	94	44	1	80	0.0125000
NODE_29364_length_566_cov_44.824411	14	94	46	1	80	0.0125000
NODE_29364_length_566_cov_44.824411	14	94	52	1	80	0.0125000
NODE_29364_length_566_cov_44.824411	14	94	54	9	80	0.1125000
NODE_29364_length_566_cov_44.824411	14	94	56	5	80	0.0625000
NODE_29364_length_566_cov_44.824411	14	94	58	51	80	0.6375000
NODE_29364_length_566_cov_44.824411	15	94	16	1	79	0.0126582
NODE_29364_length_566_cov_44.824411	15	94	18	6	79	0.0759494
NODE_29364_length_566_cov_44.824411	15	94	20	2	79	0.0253165
NODE_29364_length_566_cov_44.824411	15	94	22	1	79	0.0126582
NODE_29364_length_566_cov_44.824411	15	94	35	1	79	0.0126582
NODE_29364_length_566_cov_44.824411	15	94	44	1	79	0.0126582
NODE_29364_length_566_cov_44.824411	15	94	46	1	79	0.0126582
NODE_29364_length_566_cov_44.824411	15	94	52	1	79	0.0126582
NODE_29364_length_566_cov_44.824411	15	94	54	9	79	0.1139240
NODE_29364_length_566_cov_44.824411	15	94	56	5	79	0.0632911
NODE_29364_length_566_cov_44.824411	15	94	58	51	79	0.6455696
NODE_29364_length_566_cov_44.824411	67	147	16	3	80	0.0375000
NODE_29364_length_566_cov_44.824411	67	147	18	1	80	0.0125000
NODE_29364_length_566_cov_44.824411	67	147	26	1	80	0.0125000
NODE_29364_length_566_cov_44.824411	67	147	28	8	80	0.1000000
NODE_29364_length_566_cov_44.824411	67	147	30	5	80	0.0625000
NODE_29364_length_566_cov_44.824411	67	147	32	1	80	0.0125000
NODE_29364_length_566_cov_44.824411	67	147	36	6	80	0.0750000
NODE_29364_length_566_cov_44.824411	67	147	38	3	80	0.0375000
NODE_29364_length_566_cov_44.824411	67	147	44	1	80	0.0125000
NODE_29364_length_566_cov_44.824411	67	147	45	1	80	0.0125000
NODE_29364_length_566_cov_44.824411	67	147	48	6	80	0.0750000
NODE_29364_length_566_cov_44.824411	67	147	52	2	80	0.0250000
NODE_29364_length_566_cov_44.824411	67	147	56	3	80	0.0375000
NODE_29364_length_566_cov_44.824411	67	147	58	39	80	0.4875000
NODE_29364_length_566_cov_44.824411	67	147	16	3	80	0.0375000
NODE_29364_length_566_cov_44.824411	67	147	18	1	80	0.0125000
NODE_29364_length_566_cov_44.824411	67	147	26	1	80	0.0125000
NODE_29364_length_566_cov_44.824411	67	147	28	8	80	0.1000000
NODE_29364_length_566_cov_44.824411	67	147	30	5	80	0.0625000
NODE_29364_length_566_cov_44.824411	67	147	32	1	80	0.0125000
NODE_29364_length_566_cov_44.824411	67	147	36	6	80	0.0750000
NODE_29364_length_566_cov_44.824411	67	147	38	3	80	0.0375000
NODE_29364_length_566_cov_44.824411	67	147	44	1	80	0.0125000
NODE_29364_length_566_cov_44.824411	67	147	45	1	80	0.0125000
NODE_29364_length_566_cov_44.824411	67	147	48	6	80	0.0750000
NODE_29364_length_566_cov_44.824411	67	147	52	2	80	0.0250000
NODE_29364_length_566_cov_44.824411	67	147	56	3	80	0.0375000
NODE_29364_length_566_cov_44.824411	67	147	58	39	80	0.4875000
NODE_29364_length_566_cov_44.824411	77	147	16	3	70	0.0428571
NODE_29364_length_566_cov_44.824411	77	147	18	1	70	0.0142857
NODE_29364_length_566_cov_44.824411	77	147	26	1	70	0.0142857
NODE_29364_length_566_cov_44.824411	77	147	28	8	70	0.1142857
NODE_29364_length_566_cov_44.824411	77	147	30	5	70	0.0714286
NODE_29364_length_566_cov_44.824411	77	147	32	1	70	0.0142857
NODE_29364_length_566_cov_44.824411	77	147	36	6	70	0.0857143
NODE_29364_length_566_cov_44.824411	77	147	38	3	70	0.0428571
NODE_29364_length_566_cov_44.824411	77	147	44	1	70	0.0142857
NODE_29364_length_566_cov_44.824411	77	147	45	1	70	0.0142857
NODE_29364_length_566_cov_44.824411	77	147	48	6	70	0.0857143
NODE_29364_length_566_cov_44.824411	77	147	52	2	70	0.0285714
NODE_29364_length_566_cov_44.824411	77	147	56	3	70	0.0428571
NODE_29364_length_566_cov_44.824411	77	147	58	29	70	0.4142857
NODE_29364_length_566_cov_44.824411	143	223	0	36	80	0.4500000
NODE_29364_length_566_cov_44.824411	143	223	2	8	80	0.1000000
NODE_29364_length_566_cov_44.824411	143	223	6	21	80	0.2625000
NODE_29364_length_566_cov_44.824411	143	223	7	1	80	0.0125000
NODE_29364_length_566_cov_44.824411	143	223	10	4	80	0.0500000
NODE_29364_length_566_cov_44.824411	143	223	12	4	80	0.0500000
NODE_29364_length_566_cov_44.824411	143	223	16	5	80	0.0625000
NODE_29364_length_566_cov_44.824411	143	223	18	1	80	0.0125000
NODE_29364_length_566_cov_44.824411	196	276	2	6	80	0.0750000
NODE_29364_length_566_cov_44.824411	196	276	6	74	80	0.9250000
NODE_29367_length_566_cov_18.494647	344	424	2	41	80	0.5125000
NODE_29367_length_566_cov_18.494647	344	424	4	15	80	0.1875000
NODE_29367_length_566_cov_18.494647	344	424	6	24	80	0.3000000
NODE_29367_length_566_cov_18.494647	397	477	0	47	80	0.5875000
NODE_29367_length_566_cov_18.494647	397	477	2	33	80	0.4125000
NODE_29368_length_566_cov_17.537473	324	404	2	1	80	0.0125000
NODE_29368_length_566_cov_17.537473	324	404	4	1	80	0.0125000
NODE_29368_length_566_cov_17.537473	324	404	6	78	80	0.9750000
NODE_29368_length_566_cov_17.537473	377	457	0	33	80	0.4125000
NODE_29368_length_566_cov_17.537473	377	457	2	4	80	0.0500000
NODE_29368_length_566_cov_17.537473	377	457	4	7	80	0.0875000
NODE_29368_length_566_cov_17.537473	377	457	6	36	80	0.4500000
NODE_29369_length_566_cov_13.019272	157	237	0	80	80	1.0000000
NODE_29369_length_566_cov_13.019272	210	290	0	80	80	1.0000000
NODE_29371_length_566_cov_9.513919	191	279	0	88	88	1.0000000
NODE_29371_length_566_cov_9.513919	252	332	0	39	80	0.4875000
NODE_29371_length_566_cov_9.513919	252	332	2	6	80	0.0750000
NODE_29371_length_566_cov_9.513919	252	332	4	35	80	0.4375000
NODE_29397_length_566_cov_3.239829	292	334	0	42	42	1.0000000
NODE_29397_length_566_cov_3.239829	351	375	0	24	24	1.0000000
NODE_29437_length_566_cov_1.698073	432	481	0	49	49	1.0000000
NODE_29472_length_566_cov_0.957173	378	405	2	12	27	0.4444444
NODE_29472_length_566_cov_0.957173	378	405	4	15	27	0.5555556
NODE_29503_length_565_cov_10.508584	202	280	0	78	78	1.0000000
NODE_29503_length_565_cov_10.508584	253	334	0	81	81	1.0000000
NODE_29509_length_565_cov_7.560086	170	246	0	38	76	0.5000000
NODE_29509_length_565_cov_7.560086	170	246	2	28	76	0.3684210
NODE_29509_length_565_cov_7.560086	170	246	4	9	76	0.1184211
NODE_29509_length_565_cov_7.560086	170	246	5	1	76	0.0131579
NODE_29520_length_565_cov_4.045064	231	311	0	26	80	0.3250000
NODE_29520_length_565_cov_4.045064	231	311	2	54	80	0.6750000
NODE_29520_length_565_cov_4.045064	284	364	0	79	80	0.9875000
NODE_29520_length_565_cov_4.045064	284	364	2	1	80	0.0125000
NODE_29528_length_565_cov_3.399142	161	241	0	80	80	1.0000000
NODE_29528_length_565_cov_3.399142	214	294	0	80	80	1.0000000
NODE_29542_length_565_cov_2.542918	302	382	0	13	80	0.1625000
NODE_29542_length_565_cov_2.542918	302	382	2	66	80	0.8250000
NODE_29542_length_565_cov_2.542918	302	382	4	1	80	0.0125000
NODE_29542_length_565_cov_2.542918	355	435	0	66	80	0.8250000
NODE_29542_length_565_cov_2.542918	355	435	2	14	80	0.1750000
NODE_29650_length_564_cov_46.901075	129	209	2	7	80	0.0875000
NODE_29650_length_564_cov_46.901075	129	209	4	69	80	0.8625000
NODE_29650_length_564_cov_46.901075	129	209	6	4	80	0.0500000
NODE_29650_length_564_cov_46.901075	182	262	2	60	80	0.7500000
NODE_29650_length_564_cov_46.901075	182	262	4	16	80	0.2000000
NODE_29650_length_564_cov_46.901075	182	262	6	4	80	0.0500000
NODE_29651_length_564_cov_13.520430	300	380	1	13	80	0.1625000
NODE_29651_length_564_cov_13.520430	300	380	2	50	80	0.6250000
NODE_29651_length_564_cov_13.520430	300	380	4	17	80	0.2125000
NODE_29651_length_564_cov_13.520430	353	433	0	23	80	0.2875000
NODE_29651_length_564_cov_13.520430	353	433	1	43	80	0.5375000
NODE_29651_length_564_cov_13.520430	353	433	2	14	80	0.1750000
NODE_29653_length_564_cov_7.965591	291	332	0	41	41	1.0000000
NODE_29796_length_563_cov_24.487069	97	177	0	80	80	1.0000000
NODE_29796_length_563_cov_24.487069	150	230	0	80	80	1.0000000
NODE_29800_length_563_cov_6.758621	301	367	0	3	66	0.0454545
NODE_29800_length_563_cov_6.758621	301	367	3	1	66	0.0151515
NODE_29800_length_563_cov_6.758621	301	367	4	16	66	0.2424242
NODE_29800_length_563_cov_6.758621	301	367	8	6	66	0.0909091
NODE_29800_length_563_cov_6.758621	301	367	14	14	66	0.2121212
NODE_29800_length_563_cov_6.758621	301	367	16	5	66	0.0757576
NODE_29800_length_563_cov_6.758621	301	367	20	5	66	0.0757576
NODE_29800_length_563_cov_6.758621	301	367	21	4	66	0.0606061
NODE_29800_length_563_cov_6.758621	301	367	23	9	66	0.1363636
NODE_29800_length_563_cov_6.758621	301	367	24	3	66	0.0454545
NODE_29800_length_563_cov_6.758621	378	422	0	44	44	1.0000000
NODE_29802_length_563_cov_5.762931	48	135	2	14	87	0.1609195
NODE_29802_length_563_cov_5.762931	48	135	4	6	87	0.0689655
NODE_29802_length_563_cov_5.762931	48	135	6	54	87	0.6206896
NODE_29802_length_563_cov_5.762931	48	135	7	1	87	0.0114943
NODE_29802_length_563_cov_5.762931	48	135	8	12	87	0.1379310
NODE_29802_length_563_cov_5.762931	108	188	2	67	80	0.8375000
NODE_29802_length_563_cov_5.762931	108	188	4	6	80	0.0750000
NODE_29802_length_563_cov_5.762931	108	188	8	7	80	0.0875000
NODE_29808_length_563_cov_4.176724	197	277	0	80	80	1.0000000
NODE_29808_length_563_cov_4.176724	250	330	0	80	80	1.0000000
NODE_29809_length_563_cov_4.155172	273	315	10	42	42	1.0000000
NODE_29809_length_563_cov_4.155172	288	358	10	70	70	1.0000000
NODE_29925_length_562_cov_31.194384	47	127	0	16	80	0.2000000
NODE_29925_length_562_cov_31.194384	47	127	2	64	80	0.8000000
NODE_29925_length_562_cov_31.194384	100	180	0	40	80	0.5000000
NODE_29925_length_562_cov_31.194384	100	180	2	40	80	0.5000000
NODE_29926_length_562_cov_29.857451	33	113	0	23	80	0.2875000
NODE_29926_length_562_cov_29.857451	33	113	2	41	80	0.5125000
NODE_29926_length_562_cov_29.857451	33	113	4	16	80	0.2000000
NODE_29926_length_562_cov_29.857451	86	166	2	11	80	0.1375000
NODE_29926_length_562_cov_29.857451	86	166	4	47	80	0.5875000
NODE_29926_length_562_cov_29.857451	86	166	6	22	80	0.2750000
NODE_29927_length_562_cov_23.194384	245	325	6	80	80	1.0000000
NODE_29927_length_562_cov_23.194384	298	378	0	47	80	0.5875000
NODE_29927_length_562_cov_23.194384	298	378	4	1	80	0.0125000
NODE_29927_length_562_cov_23.194384	298	378	6	32	80	0.4000000
NODE_29930_length_562_cov_10.304536	271	321	2	10	50	0.2000000
NODE_29930_length_562_cov_10.304536	271	321	6	6	50	0.1200000
NODE_29930_length_562_cov_10.304536	271	321	8	4	50	0.0800000
NODE_29930_length_562_cov_10.304536	271	321	10	4	50	0.0800000
NODE_29930_length_562_cov_10.304536	271	321	12	26	50	0.5200000
NODE_29931_length_562_cov_9.131749	265	346	0	81	81	1.0000000
NODE_29931_length_562_cov_9.131749	319	399	0	64	80	0.8000000
NODE_29931_length_562_cov_9.131749	319	399	2	16	80	0.2000000
NODE_29960_length_562_cov_2.961123	350	398	0	48	48	1.0000000
NODE_30083_length_561_cov_18.049784	54	134	0	56	80	0.7000000
NODE_30083_length_561_cov_18.049784	54	134	1	1	80	0.0125000
NODE_30083_length_561_cov_18.049784	54	134	2	23	80	0.2875000
NODE_30083_length_561_cov_18.049784	107	187	0	3	80	0.0375000
NODE_30083_length_561_cov_18.049784	107	187	1	1	80	0.0125000
NODE_30083_length_561_cov_18.049784	107	187	2	76	80	0.9500000
NODE_30087_length_561_cov_5.348485	208	274	0	66	66	1.0000000
NODE_30105_length_561_cov_2.787879	216	285	0	38	69	0.5507246
NODE_30105_length_561_cov_2.787879	216	285	2	31	69	0.4492754
NODE_30120_length_561_cov_2.233766	339	419	2	19	80	0.2375000
NODE_30120_length_561_cov_2.233766	339	419	4	61	80	0.7625000
NODE_30120_length_561_cov_2.233766	391	445	0	15	54	0.2777778
NODE_30120_length_561_cov_2.233766	391	445	2	17	54	0.3148148
NODE_30120_length_561_cov_2.233766	391	445	4	22	54	0.4074074
NODE_30120_length_561_cov_2.233766	392	438	0	8	46	0.1739130
NODE_30120_length_561_cov_2.233766	392	438	2	17	46	0.3695652
NODE_30120_length_561_cov_2.233766	392	438	4	21	46	0.4565217
NODE_30133_length_561_cov_1.803030	258	334	0	1	76	0.0131579
NODE_30133_length_561_cov_1.803030	258	334	2	75	76	0.9868421
NODE_30224_length_560_cov_41.433839	67	147	0	37	80	0.4625000
NODE_30224_length_560_cov_41.433839	67	147	4	43	80	0.5375000
NODE_30224_length_560_cov_41.433839	120	200	4	80	80	1.0000000
NODE_30225_length_560_cov_35.993492	366	446	0	9	80	0.1125000
NODE_30225_length_560_cov_35.993492	366	446	2	1	80	0.0125000
NODE_30225_length_560_cov_35.993492	366	446	4	51	80	0.6375000
NODE_30225_length_560_cov_35.993492	366	446	6	19	80	0.2375000
NODE_30225_length_560_cov_35.993492	419	499	0	62	80	0.7750000
NODE_30225_length_560_cov_35.993492	419	499	2	1	80	0.0125000
NODE_30225_length_560_cov_35.993492	419	499	4	17	80	0.2125000
NODE_30226_length_560_cov_20.433839	342	422	0	8	80	0.1000000
NODE_30226_length_560_cov_20.433839	342	422	2	72	80	0.9000000
NODE_30226_length_560_cov_20.433839	395	475	0	14	80	0.1750000
NODE_30226_length_560_cov_20.433839	395	475	2	66	80	0.8250000
NODE_30227_length_560_cov_13.850325	274	327	0	53	53	1.0000000
NODE_30228_length_560_cov_12.075922	233	314	0	18	81	0.2222222
NODE_30228_length_560_cov_12.075922	233	314	2	55	81	0.6790124
NODE_30228_length_560_cov_12.075922	233	314	4	8	81	0.0987654
NODE_30229_length_560_cov_8.594360	263	343	2	80	80	1.0000000
NODE_30229_length_560_cov_8.594360	316	396	0	18	80	0.2250000
NODE_30229_length_560_cov_8.594360	316	396	2	62	80	0.7750000
NODE_30237_length_560_cov_5.227766	264	328	4	11	64	0.1718750
NODE_30237_length_560_cov_5.227766	264	328	8	53	64	0.8281250
NODE_30238_length_560_cov_5.056399	299	379	0	32	80	0.4000000
NODE_30238_length_560_cov_5.056399	299	379	4	48	80	0.6000000
NODE_30238_length_560_cov_5.056399	352	432	4	80	80	1.0000000
NODE_30244_length_560_cov_4.518438	156	236	0	80	80	1.0000000
NODE_30281_length_560_cov_2.154013	204	275	0	71	71	1.0000000
NODE_30281_length_560_cov_2.154013	255	335	0	80	80	1.0000000
NODE_30288_length_560_cov_2.017354	52	114	0	62	62	1.0000000
NODE_30363_length_559_cov_37.526087	289	370	0	81	81	1.0000000
NODE_30363_length_559_cov_37.526087	343	423	0	80	80	1.0000000
NODE_30363_length_559_cov_37.526087	419	500	0	81	81	1.0000000
NODE_30363_length_559_cov_37.526087	473	553	0	80	80	1.0000000
NODE_30365_length_559_cov_19.126087	388	468	0	80	80	1.0000000
NODE_30365_length_559_cov_19.126087	441	521	0	80	80	1.0000000
NODE_30366_length_559_cov_12.489130	262	341	2	10	79	0.1265823
NODE_30366_length_559_cov_12.489130	262	341	4	65	79	0.8227848
NODE_30366_length_559_cov_12.489130	262	341	6	4	79	0.0506329
NODE_30366_length_559_cov_12.489130	316	394	0	45	78	0.5769231
NODE_30366_length_559_cov_12.489130	316	394	2	18	78	0.2307692
NODE_30366_length_559_cov_12.489130	316	394	4	15	78	0.1923077
NODE_30370_length_559_cov_6.530435	283	363	0	80	80	1.0000000
NODE_30377_length_559_cov_4.930435	112	192	0	80	80	1.0000000
NODE_30377_length_559_cov_4.930435	165	244	0	79	79	1.0000000
NODE_30419_length_559_cov_1.776087	395	433	91	6	38	0.1578947
NODE_30419_length_559_cov_1.776087	395	433	93	1	38	0.0263158
NODE_30419_length_559_cov_1.776087	395	433	94	5	38	0.1315790
NODE_30419_length_559_cov_1.776087	395	433	96	3	38	0.0789474
NODE_30419_length_559_cov_1.776087	395	433	98	9	38	0.2368421
NODE_30419_length_559_cov_1.776087	395	433	100	7	38	0.1842105
NODE_30419_length_559_cov_1.776087	395	433	102	5	38	0.1315790
NODE_30419_length_559_cov_1.776087	395	433	104	2	38	0.0526316
NODE_30480_length_558_cov_13.102397	297	364	0	46	67	0.6865672
NODE_30480_length_558_cov_13.102397	297	364	2	2	67	0.0298507
NODE_30480_length_558_cov_13.102397	297	364	10	19	67	0.2835821
NODE_30482_length_558_cov_9.309368	369	449	0	40	80	0.5000000
NODE_30482_length_558_cov_9.309368	369	449	2	29	80	0.3625000
NODE_30482_length_558_cov_9.309368	369	449	4	11	80	0.1375000
NODE_30482_length_558_cov_9.309368	422	502	2	33	80	0.4125000
NODE_30482_length_558_cov_9.309368	422	502	4	47	80	0.5875000
NODE_30489_length_558_cov_5.921569	304	361	0	57	57	1.0000000
NODE_30493_length_558_cov_4.801743	197	266	0	69	69	1.0000000
NODE_30493_length_558_cov_4.801743	197	277	0	80	80	1.0000000
NODE_30493_length_558_cov_4.801743	250	330	0	79	80	0.9875000
NODE_30493_length_558_cov_4.801743	250	330	2	1	80	0.0125000
NODE_30493_length_558_cov_4.801743	250	330	0	79	80	0.9875000
NODE_30493_length_558_cov_4.801743	250	330	2	1	80	0.0125000
NODE_30495_length_558_cov_4.570806	188	244	2	34	56	0.6071429
NODE_30495_length_558_cov_4.570806	188	244	3	11	56	0.1964286
NODE_30495_length_558_cov_4.570806	188	244	4	11	56	0.1964286
NODE_30536_length_558_cov_2.259259	236	294	1	1	58	0.0172414
NODE_30536_length_558_cov_2.259259	236	294	4	6	58	0.1034483
NODE_30536_length_558_cov_2.259259	236	294	5	14	58	0.2413793
NODE_30536_length_558_cov_2.259259	236	294	6	37	58	0.6379310
NODE_30536_length_558_cov_2.259259	267	347	6	80	80	1.0000000
NODE_30568_length_558_cov_1.544662	403	483	0	34	80	0.4250000
NODE_30568_length_558_cov_1.544662	403	483	2	46	80	0.5750000
NODE_30568_length_558_cov_1.544662	456	536	0	80	80	1.0000000
NODE_30623_length_557_cov_9.141921	255	335	0	30	80	0.3750000
NODE_30623_length_557_cov_9.141921	255	335	4	50	80	0.6250000
NODE_30623_length_557_cov_9.141921	308	388	0	11	80	0.1375000
NODE_30623_length_557_cov_9.141921	308	388	4	69	80	0.8625000
NODE_30626_length_557_cov_7.316594	210	290	0	19	80	0.2375000
NODE_30626_length_557_cov_7.316594	210	290	2	61	80	0.7625000
NODE_30626_length_557_cov_7.316594	263	341	2	78	78	1.0000000
NODE_30636_length_557_cov_4.259825	185	267	2	16	82	0.1951219
NODE_30636_length_557_cov_4.259825	185	267	4	66	82	0.8048781
NODE_30646_length_557_cov_3.794760	131	188	0	57	57	1.0000000
NODE_30646_length_557_cov_3.794760	139	219	0	80	80	1.0000000
NODE_30650_length_557_cov_3.517467	246	325	0	10	79	0.1265823
NODE_30650_length_557_cov_3.517467	246	325	2	69	79	0.8734177
NODE_30650_length_557_cov_3.517467	298	378	0	63	80	0.7875000
NODE_30650_length_557_cov_3.517467	298	378	2	17	80	0.2125000
NODE_30652_length_557_cov_3.390830	366	395	20	6	29	0.2068966
NODE_30652_length_557_cov_3.390830	366	395	22	4	29	0.1379310
NODE_30652_length_557_cov_3.390830	366	395	24	6	29	0.2068966
NODE_30652_length_557_cov_3.390830	366	395	26	2	29	0.0689655
NODE_30652_length_557_cov_3.390830	366	395	28	11	29	0.3793103
NODE_30792_length_556_cov_37.258206	122	202	0	22	80	0.2750000
NODE_30792_length_556_cov_37.258206	122	202	6	58	80	0.7250000
NODE_30792_length_556_cov_37.258206	175	255	0	18	80	0.2250000
NODE_30792_length_556_cov_37.258206	175	255	6	62	80	0.7750000
NODE_30793_length_556_cov_15.266958	360	440	2	2	80	0.0250000
NODE_30793_length_556_cov_15.266958	360	440	4	16	80	0.2000000
NODE_30793_length_556_cov_15.266958	360	440	6	62	80	0.7750000
NODE_30793_length_556_cov_15.266958	413	493	0	29	80	0.3625000
NODE_30793_length_556_cov_15.266958	413	493	2	1	80	0.0125000
NODE_30793_length_556_cov_15.266958	413	493	4	23	80	0.2875000
NODE_30793_length_556_cov_15.266958	413	493	6	27	80	0.3375000
NODE_30794_length_556_cov_12.781182	341	421	0	15	80	0.1875000
NODE_30794_length_556_cov_12.781182	341	421	2	65	80	0.8125000
NODE_30794_length_556_cov_12.781182	394	474	0	68	80	0.8500000
NODE_30794_length_556_cov_12.781182	394	474	2	12	80	0.1500000
NODE_30795_length_556_cov_11.131291	304	384	2	7	80	0.0875000
NODE_30795_length_556_cov_11.131291	304	384	4	73	80	0.9125000
NODE_30795_length_556_cov_11.131291	357	437	0	42	80	0.5250000
NODE_30795_length_556_cov_11.131291	357	437	2	18	80	0.2250000
NODE_30795_length_556_cov_11.131291	357	437	4	20	80	0.2500000
NODE_30797_length_556_cov_7.168490	163	243	0	80	80	1.0000000
NODE_30797_length_556_cov_7.168490	216	296	0	80	80	1.0000000
NODE_30798_length_556_cov_7.089716	325	379	2	49	54	0.9074074
NODE_30798_length_556_cov_7.089716	325	379	4	5	54	0.0925926
NODE_30801_length_556_cov_6.505470	232	312	2	80	80	1.0000000
NODE_30801_length_556_cov_6.505470	285	365	2	80	80	1.0000000
NODE_30802_length_556_cov_6.496718	140	179	0	35	39	0.8974359
NODE_30802_length_556_cov_6.496718	140	179	2	4	39	0.1025641
NODE_30802_length_556_cov_6.496718	226	255	0	29	29	1.0000000
NODE_30809_length_556_cov_4.457330	197	277	2	29	80	0.3625000
NODE_30809_length_556_cov_4.457330	197	277	4	37	80	0.4625000
NODE_30809_length_556_cov_4.457330	197	277	6	8	80	0.1000000
NODE_30809_length_556_cov_4.457330	197	277	8	6	80	0.0750000
NODE_30818_length_556_cov_3.761488	234	307	0	9	73	0.1232877
NODE_30818_length_556_cov_3.761488	234	307	2	11	73	0.1506849
NODE_30818_length_556_cov_3.761488	234	307	4	13	73	0.1780822
NODE_30818_length_556_cov_3.761488	234	307	6	40	73	0.5479452
NODE_30930_length_555_cov_20.949561	322	402	2	80	80	1.0000000
NODE_30930_length_555_cov_20.949561	375	455	0	19	80	0.2375000
NODE_30930_length_555_cov_20.949561	375	455	2	61	80	0.7625000
NODE_30931_length_555_cov_16.822368	268	348	0	10	80	0.1250000
NODE_30931_length_555_cov_16.822368	268	348	2	18	80	0.2250000
NODE_30931_length_555_cov_16.822368	268	348	4	52	80	0.6500000
NODE_30931_length_555_cov_16.822368	321	401	2	48	80	0.6000000
NODE_30931_length_555_cov_16.822368	321	401	4	32	80	0.4000000
NODE_30933_length_555_cov_9.912281	313	393	0	80	80	1.0000000
NODE_30935_length_555_cov_8.057018	277	357	0	47	80	0.5875000
NODE_30935_length_555_cov_8.057018	277	357	2	27	80	0.3375000
NODE_30935_length_555_cov_8.057018	277	357	4	6	80	0.0750000
NODE_30935_length_555_cov_8.057018	330	410	2	22	80	0.2750000
NODE_30935_length_555_cov_8.057018	330	410	4	58	80	0.7250000
NODE_30938_length_555_cov_6.778509	62	92	0	30	30	1.0000000
NODE_30986_length_555_cov_2.177632	208	288	0	67	80	0.8375000
NODE_30986_length_555_cov_2.177632	208	288	2	13	80	0.1625000
NODE_30986_length_555_cov_2.177632	261	329	0	14	68	0.2058824
NODE_30986_length_555_cov_2.177632	261	329	2	54	68	0.7941176
NODE_31092_length_554_cov_11.942857	118	198	0	80	80	1.0000000
NODE_31092_length_554_cov_11.942857	171	251	0	80	80	1.0000000
NODE_31096_length_554_cov_8.426374	242	322	0	13	80	0.1625000
NODE_31096_length_554_cov_8.426374	242	322	2	67	80	0.8375000
NODE_31096_length_554_cov_8.426374	295	375	0	50	80	0.6250000
NODE_31096_length_554_cov_8.426374	295	375	2	30	80	0.3750000
NODE_31101_length_554_cov_6.116484	264	344	4	67	80	0.8375000
NODE_31101_length_554_cov_6.116484	264	344	6	13	80	0.1625000
NODE_31101_length_554_cov_6.116484	317	393	4	21	76	0.2763158
NODE_31101_length_554_cov_6.116484	317	393	6	55	76	0.7236842
NODE_31115_length_554_cov_3.586813	207	286	0	32	79	0.4050633
NODE_31115_length_554_cov_3.586813	207	286	2	47	79	0.5949367
NODE_31240_length_553_cov_42.017621	197	277	4	29	80	0.3625000
NODE_31240_length_553_cov_42.017621	197	277	8	7	80	0.0875000
NODE_31240_length_553_cov_42.017621	197	277	10	16	80	0.2000000
NODE_31240_length_553_cov_42.017621	197	277	12	3	80	0.0375000
NODE_31240_length_553_cov_42.017621	197	277	14	25	80	0.3125000
NODE_31240_length_553_cov_42.017621	250	330	10	2	80	0.0250000
NODE_31240_length_553_cov_42.017621	250	330	14	72	80	0.9000000
NODE_31240_length_553_cov_42.017621	250	330	16	6	80	0.0750000
NODE_31241_length_553_cov_28.944934	333	413	2	4	80	0.0500000
NODE_31241_length_553_cov_28.944934	333	413	4	76	80	0.9500000
NODE_31241_length_553_cov_28.944934	386	466	0	37	80	0.4625000
NODE_31241_length_553_cov_28.944934	386	466	2	20	80	0.2500000
NODE_31241_length_553_cov_28.944934	386	466	4	23	80	0.2875000
NODE_31242_length_553_cov_12.176211	242	322	0	28	80	0.3500000
NODE_31242_length_553_cov_12.176211	242	322	2	18	80	0.2250000
NODE_31242_length_553_cov_12.176211	242	322	5	5	80	0.0625000
NODE_31242_length_553_cov_12.176211	242	322	6	29	80	0.3625000
NODE_31242_length_553_cov_12.176211	295	375	0	6	80	0.0750000
NODE_31242_length_553_cov_12.176211	295	375	4	6	80	0.0750000
NODE_31242_length_553_cov_12.176211	295	375	6	68	80	0.8500000
NODE_31244_length_553_cov_9.876652	232	312	0	80	80	1.0000000
NODE_31244_length_553_cov_9.876652	285	365	0	58	80	0.7250000
NODE_31244_length_553_cov_9.876652	285	365	2	22	80	0.2750000
NODE_31246_length_553_cov_9.306167	207	287	0	71	80	0.8875000
NODE_31246_length_553_cov_9.306167	207	287	2	9	80	0.1125000
NODE_31246_length_553_cov_9.306167	207	287	0	71	80	0.8875000
NODE_31246_length_553_cov_9.306167	207	287	2	9	80	0.1125000
NODE_31246_length_553_cov_9.306167	260	340	0	18	80	0.2250000
NODE_31246_length_553_cov_9.306167	260	340	2	62	80	0.7750000
NODE_31259_length_553_cov_3.729075	36	93	7	44	57	0.7719298
NODE_31259_length_553_cov_3.729075	36	93	8	2	57	0.0350877
NODE_31259_length_553_cov_3.729075	36	93	9	11	57	0.1929825
NODE_31259_length_553_cov_3.729075	89	146	7	15	57	0.2631579
NODE_31259_length_553_cov_3.729075	89	146	9	42	57	0.7368421
NODE_31266_length_553_cov_3.310573	226	293	0	67	67	1.0000000
NODE_31279_length_553_cov_2.678414	102	180	0	78	78	1.0000000
NODE_31279_length_553_cov_2.678414	248	275	0	27	27	1.0000000
NODE_31295_length_553_cov_1.958150	416	462	6	1	46	0.0217391
NODE_31295_length_553_cov_1.958150	416	462	8	1	46	0.0217391
NODE_31295_length_553_cov_1.958150	416	462	10	1	46	0.0217391
NODE_31295_length_553_cov_1.958150	416	462	12	6	46	0.1304348
NODE_31295_length_553_cov_1.958150	416	462	14	3	46	0.0652174
NODE_31295_length_553_cov_1.958150	416	462	20	4	46	0.0869565
NODE_31295_length_553_cov_1.958150	416	462	22	3	46	0.0652174
NODE_31295_length_553_cov_1.958150	416	462	24	12	46	0.2608696
NODE_31295_length_553_cov_1.958150	416	462	26	3	46	0.0652174
NODE_31295_length_553_cov_1.958150	416	462	27	10	46	0.2173913
NODE_31295_length_553_cov_1.958150	416	462	28	2	46	0.0434783
NODE_31295_length_553_cov_1.958150	469	515	24	6	46	0.1304348
NODE_31295_length_553_cov_1.958150	469	515	26	40	46	0.8695652
NODE_31377_length_552_cov_92.070640	298	378	0	80	80	1.0000000
NODE_31377_length_552_cov_92.070640	298	378	0	80	80	1.0000000
NODE_31377_length_552_cov_92.070640	374	454	0	19	80	0.2375000
NODE_31377_length_552_cov_92.070640	374	454	15	12	80	0.1500000
NODE_31377_length_552_cov_92.070640	374	454	16	1	80	0.0125000
NODE_31377_length_552_cov_92.070640	374	454	24	1	80	0.0125000
NODE_31377_length_552_cov_92.070640	374	454	26	30	80	0.3750000
NODE_31377_length_552_cov_92.070640	374	454	27	17	80	0.2125000
NODE_31377_length_552_cov_92.070640	374	454	0	19	80	0.2375000
NODE_31377_length_552_cov_92.070640	374	454	15	12	80	0.1500000
NODE_31377_length_552_cov_92.070640	374	454	16	1	80	0.0125000
NODE_31377_length_552_cov_92.070640	374	454	24	1	80	0.0125000
NODE_31377_length_552_cov_92.070640	374	454	26	30	80	0.3750000
NODE_31377_length_552_cov_92.070640	374	454	27	17	80	0.2125000
NODE_31377_length_552_cov_92.070640	374	454	0	19	80	0.2375000
NODE_31377_length_552_cov_92.070640	374	454	15	12	80	0.1500000
NODE_31377_length_552_cov_92.070640	374	454	16	1	80	0.0125000
NODE_31377_length_552_cov_92.070640	374	454	24	1	80	0.0125000
NODE_31377_length_552_cov_92.070640	374	454	26	30	80	0.3750000
NODE_31377_length_552_cov_92.070640	374	454	27	17	80	0.2125000
NODE_31377_length_552_cov_92.070640	374	454	0	19	80	0.2375000
NODE_31377_length_552_cov_92.070640	374	454	15	12	80	0.1500000
NODE_31377_length_552_cov_92.070640	374	454	16	1	80	0.0125000
NODE_31377_length_552_cov_92.070640	374	454	24	1	80	0.0125000
NODE_31377_length_552_cov_92.070640	374	454	26	30	80	0.3750000
NODE_31377_length_552_cov_92.070640	374	454	27	17	80	0.2125000
NODE_31377_length_552_cov_92.070640	374	450	0	19	76	0.2500000
NODE_31377_length_552_cov_92.070640	374	450	15	12	76	0.1578947
NODE_31377_length_552_cov_92.070640	374	450	16	1	76	0.0131579
NODE_31377_length_552_cov_92.070640	374	450	24	1	76	0.0131579
NODE_31377_length_552_cov_92.070640	374	450	26	30	76	0.3947369
NODE_31377_length_552_cov_92.070640	374	450	27	13	76	0.1710526
NODE_31377_length_552_cov_92.070640	427	507	26	10	80	0.1250000
NODE_31377_length_552_cov_92.070640	427	507	27	50	80	0.6250000
NODE_31377_length_552_cov_92.070640	427	507	28	20	80	0.2500000
NODE_31377_length_552_cov_92.070640	427	507	26	10	80	0.1250000
NODE_31377_length_552_cov_92.070640	427	507	27	50	80	0.6250000
NODE_31377_length_552_cov_92.070640	427	507	28	20	80	0.2500000
NODE_31377_length_552_cov_92.070640	427	498	26	10	71	0.1408451
NODE_31377_length_552_cov_92.070640	427	498	27	50	71	0.7042254
NODE_31377_length_552_cov_92.070640	427	498	28	11	71	0.1549296
NODE_31377_length_552_cov_92.070640	430	500	26	7	70	0.1000000
NODE_31377_length_552_cov_92.070640	430	500	27	50	70	0.7142857
NODE_31377_length_552_cov_92.070640	430	500	28	13	70	0.1857143
NODE_31377_length_552_cov_92.070640	432	507	26	5	75	0.0666667
NODE_31377_length_552_cov_92.070640	432	507	27	50	75	0.6666667
NODE_31377_length_552_cov_92.070640	432	507	28	20	75	0.2666667
NODE_31378_length_552_cov_20.432671	151	231	6	16	80	0.2000000
NODE_31378_length_552_cov_20.432671	151	231	8	64	80	0.8000000
NODE_31378_length_552_cov_20.432671	204	284	0	26	80	0.3250000
NODE_31378_length_552_cov_20.432671	204	284	2	14	80	0.1750000
NODE_31378_length_552_cov_20.432671	204	284	8	40	80	0.5000000
NODE_31379_length_552_cov_18.075055	257	333	0	3	76	0.0394737
NODE_31379_length_552_cov_18.075055	257	333	1	1	76	0.0131579
NODE_31379_length_552_cov_18.075055	257	333	2	36	76	0.4736842
NODE_31379_length_552_cov_18.075055	257	333	4	36	76	0.4736842
NODE_31380_length_552_cov_13.331126	214	294	0	3	80	0.0375000
NODE_31380_length_552_cov_13.331126	214	294	2	77	80	0.9625000
NODE_31380_length_552_cov_13.331126	267	347	0	56	80	0.7000000
NODE_31380_length_552_cov_13.331126	267	347	2	24	80	0.3000000
NODE_31381_length_552_cov_12.774834	360	440	0	68	80	0.8500000
NODE_31381_length_552_cov_12.774834	360	440	2	12	80	0.1500000
NODE_31381_length_552_cov_12.774834	413	493	0	80	80	1.0000000
NODE_31384_length_552_cov_8.883002	310	390	0	15	80	0.1875000
NODE_31384_length_552_cov_8.883002	310	390	2	65	80	0.8125000
NODE_31384_length_552_cov_8.883002	363	443	0	68	80	0.8500000
NODE_31384_length_552_cov_8.883002	363	443	2	12	80	0.1500000
NODE_31385_length_552_cov_6.916115	206	281	0	5	75	0.0666667
NODE_31385_length_552_cov_6.916115	206	281	2	70	75	0.9333333
NODE_31538_length_551_cov_34.070796	324	406	0	82	82	1.0000000
NODE_31538_length_551_cov_34.070796	379	444	0	65	65	1.0000000
NODE_31541_length_551_cov_10.252212	164	244	0	80	80	1.0000000
NODE_31541_length_551_cov_10.252212	217	297	0	80	80	1.0000000
NODE_31543_length_551_cov_8.075221	363	406	0	43	43	1.0000000
NODE_31547_length_551_cov_5.668142	213	293	0	11	80	0.1375000
NODE_31547_length_551_cov_5.668142	213	293	2	69	80	0.8625000
NODE_31547_length_551_cov_5.668142	266	346	2	52	80	0.6500000
NODE_31547_length_551_cov_5.668142	266	346	4	28	80	0.3500000
NODE_31552_length_551_cov_4.212389	171	242	6	40	71	0.5633803
NODE_31552_length_551_cov_4.212389	171	242	8	27	71	0.3802817
NODE_31552_length_551_cov_4.212389	171	242	10	4	71	0.0563380
NODE_31552_length_551_cov_4.212389	215	263	2	7	48	0.1458333
NODE_31552_length_551_cov_4.212389	215	263	4	12	48	0.2500000
NODE_31552_length_551_cov_4.212389	215	263	6	29	48	0.6041667
NODE_31563_length_551_cov_3.307522	227	307	0	42	80	0.5250000
NODE_31563_length_551_cov_3.307522	227	307	2	38	80	0.4750000
NODE_31563_length_551_cov_3.307522	280	360	0	80	80	1.0000000
NODE_31693_length_550_cov_17.308204	101	181	0	63	80	0.7875000
NODE_31693_length_550_cov_17.308204	101	181	2	10	80	0.1250000
NODE_31693_length_550_cov_17.308204	101	181	4	7	80	0.0875000
NODE_31693_length_550_cov_17.308204	154	234	0	10	80	0.1250000
NODE_31693_length_550_cov_17.308204	154	234	2	10	80	0.1250000
NODE_31693_length_550_cov_17.308204	154	234	4	60	80	0.7500000
NODE_31700_length_550_cov_5.580931	286	329	0	43	43	1.0000000
NODE_31701_length_550_cov_5.490022	458	500	0	42	42	1.0000000
NODE_31701_length_550_cov_5.490022	459	523	0	64	64	1.0000000
NODE_31703_length_550_cov_5.243902	194	274	0	80	80	1.0000000
NODE_31703_length_550_cov_5.243902	247	327	0	80	80	1.0000000
NODE_31706_length_550_cov_4.815965	184	264	0	80	80	1.0000000
NODE_31726_length_550_cov_3.252772	308	388	12	3	80	0.0375000
NODE_31726_length_550_cov_3.252772	308	388	14	6	80	0.0750000
NODE_31726_length_550_cov_3.252772	308	388	16	24	80	0.3000000
NODE_31726_length_550_cov_3.252772	308	388	18	17	80	0.2125000
NODE_31726_length_550_cov_3.252772	308	388	20	7	80	0.0875000
NODE_31726_length_550_cov_3.252772	308	388	22	23	80	0.2875000
NODE_31756_length_550_cov_1.864745	189	259	2	22	70	0.3142857
NODE_31756_length_550_cov_1.864745	189	259	6	48	70	0.6857143
NODE_31756_length_550_cov_1.864745	189	258	2	21	69	0.3043478
NODE_31756_length_550_cov_1.864745	189	258	6	48	69	0.6956522
NODE_31847_length_549_cov_31.826667	216	292	26	1	76	0.0131579
NODE_31847_length_549_cov_31.826667	216	292	27	2	76	0.0263158
NODE_31847_length_549_cov_31.826667	216	292	28	2	76	0.0263158
NODE_31847_length_549_cov_31.826667	216	292	29	3	76	0.0394737
NODE_31847_length_549_cov_31.826667	216	292	30	2	76	0.0263158
NODE_31847_length_549_cov_31.826667	216	292	34	13	76	0.1710526
NODE_31847_length_549_cov_31.826667	216	292	36	24	76	0.3157895
NODE_31847_length_549_cov_31.826667	216	292	38	13	76	0.1710526
NODE_31847_length_549_cov_31.826667	216	292	40	16	76	0.2105263
NODE_31847_length_549_cov_31.826667	267	331	25	3	64	0.0468750
NODE_31847_length_549_cov_31.826667	267	331	28	3	64	0.0468750
NODE_31847_length_549_cov_31.826667	267	331	31	14	64	0.2187500
NODE_31847_length_549_cov_31.826667	267	331	33	13	64	0.2031250
NODE_31847_length_549_cov_31.826667	267	331	35	1	64	0.0156250
NODE_31847_length_549_cov_31.826667	267	331	36	4	64	0.0625000
NODE_31847_length_549_cov_31.826667	267	331	38	9	64	0.1406250
NODE_31847_length_549_cov_31.826667	267	331	40	17	64	0.2656250
NODE_31848_length_549_cov_14.124444	174	263	2	37	89	0.4157303
NODE_31848_length_549_cov_14.124444	174	263	4	52	89	0.5842696
NODE_31848_length_549_cov_14.124444	242	315	2	4	73	0.0547945
NODE_31848_length_549_cov_14.124444	242	315	4	69	73	0.9452055
NODE_31857_length_549_cov_5.375556	181	257	119	2	76	0.0263158
NODE_31857_length_549_cov_5.375556	181	257	121	3	76	0.0394737
NODE_31857_length_549_cov_5.375556	181	257	123	2	76	0.0263158
NODE_31857_length_549_cov_5.375556	181	257	127	1	76	0.0131579
NODE_31857_length_549_cov_5.375556	181	257	129	1	76	0.0131579
NODE_31857_length_549_cov_5.375556	181	257	131	1	76	0.0131579
NODE_31857_length_549_cov_5.375556	181	257	133	1	76	0.0131579
NODE_31857_length_549_cov_5.375556	181	257	135	4	76	0.0526316
NODE_31857_length_549_cov_5.375556	181	257	137	1	76	0.0131579
NODE_31857_length_549_cov_5.375556	181	257	139	1	76	0.0131579
NODE_31857_length_549_cov_5.375556	181	257	141	1	76	0.0131579
NODE_31857_length_549_cov_5.375556	181	257	143	1	76	0.0131579
NODE_31857_length_549_cov_5.375556	181	257	145	2	76	0.0263158
NODE_31857_length_549_cov_5.375556	181	257	147	2	76	0.0263158
NODE_31857_length_549_cov_5.375556	181	257	149	5	76	0.0657895
NODE_31857_length_549_cov_5.375556	181	257	151	1	76	0.0131579
NODE_31857_length_549_cov_5.375556	181	257	155	1	76	0.0131579
NODE_31857_length_549_cov_5.375556	181	257	156	1	76	0.0131579
NODE_31857_length_549_cov_5.375556	181	257	159	2	76	0.0263158
NODE_31857_length_549_cov_5.375556	181	257	161	1	76	0.0131579
NODE_31857_length_549_cov_5.375556	181	257	165	2	76	0.0263158
NODE_31857_length_549_cov_5.375556	181	257	168	1	76	0.0131579
NODE_31857_length_549_cov_5.375556	181	257	169	2	76	0.0263158
NODE_31857_length_549_cov_5.375556	181	257	170	1	76	0.0131579
NODE_31857_length_549_cov_5.375556	181	257	171	3	76	0.0394737
NODE_31857_length_549_cov_5.375556	181	257	174	2	76	0.0263158
NODE_31857_length_549_cov_5.375556	181	257	175	1	76	0.0131579
NODE_31857_length_549_cov_5.375556	181	257	176	1	76	0.0131579
NODE_31857_length_549_cov_5.375556	181	257	178	1	76	0.0131579
NODE_31857_length_549_cov_5.375556	181	257	180	5	76	0.0657895
NODE_31857_length_549_cov_5.375556	181	257	182	3	76	0.0394737
NODE_31857_length_549_cov_5.375556	181	257	184	1	76	0.0131579
NODE_31857_length_549_cov_5.375556	181	257	186	3	76	0.0394737
NODE_31857_length_549_cov_5.375556	181	257	187	2	76	0.0263158
NODE_31857_length_549_cov_5.375556	181	257	188	3	76	0.0394737
NODE_31857_length_549_cov_5.375556	181	257	189	2	76	0.0263158
NODE_31857_length_549_cov_5.375556	181	257	190	2	76	0.0263158
NODE_31857_length_549_cov_5.375556	181	257	193	3	76	0.0394737
NODE_31857_length_549_cov_5.375556	181	257	195	4	76	0.0526316
NODE_31859_length_549_cov_4.933333	260	340	4	80	80	1.0000000
NODE_31864_length_549_cov_4.537778	345	430	0	34	85	0.4000000
NODE_31864_length_549_cov_4.537778	345	430	2	51	85	0.6000000
NODE_31864_length_549_cov_4.537778	403	483	0	16	80	0.2000000
NODE_31864_length_549_cov_4.537778	403	483	2	64	80	0.8000000
NODE_31865_length_549_cov_4.124444	406	486	9	9	80	0.1125000
NODE_31865_length_549_cov_4.124444	406	486	11	2	80	0.0250000
NODE_31865_length_549_cov_4.124444	406	486	13	30	80	0.3750000
NODE_31865_length_549_cov_4.124444	406	486	15	39	80	0.4875000
NODE_31866_length_549_cov_3.931111	182	219	0	37	37	1.0000000
NODE_31868_length_549_cov_3.893333	287	367	0	80	80	1.0000000
NODE_31868_length_549_cov_3.893333	340	420	0	80	80	1.0000000
NODE_31887_length_549_cov_2.673333	282	343	0	49	61	0.8032787
NODE_31887_length_549_cov_2.673333	282	343	2	12	61	0.1967213
NODE_31890_length_549_cov_2.622222	144	220	0	16	76	0.2105263
NODE_31890_length_549_cov_2.622222	144	220	1	8	76	0.1052632
NODE_31890_length_549_cov_2.622222	144	220	2	52	76	0.6842105
NODE_32013_length_548_cov_13.962138	285	371	0	86	86	1.0000000
NODE_32013_length_548_cov_13.962138	344	424	0	80	80	1.0000000
NODE_32022_length_548_cov_4.683742	261	336	0	75	75	1.0000000
NODE_32023_length_548_cov_4.670379	140	182	0	37	42	0.8809524
NODE_32023_length_548_cov_4.670379	140	182	2	5	42	0.1190476
NODE_32023_length_548_cov_4.670379	282	311	2	16	29	0.5517241
NODE_32023_length_548_cov_4.670379	282	311	4	13	29	0.4482759
NODE_32023_length_548_cov_4.670379	410	455	2	1	45	0.0222222
NODE_32023_length_548_cov_4.670379	410	455	4	30	45	0.6666667
NODE_32023_length_548_cov_4.670379	410	455	8	6	45	0.1333333
NODE_32023_length_548_cov_4.670379	410	455	10	1	45	0.0222222
NODE_32023_length_548_cov_4.670379	410	455	12	7	45	0.1555556
NODE_32029_length_548_cov_3.630290	111	177	0	7	66	0.1060606
NODE_32029_length_548_cov_3.630290	111	177	2	59	66	0.8939394
NODE_32039_length_548_cov_3.080178	142	191	6	1	49	0.0204082
NODE_32039_length_548_cov_3.080178	142	191	8	48	49	0.9795918
NODE_32180_length_547_cov_23.982143	243	323	4	10	80	0.1250000
NODE_32180_length_547_cov_23.982143	243	323	5	8	80	0.1000000
NODE_32180_length_547_cov_23.982143	243	323	6	33	80	0.4125000
NODE_32180_length_547_cov_23.982143	243	323	7	29	80	0.3625000
NODE_32180_length_547_cov_23.982143	243	323	4	10	80	0.1250000
NODE_32180_length_547_cov_23.982143	243	323	5	8	80	0.1000000
NODE_32180_length_547_cov_23.982143	243	323	6	33	80	0.4125000
NODE_32180_length_547_cov_23.982143	243	323	7	29	80	0.3625000
NODE_32180_length_547_cov_23.982143	252	323	4	1	71	0.0140845
NODE_32180_length_547_cov_23.982143	252	323	5	8	71	0.1126761
NODE_32180_length_547_cov_23.982143	252	323	6	33	71	0.4647887
NODE_32180_length_547_cov_23.982143	252	323	7	29	71	0.4084507
NODE_32181_length_547_cov_23.555804	42	122	0	80	80	1.0000000
NODE_32181_length_547_cov_23.555804	95	175	0	80	80	1.0000000
NODE_32183_length_547_cov_12.819196	190	270	0	6	80	0.0750000
NODE_32183_length_547_cov_12.819196	190	270	4	29	80	0.3625000
NODE_32183_length_547_cov_12.819196	190	270	6	11	80	0.1375000
NODE_32183_length_547_cov_12.819196	190	270	8	33	80	0.4125000
NODE_32183_length_547_cov_12.819196	190	270	10	1	80	0.0125000
NODE_32195_length_547_cov_5.207589	290	370	0	52	80	0.6500000
NODE_32195_length_547_cov_5.207589	290	370	2	28	80	0.3500000
NODE_32195_length_547_cov_5.207589	343	423	0	41	80	0.5125000
NODE_32195_length_547_cov_5.207589	343	423	2	6	80	0.0750000
NODE_32195_length_547_cov_5.207589	343	423	4	10	80	0.1250000
NODE_32195_length_547_cov_5.207589	343	423	6	7	80	0.0875000
NODE_32195_length_547_cov_5.207589	343	423	10	16	80	0.2000000
NODE_32197_length_547_cov_4.975446	411	488	0	77	77	1.0000000
NODE_32197_length_547_cov_4.975446	461	542	0	81	81	1.0000000
NODE_32199_length_547_cov_4.683036	451	492	2	41	41	1.0000000
NODE_32204_length_547_cov_4.138393	97	175	0	2	78	0.0256410
NODE_32204_length_547_cov_4.138393	97	175	4	33	78	0.4230769
NODE_32204_length_547_cov_4.138393	97	175	6	43	78	0.5512820
NODE_32204_length_547_cov_4.138393	151	228	4	30	77	0.3896104
NODE_32204_length_547_cov_4.138393	151	228	6	47	77	0.6103896
NODE_32206_length_547_cov_4.026786	136	216	0	42	80	0.5250000
NODE_32206_length_547_cov_4.026786	136	216	2	38	80	0.4750000
NODE_32206_length_547_cov_4.026786	189	269	0	80	80	1.0000000
NODE_32215_length_547_cov_3.468750	219	299	0	80	80	1.0000000
NODE_32222_length_547_cov_2.901786	304	384	0	80	80	1.0000000
NODE_32347_length_546_cov_17.733781	159	239	0	7	80	0.0875000
NODE_32347_length_546_cov_17.733781	159	239	2	10	80	0.1250000
NODE_32347_length_546_cov_17.733781	159	239	4	31	80	0.3875000
NODE_32347_length_546_cov_17.733781	159	239	6	32	80	0.4000000
NODE_32347_length_546_cov_17.733781	212	293	0	10	81	0.1234568
NODE_32347_length_546_cov_17.733781	212	293	2	17	81	0.2098765
NODE_32347_length_546_cov_17.733781	212	293	4	25	81	0.3086420
NODE_32347_length_546_cov_17.733781	212	293	6	29	81	0.3580247
NODE_32348_length_546_cov_16.275168	272	352	0	67	80	0.8375000
NODE_32348_length_546_cov_16.275168	272	352	2	13	80	0.1625000
NODE_32348_length_546_cov_16.275168	325	405	0	14	80	0.1750000
NODE_32348_length_546_cov_16.275168	325	405	2	66	80	0.8250000
NODE_32349_length_546_cov_8.201342	179	259	3	13	80	0.1625000
NODE_32349_length_546_cov_8.201342	179	259	5	21	80	0.2625000
NODE_32349_length_546_cov_8.201342	179	259	6	1	80	0.0125000
NODE_32349_length_546_cov_8.201342	179	259	7	45	80	0.5625000
NODE_32351_length_546_cov_7.454139	241	321	0	80	80	1.0000000
NODE_32351_length_546_cov_7.454139	294	374	0	36	80	0.4500000
NODE_32351_length_546_cov_7.454139	294	374	2	44	80	0.5500000
NODE_32380_length_546_cov_3.192394	171	251	0	2	80	0.0250000
NODE_32380_length_546_cov_3.192394	171	251	1	6	80	0.0750000
NODE_32380_length_546_cov_3.192394	171	251	2	14	80	0.1750000
NODE_32380_length_546_cov_3.192394	171	251	6	58	80	0.7250000
NODE_32510_length_545_cov_31.524664	38	118	0	22	80	0.2750000
NODE_32510_length_545_cov_31.524664	38	118	4	58	80	0.7250000
NODE_32510_length_545_cov_31.524664	91	171	4	80	80	1.0000000
NODE_32517_length_545_cov_5.524664	268	348	0	80	80	1.0000000
NODE_32525_length_545_cov_3.885650	137	217	0	35	80	0.4375000
NODE_32525_length_545_cov_3.885650	137	217	4	35	80	0.4375000
NODE_32525_length_545_cov_3.885650	137	217	6	5	80	0.0625000
NODE_32525_length_545_cov_3.885650	137	217	8	5	80	0.0625000
NODE_32571_length_545_cov_2.013453	246	318	0	34	72	0.4722222
NODE_32571_length_545_cov_2.013453	246	318	2	38	72	0.5277778
NODE_32599_length_545_cov_1.450673	130	179	0	49	49	1.0000000
NODE_32616_length_545_cov_1.179372	431	469	0	38	38	1.0000000
NODE_32673_length_544_cov_37.705618	258	338	0	80	80	1.0000000
NODE_32673_length_544_cov_37.705618	311	391	0	80	80	1.0000000
NODE_32674_length_544_cov_33.847191	189	269	0	80	80	1.0000000
NODE_32674_length_544_cov_33.847191	242	327	0	85	85	1.0000000
NODE_32675_length_544_cov_19.467416	251	331	0	80	80	1.0000000
NODE_32675_length_544_cov_19.467416	304	384	0	80	80	1.0000000
NODE_32676_length_544_cov_16.775281	163	243	0	80	80	1.0000000
NODE_32676_length_544_cov_16.775281	216	296	0	80	80	1.0000000
NODE_32677_length_544_cov_8.943820	81	161	0	50	80	0.6250000
NODE_32677_length_544_cov_8.943820	81	161	4	30	80	0.3750000
NODE_32677_length_544_cov_8.943820	134	214	4	80	80	1.0000000
NODE_32678_length_544_cov_8.537079	283	363	0	28	80	0.3500000
NODE_32678_length_544_cov_8.537079	283	363	2	52	80	0.6500000
NODE_32678_length_544_cov_8.537079	336	416	0	80	80	1.0000000
NODE_32680_length_544_cov_8.440449	209	289	0	14	80	0.1750000
NODE_32680_length_544_cov_8.440449	209	289	2	66	80	0.8250000
NODE_32680_length_544_cov_8.440449	262	342	0	67	80	0.8375000
NODE_32680_length_544_cov_8.440449	262	342	2	13	80	0.1625000
NODE_32681_length_544_cov_7.604494	332	412	0	13	80	0.1625000
NODE_32681_length_544_cov_7.604494	332	412	2	67	80	0.8375000
NODE_32681_length_544_cov_7.604494	385	465	2	72	80	0.9000000
NODE_32681_length_544_cov_7.604494	385	465	4	8	80	0.1000000
NODE_32684_length_544_cov_6.000000	461	513	10	4	52	0.0769231
NODE_32684_length_544_cov_6.000000	461	513	12	22	52	0.4230769
NODE_32684_length_544_cov_6.000000	461	513	14	3	52	0.0576923
NODE_32684_length_544_cov_6.000000	461	513	20	23	52	0.4423077
NODE_32830_length_543_cov_38.790541	116	196	0	37	80	0.4625000
NODE_32830_length_543_cov_38.790541	116	196	2	32	80	0.4000000
NODE_32830_length_543_cov_38.790541	116	196	4	11	80	0.1375000
NODE_32830_length_543_cov_38.790541	169	249	2	24	80	0.3000000
NODE_32830_length_543_cov_38.790541	169	249	4	56	80	0.7000000
NODE_32831_length_543_cov_31.713964	193	273	0	44	80	0.5500000
NODE_32831_length_543_cov_31.713964	193	273	2	36	80	0.4500000
NODE_32831_length_543_cov_31.713964	246	326	0	12	80	0.1500000
NODE_32831_length_543_cov_31.713964	246	326	2	68	80	0.8500000
NODE_32832_length_543_cov_13.689189	118	198	0	80	80	1.0000000
NODE_32832_length_543_cov_13.689189	171	251	0	80	80	1.0000000
NODE_32833_length_543_cov_10.601351	271	351	1	11	80	0.1375000
NODE_32833_length_543_cov_10.601351	271	351	5	35	80	0.4375000
NODE_32833_length_543_cov_10.601351	271	351	6	34	80	0.4250000
NODE_32833_length_543_cov_10.601351	324	404	0	46	80	0.5750000
NODE_32833_length_543_cov_10.601351	324	404	1	18	80	0.2250000
NODE_32833_length_543_cov_10.601351	324	404	5	16	80	0.2000000
NODE_32833_length_543_cov_10.601351	400	480	0	80	80	1.0000000
NODE_32833_length_543_cov_10.601351	453	533	0	80	80	1.0000000
NODE_32834_length_543_cov_9.202703	291	341	0	50	50	1.0000000
NODE_32834_length_543_cov_9.202703	347	384	0	3	37	0.0810811
NODE_32834_length_543_cov_9.202703	347	384	2	34	37	0.9189189
NODE_32835_length_543_cov_7.722973	300	378	0	58	78	0.7435898
NODE_32835_length_543_cov_7.722973	300	378	2	20	78	0.2564103
NODE_32835_length_543_cov_7.722973	351	431	0	80	80	1.0000000
NODE_32836_length_543_cov_6.815315	181	260	0	79	79	1.0000000
NODE_32845_length_543_cov_4.704955	145	225	0	80	80	1.0000000
NODE_32845_length_543_cov_4.704955	198	275	0	77	77	1.0000000
NODE_32864_length_543_cov_3.301802	247	312	0	1	65	0.0153846
NODE_32864_length_543_cov_3.301802	247	312	2	64	65	0.9846154
NODE_32875_length_543_cov_2.635135	253	316	0	39	63	0.6190476
NODE_32875_length_543_cov_2.635135	253	316	1	17	63	0.2698413
NODE_32875_length_543_cov_2.635135	253	316	2	7	63	0.1111111
NODE_32875_length_543_cov_2.635135	293	373	1	16	80	0.2000000
NODE_32875_length_543_cov_2.635135	293	373	2	21	80	0.2625000
NODE_32875_length_543_cov_2.635135	293	373	4	1	80	0.0125000
NODE_32875_length_543_cov_2.635135	293	373	6	2	80	0.0250000
NODE_32875_length_543_cov_2.635135	293	373	10	1	80	0.0125000
NODE_32875_length_543_cov_2.635135	293	373	12	6	80	0.0750000
NODE_32875_length_543_cov_2.635135	293	373	14	17	80	0.2125000
NODE_32875_length_543_cov_2.635135	293	373	16	8	80	0.1000000
NODE_32875_length_543_cov_2.635135	293	373	18	8	80	0.1000000
NODE_33002_length_543_cov_0.682432	98	178	4	43	80	0.5375000
NODE_33002_length_543_cov_0.682432	98	178	8	19	80	0.2375000
NODE_33002_length_543_cov_0.682432	98	178	10	7	80	0.0875000
NODE_33002_length_543_cov_0.682432	98	178	12	11	80	0.1375000
NODE_33012_length_542_cov_57.370203	287	367	0	80	80	1.0000000
NODE_33012_length_542_cov_57.370203	340	378	0	38	38	1.0000000
NODE_33014_length_542_cov_11.616253	277	357	0	80	80	1.0000000
NODE_33014_length_542_cov_11.616253	330	410	0	80	80	1.0000000
NODE_33015_length_542_cov_9.988713	253	333	0	80	80	1.0000000
NODE_33015_length_542_cov_9.988713	306	386	0	80	80	1.0000000
NODE_33018_length_542_cov_7.934537	215	295	8	1	80	0.0125000
NODE_33018_length_542_cov_7.934537	215	295	10	79	80	0.9875000
NODE_33018_length_542_cov_7.934537	268	348	0	26	80	0.3250000
NODE_33018_length_542_cov_7.934537	268	348	6	4	80	0.0500000
NODE_33018_length_542_cov_7.934537	268	348	7	8	80	0.1000000
NODE_33018_length_542_cov_7.934537	268	348	8	16	80	0.2000000
NODE_33018_length_542_cov_7.934537	268	348	10	26	80	0.3250000
NODE_33020_length_542_cov_7.266366	159	239	0	80	80	1.0000000
NODE_33021_length_542_cov_7.069977	230	304	0	74	74	1.0000000
NODE_33021_length_542_cov_7.069977	284	362	0	78	78	1.0000000
NODE_33025_length_542_cov_4.783296	237	267	2	30	30	1.0000000
NODE_33035_length_542_cov_3.882619	275	303	0	28	28	1.0000000
NODE_33040_length_542_cov_3.600451	82	131	2	47	49	0.9591837
NODE_33040_length_542_cov_3.600451	82	131	4	2	49	0.0408163
NODE_33188_length_541_cov_22.463801	247	327	0	53	80	0.6625000
NODE_33188_length_541_cov_22.463801	247	327	2	27	80	0.3375000
NODE_33188_length_541_cov_22.463801	300	380	0	36	80	0.4500000
NODE_33188_length_541_cov_22.463801	300	380	2	44	80	0.5500000
NODE_33190_length_541_cov_11.070136	60	140	0	80	80	1.0000000
NODE_33190_length_541_cov_11.070136	113	193	0	80	80	1.0000000
NODE_33204_length_541_cov_3.690045	179	250	0	24	71	0.3380282
NODE_33204_length_541_cov_3.690045	179	250	2	7	71	0.0985916
NODE_33204_length_541_cov_3.690045	179	250	4	40	71	0.5633803
NODE_33300_length_541_cov_1.187783	352	400	0	48	48	1.0000000
NODE_33359_length_540_cov_78.353741	219	299	2	40	80	0.5000000
NODE_33359_length_540_cov_78.353741	219	299	4	40	80	0.5000000
NODE_33359_length_540_cov_78.353741	272	352	0	39	80	0.4875000
NODE_33359_length_540_cov_78.353741	272	352	2	41	80	0.5125000
NODE_33360_length_540_cov_33.473923	59	139	0	15	80	0.1875000
NODE_33360_length_540_cov_33.473923	59	139	2	33	80	0.4125000
NODE_33360_length_540_cov_33.473923	59	139	4	9	80	0.1125000
NODE_33360_length_540_cov_33.473923	59	139	8	23	80	0.2875000
NODE_33360_length_540_cov_33.473923	112	192	4	6	80	0.0750000
NODE_33360_length_540_cov_33.473923	112	192	6	8	80	0.1000000
NODE_33360_length_540_cov_33.473923	112	192	8	66	80	0.8250000
NODE_33361_length_540_cov_20.380952	97	177	4	25	80	0.3125000
NODE_33361_length_540_cov_20.380952	97	177	6	6	80	0.0750000
NODE_33361_length_540_cov_20.380952	97	177	7	1	80	0.0125000
NODE_33361_length_540_cov_20.380952	97	177	8	48	80	0.6000000
NODE_33361_length_540_cov_20.380952	150	230	0	18	80	0.2250000
NODE_33361_length_540_cov_20.380952	150	230	2	6	80	0.0750000
NODE_33361_length_540_cov_20.380952	150	230	6	30	80	0.3750000
NODE_33361_length_540_cov_20.380952	150	230	7	1	80	0.0125000
NODE_33361_length_540_cov_20.380952	150	230	8	25	80	0.3125000
NODE_33362_length_540_cov_12.657596	248	328	0	80	80	1.0000000
NODE_33362_length_540_cov_12.657596	301	381	0	80	80	1.0000000
NODE_33363_length_540_cov_11.111111	180	260	0	80	80	1.0000000
NODE_33363_length_540_cov_11.111111	233	313	0	80	80	1.0000000
NODE_33365_length_540_cov_6.328798	260	340	0	56	80	0.7000000
NODE_33365_length_540_cov_6.328798	260	340	2	24	80	0.3000000
NODE_33365_length_540_cov_6.328798	313	393	0	80	80	1.0000000
NODE_33382_length_540_cov_3.587302	351	411	0	60	60	1.0000000
NODE_33503_length_539_cov_1023.604545	264	344	255	1	80	0.0125000
NODE_33503_length_539_cov_1023.604545	264	344	259	1	80	0.0125000
NODE_33503_length_539_cov_1023.604545	264	344	269	1	80	0.0125000
NODE_33503_length_539_cov_1023.604545	264	344	273	1	80	0.0125000
NODE_33503_length_539_cov_1023.604545	264	344	274	1	80	0.0125000
NODE_33503_length_539_cov_1023.604545	264	344	275	1	80	0.0125000
NODE_33503_length_539_cov_1023.604545	264	344	278	1	80	0.0125000
NODE_33503_length_539_cov_1023.604545	264	344	298	2	80	0.0250000
NODE_33503_length_539_cov_1023.604545	264	344	310	1	80	0.0125000
NODE_33503_length_539_cov_1023.604545	264	344	319	1	80	0.0125000
NODE_33503_length_539_cov_1023.604545	264	344	327	1	80	0.0125000
NODE_33503_length_539_cov_1023.604545	264	344	328	1	80	0.0125000
NODE_33503_length_539_cov_1023.604545	264	344	342	1	80	0.0125000
NODE_33503_length_539_cov_1023.604545	264	344	343	1	80	0.0125000
NODE_33503_length_539_cov_1023.604545	264	344	346	1	80	0.0125000
NODE_33503_length_539_cov_1023.604545	264	344	360	1	80	0.0125000
NODE_33503_length_539_cov_1023.604545	264	344	369	1	80	0.0125000
NODE_33503_length_539_cov_1023.604545	264	344	376	1	80	0.0125000
NODE_33503_length_539_cov_1023.604545	264	344	382	1	80	0.0125000
NODE_33503_length_539_cov_1023.604545	264	344	384	1	80	0.0125000
NODE_33503_length_539_cov_1023.604545	264	344	392	1	80	0.0125000
NODE_33503_length_539_cov_1023.604545	264	344	408	1	80	0.0125000
NODE_33503_length_539_cov_1023.604545	264	344	422	1	80	0.0125000
NODE_33503_length_539_cov_1023.604545	264	344	447	1	80	0.0125000
NODE_33503_length_539_cov_1023.604545	264	344	451	1	80	0.0125000
NODE_33503_length_539_cov_1023.604545	264	344	464	1	80	0.0125000
NODE_33503_length_539_cov_1023.604545	264	344	487	1	80	0.0125000
NODE_33503_length_539_cov_1023.604545	264	344	488	1	80	0.0125000
NODE_33503_length_539_cov_1023.604545	264	344	511	1	80	0.0125000
NODE_33503_length_539_cov_1023.604545	264	344	522	1	80	0.0125000
NODE_33503_length_539_cov_1023.604545	264	344	533	1	80	0.0125000
NODE_33503_length_539_cov_1023.604545	264	344	561	1	80	0.0125000
NODE_33503_length_539_cov_1023.604545	264	344	569	1	80	0.0125000
NODE_33503_length_539_cov_1023.604545	264	344	573	1	80	0.0125000
NODE_33503_length_539_cov_1023.604545	264	344	574	1	80	0.0125000
NODE_33503_length_539_cov_1023.604545	264	344	600	1	80	0.0125000
NODE_33503_length_539_cov_1023.604545	264	344	639	1	80	0.0125000
NODE_33503_length_539_cov_1023.604545	264	344	646	1	80	0.0125000
NODE_33503_length_539_cov_1023.604545	264	344	667	1	80	0.0125000
NODE_33503_length_539_cov_1023.604545	264	344	695	1	80	0.0125000
NODE_33503_length_539_cov_1023.604545	264	344	704	1	80	0.0125000
NODE_33503_length_539_cov_1023.604545	264	344	713	1	80	0.0125000
NODE_33503_length_539_cov_1023.604545	264	344	725	1	80	0.0125000
NODE_33503_length_539_cov_1023.604545	264	344	728	1	80	0.0125000
NODE_33503_length_539_cov_1023.604545	264	344	731	1	80	0.0125000
NODE_33503_length_539_cov_1023.604545	264	344	741	1	80	0.0125000
NODE_33503_length_539_cov_1023.604545	264	344	745	1	80	0.0125000
NODE_33503_length_539_cov_1023.604545	264	344	761	1	80	0.0125000
NODE_33503_length_539_cov_1023.604545	264	344	769	1	80	0.0125000
NODE_33503_length_539_cov_1023.604545	264	344	777	1	80	0.0125000
NODE_33503_length_539_cov_1023.604545	264	344	784	1	80	0.0125000
NODE_33503_length_539_cov_1023.604545	264	344	808	1	80	0.0125000
NODE_33503_length_539_cov_1023.604545	264	344	810	2	80	0.0250000
NODE_33503_length_539_cov_1023.604545	264	344	817	1	80	0.0125000
NODE_33503_length_539_cov_1023.604545	264	344	822	1	80	0.0125000
NODE_33503_length_539_cov_1023.604545	264	344	829	1	80	0.0125000
NODE_33503_length_539_cov_1023.604545	264	344	859	1	80	0.0125000
NODE_33503_length_539_cov_1023.604545	264	344	863	1	80	0.0125000
NODE_33503_length_539_cov_1023.604545	264	344	867	1	80	0.0125000
NODE_33503_length_539_cov_1023.604545	264	344	880	1	80	0.0125000
NODE_33503_length_539_cov_1023.604545	264	344	883	1	80	0.0125000
NODE_33503_length_539_cov_1023.604545	264	344	902	1	80	0.0125000
NODE_33503_length_539_cov_1023.604545	264	344	911	1	80	0.0125000
NODE_33503_length_539_cov_1023.604545	264	344	921	1	80	0.0125000
NODE_33503_length_539_cov_1023.604545	264	344	929	1	80	0.0125000
NODE_33503_length_539_cov_1023.604545	264	344	959	1	80	0.0125000
NODE_33503_length_539_cov_1023.604545	264	344	967	1	80	0.0125000
NODE_33503_length_539_cov_1023.604545	264	344	968	1	80	0.0125000
NODE_33503_length_539_cov_1023.604545	264	344	991	1	80	0.0125000
NODE_33503_length_539_cov_1023.604545	264	344	1002	1	80	0.0125000
NODE_33503_length_539_cov_1023.604545	264	344	1016	1	80	0.0125000
NODE_33503_length_539_cov_1023.604545	264	344	1021	1	80	0.0125000
NODE_33503_length_539_cov_1023.604545	264	344	1029	1	80	0.0125000
NODE_33503_length_539_cov_1023.604545	264	344	1043	1	80	0.0125000
NODE_33503_length_539_cov_1023.604545	264	344	1058	1	80	0.0125000
NODE_33503_length_539_cov_1023.604545	264	344	1075	1	80	0.0125000
NODE_33503_length_539_cov_1023.604545	264	344	1081	1	80	0.0125000
NODE_33503_length_539_cov_1023.604545	264	344	1082	1	80	0.0125000
NODE_33503_length_539_cov_1023.604545	317	397	808	1	80	0.0125000
NODE_33503_length_539_cov_1023.604545	317	397	810	1	80	0.0125000
NODE_33503_length_539_cov_1023.604545	317	397	817	1	80	0.0125000
NODE_33503_length_539_cov_1023.604545	317	397	822	1	80	0.0125000
NODE_33503_length_539_cov_1023.604545	317	397	829	1	80	0.0125000
NODE_33503_length_539_cov_1023.604545	317	397	859	1	80	0.0125000
NODE_33503_length_539_cov_1023.604545	317	397	863	1	80	0.0125000
NODE_33503_length_539_cov_1023.604545	317	397	867	1	80	0.0125000
NODE_33503_length_539_cov_1023.604545	317	397	880	1	80	0.0125000
NODE_33503_length_539_cov_1023.604545	317	397	883	1	80	0.0125000
NODE_33503_length_539_cov_1023.604545	317	397	902	1	80	0.0125000
NODE_33503_length_539_cov_1023.604545	317	397	911	1	80	0.0125000
NODE_33503_length_539_cov_1023.604545	317	397	921	1	80	0.0125000
NODE_33503_length_539_cov_1023.604545	317	397	929	1	80	0.0125000
NODE_33503_length_539_cov_1023.604545	317	397	959	1	80	0.0125000
NODE_33503_length_539_cov_1023.604545	317	397	967	1	80	0.0125000
NODE_33503_length_539_cov_1023.604545	317	397	968	1	80	0.0125000
NODE_33503_length_539_cov_1023.604545	317	397	991	1	80	0.0125000
NODE_33503_length_539_cov_1023.604545	317	397	1002	1	80	0.0125000
NODE_33503_length_539_cov_1023.604545	317	397	1016	1	80	0.0125000
NODE_33503_length_539_cov_1023.604545	317	397	1021	1	80	0.0125000
NODE_33503_length_539_cov_1023.604545	317	397	1029	1	80	0.0125000
NODE_33503_length_539_cov_1023.604545	317	397	1043	1	80	0.0125000
NODE_33503_length_539_cov_1023.604545	317	397	1058	1	80	0.0125000
NODE_33503_length_539_cov_1023.604545	317	397	1075	1	80	0.0125000
NODE_33503_length_539_cov_1023.604545	317	397	1078	1	80	0.0125000
NODE_33503_length_539_cov_1023.604545	317	397	1081	2	80	0.0250000
NODE_33503_length_539_cov_1023.604545	317	397	1082	1	80	0.0125000
NODE_33503_length_539_cov_1023.604545	317	397	1088	1	80	0.0125000
NODE_33503_length_539_cov_1023.604545	317	397	1092	1	80	0.0125000
NODE_33503_length_539_cov_1023.604545	317	397	1095	1	80	0.0125000
NODE_33503_length_539_cov_1023.604545	317	397	1104	1	80	0.0125000
NODE_33503_length_539_cov_1023.604545	317	397	1106	1	80	0.0125000
NODE_33503_length_539_cov_1023.604545	317	397	1120	1	80	0.0125000
NODE_33503_length_539_cov_1023.604545	317	397	1135	1	80	0.0125000
NODE_33503_length_539_cov_1023.604545	317	397	1150	1	80	0.0125000
NODE_33503_length_539_cov_1023.604545	317	397	1154	1	80	0.0125000
NODE_33503_length_539_cov_1023.604545	317	397	1158	1	80	0.0125000
NODE_33503_length_539_cov_1023.604545	317	397	1165	1	80	0.0125000
NODE_33503_length_539_cov_1023.604545	317	397	1168	1	80	0.0125000
NODE_33503_length_539_cov_1023.604545	317	397	1170	1	80	0.0125000
NODE_33503_length_539_cov_1023.604545	317	397	1171	3	80	0.0375000
NODE_33503_length_539_cov_1023.604545	317	397	1172	1	80	0.0125000
NODE_33503_length_539_cov_1023.604545	317	397	1173	2	80	0.0250000
NODE_33503_length_539_cov_1023.604545	317	397	1174	1	80	0.0125000
NODE_33503_length_539_cov_1023.604545	317	397	1175	2	80	0.0250000
NODE_33503_length_539_cov_1023.604545	317	397	1176	1	80	0.0125000
NODE_33503_length_539_cov_1023.604545	317	397	1177	1	80	0.0125000
NODE_33503_length_539_cov_1023.604545	317	397	1178	1	80	0.0125000
NODE_33503_length_539_cov_1023.604545	317	397	1180	1	80	0.0125000
NODE_33503_length_539_cov_1023.604545	317	397	1183	1	80	0.0125000
NODE_33503_length_539_cov_1023.604545	317	397	1184	1	80	0.0125000
NODE_33503_length_539_cov_1023.604545	317	397	1185	1	80	0.0125000
NODE_33503_length_539_cov_1023.604545	317	397	1186	3	80	0.0375000
NODE_33503_length_539_cov_1023.604545	317	397	1188	1	80	0.0125000
NODE_33503_length_539_cov_1023.604545	317	397	1189	1	80	0.0125000
NODE_33503_length_539_cov_1023.604545	317	397	1190	1	80	0.0125000
NODE_33503_length_539_cov_1023.604545	317	397	1191	3	80	0.0375000
NODE_33503_length_539_cov_1023.604545	317	397	1192	2	80	0.0250000
NODE_33503_length_539_cov_1023.604545	317	397	1193	1	80	0.0125000
NODE_33503_length_539_cov_1023.604545	317	397	1196	1	80	0.0125000
NODE_33503_length_539_cov_1023.604545	317	397	1198	1	80	0.0125000
NODE_33503_length_539_cov_1023.604545	317	397	1200	1	80	0.0125000
NODE_33503_length_539_cov_1023.604545	317	397	1203	1	80	0.0125000
NODE_33503_length_539_cov_1023.604545	317	397	1204	1	80	0.0125000
NODE_33503_length_539_cov_1023.604545	317	397	1207	3	80	0.0375000
NODE_33503_length_539_cov_1023.604545	317	397	1208	1	80	0.0125000
NODE_33503_length_539_cov_1023.604545	317	397	1209	1	80	0.0125000
NODE_33504_length_539_cov_99.579545	478	539	0	61	61	1.0000000
NODE_33505_length_539_cov_15.247727	217	297	0	80	80	1.0000000
NODE_33505_length_539_cov_15.247727	270	350	0	80	80	1.0000000
NODE_33506_length_539_cov_14.172727	278	350	0	72	72	1.0000000
NODE_33507_length_539_cov_13.154545	118	198	0	9	80	0.1125000
NODE_33507_length_539_cov_13.154545	118	198	2	24	80	0.3000000
NODE_33507_length_539_cov_13.154545	118	198	4	35	80	0.4375000
NODE_33507_length_539_cov_13.154545	118	198	6	12	80	0.1500000
NODE_33507_length_539_cov_13.154545	171	251	4	55	80	0.6875000
NODE_33507_length_539_cov_13.154545	171	251	6	25	80	0.3125000
NODE_33508_length_539_cov_10.811364	48	128	2	35	80	0.4375000
NODE_33508_length_539_cov_10.811364	48	128	4	45	80	0.5625000
NODE_33508_length_539_cov_10.811364	101	181	0	16	80	0.2000000
NODE_33508_length_539_cov_10.811364	101	181	2	46	80	0.5750000
NODE_33508_length_539_cov_10.811364	101	181	4	18	80	0.2250000
NODE_33509_length_539_cov_9.563636	201	277	2	21	76	0.2763158
NODE_33509_length_539_cov_9.563636	201	277	8	3	76	0.0394737
NODE_33509_length_539_cov_9.563636	201	277	12	18	76	0.2368421
NODE_33509_length_539_cov_9.563636	201	277	14	1	76	0.0131579
NODE_33509_length_539_cov_9.563636	201	277	16	33	76	0.4342105
NODE_33510_length_539_cov_7.934091	311	369	12	4	58	0.0689655
NODE_33510_length_539_cov_7.934091	311	369	14	54	58	0.9310345
NODE_33510_length_539_cov_7.934091	342	422	0	5	80	0.0625000
NODE_33510_length_539_cov_7.934091	342	422	2	1	80	0.0125000
NODE_33510_length_539_cov_7.934091	342	422	6	18	80	0.2250000
NODE_33510_length_539_cov_7.934091	342	422	7	6	80	0.0750000
NODE_33510_length_539_cov_7.934091	342	422	8	8	80	0.1000000
NODE_33510_length_539_cov_7.934091	342	422	10	1	80	0.0125000
NODE_33510_length_539_cov_7.934091	342	422	14	41	80	0.5125000
NODE_33517_length_539_cov_5.740909	251	319	0	68	68	1.0000000
NODE_33517_length_539_cov_5.740909	301	372	0	71	71	1.0000000
NODE_33533_length_539_cov_3.627273	80	157	0	77	77	1.0000000
NODE_33533_length_539_cov_3.627273	130	175	0	45	45	1.0000000
NODE_33569_length_539_cov_2.143182	325	371	0	46	46	1.0000000
NODE_33595_length_539_cov_1.618182	408	456	2	48	48	1.0000000
NODE_33623_length_539_cov_1.129545	97	134	0	37	37	1.0000000
NODE_33669_length_538_cov_23.193622	171	256	0	10	85	0.1176471
NODE_33669_length_538_cov_23.193622	171	256	2	75	85	0.8823529
NODE_33669_length_538_cov_23.193622	225	305	0	57	80	0.7125000
NODE_33669_length_538_cov_23.193622	225	305	1	2	80	0.0250000
NODE_33669_length_538_cov_23.193622	225	305	2	21	80	0.2625000
NODE_33672_length_538_cov_7.378132	145	225	0	13	80	0.1625000
NODE_33672_length_538_cov_7.378132	145	225	3	1	80	0.0125000
NODE_33672_length_538_cov_7.378132	145	225	4	66	80	0.8250000
NODE_33672_length_538_cov_7.378132	198	278	4	52	80	0.6500000
NODE_33672_length_538_cov_7.378132	198	278	6	16	80	0.2000000
NODE_33672_length_538_cov_7.378132	198	278	8	6	80	0.0750000
NODE_33672_length_538_cov_7.378132	198	278	10	6	80	0.0750000
NODE_33683_length_538_cov_4.496583	277	357	0	6	80	0.0750000
NODE_33683_length_538_cov_4.496583	277	357	2	22	80	0.2750000
NODE_33683_length_538_cov_4.496583	277	357	4	52	80	0.6500000
NODE_33683_length_538_cov_4.496583	330	410	2	8	80	0.1000000
NODE_33683_length_538_cov_4.496583	330	410	4	72	80	0.9000000
NODE_33687_length_538_cov_3.753986	251	309	2	58	58	1.0000000
NODE_33713_length_538_cov_2.239180	256	338	4	52	82	0.6341463
NODE_33713_length_538_cov_2.239180	256	338	6	29	82	0.3536585
NODE_33713_length_538_cov_2.239180	256	338	8	1	82	0.0121951
NODE_33814_length_538_cov_0.822323	397	477	0	14	80	0.1750000
NODE_33814_length_538_cov_0.822323	397	477	2	66	80	0.8250000
NODE_33852_length_537_cov_13.031963	258	309	0	51	51	1.0000000
NODE_33854_length_537_cov_9.552511	198	278	1	80	80	1.0000000
NODE_33854_length_537_cov_9.552511	251	332	0	46	81	0.5679013
NODE_33854_length_537_cov_9.552511	251	332	1	35	81	0.4320988
NODE_33960_length_537_cov_1.244292	107	187	10	2	80	0.0250000
NODE_33960_length_537_cov_1.244292	107	187	11	5	80	0.0625000
NODE_33960_length_537_cov_1.244292	107	187	13	1	80	0.0125000
NODE_33960_length_537_cov_1.244292	107	187	17	1	80	0.0125000
NODE_33960_length_537_cov_1.244292	107	187	19	11	80	0.1375000
NODE_33960_length_537_cov_1.244292	107	187	20	2	80	0.0250000
NODE_33960_length_537_cov_1.244292	107	187	24	2	80	0.0250000
NODE_33960_length_537_cov_1.244292	107	187	27	2	80	0.0250000
NODE_33960_length_537_cov_1.244292	107	187	29	2	80	0.0250000
NODE_33960_length_537_cov_1.244292	107	187	31	1	80	0.0125000
NODE_33960_length_537_cov_1.244292	107	187	33	1	80	0.0125000
NODE_33960_length_537_cov_1.244292	107	187	39	3	80	0.0375000
NODE_33960_length_537_cov_1.244292	107	187	40	1	80	0.0125000
NODE_33960_length_537_cov_1.244292	107	187	43	2	80	0.0250000
NODE_33960_length_537_cov_1.244292	107	187	44	5	80	0.0625000
NODE_33960_length_537_cov_1.244292	107	187	46	1	80	0.0125000
NODE_33960_length_537_cov_1.244292	107	187	48	1	80	0.0125000
NODE_33960_length_537_cov_1.244292	107	187	50	2	80	0.0250000
NODE_33960_length_537_cov_1.244292	107	187	54	1	80	0.0125000
NODE_33960_length_537_cov_1.244292	107	187	56	3	80	0.0375000
NODE_33960_length_537_cov_1.244292	107	187	58	3	80	0.0375000
NODE_33960_length_537_cov_1.244292	107	187	60	2	80	0.0250000
NODE_33960_length_537_cov_1.244292	107	187	62	3	80	0.0375000
NODE_33960_length_537_cov_1.244292	107	187	66	4	80	0.0500000
NODE_33960_length_537_cov_1.244292	107	187	68	3	80	0.0375000
NODE_33960_length_537_cov_1.244292	107	187	70	6	80	0.0750000
NODE_33960_length_537_cov_1.244292	107	187	72	2	80	0.0250000
NODE_33960_length_537_cov_1.244292	107	187	74	1	80	0.0125000
NODE_33960_length_537_cov_1.244292	107	187	76	1	80	0.0125000
NODE_33960_length_537_cov_1.244292	107	187	80	1	80	0.0125000
NODE_33960_length_537_cov_1.244292	107	187	82	3	80	0.0375000
NODE_33960_length_537_cov_1.244292	107	187	84	1	80	0.0125000
NODE_33960_length_537_cov_1.244292	107	187	86	1	80	0.0125000
NODE_34029_length_536_cov_87.622426	430	462	92	1	32	0.0312500
NODE_34029_length_536_cov_87.622426	430	462	94	1	32	0.0312500
NODE_34029_length_536_cov_87.622426	430	462	95	1	32	0.0312500
NODE_34029_length_536_cov_87.622426	430	462	97	1	32	0.0312500
NODE_34029_length_536_cov_87.622426	430	462	99	10	32	0.3125000
NODE_34029_length_536_cov_87.622426	430	462	101	2	32	0.0625000
NODE_34029_length_536_cov_87.622426	430	462	103	1	32	0.0312500
NODE_34029_length_536_cov_87.622426	430	462	107	3	32	0.0937500
NODE_34029_length_536_cov_87.622426	430	462	109	2	32	0.0625000
NODE_34029_length_536_cov_87.622426	430	462	111	2	32	0.0625000
NODE_34029_length_536_cov_87.622426	430	462	113	1	32	0.0312500
NODE_34029_length_536_cov_87.622426	430	462	114	1	32	0.0312500
NODE_34029_length_536_cov_87.622426	430	462	115	5	32	0.1562500
NODE_34029_length_536_cov_87.622426	430	462	119	1	32	0.0312500
NODE_34030_length_536_cov_11.629291	119	199	2	3	80	0.0375000
NODE_34030_length_536_cov_11.629291	119	199	5	1	80	0.0125000
NODE_34030_length_536_cov_11.629291	119	199	6	76	80	0.9500000
NODE_34030_length_536_cov_11.629291	172	252	0	36	80	0.4500000
NODE_34030_length_536_cov_11.629291	172	252	5	7	80	0.0875000
NODE_34030_length_536_cov_11.629291	172	252	6	37	80	0.4625000
NODE_34032_length_536_cov_6.613272	286	372	0	69	86	0.8023256
NODE_34032_length_536_cov_6.613272	286	372	2	17	86	0.1976744
NODE_34035_length_536_cov_5.810069	191	271	0	80	80	1.0000000
NODE_34035_length_536_cov_5.810069	244	324	0	34	80	0.4250000
NODE_34035_length_536_cov_5.810069	244	324	2	46	80	0.5750000
NODE_34035_length_536_cov_5.810069	374	404	0	30	30	1.0000000
NODE_34039_length_536_cov_4.729977	202	245	0	43	43	1.0000000
NODE_34057_length_536_cov_3.297483	86	126	0	40	40	1.0000000
NODE_34068_length_536_cov_2.796339	223	280	0	53	57	0.9298246
NODE_34068_length_536_cov_2.796339	223	280	2	4	57	0.0701754
NODE_34094_length_536_cov_1.956522	181	230	40	1	49	0.0204082
NODE_34094_length_536_cov_1.956522	181	230	44	1	49	0.0204082
NODE_34094_length_536_cov_1.956522	181	230	48	9	49	0.1836735
NODE_34094_length_536_cov_1.956522	181	230	50	7	49	0.1428571
NODE_34094_length_536_cov_1.956522	181	230	52	4	49	0.0816327
NODE_34094_length_536_cov_1.956522	181	230	54	10	49	0.2040816
NODE_34094_length_536_cov_1.956522	181	230	55	9	49	0.1836735
NODE_34094_length_536_cov_1.956522	181	230	57	3	49	0.0612245
NODE_34094_length_536_cov_1.956522	181	230	59	3	49	0.0612245
NODE_34094_length_536_cov_1.956522	181	230	61	2	49	0.0408163
NODE_34095_length_536_cov_1.951945	203	284	4	5	81	0.0617284
NODE_34095_length_536_cov_1.951945	203	284	6	13	81	0.1604938
NODE_34095_length_536_cov_1.951945	203	284	8	17	81	0.2098765
NODE_34095_length_536_cov_1.951945	203	284	10	2	81	0.0246914
NODE_34095_length_536_cov_1.951945	203	284	12	32	81	0.3950617
NODE_34095_length_536_cov_1.951945	203	284	14	12	81	0.1481481
NODE_34095_length_536_cov_1.951945	306	368	0	11	62	0.1774193
NODE_34095_length_536_cov_1.951945	306	368	2	28	62	0.4516129
NODE_34095_length_536_cov_1.951945	306	368	4	23	62	0.3709677
NODE_34209_length_535_cov_32.277523	158	238	0	80	80	1.0000000
NODE_34209_length_535_cov_32.277523	211	291	0	38	80	0.4750000
NODE_34209_length_535_cov_32.277523	211	291	6	42	80	0.5250000
NODE_34215_length_535_cov_5.910550	110	162	4	11	52	0.2115385
NODE_34215_length_535_cov_5.910550	110	162	8	3	52	0.0576923
NODE_34215_length_535_cov_5.910550	110	162	10	38	52	0.7307692
NODE_34229_length_535_cov_3.795872	217	297	10	7	80	0.0875000
NODE_34229_length_535_cov_3.795872	217	297	12	28	80	0.3500000
NODE_34229_length_535_cov_3.795872	217	297	14	2	80	0.0250000
NODE_34229_length_535_cov_3.795872	217	297	15	8	80	0.1000000
NODE_34229_length_535_cov_3.795872	217	297	16	35	80	0.4375000
NODE_34375_length_534_cov_54.331034	435	498	0	58	63	0.9206349
NODE_34375_length_534_cov_54.331034	435	498	10	1	63	0.0158730
NODE_34375_length_534_cov_54.331034	435	498	43	2	63	0.0317460
NODE_34375_length_534_cov_54.331034	435	498	44	1	63	0.0158730
NODE_34375_length_534_cov_54.331034	435	498	46	1	63	0.0158730
NODE_34375_length_534_cov_54.331034	471	534	0	63	63	1.0000000
NODE_34377_length_534_cov_15.462069	460	534	0	74	74	1.0000000
NODE_34377_length_534_cov_15.462069	512	534	0	22	22	1.0000000
NODE_34378_length_534_cov_10.308046	268	348	0	80	80	1.0000000
NODE_34378_length_534_cov_10.308046	321	401	0	78	80	0.9750000
NODE_34378_length_534_cov_10.308046	321	401	2	2	80	0.0250000
NODE_34380_length_534_cov_9.041379	204	284	0	42	80	0.5250000
NODE_34380_length_534_cov_9.041379	204	284	2	38	80	0.4750000
NODE_34380_length_534_cov_9.041379	257	332	0	6	75	0.0800000
NODE_34380_length_534_cov_9.041379	257	332	2	69	75	0.9200000
NODE_34383_length_534_cov_6.958621	273	303	2	30	30	1.0000000
NODE_34392_length_534_cov_5.022989	291	371	2	25	80	0.3125000
NODE_34392_length_534_cov_5.022989	291	371	4	12	80	0.1500000
NODE_34392_length_534_cov_5.022989	291	371	6	13	80	0.1625000
NODE_34392_length_534_cov_5.022989	291	371	8	13	80	0.1625000
NODE_34392_length_534_cov_5.022989	291	371	12	1	80	0.0125000
NODE_34392_length_534_cov_5.022989	291	371	13	16	80	0.2000000
NODE_34402_length_534_cov_3.873563	110	190	2	39	80	0.4875000
NODE_34402_length_534_cov_3.873563	110	190	4	41	80	0.5125000
NODE_34409_length_534_cov_3.202299	221	301	0	1	80	0.0125000
NODE_34409_length_534_cov_3.202299	221	301	2	17	80	0.2125000
NODE_34409_length_534_cov_3.202299	221	301	6	36	80	0.4500000
NODE_34409_length_534_cov_3.202299	221	301	8	26	80	0.3250000
NODE_34411_length_534_cov_3.158621	171	200	0	6	29	0.2068966
NODE_34411_length_534_cov_3.158621	171	200	2	23	29	0.7931035
NODE_34418_length_534_cov_3.002299	175	219	0	44	44	1.0000000
NODE_34489_length_534_cov_1.344828	475	518	2	43	43	1.0000000
NODE_34494_length_534_cov_1.291954	273	336	10	3	63	0.0476190
NODE_34494_length_534_cov_1.291954	273	336	12	39	63	0.6190476
NODE_34494_length_534_cov_1.291954	273	336	14	21	63	0.3333333
NODE_34511_length_534_cov_1.160920	227	264	4	12	37	0.3243243
NODE_34511_length_534_cov_1.160920	227	264	10	21	37	0.5675676
NODE_34511_length_534_cov_1.160920	227	264	14	4	37	0.1081081
NODE_34570_length_533_cov_13.956221	216	296	0	19	80	0.2375000
NODE_34570_length_533_cov_13.956221	216	296	4	61	80	0.7625000
NODE_34570_length_533_cov_13.956221	269	349	0	5	80	0.0625000
NODE_34570_length_533_cov_13.956221	269	349	4	75	80	0.9375000
NODE_34575_length_533_cov_8.207373	244	322	0	78	78	1.0000000
NODE_34576_length_533_cov_8.023041	230	310	0	25	80	0.3125000
NODE_34576_length_533_cov_8.023041	230	310	2	55	80	0.6875000
NODE_34576_length_533_cov_8.023041	283	364	0	15	81	0.1851852
NODE_34576_length_533_cov_8.023041	283	364	2	66	81	0.8148148
NODE_34585_length_533_cov_5.170507	308	369	0	61	61	1.0000000
NODE_34588_length_533_cov_4.988479	229	309	0	80	80	1.0000000
NODE_34588_length_533_cov_4.988479	282	362	0	80	80	1.0000000
NODE_34600_length_533_cov_3.638249	201	265	0	21	64	0.3281250
NODE_34600_length_533_cov_3.638249	201	265	1	43	64	0.6718750
NODE_34603_length_533_cov_3.511521	138	218	0	10	80	0.1250000
NODE_34603_length_533_cov_3.511521	138	218	2	62	80	0.7750000
NODE_34603_length_533_cov_3.511521	138	218	4	8	80	0.1000000
NODE_34615_length_533_cov_3.073733	294	340	0	46	46	1.0000000
NODE_34617_length_533_cov_3.052995	256	304	2	21	48	0.4375000
NODE_34617_length_533_cov_3.052995	256	304	6	9	48	0.1875000
NODE_34617_length_533_cov_3.052995	256	304	7	1	48	0.0208333
NODE_34617_length_533_cov_3.052995	256	304	8	17	48	0.3541667
NODE_34631_length_533_cov_2.366359	229	311	0	12	82	0.1463415
NODE_34631_length_533_cov_2.366359	229	311	2	70	82	0.8536586
NODE_34635_length_533_cov_2.288018	468	490	0	22	22	1.0000000
NODE_34767_length_532_cov_73.279446	0	64	0	4	64	0.0625000
NODE_34767_length_532_cov_73.279446	0	64	2	20	64	0.3125000
NODE_34767_length_532_cov_73.279446	0	64	4	5	64	0.0781250
NODE_34767_length_532_cov_73.279446	0	64	6	2	64	0.0312500
NODE_34767_length_532_cov_73.279446	0	64	10	33	64	0.5156250
NODE_34768_length_532_cov_23.055427	168	248	0	80	80	1.0000000
NODE_34768_length_532_cov_23.055427	221	301	0	80	80	1.0000000
NODE_34769_length_532_cov_22.778291	256	336	6	10	80	0.1250000
NODE_34769_length_532_cov_22.778291	256	336	7	1	80	0.0125000
NODE_34769_length_532_cov_22.778291	256	336	8	20	80	0.2500000
NODE_34769_length_532_cov_22.778291	256	336	10	49	80	0.6125000
NODE_34769_length_532_cov_22.778291	309	389	0	23	80	0.2875000
NODE_34769_length_532_cov_22.778291	309	389	2	2	80	0.0250000
NODE_34769_length_532_cov_22.778291	309	389	6	38	80	0.4750000
NODE_34769_length_532_cov_22.778291	309	389	7	1	80	0.0125000
NODE_34769_length_532_cov_22.778291	309	389	8	16	80	0.2000000
NODE_34770_length_532_cov_13.279446	85	165	0	6	80	0.0750000
NODE_34770_length_532_cov_13.279446	85	165	2	57	80	0.7125000
NODE_34770_length_532_cov_13.279446	85	165	4	17	80	0.2125000
NODE_34770_length_532_cov_13.279446	138	218	2	57	80	0.7125000
NODE_34770_length_532_cov_13.279446	138	218	4	23	80	0.2875000
NODE_34774_length_532_cov_7.591224	171	235	0	64	64	1.0000000
NODE_34774_length_532_cov_7.591224	172	235	0	63	63	1.0000000
NODE_34774_length_532_cov_7.591224	173	226	0	53	53	1.0000000
NODE_34774_length_532_cov_7.591224	173	228	0	55	55	1.0000000
NODE_34774_length_532_cov_7.591224	208	282	0	54	74	0.7297297
NODE_34774_length_532_cov_7.591224	208	282	2	20	74	0.2702703
NODE_34774_length_532_cov_7.591224	208	282	0	54	74	0.7297297
NODE_34774_length_532_cov_7.591224	208	282	2	20	74	0.2702703
NODE_34774_length_532_cov_7.591224	208	282	0	54	74	0.7297297
NODE_34774_length_532_cov_7.591224	208	282	2	20	74	0.2702703
NODE_34774_length_532_cov_7.591224	208	282	0	54	74	0.7297297
NODE_34774_length_532_cov_7.591224	208	282	2	20	74	0.2702703
NODE_34788_length_532_cov_4.524249	84	151	0	67	67	1.0000000
NODE_34788_length_532_cov_4.524249	137	218	0	81	81	1.0000000
NODE_34838_length_532_cov_1.866051	263	309	0	46	46	1.0000000
NODE_34845_length_532_cov_1.757506	126	146	0	20	20	1.0000000
NODE_34948_length_531_cov_35.539352	7	45	0	38	38	1.0000000
NODE_34948_length_531_cov_35.539352	18	98	0	80	80	1.0000000
NODE_34949_length_531_cov_13.162037	129	209	0	13	80	0.1625000
NODE_34949_length_531_cov_13.162037	129	209	2	41	80	0.5125000
NODE_34949_length_531_cov_13.162037	129	209	4	26	80	0.3250000
NODE_34949_length_531_cov_13.162037	182	251	2	1	69	0.0144928
NODE_34949_length_531_cov_13.162037	182	251	4	68	69	0.9855072
NODE_34953_length_531_cov_6.821759	242	322	0	80	80	1.0000000
NODE_34953_length_531_cov_6.821759	295	375	0	80	80	1.0000000
NODE_34958_length_531_cov_5.261574	261	336	6	2	75	0.0266667
NODE_34958_length_531_cov_5.261574	261	336	10	4	75	0.0533333
NODE_34958_length_531_cov_5.261574	261	336	12	2	75	0.0266667
NODE_34958_length_531_cov_5.261574	261	336	16	14	75	0.1866667
NODE_34958_length_531_cov_5.261574	261	336	18	2	75	0.0266667
NODE_34958_length_531_cov_5.261574	261	336	20	11	75	0.1466667
NODE_34958_length_531_cov_5.261574	261	336	22	40	75	0.5333334
NODE_34958_length_531_cov_5.261574	309	362	16	7	53	0.1320755
NODE_34958_length_531_cov_5.261574	309	362	18	14	53	0.2641509
NODE_34958_length_531_cov_5.261574	309	362	20	8	53	0.1509434
NODE_34958_length_531_cov_5.261574	309	362	22	24	53	0.4528302
NODE_34963_length_531_cov_4.527778	177	255	0	78	78	1.0000000
NODE_34965_length_531_cov_4.319444	283	363	0	80	80	1.0000000
NODE_34965_length_531_cov_4.319444	336	416	0	80	80	1.0000000
NODE_34979_length_531_cov_3.488426	238	318	0	25	80	0.3125000
NODE_34979_length_531_cov_3.488426	238	318	2	55	80	0.6875000
NODE_34979_length_531_cov_3.488426	291	371	0	2	80	0.0250000
NODE_34979_length_531_cov_3.488426	291	371	2	78	80	0.9750000
NODE_34980_length_531_cov_3.375000	153	207	0	15	54	0.2777778
NODE_34980_length_531_cov_3.375000	153	207	2	4	54	0.0740741
NODE_34980_length_531_cov_3.375000	153	207	4	4	54	0.0740741
NODE_34980_length_531_cov_3.375000	153	207	6	7	54	0.1296296
NODE_34980_length_531_cov_3.375000	153	207	8	11	54	0.2037037
NODE_34980_length_531_cov_3.375000	153	207	10	13	54	0.2407407
NODE_34980_length_531_cov_3.375000	180	260	6	6	80	0.0750000
NODE_34980_length_531_cov_3.375000	180	260	8	13	80	0.1625000
NODE_34980_length_531_cov_3.375000	180	260	9	9	80	0.1125000
NODE_34980_length_531_cov_3.375000	180	260	10	46	80	0.5750000
NODE_34980_length_531_cov_3.375000	180	260	11	6	80	0.0750000
NODE_34986_length_531_cov_3.111111	243	323	0	80	80	1.0000000
NODE_34986_length_531_cov_3.111111	296	376	0	80	80	1.0000000
NODE_35008_length_531_cov_2.201389	302	373	2	71	71	1.0000000
NODE_35008_length_531_cov_2.201389	350	426	0	24	76	0.3157895
NODE_35008_length_531_cov_2.201389	350	426	2	52	76	0.6842105
NODE_35141_length_530_cov_30.605568	250	330	0	16	80	0.2000000
NODE_35141_length_530_cov_30.605568	250	330	2	25	80	0.3125000
NODE_35141_length_530_cov_30.605568	250	330	4	23	80	0.2875000
NODE_35141_length_530_cov_30.605568	250	330	6	16	80	0.2000000
NODE_35141_length_530_cov_30.605568	303	383	4	64	80	0.8000000
NODE_35141_length_530_cov_30.605568	303	383	6	16	80	0.2000000
NODE_35142_length_530_cov_16.937355	404	484	4	4	80	0.0500000
NODE_35142_length_530_cov_16.937355	404	484	12	3	80	0.0375000
NODE_35142_length_530_cov_16.937355	404	484	21	2	80	0.0250000
NODE_35142_length_530_cov_16.937355	404	484	27	3	80	0.0375000
NODE_35142_length_530_cov_16.937355	404	484	29	1	80	0.0125000
NODE_35142_length_530_cov_16.937355	404	484	30	67	80	0.8375000
NODE_35142_length_530_cov_16.937355	457	530	2	1	73	0.0136986
NODE_35142_length_530_cov_16.937355	457	530	4	4	73	0.0547945
NODE_35142_length_530_cov_16.937355	457	530	6	4	73	0.0547945
NODE_35142_length_530_cov_16.937355	457	530	16	8	73	0.1095890
NODE_35142_length_530_cov_16.937355	457	530	18	5	73	0.0684932
NODE_35142_length_530_cov_16.937355	457	530	28	1	73	0.0136986
NODE_35142_length_530_cov_16.937355	457	530	30	50	73	0.6849315
NODE_35143_length_530_cov_9.902552	273	353	0	80	80	1.0000000
NODE_35143_length_530_cov_9.902552	326	406	0	80	80	1.0000000
NODE_35144_length_530_cov_7.928074	46	126	0	80	80	1.0000000
NODE_35144_length_530_cov_7.928074	99	179	0	80	80	1.0000000
NODE_35150_length_530_cov_4.647332	188	268	0	80	80	1.0000000
NODE_35150_length_530_cov_4.647332	241	321	0	80	80	1.0000000
NODE_35154_length_530_cov_4.389791	162	242	12	5	80	0.0625000
NODE_35154_length_530_cov_4.389791	162	242	14	2	80	0.0250000
NODE_35154_length_530_cov_4.389791	162	242	16	9	80	0.1125000
NODE_35154_length_530_cov_4.389791	162	242	18	3	80	0.0375000
NODE_35154_length_530_cov_4.389791	162	242	23	5	80	0.0625000
NODE_35154_length_530_cov_4.389791	162	242	27	1	80	0.0125000
NODE_35154_length_530_cov_4.389791	162	242	29	3	80	0.0375000
NODE_35154_length_530_cov_4.389791	162	242	30	2	80	0.0250000
NODE_35154_length_530_cov_4.389791	162	242	32	1	80	0.0125000
NODE_35154_length_530_cov_4.389791	162	242	36	3	80	0.0375000
NODE_35154_length_530_cov_4.389791	162	242	38	1	80	0.0125000
NODE_35154_length_530_cov_4.389791	162	242	42	10	80	0.1250000
NODE_35154_length_530_cov_4.389791	162	242	44	5	80	0.0625000
NODE_35154_length_530_cov_4.389791	162	242	46	6	80	0.0750000
NODE_35154_length_530_cov_4.389791	162	242	48	4	80	0.0500000
NODE_35154_length_530_cov_4.389791	162	242	54	3	80	0.0375000
NODE_35154_length_530_cov_4.389791	162	242	55	8	80	0.1000000
NODE_35154_length_530_cov_4.389791	162	242	56	2	80	0.0250000
NODE_35154_length_530_cov_4.389791	162	242	58	1	80	0.0125000
NODE_35154_length_530_cov_4.389791	162	242	63	6	80	0.0750000
NODE_35159_length_530_cov_4.046404	76	111	0	35	35	1.0000000
NODE_35319_length_529_cov_38.983721	140	220	0	80	80	1.0000000
NODE_35320_length_529_cov_18.223256	189	269	0	80	80	1.0000000
NODE_35320_length_529_cov_18.223256	242	322	0	80	80	1.0000000
NODE_35321_length_529_cov_17.009302	358	438	0	26	80	0.3250000
NODE_35321_length_529_cov_17.009302	358	438	2	54	80	0.6750000
NODE_35321_length_529_cov_17.009302	411	491	0	79	80	0.9875000
NODE_35321_length_529_cov_17.009302	411	491	2	1	80	0.0125000
NODE_35331_length_529_cov_6.195349	211	291	0	80	80	1.0000000
NODE_35331_length_529_cov_6.195349	264	322	0	58	58	1.0000000
NODE_35336_length_529_cov_5.176744	139	207	0	49	68	0.7205882
NODE_35336_length_529_cov_5.176744	139	207	2	19	68	0.2794118
NODE_35336_length_529_cov_5.176744	185	260	0	3	75	0.0400000
NODE_35336_length_529_cov_5.176744	185	260	2	72	75	0.9600000
NODE_35364_length_529_cov_2.883721	223	281	2	7	58	0.1206897
NODE_35364_length_529_cov_2.883721	223	281	4	51	58	0.8793104
NODE_35374_length_529_cov_2.660465	89	168	0	26	79	0.3291139
NODE_35374_length_529_cov_2.660465	89	168	2	1	79	0.0126582
NODE_35374_length_529_cov_2.660465	89	168	4	21	79	0.2658228
NODE_35374_length_529_cov_2.660465	89	168	6	7	79	0.0886076
NODE_35374_length_529_cov_2.660465	89	168	8	24	79	0.3037975
NODE_35375_length_529_cov_2.595349	278	321	2	8	43	0.1860465
NODE_35375_length_529_cov_2.595349	278	321	4	35	43	0.8139535
NODE_35384_length_529_cov_2.272093	247	313	0	66	66	1.0000000
NODE_35427_length_529_cov_1.597674	289	332	0	43	43	1.0000000
NODE_35521_length_528_cov_25.808858	233	313	6	42	80	0.5250000
NODE_35521_length_528_cov_25.808858	233	313	7	9	80	0.1125000
NODE_35521_length_528_cov_25.808858	233	313	8	29	80	0.3625000
NODE_35521_length_528_cov_25.808858	286	366	2	8	80	0.1000000
NODE_35521_length_528_cov_25.808858	286	366	4	26	80	0.3250000
NODE_35521_length_528_cov_25.808858	286	366	6	28	80	0.3500000
NODE_35521_length_528_cov_25.808858	286	366	7	9	80	0.1125000
NODE_35521_length_528_cov_25.808858	286	366	8	9	80	0.1125000
NODE_35522_length_528_cov_17.331002	219	299	0	80	80	1.0000000
NODE_35522_length_528_cov_17.331002	272	352	0	80	80	1.0000000
NODE_35523_length_528_cov_16.165501	262	342	0	80	80	1.0000000
NODE_35523_length_528_cov_16.165501	315	395	0	80	80	1.0000000
NODE_35529_length_528_cov_5.776224	204	284	0	80	80	1.0000000
NODE_35529_length_528_cov_5.776224	257	337	0	80	80	1.0000000
NODE_35542_length_528_cov_4.016317	235	315	0	80	80	1.0000000
NODE_35542_length_528_cov_4.016317	288	368	0	80	80	1.0000000
NODE_35545_length_528_cov_3.799534	144	192	4	48	48	1.0000000
NODE_35561_length_528_cov_2.902098	252	305	0	25	53	0.4716981
NODE_35561_length_528_cov_2.902098	252	305	4	28	53	0.5283019
NODE_35575_length_528_cov_2.324009	137	188	6	7	51	0.1372549
NODE_35575_length_528_cov_2.324009	137	188	8	9	51	0.1764706
NODE_35575_length_528_cov_2.324009	137	188	12	35	51	0.6862745
NODE_35575_length_528_cov_2.324009	161	241	6	60	80	0.7500000
NODE_35575_length_528_cov_2.324009	161	241	8	9	80	0.1125000
NODE_35575_length_528_cov_2.324009	161	241	12	11	80	0.1375000
NODE_35597_length_528_cov_1.755245	268	348	2	36	80	0.4500000
NODE_35597_length_528_cov_1.755245	268	348	4	44	80	0.5500000
NODE_35597_length_528_cov_1.755245	321	401	0	46	80	0.5750000
NODE_35597_length_528_cov_1.755245	321	401	2	34	80	0.4250000
NODE_35687_length_527_cov_19.247664	306	386	0	80	80	1.0000000
NODE_35687_length_527_cov_19.247664	359	439	0	80	80	1.0000000
NODE_35688_length_527_cov_15.974299	250	349	0	99	99	1.0000000
NODE_35688_length_527_cov_15.974299	322	402	0	80	80	1.0000000
NODE_35691_length_527_cov_8.221963	235	315	0	70	80	0.8750000
NODE_35691_length_527_cov_8.221963	235	315	2	10	80	0.1250000
NODE_35691_length_527_cov_8.221963	288	368	0	17	80	0.2125000
NODE_35691_length_527_cov_8.221963	288	368	2	11	80	0.1375000
NODE_35691_length_527_cov_8.221963	288	368	4	23	80	0.2875000
NODE_35691_length_527_cov_8.221963	288	368	6	15	80	0.1875000
NODE_35691_length_527_cov_8.221963	288	368	8	14	80	0.1750000
NODE_35693_length_527_cov_7.200935	190	270	0	80	80	1.0000000
NODE_35693_length_527_cov_7.200935	243	346	0	103	103	1.0000000
NODE_35693_length_527_cov_7.200935	342	422	0	80	80	1.0000000
NODE_35693_length_527_cov_7.200935	395	475	0	80	80	1.0000000
NODE_35696_length_527_cov_6.862150	279	359	0	80	80	1.0000000
NODE_35697_length_527_cov_6.046729	155	235	0	80	80	1.0000000
NODE_35697_length_527_cov_6.046729	208	288	0	80	80	1.0000000
NODE_35736_length_527_cov_2.238318	226	306	4	14	80	0.1750000
NODE_35736_length_527_cov_2.238318	226	306	6	66	80	0.8250000
NODE_35858_length_526_cov_50.866511	169	242	0	73	73	1.0000000
NODE_35858_length_526_cov_50.866511	215	295	0	44	80	0.5500000
NODE_35858_length_526_cov_50.866511	215	295	2	36	80	0.4500000
NODE_35858_length_526_cov_50.866511	291	371	2	80	80	1.0000000
NODE_35858_length_526_cov_50.866511	344	424	0	36	80	0.4500000
NODE_35858_length_526_cov_50.866511	344	424	2	44	80	0.5500000
NODE_35860_length_526_cov_26.395785	315	395	4	8	80	0.1000000
NODE_35860_length_526_cov_26.395785	315	395	6	53	80	0.6625000
NODE_35860_length_526_cov_26.395785	315	395	8	19	80	0.2375000
NODE_35860_length_526_cov_26.395785	368	448	4	43	80	0.5375000
NODE_35860_length_526_cov_26.395785	368	448	6	13	80	0.1625000
NODE_35860_length_526_cov_26.395785	368	448	8	24	80	0.3000000
NODE_35861_length_526_cov_16.611241	305	385	2	80	80	1.0000000
NODE_35861_length_526_cov_16.611241	358	438	0	34	80	0.4250000
NODE_35861_length_526_cov_16.611241	358	438	2	46	80	0.5750000
NODE_35866_length_526_cov_6.215457	303	351	0	48	48	1.0000000
NODE_35877_length_526_cov_3.936768	118	142	0	17	24	0.7083333
NODE_35877_length_526_cov_3.936768	118	142	2	7	24	0.2916667
NODE_35877_length_526_cov_3.936768	118	163	0	38	45	0.8444445
NODE_35877_length_526_cov_3.936768	118	163	2	7	45	0.1555556
NODE_35901_length_526_cov_2.466042	138	184	4	24	46	0.5217391
NODE_35901_length_526_cov_2.466042	138	184	6	22	46	0.4782609
NODE_36055_length_525_cov_33.910798	98	178	2	7	80	0.0875000
NODE_36055_length_525_cov_33.910798	98	178	4	64	80	0.8000000
NODE_36055_length_525_cov_33.910798	98	178	6	9	80	0.1125000
NODE_36055_length_525_cov_33.910798	151	231	2	29	80	0.3625000
NODE_36055_length_525_cov_33.910798	151	231	4	51	80	0.6375000
NODE_36055_length_525_cov_33.910798	159	231	2	22	72	0.3055556
NODE_36055_length_525_cov_33.910798	159	231	4	50	72	0.6944444
NODE_36058_length_525_cov_8.788732	175	255	0	22	80	0.2750000
NODE_36058_length_525_cov_8.788732	175	255	2	58	80	0.7250000
NODE_36058_length_525_cov_8.788732	228	308	0	14	80	0.1750000
NODE_36058_length_525_cov_8.788732	228	308	2	66	80	0.8250000
NODE_36059_length_525_cov_7.880282	242	285	0	43	43	1.0000000
NODE_36098_length_525_cov_2.417840	229	306	0	4	77	0.0519481
NODE_36098_length_525_cov_2.417840	229	306	2	1	77	0.0129870
NODE_36098_length_525_cov_2.417840	229	306	3	2	77	0.0259740
NODE_36098_length_525_cov_2.417840	229	306	5	23	77	0.2987013
NODE_36098_length_525_cov_2.417840	229	306	6	47	77	0.6103896
NODE_36230_length_524_cov_21.649412	262	342	0	80	80	1.0000000
NODE_36230_length_524_cov_21.649412	315	395	0	80	80	1.0000000
NODE_36231_length_524_cov_14.131765	136	201	0	29	65	0.4461538
NODE_36231_length_524_cov_14.131765	136	201	2	36	65	0.5538462
NODE_36232_length_524_cov_10.392941	237	317	2	36	80	0.4500000
NODE_36232_length_524_cov_10.392941	237	317	6	23	80	0.2875000
NODE_36232_length_524_cov_10.392941	237	317	8	21	80	0.2625000
NODE_36232_length_524_cov_10.392941	290	370	4	28	80	0.3500000
NODE_36232_length_524_cov_10.392941	290	370	6	47	80	0.5875000
NODE_36232_length_524_cov_10.392941	290	370	8	5	80	0.0625000
NODE_36262_length_524_cov_3.221176	195	272	0	77	77	1.0000000
NODE_36262_length_524_cov_3.221176	253	324	0	71	71	1.0000000
NODE_36264_length_524_cov_3.148235	317	397	0	12	80	0.1500000
NODE_36264_length_524_cov_3.148235	317	397	2	68	80	0.8500000
NODE_36410_length_523_cov_113.438679	0	48	0	48	48	1.0000000
NODE_36410_length_523_cov_113.438679	14	69	0	55	55	1.0000000
NODE_36410_length_523_cov_113.438679	25	101	0	61	76	0.8026316
NODE_36410_length_523_cov_113.438679	25	101	2	5	76	0.0657895
NODE_36410_length_523_cov_113.438679	25	101	3	10	76	0.1315790
NODE_36410_length_523_cov_113.438679	105	181	3	15	76	0.1973684
NODE_36410_length_523_cov_113.438679	105	181	5	7	76	0.0921053
NODE_36410_length_523_cov_113.438679	105	181	6	4	76	0.0526316
NODE_36410_length_523_cov_113.438679	105	181	10	1	76	0.0131579
NODE_36410_length_523_cov_113.438679	105	181	14	1	76	0.0131579
NODE_36410_length_523_cov_113.438679	105	181	18	1	76	0.0131579
NODE_36410_length_523_cov_113.438679	105	181	20	4	76	0.0526316
NODE_36410_length_523_cov_113.438679	105	181	22	2	76	0.0263158
NODE_36410_length_523_cov_113.438679	105	181	24	6	76	0.0789474
NODE_36410_length_523_cov_113.438679	105	181	26	12	76	0.1578947
NODE_36410_length_523_cov_113.438679	105	181	28	5	76	0.0657895
NODE_36410_length_523_cov_113.438679	105	181	30	1	76	0.0131579
NODE_36410_length_523_cov_113.438679	105	181	32	17	76	0.2236842
NODE_36410_length_523_cov_113.438679	154	234	26	8	80	0.1000000
NODE_36410_length_523_cov_113.438679	154	234	28	12	80	0.1500000
NODE_36410_length_523_cov_113.438679	154	234	30	8	80	0.1000000
NODE_36410_length_523_cov_113.438679	154	234	32	43	80	0.5375000
NODE_36410_length_523_cov_113.438679	154	234	34	3	80	0.0375000
NODE_36410_length_523_cov_113.438679	154	234	36	6	80	0.0750000
NODE_36410_length_523_cov_113.438679	312	355	11	13	43	0.3023256
NODE_36410_length_523_cov_113.438679	312	355	12	10	43	0.2325581
NODE_36410_length_523_cov_113.438679	312	355	13	4	43	0.0930233
NODE_36410_length_523_cov_113.438679	312	355	14	16	43	0.3720930
NODE_36412_length_523_cov_64.695755	35	115	0	80	80	1.0000000
NODE_36412_length_523_cov_64.695755	88	168	0	80	80	1.0000000
NODE_36414_length_523_cov_20.724057	235	315	0	4	80	0.0500000
NODE_36414_length_523_cov_20.724057	235	315	5	1	80	0.0125000
NODE_36414_length_523_cov_20.724057	235	315	6	17	80	0.2125000
NODE_36414_length_523_cov_20.724057	235	315	8	14	80	0.1750000
NODE_36414_length_523_cov_20.724057	235	315	12	44	80	0.5500000
NODE_36414_length_523_cov_20.724057	288	368	0	12	80	0.1500000
NODE_36414_length_523_cov_20.724057	288	368	4	12	80	0.1500000
NODE_36414_length_523_cov_20.724057	288	368	6	8	80	0.1000000
NODE_36414_length_523_cov_20.724057	288	368	12	48	80	0.6000000
NODE_36415_length_523_cov_18.500000	164	244	0	9	80	0.1125000
NODE_36415_length_523_cov_18.500000	164	244	2	71	80	0.8875000
NODE_36415_length_523_cov_18.500000	217	297	0	58	80	0.7250000
NODE_36415_length_523_cov_18.500000	217	297	2	22	80	0.2750000
NODE_36416_length_523_cov_15.216981	62	142	0	53	80	0.6625000
NODE_36416_length_523_cov_15.216981	62	142	2	27	80	0.3375000
NODE_36416_length_523_cov_15.216981	115	195	2	80	80	1.0000000
NODE_36417_length_523_cov_10.575472	157	183	0	19	26	0.7307692
NODE_36417_length_523_cov_10.575472	157	183	9	1	26	0.0384615
NODE_36417_length_523_cov_10.575472	157	183	10	6	26	0.2307692
NODE_36418_length_523_cov_9.962264	212	292	0	80	80	1.0000000
NODE_36418_length_523_cov_9.962264	265	345	0	80	80	1.0000000
NODE_36427_length_523_cov_4.943396	108	188	8	25	80	0.3125000
NODE_36427_length_523_cov_4.943396	108	188	10	8	80	0.1000000
NODE_36427_length_523_cov_4.943396	108	188	11	1	80	0.0125000
NODE_36427_length_523_cov_4.943396	108	188	12	9	80	0.1125000
NODE_36427_length_523_cov_4.943396	108	188	14	13	80	0.1625000
NODE_36427_length_523_cov_4.943396	108	188	16	6	80	0.0750000
NODE_36427_length_523_cov_4.943396	108	188	20	7	80	0.0875000
NODE_36427_length_523_cov_4.943396	108	188	24	1	80	0.0125000
NODE_36427_length_523_cov_4.943396	108	188	26	2	80	0.0250000
NODE_36427_length_523_cov_4.943396	108	188	28	8	80	0.1000000
NODE_36427_length_523_cov_4.943396	161	241	14	9	80	0.1125000
NODE_36427_length_523_cov_4.943396	161	241	20	7	80	0.0875000
NODE_36427_length_523_cov_4.943396	161	241	24	1	80	0.0125000
NODE_36427_length_523_cov_4.943396	161	241	26	2	80	0.0250000
NODE_36427_length_523_cov_4.943396	161	241	28	39	80	0.4875000
NODE_36427_length_523_cov_4.943396	161	241	29	1	80	0.0125000
NODE_36427_length_523_cov_4.943396	161	241	31	8	80	0.1000000
NODE_36427_length_523_cov_4.943396	161	241	33	9	80	0.1125000
NODE_36427_length_523_cov_4.943396	161	241	35	4	80	0.0500000
NODE_36429_length_523_cov_4.787736	110	141	22	4	31	0.1290323
NODE_36429_length_523_cov_4.787736	110	141	24	8	31	0.2580645
NODE_36429_length_523_cov_4.787736	110	141	26	15	31	0.4838710
NODE_36429_length_523_cov_4.787736	110	141	28	4	31	0.1290323
NODE_36429_length_523_cov_4.787736	131	194	4	3	63	0.0476190
NODE_36429_length_523_cov_4.787736	131	194	6	1	63	0.0158730
NODE_36429_length_523_cov_4.787736	131	194	8	2	63	0.0317460
NODE_36429_length_523_cov_4.787736	131	194	12	9	63	0.1428571
NODE_36429_length_523_cov_4.787736	131	194	16	4	63	0.0634921
NODE_36429_length_523_cov_4.787736	131	194	20	4	63	0.0634921
NODE_36429_length_523_cov_4.787736	131	194	22	6	63	0.0952381
NODE_36429_length_523_cov_4.787736	131	194	25	1	63	0.0158730
NODE_36429_length_523_cov_4.787736	131	194	26	11	63	0.1746032
NODE_36429_length_523_cov_4.787736	131	194	28	22	63	0.3492064
NODE_36439_length_523_cov_3.792453	139	219	0	13	80	0.1625000
NODE_36439_length_523_cov_3.792453	139	219	2	67	80	0.8375000
NODE_36439_length_523_cov_3.792453	192	272	0	61	80	0.7625000
NODE_36439_length_523_cov_3.792453	192	272	2	19	80	0.2375000
NODE_36481_length_523_cov_2.259434	337	372	0	35	35	1.0000000
NODE_36490_length_523_cov_2.096698	307	351	0	10	44	0.2272727
NODE_36490_length_523_cov_2.096698	307	351	1	13	44	0.2954545
NODE_36490_length_523_cov_2.096698	307	351	2	3	44	0.0681818
NODE_36490_length_523_cov_2.096698	307	351	4	5	44	0.1136364
NODE_36490_length_523_cov_2.096698	307	351	6	1	44	0.0227273
NODE_36490_length_523_cov_2.096698	307	351	8	2	44	0.0454545
NODE_36490_length_523_cov_2.096698	307	351	9	5	44	0.1136364
NODE_36490_length_523_cov_2.096698	307	351	13	5	44	0.1136364
NODE_36518_length_523_cov_1.700472	176	195	0	19	19	1.0000000
NODE_36632_length_522_cov_33.579196	55	135	0	62	80	0.7750000
NODE_36632_length_522_cov_33.579196	55	135	2	18	80	0.2250000
NODE_36632_length_522_cov_33.579196	108	188	0	9	80	0.1125000
NODE_36632_length_522_cov_33.579196	108	188	2	58	80	0.7250000
NODE_36632_length_522_cov_33.579196	108	188	4	13	80	0.1625000
NODE_36634_length_522_cov_12.851064	266	342	0	1	76	0.0131579
NODE_36634_length_522_cov_12.851064	266	342	3	58	76	0.7631579
NODE_36634_length_522_cov_12.851064	266	342	6	17	76	0.2236842
NODE_36634_length_522_cov_12.851064	319	395	0	12	76	0.1578947
NODE_36634_length_522_cov_12.851064	319	395	2	42	76	0.5526316
NODE_36634_length_522_cov_12.851064	319	395	3	22	76	0.2894737
NODE_36637_length_522_cov_7.349882	212	283	2	71	71	1.0000000
NODE_36637_length_522_cov_7.349882	400	469	0	69	69	1.0000000
NODE_36670_length_522_cov_2.933806	178	258	0	80	80	1.0000000
NODE_36670_length_522_cov_2.933806	231	311	0	80	80	1.0000000
NODE_36676_length_522_cov_2.661939	187	241	0	54	54	1.0000000
NODE_36820_length_521_cov_9.303318	106	186	0	11	80	0.1375000
NODE_36820_length_521_cov_9.303318	106	186	2	69	80	0.8625000
NODE_36820_length_521_cov_9.303318	159	239	0	34	80	0.4250000
NODE_36820_length_521_cov_9.303318	159	239	2	46	80	0.5750000
NODE_36832_length_521_cov_4.971564	218	298	0	80	80	1.0000000
NODE_36832_length_521_cov_4.971564	271	351	0	80	80	1.0000000
NODE_36845_length_521_cov_3.504739	113	191	0	22	78	0.2820513
NODE_36845_length_521_cov_3.504739	113	191	3	14	78	0.1794872
NODE_36845_length_521_cov_3.504739	113	191	4	8	78	0.1025641
NODE_36845_length_521_cov_3.504739	113	191	6	34	78	0.4358974
NODE_36845_length_521_cov_3.504739	164	205	0	36	41	0.8780488
NODE_36845_length_521_cov_3.504739	164	205	3	5	41	0.1219512
NODE_36848_length_521_cov_3.324645	158	244	0	39	86	0.4534884
NODE_36848_length_521_cov_3.324645	158	244	2	47	86	0.5465117
NODE_36848_length_521_cov_3.324645	217	280	2	63	63	1.0000000
NODE_36916_length_521_cov_1.613744	165	227	2	62	62	1.0000000
NODE_37036_length_520_cov_50.676960	0	75	0	75	75	1.0000000
NODE_37036_length_520_cov_50.676960	48	128	0	74	80	0.9250000
NODE_37036_length_520_cov_50.676960	48	128	6	6	80	0.0750000
NODE_37036_length_520_cov_50.676960	124	204	6	80	80	1.0000000
NODE_37036_length_520_cov_50.676960	177	257	0	45	80	0.5625000
NODE_37036_length_520_cov_50.676960	177	257	6	35	80	0.4375000
NODE_37037_length_520_cov_43.294537	10	90	0	14	80	0.1750000
NODE_37037_length_520_cov_43.294537	10	90	4	2	80	0.0250000
NODE_37037_length_520_cov_43.294537	10	90	8	7	80	0.0875000
NODE_37037_length_520_cov_43.294537	10	90	14	2	80	0.0250000
NODE_37037_length_520_cov_43.294537	10	90	18	53	80	0.6625000
NODE_37037_length_520_cov_43.294537	10	90	20	2	80	0.0250000
NODE_37037_length_520_cov_43.294537	10	90	0	14	80	0.1750000
NODE_37037_length_520_cov_43.294537	10	90	4	2	80	0.0250000
NODE_37037_length_520_cov_43.294537	10	90	8	7	80	0.0875000
NODE_37037_length_520_cov_43.294537	10	90	14	2	80	0.0250000
NODE_37037_length_520_cov_43.294537	10	90	18	53	80	0.6625000
NODE_37037_length_520_cov_43.294537	10	90	20	2	80	0.0250000
NODE_37037_length_520_cov_43.294537	10	90	0	14	80	0.1750000
NODE_37037_length_520_cov_43.294537	10	90	4	2	80	0.0250000
NODE_37037_length_520_cov_43.294537	10	90	8	7	80	0.0875000
NODE_37037_length_520_cov_43.294537	10	90	14	2	80	0.0250000
NODE_37037_length_520_cov_43.294537	10	90	18	53	80	0.6625000
NODE_37037_length_520_cov_43.294537	10	90	20	2	80	0.0250000
NODE_37037_length_520_cov_43.294537	10	90	0	14	80	0.1750000
NODE_37037_length_520_cov_43.294537	10	90	4	2	80	0.0250000
NODE_37037_length_520_cov_43.294537	10	90	8	7	80	0.0875000
NODE_37037_length_520_cov_43.294537	10	90	14	2	80	0.0250000
NODE_37037_length_520_cov_43.294537	10	90	18	53	80	0.6625000
NODE_37037_length_520_cov_43.294537	10	90	20	2	80	0.0250000
NODE_37037_length_520_cov_43.294537	10	90	0	14	80	0.1750000
NODE_37037_length_520_cov_43.294537	10	90	4	2	80	0.0250000
NODE_37037_length_520_cov_43.294537	10	90	8	7	80	0.0875000
NODE_37037_length_520_cov_43.294537	10	90	14	2	80	0.0250000
NODE_37037_length_520_cov_43.294537	10	90	18	53	80	0.6625000
NODE_37037_length_520_cov_43.294537	10	90	20	2	80	0.0250000
NODE_37037_length_520_cov_43.294537	10	90	0	14	80	0.1750000
NODE_37037_length_520_cov_43.294537	10	90	4	2	80	0.0250000
NODE_37037_length_520_cov_43.294537	10	90	8	7	80	0.0875000
NODE_37037_length_520_cov_43.294537	10	90	14	2	80	0.0250000
NODE_37037_length_520_cov_43.294537	10	90	18	53	80	0.6625000
NODE_37037_length_520_cov_43.294537	10	90	20	2	80	0.0250000
NODE_37037_length_520_cov_43.294537	63	129	10	4	66	0.0606061
NODE_37037_length_520_cov_43.294537	63	129	12	10	66	0.1515152
NODE_37037_length_520_cov_43.294537	63	129	16	11	66	0.1666667
NODE_37037_length_520_cov_43.294537	63	129	18	25	66	0.3787879
NODE_37037_length_520_cov_43.294537	63	129	20	16	66	0.2424242
NODE_37037_length_520_cov_43.294537	63	142	8	2	79	0.0253165
NODE_37037_length_520_cov_43.294537	63	142	10	15	79	0.1898734
NODE_37037_length_520_cov_43.294537	63	142	12	10	79	0.1265823
NODE_37037_length_520_cov_43.294537	63	142	16	11	79	0.1392405
NODE_37037_length_520_cov_43.294537	63	142	18	25	79	0.3164557
NODE_37037_length_520_cov_43.294537	63	142	20	16	79	0.2025317
NODE_37037_length_520_cov_43.294537	63	143	8	3	80	0.0375000
NODE_37037_length_520_cov_43.294537	63	143	10	15	80	0.1875000
NODE_37037_length_520_cov_43.294537	63	143	12	10	80	0.1250000
NODE_37037_length_520_cov_43.294537	63	143	16	11	80	0.1375000
NODE_37037_length_520_cov_43.294537	63	143	18	25	80	0.3125000
NODE_37037_length_520_cov_43.294537	63	143	20	16	80	0.2000000
NODE_37037_length_520_cov_43.294537	63	133	10	8	70	0.1142857
NODE_37037_length_520_cov_43.294537	63	133	12	10	70	0.1428571
NODE_37037_length_520_cov_43.294537	63	133	16	11	70	0.1571429
NODE_37037_length_520_cov_43.294537	63	133	18	25	70	0.3571429
NODE_37037_length_520_cov_43.294537	63	133	20	16	70	0.2285714
NODE_37037_length_520_cov_43.294537	66	133	10	8	67	0.1194030
NODE_37037_length_520_cov_43.294537	66	133	12	10	67	0.1492537
NODE_37037_length_520_cov_43.294537	66	133	16	11	67	0.1641791
NODE_37037_length_520_cov_43.294537	66	133	18	22	67	0.3283582
NODE_37037_length_520_cov_43.294537	66	133	20	16	67	0.2388060
NODE_37037_length_520_cov_43.294537	68	143	8	3	75	0.0400000
NODE_37037_length_520_cov_43.294537	68	143	10	15	75	0.2000000
NODE_37037_length_520_cov_43.294537	68	143	12	10	75	0.1333333
NODE_37037_length_520_cov_43.294537	68	143	16	11	75	0.1466667
NODE_37037_length_520_cov_43.294537	68	143	18	20	75	0.2666667
NODE_37037_length_520_cov_43.294537	68	143	20	16	75	0.2133333
NODE_37038_length_520_cov_29.427553	224	304	0	80	80	1.0000000
NODE_37038_length_520_cov_29.427553	277	357	0	80	80	1.0000000
NODE_37038_length_520_cov_29.427553	353	433	0	80	80	1.0000000
NODE_37038_length_520_cov_29.427553	406	486	0	80	80	1.0000000
NODE_37039_length_520_cov_14.365796	103	183	0	80	80	1.0000000
NODE_37039_length_520_cov_14.365796	156	237	0	81	81	1.0000000
NODE_37059_length_520_cov_4.121140	79	159	0	80	80	1.0000000
NODE_37059_length_520_cov_4.121140	132	212	0	80	80	1.0000000
NODE_37063_length_520_cov_3.900238	203	233	0	30	30	1.0000000
NODE_37235_length_519_cov_42.842857	8	88	0	19	80	0.2375000
NODE_37235_length_519_cov_42.842857	8	88	2	9	80	0.1125000
NODE_37235_length_519_cov_42.842857	8	88	4	10	80	0.1250000
NODE_37235_length_519_cov_42.842857	8	88	8	6	80	0.0750000
NODE_37235_length_519_cov_42.842857	8	88	10	21	80	0.2625000
NODE_37235_length_519_cov_42.842857	8	88	14	15	80	0.1875000
NODE_37235_length_519_cov_42.842857	61	139	8	8	78	0.1025641
NODE_37235_length_519_cov_42.842857	61	139	10	12	78	0.1538462
NODE_37235_length_519_cov_42.842857	61	139	12	5	78	0.0641026
NODE_37235_length_519_cov_42.842857	61	139	14	53	78	0.6794872
NODE_37236_length_519_cov_19.269048	284	363	0	49	79	0.6202531
NODE_37236_length_519_cov_19.269048	284	363	2	30	79	0.3797468
NODE_37236_length_519_cov_19.269048	336	416	2	80	80	1.0000000
NODE_37237_length_519_cov_8.500000	195	267	4	49	72	0.6805556
NODE_37237_length_519_cov_8.500000	195	267	6	23	72	0.3194444
NODE_37245_length_519_cov_5.169048	282	346	0	64	64	1.0000000
NODE_37290_length_519_cov_2.783333	174	235	0	61	61	1.0000000
NODE_37349_length_519_cov_1.538095	147	213	0	66	66	1.0000000
NODE_37447_length_518_cov_40.026253	385	465	4	43	80	0.5375000
NODE_37447_length_518_cov_40.026253	385	465	6	37	80	0.4625000
NODE_37447_length_518_cov_40.026253	438	518	0	50	80	0.6250000
NODE_37447_length_518_cov_40.026253	438	518	4	30	80	0.3750000
NODE_37449_length_518_cov_12.083532	144	224	0	80	80	1.0000000
NODE_37449_length_518_cov_12.083532	197	277	0	80	80	1.0000000
NODE_37449_length_518_cov_12.083532	407	481	0	74	74	1.0000000
NODE_37449_length_518_cov_12.083532	454	518	0	64	64	1.0000000
NODE_37450_length_518_cov_11.467780	171	200	0	29	29	1.0000000
NODE_37450_length_518_cov_11.467780	253	320	0	41	67	0.6119403
NODE_37450_length_518_cov_11.467780	253	320	2	26	67	0.3880597
NODE_37450_length_518_cov_11.467780	253	282	0	3	29	0.1034483
NODE_37450_length_518_cov_11.467780	253	282	2	26	29	0.8965517
NODE_37454_length_518_cov_7.441527	188	273	0	22	85	0.2588235
NODE_37454_length_518_cov_7.441527	188	273	4	63	85	0.7411765
NODE_37461_length_518_cov_5.563246	315	366	0	5	51	0.0980392
NODE_37461_length_518_cov_5.563246	315	366	2	44	51	0.8627451
NODE_37461_length_518_cov_5.563246	315	366	3	2	51	0.0392157
NODE_37461_length_518_cov_5.563246	339	383	2	25	44	0.5681818
NODE_37461_length_518_cov_5.563246	339	383	3	19	44	0.4318182
NODE_37465_length_518_cov_4.732697	214	276	0	62	62	1.0000000
NODE_37465_length_518_cov_4.732697	350	430	0	2	80	0.0250000
NODE_37465_length_518_cov_4.732697	350	430	2	78	80	0.9750000
NODE_37479_length_518_cov_3.503580	291	333	0	42	42	1.0000000
NODE_37479_length_518_cov_3.503580	306	363	0	57	57	1.0000000
NODE_37483_length_518_cov_3.136038	269	338	0	13	69	0.1884058
NODE_37483_length_518_cov_3.136038	269	338	5	1	69	0.0144928
NODE_37483_length_518_cov_3.136038	269	338	6	1	69	0.0144928
NODE_37483_length_518_cov_3.136038	269	338	10	54	69	0.7826087
NODE_37483_length_518_cov_3.136038	269	348	0	13	79	0.1645570
NODE_37483_length_518_cov_3.136038	269	348	5	1	79	0.0126582
NODE_37483_length_518_cov_3.136038	269	348	6	1	79	0.0126582
NODE_37483_length_518_cov_3.136038	269	348	10	64	79	0.8101266
NODE_37483_length_518_cov_3.136038	269	349	0	13	80	0.1625000
NODE_37483_length_518_cov_3.136038	269	349	5	1	80	0.0125000
NODE_37483_length_518_cov_3.136038	269	349	6	1	80	0.0125000
NODE_37483_length_518_cov_3.136038	269	349	10	65	80	0.8125000
NODE_37483_length_518_cov_3.136038	322	402	4	33	80	0.4125000
NODE_37483_length_518_cov_3.136038	322	402	6	2	80	0.0250000
NODE_37483_length_518_cov_3.136038	322	402	10	45	80	0.5625000
NODE_37483_length_518_cov_3.136038	322	364	10	42	42	1.0000000
NODE_37483_length_518_cov_3.136038	322	368	6	1	46	0.0217391
NODE_37483_length_518_cov_3.136038	322	368	10	45	46	0.9782609
NODE_37483_length_518_cov_3.136038	331	366	10	35	35	1.0000000
NODE_37637_length_517_cov_55.267943	177	257	2	80	80	1.0000000
NODE_37637_length_517_cov_55.267943	230	310	2	80	80	1.0000000
NODE_37639_length_517_cov_30.863636	0	72	0	1	72	0.0138889
NODE_37639_length_517_cov_30.863636	0	72	2	38	72	0.5277778
NODE_37639_length_517_cov_30.863636	0	72	4	1	72	0.0138889
NODE_37639_length_517_cov_30.863636	0	72	6	11	72	0.1527778
NODE_37639_length_517_cov_30.863636	0	72	8	21	72	0.2916667
NODE_37639_length_517_cov_30.863636	0	72	0	1	72	0.0138889
NODE_37639_length_517_cov_30.863636	0	72	2	38	72	0.5277778
NODE_37639_length_517_cov_30.863636	0	72	4	1	72	0.0138889
NODE_37639_length_517_cov_30.863636	0	72	6	11	72	0.1527778
NODE_37639_length_517_cov_30.863636	0	72	8	21	72	0.2916667
NODE_37639_length_517_cov_30.863636	45	125	4	2	80	0.0250000
NODE_37639_length_517_cov_30.863636	45	125	6	9	80	0.1125000
NODE_37639_length_517_cov_30.863636	45	125	8	69	80	0.8625000
NODE_37639_length_517_cov_30.863636	45	99	6	6	54	0.1111111
NODE_37639_length_517_cov_30.863636	45	99	8	48	54	0.8888889
NODE_37641_length_517_cov_12.258373	305	385	0	80	80	1.0000000
NODE_37641_length_517_cov_12.258373	358	438	0	80	80	1.0000000
NODE_37643_length_517_cov_7.131579	100	152	0	22	52	0.4230769
NODE_37643_length_517_cov_7.131579	100	152	2	6	52	0.1153846
NODE_37643_length_517_cov_7.131579	100	152	4	24	52	0.4615385
NODE_37662_length_517_cov_4.492823	140	220	0	33	80	0.4125000
NODE_37662_length_517_cov_4.492823	140	220	1	1	80	0.0125000
NODE_37662_length_517_cov_4.492823	140	220	2	46	80	0.5750000
NODE_37662_length_517_cov_4.492823	193	273	0	2	80	0.0250000
NODE_37662_length_517_cov_4.492823	193	273	2	41	80	0.5125000
NODE_37662_length_517_cov_4.492823	193	273	3	37	80	0.4625000
NODE_37697_length_517_cov_2.437799	331	388	0	49	57	0.8596491
NODE_37697_length_517_cov_2.437799	331	388	2	8	57	0.1403509
NODE_37850_length_516_cov_17.570743	147	227	4	6	80	0.0750000
NODE_37850_length_516_cov_17.570743	147	227	6	38	80	0.4750000
NODE_37850_length_516_cov_17.570743	147	227	8	36	80	0.4500000
NODE_37850_length_516_cov_17.570743	200	280	0	21	80	0.2625000
NODE_37850_length_516_cov_17.570743	200	280	2	22	80	0.2750000
NODE_37850_length_516_cov_17.570743	200	280	4	6	80	0.0750000
NODE_37850_length_516_cov_17.570743	200	280	6	21	80	0.2625000
NODE_37850_length_516_cov_17.570743	200	280	8	10	80	0.1250000
NODE_37861_length_516_cov_5.268585	402	448	0	46	46	1.0000000
NODE_37862_length_516_cov_5.067146	114	194	0	31	80	0.3875000
NODE_37862_length_516_cov_5.067146	114	194	2	49	80	0.6125000
NODE_37862_length_516_cov_5.067146	167	247	2	31	80	0.3875000
NODE_37862_length_516_cov_5.067146	167	247	4	49	80	0.6125000
NODE_37864_length_516_cov_4.788969	156	236	0	80	80	1.0000000
NODE_37864_length_516_cov_4.788969	209	277	0	68	68	1.0000000
NODE_37881_length_516_cov_3.167866	48	93	0	1	45	0.0222222
NODE_37881_length_516_cov_3.167866	48	93	6	8	45	0.1777778
NODE_37881_length_516_cov_3.167866	48	93	8	3	45	0.0666667
NODE_37881_length_516_cov_3.167866	48	93	12	8	45	0.1777778
NODE_37881_length_516_cov_3.167866	48	93	14	7	45	0.1555556
NODE_37881_length_516_cov_3.167866	48	93	16	7	45	0.1555556
NODE_37881_length_516_cov_3.167866	48	93	18	2	45	0.0444444
NODE_37881_length_516_cov_3.167866	48	93	20	2	45	0.0444444
NODE_37881_length_516_cov_3.167866	48	93	22	3	45	0.0666667
NODE_37881_length_516_cov_3.167866	48	93	24	4	45	0.0888889
NODE_37881_length_516_cov_3.167866	103	177	10	6	74	0.0810811
NODE_37881_length_516_cov_3.167866	103	177	12	16	74	0.2162162
NODE_37881_length_516_cov_3.167866	103	177	28	7	74	0.0945946
NODE_37881_length_516_cov_3.167866	103	177	32	5	74	0.0675676
NODE_37881_length_516_cov_3.167866	103	177	34	40	74	0.5405405
NODE_38044_length_515_cov_69.442308	177	257	4	3	80	0.0375000
NODE_38044_length_515_cov_69.442308	177	257	6	1	80	0.0125000
NODE_38044_length_515_cov_69.442308	177	257	10	10	80	0.1250000
NODE_38044_length_515_cov_69.442308	177	257	11	8	80	0.1000000
NODE_38044_length_515_cov_69.442308	177	257	12	7	80	0.0875000
NODE_38044_length_515_cov_69.442308	177	257	13	36	80	0.4500000
NODE_38044_length_515_cov_69.442308	177	257	14	15	80	0.1875000
NODE_38044_length_515_cov_69.442308	177	257	4	3	80	0.0375000
NODE_38044_length_515_cov_69.442308	177	257	6	1	80	0.0125000
NODE_38044_length_515_cov_69.442308	177	257	10	10	80	0.1250000
NODE_38044_length_515_cov_69.442308	177	257	11	8	80	0.1000000
NODE_38044_length_515_cov_69.442308	177	257	12	7	80	0.0875000
NODE_38044_length_515_cov_69.442308	177	257	13	36	80	0.4500000
NODE_38044_length_515_cov_69.442308	177	257	14	15	80	0.1875000
NODE_38044_length_515_cov_69.442308	177	257	4	3	80	0.0375000
NODE_38044_length_515_cov_69.442308	177	257	6	1	80	0.0125000
NODE_38044_length_515_cov_69.442308	177	257	10	10	80	0.1250000
NODE_38044_length_515_cov_69.442308	177	257	11	8	80	0.1000000
NODE_38044_length_515_cov_69.442308	177	257	12	7	80	0.0875000
NODE_38044_length_515_cov_69.442308	177	257	13	36	80	0.4500000
NODE_38044_length_515_cov_69.442308	177	257	14	15	80	0.1875000
NODE_38044_length_515_cov_69.442308	230	291	2	20	61	0.3278688
NODE_38044_length_515_cov_69.442308	230	291	3	5	61	0.0819672
NODE_38044_length_515_cov_69.442308	230	291	5	4	61	0.0655738
NODE_38044_length_515_cov_69.442308	230	291	9	1	61	0.0163934
NODE_38044_length_515_cov_69.442308	230	291	11	12	61	0.1967213
NODE_38044_length_515_cov_69.442308	230	291	13	19	61	0.3114754
NODE_38044_length_515_cov_69.442308	230	308	0	2	78	0.0256410
NODE_38044_length_515_cov_69.442308	230	308	2	35	78	0.4487180
NODE_38044_length_515_cov_69.442308	230	308	3	5	78	0.0641026
NODE_38044_length_515_cov_69.442308	230	308	5	4	78	0.0512821
NODE_38044_length_515_cov_69.442308	230	308	9	1	78	0.0128205
NODE_38044_length_515_cov_69.442308	230	308	11	12	78	0.1538462
NODE_38044_length_515_cov_69.442308	230	308	13	19	78	0.2435897
NODE_38044_length_515_cov_69.442308	235	308	0	2	73	0.0273973
NODE_38044_length_515_cov_69.442308	235	308	2	35	73	0.4794520
NODE_38044_length_515_cov_69.442308	235	308	3	5	73	0.0684932
NODE_38044_length_515_cov_69.442308	235	308	5	4	73	0.0547945
NODE_38044_length_515_cov_69.442308	235	308	9	1	73	0.0136986
NODE_38044_length_515_cov_69.442308	235	308	11	12	73	0.1643836
NODE_38044_length_515_cov_69.442308	235	308	13	14	73	0.1917808
NODE_38045_length_515_cov_13.271635	168	248	0	80	80	1.0000000
NODE_38045_length_515_cov_13.271635	221	301	0	80	80	1.0000000
NODE_38048_length_515_cov_8.314904	213	290	0	77	77	1.0000000
NODE_38054_length_515_cov_5.487981	317	402	0	40	85	0.4705882
NODE_38054_length_515_cov_5.487981	317	402	2	44	85	0.5176471
NODE_38054_length_515_cov_5.487981	317	402	4	1	85	0.0117647
NODE_38242_length_514_cov_26.910843	170	250	4	7	80	0.0875000
NODE_38242_length_514_cov_26.910843	170	250	6	73	80	0.9125000
NODE_38242_length_514_cov_26.910843	223	303	0	27	80	0.3375000
NODE_38242_length_514_cov_26.910843	223	303	2	11	80	0.1375000
NODE_38242_length_514_cov_26.910843	223	303	4	13	80	0.1625000
NODE_38242_length_514_cov_26.910843	223	303	6	29	80	0.3625000
NODE_38243_length_514_cov_12.775904	85	149	4	64	64	1.0000000
NODE_38243_length_514_cov_12.775904	123	202	0	30	79	0.3797468
NODE_38243_length_514_cov_12.775904	123	202	4	49	79	0.6202531
NODE_38244_length_514_cov_11.156627	124	204	0	80	80	1.0000000
NODE_38244_length_514_cov_11.156627	177	257	0	80	80	1.0000000
NODE_38253_length_514_cov_5.802410	165	217	1	52	52	1.0000000
NODE_38253_length_514_cov_5.802410	190	270	0	43	80	0.5375000
NODE_38253_length_514_cov_5.802410	190	270	1	37	80	0.4625000
NODE_38254_length_514_cov_5.554217	192	272	0	80	80	1.0000000
NODE_38254_length_514_cov_5.554217	294	340	0	46	46	1.0000000
NODE_38257_length_514_cov_5.322892	230	260	0	30	30	1.0000000
NODE_38262_length_514_cov_4.337349	220	300	0	10	80	0.1250000
NODE_38262_length_514_cov_4.337349	220	300	2	70	80	0.8750000
NODE_38286_length_514_cov_3.012048	264	328	0	64	64	1.0000000
NODE_38432_length_513_cov_14.613527	118	198	0	80	80	1.0000000
NODE_38432_length_513_cov_14.613527	171	251	0	80	80	1.0000000
NODE_38433_length_513_cov_9.898551	253	333	0	80	80	1.0000000
NODE_38433_length_513_cov_9.898551	306	386	0	80	80	1.0000000
NODE_38434_length_513_cov_9.164251	185	265	0	80	80	1.0000000
NODE_38434_length_513_cov_9.164251	238	318	0	80	80	1.0000000
NODE_38441_length_513_cov_6.123188	284	364	0	80	80	1.0000000
NODE_38441_length_513_cov_6.123188	337	417	0	80	80	1.0000000
NODE_38460_length_513_cov_3.456522	283	350	0	9	67	0.1343284
NODE_38460_length_513_cov_3.456522	283	350	4	4	67	0.0597015
NODE_38460_length_513_cov_3.456522	283	350	6	10	67	0.1492537
NODE_38460_length_513_cov_3.456522	283	350	9	1	67	0.0149254
NODE_38460_length_513_cov_3.456522	283	350	10	43	67	0.6417910
NODE_38460_length_513_cov_3.456522	336	398	6	7	62	0.1129032
NODE_38460_length_513_cov_3.456522	336	398	8	2	62	0.0322581
NODE_38460_length_513_cov_3.456522	336	398	10	53	62	0.8548387
NODE_38482_length_513_cov_2.309179	134	174	2	13	40	0.3250000
NODE_38482_length_513_cov_2.309179	134	174	4	27	40	0.6750000
NODE_38482_length_513_cov_2.309179	170	223	0	14	53	0.2641509
NODE_38482_length_513_cov_2.309179	170	223	2	39	53	0.7358491
NODE_38482_length_513_cov_2.309179	238	285	0	47	47	1.0000000
NODE_38515_length_513_cov_1.671498	427	476	0	49	49	1.0000000
NODE_38646_length_512_cov_45.070218	34	114	0	80	80	1.0000000
NODE_38646_length_512_cov_45.070218	87	167	0	80	80	1.0000000
NODE_38647_length_512_cov_39.639225	323	404	6	8	81	0.0987654
NODE_38647_length_512_cov_39.639225	323	404	8	20	81	0.2469136
NODE_38647_length_512_cov_39.639225	323	404	10	33	81	0.4074074
NODE_38647_length_512_cov_39.639225	323	404	12	16	81	0.1975309
NODE_38647_length_512_cov_39.639225	323	404	14	4	81	0.0493827
NODE_38647_length_512_cov_39.639225	377	457	0	5	80	0.0625000
NODE_38647_length_512_cov_39.639225	377	457	2	29	80	0.3625000
NODE_38647_length_512_cov_39.639225	377	457	4	18	80	0.2250000
NODE_38647_length_512_cov_39.639225	377	457	6	9	80	0.1125000
NODE_38647_length_512_cov_39.639225	377	457	8	19	80	0.2375000
NODE_38648_length_512_cov_8.581114	192	256	4	13	64	0.2031250
NODE_38648_length_512_cov_8.581114	192	256	6	30	64	0.4687500
NODE_38648_length_512_cov_8.581114	192	256	8	21	64	0.3281250
NODE_38661_length_512_cov_4.869249	327	407	2	5	80	0.0625000
NODE_38661_length_512_cov_4.869249	327	407	3	3	80	0.0375000
NODE_38661_length_512_cov_4.869249	327	407	4	72	80	0.9000000
NODE_38661_length_512_cov_4.869249	380	460	0	47	80	0.5875000
NODE_38661_length_512_cov_4.869249	380	460	2	11	80	0.1375000
NODE_38661_length_512_cov_4.869249	380	460	3	3	80	0.0375000
NODE_38661_length_512_cov_4.869249	380	460	4	19	80	0.2375000
NODE_38668_length_512_cov_4.157385	161	204	0	43	43	1.0000000
NODE_38668_length_512_cov_4.157385	178	257	0	79	79	1.0000000
NODE_38677_length_512_cov_3.435835	138	218	0	80	80	1.0000000
NODE_38677_length_512_cov_3.435835	191	271	0	33	80	0.4125000
NODE_38677_length_512_cov_3.435835	191	271	2	47	80	0.5875000
NODE_38693_length_512_cov_2.888620	320	400	0	21	80	0.2625000
NODE_38693_length_512_cov_2.888620	320	400	2	8	80	0.1000000
NODE_38693_length_512_cov_2.888620	320	400	4	51	80	0.6375000
NODE_38768_length_512_cov_1.341404	198	269	0	2	71	0.0281690
NODE_38768_length_512_cov_1.341404	198	269	4	3	71	0.0422535
NODE_38768_length_512_cov_1.341404	198	269	6	1	71	0.0140845
NODE_38768_length_512_cov_1.341404	198	269	8	5	71	0.0704225
NODE_38768_length_512_cov_1.341404	198	269	10	5	71	0.0704225
NODE_38768_length_512_cov_1.341404	198	269	14	1	71	0.0140845
NODE_38768_length_512_cov_1.341404	198	269	16	4	71	0.0563380
NODE_38768_length_512_cov_1.341404	198	269	18	1	71	0.0140845
NODE_38768_length_512_cov_1.341404	198	269	20	1	71	0.0140845
NODE_38768_length_512_cov_1.341404	198	269	22	7	71	0.0985916
NODE_38768_length_512_cov_1.341404	198	269	24	2	71	0.0281690
NODE_38768_length_512_cov_1.341404	198	269	26	6	71	0.0845070
NODE_38768_length_512_cov_1.341404	198	269	28	4	71	0.0563380
NODE_38768_length_512_cov_1.341404	198	269	30	5	71	0.0704225
NODE_38768_length_512_cov_1.341404	198	269	32	2	71	0.0281690
NODE_38768_length_512_cov_1.341404	198	269	34	2	71	0.0281690
NODE_38768_length_512_cov_1.341404	198	269	36	15	71	0.2112676
NODE_38768_length_512_cov_1.341404	198	269	38	3	71	0.0422535
NODE_38768_length_512_cov_1.341404	198	269	40	1	71	0.0140845
NODE_38768_length_512_cov_1.341404	198	269	42	1	71	0.0140845
NODE_38866_length_511_cov_9.796117	251	331	0	80	80	1.0000000
NODE_38866_length_511_cov_9.796117	304	370	0	66	66	1.0000000
NODE_38869_length_511_cov_8.873786	239	319	6	26	80	0.3250000
NODE_38869_length_511_cov_8.873786	239	319	12	22	80	0.2750000
NODE_38869_length_511_cov_8.873786	239	319	14	19	80	0.2375000
NODE_38869_length_511_cov_8.873786	239	319	16	13	80	0.1625000
NODE_38869_length_511_cov_8.873786	292	356	0	5	64	0.0781250
NODE_38869_length_511_cov_8.873786	292	356	2	6	64	0.0937500
NODE_38869_length_511_cov_8.873786	292	356	6	7	64	0.1093750
NODE_38869_length_511_cov_8.873786	292	356	12	34	64	0.5312500
NODE_38869_length_511_cov_8.873786	292	356	14	12	64	0.1875000
NODE_38870_length_511_cov_8.434466	232	312	0	80	80	1.0000000
NODE_38870_length_511_cov_8.434466	285	366	0	81	81	1.0000000
NODE_38872_length_511_cov_7.519417	157	237	0	35	80	0.4375000
NODE_38872_length_511_cov_7.519417	157	237	2	45	80	0.5625000
NODE_38872_length_511_cov_7.519417	210	290	2	80	80	1.0000000
NODE_38877_length_511_cov_5.762136	102	179	0	4	77	0.0519481
NODE_38877_length_511_cov_5.762136	102	179	2	73	77	0.9480519
NODE_38877_length_511_cov_5.762136	155	230	0	25	75	0.3333333
NODE_38877_length_511_cov_5.762136	155	230	2	50	75	0.6666667
NODE_38878_length_511_cov_5.655340	133	213	2	24	80	0.3000000
NODE_38878_length_511_cov_5.655340	133	213	4	56	80	0.7000000
NODE_38878_length_511_cov_5.655340	186	266	0	14	80	0.1750000
NODE_38878_length_511_cov_5.655340	186	266	2	45	80	0.5625000
NODE_38878_length_511_cov_5.655340	186	266	4	21	80	0.2625000
NODE_38911_length_511_cov_2.978155	219	255	2	36	36	1.0000000
NODE_39013_length_511_cov_1.225728	99	127	0	28	28	1.0000000
NODE_39092_length_511_cov_0.708738	98	146	0	48	48	1.0000000
NODE_39105_length_510_cov_18.206813	334	414	0	80	80	1.0000000
NODE_39105_length_510_cov_18.206813	387	467	0	80	80	1.0000000
NODE_39110_length_510_cov_8.017032	211	291	0	80	80	1.0000000
NODE_39110_length_510_cov_8.017032	264	344	0	80	80	1.0000000
NODE_39110_length_510_cov_8.017032	391	413	0	22	22	1.0000000
NODE_39112_length_510_cov_6.476886	208	251	0	1	43	0.0232558
NODE_39112_length_510_cov_6.476886	208	251	2	42	43	0.9767442
NODE_39115_length_510_cov_6.133820	149	200	2	40	51	0.7843137
NODE_39115_length_510_cov_6.133820	149	200	4	11	51	0.2156863
NODE_39122_length_510_cov_4.313869	32	106	6	74	74	1.0000000
NODE_39131_length_510_cov_3.435523	149	213	0	8	64	0.1250000
NODE_39131_length_510_cov_3.435523	149	213	2	56	64	0.8750000
NODE_39131_length_510_cov_3.435523	191	249	2	24	58	0.4137931
NODE_39131_length_510_cov_3.435523	191	249	4	34	58	0.5862069
NODE_39293_length_509_cov_13.378049	160	240	0	16	80	0.2000000
NODE_39293_length_509_cov_13.378049	160	240	1	19	80	0.2375000
NODE_39293_length_509_cov_13.378049	160	240	2	45	80	0.5625000
NODE_39293_length_509_cov_13.378049	213	294	2	81	81	1.0000000
NODE_39302_length_509_cov_5.190244	203	283	14	1	80	0.0125000
NODE_39302_length_509_cov_5.190244	203	283	16	4	80	0.0500000
NODE_39302_length_509_cov_5.190244	203	283	18	10	80	0.1250000
NODE_39302_length_509_cov_5.190244	203	283	19	1	80	0.0125000
NODE_39302_length_509_cov_5.190244	203	283	20	27	80	0.3375000
NODE_39302_length_509_cov_5.190244	203	283	22	21	80	0.2625000
NODE_39302_length_509_cov_5.190244	203	283	24	16	80	0.2000000
NODE_39302_length_509_cov_5.190244	256	336	6	45	80	0.5625000
NODE_39302_length_509_cov_5.190244	256	336	8	1	80	0.0125000
NODE_39302_length_509_cov_5.190244	256	336	10	1	80	0.0125000
NODE_39302_length_509_cov_5.190244	256	336	12	2	80	0.0250000
NODE_39302_length_509_cov_5.190244	256	336	14	1	80	0.0125000
NODE_39302_length_509_cov_5.190244	256	336	16	2	80	0.0250000
NODE_39302_length_509_cov_5.190244	256	336	18	8	80	0.1000000
NODE_39302_length_509_cov_5.190244	256	336	19	1	80	0.0125000
NODE_39302_length_509_cov_5.190244	256	336	20	19	80	0.2375000
NODE_39309_length_509_cov_4.478049	221	301	0	80	80	1.0000000
NODE_39309_length_509_cov_4.478049	274	354	0	33	80	0.4125000
NODE_39309_length_509_cov_4.478049	274	354	2	3	80	0.0375000
NODE_39309_length_509_cov_4.478049	274	354	3	44	80	0.5500000
NODE_39311_length_509_cov_4.451220	203	283	0	80	80	1.0000000
NODE_39322_length_509_cov_3.443902	133	185	0	52	52	1.0000000
NODE_39326_length_509_cov_3.207317	367	445	0	78	78	1.0000000
NODE_39337_length_509_cov_2.853659	194	274	0	80	80	1.0000000
NODE_39480_length_509_cov_0.809756	229	272	0	43	43	1.0000000
NODE_39506_length_508_cov_22.009780	440	508	0	68	68	1.0000000
NODE_39512_length_508_cov_5.158924	248	284	0	36	36	1.0000000
NODE_39539_length_508_cov_2.662592	165	244	0	39	79	0.4936709
NODE_39539_length_508_cov_2.662592	165	244	2	15	79	0.1898734
NODE_39539_length_508_cov_2.662592	165	244	4	25	79	0.3164557
NODE_39698_length_507_cov_32.286765	0	61	3	3	61	0.0491803
NODE_39698_length_507_cov_32.286765	0	61	7	2	61	0.0327869
NODE_39698_length_507_cov_32.286765	0	61	13	3	61	0.0491803
NODE_39698_length_507_cov_32.286765	0	61	15	3	61	0.0491803
NODE_39698_length_507_cov_32.286765	0	61	17	1	61	0.0163934
NODE_39698_length_507_cov_32.286765	0	61	19	1	61	0.0163934
NODE_39698_length_507_cov_32.286765	0	61	23	4	61	0.0655738
NODE_39698_length_507_cov_32.286765	0	61	24	1	61	0.0163934
NODE_39698_length_507_cov_32.286765	0	61	26	1	61	0.0163934
NODE_39698_length_507_cov_32.286765	0	61	30	1	61	0.0163934
NODE_39698_length_507_cov_32.286765	0	61	34	1	61	0.0163934
NODE_39698_length_507_cov_32.286765	0	61	35	1	61	0.0163934
NODE_39698_length_507_cov_32.286765	0	61	39	1	61	0.0163934
NODE_39698_length_507_cov_32.286765	0	61	41	1	61	0.0163934
NODE_39698_length_507_cov_32.286765	0	61	43	2	61	0.0327869
NODE_39698_length_507_cov_32.286765	0	61	45	1	61	0.0163934
NODE_39698_length_507_cov_32.286765	0	61	51	2	61	0.0327869
NODE_39698_length_507_cov_32.286765	0	61	53	1	61	0.0163934
NODE_39698_length_507_cov_32.286765	0	61	55	1	61	0.0163934
NODE_39698_length_507_cov_32.286765	0	61	59	1	61	0.0163934
NODE_39698_length_507_cov_32.286765	0	61	62	2	61	0.0327869
NODE_39698_length_507_cov_32.286765	0	61	63	2	61	0.0327869
NODE_39698_length_507_cov_32.286765	0	61	67	14	61	0.2295082
NODE_39698_length_507_cov_32.286765	0	61	69	4	61	0.0655738
NODE_39698_length_507_cov_32.286765	0	61	71	1	61	0.0163934
NODE_39698_length_507_cov_32.286765	0	61	73	1	61	0.0163934
NODE_39698_length_507_cov_32.286765	0	61	79	5	61	0.0819672
NODE_39698_length_507_cov_32.286765	53	97	69	1	44	0.0227273
NODE_39698_length_507_cov_32.286765	53	97	71	1	44	0.0227273
NODE_39698_length_507_cov_32.286765	53	97	73	1	44	0.0227273
NODE_39698_length_507_cov_32.286765	53	97	79	5	44	0.1136364
NODE_39698_length_507_cov_32.286765	53	97	81	1	44	0.0227273
NODE_39698_length_507_cov_32.286765	53	97	87	1	44	0.0227273
NODE_39698_length_507_cov_32.286765	53	97	90	1	44	0.0227273
NODE_39698_length_507_cov_32.286765	53	97	92	3	44	0.0681818
NODE_39698_length_507_cov_32.286765	53	97	98	2	44	0.0454545
NODE_39698_length_507_cov_32.286765	53	97	100	3	44	0.0681818
NODE_39698_length_507_cov_32.286765	53	97	102	1	44	0.0227273
NODE_39698_length_507_cov_32.286765	53	97	104	1	44	0.0227273
NODE_39698_length_507_cov_32.286765	53	97	107	1	44	0.0227273
NODE_39698_length_507_cov_32.286765	53	97	109	3	44	0.0681818
NODE_39698_length_507_cov_32.286765	53	97	115	1	44	0.0227273
NODE_39698_length_507_cov_32.286765	53	97	117	1	44	0.0227273
NODE_39698_length_507_cov_32.286765	53	97	119	1	44	0.0227273
NODE_39698_length_507_cov_32.286765	53	97	121	1	44	0.0227273
NODE_39698_length_507_cov_32.286765	53	97	123	2	44	0.0454545
NODE_39698_length_507_cov_32.286765	53	97	130	2	44	0.0454545
NODE_39698_length_507_cov_32.286765	53	97	133	3	44	0.0681818
NODE_39698_length_507_cov_32.286765	53	97	135	4	44	0.0909091
NODE_39698_length_507_cov_32.286765	53	97	137	1	44	0.0227273
NODE_39698_length_507_cov_32.286765	53	97	138	2	44	0.0454545
NODE_39698_length_507_cov_32.286765	53	97	140	1	44	0.0227273
NODE_39701_length_507_cov_7.553922	203	283	12	2	80	0.0250000
NODE_39701_length_507_cov_7.553922	203	283	14	6	80	0.0750000
NODE_39701_length_507_cov_7.553922	203	283	16	24	80	0.3000000
NODE_39701_length_507_cov_7.553922	203	283	20	1	80	0.0125000
NODE_39701_length_507_cov_7.553922	203	283	22	5	80	0.0625000
NODE_39701_length_507_cov_7.553922	203	283	24	30	80	0.3750000
NODE_39701_length_507_cov_7.553922	203	283	26	12	80	0.1500000
NODE_39709_length_507_cov_5.154412	296	362	2	66	66	1.0000000
NODE_39714_length_507_cov_4.710784	248	328	2	80	80	1.0000000
NODE_39714_length_507_cov_4.710784	308	379	0	46	71	0.6478873
NODE_39714_length_507_cov_4.710784	308	379	1	4	71	0.0563380
NODE_39714_length_507_cov_4.710784	308	379	2	21	71	0.2957746
NODE_39728_length_507_cov_3.649510	80	109	8	13	29	0.4482759
NODE_39728_length_507_cov_3.649510	80	109	10	6	29	0.2068966
NODE_39728_length_507_cov_3.649510	80	109	12	10	29	0.3448276
NODE_39728_length_507_cov_3.649510	184	266	16	2	82	0.0243902
NODE_39728_length_507_cov_3.649510	184	266	18	16	82	0.1951219
NODE_39728_length_507_cov_3.649510	184	266	20	18	82	0.2195122
NODE_39728_length_507_cov_3.649510	184	266	22	19	82	0.2317073
NODE_39728_length_507_cov_3.649510	184	266	24	17	82	0.2073171
NODE_39728_length_507_cov_3.649510	184	266	26	10	82	0.1219512
NODE_39728_length_507_cov_3.649510	189	273	16	9	84	0.1071429
NODE_39728_length_507_cov_3.649510	189	273	18	16	84	0.1904762
NODE_39728_length_507_cov_3.649510	189	273	20	18	84	0.2142857
NODE_39728_length_507_cov_3.649510	189	273	22	19	84	0.2261905
NODE_39728_length_507_cov_3.649510	189	273	24	14	84	0.1666667
NODE_39728_length_507_cov_3.649510	189	273	26	8	84	0.0952381
NODE_39728_length_507_cov_3.649510	207	266	16	2	59	0.0338983
NODE_39728_length_507_cov_3.649510	207	266	18	16	59	0.2711864
NODE_39728_length_507_cov_3.649510	207	266	20	18	59	0.3050847
NODE_39728_length_507_cov_3.649510	207	266	22	6	59	0.1016949
NODE_39728_length_507_cov_3.649510	207	266	24	9	59	0.1525424
NODE_39728_length_507_cov_3.649510	207	266	26	8	59	0.1355932
NODE_39747_length_507_cov_2.754902	345	425	0	48	80	0.6000000
NODE_39747_length_507_cov_2.754902	345	425	2	32	80	0.4000000
NODE_39747_length_507_cov_2.754902	428	463	2	35	35	1.0000000
NODE_39918_length_506_cov_31.987715	71	156	6	18	85	0.2117647
NODE_39918_length_506_cov_31.987715	71	156	10	38	85	0.4470588
NODE_39918_length_506_cov_31.987715	71	156	12	10	85	0.1176471
NODE_39918_length_506_cov_31.987715	71	156	14	19	85	0.2235294
NODE_39918_length_506_cov_31.987715	71	156	6	18	85	0.2117647
NODE_39918_length_506_cov_31.987715	71	156	10	38	85	0.4470588
NODE_39918_length_506_cov_31.987715	71	156	12	10	85	0.1176471
NODE_39918_length_506_cov_31.987715	71	156	14	19	85	0.2235294
NODE_39918_length_506_cov_31.987715	71	156	6	18	85	0.2117647
NODE_39918_length_506_cov_31.987715	71	156	10	38	85	0.4470588
NODE_39918_length_506_cov_31.987715	71	156	12	10	85	0.1176471
NODE_39918_length_506_cov_31.987715	71	156	14	19	85	0.2235294
NODE_39918_length_506_cov_31.987715	129	209	4	2	80	0.0250000
NODE_39918_length_506_cov_31.987715	129	209	8	2	80	0.0250000
NODE_39918_length_506_cov_31.987715	129	209	10	33	80	0.4125000
NODE_39918_length_506_cov_31.987715	129	209	12	26	80	0.3250000
NODE_39918_length_506_cov_31.987715	129	209	14	17	80	0.2125000
NODE_39919_length_506_cov_15.877150	210	279	0	69	69	1.0000000
NODE_39920_length_506_cov_15.461916	334	414	0	32	80	0.4000000
NODE_39920_length_506_cov_15.461916	334	414	2	48	80	0.6000000
NODE_39920_length_506_cov_15.461916	387	467	0	50	80	0.6250000
NODE_39920_length_506_cov_15.461916	387	467	2	30	80	0.3750000
NODE_39921_length_506_cov_9.749386	197	276	0	79	79	1.0000000
NODE_39921_length_506_cov_9.749386	249	329	0	80	80	1.0000000
NODE_39947_length_506_cov_3.122850	218	298	0	80	80	1.0000000
NODE_39947_length_506_cov_3.122850	271	351	0	80	80	1.0000000
NODE_39951_length_506_cov_2.894349	190	270	0	80	80	1.0000000
NODE_40133_length_505_cov_35.541872	373	453	0	11	80	0.1375000
NODE_40133_length_505_cov_35.541872	373	453	2	8	80	0.1000000
NODE_40133_length_505_cov_35.541872	373	453	6	61	80	0.7625000
NODE_40135_length_505_cov_10.339901	30	110	0	18	80	0.2250000
NODE_40135_length_505_cov_10.339901	30	110	1	43	80	0.5375000
NODE_40135_length_505_cov_10.339901	30	110	2	19	80	0.2375000
NODE_40135_length_505_cov_10.339901	83	163	1	8	80	0.1000000
NODE_40135_length_505_cov_10.339901	83	163	2	72	80	0.9000000
NODE_40158_length_505_cov_3.554187	225	305	0	80	80	1.0000000
NODE_40158_length_505_cov_3.554187	278	358	0	80	80	1.0000000
NODE_40160_length_505_cov_3.403941	207	287	0	80	80	1.0000000
NODE_40175_length_505_cov_2.975369	162	227	0	65	65	1.0000000
NODE_40222_length_505_cov_1.864532	55	126	0	2	71	0.0281690
NODE_40222_length_505_cov_1.864532	55	126	2	26	71	0.3661972
NODE_40222_length_505_cov_1.864532	55	126	4	43	71	0.6056338
NODE_40368_length_504_cov_115.891358	122	202	201	1	80	0.0125000
NODE_40368_length_504_cov_115.891358	122	202	205	1	80	0.0125000
NODE_40368_length_504_cov_115.891358	122	202	218	1	80	0.0125000
NODE_40368_length_504_cov_115.891358	122	202	219	1	80	0.0125000
NODE_40368_length_504_cov_115.891358	122	202	220	1	80	0.0125000
NODE_40368_length_504_cov_115.891358	122	202	233	2	80	0.0250000
NODE_40368_length_504_cov_115.891358	122	202	235	1	80	0.0125000
NODE_40368_length_504_cov_115.891358	122	202	236	4	80	0.0500000
NODE_40368_length_504_cov_115.891358	122	202	237	1	80	0.0125000
NODE_40368_length_504_cov_115.891358	122	202	238	4	80	0.0500000
NODE_40368_length_504_cov_115.891358	122	202	239	1	80	0.0125000
NODE_40368_length_504_cov_115.891358	122	202	240	1	80	0.0125000
NODE_40368_length_504_cov_115.891358	122	202	242	4	80	0.0500000
NODE_40368_length_504_cov_115.891358	122	202	244	3	80	0.0375000
NODE_40368_length_504_cov_115.891358	122	202	245	1	80	0.0125000
NODE_40368_length_504_cov_115.891358	122	202	246	2	80	0.0250000
NODE_40368_length_504_cov_115.891358	122	202	257	1	80	0.0125000
NODE_40368_length_504_cov_115.891358	122	202	258	2	80	0.0250000
NODE_40368_length_504_cov_115.891358	122	202	265	3	80	0.0375000
NODE_40368_length_504_cov_115.891358	122	202	266	1	80	0.0125000
NODE_40368_length_504_cov_115.891358	122	202	267	1	80	0.0125000
NODE_40368_length_504_cov_115.891358	122	202	268	3	80	0.0375000
NODE_40368_length_504_cov_115.891358	122	202	269	2	80	0.0250000
NODE_40368_length_504_cov_115.891358	122	202	270	2	80	0.0250000
NODE_40368_length_504_cov_115.891358	122	202	272	1	80	0.0125000
NODE_40368_length_504_cov_115.891358	122	202	273	1	80	0.0125000
NODE_40368_length_504_cov_115.891358	122	202	278	2	80	0.0250000
NODE_40368_length_504_cov_115.891358	122	202	280	3	80	0.0375000
NODE_40368_length_504_cov_115.891358	122	202	281	3	80	0.0375000
NODE_40368_length_504_cov_115.891358	122	202	282	1	80	0.0125000
NODE_40368_length_504_cov_115.891358	122	202	284	1	80	0.0125000
NODE_40368_length_504_cov_115.891358	122	202	285	1	80	0.0125000
NODE_40368_length_504_cov_115.891358	122	202	303	1	80	0.0125000
NODE_40368_length_504_cov_115.891358	122	202	307	1	80	0.0125000
NODE_40368_length_504_cov_115.891358	122	202	311	2	80	0.0250000
NODE_40368_length_504_cov_115.891358	122	202	312	1	80	0.0125000
NODE_40368_length_504_cov_115.891358	122	202	313	3	80	0.0375000
NODE_40368_length_504_cov_115.891358	122	202	315	1	80	0.0125000
NODE_40368_length_504_cov_115.891358	122	202	316	1	80	0.0125000
NODE_40368_length_504_cov_115.891358	122	202	317	1	80	0.0125000
NODE_40368_length_504_cov_115.891358	122	202	327	1	80	0.0125000
NODE_40368_length_504_cov_115.891358	122	202	328	2	80	0.0250000
NODE_40368_length_504_cov_115.891358	122	202	329	2	80	0.0250000
NODE_40368_length_504_cov_115.891358	122	202	330	2	80	0.0250000
NODE_40368_length_504_cov_115.891358	122	202	331	2	80	0.0250000
NODE_40368_length_504_cov_115.891358	122	202	333	2	80	0.0250000
NODE_40368_length_504_cov_115.891358	122	202	337	1	80	0.0125000
NODE_40368_length_504_cov_115.891358	175	255	260	1	80	0.0125000
NODE_40368_length_504_cov_115.891358	175	255	262	1	80	0.0125000
NODE_40368_length_504_cov_115.891358	175	255	265	1	80	0.0125000
NODE_40368_length_504_cov_115.891358	175	255	266	2	80	0.0250000
NODE_40368_length_504_cov_115.891358	175	255	270	1	80	0.0125000
NODE_40368_length_504_cov_115.891358	175	255	279	2	80	0.0250000
NODE_40368_length_504_cov_115.891358	175	255	280	1	80	0.0125000
NODE_40368_length_504_cov_115.891358	175	255	281	2	80	0.0250000
NODE_40368_length_504_cov_115.891358	175	255	284	1	80	0.0125000
NODE_40368_length_504_cov_115.891358	175	255	288	2	80	0.0250000
NODE_40368_length_504_cov_115.891358	175	255	290	1	80	0.0125000
NODE_40368_length_504_cov_115.891358	175	255	292	2	80	0.0250000
NODE_40368_length_504_cov_115.891358	175	255	294	1	80	0.0125000
NODE_40368_length_504_cov_115.891358	175	255	298	2	80	0.0250000
NODE_40368_length_504_cov_115.891358	175	255	300	3	80	0.0375000
NODE_40368_length_504_cov_115.891358	175	255	301	1	80	0.0125000
NODE_40368_length_504_cov_115.891358	175	255	303	4	80	0.0500000
NODE_40368_length_504_cov_115.891358	175	255	305	1	80	0.0125000
NODE_40368_length_504_cov_115.891358	175	255	306	2	80	0.0250000
NODE_40368_length_504_cov_115.891358	175	255	307	1	80	0.0125000
NODE_40368_length_504_cov_115.891358	175	255	308	3	80	0.0375000
NODE_40368_length_504_cov_115.891358	175	255	310	2	80	0.0250000
NODE_40368_length_504_cov_115.891358	175	255	311	2	80	0.0250000
NODE_40368_length_504_cov_115.891358	175	255	312	5	80	0.0625000
NODE_40368_length_504_cov_115.891358	175	255	313	4	80	0.0500000
NODE_40368_length_504_cov_115.891358	175	255	314	1	80	0.0125000
NODE_40368_length_504_cov_115.891358	175	255	315	3	80	0.0375000
NODE_40368_length_504_cov_115.891358	175	255	316	2	80	0.0250000
NODE_40368_length_504_cov_115.891358	175	255	317	1	80	0.0125000
NODE_40368_length_504_cov_115.891358	175	255	319	3	80	0.0375000
NODE_40368_length_504_cov_115.891358	175	255	320	2	80	0.0250000
NODE_40368_length_504_cov_115.891358	175	255	321	2	80	0.0250000
NODE_40368_length_504_cov_115.891358	175	255	323	1	80	0.0125000
NODE_40368_length_504_cov_115.891358	175	255	327	1	80	0.0125000
NODE_40368_length_504_cov_115.891358	175	255	328	2	80	0.0250000
NODE_40368_length_504_cov_115.891358	175	255	329	2	80	0.0250000
NODE_40368_length_504_cov_115.891358	175	255	330	2	80	0.0250000
NODE_40368_length_504_cov_115.891358	175	255	331	3	80	0.0375000
NODE_40368_length_504_cov_115.891358	175	255	333	2	80	0.0250000
NODE_40368_length_504_cov_115.891358	175	255	335	2	80	0.0250000
NODE_40368_length_504_cov_115.891358	175	255	337	3	80	0.0375000
NODE_40369_length_504_cov_33.360494	28	108	0	15	80	0.1875000
NODE_40369_length_504_cov_33.360494	28	108	2	6	80	0.0750000
NODE_40369_length_504_cov_33.360494	28	108	4	5	80	0.0625000
NODE_40369_length_504_cov_33.360494	28	108	6	54	80	0.6750000
NODE_40369_length_504_cov_33.360494	81	161	0	14	80	0.1750000
NODE_40369_length_504_cov_33.360494	81	161	2	18	80	0.2250000
NODE_40369_length_504_cov_33.360494	81	161	4	4	80	0.0500000
NODE_40369_length_504_cov_33.360494	81	161	6	44	80	0.5500000
NODE_40370_length_504_cov_15.669136	176	256	0	80	80	1.0000000
NODE_40370_length_504_cov_15.669136	229	309	0	80	80	1.0000000
NODE_40371_length_504_cov_13.202469	134	215	0	28	81	0.3456790
NODE_40371_length_504_cov_13.202469	134	215	2	24	81	0.2962963
NODE_40371_length_504_cov_13.202469	134	215	6	29	81	0.3580247
NODE_40371_length_504_cov_13.202469	188	268	4	28	80	0.3500000
NODE_40371_length_504_cov_13.202469	188	268	6	52	80	0.6500000
NODE_40377_length_504_cov_6.770370	55	135	0	80	80	1.0000000
NODE_40377_length_504_cov_6.770370	108	188	0	80	80	1.0000000
NODE_40427_length_504_cov_2.234568	359	407	4	48	48	1.0000000
NODE_40428_length_504_cov_2.227160	307	370	0	16	63	0.2539683
NODE_40428_length_504_cov_2.227160	307	370	2	6	63	0.0952381
NODE_40428_length_504_cov_2.227160	307	370	4	41	63	0.6507937
NODE_40434_length_504_cov_2.116049	245	325	2	80	80	1.0000000
NODE_40434_length_504_cov_2.116049	298	378	0	38	80	0.4750000
NODE_40434_length_504_cov_2.116049	298	378	2	42	80	0.5250000
NODE_40446_length_504_cov_1.925926	196	262	2	66	66	1.0000000
NODE_40601_length_503_cov_11.356436	268	348	0	27	80	0.3375000
NODE_40601_length_503_cov_11.356436	268	348	2	53	80	0.6625000
NODE_40601_length_503_cov_11.356436	321	401	0	80	80	1.0000000
NODE_40615_length_503_cov_5.537129	314	381	0	67	67	1.0000000
NODE_40645_length_503_cov_3.012376	264	285	0	21	21	1.0000000
NODE_40652_length_503_cov_2.757426	266	334	5	2	68	0.0294118
NODE_40652_length_503_cov_2.757426	266	334	12	2	68	0.0294118
NODE_40652_length_503_cov_2.757426	266	334	14	3	68	0.0441176
NODE_40652_length_503_cov_2.757426	266	334	16	28	68	0.4117647
NODE_40652_length_503_cov_2.757426	266	334	18	33	68	0.4852941
NODE_40652_length_503_cov_2.757426	307	387	4	13	80	0.1625000
NODE_40652_length_503_cov_2.757426	307	387	6	7	80	0.0875000
NODE_40652_length_503_cov_2.757426	307	387	8	6	80	0.0750000
NODE_40652_length_503_cov_2.757426	307	387	13	1	80	0.0125000
NODE_40652_length_503_cov_2.757426	307	387	14	4	80	0.0500000
NODE_40652_length_503_cov_2.757426	307	387	16	34	80	0.4250000
NODE_40652_length_503_cov_2.757426	307	387	18	15	80	0.1875000
NODE_40655_length_503_cov_2.705446	158	237	0	79	79	1.0000000
NODE_40655_length_503_cov_2.705446	211	291	0	33	80	0.4125000
NODE_40655_length_503_cov_2.705446	211	291	2	47	80	0.5875000
NODE_40656_length_503_cov_2.705446	251	331	0	14	80	0.1750000
NODE_40656_length_503_cov_2.705446	251	331	2	51	80	0.6375000
NODE_40656_length_503_cov_2.705446	251	331	4	15	80	0.1875000
NODE_40656_length_503_cov_2.705446	251	321	0	14	70	0.2000000
NODE_40656_length_503_cov_2.705446	251	321	2	41	70	0.5857143
NODE_40656_length_503_cov_2.705446	251	321	4	15	70	0.2142857
NODE_40656_length_503_cov_2.705446	330	384	2	54	54	1.0000000
NODE_40656_length_503_cov_2.705446	338	384	2	46	46	1.0000000
NODE_40664_length_503_cov_2.584158	95	163	0	68	68	1.0000000
NODE_40857_length_502_cov_45.292804	353	433	8	4	80	0.0500000
NODE_40857_length_502_cov_45.292804	353	433	10	44	80	0.5500000
NODE_40857_length_502_cov_45.292804	353	433	12	25	80	0.3125000
NODE_40857_length_502_cov_45.292804	353	433	14	7	80	0.0875000
NODE_40864_length_502_cov_5.980149	305	381	0	11	76	0.1447368
NODE_40864_length_502_cov_5.980149	305	381	2	24	76	0.3157895
NODE_40864_length_502_cov_5.980149	305	381	4	5	76	0.0657895
NODE_40864_length_502_cov_5.980149	305	381	6	36	76	0.4736842
NODE_41070_length_501_cov_208.708955	288	350	107	1	62	0.0161290
NODE_41070_length_501_cov_208.708955	288	350	110	2	62	0.0322581
NODE_41070_length_501_cov_208.708955	288	350	119	1	62	0.0161290
NODE_41070_length_501_cov_208.708955	288	350	122	1	62	0.0161290
NODE_41070_length_501_cov_208.708955	288	350	129	1	62	0.0161290
NODE_41070_length_501_cov_208.708955	288	350	130	1	62	0.0161290
NODE_41070_length_501_cov_208.708955	288	350	133	1	62	0.0161290
NODE_41070_length_501_cov_208.708955	288	350	135	1	62	0.0161290
NODE_41070_length_501_cov_208.708955	288	350	137	1	62	0.0161290
NODE_41070_length_501_cov_208.708955	288	350	151	1	62	0.0161290
NODE_41070_length_501_cov_208.708955	288	350	170	1	62	0.0161290
NODE_41070_length_501_cov_208.708955	288	350	175	1	62	0.0161290
NODE_41070_length_501_cov_208.708955	288	350	183	1	62	0.0161290
NODE_41070_length_501_cov_208.708955	288	350	186	1	62	0.0161290
NODE_41070_length_501_cov_208.708955	288	350	194	1	62	0.0161290
NODE_41070_length_501_cov_208.708955	288	350	218	1	62	0.0161290
NODE_41070_length_501_cov_208.708955	288	350	226	1	62	0.0161290
NODE_41070_length_501_cov_208.708955	288	350	233	1	62	0.0161290
NODE_41070_length_501_cov_208.708955	288	350	235	2	62	0.0322581
NODE_41070_length_501_cov_208.708955	288	350	251	1	62	0.0161290
NODE_41070_length_501_cov_208.708955	288	350	259	1	62	0.0161290
NODE_41070_length_501_cov_208.708955	288	350	269	1	62	0.0161290
NODE_41070_length_501_cov_208.708955	288	350	291	1	62	0.0161290
NODE_41070_length_501_cov_208.708955	288	350	298	1	62	0.0161290
NODE_41070_length_501_cov_208.708955	288	350	299	1	62	0.0161290
NODE_41070_length_501_cov_208.708955	288	350	304	3	62	0.0483871
NODE_41070_length_501_cov_208.708955	288	350	306	1	62	0.0161290
NODE_41070_length_501_cov_208.708955	288	350	308	2	62	0.0322581
NODE_41070_length_501_cov_208.708955	288	350	310	1	62	0.0161290
NODE_41070_length_501_cov_208.708955	288	350	313	1	62	0.0161290
NODE_41070_length_501_cov_208.708955	288	350	322	1	62	0.0161290
NODE_41070_length_501_cov_208.708955	288	350	323	1	62	0.0161290
NODE_41070_length_501_cov_208.708955	288	350	326	1	62	0.0161290
NODE_41070_length_501_cov_208.708955	288	350	328	2	62	0.0322581
NODE_41070_length_501_cov_208.708955	288	350	332	2	62	0.0322581
NODE_41070_length_501_cov_208.708955	288	350	336	1	62	0.0161290
NODE_41070_length_501_cov_208.708955	288	350	340	1	62	0.0161290
NODE_41070_length_501_cov_208.708955	288	350	344	1	62	0.0161290
NODE_41070_length_501_cov_208.708955	288	350	345	1	62	0.0161290
NODE_41070_length_501_cov_208.708955	288	350	349	1	62	0.0161290
NODE_41070_length_501_cov_208.708955	288	350	350	1	62	0.0161290
NODE_41070_length_501_cov_208.708955	288	350	351	1	62	0.0161290
NODE_41070_length_501_cov_208.708955	288	350	353	2	62	0.0322581
NODE_41070_length_501_cov_208.708955	288	350	356	2	62	0.0322581
NODE_41070_length_501_cov_208.708955	288	350	364	2	62	0.0322581
NODE_41070_length_501_cov_208.708955	288	350	365	3	62	0.0483871
NODE_41070_length_501_cov_208.708955	288	350	367	1	62	0.0161290
NODE_41070_length_501_cov_208.708955	288	350	368	1	62	0.0161290
NODE_41070_length_501_cov_208.708955	288	350	370	2	62	0.0322581
NODE_41070_length_501_cov_208.708955	327	413	92	2	86	0.0232558
NODE_41070_length_501_cov_208.708955	327	413	94	2	86	0.0232558
NODE_41070_length_501_cov_208.708955	327	413	112	2	86	0.0232558
NODE_41070_length_501_cov_208.708955	327	413	135	1	86	0.0116279
NODE_41070_length_501_cov_208.708955	327	413	141	1	86	0.0116279
NODE_41070_length_501_cov_208.708955	327	413	171	1	86	0.0116279
NODE_41070_length_501_cov_208.708955	327	413	176	1	86	0.0116279
NODE_41070_length_501_cov_208.708955	327	413	199	1	86	0.0116279
NODE_41070_length_501_cov_208.708955	327	413	218	1	86	0.0116279
NODE_41070_length_501_cov_208.708955	327	413	232	1	86	0.0116279
NODE_41070_length_501_cov_208.708955	327	413	248	1	86	0.0116279
NODE_41070_length_501_cov_208.708955	327	413	258	1	86	0.0116279
NODE_41070_length_501_cov_208.708955	327	413	277	1	86	0.0116279
NODE_41070_length_501_cov_208.708955	327	413	290	1	86	0.0116279
NODE_41070_length_501_cov_208.708955	327	413	301	1	86	0.0116279
NODE_41070_length_501_cov_208.708955	327	413	303	1	86	0.0116279
NODE_41070_length_501_cov_208.708955	327	413	311	1	86	0.0116279
NODE_41070_length_501_cov_208.708955	327	413	315	1	86	0.0116279
NODE_41070_length_501_cov_208.708955	327	413	319	1	86	0.0116279
NODE_41070_length_501_cov_208.708955	327	413	323	4	86	0.0465116
NODE_41070_length_501_cov_208.708955	327	413	328	1	86	0.0116279
NODE_41070_length_501_cov_208.708955	327	413	331	1	86	0.0116279
NODE_41070_length_501_cov_208.708955	327	413	332	2	86	0.0232558
NODE_41070_length_501_cov_208.708955	327	413	333	1	86	0.0116279
NODE_41070_length_501_cov_208.708955	327	413	336	1	86	0.0116279
NODE_41070_length_501_cov_208.708955	327	413	337	1	86	0.0116279
NODE_41070_length_501_cov_208.708955	327	413	339	2	86	0.0232558
NODE_41070_length_501_cov_208.708955	327	413	340	1	86	0.0116279
NODE_41070_length_501_cov_208.708955	327	413	341	1	86	0.0116279
NODE_41070_length_501_cov_208.708955	327	413	343	4	86	0.0465116
NODE_41070_length_501_cov_208.708955	327	413	344	1	86	0.0116279
NODE_41070_length_501_cov_208.708955	327	413	345	4	86	0.0465116
NODE_41070_length_501_cov_208.708955	327	413	349	4	86	0.0465116
NODE_41070_length_501_cov_208.708955	327	413	350	1	86	0.0116279
NODE_41070_length_501_cov_208.708955	327	413	351	5	86	0.0581395
NODE_41070_length_501_cov_208.708955	327	413	352	3	86	0.0348837
NODE_41070_length_501_cov_208.708955	327	413	353	2	86	0.0232558
NODE_41070_length_501_cov_208.708955	327	413	355	3	86	0.0348837
NODE_41070_length_501_cov_208.708955	327	413	356	2	86	0.0232558
NODE_41070_length_501_cov_208.708955	327	413	357	2	86	0.0232558
NODE_41070_length_501_cov_208.708955	327	413	364	4	86	0.0465116
NODE_41070_length_501_cov_208.708955	327	413	365	3	86	0.0348837
NODE_41070_length_501_cov_208.708955	327	413	367	1	86	0.0116279
NODE_41070_length_501_cov_208.708955	327	413	368	3	86	0.0348837
NODE_41070_length_501_cov_208.708955	327	413	370	3	86	0.0348837
NODE_41070_length_501_cov_208.708955	327	413	372	3	86	0.0348837
NODE_41070_length_501_cov_208.708955	327	413	373	1	86	0.0116279
NODE_41071_length_501_cov_29.126866	23	103	2	32	80	0.4000000
NODE_41071_length_501_cov_29.126866	23	103	4	13	80	0.1625000
NODE_41071_length_501_cov_29.126866	23	103	10	31	80	0.3875000
NODE_41071_length_501_cov_29.126866	23	103	12	4	80	0.0500000
NODE_41071_length_501_cov_29.126866	76	156	10	46	80	0.5750000
NODE_41071_length_501_cov_29.126866	76	156	12	34	80	0.4250000
NODE_41072_length_501_cov_23.736318	85	165	0	80	80	1.0000000
NODE_41072_length_501_cov_23.736318	138	218	0	80	80	1.0000000
NODE_41075_length_501_cov_7.820896	270	350	0	8	80	0.1000000
NODE_41075_length_501_cov_7.820896	270	350	4	62	80	0.7750000
NODE_41075_length_501_cov_7.820896	270	350	6	10	80	0.1250000
NODE_41075_length_501_cov_7.820896	323	403	4	17	80	0.2125000
NODE_41075_length_501_cov_7.820896	323	403	6	22	80	0.2750000
NODE_41075_length_501_cov_7.820896	323	403	8	19	80	0.2375000
NODE_41075_length_501_cov_7.820896	323	403	10	7	80	0.0875000
NODE_41075_length_501_cov_7.820896	323	403	12	15	80	0.1875000
NODE_41080_length_501_cov_6.437811	309	389	0	80	80	1.0000000
NODE_41097_length_501_cov_3.656716	289	312	0	23	23	1.0000000
NODE_41097_length_501_cov_3.656716	355	420	0	65	65	1.0000000
NODE_41103_length_501_cov_3.477612	329	409	4	18	80	0.2250000
NODE_41103_length_501_cov_3.477612	329	409	6	62	80	0.7750000
NODE_41109_length_501_cov_3.134328	266	345	0	6	79	0.0759494
NODE_41109_length_501_cov_3.134328	266	345	2	53	79	0.6708861
NODE_41109_length_501_cov_3.134328	266	345	4	20	79	0.2531646
NODE_41308_length_500_cov_77.895262	456	500	4	19	44	0.4318182
NODE_41308_length_500_cov_77.895262	456	500	6	20	44	0.4545455
NODE_41308_length_500_cov_77.895262	456	500	10	5	44	0.1136364
NODE_41309_length_500_cov_35.805486	326	406	4	8	80	0.1000000
NODE_41309_length_500_cov_35.805486	326	406	6	72	80	0.9000000
NODE_41309_length_500_cov_35.805486	379	459	0	33	80	0.4125000
NODE_41309_length_500_cov_35.805486	379	459	2	12	80	0.1500000
NODE_41309_length_500_cov_35.805486	379	459	4	13	80	0.1625000
NODE_41309_length_500_cov_35.805486	379	459	6	22	80	0.2750000
NODE_41310_length_500_cov_13.084788	160	221	8	8	61	0.1311475
NODE_41310_length_500_cov_13.084788	160	221	10	20	61	0.3278688
NODE_41310_length_500_cov_13.084788	160	221	12	33	61	0.5409836
NODE_41311_length_500_cov_12.650873	215	295	0	80	80	1.0000000
NODE_41311_length_500_cov_12.650873	268	348	0	80	80	1.0000000
NODE_41312_length_500_cov_12.009975	203	268	8	2	65	0.0307692
NODE_41312_length_500_cov_12.009975	203	268	10	9	65	0.1384615
NODE_41312_length_500_cov_12.009975	203	268	12	45	65	0.6923077
NODE_41312_length_500_cov_12.009975	203	268	14	9	65	0.1384615
NODE_41312_length_500_cov_12.009975	241	321	4	6	80	0.0750000
NODE_41312_length_500_cov_12.009975	241	321	8	2	80	0.0250000
NODE_41312_length_500_cov_12.009975	241	321	10	55	80	0.6875000
NODE_41312_length_500_cov_12.009975	241	321	12	17	80	0.2125000
NODE_41325_length_500_cov_4.653367	224	295	0	71	71	1.0000000
NODE_41415_length_500_cov_1.650873	355	435	0	80	80	1.0000000
NODE_41415_length_500_cov_1.650873	408	488	0	80	80	1.0000000
NODE_41462_length_500_cov_1.231920	169	212	0	2	43	0.0465116
NODE_41462_length_500_cov_1.231920	169	212	2	29	43	0.6744186
NODE_41462_length_500_cov_1.231920	169	212	4	12	43	0.2790698
NODE_41542_length_499_cov_358.730000	425	492	8	1	67	0.0149254
NODE_41542_length_499_cov_358.730000	425	492	16	3	67	0.0447761
NODE_41542_length_499_cov_358.730000	425	492	20	2	67	0.0298507
NODE_41542_length_499_cov_358.730000	425	492	22	1	67	0.0149254
NODE_41542_length_499_cov_358.730000	425	492	24	3	67	0.0447761
NODE_41542_length_499_cov_358.730000	425	492	26	2	67	0.0298507
NODE_41542_length_499_cov_358.730000	425	492	32	1	67	0.0149254
NODE_41542_length_499_cov_358.730000	425	492	36	2	67	0.0298507
NODE_41542_length_499_cov_358.730000	425	492	43	1	67	0.0149254
NODE_41542_length_499_cov_358.730000	425	492	45	3	67	0.0447761
NODE_41542_length_499_cov_358.730000	425	492	47	2	67	0.0298507
NODE_41542_length_499_cov_358.730000	425	492	53	1	67	0.0149254
NODE_41542_length_499_cov_358.730000	425	492	55	1	67	0.0149254
NODE_41542_length_499_cov_358.730000	425	492	57	4	67	0.0597015
NODE_41542_length_499_cov_358.730000	425	492	59	1	67	0.0149254
NODE_41542_length_499_cov_358.730000	425	492	61	1	67	0.0149254
NODE_41542_length_499_cov_358.730000	425	492	63	1	67	0.0149254
NODE_41542_length_499_cov_358.730000	425	492	67	5	67	0.0746269
NODE_41542_length_499_cov_358.730000	425	492	75	1	67	0.0149254
NODE_41542_length_499_cov_358.730000	425	492	77	2	67	0.0298507
NODE_41542_length_499_cov_358.730000	425	492	84	1	67	0.0149254
NODE_41542_length_499_cov_358.730000	425	492	86	1	67	0.0149254
NODE_41542_length_499_cov_358.730000	425	492	92	1	67	0.0149254
NODE_41542_length_499_cov_358.730000	425	492	97	1	67	0.0149254
NODE_41542_length_499_cov_358.730000	425	492	100	2	67	0.0298507
NODE_41542_length_499_cov_358.730000	425	492	104	4	67	0.0597015
NODE_41542_length_499_cov_358.730000	425	492	109	3	67	0.0447761
NODE_41542_length_499_cov_358.730000	425	492	113	2	67	0.0298507
NODE_41542_length_499_cov_358.730000	425	492	117	4	67	0.0597015
NODE_41542_length_499_cov_358.730000	425	492	119	3	67	0.0447761
NODE_41542_length_499_cov_358.730000	425	492	125	3	67	0.0447761
NODE_41542_length_499_cov_358.730000	425	492	127	1	67	0.0149254
NODE_41542_length_499_cov_358.730000	425	492	129	2	67	0.0298507
NODE_41542_length_499_cov_358.730000	425	492	133	1	67	0.0149254
NODE_41543_length_499_cov_21.135000	52	132	0	80	80	1.0000000
NODE_41543_length_499_cov_21.135000	105	185	0	44	80	0.5500000
NODE_41543_length_499_cov_21.135000	105	185	2	18	80	0.2250000
NODE_41543_length_499_cov_21.135000	105	185	4	18	80	0.2250000
NODE_41544_length_499_cov_11.917500	50	130	0	40	80	0.5000000
NODE_41544_length_499_cov_11.917500	50	130	2	40	80	0.5000000
NODE_41544_length_499_cov_11.917500	103	183	2	80	80	1.0000000
NODE_41549_length_499_cov_5.007500	0	54	0	54	54	1.0000000
NODE_41563_length_499_cov_3.482500	307	336	14	4	29	0.1379310
NODE_41563_length_499_cov_3.482500	307	336	16	6	29	0.2068966
NODE_41563_length_499_cov_3.482500	307	336	18	18	29	0.6206896
NODE_41563_length_499_cov_3.482500	307	336	20	1	29	0.0344828
NODE_41594_length_499_cov_2.420000	198	247	0	19	49	0.3877551
NODE_41594_length_499_cov_2.420000	198	247	1	2	49	0.0408163
NODE_41594_length_499_cov_2.420000	198	247	2	28	49	0.5714286
NODE_41662_length_499_cov_1.445000	311	372	0	38	61	0.6229508
NODE_41662_length_499_cov_1.445000	311	372	2	23	61	0.3770492
NODE_41770_length_498_cov_31.704261	12	92	0	80	80	1.0000000
NODE_41770_length_498_cov_31.704261	65	145	0	80	80	1.0000000
NODE_41775_length_498_cov_7.002506	256	336	0	80	80	1.0000000
NODE_41780_length_498_cov_5.759398	217	247	0	30	30	1.0000000
NODE_41814_length_498_cov_3.075188	225	262	6	7	37	0.1891892
NODE_41814_length_498_cov_3.075188	225	262	8	11	37	0.2972973
NODE_41814_length_498_cov_3.075188	225	262	10	3	37	0.0810811
NODE_41814_length_498_cov_3.075188	225	262	13	1	37	0.0270270
NODE_41814_length_498_cov_3.075188	225	262	15	1	37	0.0270270
NODE_41814_length_498_cov_3.075188	225	262	20	1	37	0.0270270
NODE_41814_length_498_cov_3.075188	225	262	23	13	37	0.3513514
NODE_41814_length_498_cov_3.075188	246	324	13	1	78	0.0128205
NODE_41814_length_498_cov_3.075188	246	324	15	1	78	0.0128205
NODE_41814_length_498_cov_3.075188	246	324	20	1	78	0.0128205
NODE_41814_length_498_cov_3.075188	246	324	23	17	78	0.2179487
NODE_41814_length_498_cov_3.075188	246	324	24	1	78	0.0128205
NODE_41814_length_498_cov_3.075188	246	324	28	10	78	0.1282051
NODE_41814_length_498_cov_3.075188	246	324	30	10	78	0.1282051
NODE_41814_length_498_cov_3.075188	246	324	32	24	78	0.3076923
NODE_41814_length_498_cov_3.075188	246	324	34	13	78	0.1666667
NODE_42016_length_497_cov_44.105528	169	249	2	7	80	0.0875000
NODE_42016_length_497_cov_44.105528	169	249	4	10	80	0.1250000
NODE_42016_length_497_cov_44.105528	169	249	6	23	80	0.2875000
NODE_42016_length_497_cov_44.105528	169	249	8	34	80	0.4250000
NODE_42016_length_497_cov_44.105528	169	249	10	6	80	0.0750000
NODE_42016_length_497_cov_44.105528	222	302	2	5	80	0.0625000
NODE_42016_length_497_cov_44.105528	222	302	4	28	80	0.3500000
NODE_42016_length_497_cov_44.105528	222	302	6	5	80	0.0625000
NODE_42016_length_497_cov_44.105528	222	302	8	35	80	0.4375000
NODE_42016_length_497_cov_44.105528	222	302	10	7	80	0.0875000
NODE_42017_length_497_cov_10.145729	85	165	0	80	80	1.0000000
NODE_42017_length_497_cov_10.145729	138	226	0	88	88	1.0000000
NODE_42024_length_497_cov_6.618090	231	304	0	73	73	1.0000000
NODE_42024_length_497_cov_6.618090	284	364	0	80	80	1.0000000
NODE_42065_length_497_cov_2.889447	109	189	0	35	80	0.4375000
NODE_42065_length_497_cov_2.889447	109	189	2	14	80	0.1750000
NODE_42065_length_497_cov_2.889447	109	189	4	31	80	0.3875000
NODE_42065_length_497_cov_2.889447	162	242	2	1	80	0.0125000
NODE_42065_length_497_cov_2.889447	162	242	4	79	80	0.9875000
NODE_42071_length_497_cov_2.623116	302	368	0	41	66	0.6212121
NODE_42071_length_497_cov_2.623116	302	368	1	3	66	0.0454545
NODE_42071_length_497_cov_2.623116	302	368	2	1	66	0.0151515
NODE_42071_length_497_cov_2.623116	302	368	4	21	66	0.3181818
NODE_42071_length_497_cov_2.623116	355	406	2	24	51	0.4705882
NODE_42071_length_497_cov_2.623116	355	406	4	27	51	0.5294118
NODE_42100_length_497_cov_1.909548	106	186	6	2	80	0.0250000
NODE_42100_length_497_cov_1.909548	106	186	8	1	80	0.0125000
NODE_42100_length_497_cov_1.909548	106	186	10	2	80	0.0250000
NODE_42100_length_497_cov_1.909548	106	186	12	3	80	0.0375000
NODE_42100_length_497_cov_1.909548	106	186	14	2	80	0.0250000
NODE_42100_length_497_cov_1.909548	106	186	18	2	80	0.0250000
NODE_42100_length_497_cov_1.909548	106	186	20	10	80	0.1250000
NODE_42100_length_497_cov_1.909548	106	186	22	2	80	0.0250000
NODE_42100_length_497_cov_1.909548	106	186	24	19	80	0.2375000
NODE_42100_length_497_cov_1.909548	106	186	26	4	80	0.0500000
NODE_42100_length_497_cov_1.909548	106	186	28	11	80	0.1375000
NODE_42100_length_497_cov_1.909548	106	186	30	1	80	0.0125000
NODE_42100_length_497_cov_1.909548	106	186	32	3	80	0.0375000
NODE_42100_length_497_cov_1.909548	106	186	34	3	80	0.0375000
NODE_42100_length_497_cov_1.909548	106	186	38	1	80	0.0125000
NODE_42100_length_497_cov_1.909548	106	186	40	14	80	0.1750000
NODE_42100_length_497_cov_1.909548	159	240	28	5	81	0.0617284
NODE_42100_length_497_cov_1.909548	159	240	30	1	81	0.0123457
NODE_42100_length_497_cov_1.909548	159	240	32	6	81	0.0740741
NODE_42100_length_497_cov_1.909548	159	240	33	1	81	0.0123457
NODE_42100_length_497_cov_1.909548	159	240	34	5	81	0.0617284
NODE_42100_length_497_cov_1.909548	159	240	38	2	81	0.0246914
NODE_42100_length_497_cov_1.909548	159	240	40	25	81	0.3086420
NODE_42100_length_497_cov_1.909548	159	240	42	3	81	0.0370370
NODE_42100_length_497_cov_1.909548	159	240	46	4	81	0.0493827
NODE_42100_length_497_cov_1.909548	159	240	48	1	81	0.0123457
NODE_42100_length_497_cov_1.909548	159	240	50	2	81	0.0246914
NODE_42100_length_497_cov_1.909548	159	240	52	4	81	0.0493827
NODE_42100_length_497_cov_1.909548	159	240	58	15	81	0.1851852
NODE_42100_length_497_cov_1.909548	159	240	60	7	81	0.0864198
NODE_42100_length_497_cov_1.909548	262	324	4	1	62	0.0161290
NODE_42100_length_497_cov_1.909548	262	324	6	5	62	0.0806452
NODE_42100_length_497_cov_1.909548	262	324	7	5	62	0.0806452
NODE_42100_length_497_cov_1.909548	262	324	13	1	62	0.0161290
NODE_42100_length_497_cov_1.909548	262	324	26	1	62	0.0161290
NODE_42100_length_497_cov_1.909548	262	324	36	9	62	0.1451613
NODE_42100_length_497_cov_1.909548	262	324	39	5	62	0.0806452
NODE_42100_length_497_cov_1.909548	262	324	41	17	62	0.2741936
NODE_42100_length_497_cov_1.909548	262	324	42	2	62	0.0322581
NODE_42100_length_497_cov_1.909548	262	324	44	2	62	0.0322581
NODE_42100_length_497_cov_1.909548	262	324	46	4	62	0.0645161
NODE_42100_length_497_cov_1.909548	262	324	48	5	62	0.0806452
NODE_42100_length_497_cov_1.909548	262	324	52	5	62	0.0806452
NODE_42131_length_497_cov_1.500000	259	339	0	80	80	1.0000000
NODE_42136_length_497_cov_1.404523	211	263	0	52	52	1.0000000
NODE_42279_length_496_cov_5.619647	239	269	0	30	30	1.0000000
NODE_42281_length_496_cov_5.392947	103	168	0	65	65	1.0000000
NODE_42281_length_496_cov_5.392947	141	221	0	80	80	1.0000000
NODE_42281_length_496_cov_5.392947	217	295	0	78	78	1.0000000
NODE_42281_length_496_cov_5.392947	270	295	0	25	25	1.0000000
NODE_42287_length_496_cov_4.397985	388	467	0	79	79	1.0000000
NODE_42288_length_496_cov_4.193955	235	315	2	18	80	0.2250000
NODE_42288_length_496_cov_4.193955	235	315	4	18	80	0.2250000
NODE_42288_length_496_cov_4.193955	235	315	6	44	80	0.5500000
NODE_42297_length_496_cov_3.531486	192	273	0	20	81	0.2469136
NODE_42297_length_496_cov_3.531486	192	273	2	7	81	0.0864198
NODE_42297_length_496_cov_3.531486	192	273	5	51	81	0.6296296
NODE_42297_length_496_cov_3.531486	192	273	6	3	81	0.0370370
NODE_42297_length_496_cov_3.531486	245	325	4	16	80	0.2000000
NODE_42297_length_496_cov_3.531486	245	325	5	25	80	0.3125000
NODE_42297_length_496_cov_3.531486	245	325	6	39	80	0.4875000
NODE_42298_length_496_cov_3.377834	252	332	0	71	80	0.8875000
NODE_42298_length_496_cov_3.377834	252	332	2	9	80	0.1125000
NODE_42298_length_496_cov_3.377834	305	383	0	23	78	0.2948718
NODE_42298_length_496_cov_3.377834	305	383	2	55	78	0.7051282
NODE_42316_length_496_cov_2.659950	203	251	0	48	48	1.0000000
NODE_42328_length_496_cov_2.445844	95	165	2	70	70	1.0000000
NODE_42328_length_496_cov_2.445844	148	228	0	4	80	0.0500000
NODE_42328_length_496_cov_2.445844	148	228	2	76	80	0.9500000
NODE_42333_length_496_cov_2.214106	299	359	6	2	60	0.0333333
NODE_42333_length_496_cov_2.214106	299	359	10	2	60	0.0333333
NODE_42333_length_496_cov_2.214106	299	359	12	56	60	0.9333333
NODE_42415_length_496_cov_1.395466	273	317	0	44	44	1.0000000
NODE_42461_length_496_cov_0.979849	214	294	0	80	80	1.0000000
NODE_42525_length_495_cov_34.888889	209	264	0	55	55	1.0000000
NODE_42526_length_495_cov_12.800505	268	348	0	80	80	1.0000000
NODE_42526_length_495_cov_12.800505	321	401	0	80	80	1.0000000
NODE_42529_length_495_cov_7.080808	386	416	0	30	30	1.0000000
NODE_42548_length_495_cov_3.868687	218	298	0	8	80	0.1000000
NODE_42548_length_495_cov_3.868687	218	298	2	22	80	0.2750000
NODE_42548_length_495_cov_3.868687	218	298	4	50	80	0.6250000
NODE_42736_length_495_cov_0.792929	274	309	10	10	35	0.2857143
NODE_42736_length_495_cov_0.792929	274	309	12	25	35	0.7142857
NODE_42773_length_494_cov_20.096203	182	262	2	80	80	1.0000000
NODE_42773_length_494_cov_20.096203	235	315	2	80	80	1.0000000
NODE_42778_length_494_cov_7.498734	187	240	2	37	53	0.6981132
NODE_42778_length_494_cov_7.498734	187	240	4	16	53	0.3018868
NODE_42788_length_494_cov_4.283544	255	332	2	77	77	1.0000000
NODE_42804_length_494_cov_3.496203	209	276	0	67	67	1.0000000
NODE_42812_length_494_cov_3.032911	385	432	2	1	47	0.0212766
NODE_42812_length_494_cov_3.032911	385	432	4	8	47	0.1702128
NODE_42812_length_494_cov_3.032911	385	432	6	1	47	0.0212766
NODE_42812_length_494_cov_3.032911	385	432	8	12	47	0.2553191
NODE_42812_length_494_cov_3.032911	385	432	10	25	47	0.5319149
NODE_42816_length_494_cov_2.908861	189	269	2	2	80	0.0250000
NODE_42816_length_494_cov_2.908861	189	269	4	9	80	0.1125000
NODE_42816_length_494_cov_2.908861	189	269	6	69	80	0.8625000
NODE_42822_length_494_cov_2.777215	145	188	0	43	43	1.0000000
NODE_42834_length_494_cov_2.531646	371	430	0	15	59	0.2542373
NODE_42834_length_494_cov_2.531646	371	430	2	44	59	0.7457627
NODE_42834_length_494_cov_2.531646	428	494	0	66	66	1.0000000
NODE_43021_length_493_cov_34.946701	140	220	4	80	80	1.0000000
NODE_43021_length_493_cov_34.946701	193	265	0	36	72	0.5000000
NODE_43021_length_493_cov_34.946701	193	265	4	36	72	0.5000000
NODE_43022_length_493_cov_12.451777	173	253	0	3	80	0.0375000
NODE_43022_length_493_cov_12.451777	173	253	4	16	80	0.2000000
NODE_43022_length_493_cov_12.451777	173	253	6	61	80	0.7625000
NODE_43022_length_493_cov_12.451777	226	306	0	15	80	0.1875000
NODE_43022_length_493_cov_12.451777	226	306	2	1	80	0.0125000
NODE_43022_length_493_cov_12.451777	226	306	6	64	80	0.8000000
NODE_43025_length_493_cov_8.540609	116	146	4	30	30	1.0000000
NODE_43025_length_493_cov_8.540609	119	199	4	27	80	0.3375000
NODE_43025_length_493_cov_8.540609	119	199	6	7	80	0.0875000
NODE_43025_length_493_cov_8.540609	119	199	8	4	80	0.0500000
NODE_43025_length_493_cov_8.540609	119	199	10	6	80	0.0750000
NODE_43025_length_493_cov_8.540609	119	199	12	1	80	0.0125000
NODE_43025_length_493_cov_8.540609	119	199	16	21	80	0.2625000
NODE_43025_length_493_cov_8.540609	119	199	18	13	80	0.1625000
NODE_43025_length_493_cov_8.540609	119	199	20	1	80	0.0125000
NODE_43031_length_493_cov_6.144670	300	380	0	80	80	1.0000000
NODE_43031_length_493_cov_6.144670	353	433	0	80	80	1.0000000
NODE_43046_length_493_cov_3.840102	178	258	0	80	80	1.0000000
NODE_43046_length_493_cov_3.840102	231	311	0	80	80	1.0000000
NODE_43125_length_493_cov_1.588832	126	206	0	80	80	1.0000000
NODE_43125_length_493_cov_1.588832	179	259	0	80	80	1.0000000
NODE_43261_length_492_cov_5.488550	117	197	0	80	80	1.0000000
NODE_43261_length_492_cov_5.488550	170	250	0	80	80	1.0000000
NODE_43270_length_492_cov_4.445293	158	234	0	76	76	1.0000000
NODE_43270_length_492_cov_4.445293	207	285	0	78	78	1.0000000
NODE_43273_length_492_cov_4.244275	272	315	0	43	43	1.0000000
NODE_43293_length_492_cov_3.297710	113	193	0	80	80	1.0000000
NODE_43528_length_491_cov_17.196429	138	218	0	47	80	0.5875000
NODE_43528_length_491_cov_17.196429	138	218	2	33	80	0.4125000
NODE_43528_length_491_cov_17.196429	191	271	0	17	80	0.2125000
NODE_43528_length_491_cov_17.196429	191	271	2	63	80	0.7875000
NODE_43529_length_491_cov_17.193878	77	157	0	80	80	1.0000000
NODE_43529_length_491_cov_17.193878	130	210	0	80	80	1.0000000
NODE_43535_length_491_cov_5.505102	215	284	2	50	69	0.7246377
NODE_43535_length_491_cov_5.505102	215	284	4	19	69	0.2753623
NODE_43535_length_491_cov_5.505102	215	295	2	61	80	0.7625000
NODE_43535_length_491_cov_5.505102	215	295	4	19	80	0.2375000
NODE_43535_length_491_cov_5.505102	268	348	2	80	80	1.0000000
NODE_43536_length_491_cov_5.477041	169	222	0	53	53	1.0000000
NODE_43546_length_491_cov_4.176020	383	449	2	66	66	1.0000000
NODE_43546_length_491_cov_4.176020	422	476	0	4	54	0.0740741
NODE_43546_length_491_cov_4.176020	422	476	2	50	54	0.9259259
NODE_43570_length_491_cov_2.887755	348	428	0	58	80	0.7250000
NODE_43570_length_491_cov_2.887755	348	428	4	22	80	0.2750000
NODE_43570_length_491_cov_2.887755	401	472	0	71	71	1.0000000
NODE_43575_length_491_cov_2.693878	239	316	0	10	77	0.1298701
NODE_43575_length_491_cov_2.693878	239	316	1	1	77	0.0129870
NODE_43575_length_491_cov_2.693878	239	316	2	21	77	0.2727273
NODE_43575_length_491_cov_2.693878	239	316	4	45	77	0.5844156
NODE_43744_length_490_cov_10.058824	192	272	0	53	80	0.6625000
NODE_43744_length_490_cov_10.058824	192	272	2	27	80	0.3375000
NODE_43744_length_490_cov_10.058824	245	325	2	80	80	1.0000000
NODE_43748_length_490_cov_6.652174	304	363	0	1	59	0.0169492
NODE_43748_length_490_cov_6.652174	304	363	2	2	59	0.0338983
NODE_43748_length_490_cov_6.652174	304	363	4	37	59	0.6271186
NODE_43748_length_490_cov_6.652174	304	363	6	19	59	0.3220339
NODE_43816_length_490_cov_2.212276	241	300	0	59	59	1.0000000
NODE_43816_length_490_cov_2.212276	280	358	0	78	78	1.0000000
NODE_43886_length_490_cov_1.360614	97	159	6	1	62	0.0161290
NODE_43886_length_490_cov_1.360614	97	159	8	1	62	0.0161290
NODE_43886_length_490_cov_1.360614	97	159	10	60	62	0.9677419
NODE_43886_length_490_cov_1.360614	132	212	4	10	80	0.1250000
NODE_43886_length_490_cov_1.360614	132	212	6	14	80	0.1750000
NODE_43886_length_490_cov_1.360614	132	212	8	31	80	0.3875000
NODE_43886_length_490_cov_1.360614	132	212	10	25	80	0.3125000
NODE_43993_length_489_cov_55.992308	50	130	0	35	80	0.4375000
NODE_43993_length_489_cov_55.992308	50	130	2	24	80	0.3000000
NODE_43993_length_489_cov_55.992308	50	130	6	21	80	0.2625000
NODE_43993_length_489_cov_55.992308	103	183	2	6	80	0.0750000
NODE_43993_length_489_cov_55.992308	103	183	6	74	80	0.9250000
NODE_43993_length_489_cov_55.992308	179	259	0	13	80	0.1625000
NODE_43993_length_489_cov_55.992308	179	259	3	1	80	0.0125000
NODE_43993_length_489_cov_55.992308	179	259	4	56	80	0.7000000
NODE_43993_length_489_cov_55.992308	179	259	6	10	80	0.1250000
NODE_43993_length_489_cov_55.992308	232	312	0	66	80	0.8250000
NODE_43993_length_489_cov_55.992308	232	312	3	1	80	0.0125000
NODE_43993_length_489_cov_55.992308	232	312	4	13	80	0.1625000
NODE_43994_length_489_cov_31.707692	299	384	1	35	85	0.4117647
NODE_43994_length_489_cov_31.707692	299	384	2	20	85	0.2352941
NODE_43994_length_489_cov_31.707692	299	384	3	5	85	0.0588235
NODE_43994_length_489_cov_31.707692	299	384	4	5	85	0.0588235
NODE_43994_length_489_cov_31.707692	299	384	6	20	85	0.2352941
NODE_43994_length_489_cov_31.707692	299	384	1	35	85	0.4117647
NODE_43994_length_489_cov_31.707692	299	384	2	20	85	0.2352941
NODE_43994_length_489_cov_31.707692	299	384	3	5	85	0.0588235
NODE_43994_length_489_cov_31.707692	299	384	4	5	85	0.0588235
NODE_43994_length_489_cov_31.707692	299	384	6	20	85	0.2352941
NODE_43996_length_489_cov_13.661538	227	307	0	2	80	0.0250000
NODE_43996_length_489_cov_13.661538	227	307	2	78	80	0.9750000
NODE_43996_length_489_cov_13.661538	280	358	0	53	78	0.6794872
NODE_43996_length_489_cov_13.661538	280	358	2	25	78	0.3205128
NODE_43997_length_489_cov_12.017949	214	294	0	34	80	0.4250000
NODE_43997_length_489_cov_12.017949	214	294	2	46	80	0.5750000
NODE_43997_length_489_cov_12.017949	267	347	0	14	80	0.1750000
NODE_43997_length_489_cov_12.017949	267	347	2	66	80	0.8250000
NODE_43998_length_489_cov_10.774359	262	304	0	42	42	1.0000000
NODE_44001_length_489_cov_8.094872	141	221	0	45	80	0.5625000
NODE_44001_length_489_cov_8.094872	141	221	2	35	80	0.4375000
NODE_44001_length_489_cov_8.094872	194	247	2	53	53	1.0000000
NODE_44007_length_489_cov_5.284615	176	256	0	23	80	0.2875000
NODE_44007_length_489_cov_5.284615	176	256	2	57	80	0.7125000
NODE_44007_length_489_cov_5.284615	229	309	0	40	80	0.5000000
NODE_44007_length_489_cov_5.284615	229	309	2	40	80	0.5000000
NODE_44096_length_489_cov_1.646154	234	278	0	1	44	0.0227273
NODE_44096_length_489_cov_1.646154	234	278	2	4	44	0.0909091
NODE_44096_length_489_cov_1.646154	234	278	3	1	44	0.0227273
NODE_44096_length_489_cov_1.646154	234	278	4	38	44	0.8636364
NODE_44105_length_489_cov_1.574359	351	391	2	40	40	1.0000000
NODE_44105_length_489_cov_1.574359	351	383	2	32	32	1.0000000
NODE_44105_length_489_cov_1.574359	365	445	0	4	80	0.0500000
NODE_44105_length_489_cov_1.574359	365	445	2	76	80	0.9500000
NODE_44105_length_489_cov_1.574359	365	445	0	4	80	0.0500000
NODE_44105_length_489_cov_1.574359	365	445	2	76	80	0.9500000
NODE_44105_length_489_cov_1.574359	366	445	0	4	79	0.0506329
NODE_44105_length_489_cov_1.574359	366	445	2	75	79	0.9493671
NODE_44231_length_488_cov_15.406170	235	313	0	78	78	1.0000000
NODE_44231_length_488_cov_15.406170	286	367	0	81	81	1.0000000
NODE_44234_length_488_cov_8.416452	210	290	0	80	80	1.0000000
NODE_44234_length_488_cov_8.416452	263	343	0	80	80	1.0000000
NODE_44240_length_488_cov_6.084833	254	302	1	7	48	0.1458333
NODE_44240_length_488_cov_6.084833	254	302	2	41	48	0.8541667
NODE_44243_length_488_cov_5.434447	210	279	2	69	69	1.0000000
NODE_44243_length_488_cov_5.434447	265	300	2	35	35	1.0000000
NODE_44263_length_488_cov_3.431877	212	248	2	36	36	1.0000000
NODE_44264_length_488_cov_3.424165	320	367	0	47	47	1.0000000
NODE_44264_length_488_cov_3.424165	320	378	0	58	58	1.0000000
NODE_44264_length_488_cov_3.424165	351	393	0	42	42	1.0000000
NODE_44264_length_488_cov_3.424165	360	395	0	35	35	1.0000000
NODE_44274_length_488_cov_2.850900	276	356	0	80	80	1.0000000
NODE_44376_length_488_cov_1.562982	31	67	0	36	36	1.0000000
NODE_44496_length_487_cov_7.028351	278	358	15	6	80	0.0750000
NODE_44496_length_487_cov_7.028351	278	358	18	15	80	0.1875000
NODE_44496_length_487_cov_7.028351	278	358	19	1	80	0.0125000
NODE_44496_length_487_cov_7.028351	278	358	25	1	80	0.0125000
NODE_44496_length_487_cov_7.028351	278	358	27	11	80	0.1375000
NODE_44496_length_487_cov_7.028351	278	358	28	26	80	0.3250000
NODE_44496_length_487_cov_7.028351	278	358	32	20	80	0.2500000
NODE_44498_length_487_cov_6.804124	242	313	2	25	71	0.3521127
NODE_44498_length_487_cov_6.804124	242	313	6	2	71	0.0281690
NODE_44498_length_487_cov_6.804124	242	313	8	8	71	0.1126761
NODE_44498_length_487_cov_6.804124	242	313	10	1	71	0.0140845
NODE_44498_length_487_cov_6.804124	242	313	12	5	71	0.0704225
NODE_44498_length_487_cov_6.804124	242	313	15	1	71	0.0140845
NODE_44498_length_487_cov_6.804124	242	313	18	29	71	0.4084507
NODE_44498_length_487_cov_6.804124	286	366	0	45	80	0.5625000
NODE_44498_length_487_cov_6.804124	286	366	2	33	80	0.4125000
NODE_44498_length_487_cov_6.804124	286	366	6	2	80	0.0250000
NODE_44500_length_487_cov_5.917526	140	220	0	66	80	0.8250000
NODE_44500_length_487_cov_5.917526	140	220	2	14	80	0.1750000
NODE_44500_length_487_cov_5.917526	193	273	0	80	80	1.0000000
NODE_44520_length_487_cov_3.296392	235	315	0	37	80	0.4625000
NODE_44520_length_487_cov_3.296392	235	315	2	13	80	0.1625000
NODE_44520_length_487_cov_3.296392	235	315	4	3	80	0.0375000
NODE_44520_length_487_cov_3.296392	235	315	6	7	80	0.0875000
NODE_44520_length_487_cov_3.296392	235	315	8	20	80	0.2500000
NODE_44521_length_487_cov_3.237113	301	363	2	62	62	1.0000000
NODE_44525_length_487_cov_3.074742	214	294	0	61	80	0.7625000
NODE_44525_length_487_cov_3.074742	214	294	4	4	80	0.0500000
NODE_44525_length_487_cov_3.074742	214	294	6	15	80	0.1875000
NODE_44723_length_486_cov_6.609819	206	286	0	80	80	1.0000000
NODE_44728_length_486_cov_5.428941	147	227	0	18	80	0.2250000
NODE_44728_length_486_cov_5.428941	147	227	2	22	80	0.2750000
NODE_44728_length_486_cov_5.428941	147	227	4	40	80	0.5000000
NODE_44754_length_486_cov_3.072351	131	211	0	23	80	0.2875000
NODE_44754_length_486_cov_3.072351	131	211	2	12	80	0.1500000
NODE_44754_length_486_cov_3.072351	131	211	4	45	80	0.5625000
NODE_44754_length_486_cov_3.072351	190	235	0	45	45	1.0000000
NODE_44769_length_486_cov_2.581395	156	236	0	80	80	1.0000000
NODE_44769_length_486_cov_2.581395	209	289	0	80	80	1.0000000
NODE_44781_length_486_cov_2.343669	189	230	0	4	41	0.0975610
NODE_44781_length_486_cov_2.343669	189	230	2	27	41	0.6585366
NODE_44781_length_486_cov_2.343669	189	230	4	10	41	0.2439024
NODE_44781_length_486_cov_2.343669	242	306	2	5	64	0.0781250
NODE_44781_length_486_cov_2.343669	242	306	4	6	64	0.0937500
NODE_44781_length_486_cov_2.343669	242	306	6	53	64	0.8281250
NODE_44959_length_485_cov_29.505181	270	350	0	80	80	1.0000000
NODE_44959_length_485_cov_29.505181	323	403	0	80	80	1.0000000
NODE_44959_length_485_cov_29.505181	399	479	0	80	80	1.0000000
NODE_44960_length_485_cov_10.450777	67	153	0	86	86	1.0000000
NODE_44960_length_485_cov_10.450777	133	206	0	73	73	1.0000000
NODE_44965_length_485_cov_5.922280	196	273	0	77	77	1.0000000
NODE_44965_length_485_cov_5.922280	246	326	0	80	80	1.0000000
NODE_44966_length_485_cov_5.818653	279	359	0	20	80	0.2500000
NODE_44966_length_485_cov_5.818653	279	359	2	60	80	0.7500000
NODE_44966_length_485_cov_5.818653	332	412	0	40	80	0.5000000
NODE_44966_length_485_cov_5.818653	332	412	2	40	80	0.5000000
NODE_44968_length_485_cov_5.670984	321	396	0	75	75	1.0000000
NODE_44992_length_485_cov_3.518135	162	210	4	3	48	0.0625000
NODE_44992_length_485_cov_3.518135	162	210	6	45	48	0.9375000
NODE_45005_length_485_cov_2.790155	193	253	0	60	60	1.0000000
NODE_45021_length_485_cov_2.427461	170	249	0	79	79	1.0000000
NODE_45100_length_485_cov_1.264249	232	251	0	19	19	1.0000000
NODE_45193_length_484_cov_33.384416	92	172	2	55	80	0.6875000
NODE_45193_length_484_cov_33.384416	92	172	3	1	80	0.0125000
NODE_45193_length_484_cov_33.384416	92	172	4	24	80	0.3000000
NODE_45193_length_484_cov_33.384416	145	225	2	74	80	0.9250000
NODE_45193_length_484_cov_33.384416	145	225	4	6	80	0.0750000
NODE_45195_length_484_cov_9.111688	136	216	0	80	80	1.0000000
NODE_45195_length_484_cov_9.111688	189	270	0	81	81	1.0000000
NODE_45196_length_484_cov_8.353247	165	244	0	79	79	1.0000000
NODE_45196_length_484_cov_8.353247	217	297	0	80	80	1.0000000
NODE_45197_length_484_cov_8.119481	108	188	0	80	80	1.0000000
NODE_45197_length_484_cov_8.119481	161	241	0	80	80	1.0000000
NODE_45200_length_484_cov_7.703896	208	288	0	80	80	1.0000000
NODE_45200_length_484_cov_7.703896	261	341	0	80	80	1.0000000
NODE_45202_length_484_cov_7.153247	230	292	16	6	62	0.0967742
NODE_45202_length_484_cov_7.153247	230	292	17	2	62	0.0322581
NODE_45202_length_484_cov_7.153247	230	292	18	5	62	0.0806452
NODE_45202_length_484_cov_7.153247	230	292	19	16	62	0.2580645
NODE_45202_length_484_cov_7.153247	230	292	20	32	62	0.5161290
NODE_45202_length_484_cov_7.153247	230	292	24	1	62	0.0161290
NODE_45204_length_484_cov_6.594805	221	301	0	80	80	1.0000000
NODE_45204_length_484_cov_6.594805	274	354	0	80	80	1.0000000
NODE_45218_length_484_cov_4.044156	267	347	0	8	80	0.1000000
NODE_45218_length_484_cov_4.044156	267	347	2	6	80	0.0750000
NODE_45218_length_484_cov_4.044156	267	347	4	66	80	0.8250000
NODE_45218_length_484_cov_4.044156	342	396	0	12	54	0.2222222
NODE_45218_length_484_cov_4.044156	342	396	2	42	54	0.7777778
NODE_45225_length_484_cov_3.787013	287	331	2	44	44	1.0000000
NODE_45225_length_484_cov_3.787013	307	386	0	50	79	0.6329114
NODE_45225_length_484_cov_3.787013	307	386	2	29	79	0.3670886
NODE_45225_length_484_cov_3.787013	317	386	0	50	69	0.7246377
NODE_45225_length_484_cov_3.787013	317	386	2	19	69	0.2753623
NODE_45276_length_484_cov_2.254545	79	132	2	53	53	1.0000000
NODE_45352_length_484_cov_1.322078	429	477	0	48	48	1.0000000
NODE_45353_length_484_cov_1.314286	431	472	0	8	41	0.1951219
NODE_45353_length_484_cov_1.314286	431	472	2	33	41	0.8048781
NODE_45459_length_483_cov_40.815104	396	473	0	77	77	1.0000000
NODE_45459_length_483_cov_40.815104	396	473	0	77	77	1.0000000
NODE_45473_length_483_cov_5.289062	124	185	0	61	61	1.0000000
NODE_45494_length_483_cov_4.114583	226	306	0	11	80	0.1375000
NODE_45494_length_483_cov_4.114583	226	306	4	69	80	0.8625000
NODE_45494_length_483_cov_4.114583	226	305	0	11	79	0.1392405
NODE_45494_length_483_cov_4.114583	226	305	4	68	79	0.8607595
NODE_45494_length_483_cov_4.114583	226	306	0	11	80	0.1375000
NODE_45494_length_483_cov_4.114583	226	306	4	69	80	0.8625000
NODE_45494_length_483_cov_4.114583	226	306	0	11	80	0.1375000
NODE_45494_length_483_cov_4.114583	226	306	4	69	80	0.8625000
NODE_45494_length_483_cov_4.114583	279	359	4	41	80	0.5125000
NODE_45494_length_483_cov_4.114583	279	359	8	39	80	0.4875000
NODE_45494_length_483_cov_4.114583	279	325	4	27	46	0.5869565
NODE_45494_length_483_cov_4.114583	279	325	8	19	46	0.4130435
NODE_45494_length_483_cov_4.114583	297	323	4	9	26	0.3461539
NODE_45494_length_483_cov_4.114583	297	323	8	17	26	0.6538461
NODE_45495_length_483_cov_4.046875	68	117	0	49	49	1.0000000
NODE_45495_length_483_cov_4.046875	184	250	0	13	66	0.1969697
NODE_45495_length_483_cov_4.046875	184	250	2	53	66	0.8030303
NODE_45635_length_483_cov_1.205729	249	291	0	42	42	1.0000000
NODE_45725_length_482_cov_37.900783	72	152	12	15	80	0.1875000
NODE_45725_length_482_cov_37.900783	72	152	15	24	80	0.3000000
NODE_45725_length_482_cov_37.900783	72	152	16	7	80	0.0875000
NODE_45725_length_482_cov_37.900783	72	152	18	4	80	0.0500000
NODE_45725_length_482_cov_37.900783	72	152	19	30	80	0.3750000
NODE_45725_length_482_cov_37.900783	125	205	0	3	80	0.0375000
NODE_45725_length_482_cov_37.900783	125	205	2	7	80	0.0875000
NODE_45725_length_482_cov_37.900783	125	205	7	25	80	0.3125000
NODE_45725_length_482_cov_37.900783	125	205	9	15	80	0.1875000
NODE_45725_length_482_cov_37.900783	125	205	19	30	80	0.3750000
NODE_45728_length_482_cov_10.545692	233	297	0	64	64	1.0000000
NODE_45729_length_482_cov_9.342037	281	333	0	52	52	1.0000000
NODE_45730_length_482_cov_8.190601	247	311	8	8	64	0.1250000
NODE_45730_length_482_cov_8.190601	247	311	12	3	64	0.0468750
NODE_45730_length_482_cov_8.190601	247	311	14	6	64	0.0937500
NODE_45730_length_482_cov_8.190601	247	311	16	26	64	0.4062500
NODE_45730_length_482_cov_8.190601	247	311	18	21	64	0.3281250
NODE_45730_length_482_cov_8.190601	284	355	2	6	71	0.0845070
NODE_45730_length_482_cov_8.190601	284	355	3	9	71	0.1267606
NODE_45730_length_482_cov_8.190601	284	355	4	24	71	0.3380282
NODE_45730_length_482_cov_8.190601	284	355	8	13	71	0.1830986
NODE_45730_length_482_cov_8.190601	284	355	12	3	71	0.0422535
NODE_45730_length_482_cov_8.190601	284	355	14	5	71	0.0704225
NODE_45730_length_482_cov_8.190601	284	355	16	11	71	0.1549296
NODE_45734_length_482_cov_6.002611	112	192	0	80	80	1.0000000
NODE_45734_length_482_cov_6.002611	165	245	0	80	80	1.0000000
NODE_45735_length_482_cov_5.953003	315	395	0	80	80	1.0000000
NODE_45735_length_482_cov_5.953003	368	441	0	73	73	1.0000000
NODE_45748_length_482_cov_4.530026	20	85	0	65	65	1.0000000
NODE_45759_length_482_cov_3.791123	278	358	0	80	80	1.0000000
NODE_45759_length_482_cov_3.791123	331	411	0	80	80	1.0000000
NODE_45842_length_482_cov_1.647520	382	446	0	64	64	1.0000000
NODE_45842_length_482_cov_1.647520	435	482	0	47	47	1.0000000
NODE_45994_length_481_cov_50.623037	154	234	2	40	80	0.5000000
NODE_45994_length_481_cov_50.623037	154	234	3	21	80	0.2625000
NODE_45994_length_481_cov_50.623037	154	234	4	19	80	0.2375000
NODE_45994_length_481_cov_50.623037	207	287	2	50	80	0.6250000
NODE_45994_length_481_cov_50.623037	207	287	3	8	80	0.1000000
NODE_45994_length_481_cov_50.623037	207	287	4	22	80	0.2750000
NODE_45995_length_481_cov_30.939791	149	198	0	28	49	0.5714286
NODE_45995_length_481_cov_30.939791	149	198	2	21	49	0.4285714
NODE_45995_length_481_cov_30.939791	171	235	0	6	64	0.0937500
NODE_45995_length_481_cov_30.939791	171	235	2	58	64	0.9062500
NODE_45995_length_481_cov_30.939791	171	235	0	6	64	0.0937500
NODE_45995_length_481_cov_30.939791	171	235	2	58	64	0.9062500
NODE_45996_length_481_cov_30.183246	0	41	0	41	41	1.0000000
NODE_45996_length_481_cov_30.183246	0	39	0	39	39	1.0000000
NODE_45996_length_481_cov_30.183246	0	44	0	44	44	1.0000000
NODE_45996_length_481_cov_30.183246	0	44	0	44	44	1.0000000
NODE_45996_length_481_cov_30.183246	0	44	0	44	44	1.0000000
NODE_45996_length_481_cov_30.183246	0	44	0	44	44	1.0000000
NODE_45996_length_481_cov_30.183246	17	97	0	40	80	0.5000000
NODE_45996_length_481_cov_30.183246	17	97	2	40	80	0.5000000
NODE_45996_length_481_cov_30.183246	17	97	0	40	80	0.5000000
NODE_45996_length_481_cov_30.183246	17	97	2	40	80	0.5000000
NODE_45996_length_481_cov_30.183246	17	97	0	40	80	0.5000000
NODE_45996_length_481_cov_30.183246	17	97	2	40	80	0.5000000
NODE_45996_length_481_cov_30.183246	17	97	0	40	80	0.5000000
NODE_45996_length_481_cov_30.183246	17	97	2	40	80	0.5000000
NODE_45996_length_481_cov_30.183246	17	97	0	40	80	0.5000000
NODE_45996_length_481_cov_30.183246	17	97	2	40	80	0.5000000
NODE_45996_length_481_cov_30.183246	17	97	0	40	80	0.5000000
NODE_45996_length_481_cov_30.183246	17	97	2	40	80	0.5000000
NODE_45997_length_481_cov_12.709424	250	330	0	73	80	0.9125000
NODE_45997_length_481_cov_12.709424	250	330	2	7	80	0.0875000
NODE_45997_length_481_cov_12.709424	303	383	0	20	80	0.2500000
NODE_45997_length_481_cov_12.709424	303	383	2	60	80	0.7500000
NODE_46037_length_481_cov_3.002618	197	277	0	80	80	1.0000000
NODE_46064_length_481_cov_2.261780	271	351	2	21	80	0.2625000
NODE_46064_length_481_cov_2.261780	271	351	4	11	80	0.1375000
NODE_46064_length_481_cov_2.261780	271	351	6	48	80	0.6000000
NODE_46256_length_480_cov_22.346457	318	398	0	19	80	0.2375000
NODE_46256_length_480_cov_22.346457	318	398	2	16	80	0.2000000
NODE_46256_length_480_cov_22.346457	318	398	4	45	80	0.5625000
NODE_46256_length_480_cov_22.346457	371	451	0	72	80	0.9000000
NODE_46256_length_480_cov_22.346457	371	451	2	8	80	0.1000000
NODE_46257_length_480_cov_16.488189	252	332	0	80	80	1.0000000
NODE_46257_length_480_cov_16.488189	305	385	0	80	80	1.0000000
NODE_46258_length_480_cov_12.874016	164	234	0	17	70	0.2428571
NODE_46258_length_480_cov_12.874016	164	234	2	2	70	0.0285714
NODE_46258_length_480_cov_12.874016	164	234	4	51	70	0.7285714
NODE_46258_length_480_cov_12.874016	207	273	4	56	66	0.8484849
NODE_46258_length_480_cov_12.874016	207	273	6	10	66	0.1515152
NODE_46260_length_480_cov_11.879265	170	250	0	3	80	0.0375000
NODE_46260_length_480_cov_11.879265	170	250	2	77	80	0.9625000
NODE_46260_length_480_cov_11.879265	223	303	0	56	80	0.7000000
NODE_46260_length_480_cov_11.879265	223	303	2	24	80	0.3000000
NODE_46261_length_480_cov_8.774278	114	143	0	29	29	1.0000000
NODE_46261_length_480_cov_8.774278	165	245	0	14	80	0.1750000
NODE_46261_length_480_cov_8.774278	165	245	6	66	80	0.8250000
NODE_46261_length_480_cov_8.774278	218	298	0	3	80	0.0375000
NODE_46261_length_480_cov_8.774278	218	298	2	19	80	0.2375000
NODE_46261_length_480_cov_8.774278	218	298	5	25	80	0.3125000
NODE_46261_length_480_cov_8.774278	218	298	6	33	80	0.4125000
NODE_46261_length_480_cov_8.774278	385	428	0	43	43	1.0000000
NODE_46271_length_480_cov_5.671916	231	302	0	71	71	1.0000000
NODE_46283_length_480_cov_4.354331	126	187	0	7	61	0.1147541
NODE_46283_length_480_cov_4.354331	126	187	2	54	61	0.8852459
NODE_46283_length_480_cov_4.354331	218	298	2	13	80	0.1625000
NODE_46283_length_480_cov_4.354331	218	298	4	67	80	0.8375000
NODE_46445_length_480_cov_1.152231	142	216	0	74	74	1.0000000
NODE_46470_length_480_cov_0.973753	31	71	0	40	40	1.0000000
NODE_46533_length_479_cov_28.205263	308	388	4	2	80	0.0250000
NODE_46533_length_479_cov_28.205263	308	388	8	4	80	0.0500000
NODE_46533_length_479_cov_28.205263	308	388	10	7	80	0.0875000
NODE_46533_length_479_cov_28.205263	308	388	12	37	80	0.4625000
NODE_46533_length_479_cov_28.205263	308	388	14	30	80	0.3750000
NODE_46533_length_479_cov_28.205263	361	441	0	11	80	0.1375000
NODE_46533_length_479_cov_28.205263	361	441	2	4	80	0.0500000
NODE_46533_length_479_cov_28.205263	361	441	3	17	80	0.2125000
NODE_46533_length_479_cov_28.205263	361	441	5	2	80	0.0250000
NODE_46533_length_479_cov_28.205263	361	441	7	5	80	0.0625000
NODE_46533_length_479_cov_28.205263	361	441	11	3	80	0.0375000
NODE_46533_length_479_cov_28.205263	361	441	12	17	80	0.2125000
NODE_46533_length_479_cov_28.205263	361	441	14	21	80	0.2625000
NODE_46534_length_479_cov_23.944737	189	269	0	80	80	1.0000000
NODE_46534_length_479_cov_23.944737	242	322	0	80	80	1.0000000
NODE_46554_length_479_cov_4.942105	283	363	0	80	80	1.0000000
NODE_46554_length_479_cov_4.942105	336	416	0	80	80	1.0000000
NODE_46574_length_479_cov_3.494737	217	279	0	31	62	0.5000000
NODE_46574_length_479_cov_3.494737	217	279	2	31	62	0.5000000
NODE_46574_length_479_cov_3.494737	272	332	0	60	60	1.0000000
NODE_46611_length_479_cov_2.281579	219	265	0	15	46	0.3260870
NODE_46611_length_479_cov_2.281579	219	265	2	3	46	0.0652174
NODE_46611_length_479_cov_2.281579	219	265	4	3	46	0.0652174
NODE_46611_length_479_cov_2.281579	219	265	6	25	46	0.5434783
NODE_46638_length_479_cov_1.839474	376	431	6	14	55	0.2545455
NODE_46638_length_479_cov_1.839474	376	431	8	17	55	0.3090909
NODE_46638_length_479_cov_1.839474	376	431	10	5	55	0.0909091
NODE_46638_length_479_cov_1.839474	376	431	12	19	55	0.3454545
NODE_46654_length_479_cov_1.710526	203	265	2	62	62	1.0000000
NODE_46654_length_479_cov_1.710526	248	318	0	22	70	0.3142857
NODE_46654_length_479_cov_1.710526	248	318	2	48	70	0.6857143
NODE_46828_length_478_cov_336.139842	153	233	137	1	80	0.0125000
NODE_46828_length_478_cov_336.139842	153	233	139	1	80	0.0125000
NODE_46828_length_478_cov_336.139842	153	233	142	1	80	0.0125000
NODE_46828_length_478_cov_336.139842	153	233	144	1	80	0.0125000
NODE_46828_length_478_cov_336.139842	153	233	147	1	80	0.0125000
NODE_46828_length_478_cov_336.139842	153	233	148	1	80	0.0125000
NODE_46828_length_478_cov_336.139842	153	233	154	1	80	0.0125000
NODE_46828_length_478_cov_336.139842	153	233	156	1	80	0.0125000
NODE_46828_length_478_cov_336.139842	153	233	161	2	80	0.0250000
NODE_46828_length_478_cov_336.139842	153	233	162	1	80	0.0125000
NODE_46828_length_478_cov_336.139842	153	233	163	1	80	0.0125000
NODE_46828_length_478_cov_336.139842	153	233	164	1	80	0.0125000
NODE_46828_length_478_cov_336.139842	153	233	167	1	80	0.0125000
NODE_46828_length_478_cov_336.139842	153	233	170	2	80	0.0250000
NODE_46828_length_478_cov_336.139842	153	233	176	2	80	0.0250000
NODE_46828_length_478_cov_336.139842	153	233	178	5	80	0.0625000
NODE_46828_length_478_cov_336.139842	153	233	179	1	80	0.0125000
NODE_46828_length_478_cov_336.139842	153	233	183	2	80	0.0250000
NODE_46828_length_478_cov_336.139842	153	233	187	2	80	0.0250000
NODE_46828_length_478_cov_336.139842	153	233	194	2	80	0.0250000
NODE_46828_length_478_cov_336.139842	153	233	201	2	80	0.0250000
NODE_46828_length_478_cov_336.139842	153	233	203	1	80	0.0125000
NODE_46828_length_478_cov_336.139842	153	233	204	5	80	0.0625000
NODE_46828_length_478_cov_336.139842	153	233	210	1	80	0.0125000
NODE_46828_length_478_cov_336.139842	153	233	218	2	80	0.0250000
NODE_46828_length_478_cov_336.139842	153	233	219	1	80	0.0125000
NODE_46828_length_478_cov_336.139842	153	233	223	1	80	0.0125000
NODE_46828_length_478_cov_336.139842	153	233	226	1	80	0.0125000
NODE_46828_length_478_cov_336.139842	153	233	234	1	80	0.0125000
NODE_46828_length_478_cov_336.139842	153	233	240	2	80	0.0250000
NODE_46828_length_478_cov_336.139842	153	233	244	2	80	0.0250000
NODE_46828_length_478_cov_336.139842	153	233	260	1	80	0.0125000
NODE_46828_length_478_cov_336.139842	153	233	262	1	80	0.0125000
NODE_46828_length_478_cov_336.139842	153	233	268	2	80	0.0250000
NODE_46828_length_478_cov_336.139842	153	233	272	1	80	0.0125000
NODE_46828_length_478_cov_336.139842	153	233	280	5	80	0.0625000
NODE_46828_length_478_cov_336.139842	153	233	282	1	80	0.0125000
NODE_46828_length_478_cov_336.139842	153	233	288	1	80	0.0125000
NODE_46828_length_478_cov_336.139842	153	233	293	2	80	0.0250000
NODE_46828_length_478_cov_336.139842	153	233	297	1	80	0.0125000
NODE_46828_length_478_cov_336.139842	153	233	298	2	80	0.0250000
NODE_46828_length_478_cov_336.139842	153	233	299	1	80	0.0125000
NODE_46828_length_478_cov_336.139842	153	233	300	6	80	0.0750000
NODE_46828_length_478_cov_336.139842	153	233	301	1	80	0.0125000
NODE_46828_length_478_cov_336.139842	153	233	302	6	80	0.0750000
NODE_46828_length_478_cov_336.139842	206	286	230	3	80	0.0375000
NODE_46828_length_478_cov_336.139842	206	286	232	1	80	0.0125000
NODE_46828_length_478_cov_336.139842	206	286	240	2	80	0.0250000
NODE_46828_length_478_cov_336.139842	206	286	250	1	80	0.0125000
NODE_46828_length_478_cov_336.139842	206	286	252	1	80	0.0125000
NODE_46828_length_478_cov_336.139842	206	286	255	1	80	0.0125000
NODE_46828_length_478_cov_336.139842	206	286	267	1	80	0.0125000
NODE_46828_length_478_cov_336.139842	206	286	270	2	80	0.0250000
NODE_46828_length_478_cov_336.139842	206	286	272	1	80	0.0125000
NODE_46828_length_478_cov_336.139842	206	286	276	2	80	0.0250000
NODE_46828_length_478_cov_336.139842	206	286	278	3	80	0.0375000
NODE_46828_length_478_cov_336.139842	206	286	279	1	80	0.0125000
NODE_46828_length_478_cov_336.139842	206	286	280	8	80	0.1000000
NODE_46828_length_478_cov_336.139842	206	286	281	1	80	0.0125000
NODE_46828_length_478_cov_336.139842	206	286	282	1	80	0.0125000
NODE_46828_length_478_cov_336.139842	206	286	283	1	80	0.0125000
NODE_46828_length_478_cov_336.139842	206	286	287	1	80	0.0125000
NODE_46828_length_478_cov_336.139842	206	286	288	1	80	0.0125000
NODE_46828_length_478_cov_336.139842	206	286	293	3	80	0.0375000
NODE_46828_length_478_cov_336.139842	206	286	295	1	80	0.0125000
NODE_46828_length_478_cov_336.139842	206	286	296	1	80	0.0125000
NODE_46828_length_478_cov_336.139842	206	286	297	2	80	0.0250000
NODE_46828_length_478_cov_336.139842	206	286	298	4	80	0.0500000
NODE_46828_length_478_cov_336.139842	206	286	299	2	80	0.0250000
NODE_46828_length_478_cov_336.139842	206	286	300	8	80	0.1000000
NODE_46828_length_478_cov_336.139842	206	286	301	1	80	0.0125000
NODE_46828_length_478_cov_336.139842	206	286	302	8	80	0.1000000
NODE_46828_length_478_cov_336.139842	206	286	304	3	80	0.0375000
NODE_46828_length_478_cov_336.139842	206	286	305	6	80	0.0750000
NODE_46828_length_478_cov_336.139842	206	286	306	3	80	0.0375000
NODE_46828_length_478_cov_336.139842	206	286	307	1	80	0.0125000
NODE_46828_length_478_cov_336.139842	206	286	308	4	80	0.0500000
NODE_46828_length_478_cov_336.139842	206	286	309	1	80	0.0125000
NODE_46846_length_478_cov_4.448549	150	230	0	80	80	1.0000000
NODE_46846_length_478_cov_4.448549	203	284	0	81	81	1.0000000
NODE_46874_length_478_cov_2.627968	228	278	0	49	50	0.9800000
NODE_46874_length_478_cov_2.627968	228	278	3	1	50	0.0200000
NODE_47128_length_477_cov_36.230159	225	305	0	80	80	1.0000000
NODE_47128_length_477_cov_36.230159	278	358	0	80	80	1.0000000
NODE_47129_length_477_cov_33.111111	307	387	9	5	80	0.0625000
NODE_47129_length_477_cov_33.111111	307	387	10	4	80	0.0500000
NODE_47129_length_477_cov_33.111111	307	387	12	48	80	0.6000000
NODE_47129_length_477_cov_33.111111	307	387	14	10	80	0.1250000
NODE_47129_length_477_cov_33.111111	307	387	16	12	80	0.1500000
NODE_47129_length_477_cov_33.111111	307	387	18	1	80	0.0125000
NODE_47129_length_477_cov_33.111111	360	440	2	9	80	0.1125000
NODE_47129_length_477_cov_33.111111	360	440	4	20	80	0.2500000
NODE_47129_length_477_cov_33.111111	360	440	6	17	80	0.2125000
NODE_47129_length_477_cov_33.111111	360	440	7	5	80	0.0625000
NODE_47129_length_477_cov_33.111111	360	440	9	7	80	0.0875000
NODE_47129_length_477_cov_33.111111	360	440	10	4	80	0.0500000
NODE_47129_length_477_cov_33.111111	360	440	12	18	80	0.2250000
NODE_47133_length_477_cov_11.235450	119	199	0	53	80	0.6625000
NODE_47133_length_477_cov_11.235450	119	199	2	13	80	0.1625000
NODE_47133_length_477_cov_11.235450	119	199	4	14	80	0.1750000
NODE_47133_length_477_cov_11.235450	172	247	2	23	75	0.3066667
NODE_47133_length_477_cov_11.235450	172	247	4	52	75	0.6933333
NODE_47135_length_477_cov_9.359788	221	301	0	80	80	1.0000000
NODE_47135_length_477_cov_9.359788	274	354	0	80	80	1.0000000
NODE_47139_length_477_cov_7.436508	230	304	4	2	74	0.0270270
NODE_47139_length_477_cov_7.436508	230	304	6	15	74	0.2027027
NODE_47139_length_477_cov_7.436508	230	304	8	15	74	0.2027027
NODE_47139_length_477_cov_7.436508	230	304	10	5	74	0.0675676
NODE_47139_length_477_cov_7.436508	230	304	12	5	74	0.0675676
NODE_47139_length_477_cov_7.436508	230	304	18	4	74	0.0540541
NODE_47139_length_477_cov_7.436508	230	304	20	28	74	0.3783784
NODE_47140_length_477_cov_7.433862	43	123	0	80	80	1.0000000
NODE_47140_length_477_cov_7.433862	96	176	0	80	80	1.0000000
NODE_47143_length_477_cov_6.846561	163	243	0	80	80	1.0000000
NODE_47143_length_477_cov_6.846561	216	296	0	80	80	1.0000000
NODE_47147_length_477_cov_5.677249	150	228	0	20	78	0.2564103
NODE_47147_length_477_cov_5.677249	150	228	3	38	78	0.4871795
NODE_47147_length_477_cov_5.677249	150	228	4	20	78	0.2564103
NODE_47148_length_477_cov_5.084656	227	288	0	10	61	0.1639344
NODE_47148_length_477_cov_5.084656	227	288	2	51	61	0.8360656
NODE_47253_length_477_cov_1.629630	115	171	6	3	56	0.0535714
NODE_47253_length_477_cov_1.629630	115	171	8	17	56	0.3035714
NODE_47253_length_477_cov_1.629630	115	171	12	19	56	0.3392857
NODE_47253_length_477_cov_1.629630	115	171	14	17	56	0.3035714
NODE_47253_length_477_cov_1.629630	167	224	8	25	57	0.4385965
NODE_47253_length_477_cov_1.629630	167	224	10	7	57	0.1228070
NODE_47253_length_477_cov_1.629630	167	224	12	12	57	0.2105263
NODE_47253_length_477_cov_1.629630	167	224	14	13	57	0.2280702
NODE_47375_length_477_cov_0.859788	445	477	4	32	32	1.0000000
NODE_47427_length_476_cov_7.533156	221	301	0	80	80	1.0000000
NODE_47427_length_476_cov_7.533156	274	354	0	80	80	1.0000000
NODE_47529_length_476_cov_1.618037	385	444	2	9	59	0.1525424
NODE_47529_length_476_cov_1.618037	385	444	6	17	59	0.2881356
NODE_47529_length_476_cov_1.618037	385	444	8	33	59	0.5593221
NODE_47601_length_476_cov_1.129973	15	34	0	13	19	0.6842105
NODE_47601_length_476_cov_1.129973	15	34	2	6	19	0.3157895
NODE_47620_length_476_cov_1.037135	180	243	0	63	63	1.0000000
NODE_47620_length_476_cov_1.037135	237	296	0	59	59	1.0000000
NODE_47693_length_475_cov_34.460106	270	350	0	80	80	1.0000000
NODE_47693_length_475_cov_34.460106	323	403	0	80	80	1.0000000
NODE_47694_length_475_cov_30.087766	273	353	0	46	80	0.5750000
NODE_47694_length_475_cov_30.087766	273	353	2	34	80	0.4250000
NODE_47694_length_475_cov_30.087766	326	406	2	80	80	1.0000000
NODE_47695_length_475_cov_10.247340	42	122	0	80	80	1.0000000
NODE_47701_length_475_cov_8.393617	9	89	0	80	80	1.0000000
NODE_47701_length_475_cov_8.393617	62	142	0	80	80	1.0000000
NODE_47828_length_475_cov_1.531915	272	352	1	80	80	1.0000000
NODE_47839_length_475_cov_1.457447	50	93	0	43	43	1.0000000
NODE_47979_length_474_cov_49.453333	392	472	17	3	80	0.0375000
NODE_47979_length_474_cov_49.453333	392	472	19	2	80	0.0250000
NODE_47979_length_474_cov_49.453333	392	472	20	1	80	0.0125000
NODE_47979_length_474_cov_49.453333	392	472	22	1	80	0.0125000
NODE_47979_length_474_cov_49.453333	392	472	28	2	80	0.0250000
NODE_47979_length_474_cov_49.453333	392	472	32	1	80	0.0125000
NODE_47979_length_474_cov_49.453333	392	472	34	1	80	0.0125000
NODE_47979_length_474_cov_49.453333	392	472	39	1	80	0.0125000
NODE_47979_length_474_cov_49.453333	392	472	41	1	80	0.0125000
NODE_47979_length_474_cov_49.453333	392	472	45	1	80	0.0125000
NODE_47979_length_474_cov_49.453333	392	472	47	1	80	0.0125000
NODE_47979_length_474_cov_49.453333	392	472	49	1	80	0.0125000
NODE_47979_length_474_cov_49.453333	392	472	55	1	80	0.0125000
NODE_47979_length_474_cov_49.453333	392	472	69	3	80	0.0375000
NODE_47979_length_474_cov_49.453333	392	472	76	1	80	0.0125000
NODE_47979_length_474_cov_49.453333	392	472	80	1	80	0.0125000
NODE_47979_length_474_cov_49.453333	392	472	98	1	80	0.0125000
NODE_47979_length_474_cov_49.453333	392	472	105	1	80	0.0125000
NODE_47979_length_474_cov_49.453333	392	472	108	1	80	0.0125000
NODE_47979_length_474_cov_49.453333	392	472	109	1	80	0.0125000
NODE_47979_length_474_cov_49.453333	392	472	112	2	80	0.0250000
NODE_47979_length_474_cov_49.453333	392	472	120	1	80	0.0125000
NODE_47979_length_474_cov_49.453333	392	472	126	1	80	0.0125000
NODE_47979_length_474_cov_49.453333	392	472	127	1	80	0.0125000
NODE_47979_length_474_cov_49.453333	392	472	135	1	80	0.0125000
NODE_47979_length_474_cov_49.453333	392	472	136	2	80	0.0250000
NODE_47979_length_474_cov_49.453333	392	472	140	1	80	0.0125000
NODE_47979_length_474_cov_49.453333	392	472	144	1	80	0.0125000
NODE_47979_length_474_cov_49.453333	392	472	146	1	80	0.0125000
NODE_47979_length_474_cov_49.453333	392	472	148	1	80	0.0125000
NODE_47979_length_474_cov_49.453333	392	472	152	1	80	0.0125000
NODE_47979_length_474_cov_49.453333	392	472	155	1	80	0.0125000
NODE_47979_length_474_cov_49.453333	392	472	158	1	80	0.0125000
NODE_47979_length_474_cov_49.453333	392	472	162	1	80	0.0125000
NODE_47979_length_474_cov_49.453333	392	472	164	1	80	0.0125000
NODE_47979_length_474_cov_49.453333	392	472	165	3	80	0.0375000
NODE_47979_length_474_cov_49.453333	392	472	167	1	80	0.0125000
NODE_47979_length_474_cov_49.453333	392	472	172	1	80	0.0125000
NODE_47979_length_474_cov_49.453333	392	472	174	2	80	0.0250000
NODE_47979_length_474_cov_49.453333	392	472	182	1	80	0.0125000
NODE_47979_length_474_cov_49.453333	392	472	187	3	80	0.0375000
NODE_47979_length_474_cov_49.453333	392	472	189	1	80	0.0125000
NODE_47979_length_474_cov_49.453333	392	472	194	1	80	0.0125000
NODE_47979_length_474_cov_49.453333	392	472	196	2	80	0.0250000
NODE_47979_length_474_cov_49.453333	392	472	197	1	80	0.0125000
NODE_47979_length_474_cov_49.453333	392	472	198	2	80	0.0250000
NODE_47979_length_474_cov_49.453333	392	472	207	1	80	0.0125000
NODE_47979_length_474_cov_49.453333	392	472	208	1	80	0.0125000
NODE_47979_length_474_cov_49.453333	392	472	211	1	80	0.0125000
NODE_47979_length_474_cov_49.453333	392	472	214	1	80	0.0125000
NODE_47979_length_474_cov_49.453333	392	472	220	1	80	0.0125000
NODE_47979_length_474_cov_49.453333	392	472	227	1	80	0.0125000
NODE_47979_length_474_cov_49.453333	392	472	233	2	80	0.0250000
NODE_47979_length_474_cov_49.453333	392	472	241	1	80	0.0125000
NODE_47979_length_474_cov_49.453333	392	472	257	1	80	0.0125000
NODE_47979_length_474_cov_49.453333	392	472	258	1	80	0.0125000
NODE_47979_length_474_cov_49.453333	392	472	260	1	80	0.0125000
NODE_47979_length_474_cov_49.453333	392	472	266	1	80	0.0125000
NODE_47979_length_474_cov_49.453333	392	472	270	1	80	0.0125000
NODE_47979_length_474_cov_49.453333	392	472	278	2	80	0.0250000
NODE_47979_length_474_cov_49.453333	392	472	280	1	80	0.0125000
NODE_47979_length_474_cov_49.453333	392	472	283	1	80	0.0125000
NODE_47979_length_474_cov_49.453333	392	472	290	1	80	0.0125000
NODE_47979_length_474_cov_49.453333	445	474	11	1	29	0.0344828
NODE_47979_length_474_cov_49.453333	445	474	13	1	29	0.0344828
NODE_47979_length_474_cov_49.453333	445	474	17	3	29	0.1034483
NODE_47979_length_474_cov_49.453333	445	474	19	2	29	0.0689655
NODE_47979_length_474_cov_49.453333	445	474	20	1	29	0.0344828
NODE_47979_length_474_cov_49.453333	445	474	22	1	29	0.0344828
NODE_47979_length_474_cov_49.453333	445	474	28	2	29	0.0689655
NODE_47979_length_474_cov_49.453333	445	474	32	1	29	0.0344828
NODE_47979_length_474_cov_49.453333	445	474	34	1	29	0.0344828
NODE_47979_length_474_cov_49.453333	445	474	39	1	29	0.0344828
NODE_47979_length_474_cov_49.453333	445	474	41	1	29	0.0344828
NODE_47979_length_474_cov_49.453333	445	474	45	1	29	0.0344828
NODE_47979_length_474_cov_49.453333	445	474	47	1	29	0.0344828
NODE_47979_length_474_cov_49.453333	445	474	49	1	29	0.0344828
NODE_47979_length_474_cov_49.453333	445	474	55	1	29	0.0344828
NODE_47979_length_474_cov_49.453333	445	474	69	3	29	0.1034483
NODE_47979_length_474_cov_49.453333	445	474	76	1	29	0.0344828
NODE_47979_length_474_cov_49.453333	445	474	80	1	29	0.0344828
NODE_47979_length_474_cov_49.453333	445	474	98	1	29	0.0344828
NODE_47979_length_474_cov_49.453333	445	474	105	1	29	0.0344828
NODE_47979_length_474_cov_49.453333	445	474	108	1	29	0.0344828
NODE_47979_length_474_cov_49.453333	445	474	109	1	29	0.0344828
NODE_47979_length_474_cov_49.453333	445	474	112	1	29	0.0344828
NODE_47981_length_474_cov_24.930667	287	367	0	80	80	1.0000000
NODE_47981_length_474_cov_24.930667	340	420	0	80	80	1.0000000
NODE_47982_length_474_cov_15.952000	258	338	0	4	80	0.0500000
NODE_47982_length_474_cov_15.952000	258	338	2	33	80	0.4125000
NODE_47982_length_474_cov_15.952000	258	338	4	42	80	0.5250000
NODE_47982_length_474_cov_15.952000	258	338	6	1	80	0.0125000
NODE_47982_length_474_cov_15.952000	311	391	4	41	80	0.5125000
NODE_47982_length_474_cov_15.952000	311	391	6	8	80	0.1000000
NODE_47982_length_474_cov_15.952000	311	391	8	31	80	0.3875000
NODE_48003_length_474_cov_3.986667	172	252	4	6	80	0.0750000
NODE_48003_length_474_cov_3.986667	172	252	8	5	80	0.0625000
NODE_48003_length_474_cov_3.986667	172	252	10	16	80	0.2000000
NODE_48003_length_474_cov_3.986667	172	252	12	42	80	0.5250000
NODE_48003_length_474_cov_3.986667	172	252	14	11	80	0.1375000
NODE_48015_length_474_cov_3.496000	163	243	4	14	80	0.1750000
NODE_48015_length_474_cov_3.496000	163	243	5	1	80	0.0125000
NODE_48015_length_474_cov_3.496000	163	243	6	6	80	0.0750000
NODE_48015_length_474_cov_3.496000	163	243	7	3	80	0.0375000
NODE_48015_length_474_cov_3.496000	163	243	8	31	80	0.3875000
NODE_48015_length_474_cov_3.496000	163	243	9	25	80	0.3125000
NODE_48038_length_474_cov_2.784000	259	300	2	41	41	1.0000000
NODE_48116_length_474_cov_1.538667	41	62	0	21	21	1.0000000
NODE_48181_length_474_cov_1.085333	0	50	0	49	50	0.9800000
NODE_48181_length_474_cov_1.085333	0	50	2	1	50	0.0200000
NODE_48184_length_474_cov_1.056000	95	133	0	38	38	1.0000000
NODE_48266_length_473_cov_82.374332	123	203	0	80	80	1.0000000
NODE_48266_length_473_cov_82.374332	176	256	0	80	80	1.0000000
NODE_48267_length_473_cov_54.882353	199	279	0	80	80	1.0000000
NODE_48267_length_473_cov_54.882353	252	332	0	46	80	0.5750000
NODE_48267_length_473_cov_54.882353	252	332	2	34	80	0.4250000
NODE_48268_length_473_cov_48.997326	119	194	23	4	75	0.0533333
NODE_48268_length_473_cov_48.997326	119	194	26	1	75	0.0133333
NODE_48268_length_473_cov_48.997326	119	194	28	1	75	0.0133333
NODE_48268_length_473_cov_48.997326	119	194	30	3	75	0.0400000
NODE_48268_length_473_cov_48.997326	119	194	31	7	75	0.0933333
NODE_48268_length_473_cov_48.997326	119	194	32	1	75	0.0133333
NODE_48268_length_473_cov_48.997326	119	194	33	3	75	0.0400000
NODE_48268_length_473_cov_48.997326	119	194	34	3	75	0.0400000
NODE_48268_length_473_cov_48.997326	119	194	35	3	75	0.0400000
NODE_48268_length_473_cov_48.997326	119	194	36	13	75	0.1733333
NODE_48268_length_473_cov_48.997326	119	194	37	7	75	0.0933333
NODE_48268_length_473_cov_48.997326	119	194	38	8	75	0.1066667
NODE_48268_length_473_cov_48.997326	119	194	39	4	75	0.0533333
NODE_48268_length_473_cov_48.997326	119	194	40	6	75	0.0800000
NODE_48268_length_473_cov_48.997326	119	194	41	1	75	0.0133333
NODE_48268_length_473_cov_48.997326	119	194	42	10	75	0.1333333
NODE_48268_length_473_cov_48.997326	119	194	23	4	75	0.0533333
NODE_48268_length_473_cov_48.997326	119	194	26	1	75	0.0133333
NODE_48268_length_473_cov_48.997326	119	194	28	1	75	0.0133333
NODE_48268_length_473_cov_48.997326	119	194	30	3	75	0.0400000
NODE_48268_length_473_cov_48.997326	119	194	31	7	75	0.0933333
NODE_48268_length_473_cov_48.997326	119	194	32	1	75	0.0133333
NODE_48268_length_473_cov_48.997326	119	194	33	3	75	0.0400000
NODE_48268_length_473_cov_48.997326	119	194	34	3	75	0.0400000
NODE_48268_length_473_cov_48.997326	119	194	35	3	75	0.0400000
NODE_48268_length_473_cov_48.997326	119	194	36	13	75	0.1733333
NODE_48268_length_473_cov_48.997326	119	194	37	7	75	0.0933333
NODE_48268_length_473_cov_48.997326	119	194	38	8	75	0.1066667
NODE_48268_length_473_cov_48.997326	119	194	39	4	75	0.0533333
NODE_48268_length_473_cov_48.997326	119	194	40	6	75	0.0800000
NODE_48268_length_473_cov_48.997326	119	194	41	1	75	0.0133333
NODE_48268_length_473_cov_48.997326	119	194	42	10	75	0.1333333
NODE_48268_length_473_cov_48.997326	167	247	14	3	80	0.0375000
NODE_48268_length_473_cov_48.997326	167	247	16	17	80	0.2125000
NODE_48268_length_473_cov_48.997326	167	247	18	14	80	0.1750000
NODE_48268_length_473_cov_48.997326	167	247	20	1	80	0.0125000
NODE_48268_length_473_cov_48.997326	167	247	22	8	80	0.1000000
NODE_48268_length_473_cov_48.997326	167	247	23	5	80	0.0625000
NODE_48268_length_473_cov_48.997326	167	247	24	8	80	0.1000000
NODE_48268_length_473_cov_48.997326	167	247	26	1	80	0.0125000
NODE_48268_length_473_cov_48.997326	167	247	31	7	80	0.0875000
NODE_48268_length_473_cov_48.997326	167	247	33	3	80	0.0375000
NODE_48268_length_473_cov_48.997326	167	247	35	3	80	0.0375000
NODE_48268_length_473_cov_48.997326	167	247	37	6	80	0.0750000
NODE_48268_length_473_cov_48.997326	167	247	39	4	80	0.0500000
NODE_48269_length_473_cov_30.679144	174	254	2	13	80	0.1625000
NODE_48269_length_473_cov_30.679144	174	254	4	20	80	0.2500000
NODE_48269_length_473_cov_30.679144	174	254	6	14	80	0.1750000
NODE_48269_length_473_cov_30.679144	174	254	8	2	80	0.0250000
NODE_48269_length_473_cov_30.679144	174	254	10	6	80	0.0750000
NODE_48269_length_473_cov_30.679144	174	254	14	2	80	0.0250000
NODE_48269_length_473_cov_30.679144	174	254	18	2	80	0.0250000
NODE_48269_length_473_cov_30.679144	174	254	20	14	80	0.1750000
NODE_48269_length_473_cov_30.679144	174	254	22	3	80	0.0375000
NODE_48269_length_473_cov_30.679144	174	254	24	4	80	0.0500000
NODE_48269_length_473_cov_30.679144	226	307	2	58	81	0.7160494
NODE_48269_length_473_cov_30.679144	226	307	4	23	81	0.2839506
NODE_48269_length_473_cov_30.679144	227	307	2	58	80	0.7250000
NODE_48269_length_473_cov_30.679144	227	307	4	22	80	0.2750000
NODE_48270_length_473_cov_24.967914	295	370	0	75	75	1.0000000
NODE_48270_length_473_cov_24.967914	343	423	0	80	80	1.0000000
NODE_48271_length_473_cov_18.540107	168	248	2	78	80	0.9750000
NODE_48271_length_473_cov_18.540107	168	248	4	2	80	0.0250000
NODE_48271_length_473_cov_18.540107	221	301	0	27	80	0.3375000
NODE_48271_length_473_cov_18.540107	221	301	2	53	80	0.6625000
NODE_48272_length_473_cov_15.871658	143	223	1	80	80	1.0000000
NODE_48272_length_473_cov_15.871658	196	276	1	76	80	0.9500000
NODE_48272_length_473_cov_15.871658	196	276	2	4	80	0.0500000
NODE_48291_length_473_cov_4.363636	160	240	0	28	80	0.3500000
NODE_48291_length_473_cov_4.363636	160	240	2	52	80	0.6500000
NODE_48291_length_473_cov_4.363636	213	293	0	80	80	1.0000000
NODE_48320_length_473_cov_2.959893	199	267	0	68	68	1.0000000
NODE_48325_length_473_cov_2.804813	207	269	0	62	62	1.0000000
NODE_48350_length_473_cov_2.251337	48	128	0	80	80	1.0000000
NODE_48350_length_473_cov_2.251337	101	181	0	51	80	0.6375000
NODE_48350_length_473_cov_2.251337	101	181	2	29	80	0.3625000
NODE_48568_length_472_cov_50.077748	1	81	0	23	80	0.2875000
NODE_48568_length_472_cov_50.077748	1	81	4	1	80	0.0125000
NODE_48568_length_472_cov_50.077748	1	81	6	7	80	0.0875000
NODE_48568_length_472_cov_50.077748	1	81	7	4	80	0.0500000
NODE_48568_length_472_cov_50.077748	1	81	8	22	80	0.2750000
NODE_48568_length_472_cov_50.077748	1	81	10	1	80	0.0125000
NODE_48568_length_472_cov_50.077748	1	81	12	9	80	0.1125000
NODE_48568_length_472_cov_50.077748	1	81	14	5	80	0.0625000
NODE_48568_length_472_cov_50.077748	1	81	16	8	80	0.1000000
NODE_48568_length_472_cov_50.077748	1	81	0	23	80	0.2875000
NODE_48568_length_472_cov_50.077748	1	81	4	1	80	0.0125000
NODE_48568_length_472_cov_50.077748	1	81	6	7	80	0.0875000
NODE_48568_length_472_cov_50.077748	1	81	7	4	80	0.0500000
NODE_48568_length_472_cov_50.077748	1	81	8	22	80	0.2750000
NODE_48568_length_472_cov_50.077748	1	81	10	1	80	0.0125000
NODE_48568_length_472_cov_50.077748	1	81	12	9	80	0.1125000
NODE_48568_length_472_cov_50.077748	1	81	14	5	80	0.0625000
NODE_48568_length_472_cov_50.077748	1	81	16	8	80	0.1000000
NODE_48568_length_472_cov_50.077748	1	81	0	23	80	0.2875000
NODE_48568_length_472_cov_50.077748	1	81	4	1	80	0.0125000
NODE_48568_length_472_cov_50.077748	1	81	6	7	80	0.0875000
NODE_48568_length_472_cov_50.077748	1	81	7	4	80	0.0500000
NODE_48568_length_472_cov_50.077748	1	81	8	22	80	0.2750000
NODE_48568_length_472_cov_50.077748	1	81	10	1	80	0.0125000
NODE_48568_length_472_cov_50.077748	1	81	12	9	80	0.1125000
NODE_48568_length_472_cov_50.077748	1	81	14	5	80	0.0625000
NODE_48568_length_472_cov_50.077748	1	81	16	8	80	0.1000000
NODE_48568_length_472_cov_50.077748	1	81	0	23	80	0.2875000
NODE_48568_length_472_cov_50.077748	1	81	4	1	80	0.0125000
NODE_48568_length_472_cov_50.077748	1	81	6	7	80	0.0875000
NODE_48568_length_472_cov_50.077748	1	81	7	4	80	0.0500000
NODE_48568_length_472_cov_50.077748	1	81	8	22	80	0.2750000
NODE_48568_length_472_cov_50.077748	1	81	10	1	80	0.0125000
NODE_48568_length_472_cov_50.077748	1	81	12	9	80	0.1125000
NODE_48568_length_472_cov_50.077748	1	81	14	5	80	0.0625000
NODE_48568_length_472_cov_50.077748	1	81	16	8	80	0.1000000
NODE_48568_length_472_cov_50.077748	1	81	0	23	80	0.2875000
NODE_48568_length_472_cov_50.077748	1	81	4	1	80	0.0125000
NODE_48568_length_472_cov_50.077748	1	81	6	7	80	0.0875000
NODE_48568_length_472_cov_50.077748	1	81	7	4	80	0.0500000
NODE_48568_length_472_cov_50.077748	1	81	8	22	80	0.2750000
NODE_48568_length_472_cov_50.077748	1	81	10	1	80	0.0125000
NODE_48568_length_472_cov_50.077748	1	81	12	9	80	0.1125000
NODE_48568_length_472_cov_50.077748	1	81	14	5	80	0.0625000
NODE_48568_length_472_cov_50.077748	1	81	16	8	80	0.1000000
NODE_48568_length_472_cov_50.077748	10	81	0	14	71	0.1971831
NODE_48568_length_472_cov_50.077748	10	81	4	1	71	0.0140845
NODE_48568_length_472_cov_50.077748	10	81	6	7	71	0.0985916
NODE_48568_length_472_cov_50.077748	10	81	7	4	71	0.0563380
NODE_48568_length_472_cov_50.077748	10	81	8	22	71	0.3098592
NODE_48568_length_472_cov_50.077748	10	81	10	1	71	0.0140845
NODE_48568_length_472_cov_50.077748	10	81	12	9	71	0.1267606
NODE_48568_length_472_cov_50.077748	10	81	14	5	71	0.0704225
NODE_48568_length_472_cov_50.077748	10	81	16	8	71	0.1126761
NODE_48568_length_472_cov_50.077748	54	131	8	4	77	0.0519481
NODE_48568_length_472_cov_50.077748	54	131	10	11	77	0.1428571
NODE_48568_length_472_cov_50.077748	54	131	12	20	77	0.2597403
NODE_48568_length_472_cov_50.077748	54	131	14	5	77	0.0649351
NODE_48568_length_472_cov_50.077748	54	131	16	37	77	0.4805195
NODE_48568_length_472_cov_50.077748	54	131	8	4	77	0.0519481
NODE_48568_length_472_cov_50.077748	54	131	10	11	77	0.1428571
NODE_48568_length_472_cov_50.077748	54	131	12	20	77	0.2597403
NODE_48568_length_472_cov_50.077748	54	131	14	5	77	0.0649351
NODE_48568_length_472_cov_50.077748	54	131	16	37	77	0.4805195
NODE_48568_length_472_cov_50.077748	54	131	8	4	77	0.0519481
NODE_48568_length_472_cov_50.077748	54	131	10	11	77	0.1428571
NODE_48568_length_472_cov_50.077748	54	131	12	20	77	0.2597403
NODE_48568_length_472_cov_50.077748	54	131	14	5	77	0.0649351
NODE_48568_length_472_cov_50.077748	54	131	16	37	77	0.4805195
NODE_48568_length_472_cov_50.077748	130	204	6	12	74	0.1621622
NODE_48568_length_472_cov_50.077748	130	204	8	3	74	0.0405405
NODE_48568_length_472_cov_50.077748	130	204	10	5	74	0.0675676
NODE_48568_length_472_cov_50.077748	130	204	12	1	74	0.0135135
NODE_48568_length_472_cov_50.077748	130	204	14	27	74	0.3648649
NODE_48568_length_472_cov_50.077748	130	204	15	4	74	0.0540541
NODE_48568_length_472_cov_50.077748	130	204	16	22	74	0.2972973
NODE_48569_length_472_cov_10.469169	294	374	0	35	80	0.4375000
NODE_48569_length_472_cov_10.469169	294	374	2	45	80	0.5625000
NODE_48569_length_472_cov_10.469169	347	427	0	80	80	1.0000000
NODE_48570_length_472_cov_10.195710	143	223	0	80	80	1.0000000
NODE_48570_length_472_cov_10.195710	196	276	0	80	80	1.0000000
NODE_48593_length_472_cov_4.375335	165	245	2	52	80	0.6500000
NODE_48593_length_472_cov_4.375335	165	245	3	10	80	0.1250000
NODE_48593_length_472_cov_4.375335	165	245	4	18	80	0.2250000
NODE_48593_length_472_cov_4.375335	218	251	2	33	33	1.0000000
NODE_48614_length_472_cov_3.495979	305	349	0	44	44	1.0000000
NODE_48620_length_472_cov_3.093834	220	295	0	75	75	1.0000000
NODE_48638_length_472_cov_2.592493	431	471	0	40	40	1.0000000
NODE_48745_length_472_cov_1.294906	43	98	2	55	55	1.0000000
NODE_48745_length_472_cov_1.294906	71	151	0	1	80	0.0125000
NODE_48745_length_472_cov_1.294906	71	151	2	79	80	0.9875000
NODE_48768_length_472_cov_1.211796	106	126	0	20	20	1.0000000
NODE_48873_length_471_cov_39.319892	119	193	0	71	74	0.9594595
NODE_48873_length_471_cov_39.319892	119	193	4	2	74	0.0270270
NODE_48873_length_471_cov_39.319892	119	193	37	1	74	0.0135135
NODE_48874_length_471_cov_24.279570	185	265	0	40	80	0.5000000
NODE_48874_length_471_cov_24.279570	185	265	2	7	80	0.0875000
NODE_48874_length_471_cov_24.279570	185	265	4	33	80	0.4125000
NODE_48874_length_471_cov_24.279570	238	318	0	7	80	0.0875000
NODE_48874_length_471_cov_24.279570	238	318	2	16	80	0.2000000
NODE_48874_length_471_cov_24.279570	238	318	4	57	80	0.7125000
NODE_48875_length_471_cov_19.669355	83	163	4	34	80	0.4250000
NODE_48875_length_471_cov_19.669355	83	163	10	46	80	0.5750000
NODE_48875_length_471_cov_19.669355	136	216	6	15	80	0.1875000
NODE_48875_length_471_cov_19.669355	136	216	7	5	80	0.0625000
NODE_48875_length_471_cov_19.669355	136	216	9	24	80	0.3000000
NODE_48875_length_471_cov_19.669355	136	216	10	36	80	0.4500000
NODE_48876_length_471_cov_14.387097	198	278	0	80	80	1.0000000
NODE_48876_length_471_cov_14.387097	251	331	0	80	80	1.0000000
NODE_48881_length_471_cov_6.948925	186	213	0	27	27	1.0000000
NODE_48881_length_471_cov_6.948925	204	284	0	80	80	1.0000000
NODE_48881_length_471_cov_6.948925	244	275	0	31	31	1.0000000
NODE_48881_length_471_cov_6.948925	257	337	0	80	80	1.0000000
NODE_48881_length_471_cov_6.948925	268	337	0	69	69	1.0000000
NODE_48902_length_471_cov_3.803763	83	162	0	29	79	0.3670886
NODE_48902_length_471_cov_3.803763	83	162	2	50	79	0.6329114
NODE_48902_length_471_cov_3.803763	135	215	2	80	80	1.0000000
NODE_48924_length_471_cov_2.954301	284	315	14	2	31	0.0645161
NODE_48924_length_471_cov_2.954301	284	315	16	1	31	0.0322581
NODE_48924_length_471_cov_2.954301	284	315	18	2	31	0.0645161
NODE_48924_length_471_cov_2.954301	284	315	20	26	31	0.8387097
NODE_48957_length_471_cov_2.287634	133	200	2	7	67	0.1044776
NODE_48957_length_471_cov_2.287634	133	200	4	19	67	0.2835821
NODE_48957_length_471_cov_2.287634	133	200	6	2	67	0.0298507
NODE_48957_length_471_cov_2.287634	133	200	8	4	67	0.0597015
NODE_48957_length_471_cov_2.287634	133	200	10	5	67	0.0746269
NODE_48957_length_471_cov_2.287634	133	200	12	3	67	0.0447761
NODE_48957_length_471_cov_2.287634	133	200	14	10	67	0.1492537
NODE_48957_length_471_cov_2.287634	133	200	16	2	67	0.0298507
NODE_48957_length_471_cov_2.287634	133	200	18	15	67	0.2238806
NODE_49186_length_470_cov_57.078167	184	264	0	28	80	0.3500000
NODE_49186_length_470_cov_57.078167	184	264	2	52	80	0.6500000
NODE_49186_length_470_cov_57.078167	237	317	0	23	80	0.2875000
NODE_49186_length_470_cov_57.078167	237	317	2	42	80	0.5250000
NODE_49186_length_470_cov_57.078167	237	317	3	1	80	0.0125000
NODE_49186_length_470_cov_57.078167	237	317	4	1	80	0.0125000
NODE_49186_length_470_cov_57.078167	237	317	6	7	80	0.0875000
NODE_49186_length_470_cov_57.078167	237	317	10	5	80	0.0625000
NODE_49186_length_470_cov_57.078167	237	317	12	1	80	0.0125000
NODE_49186_length_470_cov_57.078167	313	393	10	3	80	0.0375000
NODE_49186_length_470_cov_57.078167	313	393	12	31	80	0.3875000
NODE_49186_length_470_cov_57.078167	313	393	16	1	80	0.0125000
NODE_49186_length_470_cov_57.078167	313	393	18	45	80	0.5625000
NODE_49186_length_470_cov_57.078167	366	446	8	1	80	0.0125000
NODE_49186_length_470_cov_57.078167	366	446	12	1	80	0.0125000
NODE_49186_length_470_cov_57.078167	366	446	14	23	80	0.2875000
NODE_49186_length_470_cov_57.078167	366	446	16	5	80	0.0625000
NODE_49186_length_470_cov_57.078167	366	446	18	50	80	0.6250000
NODE_49187_length_470_cov_34.035040	228	308	0	80	80	1.0000000
NODE_49187_length_470_cov_34.035040	281	361	0	80	80	1.0000000
NODE_49187_length_470_cov_34.035040	357	437	0	80	80	1.0000000
NODE_49187_length_470_cov_34.035040	410	470	0	60	60	1.0000000
NODE_49188_length_470_cov_15.539084	142	222	2	71	80	0.8875000
NODE_49188_length_470_cov_15.539084	142	222	4	9	80	0.1125000
NODE_49188_length_470_cov_15.539084	195	275	0	11	80	0.1375000
NODE_49188_length_470_cov_15.539084	195	275	2	60	80	0.7500000
NODE_49188_length_470_cov_15.539084	195	275	4	9	80	0.1125000
NODE_49193_length_470_cov_6.070081	272	330	41	3	58	0.0517241
NODE_49193_length_470_cov_6.070081	272	330	43	2	58	0.0344828
NODE_49193_length_470_cov_6.070081	272	330	45	1	58	0.0172414
NODE_49193_length_470_cov_6.070081	272	330	47	2	58	0.0344828
NODE_49193_length_470_cov_6.070081	272	330	49	8	58	0.1379310
NODE_49193_length_470_cov_6.070081	272	330	50	4	58	0.0689655
NODE_49193_length_470_cov_6.070081	272	330	51	1	58	0.0172414
NODE_49193_length_470_cov_6.070081	272	330	52	5	58	0.0862069
NODE_49193_length_470_cov_6.070081	272	330	57	1	58	0.0172414
NODE_49193_length_470_cov_6.070081	272	330	58	1	58	0.0172414
NODE_49193_length_470_cov_6.070081	272	330	62	1	58	0.0172414
NODE_49193_length_470_cov_6.070081	272	330	64	9	58	0.1551724
NODE_49193_length_470_cov_6.070081	272	330	66	9	58	0.1551724
NODE_49193_length_470_cov_6.070081	272	330	68	2	58	0.0344828
NODE_49193_length_470_cov_6.070081	272	330	70	5	58	0.0862069
NODE_49193_length_470_cov_6.070081	272	330	72	4	58	0.0689655
NODE_49193_length_470_cov_6.070081	325	383	6	2	58	0.0344828
NODE_49193_length_470_cov_6.070081	325	383	11	9	58	0.1551724
NODE_49193_length_470_cov_6.070081	325	383	12	10	58	0.1724138
NODE_49193_length_470_cov_6.070081	325	383	13	6	58	0.1034483
NODE_49193_length_470_cov_6.070081	325	383	14	2	58	0.0344828
NODE_49193_length_470_cov_6.070081	325	383	18	1	58	0.0172414
NODE_49193_length_470_cov_6.070081	325	383	20	1	58	0.0172414
NODE_49193_length_470_cov_6.070081	325	383	23	4	58	0.0689655
NODE_49193_length_470_cov_6.070081	325	383	25	1	58	0.0172414
NODE_49193_length_470_cov_6.070081	325	383	26	7	58	0.1206897
NODE_49193_length_470_cov_6.070081	325	383	30	2	58	0.0344828
NODE_49193_length_470_cov_6.070081	325	383	31	4	58	0.0689655
NODE_49193_length_470_cov_6.070081	325	383	35	1	58	0.0172414
NODE_49193_length_470_cov_6.070081	325	383	39	1	58	0.0172414
NODE_49193_length_470_cov_6.070081	325	383	41	5	58	0.0862069
NODE_49193_length_470_cov_6.070081	325	383	43	2	58	0.0344828
NODE_49215_length_470_cov_3.735849	194	251	2	57	57	1.0000000
NODE_49260_length_470_cov_2.363881	403	422	2	7	19	0.3684210
NODE_49260_length_470_cov_2.363881	403	422	4	12	19	0.6315789
NODE_49260_length_470_cov_2.363881	403	422	2	7	19	0.3684210
NODE_49260_length_470_cov_2.363881	403	422	4	12	19	0.6315789
NODE_49389_length_470_cov_1.142857	414	470	0	56	56	1.0000000
NODE_49502_length_469_cov_221.024324	150	228	213	2	78	0.0256410
NODE_49502_length_469_cov_221.024324	150	228	223	2	78	0.0256410
NODE_49502_length_469_cov_221.024324	150	228	224	1	78	0.0128205
NODE_49502_length_469_cov_221.024324	150	228	225	1	78	0.0128205
NODE_49502_length_469_cov_221.024324	150	228	226	4	78	0.0512821
NODE_49502_length_469_cov_221.024324	150	228	227	3	78	0.0384615
NODE_49502_length_469_cov_221.024324	150	228	228	2	78	0.0256410
NODE_49502_length_469_cov_221.024324	150	228	229	1	78	0.0128205
NODE_49502_length_469_cov_221.024324	150	228	235	7	78	0.0897436
NODE_49502_length_469_cov_221.024324	150	228	236	1	78	0.0128205
NODE_49502_length_469_cov_221.024324	150	228	237	1	78	0.0128205
NODE_49502_length_469_cov_221.024324	150	228	238	6	78	0.0769231
NODE_49502_length_469_cov_221.024324	150	228	239	7	78	0.0897436
NODE_49502_length_469_cov_221.024324	150	228	242	1	78	0.0128205
NODE_49502_length_469_cov_221.024324	150	228	244	2	78	0.0256410
NODE_49502_length_469_cov_221.024324	150	228	245	3	78	0.0384615
NODE_49502_length_469_cov_221.024324	150	228	246	2	78	0.0256410
NODE_49502_length_469_cov_221.024324	150	228	247	1	78	0.0128205
NODE_49502_length_469_cov_221.024324	150	228	248	2	78	0.0256410
NODE_49502_length_469_cov_221.024324	150	228	249	5	78	0.0641026
NODE_49502_length_469_cov_221.024324	150	228	250	7	78	0.0897436
NODE_49502_length_469_cov_221.024324	150	228	251	1	78	0.0128205
NODE_49502_length_469_cov_221.024324	150	228	252	3	78	0.0384615
NODE_49502_length_469_cov_221.024324	150	228	253	1	78	0.0128205
NODE_49502_length_469_cov_221.024324	150	228	254	3	78	0.0384615
NODE_49502_length_469_cov_221.024324	150	228	255	1	78	0.0128205
NODE_49502_length_469_cov_221.024324	150	228	256	2	78	0.0256410
NODE_49502_length_469_cov_221.024324	150	228	257	3	78	0.0384615
NODE_49502_length_469_cov_221.024324	150	228	258	1	78	0.0128205
NODE_49502_length_469_cov_221.024324	150	228	259	1	78	0.0128205
NODE_49502_length_469_cov_221.024324	150	228	260	1	78	0.0128205
NODE_49502_length_469_cov_221.024324	150	228	213	2	78	0.0256410
NODE_49502_length_469_cov_221.024324	150	228	223	2	78	0.0256410
NODE_49502_length_469_cov_221.024324	150	228	224	1	78	0.0128205
NODE_49502_length_469_cov_221.024324	150	228	225	1	78	0.0128205
NODE_49502_length_469_cov_221.024324	150	228	226	4	78	0.0512821
NODE_49502_length_469_cov_221.024324	150	228	227	3	78	0.0384615
NODE_49502_length_469_cov_221.024324	150	228	228	2	78	0.0256410
NODE_49502_length_469_cov_221.024324	150	228	229	1	78	0.0128205
NODE_49502_length_469_cov_221.024324	150	228	235	7	78	0.0897436
NODE_49502_length_469_cov_221.024324	150	228	236	1	78	0.0128205
NODE_49502_length_469_cov_221.024324	150	228	237	1	78	0.0128205
NODE_49502_length_469_cov_221.024324	150	228	238	6	78	0.0769231
NODE_49502_length_469_cov_221.024324	150	228	239	7	78	0.0897436
NODE_49502_length_469_cov_221.024324	150	228	242	1	78	0.0128205
NODE_49502_length_469_cov_221.024324	150	228	244	2	78	0.0256410
NODE_49502_length_469_cov_221.024324	150	228	245	3	78	0.0384615
NODE_49502_length_469_cov_221.024324	150	228	246	2	78	0.0256410
NODE_49502_length_469_cov_221.024324	150	228	247	1	78	0.0128205
NODE_49502_length_469_cov_221.024324	150	228	248	2	78	0.0256410
NODE_49502_length_469_cov_221.024324	150	228	249	5	78	0.0641026
NODE_49502_length_469_cov_221.024324	150	228	250	7	78	0.0897436
NODE_49502_length_469_cov_221.024324	150	228	251	1	78	0.0128205
NODE_49502_length_469_cov_221.024324	150	228	252	3	78	0.0384615
NODE_49502_length_469_cov_221.024324	150	228	253	1	78	0.0128205
NODE_49502_length_469_cov_221.024324	150	228	254	3	78	0.0384615
NODE_49502_length_469_cov_221.024324	150	228	255	1	78	0.0128205
NODE_49502_length_469_cov_221.024324	150	228	256	2	78	0.0256410
NODE_49502_length_469_cov_221.024324	150	228	257	3	78	0.0384615
NODE_49502_length_469_cov_221.024324	150	228	258	1	78	0.0128205
NODE_49502_length_469_cov_221.024324	150	228	259	1	78	0.0128205
NODE_49502_length_469_cov_221.024324	150	228	260	1	78	0.0128205
NODE_49502_length_469_cov_221.024324	150	219	223	1	69	0.0144928
NODE_49502_length_469_cov_221.024324	150	219	224	1	69	0.0144928
NODE_49502_length_469_cov_221.024324	150	219	226	4	69	0.0579710
NODE_49502_length_469_cov_221.024324	150	219	227	1	69	0.0144928
NODE_49502_length_469_cov_221.024324	150	219	228	1	69	0.0144928
NODE_49502_length_469_cov_221.024324	150	219	229	1	69	0.0144928
NODE_49502_length_469_cov_221.024324	150	219	235	7	69	0.1014493
NODE_49502_length_469_cov_221.024324	150	219	236	1	69	0.0144928
NODE_49502_length_469_cov_221.024324	150	219	237	1	69	0.0144928
NODE_49502_length_469_cov_221.024324	150	219	238	6	69	0.0869565
NODE_49502_length_469_cov_221.024324	150	219	239	7	69	0.1014493
NODE_49502_length_469_cov_221.024324	150	219	244	2	69	0.0289855
NODE_49502_length_469_cov_221.024324	150	219	245	3	69	0.0434783
NODE_49502_length_469_cov_221.024324	150	219	246	2	69	0.0289855
NODE_49502_length_469_cov_221.024324	150	219	248	2	69	0.0289855
NODE_49502_length_469_cov_221.024324	150	219	249	5	69	0.0724638
NODE_49502_length_469_cov_221.024324	150	219	250	7	69	0.1014493
NODE_49502_length_469_cov_221.024324	150	219	251	1	69	0.0144928
NODE_49502_length_469_cov_221.024324	150	219	252	3	69	0.0434783
NODE_49502_length_469_cov_221.024324	150	219	253	1	69	0.0144928
NODE_49502_length_469_cov_221.024324	150	219	254	3	69	0.0434783
NODE_49502_length_469_cov_221.024324	150	219	255	1	69	0.0144928
NODE_49502_length_469_cov_221.024324	150	219	256	2	69	0.0289855
NODE_49502_length_469_cov_221.024324	150	219	257	3	69	0.0434783
NODE_49502_length_469_cov_221.024324	150	219	258	1	69	0.0144928
NODE_49502_length_469_cov_221.024324	150	219	259	1	69	0.0144928
NODE_49502_length_469_cov_221.024324	150	219	260	1	69	0.0144928
NODE_49557_length_469_cov_2.686486	263	343	0	80	80	1.0000000
NODE_49561_length_469_cov_2.521622	237	289	0	52	52	1.0000000
NODE_49579_length_469_cov_2.224324	279	331	0	26	52	0.5000000
NODE_49579_length_469_cov_2.224324	279	331	4	26	52	0.5000000
NODE_49796_length_468_cov_8.043360	190	250	2	10	60	0.1666667
NODE_49796_length_468_cov_8.043360	190	250	4	50	60	0.8333333
NODE_49796_length_468_cov_8.043360	223	303	0	9	80	0.1125000
NODE_49796_length_468_cov_8.043360	223	303	2	54	80	0.6750000
NODE_49796_length_468_cov_8.043360	223	303	4	17	80	0.2125000
NODE_49800_length_468_cov_6.046070	152	232	0	80	80	1.0000000
NODE_49800_length_468_cov_6.046070	205	285	0	80	80	1.0000000
NODE_49801_length_468_cov_5.997290	81	161	0	80	80	1.0000000
NODE_49801_length_468_cov_5.997290	134	214	0	80	80	1.0000000
NODE_49801_length_468_cov_5.997290	210	270	0	9	60	0.1500000
NODE_49801_length_468_cov_5.997290	210	270	2	12	60	0.2000000
NODE_49801_length_468_cov_5.997290	210	270	4	39	60	0.6500000
NODE_49803_length_468_cov_5.872629	133	201	4	35	68	0.5147059
NODE_49803_length_468_cov_5.872629	133	201	6	7	68	0.1029412
NODE_49803_length_468_cov_5.872629	133	201	8	26	68	0.3823529
NODE_49807_length_468_cov_5.384824	305	356	0	51	51	1.0000000
NODE_49894_length_468_cov_2.067751	45	96	0	4	51	0.0784314
NODE_49894_length_468_cov_2.067751	45	96	2	47	51	0.9215686
NODE_49913_length_468_cov_1.891599	4	63	0	59	59	1.0000000
NODE_49928_length_468_cov_1.758808	140	218	0	78	78	1.0000000
NODE_49928_length_468_cov_1.758808	191	257	0	66	66	1.0000000
NODE_49974_length_468_cov_1.390244	291	310	0	19	19	1.0000000
NODE_49974_length_468_cov_1.390244	369	405	2	36	36	1.0000000
NODE_50133_length_467_cov_14.100543	176	256	0	60	80	0.7500000
NODE_50133_length_467_cov_14.100543	176	256	4	20	80	0.2500000
NODE_50134_length_467_cov_11.902174	193	236	0	43	43	1.0000000
NODE_50135_length_467_cov_10.875000	226	306	0	80	80	1.0000000
NODE_50135_length_467_cov_10.875000	279	359	0	80	80	1.0000000
NODE_50144_length_467_cov_6.625000	206	275	2	43	69	0.6231884
NODE_50144_length_467_cov_6.625000	206	275	4	6	69	0.0869565
NODE_50144_length_467_cov_6.625000	206	275	8	20	69	0.2898551
NODE_50144_length_467_cov_6.625000	257	328	6	35	71	0.4929577
NODE_50144_length_467_cov_6.625000	257	328	8	36	71	0.5070422
NODE_50197_length_467_cov_2.709239	247	327	2	2	80	0.0250000
NODE_50197_length_467_cov_2.709239	247	327	4	78	80	0.9750000
NODE_50215_length_467_cov_2.296196	284	329	0	45	45	1.0000000
NODE_50238_length_467_cov_2.027174	218	269	0	51	51	1.0000000
NODE_50252_length_467_cov_1.836957	55	118	0	63	63	1.0000000
NODE_50267_length_467_cov_1.603261	92	141	0	1	49	0.0204082
NODE_50267_length_467_cov_1.603261	92	141	2	1	49	0.0204082
NODE_50267_length_467_cov_1.603261	92	141	4	26	49	0.5306122
NODE_50267_length_467_cov_1.603261	92	141	6	21	49	0.4285714
NODE_50283_length_467_cov_1.426630	135	183	0	46	48	0.9583333
NODE_50283_length_467_cov_1.426630	135	183	1	2	48	0.0416667
NODE_50447_length_466_cov_42.839237	0	47	0	47	47	1.0000000
NODE_50447_length_466_cov_42.839237	20	100	0	63	80	0.7875000
NODE_50447_length_466_cov_42.839237	20	100	2	17	80	0.2125000
NODE_50447_length_466_cov_42.839237	96	176	2	20	80	0.2500000
NODE_50447_length_466_cov_42.839237	96	176	6	26	80	0.3250000
NODE_50447_length_466_cov_42.839237	96	176	8	34	80	0.4250000
NODE_50447_length_466_cov_42.839237	149	229	2	22	80	0.2750000
NODE_50447_length_466_cov_42.839237	149	229	6	9	80	0.1125000
NODE_50447_length_466_cov_42.839237	149	229	8	49	80	0.6125000
NODE_50448_length_466_cov_36.901907	85	165	0	80	80	1.0000000
NODE_50448_length_466_cov_36.901907	138	218	0	80	80	1.0000000
NODE_50448_length_466_cov_36.901907	214	294	0	15	80	0.1875000
NODE_50448_length_466_cov_36.901907	214	294	2	65	80	0.8125000
NODE_50448_length_466_cov_36.901907	267	347	2	80	80	1.0000000
NODE_50457_length_466_cov_5.122616	275	316	0	41	41	1.0000000
NODE_50457_length_466_cov_5.122616	276	316	0	40	40	1.0000000
NODE_50457_length_466_cov_5.122616	289	338	0	49	49	1.0000000
NODE_50515_length_466_cov_2.602180	9	90	4	16	81	0.1975309
NODE_50515_length_466_cov_2.602180	9	90	6	6	81	0.0740741
NODE_50515_length_466_cov_2.602180	9	90	8	3	81	0.0370370
NODE_50515_length_466_cov_2.602180	9	90	10	5	81	0.0617284
NODE_50515_length_466_cov_2.602180	9	90	12	1	81	0.0123457
NODE_50515_length_466_cov_2.602180	9	90	14	13	81	0.1604938
NODE_50515_length_466_cov_2.602180	9	90	16	37	81	0.4567901
NODE_50515_length_466_cov_2.602180	312	341	4	4	29	0.1379310
NODE_50515_length_466_cov_2.602180	312	341	5	19	29	0.6551724
NODE_50515_length_466_cov_2.602180	312	341	7	6	29	0.2068966
NODE_50549_length_466_cov_2.108992	130	182	2	52	52	1.0000000
NODE_50562_length_466_cov_1.980926	183	265	0	67	82	0.8170732
NODE_50562_length_466_cov_1.980926	183	265	6	4	82	0.0487805
NODE_50562_length_466_cov_1.980926	183	265	8	11	82	0.1341463
NODE_50787_length_465_cov_13.019126	170	250	7	11	80	0.1375000
NODE_50787_length_465_cov_13.019126	170	250	8	19	80	0.2375000
NODE_50787_length_465_cov_13.019126	170	250	10	50	80	0.6250000
NODE_50787_length_465_cov_13.019126	223	301	8	52	78	0.6666667
NODE_50787_length_465_cov_13.019126	223	301	10	26	78	0.3333333
NODE_50799_length_465_cov_5.363388	316	393	0	77	77	1.0000000
NODE_50800_length_465_cov_4.898907	376	406	0	30	30	1.0000000
NODE_50869_length_465_cov_2.366120	147	227	0	80	80	1.0000000
NODE_50869_length_465_cov_2.366120	200	271	0	71	71	1.0000000
NODE_50911_length_465_cov_1.737705	338	383	6	22	45	0.4888889
NODE_50911_length_465_cov_1.737705	338	383	8	23	45	0.5111111
NODE_51100_length_464_cov_8.473973	209	289	2	80	80	1.0000000
NODE_51100_length_464_cov_8.473973	262	342	0	39	80	0.4875000
NODE_51100_length_464_cov_8.473973	262	342	2	41	80	0.5125000
NODE_51148_length_464_cov_2.528767	136	199	0	63	63	1.0000000
NODE_51167_length_464_cov_2.134247	130	203	2	18	73	0.2465753
NODE_51167_length_464_cov_2.134247	130	203	4	39	73	0.5342466
NODE_51167_length_464_cov_2.134247	130	203	6	16	73	0.2191781
NODE_51186_length_464_cov_1.901370	58	138	0	41	80	0.5125000
NODE_51186_length_464_cov_1.901370	58	138	2	39	80	0.4875000
NODE_51203_length_464_cov_1.706849	186	265	2	1	79	0.0126582
NODE_51203_length_464_cov_1.706849	186	265	4	11	79	0.1392405
NODE_51203_length_464_cov_1.706849	186	265	8	67	79	0.8481013
NODE_51377_length_463_cov_64.420330	375	455	0	33	80	0.4125000
NODE_51377_length_463_cov_64.420330	375	455	2	8	80	0.1000000
NODE_51377_length_463_cov_64.420330	375	455	3	7	80	0.0875000
NODE_51377_length_463_cov_64.420330	375	455	4	32	80	0.4000000
NODE_51377_length_463_cov_64.420330	375	455	0	33	80	0.4125000
NODE_51377_length_463_cov_64.420330	375	455	2	8	80	0.1000000
NODE_51377_length_463_cov_64.420330	375	455	3	7	80	0.0875000
NODE_51377_length_463_cov_64.420330	375	455	4	32	80	0.4000000
NODE_51377_length_463_cov_64.420330	375	455	0	33	80	0.4125000
NODE_51377_length_463_cov_64.420330	375	455	2	8	80	0.1000000
NODE_51377_length_463_cov_64.420330	375	455	3	7	80	0.0875000
NODE_51377_length_463_cov_64.420330	375	455	4	32	80	0.4000000
NODE_51377_length_463_cov_64.420330	375	455	0	33	80	0.4125000
NODE_51377_length_463_cov_64.420330	375	455	2	8	80	0.1000000
NODE_51377_length_463_cov_64.420330	375	455	3	7	80	0.0875000
NODE_51377_length_463_cov_64.420330	375	455	4	32	80	0.4000000
NODE_51377_length_463_cov_64.420330	375	455	0	33	80	0.4125000
NODE_51377_length_463_cov_64.420330	375	455	2	8	80	0.1000000
NODE_51377_length_463_cov_64.420330	375	455	3	7	80	0.0875000
NODE_51377_length_463_cov_64.420330	375	455	4	32	80	0.4000000
NODE_51378_length_463_cov_49.673077	0	71	0	28	71	0.3943662
NODE_51378_length_463_cov_49.673077	0	71	2	18	71	0.2535211
NODE_51378_length_463_cov_49.673077	0	71	4	25	71	0.3521127
NODE_51378_length_463_cov_49.673077	44	121	2	2	77	0.0259740
NODE_51378_length_463_cov_49.673077	44	121	4	26	77	0.3376623
NODE_51378_length_463_cov_49.673077	44	121	8	25	77	0.3246753
NODE_51378_length_463_cov_49.673077	44	121	10	7	77	0.0909091
NODE_51378_length_463_cov_49.673077	44	121	12	14	77	0.1818182
NODE_51378_length_463_cov_49.673077	44	121	14	3	77	0.0389610
NODE_51379_length_463_cov_41.005495	8	88	0	29	80	0.3625000
NODE_51379_length_463_cov_41.005495	8	88	4	51	80	0.6375000
NODE_51379_length_463_cov_41.005495	61	141	4	80	80	1.0000000
NODE_51380_length_463_cov_30.626374	318	398	0	80	80	1.0000000
NODE_51380_length_463_cov_30.626374	371	451	0	80	80	1.0000000
NODE_51381_length_463_cov_27.475275	211	291	2	11	80	0.1375000
NODE_51381_length_463_cov_27.475275	211	291	4	11	80	0.1375000
NODE_51381_length_463_cov_27.475275	211	291	6	58	80	0.7250000
NODE_51381_length_463_cov_27.475275	264	344	0	8	80	0.1000000
NODE_51381_length_463_cov_27.475275	264	344	2	6	80	0.0750000
NODE_51381_length_463_cov_27.475275	264	344	4	5	80	0.0625000
NODE_51381_length_463_cov_27.475275	264	344	6	61	80	0.7625000
NODE_51383_length_463_cov_11.211538	304	377	6	23	73	0.3150685
NODE_51383_length_463_cov_11.211538	304	377	8	14	73	0.1917808
NODE_51383_length_463_cov_11.211538	304	377	10	36	73	0.4931507
NODE_51383_length_463_cov_11.211538	350	430	4	36	80	0.4500000
NODE_51383_length_463_cov_11.211538	350	430	6	3	80	0.0375000
NODE_51383_length_463_cov_11.211538	350	430	9	1	80	0.0125000
NODE_51383_length_463_cov_11.211538	350	430	10	40	80	0.5000000
NODE_51391_length_463_cov_5.711538	181	261	0	80	80	1.0000000
NODE_51391_length_463_cov_5.711538	234	314	0	80	80	1.0000000
NODE_51399_length_463_cov_4.398352	119	169	0	48	50	0.9600000
NODE_51399_length_463_cov_4.398352	119	169	2	2	50	0.0400000
NODE_51402_length_463_cov_4.186813	175	233	6	4	58	0.0689655
NODE_51402_length_463_cov_4.186813	175	233	8	4	58	0.0689655
NODE_51402_length_463_cov_4.186813	175	233	10	13	58	0.2241379
NODE_51402_length_463_cov_4.186813	175	233	12	37	58	0.6379310
NODE_51402_length_463_cov_4.186813	206	251	10	27	45	0.6000000
NODE_51402_length_463_cov_4.186813	206	251	12	18	45	0.4000000
NODE_51408_length_463_cov_3.846154	235	268	0	33	33	1.0000000
NODE_51421_length_463_cov_3.063187	193	248	0	49	55	0.8909091
NODE_51421_length_463_cov_3.063187	193	248	4	6	55	0.1090909
NODE_51421_length_463_cov_3.063187	222	301	0	20	79	0.2531646
NODE_51421_length_463_cov_3.063187	222	301	4	59	79	0.7468355
NODE_51680_length_462_cov_21.876033	93	173	0	13	80	0.1625000
NODE_51680_length_462_cov_21.876033	93	173	2	67	80	0.8375000
NODE_51680_length_462_cov_21.876033	146	226	0	11	80	0.1375000
NODE_51680_length_462_cov_21.876033	146	226	1	14	80	0.1750000
NODE_51680_length_462_cov_21.876033	146	226	2	55	80	0.6875000
NODE_51687_length_462_cov_5.033058	93	154	0	58	61	0.9508197
NODE_51687_length_462_cov_5.033058	93	154	2	3	61	0.0491803
NODE_51687_length_462_cov_5.033058	159	209	2	50	50	1.0000000
NODE_51699_length_462_cov_4.101928	168	246	0	78	78	1.0000000
NODE_51699_length_462_cov_4.101928	184	208	0	24	24	1.0000000
NODE_51699_length_462_cov_4.101928	219	299	0	80	80	1.0000000
NODE_51708_length_462_cov_3.630854	149	194	4	3	45	0.0666667
NODE_51708_length_462_cov_3.630854	149	194	6	42	45	0.9333333
NODE_51720_length_462_cov_3.079890	103	147	0	19	44	0.4318182
NODE_51720_length_462_cov_3.079890	103	147	2	16	44	0.3636364
NODE_51720_length_462_cov_3.079890	103	147	4	9	44	0.2045455
NODE_51735_length_462_cov_2.677686	78	118	0	40	40	1.0000000
NODE_51763_length_462_cov_2.209366	18	58	0	40	40	1.0000000
NODE_51817_length_462_cov_1.570248	68	113	0	45	45	1.0000000
NODE_51995_length_461_cov_35.116022	0	79	0	79	79	1.0000000
NODE_51995_length_461_cov_35.116022	52	132	0	80	80	1.0000000
NODE_51996_length_461_cov_11.124309	77	157	0	32	80	0.4000000
NODE_51996_length_461_cov_11.124309	77	157	2	48	80	0.6000000
NODE_51996_length_461_cov_11.124309	130	210	0	30	80	0.3750000
NODE_51996_length_461_cov_11.124309	130	210	2	50	80	0.6250000
NODE_52010_length_461_cov_5.361878	246	322	0	14	76	0.1842105
NODE_52010_length_461_cov_5.361878	246	322	1	62	76	0.8157895
NODE_52018_length_461_cov_4.472376	268	333	0	65	65	1.0000000
NODE_52021_length_461_cov_4.168508	159	234	0	75	75	1.0000000
NODE_52047_length_461_cov_2.892265	233	312	0	79	79	1.0000000
NODE_52073_length_461_cov_2.392265	186	223	0	37	37	1.0000000
NODE_52154_length_461_cov_1.389503	283	349	0	66	66	1.0000000
NODE_52292_length_460_cov_172.986150	0	68	7	1	68	0.0147059
NODE_52292_length_460_cov_172.986150	0	68	11	1	68	0.0147059
NODE_52292_length_460_cov_172.986150	0	68	13	1	68	0.0147059
NODE_52292_length_460_cov_172.986150	0	68	25	1	68	0.0147059
NODE_52292_length_460_cov_172.986150	0	68	33	1	68	0.0147059
NODE_52292_length_460_cov_172.986150	0	68	37	1	68	0.0147059
NODE_52292_length_460_cov_172.986150	0	68	42	1	68	0.0147059
NODE_52292_length_460_cov_172.986150	0	68	44	1	68	0.0147059
NODE_52292_length_460_cov_172.986150	0	68	58	1	68	0.0147059
NODE_52292_length_460_cov_172.986150	0	68	69	1	68	0.0147059
NODE_52292_length_460_cov_172.986150	0	68	71	1	68	0.0147059
NODE_52292_length_460_cov_172.986150	0	68	78	1	68	0.0147059
NODE_52292_length_460_cov_172.986150	0	68	87	1	68	0.0147059
NODE_52292_length_460_cov_172.986150	0	68	100	1	68	0.0147059
NODE_52292_length_460_cov_172.986150	0	68	104	1	68	0.0147059
NODE_52292_length_460_cov_172.986150	0	68	106	1	68	0.0147059
NODE_52292_length_460_cov_172.986150	0	68	115	1	68	0.0147059
NODE_52292_length_460_cov_172.986150	0	68	126	1	68	0.0147059
NODE_52292_length_460_cov_172.986150	0	68	132	1	68	0.0147059
NODE_52292_length_460_cov_172.986150	0	68	143	1	68	0.0147059
NODE_52292_length_460_cov_172.986150	0	68	156	1	68	0.0147059
NODE_52292_length_460_cov_172.986150	0	68	159	1	68	0.0147059
NODE_52292_length_460_cov_172.986150	0	68	161	1	68	0.0147059
NODE_52292_length_460_cov_172.986150	0	68	172	1	68	0.0147059
NODE_52292_length_460_cov_172.986150	0	68	186	1	68	0.0147059
NODE_52292_length_460_cov_172.986150	0	68	189	2	68	0.0294118
NODE_52292_length_460_cov_172.986150	0	68	201	1	68	0.0147059
NODE_52292_length_460_cov_172.986150	0	68	203	1	68	0.0147059
NODE_52292_length_460_cov_172.986150	0	68	205	4	68	0.0588235
NODE_52292_length_460_cov_172.986150	0	68	207	1	68	0.0147059
NODE_52292_length_460_cov_172.986150	0	68	215	1	68	0.0147059
NODE_52292_length_460_cov_172.986150	0	68	217	2	68	0.0294118
NODE_52292_length_460_cov_172.986150	0	68	219	2	68	0.0294118
NODE_52292_length_460_cov_172.986150	0	68	221	1	68	0.0147059
NODE_52292_length_460_cov_172.986150	0	68	223	4	68	0.0588235
NODE_52292_length_460_cov_172.986150	0	68	231	1	68	0.0147059
NODE_52292_length_460_cov_172.986150	0	68	237	1	68	0.0147059
NODE_52292_length_460_cov_172.986150	0	68	247	2	68	0.0294118
NODE_52292_length_460_cov_172.986150	0	68	257	1	68	0.0147059
NODE_52292_length_460_cov_172.986150	0	68	264	1	68	0.0147059
NODE_52292_length_460_cov_172.986150	0	68	265	2	68	0.0294118
NODE_52292_length_460_cov_172.986150	0	68	271	1	68	0.0147059
NODE_52292_length_460_cov_172.986150	0	68	273	1	68	0.0147059
NODE_52292_length_460_cov_172.986150	0	68	282	1	68	0.0147059
NODE_52292_length_460_cov_172.986150	0	68	287	2	68	0.0294118
NODE_52292_length_460_cov_172.986150	0	68	298	1	68	0.0147059
NODE_52292_length_460_cov_172.986150	0	68	300	1	68	0.0147059
NODE_52292_length_460_cov_172.986150	0	68	304	3	68	0.0441176
NODE_52292_length_460_cov_172.986150	0	68	305	3	68	0.0441176
NODE_52292_length_460_cov_172.986150	0	68	307	1	68	0.0147059
NODE_52292_length_460_cov_172.986150	0	68	308	2	68	0.0294118
NODE_52292_length_460_cov_172.986150	41	121	223	3	80	0.0375000
NODE_52292_length_460_cov_172.986150	41	121	231	1	80	0.0125000
NODE_52292_length_460_cov_172.986150	41	121	237	1	80	0.0125000
NODE_52292_length_460_cov_172.986150	41	121	247	2	80	0.0250000
NODE_52292_length_460_cov_172.986150	41	121	257	1	80	0.0125000
NODE_52292_length_460_cov_172.986150	41	121	264	1	80	0.0125000
NODE_52292_length_460_cov_172.986150	41	121	265	2	80	0.0250000
NODE_52292_length_460_cov_172.986150	41	121	271	1	80	0.0125000
NODE_52292_length_460_cov_172.986150	41	121	273	1	80	0.0125000
NODE_52292_length_460_cov_172.986150	41	121	282	1	80	0.0125000
NODE_52292_length_460_cov_172.986150	41	121	287	2	80	0.0250000
NODE_52292_length_460_cov_172.986150	41	121	298	1	80	0.0125000
NODE_52292_length_460_cov_172.986150	41	121	300	1	80	0.0125000
NODE_52292_length_460_cov_172.986150	41	121	304	3	80	0.0375000
NODE_52292_length_460_cov_172.986150	41	121	305	3	80	0.0375000
NODE_52292_length_460_cov_172.986150	41	121	307	1	80	0.0125000
NODE_52292_length_460_cov_172.986150	41	121	308	2	80	0.0250000
NODE_52292_length_460_cov_172.986150	41	121	311	4	80	0.0500000
NODE_52292_length_460_cov_172.986150	41	121	315	1	80	0.0125000
NODE_52292_length_460_cov_172.986150	41	121	317	3	80	0.0375000
NODE_52292_length_460_cov_172.986150	41	121	323	1	80	0.0125000
NODE_52292_length_460_cov_172.986150	41	121	327	1	80	0.0125000
NODE_52292_length_460_cov_172.986150	41	121	329	1	80	0.0125000
NODE_52292_length_460_cov_172.986150	41	121	335	5	80	0.0625000
NODE_52292_length_460_cov_172.986150	41	121	339	3	80	0.0375000
NODE_52292_length_460_cov_172.986150	41	121	341	1	80	0.0125000
NODE_52292_length_460_cov_172.986150	41	121	343	1	80	0.0125000
NODE_52292_length_460_cov_172.986150	41	121	347	1	80	0.0125000
NODE_52292_length_460_cov_172.986150	41	121	349	2	80	0.0250000
NODE_52292_length_460_cov_172.986150	41	121	355	1	80	0.0125000
NODE_52292_length_460_cov_172.986150	41	121	357	4	80	0.0500000
NODE_52292_length_460_cov_172.986150	41	121	358	1	80	0.0125000
NODE_52292_length_460_cov_172.986150	41	121	361	1	80	0.0125000
NODE_52292_length_460_cov_172.986150	41	121	363	1	80	0.0125000
NODE_52292_length_460_cov_172.986150	41	121	365	2	80	0.0250000
NODE_52292_length_460_cov_172.986150	41	121	371	2	80	0.0250000
NODE_52292_length_460_cov_172.986150	41	121	375	1	80	0.0125000
NODE_52292_length_460_cov_172.986150	41	121	379	3	80	0.0375000
NODE_52292_length_460_cov_172.986150	41	121	381	1	80	0.0125000
NODE_52292_length_460_cov_172.986150	41	121	387	1	80	0.0125000
NODE_52292_length_460_cov_172.986150	41	121	393	1	80	0.0125000
NODE_52292_length_460_cov_172.986150	41	121	394	1	80	0.0125000
NODE_52292_length_460_cov_172.986150	41	121	395	3	80	0.0375000
NODE_52292_length_460_cov_172.986150	41	121	405	1	80	0.0125000
NODE_52292_length_460_cov_172.986150	41	121	415	1	80	0.0125000
NODE_52292_length_460_cov_172.986150	41	121	417	4	80	0.0500000
NODE_52293_length_460_cov_62.512465	9	48	0	5	39	0.1282051
NODE_52293_length_460_cov_62.512465	9	48	2	1	39	0.0256410
NODE_52293_length_460_cov_62.512465	9	48	4	9	39	0.2307692
NODE_52293_length_460_cov_62.512465	9	48	6	9	39	0.2307692
NODE_52293_length_460_cov_62.512465	9	48	8	11	39	0.2820513
NODE_52293_length_460_cov_62.512465	9	48	9	4	39	0.1025641
NODE_52294_length_460_cov_33.146814	0	47	0	47	47	1.0000000
NODE_52294_length_460_cov_33.146814	43	115	0	72	72	1.0000000
NODE_52294_length_460_cov_33.146814	96	165	0	69	69	1.0000000
NODE_52295_length_460_cov_26.049861	0	63	0	4	63	0.0634921
NODE_52295_length_460_cov_26.049861	0	63	7	21	63	0.3333333
NODE_52295_length_460_cov_26.049861	0	63	11	22	63	0.3492064
NODE_52295_length_460_cov_26.049861	0	63	15	4	63	0.0634921
NODE_52295_length_460_cov_26.049861	0	63	16	1	63	0.0158730
NODE_52295_length_460_cov_26.049861	0	63	18	5	63	0.0793651
NODE_52295_length_460_cov_26.049861	0	63	24	6	63	0.0952381
NODE_52296_length_460_cov_25.709141	246	326	0	80	80	1.0000000
NODE_52296_length_460_cov_25.709141	299	379	0	80	80	1.0000000
NODE_52297_length_460_cov_11.063712	273	353	0	80	80	1.0000000
NODE_52297_length_460_cov_11.063712	326	406	0	80	80	1.0000000
NODE_52303_length_460_cov_7.285319	172	250	0	58	78	0.7435898
NODE_52303_length_460_cov_7.285319	172	250	1	20	78	0.2564103
NODE_52312_length_460_cov_5.163435	120	200	5	25	80	0.3125000
NODE_52312_length_460_cov_5.163435	120	200	6	3	80	0.0375000
NODE_52312_length_460_cov_5.163435	120	200	9	6	80	0.0750000
NODE_52312_length_460_cov_5.163435	120	200	13	11	80	0.1375000
NODE_52312_length_460_cov_5.163435	120	200	15	15	80	0.1875000
NODE_52312_length_460_cov_5.163435	120	200	16	16	80	0.2000000
NODE_52312_length_460_cov_5.163435	120	200	17	4	80	0.0500000
NODE_52312_length_460_cov_5.163435	173	253	3	10	80	0.1250000
NODE_52312_length_460_cov_5.163435	173	253	7	10	80	0.1250000
NODE_52312_length_460_cov_5.163435	173	253	9	10	80	0.1250000
NODE_52312_length_460_cov_5.163435	173	253	13	3	80	0.0375000
NODE_52312_length_460_cov_5.163435	173	253	15	34	80	0.4250000
NODE_52312_length_460_cov_5.163435	173	253	16	13	80	0.1625000
NODE_52333_length_460_cov_3.457064	150	230	0	54	80	0.6750000
NODE_52333_length_460_cov_3.457064	150	230	3	1	80	0.0125000
NODE_52333_length_460_cov_3.457064	150	230	4	25	80	0.3125000
NODE_52333_length_460_cov_3.457064	203	246	0	1	43	0.0232558
NODE_52333_length_460_cov_3.457064	203	246	3	1	43	0.0232558
NODE_52333_length_460_cov_3.457064	203	246	4	41	43	0.9534883
NODE_52339_length_460_cov_3.027701	167	230	0	63	63	1.0000000
NODE_52347_length_460_cov_2.819945	195	266	7	5	71	0.0704225
NODE_52347_length_460_cov_2.819945	195	266	9	32	71	0.4507042
NODE_52347_length_460_cov_2.819945	195	266	10	5	71	0.0704225
NODE_52347_length_460_cov_2.819945	195	266	12	7	71	0.0985916
NODE_52347_length_460_cov_2.819945	195	266	14	22	71	0.3098592
NODE_52358_length_460_cov_2.626039	223	277	0	54	54	1.0000000
NODE_52612_length_459_cov_34.927778	165	239	0	9	74	0.1216216
NODE_52612_length_459_cov_34.927778	165	239	2	35	74	0.4729730
NODE_52612_length_459_cov_34.927778	165	239	4	30	74	0.4054054
NODE_52612_length_459_cov_34.927778	212	292	0	35	80	0.4375000
NODE_52612_length_459_cov_34.927778	212	292	2	2	80	0.0250000
NODE_52612_length_459_cov_34.927778	212	292	4	43	80	0.5375000
NODE_52617_length_459_cov_7.261111	143	189	0	28	46	0.6086956
NODE_52617_length_459_cov_7.261111	143	189	2	6	46	0.1304348
NODE_52617_length_459_cov_7.261111	143	189	4	12	46	0.2608696
NODE_52617_length_459_cov_7.261111	162	242	0	9	80	0.1125000
NODE_52617_length_459_cov_7.261111	162	242	2	10	80	0.1250000
NODE_52617_length_459_cov_7.261111	162	242	4	61	80	0.7625000
NODE_52635_length_459_cov_4.127778	153	233	0	80	80	1.0000000
NODE_52685_length_459_cov_2.158333	219	285	2	66	66	1.0000000
NODE_52685_length_459_cov_2.158333	283	342	0	18	59	0.3050847
NODE_52685_length_459_cov_2.158333	283	342	2	41	59	0.6949152
NODE_52704_length_459_cov_1.722222	280	353	1	1	73	0.0136986
NODE_52704_length_459_cov_1.722222	280	353	2	16	73	0.2191781
NODE_52704_length_459_cov_1.722222	280	353	4	6	73	0.0821918
NODE_52704_length_459_cov_1.722222	280	353	6	24	73	0.3287671
NODE_52704_length_459_cov_1.722222	280	353	8	26	73	0.3561644
NODE_52920_length_458_cov_71.047354	0	51	0	51	51	1.0000000
NODE_52920_length_458_cov_71.047354	24	104	0	66	80	0.8250000
NODE_52920_length_458_cov_71.047354	24	104	2	14	80	0.1750000
NODE_52920_length_458_cov_71.047354	100	180	2	27	80	0.3375000
NODE_52920_length_458_cov_71.047354	100	180	4	17	80	0.2125000
NODE_52920_length_458_cov_71.047354	100	180	6	30	80	0.3750000
NODE_52920_length_458_cov_71.047354	100	180	8	6	80	0.0750000
NODE_52920_length_458_cov_71.047354	153	233	6	27	80	0.3375000
NODE_52920_length_458_cov_71.047354	153	233	8	31	80	0.3875000
NODE_52920_length_458_cov_71.047354	153	233	10	22	80	0.2750000
NODE_52921_length_458_cov_47.966574	151	231	0	80	80	1.0000000
NODE_52921_length_458_cov_47.966574	204	284	0	80	80	1.0000000
NODE_52921_length_458_cov_47.966574	280	360	0	80	80	1.0000000
NODE_52921_length_458_cov_47.966574	333	413	0	80	80	1.0000000
NODE_52924_length_458_cov_9.935933	267	347	6	6	80	0.0750000
NODE_52924_length_458_cov_9.935933	267	347	8	42	80	0.5250000
NODE_52924_length_458_cov_9.935933	267	347	10	32	80	0.4000000
NODE_52924_length_458_cov_9.935933	320	400	0	30	80	0.3750000
NODE_52924_length_458_cov_9.935933	320	400	2	3	80	0.0375000
NODE_52924_length_458_cov_9.935933	320	400	4	16	80	0.2000000
NODE_52924_length_458_cov_9.935933	320	400	6	7	80	0.0875000
NODE_52924_length_458_cov_9.935933	320	400	8	24	80	0.3000000
NODE_52929_length_458_cov_7.598886	87	167	2	31	80	0.3875000
NODE_52929_length_458_cov_7.598886	87	167	4	49	80	0.6125000
NODE_52967_length_458_cov_3.061281	62	91	4	29	29	1.0000000
NODE_52967_length_458_cov_3.061281	185	224	0	39	39	1.0000000
NODE_52992_length_458_cov_2.454039	210	251	0	41	41	1.0000000
NODE_53107_length_458_cov_1.139276	242	289	2	16	47	0.3404255
NODE_53107_length_458_cov_1.139276	242	289	4	8	47	0.1702128
NODE_53107_length_458_cov_1.139276	242	289	8	23	47	0.4893617
NODE_53107_length_458_cov_1.139276	262	328	2	35	66	0.5303030
NODE_53107_length_458_cov_1.139276	262	328	4	28	66	0.4242424
NODE_53107_length_458_cov_1.139276	262	328	8	3	66	0.0454545
NODE_53205_length_457_cov_20.754190	123	203	0	43	80	0.5375000
NODE_53205_length_457_cov_20.754190	123	203	2	37	80	0.4625000
NODE_53205_length_457_cov_20.754190	176	256	0	80	80	1.0000000
NODE_53207_length_457_cov_13.918994	218	298	0	80	80	1.0000000
NODE_53207_length_457_cov_13.918994	218	298	0	80	80	1.0000000
NODE_53207_length_457_cov_13.918994	218	298	0	80	80	1.0000000
NODE_53207_length_457_cov_13.918994	218	298	0	80	80	1.0000000
NODE_53207_length_457_cov_13.918994	271	320	0	48	49	0.9795918
NODE_53207_length_457_cov_13.918994	271	320	2	1	49	0.0204082
NODE_53207_length_457_cov_13.918994	271	320	0	48	49	0.9795918
NODE_53207_length_457_cov_13.918994	271	320	2	1	49	0.0204082
NODE_53207_length_457_cov_13.918994	271	320	0	48	49	0.9795918
NODE_53207_length_457_cov_13.918994	271	320	2	1	49	0.0204082
NODE_53216_length_457_cov_6.050279	264	326	0	62	62	1.0000000
NODE_53220_length_457_cov_5.078212	71	149	0	78	78	1.0000000
NODE_53220_length_457_cov_5.078212	122	202	0	80	80	1.0000000
NODE_53225_length_457_cov_4.530726	193	273	0	18	80	0.2250000
NODE_53225_length_457_cov_4.530726	193	273	2	62	80	0.7750000
NODE_53225_length_457_cov_4.530726	246	315	2	69	69	1.0000000
NODE_53230_length_457_cov_3.986034	192	272	0	80	80	1.0000000
NODE_53267_length_457_cov_2.636872	117	197	0	25	80	0.3125000
NODE_53267_length_457_cov_2.636872	117	197	1	18	80	0.2250000
NODE_53267_length_457_cov_2.636872	117	197	2	37	80	0.4625000
NODE_53462_length_457_cov_0.916201	108	188	0	80	80	1.0000000
NODE_53462_length_457_cov_0.916201	108	188	0	80	80	1.0000000
NODE_53462_length_457_cov_0.916201	161	241	0	80	80	1.0000000
NODE_53462_length_457_cov_0.916201	161	241	0	80	80	1.0000000
NODE_53512_length_456_cov_34.731092	0	63	0	63	63	1.0000000
NODE_53512_length_456_cov_34.731092	36	116	0	80	80	1.0000000
NODE_53512_length_456_cov_34.731092	112	194	0	82	82	1.0000000
NODE_53532_length_456_cov_4.582633	269	349	0	80	80	1.0000000
NODE_53533_length_456_cov_4.554622	124	206	0	24	82	0.2926829
NODE_53533_length_456_cov_4.554622	124	206	2	58	82	0.7073171
NODE_53533_length_456_cov_4.554622	179	263	0	81	84	0.9642857
NODE_53533_length_456_cov_4.554622	179	263	2	3	84	0.0357143
NODE_53546_length_456_cov_3.669468	123	186	0	3	63	0.0476190
NODE_53546_length_456_cov_3.669468	123	186	2	4	63	0.0634921
NODE_53546_length_456_cov_3.669468	123	186	4	56	63	0.8888889
NODE_53566_length_456_cov_2.921569	302	362	0	60	60	1.0000000
NODE_53859_length_455_cov_113.589888	137	220	8	83	83	1.0000000
NODE_53859_length_455_cov_113.589888	198	268	0	3	70	0.0428571
NODE_53859_length_455_cov_113.589888	198	268	2	3	70	0.0428571
NODE_53859_length_455_cov_113.589888	198	268	3	21	70	0.3000000
NODE_53859_length_455_cov_113.589888	198	268	5	19	70	0.2714286
NODE_53859_length_455_cov_113.589888	198	268	8	24	70	0.3428572
NODE_53859_length_455_cov_113.589888	269	348	5	23	79	0.2911392
NODE_53859_length_455_cov_113.589888	269	348	6	13	79	0.1645570
NODE_53859_length_455_cov_113.589888	269	348	10	12	79	0.1518987
NODE_53859_length_455_cov_113.589888	269	348	12	4	79	0.0506329
NODE_53859_length_455_cov_113.589888	269	348	14	6	79	0.0759494
NODE_53859_length_455_cov_113.589888	269	348	16	8	79	0.1012658
NODE_53859_length_455_cov_113.589888	269	348	18	4	79	0.0506329
NODE_53859_length_455_cov_113.589888	269	348	20	7	79	0.0886076
NODE_53859_length_455_cov_113.589888	269	348	22	2	79	0.0253165
NODE_53859_length_455_cov_113.589888	321	401	14	6	80	0.0750000
NODE_53859_length_455_cov_113.589888	321	401	16	8	80	0.1000000
NODE_53859_length_455_cov_113.589888	321	401	17	21	80	0.2625000
NODE_53859_length_455_cov_113.589888	321	401	18	4	80	0.0500000
NODE_53859_length_455_cov_113.589888	321	401	19	2	80	0.0250000
NODE_53859_length_455_cov_113.589888	321	401	20	37	80	0.4625000
NODE_53859_length_455_cov_113.589888	321	401	22	2	80	0.0250000
NODE_53860_length_455_cov_52.941011	260	340	0	32	80	0.4000000
NODE_53860_length_455_cov_52.941011	260	340	2	48	80	0.6000000
NODE_53860_length_455_cov_52.941011	313	393	0	80	80	1.0000000
NODE_53863_length_455_cov_8.584270	250	302	0	52	52	1.0000000
NODE_53863_length_455_cov_8.584270	275	355	0	80	80	1.0000000
NODE_53864_length_455_cov_8.084270	146	226	5	13	80	0.1625000
NODE_53864_length_455_cov_8.084270	146	226	9	1	80	0.0125000
NODE_53864_length_455_cov_8.084270	146	226	11	14	80	0.1750000
NODE_53864_length_455_cov_8.084270	146	226	13	2	80	0.0250000
NODE_53864_length_455_cov_8.084270	146	226	15	2	80	0.0250000
NODE_53864_length_455_cov_8.084270	146	226	16	2	80	0.0250000
NODE_53864_length_455_cov_8.084270	146	226	17	46	80	0.5750000
NODE_53864_length_455_cov_8.084270	199	279	0	25	80	0.3125000
NODE_53864_length_455_cov_8.084270	199	279	2	19	80	0.2375000
NODE_53864_length_455_cov_8.084270	199	279	5	22	80	0.2750000
NODE_53864_length_455_cov_8.084270	199	279	9	1	80	0.0125000
NODE_53864_length_455_cov_8.084270	199	279	11	13	80	0.1625000
NODE_53870_length_455_cov_6.022472	122	203	0	6	81	0.0740741
NODE_53870_length_455_cov_6.022472	122	203	2	1	81	0.0123457
NODE_53870_length_455_cov_6.022472	122	203	4	6	81	0.0740741
NODE_53870_length_455_cov_6.022472	122	203	5	24	81	0.2962963
NODE_53870_length_455_cov_6.022472	122	203	7	16	81	0.1975309
NODE_53870_length_455_cov_6.022472	122	203	9	28	81	0.3456790
NODE_53872_length_455_cov_5.140449	181	232	0	51	51	1.0000000
NODE_54512_length_453_cov_29.528249	44	124	0	80	80	1.0000000
NODE_54512_length_453_cov_29.528249	97	177	0	80	80	1.0000000
NODE_54512_length_453_cov_29.528249	173	253	0	64	80	0.8000000
NODE_54512_length_453_cov_29.528249	173	253	4	16	80	0.2000000
NODE_54512_length_453_cov_29.528249	226	301	0	11	75	0.1466667
NODE_54512_length_453_cov_29.528249	226	301	4	64	75	0.8533334
NODE_54513_length_453_cov_11.146893	95	140	0	45	45	1.0000000
NODE_54513_length_453_cov_11.146893	146	220	0	74	74	1.0000000
NODE_54517_length_453_cov_7.709040	194	252	4	20	58	0.3448276
NODE_54517_length_453_cov_7.709040	194	252	8	38	58	0.6551724
NODE_54518_length_453_cov_7.440678	250	319	0	69	69	1.0000000
NODE_54533_length_453_cov_4.282486	190	270	0	80	80	1.0000000
NODE_54533_length_453_cov_4.282486	243	283	0	40	40	1.0000000
NODE_54566_length_453_cov_2.836158	186	266	0	80	80	1.0000000
NODE_54566_length_453_cov_2.836158	239	319	0	80	80	1.0000000
NODE_54592_length_453_cov_2.048023	139	174	4	16	35	0.4571429
NODE_54592_length_453_cov_2.048023	139	174	6	13	35	0.3714286
NODE_54592_length_453_cov_2.048023	139	174	8	6	35	0.1714286
NODE_54600_length_453_cov_2.002825	78	98	0	20	20	1.0000000
NODE_54767_length_453_cov_0.774011	174	195	2	21	21	1.0000000
NODE_54822_length_452_cov_36.028329	0	72	0	38	72	0.5277778
NODE_54822_length_452_cov_36.028329	0	72	2	34	72	0.4722222
NODE_54822_length_452_cov_36.028329	0	72	0	38	72	0.5277778
NODE_54822_length_452_cov_36.028329	0	72	2	34	72	0.4722222
NODE_54822_length_452_cov_36.028329	45	99	2	54	54	1.0000000
NODE_54822_length_452_cov_36.028329	45	125	0	3	80	0.0375000
NODE_54822_length_452_cov_36.028329	45	125	2	77	80	0.9625000
NODE_54823_length_452_cov_17.424929	29	109	0	80	80	1.0000000
NODE_54823_length_452_cov_17.424929	82	162	0	80	80	1.0000000
NODE_54844_length_452_cov_4.317280	141	200	0	59	59	1.0000000
NODE_54886_length_452_cov_2.634561	262	338	0	27	76	0.3552631
NODE_54886_length_452_cov_2.634561	262	338	4	21	76	0.2763158
NODE_54886_length_452_cov_2.634561	262	338	6	28	76	0.3684210
NODE_55146_length_451_cov_37.090909	230	310	4	5	80	0.0625000
NODE_55146_length_451_cov_37.090909	230	310	8	21	80	0.2625000
NODE_55146_length_451_cov_37.090909	230	310	10	19	80	0.2375000
NODE_55146_length_451_cov_37.090909	230	310	12	35	80	0.4375000
NODE_55146_length_451_cov_37.090909	283	363	7	36	80	0.4500000
NODE_55146_length_451_cov_37.090909	283	363	8	8	80	0.1000000
NODE_55146_length_451_cov_37.090909	283	363	10	28	80	0.3500000
NODE_55146_length_451_cov_37.090909	283	363	12	8	80	0.1000000
NODE_55147_length_451_cov_16.517045	205	286	4	34	81	0.4197531
NODE_55147_length_451_cov_16.517045	205	286	6	36	81	0.4444444
NODE_55147_length_451_cov_16.517045	205	286	8	11	81	0.1358025
NODE_55147_length_451_cov_16.517045	259	339	2	34	80	0.4250000
NODE_55147_length_451_cov_16.517045	259	339	4	26	80	0.3250000
NODE_55147_length_451_cov_16.517045	259	339	6	20	80	0.2500000
NODE_55148_length_451_cov_13.153409	182	262	0	80	80	1.0000000
NODE_55148_length_451_cov_13.153409	235	315	0	80	80	1.0000000
NODE_55149_length_451_cov_11.926136	141	221	2	5	80	0.0625000
NODE_55149_length_451_cov_11.926136	141	221	4	45	80	0.5625000
NODE_55149_length_451_cov_11.926136	141	221	6	20	80	0.2500000
NODE_55149_length_451_cov_11.926136	141	221	7	10	80	0.1250000
NODE_55149_length_451_cov_11.926136	331	411	0	80	80	1.0000000
NODE_55154_length_451_cov_7.102273	81	143	0	62	62	1.0000000
NODE_55161_length_451_cov_5.610795	1	31	0	30	30	1.0000000
NODE_55161_length_451_cov_5.610795	60	90	4	30	30	1.0000000
NODE_55166_length_451_cov_5.065341	219	285	0	10	66	0.1515152
NODE_55166_length_451_cov_5.065341	219	285	2	24	66	0.3636364
NODE_55166_length_451_cov_5.065341	219	285	4	14	66	0.2121212
NODE_55166_length_451_cov_5.065341	219	285	6	9	66	0.1363636
NODE_55166_length_451_cov_5.065341	219	285	8	9	66	0.1363636
NODE_55166_length_451_cov_5.065341	272	322	6	4	50	0.0800000
NODE_55166_length_451_cov_5.065341	272	322	8	46	50	0.9200000
NODE_55184_length_451_cov_3.696023	253	332	4	36	79	0.4556962
NODE_55184_length_451_cov_3.696023	253	332	6	9	79	0.1139240
NODE_55184_length_451_cov_3.696023	253	332	8	3	79	0.0379747
NODE_55184_length_451_cov_3.696023	253	332	10	2	79	0.0253165
NODE_55184_length_451_cov_3.696023	253	332	12	2	79	0.0253165
NODE_55184_length_451_cov_3.696023	253	332	16	3	79	0.0379747
NODE_55184_length_451_cov_3.696023	253	332	18	9	79	0.1139240
NODE_55184_length_451_cov_3.696023	253	332	22	15	79	0.1898734
NODE_55188_length_451_cov_3.406250	176	247	6	1	71	0.0140845
NODE_55188_length_451_cov_3.406250	176	247	8	13	71	0.1830986
NODE_55188_length_451_cov_3.406250	176	247	10	5	71	0.0704225
NODE_55188_length_451_cov_3.406250	176	247	12	5	71	0.0704225
NODE_55188_length_451_cov_3.406250	176	247	14	47	71	0.6619718
NODE_55188_length_451_cov_3.406250	220	300	12	18	80	0.2250000
NODE_55188_length_451_cov_3.406250	220	300	14	53	80	0.6625000
NODE_55188_length_451_cov_3.406250	220	300	18	9	80	0.1125000
NODE_55198_length_451_cov_3.025568	72	148	0	3	76	0.0394737
NODE_55198_length_451_cov_3.025568	72	148	2	73	76	0.9605263
NODE_55213_length_451_cov_2.607955	84	143	0	59	59	1.0000000
NODE_55213_length_451_cov_2.607955	257	326	0	69	69	1.0000000
NODE_55234_length_451_cov_2.125000	156	224	0	68	68	1.0000000
NODE_55436_length_450_cov_105.723647	317	386	0	69	69	1.0000000
NODE_55438_length_450_cov_27.982906	98	120	0	8	22	0.3636364
NODE_55438_length_450_cov_27.982906	98	120	2	14	22	0.6363636
NODE_55438_length_450_cov_27.982906	225	305	0	80	80	1.0000000
NODE_55438_length_450_cov_27.982906	278	358	0	80	80	1.0000000
NODE_55459_length_450_cov_3.991453	220	290	0	70	70	1.0000000
NODE_55459_length_450_cov_3.991453	223	290	0	67	67	1.0000000
NODE_55459_length_450_cov_3.991453	268	348	0	80	80	1.0000000
NODE_55459_length_450_cov_3.991453	268	348	0	80	80	1.0000000
NODE_55459_length_450_cov_3.991453	278	348	0	70	70	1.0000000
NODE_55459_length_450_cov_3.991453	344	363	0	19	19	1.0000000
NODE_55466_length_450_cov_3.717949	107	177	0	70	70	1.0000000
NODE_55483_length_450_cov_3.162393	99	157	0	58	58	1.0000000
NODE_55550_length_450_cov_1.857550	114	172	6	15	58	0.2586207
NODE_55550_length_450_cov_1.857550	114	172	8	17	58	0.2931035
NODE_55550_length_450_cov_1.857550	114	172	10	10	58	0.1724138
NODE_55550_length_450_cov_1.857550	114	172	12	15	58	0.2586207
NODE_55550_length_450_cov_1.857550	114	172	14	1	58	0.0172414
NODE_55560_length_450_cov_1.749288	321	376	0	55	55	1.0000000
NODE_55565_length_450_cov_1.723647	101	161	26	8	60	0.1333333
NODE_55565_length_450_cov_1.723647	101	161	28	1	60	0.0166667
NODE_55565_length_450_cov_1.723647	101	161	32	2	60	0.0333333
NODE_55565_length_450_cov_1.723647	101	161	35	10	60	0.1666667
NODE_55565_length_450_cov_1.723647	101	161	37	3	60	0.0500000
NODE_55565_length_450_cov_1.723647	101	161	39	7	60	0.1166667
NODE_55565_length_450_cov_1.723647	101	161	41	26	60	0.4333333
NODE_55565_length_450_cov_1.723647	101	161	43	3	60	0.0500000
NODE_55685_length_450_cov_1.017094	116	196	0	25	80	0.3125000
NODE_55685_length_450_cov_1.017094	116	196	2	14	80	0.1750000
NODE_55685_length_450_cov_1.017094	116	196	4	2	80	0.0250000
NODE_55685_length_450_cov_1.017094	116	196	6	39	80	0.4875000
NODE_55761_length_449_cov_46.882857	237	317	6	58	80	0.7250000
NODE_55761_length_449_cov_46.882857	237	317	8	13	80	0.1625000
NODE_55761_length_449_cov_46.882857	237	317	10	9	80	0.1125000
NODE_55761_length_449_cov_46.882857	290	370	4	32	80	0.4000000
NODE_55761_length_449_cov_46.882857	290	370	6	5	80	0.0625000
NODE_55761_length_449_cov_46.882857	290	370	8	13	80	0.1625000
NODE_55761_length_449_cov_46.882857	290	370	10	30	80	0.3750000
NODE_55762_length_449_cov_36.031429	238	318	0	80	80	1.0000000
NODE_55762_length_449_cov_36.031429	291	371	0	80	80	1.0000000
NODE_55783_length_449_cov_4.594286	137	184	0	47	47	1.0000000
NODE_55794_length_449_cov_3.797143	204	284	0	8	80	0.1000000
NODE_55794_length_449_cov_3.797143	204	284	2	72	80	0.9000000
NODE_55844_length_449_cov_2.445714	346	376	0	30	30	1.0000000
NODE_56144_length_448_cov_44.664756	126	206	0	80	80	1.0000000
NODE_56144_length_448_cov_44.664756	179	259	0	80	80	1.0000000
NODE_56145_length_448_cov_36.148997	195	275	0	65	80	0.8125000
NODE_56145_length_448_cov_36.148997	195	275	1	15	80	0.1875000
NODE_56145_length_448_cov_36.148997	248	328	0	12	80	0.1500000
NODE_56145_length_448_cov_36.148997	248	328	1	16	80	0.2000000
NODE_56145_length_448_cov_36.148997	248	328	2	52	80	0.6500000
NODE_56145_length_448_cov_36.148997	324	404	2	80	80	1.0000000
NODE_56145_length_448_cov_36.148997	377	448	0	22	71	0.3098592
NODE_56145_length_448_cov_36.148997	377	448	1	16	71	0.2253521
NODE_56145_length_448_cov_36.148997	377	448	2	33	71	0.4647887
NODE_56146_length_448_cov_31.816619	43	123	8	21	80	0.2625000
NODE_56146_length_448_cov_31.816619	43	123	12	14	80	0.1750000
NODE_56146_length_448_cov_31.816619	43	123	13	1	80	0.0125000
NODE_56146_length_448_cov_31.816619	43	123	14	44	80	0.5500000
NODE_56151_length_448_cov_6.779370	197	277	2	24	80	0.3000000
NODE_56151_length_448_cov_6.779370	197	277	4	56	80	0.7000000
NODE_56151_length_448_cov_6.779370	250	313	2	1	63	0.0158730
NODE_56151_length_448_cov_6.779370	250	313	4	62	63	0.9841270
NODE_56180_length_448_cov_3.664756	148	189	0	41	41	1.0000000
NODE_56189_length_448_cov_3.108883	242	324	0	82	82	1.0000000
NODE_56233_length_448_cov_2.263610	292	360	0	61	68	0.8970588
NODE_56233_length_448_cov_2.263610	292	360	2	7	68	0.1029412
NODE_56518_length_447_cov_10.505747	205	234	0	29	29	1.0000000
NODE_56518_length_447_cov_10.505747	267	326	0	7	59	0.1186441
NODE_56518_length_447_cov_10.505747	267	326	2	52	59	0.8813559
NODE_56518_length_447_cov_10.505747	299	379	0	2	80	0.0250000
NODE_56518_length_447_cov_10.505747	299	379	2	78	80	0.9750000
NODE_56527_length_447_cov_5.767241	176	256	4	36	80	0.4500000
NODE_56527_length_447_cov_5.767241	176	256	6	2	80	0.0250000
NODE_56527_length_447_cov_5.767241	176	256	8	42	80	0.5250000
NODE_56527_length_447_cov_5.767241	229	309	0	34	80	0.4250000
NODE_56527_length_447_cov_5.767241	229	309	4	46	80	0.5750000
NODE_56539_length_447_cov_4.583333	265	289	0	24	24	1.0000000
NODE_56545_length_447_cov_4.037356	58	138	0	60	80	0.7500000
NODE_56545_length_447_cov_4.037356	58	138	2	1	80	0.0125000
NODE_56545_length_447_cov_4.037356	58	138	4	2	80	0.0250000
NODE_56545_length_447_cov_4.037356	58	138	6	17	80	0.2125000
NODE_56545_length_447_cov_4.037356	111	191	0	7	80	0.0875000
NODE_56545_length_447_cov_4.037356	111	191	2	1	80	0.0125000
NODE_56545_length_447_cov_4.037356	111	191	4	2	80	0.0250000
NODE_56545_length_447_cov_4.037356	111	191	6	70	80	0.8750000
NODE_56890_length_446_cov_42.527378	239	310	8	5	71	0.0704225
NODE_56890_length_446_cov_42.527378	239	310	14	13	71	0.1830986
NODE_56890_length_446_cov_42.527378	239	310	15	3	71	0.0422535
NODE_56890_length_446_cov_42.527378	239	310	16	14	71	0.1971831
NODE_56890_length_446_cov_42.527378	239	310	17	3	71	0.0422535
NODE_56890_length_446_cov_42.527378	239	310	18	5	71	0.0704225
NODE_56890_length_446_cov_42.527378	239	310	19	3	71	0.0422535
NODE_56890_length_446_cov_42.527378	239	310	24	2	71	0.0281690
NODE_56890_length_446_cov_42.527378	239	310	25	5	71	0.0704225
NODE_56890_length_446_cov_42.527378	239	310	26	4	71	0.0563380
NODE_56890_length_446_cov_42.527378	239	310	28	13	71	0.1830986
NODE_56890_length_446_cov_42.527378	239	310	30	1	71	0.0140845
NODE_56890_length_446_cov_42.527378	359	433	3	4	74	0.0540541
NODE_56890_length_446_cov_42.527378	359	433	4	3	74	0.0405405
NODE_56890_length_446_cov_42.527378	359	433	8	2	74	0.0270270
NODE_56890_length_446_cov_42.527378	359	433	9	1	74	0.0135135
NODE_56890_length_446_cov_42.527378	359	433	10	2	74	0.0270270
NODE_56890_length_446_cov_42.527378	359	433	12	3	74	0.0405405
NODE_56890_length_446_cov_42.527378	359	433	21	1	74	0.0135135
NODE_56890_length_446_cov_42.527378	359	433	22	22	74	0.2972973
NODE_56890_length_446_cov_42.527378	359	433	24	22	74	0.2972973
NODE_56890_length_446_cov_42.527378	359	433	26	1	74	0.0135135
NODE_56890_length_446_cov_42.527378	359	433	32	13	74	0.1756757
NODE_56891_length_446_cov_12.749280	92	172	0	18	80	0.2250000
NODE_56891_length_446_cov_12.749280	92	172	2	34	80	0.4250000
NODE_56891_length_446_cov_12.749280	92	172	3	28	80	0.3500000
NODE_56891_length_446_cov_12.749280	145	225	0	40	80	0.5000000
NODE_56891_length_446_cov_12.749280	145	225	1	31	80	0.3875000
NODE_56891_length_446_cov_12.749280	145	225	2	9	80	0.1125000
NODE_56896_length_446_cov_6.902017	175	217	0	37	42	0.8809524
NODE_56896_length_446_cov_6.902017	175	217	2	5	42	0.1190476
NODE_56902_length_446_cov_5.930836	165	245	0	80	80	1.0000000
NODE_56902_length_446_cov_5.930836	165	245	0	80	80	1.0000000
NODE_56902_length_446_cov_5.930836	165	235	0	70	70	1.0000000
NODE_56902_length_446_cov_5.930836	218	298	0	80	80	1.0000000
NODE_56902_length_446_cov_5.930836	218	297	0	79	79	1.0000000
NODE_56919_length_446_cov_3.896254	215	274	2	3	59	0.0508475
NODE_56919_length_446_cov_3.896254	215	274	4	56	59	0.9491525
NODE_56934_length_446_cov_3.282421	130	168	0	38	38	1.0000000
NODE_56952_length_446_cov_2.775216	337	417	0	80	80	1.0000000
NODE_56995_length_446_cov_2.161383	17	97	0	80	80	1.0000000
NODE_57022_length_446_cov_1.907781	196	225	8	6	29	0.2068966
NODE_57022_length_446_cov_1.907781	196	225	12	11	29	0.3793103
NODE_57022_length_446_cov_1.907781	196	225	14	11	29	0.3793103
NODE_57022_length_446_cov_1.907781	196	225	16	1	29	0.0344828
NODE_57277_length_445_cov_75.572254	108	188	0	80	80	1.0000000
NODE_57277_length_445_cov_75.572254	161	241	0	80	80	1.0000000
NODE_57277_length_445_cov_75.572254	237	317	0	80	80	1.0000000
NODE_57277_length_445_cov_75.572254	290	370	0	80	80	1.0000000
NODE_57278_length_445_cov_33.973988	83	163	0	25	80	0.3125000
NODE_57278_length_445_cov_33.973988	83	163	2	34	80	0.4250000
NODE_57278_length_445_cov_33.973988	83	163	4	16	80	0.2000000
NODE_57278_length_445_cov_33.973988	83	163	6	5	80	0.0625000
NODE_57278_length_445_cov_33.973988	136	216	2	6	80	0.0750000
NODE_57278_length_445_cov_33.973988	136	216	4	31	80	0.3875000
NODE_57278_length_445_cov_33.973988	136	216	6	43	80	0.5375000
NODE_57280_length_445_cov_9.323699	78	148	0	70	70	1.0000000
NODE_57280_length_445_cov_9.323699	121	201	0	80	80	1.0000000
NODE_57284_length_445_cov_6.439306	210	282	0	56	72	0.7777778
NODE_57284_length_445_cov_6.439306	210	282	2	9	72	0.1250000
NODE_57284_length_445_cov_6.439306	210	282	4	7	72	0.0972222
NODE_57286_length_445_cov_5.479769	115	184	2	49	69	0.7101449
NODE_57286_length_445_cov_5.479769	115	184	4	20	69	0.2898551
NODE_57286_length_445_cov_5.479769	157	237	0	46	80	0.5750000
NODE_57286_length_445_cov_5.479769	157	237	2	34	80	0.4250000
NODE_57286_length_445_cov_5.479769	233	309	0	75	76	0.9868421
NODE_57286_length_445_cov_5.479769	233	309	6	1	76	0.0131579
NODE_57286_length_445_cov_5.479769	286	309	0	22	23	0.9565217
NODE_57286_length_445_cov_5.479769	286	309	6	1	23	0.0434783
NODE_57345_length_445_cov_2.843931	124	199	0	9	75	0.1200000
NODE_57345_length_445_cov_2.843931	124	199	2	66	75	0.8800000
NODE_57352_length_445_cov_2.682081	202	248	0	46	46	1.0000000
NODE_57400_length_445_cov_1.884393	252	332	0	42	80	0.5250000
NODE_57400_length_445_cov_1.884393	252	332	2	38	80	0.4750000
NODE_57409_length_445_cov_1.783237	132	203	0	71	71	1.0000000
NODE_57409_length_445_cov_1.783237	256	331	0	51	75	0.6800000
NODE_57409_length_445_cov_1.783237	256	331	2	24	75	0.3200000
NODE_57409_length_445_cov_1.783237	256	278	0	22	22	1.0000000
NODE_57644_length_444_cov_34.075362	243	323	1	34	80	0.4250000
NODE_57644_length_444_cov_34.075362	243	323	2	46	80	0.5750000
NODE_57644_length_444_cov_34.075362	296	376	0	40	80	0.5000000
NODE_57644_length_444_cov_34.075362	296	376	1	40	80	0.5000000
NODE_57645_length_444_cov_22.524638	98	178	0	80	80	1.0000000
NODE_57645_length_444_cov_22.524638	151	231	0	80	80	1.0000000
NODE_57646_length_444_cov_16.544928	263	343	0	12	80	0.1500000
NODE_57646_length_444_cov_16.544928	263	343	6	68	80	0.8500000
NODE_57646_length_444_cov_16.544928	316	396	0	10	80	0.1250000
NODE_57646_length_444_cov_16.544928	316	396	6	70	80	0.8750000
NODE_57647_length_444_cov_12.684058	293	373	0	43	80	0.5375000
NODE_57647_length_444_cov_12.684058	293	373	2	37	80	0.4625000
NODE_57647_length_444_cov_12.684058	346	426	0	80	80	1.0000000
NODE_57649_length_444_cov_9.284058	176	256	0	80	80	1.0000000
NODE_57649_length_444_cov_9.284058	229	309	0	80	80	1.0000000
NODE_57666_length_444_cov_5.159420	170	241	0	71	71	1.0000000
NODE_57668_length_444_cov_5.060870	201	245	1	1	44	0.0227273
NODE_57668_length_444_cov_5.060870	201	245	2	34	44	0.7727273
NODE_57668_length_444_cov_5.060870	201	245	3	9	44	0.2045455
NODE_57668_length_444_cov_5.060870	218	298	2	27	80	0.3375000
NODE_57668_length_444_cov_5.060870	218	298	8	1	80	0.0125000
NODE_57668_length_444_cov_5.060870	218	298	9	14	80	0.1750000
NODE_57668_length_444_cov_5.060870	218	298	10	11	80	0.1375000
NODE_57668_length_444_cov_5.060870	218	298	11	27	80	0.3375000
NODE_57717_length_444_cov_2.744928	73	136	2	1	63	0.0158730
NODE_57717_length_444_cov_2.744928	73	136	4	16	63	0.2539683
NODE_57717_length_444_cov_2.744928	73	136	6	5	63	0.0793651
NODE_57717_length_444_cov_2.744928	73	136	8	7	63	0.1111111
NODE_57717_length_444_cov_2.744928	73	136	10	34	63	0.5396826
NODE_57770_length_444_cov_2.028986	46	113	29	1	67	0.0149254
NODE_57770_length_444_cov_2.028986	46	113	35	1	67	0.0149254
NODE_57770_length_444_cov_2.028986	46	113	39	1	67	0.0149254
NODE_57770_length_444_cov_2.028986	46	113	46	1	67	0.0149254
NODE_57770_length_444_cov_2.028986	46	113	51	1	67	0.0149254
NODE_57770_length_444_cov_2.028986	46	113	55	1	67	0.0149254
NODE_57770_length_444_cov_2.028986	46	113	63	1	67	0.0149254
NODE_57770_length_444_cov_2.028986	46	113	65	1	67	0.0149254
NODE_57770_length_444_cov_2.028986	46	113	71	2	67	0.0298507
NODE_57770_length_444_cov_2.028986	46	113	79	1	67	0.0149254
NODE_57770_length_444_cov_2.028986	46	113	87	1	67	0.0149254
NODE_57770_length_444_cov_2.028986	46	113	93	1	67	0.0149254
NODE_57770_length_444_cov_2.028986	46	113	95	1	67	0.0149254
NODE_57770_length_444_cov_2.028986	46	113	101	2	67	0.0298507
NODE_57770_length_444_cov_2.028986	46	113	103	3	67	0.0447761
NODE_57770_length_444_cov_2.028986	46	113	105	2	67	0.0298507
NODE_57770_length_444_cov_2.028986	46	113	110	1	67	0.0149254
NODE_57770_length_444_cov_2.028986	46	113	114	1	67	0.0149254
NODE_57770_length_444_cov_2.028986	46	113	116	1	67	0.0149254
NODE_57770_length_444_cov_2.028986	46	113	120	1	67	0.0149254
NODE_57770_length_444_cov_2.028986	46	113	122	1	67	0.0149254
NODE_57770_length_444_cov_2.028986	46	113	128	1	67	0.0149254
NODE_57770_length_444_cov_2.028986	46	113	132	1	67	0.0149254
NODE_57770_length_444_cov_2.028986	46	113	136	1	67	0.0149254
NODE_57770_length_444_cov_2.028986	46	113	156	1	67	0.0149254
NODE_57770_length_444_cov_2.028986	46	113	168	1	67	0.0149254
NODE_57770_length_444_cov_2.028986	46	113	170	2	67	0.0298507
NODE_57770_length_444_cov_2.028986	46	113	176	1	67	0.0149254
NODE_57770_length_444_cov_2.028986	46	113	181	1	67	0.0149254
NODE_57770_length_444_cov_2.028986	46	113	185	1	67	0.0149254
NODE_57770_length_444_cov_2.028986	46	113	187	1	67	0.0149254
NODE_57770_length_444_cov_2.028986	46	113	198	2	67	0.0298507
NODE_57770_length_444_cov_2.028986	46	113	200	1	67	0.0149254
NODE_57770_length_444_cov_2.028986	46	113	206	1	67	0.0149254
NODE_57770_length_444_cov_2.028986	46	113	210	1	67	0.0149254
NODE_57770_length_444_cov_2.028986	46	113	212	1	67	0.0149254
NODE_57770_length_444_cov_2.028986	46	113	218	2	67	0.0298507
NODE_57770_length_444_cov_2.028986	46	113	226	2	67	0.0298507
NODE_57770_length_444_cov_2.028986	46	113	230	1	67	0.0149254
NODE_57770_length_444_cov_2.028986	46	113	232	2	67	0.0298507
NODE_57770_length_444_cov_2.028986	46	113	234	3	67	0.0447761
NODE_57770_length_444_cov_2.028986	46	113	240	1	67	0.0149254
NODE_57770_length_444_cov_2.028986	46	113	242	1	67	0.0149254
NODE_57770_length_444_cov_2.028986	46	113	246	1	67	0.0149254
NODE_57770_length_444_cov_2.028986	46	113	252	2	67	0.0298507
NODE_57770_length_444_cov_2.028986	46	113	254	5	67	0.0746269
NODE_57770_length_444_cov_2.028986	46	113	256	1	67	0.0149254
NODE_57770_length_444_cov_2.028986	46	113	260	1	67	0.0149254
NODE_57770_length_444_cov_2.028986	46	113	262	1	67	0.0149254
NODE_57770_length_444_cov_2.028986	46	113	264	1	67	0.0149254
NODE_57770_length_444_cov_2.028986	86	166	158	1	80	0.0125000
NODE_57770_length_444_cov_2.028986	86	166	172	1	80	0.0125000
NODE_57770_length_444_cov_2.028986	86	166	178	1	80	0.0125000
NODE_57770_length_444_cov_2.028986	86	166	188	1	80	0.0125000
NODE_57770_length_444_cov_2.028986	86	166	190	1	80	0.0125000
NODE_57770_length_444_cov_2.028986	86	166	197	2	80	0.0250000
NODE_57770_length_444_cov_2.028986	86	166	202	3	80	0.0375000
NODE_57770_length_444_cov_2.028986	86	166	206	2	80	0.0250000
NODE_57770_length_444_cov_2.028986	86	166	208	1	80	0.0125000
NODE_57770_length_444_cov_2.028986	86	166	210	1	80	0.0125000
NODE_57770_length_444_cov_2.028986	86	166	212	1	80	0.0125000
NODE_57770_length_444_cov_2.028986	86	166	217	1	80	0.0125000
NODE_57770_length_444_cov_2.028986	86	166	218	2	80	0.0250000
NODE_57770_length_444_cov_2.028986	86	166	221	1	80	0.0125000
NODE_57770_length_444_cov_2.028986	86	166	226	2	80	0.0250000
NODE_57770_length_444_cov_2.028986	86	166	230	1	80	0.0125000
NODE_57770_length_444_cov_2.028986	86	166	232	2	80	0.0250000
NODE_57770_length_444_cov_2.028986	86	166	233	1	80	0.0125000
NODE_57770_length_444_cov_2.028986	86	166	234	3	80	0.0375000
NODE_57770_length_444_cov_2.028986	86	166	240	1	80	0.0125000
NODE_57770_length_444_cov_2.028986	86	166	241	3	80	0.0375000
NODE_57770_length_444_cov_2.028986	86	166	242	1	80	0.0125000
NODE_57770_length_444_cov_2.028986	86	166	245	1	80	0.0125000
NODE_57770_length_444_cov_2.028986	86	166	246	1	80	0.0125000
NODE_57770_length_444_cov_2.028986	86	166	249	1	80	0.0125000
NODE_57770_length_444_cov_2.028986	86	166	251	3	80	0.0375000
NODE_57770_length_444_cov_2.028986	86	166	252	2	80	0.0250000
NODE_57770_length_444_cov_2.028986	86	166	254	5	80	0.0625000
NODE_57770_length_444_cov_2.028986	86	166	255	1	80	0.0125000
NODE_57770_length_444_cov_2.028986	86	166	256	1	80	0.0125000
NODE_57770_length_444_cov_2.028986	86	166	257	1	80	0.0125000
NODE_57770_length_444_cov_2.028986	86	166	259	1	80	0.0125000
NODE_57770_length_444_cov_2.028986	86	166	260	2	80	0.0250000
NODE_57770_length_444_cov_2.028986	86	166	261	3	80	0.0375000
NODE_57770_length_444_cov_2.028986	86	166	262	4	80	0.0500000
NODE_57770_length_444_cov_2.028986	86	166	263	2	80	0.0250000
NODE_57770_length_444_cov_2.028986	86	166	264	1	80	0.0125000
NODE_57770_length_444_cov_2.028986	86	166	265	10	80	0.1250000
NODE_57770_length_444_cov_2.028986	86	166	267	6	80	0.0750000
NODE_57770_length_444_cov_2.028986	86	166	268	1	80	0.0125000
NODE_57770_length_444_cov_2.028986	86	166	269	1	80	0.0125000
NODE_57873_length_444_cov_1.234783	335	407	2	72	72	1.0000000
NODE_57892_length_444_cov_1.173913	7	87	2	80	80	1.0000000
NODE_58026_length_443_cov_71.284884	209	289	0	18	80	0.2250000
NODE_58026_length_443_cov_71.284884	209	289	2	13	80	0.1625000
NODE_58026_length_443_cov_71.284884	209	289	4	49	80	0.6125000
NODE_58026_length_443_cov_71.284884	262	342	4	56	80	0.7000000
NODE_58026_length_443_cov_71.284884	262	342	6	10	80	0.1250000
NODE_58026_length_443_cov_71.284884	262	342	11	1	80	0.0125000
NODE_58026_length_443_cov_71.284884	262	342	12	13	80	0.1625000
NODE_58026_length_443_cov_71.284884	338	418	6	19	80	0.2375000
NODE_58026_length_443_cov_71.284884	338	418	8	6	80	0.0750000
NODE_58026_length_443_cov_71.284884	338	418	10	34	80	0.4250000
NODE_58026_length_443_cov_71.284884	338	418	12	21	80	0.2625000
NODE_58026_length_443_cov_71.284884	391	443	0	22	52	0.4230769
NODE_58026_length_443_cov_71.284884	391	443	6	22	52	0.4230769
NODE_58026_length_443_cov_71.284884	391	443	8	6	52	0.1153846
NODE_58026_length_443_cov_71.284884	391	443	10	2	52	0.0384615
NODE_58027_length_443_cov_68.973837	314	394	6	15	80	0.1875000
NODE_58027_length_443_cov_68.973837	314	394	10	65	80	0.8125000
NODE_58027_length_443_cov_68.973837	367	443	0	2	76	0.0263158
NODE_58027_length_443_cov_68.973837	367	443	4	1	76	0.0131579
NODE_58027_length_443_cov_68.973837	367	443	5	1	76	0.0131579
NODE_58027_length_443_cov_68.973837	367	443	10	72	76	0.9473684
NODE_58028_length_443_cov_61.116279	34	114	2	9	80	0.1125000
NODE_58028_length_443_cov_61.116279	34	114	6	14	80	0.1750000
NODE_58028_length_443_cov_61.116279	34	114	10	15	80	0.1875000
NODE_58028_length_443_cov_61.116279	34	114	11	20	80	0.2500000
NODE_58028_length_443_cov_61.116279	34	114	12	22	80	0.2750000
NODE_58028_length_443_cov_61.116279	87	167	10	21	80	0.2625000
NODE_58028_length_443_cov_61.116279	87	167	11	5	80	0.0625000
NODE_58028_length_443_cov_61.116279	87	167	12	54	80	0.6750000
NODE_58041_length_443_cov_4.895349	127	207	0	80	80	1.0000000
NODE_58086_length_443_cov_2.581395	121	195	0	74	74	1.0000000
NODE_58088_length_443_cov_2.508721	297	347	0	50	50	1.0000000
NODE_58088_length_443_cov_2.508721	320	395	0	75	75	1.0000000
NODE_58091_length_443_cov_2.456395	114	192	0	44	78	0.5641026
NODE_58091_length_443_cov_2.456395	114	192	2	34	78	0.4358974
NODE_58091_length_443_cov_2.456395	118	141	2	23	23	1.0000000
NODE_58237_length_443_cov_1.151163	144	224	5	1	80	0.0125000
NODE_58237_length_443_cov_1.151163	144	224	6	12	80	0.1500000
NODE_58237_length_443_cov_1.151163	144	224	7	5	80	0.0625000
NODE_58237_length_443_cov_1.151163	144	224	8	5	80	0.0625000
NODE_58237_length_443_cov_1.151163	144	224	10	1	80	0.0125000
NODE_58237_length_443_cov_1.151163	144	224	12	56	80	0.7000000
NODE_58321_length_443_cov_0.715116	52	104	0	5	52	0.0961538
NODE_58321_length_443_cov_0.715116	52	104	2	47	52	0.9038461
NODE_58321_length_443_cov_0.715116	105	146	2	27	41	0.6585366
NODE_58321_length_443_cov_0.715116	105	146	4	14	41	0.3414634
NODE_58346_length_442_cov_42.956268	290	375	10	16	85	0.1882353
NODE_58346_length_442_cov_42.956268	290	375	14	4	85	0.0470588
NODE_58346_length_442_cov_42.956268	290	375	16	9	85	0.1058824
NODE_58346_length_442_cov_42.956268	290	375	18	56	85	0.6588235
NODE_58346_length_442_cov_42.956268	290	375	10	16	85	0.1882353
NODE_58346_length_442_cov_42.956268	290	375	14	4	85	0.0470588
NODE_58346_length_442_cov_42.956268	290	375	16	9	85	0.1058824
NODE_58346_length_442_cov_42.956268	290	375	18	56	85	0.6588235
NODE_58347_length_442_cov_24.093294	225	305	15	20	80	0.2500000
NODE_58347_length_442_cov_24.093294	225	305	16	30	80	0.3750000
NODE_58347_length_442_cov_24.093294	225	305	17	30	80	0.3750000
NODE_58347_length_442_cov_24.093294	278	358	2	8	80	0.1000000
NODE_58347_length_442_cov_24.093294	278	358	6	33	80	0.4125000
NODE_58347_length_442_cov_24.093294	278	358	17	39	80	0.4875000
NODE_58348_length_442_cov_8.956268	173	192	0	19	19	1.0000000
NODE_58361_length_442_cov_5.052478	213	293	0	3	80	0.0375000
NODE_58361_length_442_cov_5.052478	213	293	2	77	80	0.9625000
NODE_58361_length_442_cov_5.052478	266	346	0	56	80	0.7000000
NODE_58361_length_442_cov_5.052478	266	346	2	24	80	0.3000000
NODE_58376_length_442_cov_3.871720	297	372	4	3	75	0.0400000
NODE_58376_length_442_cov_3.871720	297	372	6	5	75	0.0666667
NODE_58376_length_442_cov_3.871720	297	372	8	8	75	0.1066667
NODE_58376_length_442_cov_3.871720	297	372	10	13	75	0.1733333
NODE_58376_length_442_cov_3.871720	297	372	12	2	75	0.0266667
NODE_58376_length_442_cov_3.871720	297	372	14	1	75	0.0133333
NODE_58376_length_442_cov_3.871720	297	372	15	21	75	0.2800000
NODE_58376_length_442_cov_3.871720	297	372	16	22	75	0.2933333
NODE_58376_length_442_cov_3.871720	360	413	8	2	53	0.0377358
NODE_58376_length_442_cov_3.871720	360	413	10	26	53	0.4905660
NODE_58376_length_442_cov_3.871720	360	413	12	3	53	0.0566038
NODE_58376_length_442_cov_3.871720	360	413	14	2	53	0.0377358
NODE_58376_length_442_cov_3.871720	360	413	16	20	53	0.3773585
NODE_58378_length_442_cov_3.804665	211	244	0	29	33	0.8787879
NODE_58378_length_442_cov_3.804665	211	244	2	2	33	0.0606061
NODE_58378_length_442_cov_3.804665	211	244	4	1	33	0.0303030
NODE_58378_length_442_cov_3.804665	211	244	10	1	33	0.0303030
NODE_58405_length_442_cov_3.206997	149	217	0	68	68	1.0000000
NODE_58438_length_442_cov_2.434402	203	274	24	28	71	0.3943662
NODE_58438_length_442_cov_2.434402	203	274	26	1	71	0.0140845
NODE_58438_length_442_cov_2.434402	203	274	28	9	71	0.1267606
NODE_58438_length_442_cov_2.434402	203	274	29	2	71	0.0281690
NODE_58438_length_442_cov_2.434402	203	274	30	30	71	0.4225352
NODE_58438_length_442_cov_2.434402	203	274	32	1	71	0.0140845
NODE_58438_length_442_cov_2.434402	247	327	30	26	80	0.3250000
NODE_58438_length_442_cov_2.434402	247	327	32	13	80	0.1625000
NODE_58438_length_442_cov_2.434402	247	327	34	4	80	0.0500000
NODE_58438_length_442_cov_2.434402	247	327	36	5	80	0.0625000
NODE_58438_length_442_cov_2.434402	247	327	38	1	80	0.0125000
NODE_58438_length_442_cov_2.434402	247	327	40	9	80	0.1125000
NODE_58438_length_442_cov_2.434402	247	327	42	7	80	0.0875000
NODE_58438_length_442_cov_2.434402	247	327	44	15	80	0.1875000
NODE_58503_length_442_cov_1.746356	95	161	0	3	66	0.0454545
NODE_58503_length_442_cov_1.746356	95	161	2	2	66	0.0303030
NODE_58503_length_442_cov_1.746356	95	161	4	12	66	0.1818182
NODE_58503_length_442_cov_1.746356	95	161	6	18	66	0.2727273
NODE_58503_length_442_cov_1.746356	95	161	10	5	66	0.0757576
NODE_58503_length_442_cov_1.746356	95	161	16	26	66	0.3939394
NODE_58503_length_442_cov_1.746356	95	122	0	3	27	0.1111111
NODE_58503_length_442_cov_1.746356	95	122	2	2	27	0.0740741
NODE_58503_length_442_cov_1.746356	95	122	4	12	27	0.4444444
NODE_58503_length_442_cov_1.746356	95	122	6	10	27	0.3703704
NODE_58759_length_441_cov_21.877193	28	108	2	52	80	0.6500000
NODE_58759_length_441_cov_21.877193	28	108	4	28	80	0.3500000
NODE_58759_length_441_cov_21.877193	81	161	2	30	80	0.3750000
NODE_58759_length_441_cov_21.877193	81	161	4	50	80	0.6250000
NODE_58760_length_441_cov_13.546784	152	232	0	72	80	0.9000000
NODE_58760_length_441_cov_13.546784	152	232	2	8	80	0.1000000
NODE_58760_length_441_cov_13.546784	205	285	0	19	80	0.2375000
NODE_58760_length_441_cov_13.546784	205	285	2	61	80	0.7625000
NODE_58771_length_441_cov_5.710526	200	280	0	80	80	1.0000000
NODE_58771_length_441_cov_5.710526	253	333	0	80	80	1.0000000
NODE_58817_length_441_cov_3.096491	240	324	0	62	84	0.7380952
NODE_58817_length_441_cov_3.096491	240	324	2	1	84	0.0119048
NODE_58817_length_441_cov_3.096491	240	324	4	21	84	0.2500000
NODE_58820_length_441_cov_3.023392	105	163	0	14	58	0.2413793
NODE_58820_length_441_cov_3.023392	105	163	2	23	58	0.3965517
NODE_58820_length_441_cov_3.023392	105	163	4	21	58	0.3620690
NODE_58852_length_441_cov_2.438596	19	99	0	80	80	1.0000000
NODE_58852_length_441_cov_2.438596	72	126	0	54	54	1.0000000
NODE_58970_length_441_cov_1.435673	105	156	0	6	51	0.1176471
NODE_58970_length_441_cov_1.435673	105	156	2	45	51	0.8823529
NODE_59142_length_440_cov_43.131965	122	202	0	7	80	0.0875000
NODE_59142_length_440_cov_43.131965	122	202	2	6	80	0.0750000
NODE_59142_length_440_cov_43.131965	122	202	4	67	80	0.8375000
NODE_59142_length_440_cov_43.131965	175	255	0	60	80	0.7500000
NODE_59142_length_440_cov_43.131965	175	255	2	6	80	0.0750000
NODE_59142_length_440_cov_43.131965	175	255	4	14	80	0.1750000
NODE_59142_length_440_cov_43.131965	251	331	0	80	80	1.0000000
NODE_59142_length_440_cov_43.131965	304	384	0	80	80	1.0000000
NODE_59143_length_440_cov_42.929619	116	196	0	6	80	0.0750000
NODE_59143_length_440_cov_42.929619	116	196	2	6	80	0.0750000
NODE_59143_length_440_cov_42.929619	116	196	4	68	80	0.8500000
NODE_59143_length_440_cov_42.929619	169	249	0	38	80	0.4750000
NODE_59143_length_440_cov_42.929619	169	249	2	1	80	0.0125000
NODE_59143_length_440_cov_42.929619	169	249	4	41	80	0.5125000
NODE_59147_length_440_cov_8.164223	45	125	0	80	80	1.0000000
NODE_59147_length_440_cov_8.164223	98	178	0	80	80	1.0000000
NODE_59157_length_440_cov_5.193548	146	210	8	9	64	0.1406250
NODE_59157_length_440_cov_5.193548	146	210	11	42	64	0.6562500
NODE_59157_length_440_cov_5.193548	146	210	12	13	64	0.2031250
NODE_59157_length_440_cov_5.193548	146	210	8	9	64	0.1406250
NODE_59157_length_440_cov_5.193548	146	210	11	42	64	0.6562500
NODE_59157_length_440_cov_5.193548	146	210	12	13	64	0.2031250
NODE_59157_length_440_cov_5.193548	146	210	8	9	64	0.1406250
NODE_59157_length_440_cov_5.193548	146	210	11	42	64	0.6562500
NODE_59157_length_440_cov_5.193548	146	210	12	13	64	0.2031250
NODE_59164_length_440_cov_4.595308	153	233	0	10	80	0.1250000
NODE_59164_length_440_cov_4.595308	153	233	2	4	80	0.0500000
NODE_59164_length_440_cov_4.595308	153	233	4	60	80	0.7500000
NODE_59164_length_440_cov_4.595308	153	233	8	6	80	0.0750000
NODE_59164_length_440_cov_4.595308	153	180	4	21	27	0.7777778
NODE_59164_length_440_cov_4.595308	153	180	8	6	27	0.2222222
NODE_59188_length_440_cov_3.431085	84	150	2	13	66	0.1969697
NODE_59188_length_440_cov_3.431085	84	150	4	53	66	0.8030303
NODE_59191_length_440_cov_3.331378	139	195	0	56	56	1.0000000
NODE_59517_length_439_cov_76.552941	0	68	0	5	68	0.0735294
NODE_59517_length_439_cov_76.552941	0	68	4	61	68	0.8970588
NODE_59517_length_439_cov_76.552941	0	68	7	2	68	0.0294118
NODE_59517_length_439_cov_76.552941	0	68	0	5	68	0.0735294
NODE_59517_length_439_cov_76.552941	0	68	4	61	68	0.8970588
NODE_59517_length_439_cov_76.552941	0	68	7	2	68	0.0294118
NODE_59517_length_439_cov_76.552941	0	68	0	5	68	0.0735294
NODE_59517_length_439_cov_76.552941	0	68	4	61	68	0.8970588
NODE_59517_length_439_cov_76.552941	0	68	7	2	68	0.0294118
NODE_59517_length_439_cov_76.552941	1	68	0	4	67	0.0597015
NODE_59517_length_439_cov_76.552941	1	68	4	61	67	0.9104478
NODE_59517_length_439_cov_76.552941	1	68	7	2	67	0.0298507
NODE_59517_length_439_cov_76.552941	64	144	4	2	80	0.0250000
NODE_59517_length_439_cov_76.552941	64	144	7	5	80	0.0625000
NODE_59517_length_439_cov_76.552941	64	144	9	22	80	0.2750000
NODE_59517_length_439_cov_76.552941	64	144	10	17	80	0.2125000
NODE_59517_length_439_cov_76.552941	64	144	12	31	80	0.3875000
NODE_59517_length_439_cov_76.552941	64	144	13	1	80	0.0125000
NODE_59517_length_439_cov_76.552941	64	144	14	2	80	0.0250000
NODE_59517_length_439_cov_76.552941	64	144	4	2	80	0.0250000
NODE_59517_length_439_cov_76.552941	64	144	7	5	80	0.0625000
NODE_59517_length_439_cov_76.552941	64	144	9	22	80	0.2750000
NODE_59517_length_439_cov_76.552941	64	144	10	17	80	0.2125000
NODE_59517_length_439_cov_76.552941	64	144	12	31	80	0.3875000
NODE_59517_length_439_cov_76.552941	64	144	13	1	80	0.0125000
NODE_59517_length_439_cov_76.552941	64	144	14	2	80	0.0250000
NODE_59517_length_439_cov_76.552941	117	197	6	37	80	0.4625000
NODE_59517_length_439_cov_76.552941	117	197	9	8	80	0.1000000
NODE_59517_length_439_cov_76.552941	117	197	11	6	80	0.0750000
NODE_59517_length_439_cov_76.552941	117	197	12	29	80	0.3625000
NODE_59517_length_439_cov_76.552941	117	195	6	35	78	0.4487180
NODE_59517_length_439_cov_76.552941	117	195	9	8	78	0.1025641
NODE_59517_length_439_cov_76.552941	117	195	11	6	78	0.0769231
NODE_59517_length_439_cov_76.552941	117	195	12	29	78	0.3717949
NODE_59533_length_439_cov_4.408824	174	238	2	58	64	0.9062500
NODE_59533_length_439_cov_4.408824	174	238	4	6	64	0.0937500
NODE_59536_length_439_cov_4.255882	258	318	0	60	60	1.0000000
NODE_59560_length_439_cov_3.011765	57	128	34	7	71	0.0985916
NODE_59560_length_439_cov_3.011765	57	128	35	27	71	0.3802817
NODE_59560_length_439_cov_3.011765	57	128	36	2	71	0.0281690
NODE_59560_length_439_cov_3.011765	57	128	37	24	71	0.3380282
NODE_59560_length_439_cov_3.011765	57	128	38	7	71	0.0985916
NODE_59560_length_439_cov_3.011765	57	128	40	1	71	0.0140845
NODE_59560_length_439_cov_3.011765	57	128	41	2	71	0.0281690
NODE_59560_length_439_cov_3.011765	57	128	42	1	71	0.0140845
NODE_59560_length_439_cov_3.011765	101	140	36	3	39	0.0769231
NODE_59560_length_439_cov_3.011765	101	140	37	16	39	0.4102564
NODE_59560_length_439_cov_3.011765	101	140	38	18	39	0.4615385
NODE_59560_length_439_cov_3.011765	101	140	40	1	39	0.0256410
NODE_59560_length_439_cov_3.011765	101	140	42	1	39	0.0256410
NODE_59592_length_439_cov_2.252941	227	269	0	42	42	1.0000000
NODE_59599_length_439_cov_2.135294	116	179	0	63	63	1.0000000
NODE_59617_length_439_cov_1.929412	388	439	0	51	51	1.0000000
NODE_59897_length_438_cov_29.952802	196	276	0	80	80	1.0000000
NODE_59897_length_438_cov_29.952802	249	329	0	80	80	1.0000000
NODE_59898_length_438_cov_16.330383	225	305	0	80	80	1.0000000
NODE_59898_length_438_cov_16.330383	278	358	0	80	80	1.0000000
NODE_59899_length_438_cov_15.436578	74	154	0	4	80	0.0500000
NODE_59899_length_438_cov_15.436578	74	154	2	32	80	0.4000000
NODE_59899_length_438_cov_15.436578	74	154	4	44	80	0.5500000
NODE_59899_length_438_cov_15.436578	127	207	2	15	80	0.1875000
NODE_59899_length_438_cov_15.436578	127	207	4	65	80	0.8125000
NODE_59901_length_438_cov_9.306785	256	309	0	53	53	1.0000000
NODE_59901_length_438_cov_9.306785	282	327	0	45	45	1.0000000
NODE_59916_length_438_cov_4.808260	46	133	0	6	87	0.0689655
NODE_59916_length_438_cov_4.808260	46	133	2	67	87	0.7701150
NODE_59916_length_438_cov_4.808260	46	133	6	14	87	0.1609195
NODE_59916_length_438_cov_4.808260	106	186	2	13	80	0.1625000
NODE_59916_length_438_cov_4.808260	106	186	4	36	80	0.4500000
NODE_59916_length_438_cov_4.808260	106	186	6	31	80	0.3875000
NODE_59920_length_438_cov_4.622419	135	184	0	49	49	1.0000000
NODE_59936_length_438_cov_3.651917	86	166	0	14	80	0.1750000
NODE_59936_length_438_cov_3.651917	86	166	2	4	80	0.0500000
NODE_59936_length_438_cov_3.651917	86	166	4	62	80	0.7750000
NODE_59936_length_438_cov_3.651917	139	219	0	67	80	0.8375000
NODE_59936_length_438_cov_3.651917	139	219	2	4	80	0.0500000
NODE_59936_length_438_cov_3.651917	139	219	4	9	80	0.1125000
NODE_59952_length_438_cov_3.109145	215	273	0	28	58	0.4827586
NODE_59952_length_438_cov_3.109145	215	273	2	30	58	0.5172414
NODE_59957_length_438_cov_3.005900	175	258	0	83	83	1.0000000
NODE_60317_length_437_cov_57.260355	272	352	0	80	80	1.0000000
NODE_60317_length_437_cov_57.260355	325	405	0	80	80	1.0000000
NODE_60318_length_437_cov_40.964497	0	73	0	73	73	1.0000000
NODE_60318_length_437_cov_40.964497	46	126	0	80	80	1.0000000
NODE_60319_length_437_cov_30.843195	140	220	0	80	80	1.0000000
NODE_60319_length_437_cov_30.843195	193	273	0	80	80	1.0000000
NODE_60320_length_437_cov_14.736686	164	244	0	80	80	1.0000000
NODE_60320_length_437_cov_14.736686	217	297	0	80	80	1.0000000
NODE_60331_length_437_cov_6.032544	249	320	0	71	71	1.0000000
NODE_60332_length_437_cov_6.020710	272	352	0	25	80	0.3125000
NODE_60332_length_437_cov_6.020710	272	352	2	55	80	0.6875000
NODE_60332_length_437_cov_6.020710	325	405	0	73	80	0.9125000
NODE_60332_length_437_cov_6.020710	325	405	2	7	80	0.0875000
NODE_60336_length_437_cov_5.526627	129	209	0	80	80	1.0000000
NODE_60336_length_437_cov_5.526627	182	262	0	80	80	1.0000000
NODE_60348_length_437_cov_4.505917	247	327	0	57	80	0.7125000
NODE_60348_length_437_cov_4.505917	247	327	2	23	80	0.2875000
NODE_60361_length_437_cov_3.470414	204	259	0	55	55	1.0000000
NODE_60369_length_437_cov_3.301775	95	149	0	54	54	1.0000000
NODE_60381_length_437_cov_2.911243	91	171	0	49	80	0.6125000
NODE_60381_length_437_cov_2.911243	91	171	2	3	80	0.0375000
NODE_60381_length_437_cov_2.911243	91	171	4	28	80	0.3500000
NODE_60400_length_437_cov_2.650888	190	239	2	49	49	1.0000000
NODE_60400_length_437_cov_2.650888	212	292	0	27	80	0.3375000
NODE_60400_length_437_cov_2.650888	212	292	2	53	80	0.6625000
NODE_60411_length_437_cov_2.514793	292	333	4	38	41	0.9268293
NODE_60411_length_437_cov_2.514793	292	333	6	3	41	0.0731707
NODE_60509_length_437_cov_1.473373	252	324	2	7	72	0.0972222
NODE_60509_length_437_cov_1.473373	252	324	4	3	72	0.0416667
NODE_60509_length_437_cov_1.473373	252	324	8	22	72	0.3055556
NODE_60509_length_437_cov_1.473373	252	324	10	40	72	0.5555556
NODE_60709_length_436_cov_125.940653	204	284	9	7	80	0.0875000
NODE_60709_length_436_cov_125.940653	204	284	10	1	80	0.0125000
NODE_60709_length_436_cov_125.940653	204	284	14	17	80	0.2125000
NODE_60709_length_436_cov_125.940653	204	284	15	10	80	0.1250000
NODE_60709_length_436_cov_125.940653	204	284	16	10	80	0.1250000
NODE_60709_length_436_cov_125.940653	204	284	20	8	80	0.1000000
NODE_60709_length_436_cov_125.940653	204	284	27	7	80	0.0875000
NODE_60709_length_436_cov_125.940653	204	284	28	8	80	0.1000000
NODE_60709_length_436_cov_125.940653	204	284	29	2	80	0.0250000
NODE_60709_length_436_cov_125.940653	204	284	31	1	80	0.0125000
NODE_60709_length_436_cov_125.940653	204	284	32	4	80	0.0500000
NODE_60709_length_436_cov_125.940653	204	284	34	1	80	0.0125000
NODE_60709_length_436_cov_125.940653	204	284	42	4	80	0.0500000
NODE_60709_length_436_cov_125.940653	255	301	7	4	46	0.0869565
NODE_60709_length_436_cov_125.940653	255	301	8	3	46	0.0652174
NODE_60709_length_436_cov_125.940653	255	301	9	14	46	0.3043478
NODE_60709_length_436_cov_125.940653	255	301	10	4	46	0.0869565
NODE_60709_length_436_cov_125.940653	255	301	14	13	46	0.2826087
NODE_60709_length_436_cov_125.940653	255	301	15	5	46	0.1086956
NODE_60709_length_436_cov_125.940653	255	301	16	3	46	0.0652174
NODE_60709_length_436_cov_125.940653	257	337	4	7	80	0.0875000
NODE_60709_length_436_cov_125.940653	257	337	6	2	80	0.0250000
NODE_60709_length_436_cov_125.940653	257	337	7	31	80	0.3875000
NODE_60709_length_436_cov_125.940653	257	337	8	3	80	0.0375000
NODE_60709_length_436_cov_125.940653	257	337	9	14	80	0.1750000
NODE_60709_length_436_cov_125.940653	257	337	10	4	80	0.0500000
NODE_60709_length_436_cov_125.940653	257	337	14	11	80	0.1375000
NODE_60709_length_436_cov_125.940653	257	337	15	5	80	0.0625000
NODE_60709_length_436_cov_125.940653	257	337	16	3	80	0.0375000
NODE_60709_length_436_cov_125.940653	333	413	0	20	80	0.2500000
NODE_60709_length_436_cov_125.940653	333	413	2	49	80	0.6125000
NODE_60709_length_436_cov_125.940653	333	413	4	11	80	0.1375000
NODE_60709_length_436_cov_125.940653	386	436	0	43	50	0.8600000
NODE_60709_length_436_cov_125.940653	386	436	2	7	50	0.1400000
NODE_60712_length_436_cov_45.459941	166	246	0	4	80	0.0500000
NODE_60712_length_436_cov_45.459941	166	246	4	76	80	0.9500000
NODE_60712_length_436_cov_45.459941	219	299	0	22	80	0.2750000
NODE_60712_length_436_cov_45.459941	219	299	4	58	80	0.7250000
NODE_60712_length_436_cov_45.459941	295	375	0	80	80	1.0000000
NODE_60712_length_436_cov_45.459941	348	428	0	80	80	1.0000000
NODE_60713_length_436_cov_10.560831	74	154	0	80	80	1.0000000
NODE_60713_length_436_cov_10.560831	127	207	0	80	80	1.0000000
NODE_60716_length_436_cov_8.317507	51	127	0	76	76	1.0000000
NODE_60716_length_436_cov_8.317507	104	182	0	78	78	1.0000000
NODE_60760_length_436_cov_3.109792	153	205	0	52	52	1.0000000
NODE_60786_length_436_cov_2.551929	182	258	0	30	76	0.3947369
NODE_60786_length_436_cov_2.551929	182	258	2	46	76	0.6052632
NODE_60786_length_436_cov_2.551929	235	315	2	43	80	0.5375000
NODE_60786_length_436_cov_2.551929	235	315	4	30	80	0.3750000
NODE_60786_length_436_cov_2.551929	235	315	6	7	80	0.0875000
NODE_60934_length_436_cov_1.207715	105	181	0	18	76	0.2368421
NODE_60934_length_436_cov_1.207715	105	181	2	58	76	0.7631579
NODE_61088_length_435_cov_17.401786	55	135	2	43	80	0.5375000
NODE_61088_length_435_cov_17.401786	55	135	4	5	80	0.0625000
NODE_61088_length_435_cov_17.401786	55	135	6	9	80	0.1125000
NODE_61088_length_435_cov_17.401786	55	135	10	23	80	0.2875000
NODE_61088_length_435_cov_17.401786	108	188	6	29	80	0.3625000
NODE_61088_length_435_cov_17.401786	108	188	8	28	80	0.3500000
NODE_61088_length_435_cov_17.401786	108	188	10	23	80	0.2875000
NODE_61094_length_435_cov_6.910714	113	193	2	14	80	0.1750000
NODE_61094_length_435_cov_6.910714	113	193	4	28	80	0.3500000
NODE_61094_length_435_cov_6.910714	113	193	6	8	80	0.1000000
NODE_61094_length_435_cov_6.910714	113	193	8	30	80	0.3750000
NODE_61094_length_435_cov_6.910714	147	194	2	15	47	0.3191489
NODE_61094_length_435_cov_6.910714	147	194	4	28	47	0.5957447
NODE_61094_length_435_cov_6.910714	147	194	6	4	47	0.0851064
NODE_61094_length_435_cov_6.910714	149	184	2	5	35	0.1428571
NODE_61094_length_435_cov_6.910714	149	184	4	28	35	0.8000000
NODE_61094_length_435_cov_6.910714	149	184	6	2	35	0.0571429
NODE_61094_length_435_cov_6.910714	151	193	2	14	42	0.3333333
NODE_61094_length_435_cov_6.910714	151	193	4	28	42	0.6666667
NODE_61094_length_435_cov_6.910714	166	251	0	57	85	0.6705883
NODE_61094_length_435_cov_6.910714	166	251	2	15	85	0.1764706
NODE_61094_length_435_cov_6.910714	166	251	4	13	85	0.1529412
NODE_61094_length_435_cov_6.910714	167	251	0	57	84	0.6785714
NODE_61094_length_435_cov_6.910714	167	251	2	15	84	0.1785714
NODE_61094_length_435_cov_6.910714	167	251	4	12	84	0.1428571
NODE_61102_length_435_cov_5.630952	159	217	0	58	58	1.0000000
NODE_61102_length_435_cov_5.630952	190	270	0	54	80	0.6750000
NODE_61102_length_435_cov_5.630952	190	270	4	26	80	0.3250000
NODE_61112_length_435_cov_4.601190	271	309	0	38	38	1.0000000
NODE_61112_length_435_cov_4.601190	282	344	0	62	62	1.0000000
NODE_61122_length_435_cov_3.770833	209	240	2	31	31	1.0000000
NODE_61137_length_435_cov_2.836310	113	194	14	4	81	0.0493827
NODE_61137_length_435_cov_2.836310	113	194	18	2	81	0.0246914
NODE_61137_length_435_cov_2.836310	113	194	20	22	81	0.2716049
NODE_61137_length_435_cov_2.836310	113	194	22	53	81	0.6543210
NODE_61357_length_435_cov_0.988095	286	322	2	36	36	1.0000000
NODE_61451_length_434_cov_136.483582	0	58	20	1	58	0.0172414
NODE_61451_length_434_cov_136.483582	0	58	22	1	58	0.0172414
NODE_61451_length_434_cov_136.483582	0	58	30	1	58	0.0172414
NODE_61451_length_434_cov_136.483582	0	58	32	2	58	0.0344828
NODE_61451_length_434_cov_136.483582	0	58	36	1	58	0.0172414
NODE_61451_length_434_cov_136.483582	0	58	45	2	58	0.0344828
NODE_61451_length_434_cov_136.483582	0	58	53	1	58	0.0172414
NODE_61451_length_434_cov_136.483582	0	58	57	1	58	0.0172414
NODE_61451_length_434_cov_136.483582	0	58	58	1	58	0.0172414
NODE_61451_length_434_cov_136.483582	0	58	70	1	58	0.0172414
NODE_61451_length_434_cov_136.483582	0	58	76	1	58	0.0172414
NODE_61451_length_434_cov_136.483582	0	58	82	2	58	0.0344828
NODE_61451_length_434_cov_136.483582	0	58	83	3	58	0.0517241
NODE_61451_length_434_cov_136.483582	0	58	86	1	58	0.0172414
NODE_61451_length_434_cov_136.483582	0	58	88	1	58	0.0172414
NODE_61451_length_434_cov_136.483582	0	58	92	1	58	0.0172414
NODE_61451_length_434_cov_136.483582	0	58	94	1	58	0.0172414
NODE_61451_length_434_cov_136.483582	0	58	98	1	58	0.0172414
NODE_61451_length_434_cov_136.483582	0	58	100	2	58	0.0344828
NODE_61451_length_434_cov_136.483582	0	58	102	1	58	0.0172414
NODE_61451_length_434_cov_136.483582	0	58	106	1	58	0.0172414
NODE_61451_length_434_cov_136.483582	0	58	109	1	58	0.0172414
NODE_61451_length_434_cov_136.483582	0	58	120	1	58	0.0172414
NODE_61451_length_434_cov_136.483582	0	58	124	3	58	0.0517241
NODE_61451_length_434_cov_136.483582	0	58	126	1	58	0.0172414
NODE_61451_length_434_cov_136.483582	0	58	130	5	58	0.0862069
NODE_61451_length_434_cov_136.483582	0	58	134	6	58	0.1034483
NODE_61451_length_434_cov_136.483582	0	58	136	9	58	0.1551724
NODE_61451_length_434_cov_136.483582	0	58	137	5	58	0.0862069
NODE_61451_length_434_cov_136.483582	31	111	124	1	80	0.0125000
NODE_61451_length_434_cov_136.483582	31	111	126	1	80	0.0125000
NODE_61451_length_434_cov_136.483582	31	111	130	5	80	0.0625000
NODE_61451_length_434_cov_136.483582	31	111	134	6	80	0.0750000
NODE_61451_length_434_cov_136.483582	31	111	136	9	80	0.1125000
NODE_61451_length_434_cov_136.483582	31	111	137	5	80	0.0625000
NODE_61451_length_434_cov_136.483582	31	111	139	1	80	0.0125000
NODE_61451_length_434_cov_136.483582	31	111	141	2	80	0.0250000
NODE_61451_length_434_cov_136.483582	31	111	143	1	80	0.0125000
NODE_61451_length_434_cov_136.483582	31	111	144	1	80	0.0125000
NODE_61451_length_434_cov_136.483582	31	111	145	6	80	0.0750000
NODE_61451_length_434_cov_136.483582	31	111	152	1	80	0.0125000
NODE_61451_length_434_cov_136.483582	31	111	153	2	80	0.0250000
NODE_61451_length_434_cov_136.483582	31	111	155	1	80	0.0125000
NODE_61451_length_434_cov_136.483582	31	111	159	2	80	0.0250000
NODE_61451_length_434_cov_136.483582	31	111	160	2	80	0.0250000
NODE_61451_length_434_cov_136.483582	31	111	161	1	80	0.0125000
NODE_61451_length_434_cov_136.483582	31	111	162	2	80	0.0250000
NODE_61451_length_434_cov_136.483582	31	111	164	2	80	0.0250000
NODE_61451_length_434_cov_136.483582	31	111	165	1	80	0.0125000
NODE_61451_length_434_cov_136.483582	31	111	166	4	80	0.0500000
NODE_61451_length_434_cov_136.483582	31	111	168	1	80	0.0125000
NODE_61451_length_434_cov_136.483582	31	111	170	5	80	0.0625000
NODE_61451_length_434_cov_136.483582	31	111	172	4	80	0.0500000
NODE_61451_length_434_cov_136.483582	31	111	176	1	80	0.0125000
NODE_61451_length_434_cov_136.483582	31	111	178	12	80	0.1500000
NODE_61451_length_434_cov_136.483582	31	111	180	1	80	0.0125000
NODE_61452_length_434_cov_43.214925	291	366	1	4	75	0.0533333
NODE_61452_length_434_cov_43.214925	291	366	5	4	75	0.0533333
NODE_61452_length_434_cov_43.214925	291	366	7	15	75	0.2000000
NODE_61452_length_434_cov_43.214925	291	366	9	52	75	0.6933333
NODE_61452_length_434_cov_43.214925	344	424	0	4	80	0.0500000
NODE_61452_length_434_cov_43.214925	344	424	2	9	80	0.1125000
NODE_61452_length_434_cov_43.214925	344	424	4	3	80	0.0375000
NODE_61452_length_434_cov_43.214925	344	424	8	23	80	0.2875000
NODE_61452_length_434_cov_43.214925	344	424	9	41	80	0.5125000
NODE_61452_length_434_cov_43.214925	344	424	0	4	80	0.0500000
NODE_61452_length_434_cov_43.214925	344	424	2	9	80	0.1125000
NODE_61452_length_434_cov_43.214925	344	424	4	3	80	0.0375000
NODE_61452_length_434_cov_43.214925	344	424	8	23	80	0.2875000
NODE_61452_length_434_cov_43.214925	344	424	9	41	80	0.5125000
NODE_61453_length_434_cov_22.373134	80	160	0	53	80	0.6625000
NODE_61453_length_434_cov_22.373134	80	160	2	27	80	0.3375000
NODE_61453_length_434_cov_22.373134	133	213	2	80	80	1.0000000
NODE_61455_length_434_cov_11.549254	74	145	0	71	71	1.0000000
NODE_61455_length_434_cov_11.549254	118	198	0	80	80	1.0000000
NODE_61477_length_434_cov_4.125373	191	233	0	42	42	1.0000000
NODE_61477_length_434_cov_4.125373	200	235	0	35	35	1.0000000
NODE_61497_length_434_cov_3.104478	191	263	0	5	72	0.0694444
NODE_61497_length_434_cov_3.104478	191	263	2	49	72	0.6805556
NODE_61497_length_434_cov_3.104478	191	263	4	2	72	0.0277778
NODE_61497_length_434_cov_3.104478	191	263	6	16	72	0.2222222
NODE_61528_length_434_cov_2.197015	129	168	2	27	39	0.6923077
NODE_61528_length_434_cov_2.197015	129	168	4	12	39	0.3076923
NODE_61563_length_434_cov_1.883582	88	133	0	13	45	0.2888889
NODE_61563_length_434_cov_1.883582	88	133	2	13	45	0.2888889
NODE_61563_length_434_cov_1.883582	88	133	4	19	45	0.4222222
NODE_61563_length_434_cov_1.883582	141	182	4	1	41	0.0243902
NODE_61563_length_434_cov_1.883582	141	182	8	7	41	0.1707317
NODE_61563_length_434_cov_1.883582	141	182	12	22	41	0.5365854
NODE_61563_length_434_cov_1.883582	141	182	14	11	41	0.2682927
NODE_61603_length_434_cov_1.626866	163	243	10	8	80	0.1000000
NODE_61603_length_434_cov_1.626866	163	243	12	33	80	0.4125000
NODE_61603_length_434_cov_1.626866	163	243	14	33	80	0.4125000
NODE_61603_length_434_cov_1.626866	163	243	16	6	80	0.0750000
NODE_61676_length_434_cov_1.220896	118	198	89	1	80	0.0125000
NODE_61676_length_434_cov_1.220896	118	198	90	1	80	0.0125000
NODE_61676_length_434_cov_1.220896	118	198	92	1	80	0.0125000
NODE_61676_length_434_cov_1.220896	118	198	93	1	80	0.0125000
NODE_61676_length_434_cov_1.220896	118	198	95	2	80	0.0250000
NODE_61676_length_434_cov_1.220896	118	198	103	1	80	0.0125000
NODE_61676_length_434_cov_1.220896	118	198	104	1	80	0.0125000
NODE_61676_length_434_cov_1.220896	118	198	105	1	80	0.0125000
NODE_61676_length_434_cov_1.220896	118	198	107	1	80	0.0125000
NODE_61676_length_434_cov_1.220896	118	198	108	1	80	0.0125000
NODE_61676_length_434_cov_1.220896	118	198	116	1	80	0.0125000
NODE_61676_length_434_cov_1.220896	118	198	122	1	80	0.0125000
NODE_61676_length_434_cov_1.220896	118	198	124	2	80	0.0250000
NODE_61676_length_434_cov_1.220896	118	198	126	1	80	0.0125000
NODE_61676_length_434_cov_1.220896	118	198	130	2	80	0.0250000
NODE_61676_length_434_cov_1.220896	118	198	132	2	80	0.0250000
NODE_61676_length_434_cov_1.220896	118	198	134	1	80	0.0125000
NODE_61676_length_434_cov_1.220896	118	198	138	1	80	0.0125000
NODE_61676_length_434_cov_1.220896	118	198	140	2	80	0.0250000
NODE_61676_length_434_cov_1.220896	118	198	142	3	80	0.0375000
NODE_61676_length_434_cov_1.220896	118	198	146	1	80	0.0125000
NODE_61676_length_434_cov_1.220896	118	198	152	1	80	0.0125000
NODE_61676_length_434_cov_1.220896	118	198	156	2	80	0.0250000
NODE_61676_length_434_cov_1.220896	118	198	157	2	80	0.0250000
NODE_61676_length_434_cov_1.220896	118	198	158	4	80	0.0500000
NODE_61676_length_434_cov_1.220896	118	198	159	6	80	0.0750000
NODE_61676_length_434_cov_1.220896	118	198	160	5	80	0.0625000
NODE_61676_length_434_cov_1.220896	118	198	161	2	80	0.0250000
NODE_61676_length_434_cov_1.220896	118	198	163	3	80	0.0375000
NODE_61676_length_434_cov_1.220896	118	198	164	2	80	0.0250000
NODE_61676_length_434_cov_1.220896	118	198	165	2	80	0.0250000
NODE_61676_length_434_cov_1.220896	118	198	168	8	80	0.1000000
NODE_61676_length_434_cov_1.220896	118	198	170	7	80	0.0875000
NODE_61676_length_434_cov_1.220896	118	198	172	8	80	0.1000000
NODE_61727_length_434_cov_1.002985	245	286	4	18	41	0.4390244
NODE_61727_length_434_cov_1.002985	245	286	6	11	41	0.2682927
NODE_61727_length_434_cov_1.002985	245	286	8	12	41	0.2926829
NODE_61727_length_434_cov_1.002985	258	339	2	1	81	0.0123457
NODE_61727_length_434_cov_1.002985	258	339	4	6	81	0.0740741
NODE_61727_length_434_cov_1.002985	258	339	6	17	81	0.2098765
NODE_61727_length_434_cov_1.002985	258	339	8	57	81	0.7037037
NODE_61826_length_433_cov_51.392216	2	82	0	80	80	1.0000000
NODE_61826_length_433_cov_51.392216	55	135	0	80	80	1.0000000
NODE_61826_length_433_cov_51.392216	131	213	0	82	82	1.0000000
NODE_61826_length_433_cov_51.392216	189	266	0	77	77	1.0000000
NODE_61827_length_433_cov_46.344311	248	328	0	80	80	1.0000000
NODE_61827_length_433_cov_46.344311	301	381	0	80	80	1.0000000
NODE_61828_length_433_cov_41.808383	92	172	0	80	80	1.0000000
NODE_61828_length_433_cov_41.808383	145	225	0	80	80	1.0000000
NODE_61835_length_433_cov_6.227545	157	237	0	80	80	1.0000000
NODE_61836_length_433_cov_6.080838	164	244	0	11	80	0.1375000
NODE_61836_length_433_cov_6.080838	164	244	2	9	80	0.1125000
NODE_61836_length_433_cov_6.080838	164	244	4	60	80	0.7500000
NODE_61838_length_433_cov_5.547904	10	80	2	15	70	0.2142857
NODE_61838_length_433_cov_5.547904	10	80	4	21	70	0.3000000
NODE_61838_length_433_cov_5.547904	10	80	6	34	70	0.4857143
NODE_61838_length_433_cov_5.547904	51	133	2	16	82	0.1951219
NODE_61838_length_433_cov_5.547904	51	133	4	3	82	0.0365854
NODE_61838_length_433_cov_5.547904	51	133	6	63	82	0.7682927
NODE_61839_length_433_cov_5.476048	81	141	0	60	60	1.0000000
NODE_61855_length_433_cov_3.907186	77	107	2	30	30	1.0000000
NODE_61862_length_433_cov_3.595808	231	316	0	2	85	0.0235294
NODE_61862_length_433_cov_3.595808	231	316	2	7	85	0.0823529
NODE_61862_length_433_cov_3.595808	231	316	4	2	85	0.0235294
NODE_61862_length_433_cov_3.595808	231	316	6	1	85	0.0117647
NODE_61862_length_433_cov_3.595808	231	316	8	3	85	0.0352941
NODE_61862_length_433_cov_3.595808	231	316	10	35	85	0.4117647
NODE_61862_length_433_cov_3.595808	231	316	12	5	85	0.0588235
NODE_61862_length_433_cov_3.595808	231	316	14	10	85	0.1176471
NODE_61862_length_433_cov_3.595808	231	316	16	10	85	0.1176471
NODE_61862_length_433_cov_3.595808	231	316	18	1	85	0.0117647
NODE_61862_length_433_cov_3.595808	231	316	22	3	85	0.0352941
NODE_61862_length_433_cov_3.595808	231	316	24	1	85	0.0117647
NODE_61862_length_433_cov_3.595808	231	316	25	2	85	0.0235294
NODE_61862_length_433_cov_3.595808	231	316	26	3	85	0.0352941
NODE_61864_length_433_cov_3.526946	107	178	0	57	71	0.8028169
NODE_61864_length_433_cov_3.526946	107	178	4	14	71	0.1971831
NODE_61931_length_433_cov_2.137725	123	203	0	63	80	0.7875000
NODE_61931_length_433_cov_2.137725	123	203	1	17	80	0.2125000
NODE_62258_length_432_cov_17.540541	150	230	0	3	80	0.0375000
NODE_62258_length_432_cov_17.540541	150	230	2	2	80	0.0250000
NODE_62258_length_432_cov_17.540541	150	230	3	1	80	0.0125000
NODE_62258_length_432_cov_17.540541	150	230	5	13	80	0.1625000
NODE_62258_length_432_cov_17.540541	150	230	6	29	80	0.3625000
NODE_62258_length_432_cov_17.540541	150	230	8	32	80	0.4000000
NODE_62258_length_432_cov_17.540541	203	288	4	19	85	0.2235294
NODE_62258_length_432_cov_17.540541	203	288	6	23	85	0.2705882
NODE_62258_length_432_cov_17.540541	203	288	8	43	85	0.5058824
NODE_62264_length_432_cov_6.555556	52	82	2	30	30	1.0000000
NODE_62268_length_432_cov_5.720721	77	157	0	80	80	1.0000000
NODE_62268_length_432_cov_5.720721	130	202	0	72	72	1.0000000
NODE_62269_length_432_cov_5.387387	65	95	0	30	30	1.0000000
NODE_62270_length_432_cov_5.345345	271	324	10	2	53	0.0377358
NODE_62270_length_432_cov_5.345345	271	324	12	2	53	0.0377358
NODE_62270_length_432_cov_5.345345	271	324	14	5	53	0.0943396
NODE_62270_length_432_cov_5.345345	271	324	16	44	53	0.8301887
NODE_62293_length_432_cov_3.678679	78	121	0	18	43	0.4186046
NODE_62293_length_432_cov_3.678679	78	121	2	25	43	0.5813953
NODE_62304_length_432_cov_3.246246	87	128	12	17	41	0.4146341
NODE_62304_length_432_cov_3.246246	87	128	13	1	41	0.0243902
NODE_62304_length_432_cov_3.246246	87	128	14	17	41	0.4146341
NODE_62304_length_432_cov_3.246246	87	128	16	5	41	0.1219512
NODE_62304_length_432_cov_3.246246	87	128	18	1	41	0.0243902
NODE_62304_length_432_cov_3.246246	101	167	12	3	66	0.0454545
NODE_62304_length_432_cov_3.246246	101	167	13	1	66	0.0151515
NODE_62304_length_432_cov_3.246246	101	167	14	17	66	0.2575758
NODE_62304_length_432_cov_3.246246	101	167	16	5	66	0.0757576
NODE_62304_length_432_cov_3.246246	101	167	18	1	66	0.0151515
NODE_62304_length_432_cov_3.246246	101	167	20	6	66	0.0909091
NODE_62304_length_432_cov_3.246246	101	167	22	2	66	0.0303030
NODE_62304_length_432_cov_3.246246	101	167	30	5	66	0.0757576
NODE_62304_length_432_cov_3.246246	101	167	32	1	66	0.0151515
NODE_62304_length_432_cov_3.246246	101	167	36	2	66	0.0303030
NODE_62304_length_432_cov_3.246246	101	167	38	23	66	0.3484848
NODE_62396_length_432_cov_1.762763	4	71	2	67	67	1.0000000
NODE_62544_length_432_cov_1.027027	44	68	0	24	24	1.0000000
NODE_62650_length_431_cov_35.355422	202	284	0	82	82	1.0000000
NODE_62650_length_431_cov_35.355422	257	333	0	76	76	1.0000000
NODE_62652_length_431_cov_11.207831	185	265	2	80	80	1.0000000
NODE_62652_length_431_cov_11.207831	238	318	0	32	80	0.4000000
NODE_62652_length_431_cov_11.207831	238	318	2	48	80	0.6000000
NODE_62657_length_431_cov_7.018072	110	190	0	80	80	1.0000000
NODE_62657_length_431_cov_7.018072	163	243	0	56	80	0.7000000
NODE_62657_length_431_cov_7.018072	163	243	2	24	80	0.3000000
NODE_62661_length_431_cov_6.292169	123	203	0	6	80	0.0750000
NODE_62661_length_431_cov_6.292169	123	203	2	45	80	0.5625000
NODE_62661_length_431_cov_6.292169	123	203	4	29	80	0.3625000
NODE_62668_length_431_cov_5.608434	170	241	6	22	71	0.3098592
NODE_62668_length_431_cov_5.608434	170	241	7	49	71	0.6901408
NODE_62681_length_431_cov_4.250000	146	216	4	54	70	0.7714286
NODE_62681_length_431_cov_4.250000	146	216	8	16	70	0.2285714
NODE_62684_length_431_cov_3.993976	210	290	0	25	80	0.3125000
NODE_62684_length_431_cov_3.993976	210	290	2	18	80	0.2250000
NODE_62684_length_431_cov_3.993976	210	290	4	37	80	0.4625000
NODE_62794_length_431_cov_1.695783	76	156	8	5	80	0.0625000
NODE_62794_length_431_cov_1.695783	76	156	10	2	80	0.0250000
NODE_62794_length_431_cov_1.695783	76	156	12	1	80	0.0125000
NODE_62794_length_431_cov_1.695783	76	156	14	8	80	0.1000000
NODE_62794_length_431_cov_1.695783	76	156	16	57	80	0.7125000
NODE_62794_length_431_cov_1.695783	76	156	20	7	80	0.0875000
NODE_62794_length_431_cov_1.695783	129	199	14	7	70	0.1000000
NODE_62794_length_431_cov_1.695783	129	199	16	30	70	0.4285714
NODE_62794_length_431_cov_1.695783	129	199	18	18	70	0.2571429
NODE_62794_length_431_cov_1.695783	129	199	20	15	70	0.2142857
NODE_63043_length_430_cov_49.791541	319	399	46	1	80	0.0125000
NODE_63043_length_430_cov_49.791541	319	399	48	1	80	0.0125000
NODE_63043_length_430_cov_49.791541	319	399	52	7	80	0.0875000
NODE_63043_length_430_cov_49.791541	319	399	54	2	80	0.0250000
NODE_63043_length_430_cov_49.791541	319	399	56	3	80	0.0375000
NODE_63043_length_430_cov_49.791541	319	399	57	1	80	0.0125000
NODE_63043_length_430_cov_49.791541	319	399	58	1	80	0.0125000
NODE_63043_length_430_cov_49.791541	319	399	62	2	80	0.0250000
NODE_63043_length_430_cov_49.791541	319	399	66	5	80	0.0625000
NODE_63043_length_430_cov_49.791541	319	399	68	3	80	0.0375000
NODE_63043_length_430_cov_49.791541	319	399	70	1	80	0.0125000
NODE_63043_length_430_cov_49.791541	319	399	72	3	80	0.0375000
NODE_63043_length_430_cov_49.791541	319	399	74	1	80	0.0125000
NODE_63043_length_430_cov_49.791541	319	399	79	1	80	0.0125000
NODE_63043_length_430_cov_49.791541	319	399	83	11	80	0.1375000
NODE_63043_length_430_cov_49.791541	319	399	85	1	80	0.0125000
NODE_63043_length_430_cov_49.791541	319	399	87	2	80	0.0250000
NODE_63043_length_430_cov_49.791541	319	399	89	3	80	0.0375000
NODE_63043_length_430_cov_49.791541	319	399	90	2	80	0.0250000
NODE_63043_length_430_cov_49.791541	319	399	94	3	80	0.0375000
NODE_63043_length_430_cov_49.791541	319	399	96	1	80	0.0125000
NODE_63043_length_430_cov_49.791541	319	399	100	1	80	0.0125000
NODE_63043_length_430_cov_49.791541	319	399	104	8	80	0.1000000
NODE_63043_length_430_cov_49.791541	319	399	106	1	80	0.0125000
NODE_63043_length_430_cov_49.791541	319	399	108	2	80	0.0250000
NODE_63043_length_430_cov_49.791541	319	399	110	10	80	0.1250000
NODE_63043_length_430_cov_49.791541	319	399	112	3	80	0.0375000
NODE_63043_length_430_cov_49.791541	372	430	10	2	58	0.0344828
NODE_63043_length_430_cov_49.791541	372	430	12	3	58	0.0517241
NODE_63043_length_430_cov_49.791541	372	430	18	1	58	0.0172414
NODE_63043_length_430_cov_49.791541	372	430	20	2	58	0.0344828
NODE_63043_length_430_cov_49.791541	372	430	24	1	58	0.0172414
NODE_63043_length_430_cov_49.791541	372	430	26	3	58	0.0517241
NODE_63043_length_430_cov_49.791541	372	430	28	2	58	0.0344828
NODE_63043_length_430_cov_49.791541	372	430	32	4	58	0.0689655
NODE_63043_length_430_cov_49.791541	372	430	34	1	58	0.0172414
NODE_63043_length_430_cov_49.791541	372	430	36	3	58	0.0517241
NODE_63043_length_430_cov_49.791541	372	430	38	4	58	0.0689655
NODE_63043_length_430_cov_49.791541	372	430	46	6	58	0.1034483
NODE_63043_length_430_cov_49.791541	372	430	48	1	58	0.0172414
NODE_63043_length_430_cov_49.791541	372	430	52	7	58	0.1206897
NODE_63043_length_430_cov_49.791541	372	430	54	2	58	0.0344828
NODE_63043_length_430_cov_49.791541	372	430	56	3	58	0.0517241
NODE_63043_length_430_cov_49.791541	372	430	57	1	58	0.0172414
NODE_63043_length_430_cov_49.791541	372	430	58	1	58	0.0172414
NODE_63043_length_430_cov_49.791541	372	430	62	2	58	0.0344828
NODE_63043_length_430_cov_49.791541	372	430	66	5	58	0.0862069
NODE_63043_length_430_cov_49.791541	372	430	68	3	58	0.0517241
NODE_63043_length_430_cov_49.791541	372	430	70	1	58	0.0172414
NODE_63044_length_430_cov_44.365559	109	189	0	80	80	1.0000000
NODE_63044_length_430_cov_44.365559	162	242	0	80	80	1.0000000
NODE_63045_length_430_cov_16.746224	92	172	0	80	80	1.0000000
NODE_63045_length_430_cov_16.746224	145	225	0	80	80	1.0000000
NODE_63048_length_430_cov_7.737160	180	263	0	31	83	0.3734940
NODE_63048_length_430_cov_7.737160	180	263	2	52	83	0.6265060
NODE_63050_length_430_cov_6.163142	135	197	0	62	62	1.0000000
NODE_63051_length_430_cov_5.873112	7	90	0	75	83	0.9036145
NODE_63051_length_430_cov_5.873112	7	90	2	8	83	0.0963855
NODE_63051_length_430_cov_5.873112	60	126	0	22	66	0.3333333
NODE_63051_length_430_cov_5.873112	60	126	2	16	66	0.2424242
NODE_63051_length_430_cov_5.873112	60	126	4	28	66	0.4242424
NODE_63066_length_430_cov_4.323263	18	90	0	72	72	1.0000000
NODE_63161_length_430_cov_1.945619	153	233	2	80	80	1.0000000
NODE_63401_length_430_cov_0.664653	391	430	0	39	39	1.0000000
NODE_63437_length_429_cov_10.424242	78	158	2	80	80	1.0000000
NODE_63437_length_429_cov_10.424242	207	287	0	47	80	0.5875000
NODE_63437_length_429_cov_10.424242	207	287	1	33	80	0.4125000
NODE_63437_length_429_cov_10.424242	260	340	1	32	80	0.4000000
NODE_63437_length_429_cov_10.424242	260	340	2	48	80	0.6000000
NODE_63439_length_429_cov_8.957576	213	293	0	51	80	0.6375000
NODE_63439_length_429_cov_8.957576	213	293	2	29	80	0.3625000
NODE_63439_length_429_cov_8.957576	266	346	2	80	80	1.0000000
NODE_63441_length_429_cov_6.772727	337	366	0	29	29	1.0000000
NODE_63485_length_429_cov_3.003030	173	251	0	74	78	0.9487180
NODE_63485_length_429_cov_3.003030	173	251	2	4	78	0.0512821
NODE_63516_length_429_cov_2.433333	220	300	0	80	80	1.0000000
NODE_63519_length_429_cov_2.360606	24	85	0	61	61	1.0000000
NODE_63527_length_429_cov_2.224242	115	195	0	22	80	0.2750000
NODE_63527_length_429_cov_2.224242	115	195	2	58	80	0.7250000
NODE_63547_length_429_cov_2.051515	114	143	0	29	29	1.0000000
NODE_63547_length_429_cov_2.051515	286	348	0	14	62	0.2258064
NODE_63547_length_429_cov_2.051515	286	348	4	48	62	0.7741935
NODE_63864_length_428_cov_40.449848	217	297	0	80	80	1.0000000
NODE_63864_length_428_cov_40.449848	270	350	0	80	80	1.0000000
NODE_63864_length_428_cov_40.449848	346	426	0	80	80	1.0000000
NODE_63865_length_428_cov_31.066869	249	325	2	28	76	0.3684210
NODE_63865_length_428_cov_31.066869	249	325	3	3	76	0.0394737
NODE_63865_length_428_cov_31.066869	249	325	4	9	76	0.1184211
NODE_63865_length_428_cov_31.066869	249	325	6	8	76	0.1052632
NODE_63865_length_428_cov_31.066869	249	325	7	2	76	0.0263158
NODE_63865_length_428_cov_31.066869	249	325	9	1	76	0.0131579
NODE_63865_length_428_cov_31.066869	249	325	11	3	76	0.0394737
NODE_63865_length_428_cov_31.066869	249	325	13	6	76	0.0789474
NODE_63865_length_428_cov_31.066869	249	325	15	2	76	0.0263158
NODE_63865_length_428_cov_31.066869	249	325	19	3	76	0.0394737
NODE_63865_length_428_cov_31.066869	249	325	20	11	76	0.1447368
NODE_63865_length_428_cov_31.066869	297	378	2	11	81	0.1358025
NODE_63865_length_428_cov_31.066869	297	378	4	60	81	0.7407407
NODE_63865_length_428_cov_31.066869	297	378	6	10	81	0.1234568
NODE_63866_length_428_cov_11.799392	62	142	0	80	80	1.0000000
NODE_63866_length_428_cov_11.799392	115	195	0	80	80	1.0000000
NODE_63867_length_428_cov_10.595745	227	307	0	80	80	1.0000000
NODE_63870_length_428_cov_6.784195	344	374	0	30	30	1.0000000
NODE_63871_length_428_cov_6.768997	131	194	0	22	63	0.3492064
NODE_63871_length_428_cov_6.768997	131	194	2	41	63	0.6507937
NODE_63895_length_428_cov_4.206687	224	304	0	17	80	0.2125000
NODE_63895_length_428_cov_4.206687	224	304	1	4	80	0.0500000
NODE_63895_length_428_cov_4.206687	224	304	2	32	80	0.4000000
NODE_63895_length_428_cov_4.206687	224	304	4	3	80	0.0375000
NODE_63895_length_428_cov_4.206687	224	304	6	21	80	0.2625000
NODE_63895_length_428_cov_4.206687	224	304	9	1	80	0.0125000
NODE_63895_length_428_cov_4.206687	224	304	10	2	80	0.0250000
NODE_63905_length_428_cov_3.525836	168	236	0	68	68	1.0000000
NODE_63905_length_428_cov_3.525836	209	244	0	35	35	1.0000000
NODE_63959_length_428_cov_2.322188	1	42	0	41	41	1.0000000
NODE_63977_length_428_cov_2.124620	228	308	0	51	80	0.6375000
NODE_63977_length_428_cov_2.124620	228	308	2	29	80	0.3625000
NODE_64011_length_428_cov_1.848024	178	260	0	82	82	1.0000000
NODE_64027_length_428_cov_1.772036	187	255	0	68	68	1.0000000
NODE_64245_length_428_cov_0.790274	275	308	0	33	33	1.0000000
NODE_64245_length_428_cov_0.790274	276	302	0	26	26	1.0000000
NODE_64310_length_427_cov_29.628049	312	392	6	23	80	0.2875000
NODE_64310_length_427_cov_29.628049	312	392	8	57	80	0.7125000
NODE_64310_length_427_cov_29.628049	365	427	0	4	62	0.0645161
NODE_64310_length_427_cov_29.628049	365	427	2	23	62	0.3709677
NODE_64310_length_427_cov_29.628049	365	427	3	2	62	0.0322581
NODE_64310_length_427_cov_29.628049	365	427	4	6	62	0.0967742
NODE_64310_length_427_cov_29.628049	365	427	6	23	62	0.3709677
NODE_64310_length_427_cov_29.628049	365	427	8	4	62	0.0645161
NODE_64310_length_427_cov_29.628049	365	427	0	4	62	0.0645161
NODE_64310_length_427_cov_29.628049	365	427	2	23	62	0.3709677
NODE_64310_length_427_cov_29.628049	365	427	3	2	62	0.0322581
NODE_64310_length_427_cov_29.628049	365	427	4	6	62	0.0967742
NODE_64310_length_427_cov_29.628049	365	427	6	23	62	0.3709677
NODE_64310_length_427_cov_29.628049	365	427	8	4	62	0.0645161
NODE_64312_length_427_cov_9.371951	184	239	2	8	55	0.1454545
NODE_64312_length_427_cov_9.371951	184	239	4	5	55	0.0909091
NODE_64312_length_427_cov_9.371951	184	239	6	42	55	0.7636364
NODE_64313_length_427_cov_9.359756	11	82	0	71	71	1.0000000
NODE_64313_length_427_cov_9.359756	70	149	0	79	79	1.0000000
NODE_64313_length_427_cov_9.359756	145	225	0	80	80	1.0000000
NODE_64313_length_427_cov_9.359756	198	278	0	80	80	1.0000000
NODE_64321_length_427_cov_5.929878	405	424	0	19	19	1.0000000
NODE_64324_length_427_cov_5.088415	257	332	0	75	75	1.0000000
NODE_64345_length_427_cov_3.884146	212	260	0	48	48	1.0000000
NODE_64383_length_427_cov_2.765244	312	363	0	51	51	1.0000000
NODE_64409_length_427_cov_2.362805	142	177	0	35	35	1.0000000
NODE_64537_length_427_cov_1.359756	56	139	0	83	83	1.0000000
NODE_64728_length_426_cov_21.837920	178	258	0	27	80	0.3375000
NODE_64728_length_426_cov_21.837920	178	258	2	53	80	0.6625000
NODE_64729_length_426_cov_16.850153	76	156	0	43	80	0.5375000
NODE_64729_length_426_cov_16.850153	76	156	2	37	80	0.4625000
NODE_64729_length_426_cov_16.850153	129	209	2	80	80	1.0000000
NODE_64731_length_426_cov_9.033639	152	232	0	80	80	1.0000000
NODE_64731_length_426_cov_9.033639	205	285	0	80	80	1.0000000
NODE_64734_length_426_cov_8.314985	133	213	0	13	80	0.1625000
NODE_64734_length_426_cov_8.314985	133	213	1	7	80	0.0875000
NODE_64734_length_426_cov_8.314985	133	213	2	60	80	0.7500000
NODE_64734_length_426_cov_8.314985	186	266	0	66	80	0.8250000
NODE_64734_length_426_cov_8.314985	186	266	1	7	80	0.0875000
NODE_64734_length_426_cov_8.314985	186	266	2	7	80	0.0875000
NODE_64735_length_426_cov_8.278287	132	212	0	80	80	1.0000000
NODE_64735_length_426_cov_8.278287	185	265	0	80	80	1.0000000
NODE_64752_length_426_cov_4.926606	116	196	0	75	80	0.9375000
NODE_64752_length_426_cov_4.926606	116	196	2	5	80	0.0625000
NODE_64754_length_426_cov_4.743119	119	199	2	16	80	0.2000000
NODE_64754_length_426_cov_4.743119	119	199	4	64	80	0.8000000
NODE_64754_length_426_cov_4.743119	172	252	2	27	80	0.3375000
NODE_64754_length_426_cov_4.743119	172	252	4	53	80	0.6625000
NODE_64833_length_426_cov_2.278287	92	132	0	40	40	1.0000000
NODE_64833_length_426_cov_2.278287	139	205	0	44	66	0.6666667
NODE_64833_length_426_cov_2.278287	139	205	2	22	66	0.3333333
NODE_64865_length_426_cov_1.896024	80	154	0	74	74	1.0000000
NODE_64948_length_426_cov_1.397554	240	290	4	50	50	1.0000000
NODE_65135_length_426_cov_0.602446	127	158	2	31	31	1.0000000
NODE_65152_length_425_cov_63.938650	0	61	0	61	61	1.0000000
NODE_65152_length_425_cov_63.938650	34	114	0	80	80	1.0000000
NODE_65164_length_425_cov_4.877301	171	229	10	23	58	0.3965517
NODE_65164_length_425_cov_4.877301	171	229	12	3	58	0.0517241
NODE_65164_length_425_cov_4.877301	171	229	14	2	58	0.0344828
NODE_65164_length_425_cov_4.877301	171	229	15	16	58	0.2758621
NODE_65164_length_425_cov_4.877301	171	229	16	8	58	0.1379310
NODE_65164_length_425_cov_4.877301	171	229	18	6	58	0.1034483
NODE_65165_length_425_cov_4.822086	295	377	4	6	82	0.0731707
NODE_65165_length_425_cov_4.822086	295	377	6	5	82	0.0609756
NODE_65165_length_425_cov_4.822086	295	377	8	42	82	0.5121951
NODE_65165_length_425_cov_4.822086	295	377	10	2	82	0.0243902
NODE_65165_length_425_cov_4.822086	295	377	12	7	82	0.0853659
NODE_65165_length_425_cov_4.822086	295	377	14	8	82	0.0975610
NODE_65165_length_425_cov_4.822086	295	377	16	10	82	0.1219512
NODE_65165_length_425_cov_4.822086	295	377	18	2	82	0.0243902
NODE_65218_length_425_cov_2.809816	38	118	2	30	80	0.3750000
NODE_65218_length_425_cov_2.809816	38	118	4	50	80	0.6250000
NODE_65278_length_425_cov_1.935583	93	138	0	45	45	1.0000000
NODE_65278_length_425_cov_1.935583	170	225	0	55	55	1.0000000
NODE_65278_length_425_cov_1.935583	312	355	4	20	43	0.4651163
NODE_65278_length_425_cov_1.935583	312	355	6	23	43	0.5348837
NODE_65565_length_425_cov_0.628834	104	131	0	27	27	1.0000000
NODE_65602_length_424_cov_5.295385	224	270	0	46	46	1.0000000
NODE_65634_length_424_cov_3.255385	266	329	0	51	63	0.8095238
NODE_65634_length_424_cov_3.255385	266	329	2	12	63	0.1904762
NODE_65669_length_424_cov_2.578462	403	422	4	15	19	0.7894737
NODE_65669_length_424_cov_2.578462	403	422	6	4	19	0.2105263
NODE_65670_length_424_cov_2.578462	122	144	2	6	22	0.2727273
NODE_65670_length_424_cov_2.578462	122	144	4	16	22	0.7272727
NODE_66111_length_423_cov_2.728395	150	229	0	57	79	0.7215190
NODE_66111_length_423_cov_2.728395	150	229	4	22	79	0.2784810
NODE_66181_length_423_cov_1.879630	94	142	0	48	48	1.0000000
NODE_66222_length_423_cov_1.580247	128	208	0	44	80	0.5500000
NODE_66222_length_423_cov_1.580247	128	208	2	36	80	0.4500000
NODE_66258_length_423_cov_1.410494	206	286	2	11	80	0.1375000
NODE_66258_length_423_cov_1.410494	206	286	4	13	80	0.1625000
NODE_66258_length_423_cov_1.410494	206	286	6	56	80	0.7000000
NODE_66459_length_422_cov_12.021672	201	236	0	31	35	0.8857143
NODE_66459_length_422_cov_12.021672	201	236	2	4	35	0.1142857
NODE_66459_length_422_cov_12.021672	247	289	4	42	42	1.0000000
NODE_66460_length_422_cov_10.712074	62	140	0	78	78	1.0000000
NODE_66460_length_422_cov_10.712074	115	195	0	80	80	1.0000000
NODE_66468_length_422_cov_6.281734	37	117	0	18	80	0.2250000
NODE_66468_length_422_cov_6.281734	37	117	2	62	80	0.7750000
NODE_66468_length_422_cov_6.281734	90	170	0	48	80	0.6000000
NODE_66468_length_422_cov_6.281734	90	170	2	32	80	0.4000000
NODE_66474_length_422_cov_5.266254	176	256	9	32	80	0.4000000
NODE_66474_length_422_cov_5.266254	176	256	13	15	80	0.1875000
NODE_66474_length_422_cov_5.266254	176	256	14	4	80	0.0500000
NODE_66474_length_422_cov_5.266254	176	256	16	18	80	0.2250000
NODE_66474_length_422_cov_5.266254	176	256	18	11	80	0.1375000
NODE_66485_length_422_cov_4.148607	159	224	0	65	65	1.0000000
NODE_66485_length_422_cov_4.148607	197	277	0	80	80	1.0000000
NODE_66488_length_422_cov_4.003096	146	226	0	41	80	0.5125000
NODE_66488_length_422_cov_4.003096	146	226	2	39	80	0.4875000
NODE_66488_length_422_cov_4.003096	199	279	2	43	80	0.5375000
NODE_66488_length_422_cov_4.003096	199	279	3	1	80	0.0125000
NODE_66488_length_422_cov_4.003096	199	279	4	10	80	0.1250000
NODE_66488_length_422_cov_4.003096	199	279	6	26	80	0.3250000
NODE_66512_length_422_cov_3.130031	93	173	2	80	80	1.0000000
NODE_66512_length_422_cov_3.130031	146	226	0	50	80	0.6250000
NODE_66512_length_422_cov_3.130031	146	226	2	30	80	0.3750000
NODE_66515_length_422_cov_3.077399	291	359	4	3	68	0.0441176
NODE_66515_length_422_cov_3.077399	291	359	6	9	68	0.1323529
NODE_66515_length_422_cov_3.077399	291	359	8	6	68	0.0882353
NODE_66515_length_422_cov_3.077399	291	359	10	2	68	0.0294118
NODE_66515_length_422_cov_3.077399	291	359	12	5	68	0.0735294
NODE_66515_length_422_cov_3.077399	291	359	14	38	68	0.5588235
NODE_66515_length_422_cov_3.077399	291	359	16	2	68	0.0294118
NODE_66515_length_422_cov_3.077399	291	359	18	3	68	0.0441176
NODE_66550_length_422_cov_2.191950	5	24	0	19	19	1.0000000
NODE_66560_length_422_cov_2.108359	97	177	0	33	80	0.4125000
NODE_66560_length_422_cov_2.108359	97	177	2	13	80	0.1625000
NODE_66560_length_422_cov_2.108359	97	177	6	1	80	0.0125000
NODE_66560_length_422_cov_2.108359	97	177	11	3	80	0.0375000
NODE_66560_length_422_cov_2.108359	97	177	13	30	80	0.3750000
NODE_66560_length_422_cov_2.108359	150	189	0	10	39	0.2564103
NODE_66560_length_422_cov_2.108359	150	189	13	29	39	0.7435898
NODE_66560_length_422_cov_2.108359	249	289	35	9	40	0.2250000
NODE_66560_length_422_cov_2.108359	249	289	36	3	40	0.0750000
NODE_66560_length_422_cov_2.108359	249	289	40	2	40	0.0500000
NODE_66560_length_422_cov_2.108359	249	289	42	8	40	0.2000000
NODE_66560_length_422_cov_2.108359	249	289	46	3	40	0.0750000
NODE_66560_length_422_cov_2.108359	249	289	48	11	40	0.2750000
NODE_66560_length_422_cov_2.108359	249	289	50	4	40	0.1000000
NODE_66806_length_422_cov_0.845201	2	76	0	74	74	1.0000000
NODE_66869_length_421_cov_10.664596	178	256	0	78	78	1.0000000
NODE_66869_length_421_cov_10.664596	229	309	0	80	80	1.0000000
NODE_66874_length_421_cov_7.552795	325	407	0	79	82	0.9634146
NODE_66874_length_421_cov_7.552795	325	407	2	1	82	0.0121951
NODE_66874_length_421_cov_7.552795	325	407	12	1	82	0.0121951
NODE_66874_length_421_cov_7.552795	325	407	16	1	82	0.0121951
NODE_66874_length_421_cov_7.552795	380	421	0	41	41	1.0000000
NODE_66875_length_421_cov_7.431677	96	118	2	22	22	1.0000000
NODE_66883_length_421_cov_5.279503	245	310	0	65	65	1.0000000
NODE_66884_length_421_cov_5.158385	68	145	2	9	77	0.1168831
NODE_66884_length_421_cov_5.158385	68	145	4	68	77	0.8831169
NODE_66897_length_421_cov_4.114907	221	287	0	66	66	1.0000000
NODE_66898_length_421_cov_4.102484	202	277	0	75	75	1.0000000
NODE_66899_length_421_cov_4.040373	192	272	0	80	80	1.0000000
NODE_66899_length_421_cov_4.040373	245	314	0	69	69	1.0000000
NODE_66923_length_421_cov_3.319876	0	57	0	57	57	1.0000000
NODE_66955_length_421_cov_2.708075	95	118	4	22	23	0.9565217
NODE_66955_length_421_cov_2.708075	95	118	6	1	23	0.0434783
NODE_66955_length_421_cov_2.708075	109	189	2	52	80	0.6500000
NODE_66955_length_421_cov_2.708075	109	189	4	28	80	0.3500000
NODE_66955_length_421_cov_2.708075	248	300	2	52	52	1.0000000
NODE_67073_length_421_cov_1.559006	240	309	0	43	69	0.6231884
NODE_67073_length_421_cov_1.559006	240	309	2	8	69	0.1159420
NODE_67073_length_421_cov_1.559006	240	309	4	18	69	0.2608696
NODE_67073_length_421_cov_1.559006	240	310	0	44	70	0.6285715
NODE_67073_length_421_cov_1.559006	240	310	2	8	70	0.1142857
NODE_67073_length_421_cov_1.559006	240	310	4	18	70	0.2571429
NODE_67077_length_421_cov_1.537267	305	383	0	78	78	1.0000000
NODE_67098_length_421_cov_1.413043	254	303	0	49	49	1.0000000
NODE_67283_length_421_cov_0.633540	132	156	0	14	24	0.5833333
NODE_67283_length_421_cov_0.633540	132	156	2	10	24	0.4166667
NODE_67317_length_420_cov_80.766355	90	170	0	75	80	0.9375000
NODE_67317_length_420_cov_80.766355	90	170	2	5	80	0.0625000
NODE_67317_length_420_cov_80.766355	143	223	0	22	80	0.2750000
NODE_67317_length_420_cov_80.766355	143	223	2	58	80	0.7250000
NODE_67319_length_420_cov_51.473520	171	250	0	79	79	1.0000000
NODE_67319_length_420_cov_51.473520	223	307	0	84	84	1.0000000
NODE_67319_length_420_cov_51.473520	303	383	0	80	80	1.0000000
NODE_67319_length_420_cov_51.473520	356	420	0	64	64	1.0000000
NODE_67330_length_420_cov_5.071651	230	310	0	30	80	0.3750000
NODE_67330_length_420_cov_5.071651	230	310	2	50	80	0.6250000
NODE_67334_length_420_cov_4.775701	177	221	0	44	44	1.0000000
NODE_67345_length_420_cov_4.037383	161	240	0	79	79	1.0000000
NODE_67358_length_420_cov_3.657321	291	373	2	82	82	1.0000000
NODE_67398_length_420_cov_2.542056	96	176	0	80	80	1.0000000
NODE_67398_length_420_cov_2.542056	148	202	0	54	54	1.0000000
NODE_67398_length_420_cov_2.542056	149	195	0	46	46	1.0000000
NODE_67414_length_420_cov_2.323988	89	108	0	19	19	1.0000000
NODE_67506_length_420_cov_1.641745	277	312	0	10	35	0.2857143
NODE_67506_length_420_cov_1.641745	277	312	4	25	35	0.7142857
NODE_67547_length_420_cov_1.429907	15	68	2	20	53	0.3773585
NODE_67547_length_420_cov_1.429907	15	68	4	12	53	0.2264151
NODE_67547_length_420_cov_1.429907	15	68	6	21	53	0.3962264
NODE_67547_length_420_cov_1.429907	69	111	8	1	42	0.0238095
NODE_67547_length_420_cov_1.429907	69	111	10	21	42	0.5000000
NODE_67547_length_420_cov_1.429907	69	111	11	1	42	0.0238095
NODE_67547_length_420_cov_1.429907	69	111	12	12	42	0.2857143
NODE_67547_length_420_cov_1.429907	69	111	13	2	42	0.0476190
NODE_67547_length_420_cov_1.429907	69	111	14	1	42	0.0238095
NODE_67547_length_420_cov_1.429907	69	111	18	4	42	0.0952381
NODE_67770_length_419_cov_491.015625	0	67	2	15	67	0.2238806
NODE_67770_length_419_cov_491.015625	0	67	4	11	67	0.1641791
NODE_67770_length_419_cov_491.015625	0	67	8	12	67	0.1791045
NODE_67770_length_419_cov_491.015625	0	67	10	8	67	0.1194030
NODE_67770_length_419_cov_491.015625	0	67	12	7	67	0.1044776
NODE_67770_length_419_cov_491.015625	0	67	13	9	67	0.1343284
NODE_67770_length_419_cov_491.015625	0	67	14	4	67	0.0597015
NODE_67770_length_419_cov_491.015625	0	67	15	1	67	0.0149254
NODE_67770_length_419_cov_491.015625	0	67	2	15	67	0.2238806
NODE_67770_length_419_cov_491.015625	0	67	4	11	67	0.1641791
NODE_67770_length_419_cov_491.015625	0	67	8	12	67	0.1791045
NODE_67770_length_419_cov_491.015625	0	67	10	8	67	0.1194030
NODE_67770_length_419_cov_491.015625	0	67	12	7	67	0.1044776
NODE_67770_length_419_cov_491.015625	0	67	13	9	67	0.1343284
NODE_67770_length_419_cov_491.015625	0	67	14	4	67	0.0597015
NODE_67770_length_419_cov_491.015625	0	67	15	1	67	0.0149254
NODE_67770_length_419_cov_491.015625	0	67	2	15	67	0.2238806
NODE_67770_length_419_cov_491.015625	0	67	4	11	67	0.1641791
NODE_67770_length_419_cov_491.015625	0	67	8	12	67	0.1791045
NODE_67770_length_419_cov_491.015625	0	67	10	8	67	0.1194030
NODE_67770_length_419_cov_491.015625	0	67	12	7	67	0.1044776
NODE_67770_length_419_cov_491.015625	0	67	13	9	67	0.1343284
NODE_67770_length_419_cov_491.015625	0	67	14	4	67	0.0597015
NODE_67770_length_419_cov_491.015625	0	67	15	1	67	0.0149254
NODE_67770_length_419_cov_491.015625	0	67	2	15	67	0.2238806
NODE_67770_length_419_cov_491.015625	0	67	4	11	67	0.1641791
NODE_67770_length_419_cov_491.015625	0	67	8	12	67	0.1791045
NODE_67770_length_419_cov_491.015625	0	67	10	8	67	0.1194030
NODE_67770_length_419_cov_491.015625	0	67	12	7	67	0.1044776
NODE_67770_length_419_cov_491.015625	0	67	13	9	67	0.1343284
NODE_67770_length_419_cov_491.015625	0	67	14	4	67	0.0597015
NODE_67770_length_419_cov_491.015625	0	67	15	1	67	0.0149254
NODE_67770_length_419_cov_491.015625	63	143	14	3	80	0.0375000
NODE_67770_length_419_cov_491.015625	63	143	15	2	80	0.0250000
NODE_67770_length_419_cov_491.015625	63	143	16	6	80	0.0750000
NODE_67770_length_419_cov_491.015625	63	143	18	1	80	0.0125000
NODE_67770_length_419_cov_491.015625	63	143	19	3	80	0.0375000
NODE_67770_length_419_cov_491.015625	63	143	20	14	80	0.1750000
NODE_67770_length_419_cov_491.015625	63	143	22	16	80	0.2000000
NODE_67770_length_419_cov_491.015625	63	143	23	5	80	0.0625000
NODE_67770_length_419_cov_491.015625	63	143	27	3	80	0.0375000
NODE_67770_length_419_cov_491.015625	63	143	29	7	80	0.0875000
NODE_67770_length_419_cov_491.015625	63	143	31	10	80	0.1250000
NODE_67770_length_419_cov_491.015625	63	143	33	1	80	0.0125000
NODE_67770_length_419_cov_491.015625	63	143	35	9	80	0.1125000
NODE_67770_length_419_cov_491.015625	63	143	14	3	80	0.0375000
NODE_67770_length_419_cov_491.015625	63	143	15	2	80	0.0250000
NODE_67770_length_419_cov_491.015625	63	143	16	6	80	0.0750000
NODE_67770_length_419_cov_491.015625	63	143	18	1	80	0.0125000
NODE_67770_length_419_cov_491.015625	63	143	19	3	80	0.0375000
NODE_67770_length_419_cov_491.015625	63	143	20	14	80	0.1750000
NODE_67770_length_419_cov_491.015625	63	143	22	16	80	0.2000000
NODE_67770_length_419_cov_491.015625	63	143	23	5	80	0.0625000
NODE_67770_length_419_cov_491.015625	63	143	27	3	80	0.0375000
NODE_67770_length_419_cov_491.015625	63	143	29	7	80	0.0875000
NODE_67770_length_419_cov_491.015625	63	143	31	10	80	0.1250000
NODE_67770_length_419_cov_491.015625	63	143	33	1	80	0.0125000
NODE_67770_length_419_cov_491.015625	63	143	35	9	80	0.1125000
NODE_67770_length_419_cov_491.015625	63	143	14	3	80	0.0375000
NODE_67770_length_419_cov_491.015625	63	143	15	2	80	0.0250000
NODE_67770_length_419_cov_491.015625	63	143	16	6	80	0.0750000
NODE_67770_length_419_cov_491.015625	63	143	18	1	80	0.0125000
NODE_67770_length_419_cov_491.015625	63	143	19	3	80	0.0375000
NODE_67770_length_419_cov_491.015625	63	143	20	14	80	0.1750000
NODE_67770_length_419_cov_491.015625	63	143	22	16	80	0.2000000
NODE_67770_length_419_cov_491.015625	63	143	23	5	80	0.0625000
NODE_67770_length_419_cov_491.015625	63	143	27	3	80	0.0375000
NODE_67770_length_419_cov_491.015625	63	143	29	7	80	0.0875000
NODE_67770_length_419_cov_491.015625	63	143	31	10	80	0.1250000
NODE_67770_length_419_cov_491.015625	63	143	33	1	80	0.0125000
NODE_67770_length_419_cov_491.015625	63	143	35	9	80	0.1125000
NODE_67770_length_419_cov_491.015625	116	196	23	7	80	0.0875000
NODE_67770_length_419_cov_491.015625	116	196	24	2	80	0.0250000
NODE_67770_length_419_cov_491.015625	116	196	25	3	80	0.0375000
NODE_67770_length_419_cov_491.015625	116	196	26	5	80	0.0625000
NODE_67770_length_419_cov_491.015625	116	196	27	4	80	0.0500000
NODE_67770_length_419_cov_491.015625	116	196	29	7	80	0.0875000
NODE_67770_length_419_cov_491.015625	116	196	31	10	80	0.1250000
NODE_67770_length_419_cov_491.015625	116	196	33	30	80	0.3750000
NODE_67770_length_419_cov_491.015625	116	196	35	12	80	0.1500000
NODE_67770_length_419_cov_491.015625	116	196	23	7	80	0.0875000
NODE_67770_length_419_cov_491.015625	116	196	24	2	80	0.0250000
NODE_67770_length_419_cov_491.015625	116	196	25	3	80	0.0375000
NODE_67770_length_419_cov_491.015625	116	196	26	5	80	0.0625000
NODE_67770_length_419_cov_491.015625	116	196	27	4	80	0.0500000
NODE_67770_length_419_cov_491.015625	116	196	29	7	80	0.0875000
NODE_67770_length_419_cov_491.015625	116	196	31	10	80	0.1250000
NODE_67770_length_419_cov_491.015625	116	196	33	30	80	0.3750000
NODE_67770_length_419_cov_491.015625	116	196	35	12	80	0.1500000
NODE_67770_length_419_cov_491.015625	116	196	23	7	80	0.0875000
NODE_67770_length_419_cov_491.015625	116	196	24	2	80	0.0250000
NODE_67770_length_419_cov_491.015625	116	196	25	3	80	0.0375000
NODE_67770_length_419_cov_491.015625	116	196	26	5	80	0.0625000
NODE_67770_length_419_cov_491.015625	116	196	27	4	80	0.0500000
NODE_67770_length_419_cov_491.015625	116	196	29	7	80	0.0875000
NODE_67770_length_419_cov_491.015625	116	196	31	10	80	0.1250000
NODE_67770_length_419_cov_491.015625	116	196	33	30	80	0.3750000
NODE_67770_length_419_cov_491.015625	116	196	35	12	80	0.1500000
NODE_67770_length_419_cov_491.015625	116	196	23	7	80	0.0875000
NODE_67770_length_419_cov_491.015625	116	196	24	2	80	0.0250000
NODE_67770_length_419_cov_491.015625	116	196	25	3	80	0.0375000
NODE_67770_length_419_cov_491.015625	116	196	26	5	80	0.0625000
NODE_67770_length_419_cov_491.015625	116	196	27	4	80	0.0500000
NODE_67770_length_419_cov_491.015625	116	196	29	7	80	0.0875000
NODE_67770_length_419_cov_491.015625	116	196	31	10	80	0.1250000
NODE_67770_length_419_cov_491.015625	116	196	33	30	80	0.3750000
NODE_67770_length_419_cov_491.015625	116	196	35	12	80	0.1500000
NODE_67770_length_419_cov_491.015625	116	196	23	7	80	0.0875000
NODE_67770_length_419_cov_491.015625	116	196	24	2	80	0.0250000
NODE_67770_length_419_cov_491.015625	116	196	25	3	80	0.0375000
NODE_67770_length_419_cov_491.015625	116	196	26	5	80	0.0625000
NODE_67770_length_419_cov_491.015625	116	196	27	4	80	0.0500000
NODE_67770_length_419_cov_491.015625	116	196	29	7	80	0.0875000
NODE_67770_length_419_cov_491.015625	116	196	31	10	80	0.1250000
NODE_67770_length_419_cov_491.015625	116	196	33	30	80	0.3750000
NODE_67770_length_419_cov_491.015625	116	196	35	12	80	0.1500000
NODE_67772_length_419_cov_31.725000	12	92	0	80	80	1.0000000
NODE_67772_length_419_cov_31.725000	65	145	0	80	80	1.0000000
NODE_67789_length_419_cov_4.862500	47	103	0	56	56	1.0000000
NODE_67789_length_419_cov_4.862500	258	327	0	33	69	0.4782609
NODE_67789_length_419_cov_4.862500	258	327	2	36	69	0.5217391
NODE_67789_length_419_cov_4.862500	284	328	0	34	44	0.7727273
NODE_67789_length_419_cov_4.862500	284	328	2	10	44	0.2272727
NODE_67803_length_419_cov_4.193750	215	262	0	7	47	0.1489362
NODE_67803_length_419_cov_4.193750	215	262	2	40	47	0.8510638
NODE_67803_length_419_cov_4.193750	235	275	2	40	40	1.0000000
NODE_67817_length_419_cov_3.696875	165	215	0	50	50	1.0000000
NODE_67854_length_419_cov_2.628125	234	314	0	26	80	0.3250000
NODE_67854_length_419_cov_2.628125	234	314	2	17	80	0.2125000
NODE_67854_length_419_cov_2.628125	234	314	6	37	80	0.4625000
NODE_67856_length_419_cov_2.603125	154	196	0	42	42	1.0000000
NODE_67878_length_419_cov_2.350000	156	220	4	2	64	0.0312500
NODE_67878_length_419_cov_2.350000	156	220	5	11	64	0.1718750
NODE_67878_length_419_cov_2.350000	156	220	7	4	64	0.0625000
NODE_67878_length_419_cov_2.350000	156	220	9	8	64	0.1250000
NODE_67878_length_419_cov_2.350000	156	220	10	3	64	0.0468750
NODE_67878_length_419_cov_2.350000	156	220	12	2	64	0.0312500
NODE_67878_length_419_cov_2.350000	156	220	14	2	64	0.0312500
NODE_67878_length_419_cov_2.350000	156	220	15	1	64	0.0156250
NODE_67878_length_419_cov_2.350000	156	220	16	31	64	0.4843750
NODE_67961_length_419_cov_1.593750	339	358	0	19	19	1.0000000
NODE_68250_length_418_cov_63.059561	105	186	0	81	81	1.0000000
NODE_68250_length_418_cov_63.059561	159	239	0	80	80	1.0000000
NODE_68251_length_418_cov_49.796238	325	405	6	8	80	0.1000000
NODE_68251_length_418_cov_49.796238	325	405	7	2	80	0.0250000
NODE_68251_length_418_cov_49.796238	325	405	9	5	80	0.0625000
NODE_68251_length_418_cov_49.796238	325	405	11	5	80	0.0625000
NODE_68251_length_418_cov_49.796238	325	405	12	2	80	0.0250000
NODE_68251_length_418_cov_49.796238	325	405	14	14	80	0.1750000
NODE_68251_length_418_cov_49.796238	325	405	16	1	80	0.0125000
NODE_68251_length_418_cov_49.796238	325	405	20	6	80	0.0750000
NODE_68251_length_418_cov_49.796238	325	405	22	1	80	0.0125000
NODE_68251_length_418_cov_49.796238	325	405	24	5	80	0.0625000
NODE_68251_length_418_cov_49.796238	325	405	26	2	80	0.0250000
NODE_68251_length_418_cov_49.796238	325	405	31	2	80	0.0250000
NODE_68251_length_418_cov_49.796238	325	405	32	1	80	0.0125000
NODE_68251_length_418_cov_49.796238	325	405	33	5	80	0.0625000
NODE_68251_length_418_cov_49.796238	325	405	37	13	80	0.1625000
NODE_68251_length_418_cov_49.796238	325	405	39	2	80	0.0250000
NODE_68251_length_418_cov_49.796238	325	405	43	6	80	0.0750000
NODE_68251_length_418_cov_49.796238	378	415	0	3	37	0.0810811
NODE_68251_length_418_cov_49.796238	378	415	6	15	37	0.4054054
NODE_68251_length_418_cov_49.796238	378	415	7	2	37	0.0540541
NODE_68251_length_418_cov_49.796238	378	415	9	5	37	0.1351351
NODE_68251_length_418_cov_49.796238	378	415	11	5	37	0.1351351
NODE_68251_length_418_cov_49.796238	378	415	12	2	37	0.0540541
NODE_68251_length_418_cov_49.796238	378	415	14	5	37	0.1351351
NODE_68252_length_418_cov_42.764890	119	196	0	1	77	0.0129870
NODE_68252_length_418_cov_42.764890	119	196	3	1	77	0.0129870
NODE_68252_length_418_cov_42.764890	119	196	4	75	77	0.9740260
NODE_68252_length_418_cov_42.764890	172	250	0	30	78	0.3846154
NODE_68252_length_418_cov_42.764890	172	250	4	48	78	0.6153846
NODE_68253_length_418_cov_23.830721	73	153	2	80	80	1.0000000
NODE_68253_length_418_cov_23.830721	126	200	0	40	74	0.5405405
NODE_68253_length_418_cov_23.830721	126	200	2	34	74	0.4594595
NODE_68255_length_418_cov_7.216301	211	291	6	10	80	0.1250000
NODE_68255_length_418_cov_7.216301	211	291	8	43	80	0.5375000
NODE_68255_length_418_cov_7.216301	211	291	10	2	80	0.0250000
NODE_68255_length_418_cov_7.216301	211	291	12	10	80	0.1250000
NODE_68255_length_418_cov_7.216301	211	291	16	15	80	0.1875000
NODE_68265_length_418_cov_5.382445	134	215	0	34	81	0.4197531
NODE_68265_length_418_cov_5.382445	134	215	2	47	81	0.5802469
NODE_68265_length_418_cov_5.382445	187	268	0	9	81	0.1111111
NODE_68265_length_418_cov_5.382445	187	268	2	72	81	0.8888889
NODE_68275_length_418_cov_4.463950	191	272	10	81	81	1.0000000
NODE_68280_length_418_cov_4.216301	148	230	4	76	82	0.9268293
NODE_68280_length_418_cov_4.216301	148	230	6	6	82	0.0731707
NODE_68281_length_418_cov_4.065831	211	280	0	12	69	0.1739130
NODE_68281_length_418_cov_4.065831	211	280	2	57	69	0.8260869
NODE_68284_length_418_cov_3.909091	95	175	7	1	80	0.0125000
NODE_68284_length_418_cov_3.909091	95	175	9	14	80	0.1750000
NODE_68284_length_418_cov_3.909091	95	175	10	1	80	0.0125000
NODE_68284_length_418_cov_3.909091	95	175	12	1	80	0.0125000
NODE_68284_length_418_cov_3.909091	95	175	14	5	80	0.0625000
NODE_68284_length_418_cov_3.909091	95	175	16	3	80	0.0375000
NODE_68284_length_418_cov_3.909091	95	175	18	5	80	0.0625000
NODE_68284_length_418_cov_3.909091	95	175	20	1	80	0.0125000
NODE_68284_length_418_cov_3.909091	95	175	22	2	80	0.0250000
NODE_68284_length_418_cov_3.909091	95	175	24	1	80	0.0125000
NODE_68284_length_418_cov_3.909091	95	175	25	4	80	0.0500000
NODE_68284_length_418_cov_3.909091	95	175	27	2	80	0.0250000
NODE_68284_length_418_cov_3.909091	95	175	29	6	80	0.0750000
NODE_68284_length_418_cov_3.909091	95	175	33	4	80	0.0500000
NODE_68284_length_418_cov_3.909091	95	175	36	1	80	0.0125000
NODE_68284_length_418_cov_3.909091	95	175	38	7	80	0.0875000
NODE_68284_length_418_cov_3.909091	95	175	40	7	80	0.0875000
NODE_68284_length_418_cov_3.909091	95	175	44	15	80	0.1875000
NODE_68284_length_418_cov_3.909091	148	224	7	1	76	0.0131579
NODE_68284_length_418_cov_3.909091	148	224	9	17	76	0.2236842
NODE_68284_length_418_cov_3.909091	148	224	10	1	76	0.0131579
NODE_68284_length_418_cov_3.909091	148	224	11	9	76	0.1184211
NODE_68284_length_418_cov_3.909091	148	224	12	5	76	0.0657895
NODE_68284_length_418_cov_3.909091	148	224	13	8	76	0.1052632
NODE_68284_length_418_cov_3.909091	148	224	14	5	76	0.0657895
NODE_68284_length_418_cov_3.909091	148	224	15	23	76	0.3026316
NODE_68284_length_418_cov_3.909091	148	224	16	3	76	0.0394737
NODE_68284_length_418_cov_3.909091	148	224	17	2	76	0.0263158
NODE_68284_length_418_cov_3.909091	148	224	18	2	76	0.0263158
NODE_68288_length_418_cov_3.749216	181	247	0	66	66	1.0000000
NODE_68289_length_418_cov_3.711599	249	313	4	30	64	0.4687500
NODE_68289_length_418_cov_3.711599	249	313	6	26	64	0.4062500
NODE_68289_length_418_cov_3.711599	249	313	10	4	64	0.0625000
NODE_68289_length_418_cov_3.711599	249	313	14	4	64	0.0625000
NODE_68307_length_418_cov_3.012539	101	181	0	16	80	0.2000000
NODE_68307_length_418_cov_3.012539	101	181	2	9	80	0.1125000
NODE_68307_length_418_cov_3.012539	101	181	4	16	80	0.2000000
NODE_68307_length_418_cov_3.012539	101	181	6	2	80	0.0250000
NODE_68307_length_418_cov_3.012539	101	181	8	1	80	0.0125000
NODE_68307_length_418_cov_3.012539	101	181	10	1	80	0.0125000
NODE_68307_length_418_cov_3.012539	101	181	12	1	80	0.0125000
NODE_68307_length_418_cov_3.012539	101	181	15	1	80	0.0125000
NODE_68307_length_418_cov_3.012539	101	181	17	1	80	0.0125000
NODE_68307_length_418_cov_3.012539	101	181	18	1	80	0.0125000
NODE_68307_length_418_cov_3.012539	101	181	22	31	80	0.3875000
NODE_68354_length_418_cov_2.376176	95	115	0	20	20	1.0000000
NODE_68436_length_418_cov_1.623824	47	128	0	31	81	0.3827161
NODE_68436_length_418_cov_1.623824	47	128	2	50	81	0.6172839
NODE_68436_length_418_cov_1.623824	239	268	6	5	29	0.1724138
NODE_68436_length_418_cov_1.623824	239	268	8	6	29	0.2068966
NODE_68436_length_418_cov_1.623824	239	268	9	4	29	0.1379310
NODE_68436_length_418_cov_1.623824	239	268	11	3	29	0.1034483
NODE_68436_length_418_cov_1.623824	239	268	12	2	29	0.0689655
NODE_68436_length_418_cov_1.623824	239	268	13	9	29	0.3103448
NODE_68682_length_418_cov_0.626959	255	299	0	4	44	0.0909091
NODE_68682_length_418_cov_0.626959	255	299	2	40	44	0.9090909
NODE_68708_length_417_cov_45.267296	212	292	0	80	80	1.0000000
NODE_68708_length_417_cov_45.267296	265	345	0	80	80	1.0000000
NODE_68708_length_417_cov_45.267296	341	417	0	76	76	1.0000000
NODE_68709_length_417_cov_36.006289	159	239	0	80	80	1.0000000
NODE_68711_length_417_cov_12.886792	193	273	0	80	80	1.0000000
NODE_68711_length_417_cov_12.886792	246	326	0	80	80	1.0000000
NODE_68717_length_417_cov_7.056604	210	271	0	61	61	1.0000000
NODE_68717_length_417_cov_7.056604	263	315	0	52	52	1.0000000
NODE_68718_length_417_cov_6.669811	194	264	0	22	70	0.3142857
NODE_68718_length_417_cov_6.669811	194	264	2	42	70	0.6000000
NODE_68718_length_417_cov_6.669811	194	264	3	1	70	0.0142857
NODE_68718_length_417_cov_6.669811	194	264	4	5	70	0.0714286
NODE_68779_length_417_cov_2.795597	20	91	0	71	71	1.0000000
NODE_69163_length_416_cov_115.782334	174	259	6	32	85	0.3764706
NODE_69163_length_416_cov_115.782334	174	259	8	7	85	0.0823529
NODE_69163_length_416_cov_115.782334	174	259	10	9	85	0.1058824
NODE_69163_length_416_cov_115.782334	174	259	12	17	85	0.2000000
NODE_69163_length_416_cov_115.782334	174	259	14	3	85	0.0352941
NODE_69163_length_416_cov_115.782334	174	259	16	17	85	0.2000000
NODE_69164_length_416_cov_70.678233	180	244	9	1	64	0.0156250
NODE_69164_length_416_cov_70.678233	180	244	11	2	64	0.0312500
NODE_69164_length_416_cov_70.678233	180	244	13	7	64	0.1093750
NODE_69164_length_416_cov_70.678233	180	244	19	10	64	0.1562500
NODE_69164_length_416_cov_70.678233	180	244	21	7	64	0.1093750
NODE_69164_length_416_cov_70.678233	180	244	23	1	64	0.0156250
NODE_69164_length_416_cov_70.678233	180	244	27	1	64	0.0156250
NODE_69164_length_416_cov_70.678233	180	244	31	1	64	0.0156250
NODE_69164_length_416_cov_70.678233	180	244	33	2	64	0.0312500
NODE_69164_length_416_cov_70.678233	180	244	35	3	64	0.0468750
NODE_69164_length_416_cov_70.678233	180	244	41	2	64	0.0312500
NODE_69164_length_416_cov_70.678233	180	244	43	6	64	0.0937500
NODE_69164_length_416_cov_70.678233	180	244	45	1	64	0.0156250
NODE_69164_length_416_cov_70.678233	180	244	49	20	64	0.3125000
NODE_69166_length_416_cov_39.933754	288	368	0	21	80	0.2625000
NODE_69166_length_416_cov_39.933754	288	368	2	59	80	0.7375000
NODE_69166_length_416_cov_39.933754	341	416	0	33	75	0.4400000
NODE_69166_length_416_cov_39.933754	341	416	2	42	75	0.5600000
NODE_69167_length_416_cov_37.334385	158	238	0	80	80	1.0000000
NODE_69167_length_416_cov_37.334385	211	291	0	80	80	1.0000000
NODE_69167_length_416_cov_37.334385	287	367	0	80	80	1.0000000
NODE_69167_length_416_cov_37.334385	340	416	0	76	76	1.0000000
NODE_69179_length_416_cov_5.242902	89	169	0	80	80	1.0000000
NODE_69179_length_416_cov_5.242902	142	222	0	80	80	1.0000000
NODE_69184_length_416_cov_4.892744	79	145	0	51	66	0.7727273
NODE_69184_length_416_cov_4.892744	79	145	2	15	66	0.2272727
NODE_69184_length_416_cov_4.892744	194	272	2	54	78	0.6923077
NODE_69184_length_416_cov_4.892744	194	272	4	24	78	0.3076923
NODE_69184_length_416_cov_4.892744	247	272	2	25	25	1.0000000
NODE_69204_length_416_cov_3.886435	79	136	6	4	57	0.0701754
NODE_69204_length_416_cov_3.886435	79	136	8	53	57	0.9298246
NODE_69279_length_416_cov_2.230284	10	90	0	80	80	1.0000000
NODE_69399_length_416_cov_1.520505	198	244	2	20	46	0.4347826
NODE_69399_length_416_cov_1.520505	198	244	4	16	46	0.3478261
NODE_69399_length_416_cov_1.520505	198	244	6	10	46	0.2173913
NODE_69399_length_416_cov_1.520505	261	328	8	31	67	0.4626866
NODE_69399_length_416_cov_1.520505	261	328	11	1	67	0.0149254
NODE_69399_length_416_cov_1.520505	261	328	12	14	67	0.2089552
NODE_69399_length_416_cov_1.520505	261	328	16	11	67	0.1641791
NODE_69399_length_416_cov_1.520505	261	328	18	10	67	0.1492537
NODE_69673_length_415_cov_35.924051	260	339	2	79	79	1.0000000
NODE_69673_length_415_cov_35.924051	316	392	0	16	76	0.2105263
NODE_69673_length_415_cov_35.924051	316	392	2	60	76	0.7894737
NODE_69679_length_415_cov_6.376582	117	197	0	80	80	1.0000000
NODE_69679_length_415_cov_6.376582	254	334	0	80	80	1.0000000
NODE_69774_length_415_cov_2.224684	144	224	6	10	80	0.1250000
NODE_69774_length_415_cov_2.224684	144	224	8	1	80	0.0125000
NODE_69774_length_415_cov_2.224684	144	224	10	2	80	0.0250000
NODE_69774_length_415_cov_2.224684	144	224	12	13	80	0.1625000
NODE_69774_length_415_cov_2.224684	144	224	14	54	80	0.6750000
NODE_69795_length_415_cov_2.069620	207	273	0	24	66	0.3636364
NODE_69795_length_415_cov_2.069620	207	273	2	42	66	0.6363636
NODE_69817_length_415_cov_1.832278	225	283	0	19	58	0.3275862
NODE_69817_length_415_cov_1.832278	225	283	4	16	58	0.2758621
NODE_69817_length_415_cov_1.832278	225	283	6	10	58	0.1724138
NODE_69817_length_415_cov_1.832278	225	283	10	13	58	0.2241379
NODE_69845_length_415_cov_1.610759	90	170	10	2	80	0.0250000
NODE_69845_length_415_cov_1.610759	90	170	14	3	80	0.0375000
NODE_69845_length_415_cov_1.610759	90	170	16	2	80	0.0250000
NODE_69845_length_415_cov_1.610759	90	170	18	3	80	0.0375000
NODE_69845_length_415_cov_1.610759	90	170	22	4	80	0.0500000
NODE_69845_length_415_cov_1.610759	90	170	24	4	80	0.0500000
NODE_69845_length_415_cov_1.610759	90	170	30	2	80	0.0250000
NODE_69845_length_415_cov_1.610759	90	170	32	1	80	0.0125000
NODE_69845_length_415_cov_1.610759	90	170	42	1	80	0.0125000
NODE_69845_length_415_cov_1.610759	90	170	46	2	80	0.0250000
NODE_69845_length_415_cov_1.610759	90	170	52	1	80	0.0125000
NODE_69845_length_415_cov_1.610759	90	170	54	9	80	0.1125000
NODE_69845_length_415_cov_1.610759	90	170	56	3	80	0.0375000
NODE_69845_length_415_cov_1.610759	90	170	58	3	80	0.0375000
NODE_69845_length_415_cov_1.610759	90	170	62	13	80	0.1625000
NODE_69845_length_415_cov_1.610759	90	170	63	1	80	0.0125000
NODE_69845_length_415_cov_1.610759	90	170	64	3	80	0.0375000
NODE_69845_length_415_cov_1.610759	90	170	68	6	80	0.0750000
NODE_69845_length_415_cov_1.610759	90	170	70	3	80	0.0375000
NODE_69845_length_415_cov_1.610759	90	170	71	1	80	0.0125000
NODE_69845_length_415_cov_1.610759	90	170	72	9	80	0.1125000
NODE_69845_length_415_cov_1.610759	90	170	74	4	80	0.0500000
NODE_69845_length_415_cov_1.610759	335	376	0	41	41	1.0000000
NODE_70175_length_414_cov_46.263492	0	49	0	49	49	1.0000000
NODE_70175_length_414_cov_46.263492	22	102	0	50	80	0.6250000
NODE_70175_length_414_cov_46.263492	22	102	2	30	80	0.3750000
NODE_70183_length_414_cov_7.460317	167	247	0	42	80	0.5250000
NODE_70183_length_414_cov_7.460317	167	247	4	38	80	0.4750000
NODE_70183_length_414_cov_7.460317	220	300	4	80	80	1.0000000
NODE_70192_length_414_cov_5.676190	54	134	0	80	80	1.0000000
NODE_70192_length_414_cov_5.676190	107	187	0	80	80	1.0000000
NODE_70222_length_414_cov_4.130159	257	303	4	46	46	1.0000000
NODE_70222_length_414_cov_4.130159	276	356	0	18	80	0.2250000
NODE_70222_length_414_cov_4.130159	276	356	2	4	80	0.0500000
NODE_70222_length_414_cov_4.130159	276	356	4	58	80	0.7250000
NODE_70254_length_414_cov_2.996825	75	135	3	30	60	0.5000000
NODE_70254_length_414_cov_2.996825	75	135	5	15	60	0.2500000
NODE_70254_length_414_cov_2.996825	75	135	6	15	60	0.2500000
NODE_70271_length_414_cov_2.631746	68	145	0	32	77	0.4155844
NODE_70271_length_414_cov_2.631746	68	145	2	45	77	0.5844156
NODE_70284_length_414_cov_2.473016	164	197	0	33	33	1.0000000
NODE_70284_length_414_cov_2.473016	170	255	0	85	85	1.0000000
NODE_70305_length_414_cov_2.222222	185	260	2	16	75	0.2133333
NODE_70305_length_414_cov_2.222222	185	260	4	11	75	0.1466667
NODE_70305_length_414_cov_2.222222	185	260	6	4	75	0.0533333
NODE_70305_length_414_cov_2.222222	185	260	8	30	75	0.4000000
NODE_70305_length_414_cov_2.222222	185	260	12	14	75	0.1866667
NODE_70305_length_414_cov_2.222222	233	304	8	19	71	0.2676056
NODE_70305_length_414_cov_2.222222	233	304	10	4	71	0.0563380
NODE_70305_length_414_cov_2.222222	233	304	12	48	71	0.6760563
NODE_70307_length_414_cov_2.206349	88	163	0	8	75	0.1066667
NODE_70307_length_414_cov_2.206349	88	163	2	5	75	0.0666667
NODE_70307_length_414_cov_2.206349	88	163	4	62	75	0.8266667
NODE_70326_length_414_cov_2.047619	298	349	0	16	51	0.3137255
NODE_70326_length_414_cov_2.047619	298	349	2	35	51	0.6862745
NODE_70486_length_414_cov_1.177778	106	190	0	45	84	0.5357143
NODE_70486_length_414_cov_1.177778	106	190	2	39	84	0.4642857
NODE_70494_length_414_cov_1.155556	0	23	0	23	23	1.0000000
NODE_70690_length_413_cov_41.471338	35	115	0	80	80	1.0000000
NODE_70690_length_413_cov_41.471338	35	115	0	80	80	1.0000000
NODE_70690_length_413_cov_41.471338	88	168	0	80	80	1.0000000
NODE_70690_length_413_cov_41.471338	88	168	0	80	80	1.0000000
NODE_70691_length_413_cov_16.687898	222	302	0	31	80	0.3875000
NODE_70691_length_413_cov_16.687898	222	302	4	1	80	0.0125000
NODE_70691_length_413_cov_16.687898	222	302	6	48	80	0.6000000
NODE_70691_length_413_cov_16.687898	275	355	0	17	80	0.2125000
NODE_70691_length_413_cov_16.687898	275	355	4	23	80	0.2875000
NODE_70691_length_413_cov_16.687898	275	355	6	40	80	0.5000000
NODE_70699_length_413_cov_7.057325	170	250	0	80	80	1.0000000
NODE_70699_length_413_cov_7.057325	223	300	0	77	77	1.0000000
NODE_70703_length_413_cov_5.665605	125	182	2	2	57	0.0350877
NODE_70703_length_413_cov_5.665605	125	182	4	14	57	0.2456140
NODE_70703_length_413_cov_5.665605	125	182	6	41	57	0.7192982
NODE_70712_length_413_cov_4.754777	140	184	0	44	44	1.0000000
NODE_70743_length_413_cov_3.506369	113	193	6	80	80	1.0000000
NODE_70749_length_413_cov_3.235669	251	331	0	80	80	1.0000000
NODE_70749_length_413_cov_3.235669	304	356	0	52	52	1.0000000
NODE_70792_length_413_cov_2.484076	209	257	0	48	48	1.0000000
NODE_70835_length_413_cov_1.949045	224	296	0	72	72	1.0000000
NODE_71196_length_412_cov_9.996805	172	244	0	72	72	1.0000000
NODE_71218_length_412_cov_4.686901	112	167	0	55	55	1.0000000
NODE_71253_length_412_cov_3.204473	44	124	0	3	80	0.0375000
NODE_71253_length_412_cov_3.204473	44	124	2	77	80	0.9625000
NODE_71276_length_412_cov_2.824281	225	305	0	80	80	1.0000000
NODE_71371_length_412_cov_1.782748	262	342	0	22	80	0.2750000
NODE_71371_length_412_cov_1.782748	262	342	2	58	80	0.7250000
NODE_71398_length_412_cov_1.603834	143	182	6	5	39	0.1282051
NODE_71398_length_412_cov_1.603834	143	182	8	1	39	0.0256410
NODE_71398_length_412_cov_1.603834	143	182	10	2	39	0.0512821
NODE_71398_length_412_cov_1.603834	143	182	16	1	39	0.0256410
NODE_71398_length_412_cov_1.603834	143	182	18	1	39	0.0256410
NODE_71398_length_412_cov_1.603834	143	182	19	3	39	0.0769231
NODE_71398_length_412_cov_1.603834	143	182	21	1	39	0.0256410
NODE_71398_length_412_cov_1.603834	143	182	23	6	39	0.1538462
NODE_71398_length_412_cov_1.603834	143	182	26	4	39	0.1025641
NODE_71398_length_412_cov_1.603834	143	182	28	1	39	0.0256410
NODE_71398_length_412_cov_1.603834	143	182	30	2	39	0.0512821
NODE_71398_length_412_cov_1.603834	143	182	32	1	39	0.0256410
NODE_71398_length_412_cov_1.603834	143	182	34	3	39	0.0769231
NODE_71398_length_412_cov_1.603834	143	182	38	4	39	0.1025641
NODE_71398_length_412_cov_1.603834	143	182	40	4	39	0.1025641
NODE_71665_length_411_cov_44.701923	4	72	0	68	68	1.0000000
NODE_71665_length_411_cov_44.701923	35	116	0	81	81	1.0000000
NODE_71665_length_411_cov_44.701923	161	242	0	81	81	1.0000000
NODE_71665_length_411_cov_44.701923	293	374	0	81	81	1.0000000
NODE_71665_length_411_cov_44.701923	337	411	0	74	74	1.0000000
NODE_71666_length_411_cov_43.144231	102	183	0	76	81	0.9382716
NODE_71666_length_411_cov_43.144231	102	183	2	5	81	0.0617284
NODE_71666_length_411_cov_43.144231	156	236	0	80	80	1.0000000
NODE_71666_length_411_cov_43.144231	232	312	0	23	80	0.2875000
NODE_71666_length_411_cov_43.144231	232	312	2	36	80	0.4500000
NODE_71666_length_411_cov_43.144231	232	312	4	21	80	0.2625000
NODE_71666_length_411_cov_43.144231	285	365	2	17	80	0.2125000
NODE_71666_length_411_cov_43.144231	285	365	4	63	80	0.7875000
NODE_71672_length_411_cov_8.471154	133	213	0	80	80	1.0000000
NODE_71672_length_411_cov_8.471154	186	266	0	80	80	1.0000000
NODE_71673_length_411_cov_8.407051	133	220	0	87	87	1.0000000
NODE_71675_length_411_cov_6.455128	249	316	0	51	67	0.7611941
NODE_71675_length_411_cov_6.455128	249	316	1	2	67	0.0298507
NODE_71675_length_411_cov_6.455128	249	316	2	14	67	0.2089552
NODE_71675_length_411_cov_6.455128	292	344	0	10	52	0.1923077
NODE_71675_length_411_cov_6.455128	292	344	2	18	52	0.3461539
NODE_71675_length_411_cov_6.455128	292	344	4	24	52	0.4615385
NODE_71687_length_411_cov_4.782051	98	178	6	35	80	0.4375000
NODE_71687_length_411_cov_4.782051	98	178	8	45	80	0.5625000
NODE_71687_length_411_cov_4.782051	151	228	2	46	77	0.5974026
NODE_71687_length_411_cov_4.782051	151	228	4	1	77	0.0129870
NODE_71687_length_411_cov_4.782051	151	228	6	2	77	0.0259740
NODE_71687_length_411_cov_4.782051	151	228	8	28	77	0.3636364
NODE_71705_length_411_cov_3.698718	282	347	0	37	65	0.5692308
NODE_71705_length_411_cov_3.698718	282	347	2	28	65	0.4307692
NODE_71713_length_411_cov_3.378205	88	148	0	8	60	0.1333333
NODE_71713_length_411_cov_3.378205	88	148	4	52	60	0.8666667
NODE_71714_length_411_cov_3.371795	145	225	0	80	80	1.0000000
NODE_71714_length_411_cov_3.371795	198	274	0	44	76	0.5789474
NODE_71714_length_411_cov_3.371795	198	274	2	32	76	0.4210526
NODE_72163_length_410_cov_49.331190	320	400	2	10	80	0.1250000
NODE_72163_length_410_cov_49.331190	320	400	4	14	80	0.1750000
NODE_72163_length_410_cov_49.331190	320	400	6	56	80	0.7000000
NODE_72163_length_410_cov_49.331190	320	400	2	10	80	0.1250000
NODE_72163_length_410_cov_49.331190	320	400	4	14	80	0.1750000
NODE_72163_length_410_cov_49.331190	320	400	6	56	80	0.7000000
NODE_72163_length_410_cov_49.331190	320	400	2	10	80	0.1250000
NODE_72163_length_410_cov_49.331190	320	400	4	14	80	0.1750000
NODE_72163_length_410_cov_49.331190	320	400	6	56	80	0.7000000
NODE_72163_length_410_cov_49.331190	320	400	2	10	80	0.1250000
NODE_72163_length_410_cov_49.331190	320	400	4	14	80	0.1750000
NODE_72163_length_410_cov_49.331190	320	400	6	56	80	0.7000000
NODE_72163_length_410_cov_49.331190	320	400	2	10	80	0.1250000
NODE_72163_length_410_cov_49.331190	320	400	4	14	80	0.1750000
NODE_72163_length_410_cov_49.331190	320	400	6	56	80	0.7000000
NODE_72163_length_410_cov_49.331190	329	400	2	10	71	0.1408451
NODE_72163_length_410_cov_49.331190	329	400	4	14	71	0.1971831
NODE_72163_length_410_cov_49.331190	329	400	6	47	71	0.6619718
NODE_72169_length_410_cov_6.797428	179	259	0	80	80	1.0000000
NODE_72169_length_410_cov_6.797428	232	312	0	61	80	0.7625000
NODE_72169_length_410_cov_6.797428	232	312	1	19	80	0.2375000
NODE_72184_length_410_cov_5.102894	153	222	2	3	69	0.0434783
NODE_72184_length_410_cov_5.102894	153	222	4	33	69	0.4782609
NODE_72184_length_410_cov_5.102894	153	222	5	4	69	0.0579710
NODE_72184_length_410_cov_5.102894	153	222	6	29	69	0.4202898
NODE_72186_length_410_cov_4.884244	101	179	0	51	78	0.6538461
NODE_72186_length_410_cov_4.884244	101	179	2	4	78	0.0512821
NODE_72186_length_410_cov_4.884244	101	179	6	23	78	0.2948718
NODE_72187_length_410_cov_4.787781	287	344	0	57	57	1.0000000
NODE_72187_length_410_cov_4.787781	340	397	0	57	57	1.0000000
NODE_72194_length_410_cov_4.591640	245	303	10	6	58	0.1034483
NODE_72194_length_410_cov_4.591640	245	303	11	1	58	0.0172414
NODE_72194_length_410_cov_4.591640	245	303	14	7	58	0.1206897
NODE_72194_length_410_cov_4.591640	245	303	16	2	58	0.0344828
NODE_72194_length_410_cov_4.591640	245	303	18	3	58	0.0517241
NODE_72194_length_410_cov_4.591640	245	303	19	1	58	0.0172414
NODE_72194_length_410_cov_4.591640	245	303	20	3	58	0.0517241
NODE_72194_length_410_cov_4.591640	245	303	24	1	58	0.0172414
NODE_72194_length_410_cov_4.591640	245	303	26	1	58	0.0172414
NODE_72194_length_410_cov_4.591640	245	303	28	5	58	0.0862069
NODE_72194_length_410_cov_4.591640	245	303	30	2	58	0.0344828
NODE_72194_length_410_cov_4.591640	245	303	32	5	58	0.0862069
NODE_72194_length_410_cov_4.591640	245	303	34	6	58	0.1034483
NODE_72194_length_410_cov_4.591640	245	303	38	10	58	0.1724138
NODE_72194_length_410_cov_4.591640	245	303	40	5	58	0.0862069
NODE_72194_length_410_cov_4.591640	298	356	30	9	58	0.1551724
NODE_72194_length_410_cov_4.591640	298	356	32	5	58	0.0862069
NODE_72194_length_410_cov_4.591640	298	356	34	6	58	0.1034483
NODE_72194_length_410_cov_4.591640	298	356	36	2	58	0.0344828
NODE_72194_length_410_cov_4.591640	298	356	38	1	58	0.0172414
NODE_72194_length_410_cov_4.591640	298	356	40	6	58	0.1034483
NODE_72194_length_410_cov_4.591640	298	356	42	29	58	0.5000000
NODE_72230_length_410_cov_3.215434	32	112	0	34	80	0.4250000
NODE_72230_length_410_cov_3.215434	32	112	2	46	80	0.5750000
NODE_72230_length_410_cov_3.215434	85	165	0	2	80	0.0250000
NODE_72230_length_410_cov_3.215434	85	165	2	78	80	0.9750000
NODE_72327_length_410_cov_1.913183	227	285	0	3	58	0.0517241
NODE_72327_length_410_cov_1.913183	227	285	2	9	58	0.1551724
NODE_72327_length_410_cov_1.913183	227	285	3	16	58	0.2758621
NODE_72327_length_410_cov_1.913183	227	285	4	30	58	0.5172414
NODE_72526_length_410_cov_1.038585	272	316	2	19	44	0.4318182
NODE_72526_length_410_cov_1.038585	272	316	8	13	44	0.2954545
NODE_72526_length_410_cov_1.038585	272	316	10	5	44	0.1136364
NODE_72526_length_410_cov_1.038585	272	316	12	7	44	0.1590909
NODE_72688_length_409_cov_11.506452	56	136	0	80	80	1.0000000
NODE_72688_length_409_cov_11.506452	109	189	0	29	80	0.3625000
NODE_72688_length_409_cov_11.506452	109	189	2	51	80	0.6375000
NODE_72689_length_409_cov_10.329032	131	186	0	55	55	1.0000000
NODE_72690_length_409_cov_9.625806	62	142	0	58	80	0.7250000
NODE_72690_length_409_cov_9.625806	62	142	2	22	80	0.2750000
NODE_72690_length_409_cov_9.625806	115	195	0	5	80	0.0625000
NODE_72690_length_409_cov_9.625806	115	195	2	75	80	0.9375000
NODE_72697_length_409_cov_6.867742	41	71	0	30	30	1.0000000
NODE_72730_length_409_cov_3.822581	103	158	0	3	55	0.0545455
NODE_72730_length_409_cov_3.822581	103	158	2	52	55	0.9454545
NODE_72730_length_409_cov_3.822581	151	232	0	25	81	0.3086420
NODE_72730_length_409_cov_3.822581	151	232	2	56	81	0.6913580
NODE_72754_length_409_cov_2.987097	240	287	0	47	47	1.0000000
NODE_72951_length_409_cov_1.319355	49	131	0	12	82	0.1463415
NODE_72951_length_409_cov_1.319355	49	131	2	1	82	0.0121951
NODE_72951_length_409_cov_1.319355	49	131	6	9	82	0.1097561
NODE_72951_length_409_cov_1.319355	49	131	8	60	82	0.7317073
NODE_72951_length_409_cov_1.319355	104	161	4	10	57	0.1754386
NODE_72951_length_409_cov_1.319355	104	161	7	1	57	0.0175439
NODE_72951_length_409_cov_1.319355	104	161	8	46	57	0.8070176
NODE_73196_length_408_cov_8.585761	57	137	0	43	80	0.5375000
NODE_73196_length_408_cov_8.585761	57	137	3	1	80	0.0125000
NODE_73196_length_408_cov_8.585761	57	137	4	16	80	0.2000000
NODE_73196_length_408_cov_8.585761	57	137	6	18	80	0.2250000
NODE_73196_length_408_cov_8.585761	57	137	8	2	80	0.0250000
NODE_73196_length_408_cov_8.585761	110	190	4	21	80	0.2625000
NODE_73196_length_408_cov_8.585761	110	190	6	18	80	0.2250000
NODE_73196_length_408_cov_8.585761	110	190	8	41	80	0.5125000
NODE_73198_length_408_cov_6.948220	71	151	4	8	80	0.1000000
NODE_73198_length_408_cov_6.948220	71	151	6	1	80	0.0125000
NODE_73198_length_408_cov_6.948220	71	151	8	6	80	0.0750000
NODE_73198_length_408_cov_6.948220	71	151	12	14	80	0.1750000
NODE_73198_length_408_cov_6.948220	71	151	14	22	80	0.2750000
NODE_73198_length_408_cov_6.948220	71	151	20	12	80	0.1500000
NODE_73198_length_408_cov_6.948220	71	151	22	17	80	0.2125000
NODE_73198_length_408_cov_6.948220	124	204	6	3	80	0.0375000
NODE_73198_length_408_cov_6.948220	124	204	8	20	80	0.2500000
NODE_73198_length_408_cov_6.948220	124	204	14	18	80	0.2250000
NODE_73198_length_408_cov_6.948220	124	204	16	2	80	0.0250000
NODE_73198_length_408_cov_6.948220	124	204	20	13	80	0.1625000
NODE_73198_length_408_cov_6.948220	124	204	22	24	80	0.3000000
NODE_73219_length_408_cov_3.957929	83	132	2	49	49	1.0000000
NODE_73226_length_408_cov_3.511327	40	97	0	57	57	1.0000000
NODE_73226_length_408_cov_3.511327	357	398	0	41	41	1.0000000
NODE_73262_length_408_cov_2.724919	128	180	4	15	52	0.2884615
NODE_73262_length_408_cov_2.724919	128	180	6	37	52	0.7115384
NODE_73269_length_408_cov_2.563107	164	241	0	49	77	0.6363636
NODE_73269_length_408_cov_2.563107	164	241	2	11	77	0.1428571
NODE_73269_length_408_cov_2.563107	164	241	4	10	77	0.1298701
NODE_73269_length_408_cov_2.563107	164	241	8	1	77	0.0129870
NODE_73269_length_408_cov_2.563107	164	241	10	2	77	0.0259740
NODE_73269_length_408_cov_2.563107	164	241	18	4	77	0.0519481
NODE_73271_length_408_cov_2.456311	314	379	2	65	65	1.0000000
NODE_73271_length_408_cov_2.456311	352	408	0	13	56	0.2321429
NODE_73271_length_408_cov_2.456311	352	408	2	43	56	0.7678571
NODE_73690_length_407_cov_6.191558	144	208	0	64	64	1.0000000
NODE_73698_length_407_cov_4.961039	212	291	0	36	79	0.4556962
NODE_73698_length_407_cov_4.961039	212	291	1	2	79	0.0253165
NODE_73698_length_407_cov_4.961039	212	291	2	41	79	0.5189874
NODE_73719_length_407_cov_3.681818	314	375	0	61	61	1.0000000
NODE_73732_length_407_cov_3.344156	199	247	0	11	48	0.2291667
NODE_73732_length_407_cov_3.344156	199	247	1	37	48	0.7708333
NODE_73736_length_407_cov_3.250000	142	223	4	2	81	0.0246914
NODE_73736_length_407_cov_3.250000	142	223	6	1	81	0.0123457
NODE_73736_length_407_cov_3.250000	142	223	11	3	81	0.0370370
NODE_73736_length_407_cov_3.250000	142	223	13	8	81	0.0987654
NODE_73736_length_407_cov_3.250000	142	223	15	16	81	0.1975309
NODE_73736_length_407_cov_3.250000	142	223	17	51	81	0.6296296
NODE_73762_length_407_cov_2.594156	194	257	0	49	63	0.7777778
NODE_73762_length_407_cov_2.594156	194	257	2	14	63	0.2222222
NODE_73769_length_407_cov_2.538961	34	114	0	14	80	0.1750000
NODE_73769_length_407_cov_2.538961	34	114	2	66	80	0.8250000
NODE_73853_length_407_cov_1.737013	208	264	0	25	56	0.4464286
NODE_73853_length_407_cov_1.737013	208	264	2	31	56	0.5535714
NODE_74200_length_406_cov_176.856678	200	271	142	4	71	0.0563380
NODE_74200_length_406_cov_176.856678	200	271	144	2	71	0.0281690
NODE_74200_length_406_cov_176.856678	200	271	145	1	71	0.0140845
NODE_74200_length_406_cov_176.856678	200	271	146	1	71	0.0140845
NODE_74200_length_406_cov_176.856678	200	271	148	1	71	0.0140845
NODE_74200_length_406_cov_176.856678	200	271	150	1	71	0.0140845
NODE_74200_length_406_cov_176.856678	200	271	154	2	71	0.0281690
NODE_74200_length_406_cov_176.856678	200	271	156	1	71	0.0140845
NODE_74200_length_406_cov_176.856678	200	271	158	1	71	0.0140845
NODE_74200_length_406_cov_176.856678	200	271	160	1	71	0.0140845
NODE_74200_length_406_cov_176.856678	200	271	162	1	71	0.0140845
NODE_74200_length_406_cov_176.856678	200	271	163	3	71	0.0422535
NODE_74200_length_406_cov_176.856678	200	271	164	1	71	0.0140845
NODE_74200_length_406_cov_176.856678	200	271	165	3	71	0.0422535
NODE_74200_length_406_cov_176.856678	200	271	167	3	71	0.0422535
NODE_74200_length_406_cov_176.856678	200	271	168	4	71	0.0563380
NODE_74200_length_406_cov_176.856678	200	271	169	1	71	0.0140845
NODE_74200_length_406_cov_176.856678	200	271	170	4	71	0.0563380
NODE_74200_length_406_cov_176.856678	200	271	171	2	71	0.0281690
NODE_74200_length_406_cov_176.856678	200	271	172	1	71	0.0140845
NODE_74200_length_406_cov_176.856678	200	271	173	3	71	0.0422535
NODE_74200_length_406_cov_176.856678	200	271	175	1	71	0.0140845
NODE_74200_length_406_cov_176.856678	200	271	178	3	71	0.0422535
NODE_74200_length_406_cov_176.856678	200	271	179	6	71	0.0845070
NODE_74200_length_406_cov_176.856678	200	271	181	2	71	0.0281690
NODE_74200_length_406_cov_176.856678	200	271	182	2	71	0.0281690
NODE_74200_length_406_cov_176.856678	200	271	183	2	71	0.0281690
NODE_74200_length_406_cov_176.856678	200	271	185	1	71	0.0140845
NODE_74200_length_406_cov_176.856678	200	271	186	1	71	0.0140845
NODE_74200_length_406_cov_176.856678	200	271	187	2	71	0.0281690
NODE_74200_length_406_cov_176.856678	200	271	188	1	71	0.0140845
NODE_74200_length_406_cov_176.856678	200	271	189	2	71	0.0281690
NODE_74200_length_406_cov_176.856678	200	271	190	1	71	0.0140845
NODE_74200_length_406_cov_176.856678	200	271	191	3	71	0.0422535
NODE_74200_length_406_cov_176.856678	200	271	192	2	71	0.0281690
NODE_74200_length_406_cov_176.856678	200	271	193	1	71	0.0140845
NODE_74200_length_406_cov_176.856678	244	321	98	2	77	0.0259740
NODE_74200_length_406_cov_176.856678	244	321	99	2	77	0.0259740
NODE_74200_length_406_cov_176.856678	244	321	102	8	77	0.1038961
NODE_74200_length_406_cov_176.856678	244	321	109	1	77	0.0129870
NODE_74200_length_406_cov_176.856678	244	321	110	2	77	0.0259740
NODE_74200_length_406_cov_176.856678	244	321	112	2	77	0.0259740
NODE_74200_length_406_cov_176.856678	244	321	113	3	77	0.0389610
NODE_74200_length_406_cov_176.856678	244	321	114	2	77	0.0259740
NODE_74200_length_406_cov_176.856678	244	321	115	3	77	0.0389610
NODE_74200_length_406_cov_176.856678	244	321	117	1	77	0.0129870
NODE_74200_length_406_cov_176.856678	244	321	119	3	77	0.0389610
NODE_74200_length_406_cov_176.856678	244	321	120	1	77	0.0129870
NODE_74200_length_406_cov_176.856678	244	321	121	2	77	0.0259740
NODE_74200_length_406_cov_176.856678	244	321	122	2	77	0.0259740
NODE_74200_length_406_cov_176.856678	244	321	124	1	77	0.0129870
NODE_74200_length_406_cov_176.856678	244	321	125	1	77	0.0129870
NODE_74200_length_406_cov_176.856678	244	321	126	3	77	0.0389610
NODE_74200_length_406_cov_176.856678	244	321	128	2	77	0.0259740
NODE_74200_length_406_cov_176.856678	244	321	130	2	77	0.0259740
NODE_74200_length_406_cov_176.856678	244	321	134	1	77	0.0129870
NODE_74200_length_406_cov_176.856678	244	321	138	6	77	0.0779221
NODE_74200_length_406_cov_176.856678	244	321	142	4	77	0.0519481
NODE_74200_length_406_cov_176.856678	244	321	144	2	77	0.0259740
NODE_74200_length_406_cov_176.856678	244	321	145	1	77	0.0129870
NODE_74200_length_406_cov_176.856678	244	321	146	1	77	0.0129870
NODE_74200_length_406_cov_176.856678	244	321	148	1	77	0.0129870
NODE_74200_length_406_cov_176.856678	244	321	150	1	77	0.0129870
NODE_74200_length_406_cov_176.856678	244	321	154	2	77	0.0259740
NODE_74200_length_406_cov_176.856678	244	321	156	1	77	0.0129870
NODE_74200_length_406_cov_176.856678	244	321	164	1	77	0.0129870
NODE_74200_length_406_cov_176.856678	244	321	172	1	77	0.0129870
NODE_74200_length_406_cov_176.856678	244	321	181	1	77	0.0129870
NODE_74200_length_406_cov_176.856678	244	321	187	2	77	0.0259740
NODE_74200_length_406_cov_176.856678	244	321	189	2	77	0.0259740
NODE_74200_length_406_cov_176.856678	244	321	190	1	77	0.0129870
NODE_74200_length_406_cov_176.856678	244	321	191	3	77	0.0389610
NODE_74200_length_406_cov_176.856678	244	321	192	2	77	0.0259740
NODE_74200_length_406_cov_176.856678	244	321	193	1	77	0.0129870
NODE_74203_length_406_cov_37.723127	15	95	0	16	80	0.2000000
NODE_74203_length_406_cov_37.723127	15	95	2	26	80	0.3250000
NODE_74203_length_406_cov_37.723127	15	95	4	34	80	0.4250000
NODE_74203_length_406_cov_37.723127	15	95	6	1	80	0.0125000
NODE_74203_length_406_cov_37.723127	15	95	16	1	80	0.0125000
NODE_74203_length_406_cov_37.723127	15	95	22	1	80	0.0125000
NODE_74203_length_406_cov_37.723127	15	95	40	1	80	0.0125000
NODE_74219_length_406_cov_4.960912	268	327	0	59	59	1.0000000
NODE_74253_length_406_cov_3.087948	261	302	0	41	41	1.0000000
NODE_74284_length_406_cov_2.475570	220	270	2	28	50	0.5600000
NODE_74284_length_406_cov_2.475570	220	270	4	22	50	0.4400000
NODE_74332_length_406_cov_1.986971	238	276	0	38	38	1.0000000
NODE_74368_length_406_cov_1.778502	159	195	0	1	36	0.0277778
NODE_74368_length_406_cov_1.778502	159	195	3	1	36	0.0277778
NODE_74368_length_406_cov_1.778502	159	195	4	34	36	0.9444444
NODE_74368_length_406_cov_1.778502	234	294	10	2	60	0.0333333
NODE_74368_length_406_cov_1.778502	234	294	12	4	60	0.0666667
NODE_74368_length_406_cov_1.778502	234	294	14	1	60	0.0166667
NODE_74368_length_406_cov_1.778502	234	294	18	12	60	0.2000000
NODE_74368_length_406_cov_1.778502	234	294	20	11	60	0.1833333
NODE_74368_length_406_cov_1.778502	234	294	24	30	60	0.5000000
NODE_74368_length_406_cov_1.778502	267	347	0	10	80	0.1250000
NODE_74368_length_406_cov_1.778502	267	347	2	2	80	0.0250000
NODE_74368_length_406_cov_1.778502	267	347	4	16	80	0.2000000
NODE_74368_length_406_cov_1.778502	267	347	6	1	80	0.0125000
NODE_74368_length_406_cov_1.778502	267	347	8	3	80	0.0375000
NODE_74368_length_406_cov_1.778502	267	347	10	2	80	0.0250000
NODE_74368_length_406_cov_1.778502	267	347	12	2	80	0.0250000
NODE_74368_length_406_cov_1.778502	267	347	14	2	80	0.0250000
NODE_74368_length_406_cov_1.778502	267	347	16	2	80	0.0250000
NODE_74368_length_406_cov_1.778502	267	347	18	15	80	0.1875000
NODE_74368_length_406_cov_1.778502	267	347	24	25	80	0.3125000
NODE_74427_length_406_cov_1.495114	173	212	0	3	39	0.0769231
NODE_74427_length_406_cov_1.495114	173	212	2	9	39	0.2307692
NODE_74427_length_406_cov_1.495114	173	212	4	13	39	0.3333333
NODE_74427_length_406_cov_1.495114	173	212	6	14	39	0.3589744
NODE_74476_length_406_cov_1.325733	367	398	0	31	31	1.0000000
NODE_74588_length_406_cov_0.934853	1	32	0	31	31	1.0000000
NODE_74588_length_406_cov_0.934853	5	85	0	80	80	1.0000000
NODE_74696_length_405_cov_5.107843	332	380	0	42	48	0.8750000
NODE_74696_length_405_cov_5.107843	332	380	2	6	48	0.1250000
NODE_74697_length_405_cov_4.915033	15	46	2	31	31	1.0000000
NODE_74727_length_405_cov_3.346405	195	240	0	45	45	1.0000000
NODE_74727_length_405_cov_3.346405	274	329	2	55	55	1.0000000
NODE_74737_length_405_cov_3.124183	210	260	2	50	50	1.0000000
NODE_74737_length_405_cov_3.124183	240	286	2	45	46	0.9782609
NODE_74737_length_405_cov_3.124183	240	286	3	1	46	0.0217391
NODE_74737_length_405_cov_3.124183	260	339	2	34	79	0.4303797
NODE_74737_length_405_cov_3.124183	260	339	3	3	79	0.0379747
NODE_74737_length_405_cov_3.124183	260	339	4	1	79	0.0126582
NODE_74737_length_405_cov_3.124183	260	339	10	17	79	0.2151899
NODE_74737_length_405_cov_3.124183	260	339	12	24	79	0.3037975
NODE_74737_length_405_cov_3.124183	272	339	2	22	67	0.3283582
NODE_74737_length_405_cov_3.124183	272	339	3	3	67	0.0447761
NODE_74737_length_405_cov_3.124183	272	339	4	1	67	0.0149254
NODE_74737_length_405_cov_3.124183	272	339	10	17	67	0.2537313
NODE_74737_length_405_cov_3.124183	272	339	12	24	67	0.3582090
NODE_74780_length_405_cov_2.503268	352	399	0	47	47	1.0000000
NODE_74787_length_405_cov_2.460784	0	73	0	12	73	0.1643836
NODE_74787_length_405_cov_2.460784	0	73	2	61	73	0.8356164
NODE_75145_length_405_cov_0.666667	207	268	0	55	61	0.9016393
NODE_75145_length_405_cov_0.666667	207	268	2	6	61	0.0983607
NODE_75196_length_404_cov_40.937705	40	120	0	80	80	1.0000000
NODE_75196_length_404_cov_40.937705	93	173	0	80	80	1.0000000
NODE_75197_length_404_cov_32.940984	46	126	2	23	80	0.2875000
NODE_75197_length_404_cov_32.940984	46	126	4	2	80	0.0250000
NODE_75197_length_404_cov_32.940984	46	126	6	55	80	0.6875000
NODE_75197_length_404_cov_32.940984	99	179	4	42	80	0.5250000
NODE_75197_length_404_cov_32.940984	99	179	6	38	80	0.4750000
NODE_75197_length_404_cov_32.940984	175	255	0	6	80	0.0750000
NODE_75197_length_404_cov_32.940984	175	255	2	61	80	0.7625000
NODE_75197_length_404_cov_32.940984	175	255	4	13	80	0.1625000
NODE_75197_length_404_cov_32.940984	228	308	2	80	80	1.0000000
NODE_75198_length_404_cov_11.731148	130	210	0	33	80	0.4125000
NODE_75198_length_404_cov_11.731148	130	210	2	47	80	0.5875000
NODE_75198_length_404_cov_11.731148	183	263	2	80	80	1.0000000
NODE_75200_length_404_cov_9.170492	201	257	0	56	56	1.0000000
NODE_75236_length_404_cov_3.613115	323	385	0	62	62	1.0000000
NODE_75259_length_404_cov_2.914754	181	261	0	1	80	0.0125000
NODE_75259_length_404_cov_2.914754	181	261	16	79	80	0.9875000
NODE_75345_length_404_cov_2.085246	245	325	0	20	80	0.2500000
NODE_75345_length_404_cov_2.085246	245	325	2	60	80	0.7500000
NODE_75357_length_404_cov_1.993443	95	148	0	53	53	1.0000000
NODE_75399_length_404_cov_1.672131	32	106	0	74	74	1.0000000
NODE_75440_length_404_cov_1.498361	94	174	8	10	80	0.1250000
NODE_75440_length_404_cov_1.498361	94	174	10	30	80	0.3750000
NODE_75440_length_404_cov_1.498361	94	174	12	23	80	0.2875000
NODE_75440_length_404_cov_1.498361	94	174	14	7	80	0.0875000
NODE_75440_length_404_cov_1.498361	94	174	16	10	80	0.1250000
NODE_75446_length_404_cov_1.485246	234	282	8	48	48	1.0000000
NODE_75545_length_404_cov_1.121311	114	194	6	6	80	0.0750000
NODE_75545_length_404_cov_1.121311	114	194	8	11	80	0.1375000
NODE_75545_length_404_cov_1.121311	114	194	12	2	80	0.0250000
NODE_75545_length_404_cov_1.121311	114	194	13	17	80	0.2125000
NODE_75545_length_404_cov_1.121311	114	194	14	2	80	0.0250000
NODE_75545_length_404_cov_1.121311	114	194	15	24	80	0.3000000
NODE_75545_length_404_cov_1.121311	114	194	16	18	80	0.2250000
NODE_75750_length_403_cov_7.325658	80	146	0	66	66	1.0000000
NODE_75750_length_403_cov_7.325658	165	234	0	69	69	1.0000000
NODE_75750_length_403_cov_7.325658	215	255	0	40	40	1.0000000
NODE_75751_length_403_cov_7.217105	207	284	0	77	77	1.0000000
NODE_75751_length_403_cov_7.217105	257	334	0	77	77	1.0000000
NODE_75752_length_403_cov_6.776316	192	250	0	58	58	1.0000000
NODE_75788_length_403_cov_3.710526	327	373	0	46	46	1.0000000
NODE_75788_length_403_cov_3.710526	346	403	0	57	57	1.0000000
NODE_75793_length_403_cov_3.611842	283	363	17	2	80	0.0250000
NODE_75793_length_403_cov_3.611842	283	363	18	2	80	0.0250000
NODE_75793_length_403_cov_3.611842	283	363	20	2	80	0.0250000
NODE_75793_length_403_cov_3.611842	283	363	22	6	80	0.0750000
NODE_75793_length_403_cov_3.611842	283	363	24	32	80	0.4000000
NODE_75793_length_403_cov_3.611842	283	363	25	1	80	0.0125000
NODE_75793_length_403_cov_3.611842	283	363	26	35	80	0.4375000
NODE_75824_length_403_cov_2.822368	201	282	4	14	81	0.1728395
NODE_75824_length_403_cov_2.822368	201	282	6	2	81	0.0246914
NODE_75824_length_403_cov_2.822368	201	282	8	7	81	0.0864198
NODE_75824_length_403_cov_2.822368	201	282	10	58	81	0.7160494
NODE_75871_length_403_cov_2.082237	102	145	2	43	43	1.0000000
NODE_75908_length_403_cov_1.871711	130	166	0	36	36	1.0000000
NODE_75993_length_403_cov_1.398026	79	116	0	37	37	1.0000000
NODE_76029_length_403_cov_1.269737	82	111	0	29	29	1.0000000
NODE_76239_length_402_cov_6.293729	217	297	0	80	80	1.0000000
NODE_76239_length_402_cov_6.293729	270	350	0	80	80	1.0000000
NODE_76246_length_402_cov_5.227723	176	236	6	4	60	0.0666667
NODE_76246_length_402_cov_5.227723	176	236	8	56	60	0.9333333
NODE_76261_length_402_cov_4.356436	44	123	0	79	79	1.0000000
NODE_76261_length_402_cov_4.356436	119	199	0	8	80	0.1000000
NODE_76261_length_402_cov_4.356436	119	199	2	72	80	0.9000000
NODE_76261_length_402_cov_4.356436	172	252	2	35	80	0.4375000
NODE_76261_length_402_cov_4.356436	172	252	4	35	80	0.4375000
NODE_76261_length_402_cov_4.356436	172	252	6	10	80	0.1250000
NODE_76276_length_402_cov_3.564356	197	257	0	19	60	0.3166667
NODE_76276_length_402_cov_3.564356	197	257	2	7	60	0.1166667
NODE_76276_length_402_cov_3.564356	197	257	4	34	60	0.5666667
NODE_76276_length_402_cov_3.564356	230	310	2	6	80	0.0750000
NODE_76276_length_402_cov_3.564356	230	310	4	74	80	0.9250000
NODE_76328_length_402_cov_2.633663	335	402	0	45	67	0.6716418
NODE_76328_length_402_cov_2.633663	335	402	2	22	67	0.3283582
NODE_76336_length_402_cov_2.514851	82	162	2	1	80	0.0125000
NODE_76336_length_402_cov_2.514851	82	162	4	6	80	0.0750000
NODE_76336_length_402_cov_2.514851	82	162	5	5	80	0.0625000
NODE_76336_length_402_cov_2.514851	82	162	7	8	80	0.1000000
NODE_76336_length_402_cov_2.514851	82	162	11	7	80	0.0875000
NODE_76336_length_402_cov_2.514851	82	162	13	1	80	0.0125000
NODE_76336_length_402_cov_2.514851	82	162	15	1	80	0.0125000
NODE_76336_length_402_cov_2.514851	82	162	16	3	80	0.0375000
NODE_76336_length_402_cov_2.514851	82	162	17	40	80	0.5000000
NODE_76336_length_402_cov_2.514851	82	162	20	8	80	0.1000000
NODE_76336_length_402_cov_2.514851	135	200	0	36	65	0.5538462
NODE_76336_length_402_cov_2.514851	135	200	2	3	65	0.0461538
NODE_76336_length_402_cov_2.514851	135	200	4	6	65	0.0923077
NODE_76336_length_402_cov_2.514851	135	200	5	5	65	0.0769231
NODE_76336_length_402_cov_2.514851	135	200	7	8	65	0.1230769
NODE_76336_length_402_cov_2.514851	135	200	11	7	65	0.1076923
NODE_76380_length_402_cov_2.102310	114	165	0	51	51	1.0000000
NODE_76380_length_402_cov_2.102310	138	195	0	41	57	0.7192982
NODE_76380_length_402_cov_2.102310	138	195	2	16	57	0.2807018
NODE_76560_length_402_cov_1.214521	0	33	0	33	33	1.0000000
NODE_76646_length_402_cov_1.000000	119	188	0	39	69	0.5652174
NODE_76646_length_402_cov_1.000000	119	188	2	5	69	0.0724638
NODE_76646_length_402_cov_1.000000	119	188	4	25	69	0.3623188
NODE_76752_length_402_cov_0.663366	0	46	0	46	46	1.0000000
NODE_76780_length_401_cov_43.675497	285	343	4	58	58	1.0000000
NODE_76801_length_401_cov_4.377483	309	389	0	80	80	1.0000000
NODE_76804_length_401_cov_4.241722	125	180	0	55	55	1.0000000
NODE_76808_length_401_cov_4.132450	195	275	0	2	80	0.0250000
NODE_76808_length_401_cov_4.132450	195	275	2	2	80	0.0250000
NODE_76808_length_401_cov_4.132450	195	275	3	59	80	0.7375000
NODE_76808_length_401_cov_4.132450	195	275	5	3	80	0.0375000
NODE_76808_length_401_cov_4.132450	195	275	6	14	80	0.1750000
NODE_76811_length_401_cov_3.973510	138	181	0	31	43	0.7209302
NODE_76811_length_401_cov_3.973510	138	181	1	5	43	0.1162791
NODE_76811_length_401_cov_3.973510	138	181	2	6	43	0.1395349
NODE_76811_length_401_cov_3.973510	138	181	4	1	43	0.0232558
NODE_76828_length_401_cov_3.370861	141	221	0	48	80	0.6000000
NODE_76828_length_401_cov_3.370861	141	221	2	32	80	0.4000000
NODE_76828_length_401_cov_3.370861	194	273	0	22	79	0.2784810
NODE_76828_length_401_cov_3.370861	194	273	2	57	79	0.7215190
NODE_76830_length_401_cov_3.317881	67	147	0	34	80	0.4250000
NODE_76830_length_401_cov_3.317881	67	147	2	7	80	0.0875000
NODE_76830_length_401_cov_3.317881	67	147	4	39	80	0.4875000
NODE_76918_length_401_cov_1.937086	160	239	6	1	79	0.0126582
NODE_76918_length_401_cov_1.937086	160	239	8	32	79	0.4050633
NODE_76918_length_401_cov_1.937086	160	239	10	28	79	0.3544304
NODE_76918_length_401_cov_1.937086	160	239	12	18	79	0.2278481
NODE_76978_length_401_cov_1.615894	205	269	6	6	64	0.0937500
NODE_76978_length_401_cov_1.615894	205	269	10	7	64	0.1093750
NODE_76978_length_401_cov_1.615894	205	269	12	1	64	0.0156250
NODE_76978_length_401_cov_1.615894	205	269	14	4	64	0.0625000
NODE_76978_length_401_cov_1.615894	205	269	21	1	64	0.0156250
NODE_76978_length_401_cov_1.615894	205	269	22	1	64	0.0156250
NODE_76978_length_401_cov_1.615894	205	269	30	1	64	0.0156250
NODE_76978_length_401_cov_1.615894	205	269	35	1	64	0.0156250
NODE_76978_length_401_cov_1.615894	205	269	38	1	64	0.0156250
NODE_76978_length_401_cov_1.615894	205	269	47	1	64	0.0156250
NODE_76978_length_401_cov_1.615894	205	269	52	1	64	0.0156250
NODE_76978_length_401_cov_1.615894	205	269	56	1	64	0.0156250
NODE_76978_length_401_cov_1.615894	205	269	62	1	64	0.0156250
NODE_76978_length_401_cov_1.615894	205	269	64	4	64	0.0625000
NODE_76978_length_401_cov_1.615894	205	269	66	1	64	0.0156250
NODE_76978_length_401_cov_1.615894	205	269	68	1	64	0.0156250
NODE_76978_length_401_cov_1.615894	205	269	70	2	64	0.0312500
NODE_76978_length_401_cov_1.615894	205	269	72	1	64	0.0156250
NODE_76978_length_401_cov_1.615894	205	269	80	1	64	0.0156250
NODE_76978_length_401_cov_1.615894	205	269	82	5	64	0.0781250
NODE_76978_length_401_cov_1.615894	205	269	84	2	64	0.0312500
NODE_76978_length_401_cov_1.615894	205	269	86	2	64	0.0312500
NODE_76978_length_401_cov_1.615894	205	269	88	2	64	0.0312500
NODE_76978_length_401_cov_1.615894	205	269	90	2	64	0.0312500
NODE_76978_length_401_cov_1.615894	205	269	92	2	64	0.0312500
NODE_76978_length_401_cov_1.615894	205	269	96	2	64	0.0312500
NODE_76978_length_401_cov_1.615894	205	269	98	1	64	0.0156250
NODE_76978_length_401_cov_1.615894	205	269	102	1	64	0.0156250
NODE_76978_length_401_cov_1.615894	205	269	106	2	64	0.0312500
NODE_76978_length_401_cov_1.615894	205	269	110	2	64	0.0312500
NODE_76978_length_401_cov_1.615894	205	269	112	2	64	0.0312500
NODE_76978_length_401_cov_1.615894	205	269	114	2	64	0.0312500
NODE_77017_length_401_cov_1.407285	23	92	0	69	69	1.0000000
NODE_77017_length_401_cov_1.407285	76	122	0	46	46	1.0000000
NODE_77236_length_401_cov_0.675497	292	372	0	80	80	1.0000000
NODE_77236_length_401_cov_0.675497	345	401	0	56	56	1.0000000
NODE_77284_length_400_cov_40.584718	205	281	2	76	76	1.0000000
NODE_77284_length_400_cov_40.584718	254	334	0	46	80	0.5750000
NODE_77284_length_400_cov_40.584718	254	334	2	34	80	0.4250000
NODE_77289_length_400_cov_8.631229	307	372	0	65	65	1.0000000
NODE_77292_length_400_cov_6.850498	281	329	0	48	48	1.0000000
NODE_77322_length_400_cov_4.000000	82	140	2	7	58	0.1206897
NODE_77322_length_400_cov_4.000000	82	140	4	51	58	0.8793104
NODE_77358_length_400_cov_3.029900	204	284	0	80	80	1.0000000
NODE_77358_length_400_cov_3.029900	205	231	0	26	26	1.0000000
NODE_77362_length_400_cov_3.009967	146	220	8	6	74	0.0810811
NODE_77362_length_400_cov_3.009967	146	220	12	17	74	0.2297297
NODE_77362_length_400_cov_3.009967	146	220	14	18	74	0.2432432
NODE_77362_length_400_cov_3.009967	146	220	16	22	74	0.2972973
NODE_77362_length_400_cov_3.009967	146	220	18	11	74	0.1486486
NODE_77362_length_400_cov_3.009967	195	261	10	23	66	0.3484848
NODE_77362_length_400_cov_3.009967	195	261	12	9	66	0.1363636
NODE_77362_length_400_cov_3.009967	195	261	16	23	66	0.3484848
NODE_77362_length_400_cov_3.009967	195	261	18	11	66	0.1666667
NODE_77363_length_400_cov_2.990033	253	332	27	1	79	0.0126582
NODE_77363_length_400_cov_2.990033	253	332	28	4	79	0.0506329
NODE_77363_length_400_cov_2.990033	253	332	29	16	79	0.2025317
NODE_77363_length_400_cov_2.990033	253	332	30	10	79	0.1265823
NODE_77363_length_400_cov_2.990033	253	332	32	5	79	0.0632911
NODE_77363_length_400_cov_2.990033	253	332	34	1	79	0.0126582
NODE_77363_length_400_cov_2.990033	253	332	36	1	79	0.0126582
NODE_77363_length_400_cov_2.990033	253	332	38	2	79	0.0253165
NODE_77363_length_400_cov_2.990033	253	332	39	3	79	0.0379747
NODE_77363_length_400_cov_2.990033	253	332	41	2	79	0.0253165
NODE_77363_length_400_cov_2.990033	253	332	45	1	79	0.0126582
NODE_77363_length_400_cov_2.990033	253	332	46	2	79	0.0253165
NODE_77363_length_400_cov_2.990033	253	332	47	4	79	0.0506329
NODE_77363_length_400_cov_2.990033	253	332	51	1	79	0.0126582
NODE_77363_length_400_cov_2.990033	253	332	53	2	79	0.0253165
NODE_77363_length_400_cov_2.990033	253	332	55	2	79	0.0253165
NODE_77363_length_400_cov_2.990033	253	332	59	1	79	0.0126582
NODE_77363_length_400_cov_2.990033	253	332	61	11	79	0.1392405
NODE_77363_length_400_cov_2.990033	253	332	63	1	79	0.0126582
NODE_77363_length_400_cov_2.990033	253	332	65	3	79	0.0379747
NODE_77363_length_400_cov_2.990033	253	332	67	6	79	0.0759494
NODE_77363_length_400_cov_2.990033	306	385	50	22	79	0.2784810
NODE_77363_length_400_cov_2.990033	306	385	51	1	79	0.0126582
NODE_77363_length_400_cov_2.990033	306	385	53	2	79	0.0253165
NODE_77363_length_400_cov_2.990033	306	385	54	7	79	0.0886076
NODE_77363_length_400_cov_2.990033	306	385	55	2	79	0.0253165
NODE_77363_length_400_cov_2.990033	306	385	56	10	79	0.1265823
NODE_77363_length_400_cov_2.990033	306	385	58	3	79	0.0379747
NODE_77363_length_400_cov_2.990033	306	385	59	1	79	0.0126582
NODE_77363_length_400_cov_2.990033	306	385	60	5	79	0.0632911
NODE_77363_length_400_cov_2.990033	306	385	61	12	79	0.1518987
NODE_77363_length_400_cov_2.990033	306	385	62	1	79	0.0126582
NODE_77363_length_400_cov_2.990033	306	385	63	1	79	0.0126582
NODE_77363_length_400_cov_2.990033	306	385	64	1	79	0.0126582
NODE_77363_length_400_cov_2.990033	306	385	65	3	79	0.0379747
NODE_77363_length_400_cov_2.990033	306	385	66	1	79	0.0126582
NODE_77363_length_400_cov_2.990033	306	385	67	7	79	0.0886076
NODE_77368_length_400_cov_2.860465	365	400	0	35	35	1.0000000
NODE_77371_length_400_cov_2.797342	324	372	0	48	48	1.0000000
NODE_77380_length_400_cov_2.581395	192	254	0	62	62	1.0000000
NODE_77460_length_400_cov_1.940199	225	268	2	7	43	0.1627907
NODE_77460_length_400_cov_1.940199	225	268	4	36	43	0.8372093
NODE_77460_length_400_cov_1.940199	293	374	4	5	81	0.0617284
NODE_77460_length_400_cov_1.940199	293	374	6	55	81	0.6790124
NODE_77460_length_400_cov_1.940199	293	374	8	21	81	0.2592593
NODE_77821_length_399_cov_71.493333	215	295	0	80	80	1.0000000
NODE_77821_length_399_cov_71.493333	268	348	0	80	80	1.0000000
NODE_77823_length_399_cov_7.510000	229	309	0	80	80	1.0000000
NODE_77823_length_399_cov_7.510000	282	362	0	80	80	1.0000000
NODE_77825_length_399_cov_7.310000	125	187	0	2	62	0.0322581
NODE_77825_length_399_cov_7.310000	125	187	2	60	62	0.9677419
NODE_77854_length_399_cov_4.293333	86	164	4	11	78	0.1410256
NODE_77854_length_399_cov_4.293333	86	164	6	2	78	0.0256410
NODE_77854_length_399_cov_4.293333	86	164	8	6	78	0.0769231
NODE_77854_length_399_cov_4.293333	86	164	10	53	78	0.6794872
NODE_77854_length_399_cov_4.293333	86	164	12	6	78	0.0769231
NODE_77877_length_399_cov_3.406667	51	124	0	73	73	1.0000000
NODE_77933_length_399_cov_2.286667	310	390	2	48	80	0.6000000
NODE_77933_length_399_cov_2.286667	310	390	4	32	80	0.4000000
NODE_77966_length_399_cov_1.916667	76	136	0	53	60	0.8833333
NODE_77966_length_399_cov_1.916667	76	136	2	7	60	0.1166667
NODE_77966_length_399_cov_1.916667	123	189	0	6	66	0.0909091
NODE_77966_length_399_cov_1.916667	123	189	2	60	66	0.9090909
NODE_78276_length_399_cov_0.710000	313	392	0	50	79	0.6329114
NODE_78276_length_399_cov_0.710000	313	392	2	29	79	0.3670886
NODE_78354_length_398_cov_9.688963	1	81	0	80	80	1.0000000
NODE_78354_length_398_cov_9.688963	247	327	0	80	80	1.0000000
NODE_78354_length_398_cov_9.688963	300	380	0	80	80	1.0000000
NODE_78360_length_398_cov_6.488294	130	210	0	80	80	1.0000000
NODE_78364_length_398_cov_5.765886	253	333	0	61	80	0.7625000
NODE_78364_length_398_cov_5.765886	253	333	2	4	80	0.0500000
NODE_78364_length_398_cov_5.765886	253	333	8	13	80	0.1625000
NODE_78364_length_398_cov_5.765886	253	333	10	2	80	0.0250000
NODE_78372_length_398_cov_5.244147	248	312	14	1	64	0.0156250
NODE_78372_length_398_cov_5.244147	248	312	16	5	64	0.0781250
NODE_78372_length_398_cov_5.244147	248	312	17	35	64	0.5468750
NODE_78372_length_398_cov_5.244147	248	312	18	23	64	0.3593750
NODE_78376_length_398_cov_5.006689	116	196	0	80	80	1.0000000
NODE_78376_length_398_cov_5.006689	169	251	0	82	82	1.0000000
NODE_78383_length_398_cov_4.284281	63	117	0	54	54	1.0000000
NODE_78383_length_398_cov_4.284281	135	160	0	25	25	1.0000000
NODE_78420_length_398_cov_2.993311	229	309	0	40	80	0.5000000
NODE_78420_length_398_cov_2.993311	229	309	2	40	80	0.5000000
NODE_78429_length_398_cov_2.822742	236	271	0	35	35	1.0000000
NODE_78891_length_397_cov_52.855705	124	204	0	38	80	0.4750000
NODE_78891_length_397_cov_52.855705	124	204	2	42	80	0.5250000
NODE_78891_length_397_cov_52.855705	177	257	0	80	80	1.0000000
NODE_78894_length_397_cov_35.036913	173	253	0	22	80	0.2750000
NODE_78894_length_397_cov_35.036913	173	253	2	2	80	0.0250000
NODE_78894_length_397_cov_35.036913	173	253	4	56	80	0.7000000
NODE_78895_length_397_cov_13.667785	94	174	0	80	80	1.0000000
NODE_78895_length_397_cov_13.667785	147	227	0	80	80	1.0000000
NODE_78897_length_397_cov_7.496644	192	272	2	80	80	1.0000000
NODE_78897_length_397_cov_7.496644	245	325	0	50	80	0.6250000
NODE_78897_length_397_cov_7.496644	245	325	2	30	80	0.3750000
NODE_78898_length_397_cov_6.828859	127	173	0	9	46	0.1956522
NODE_78898_length_397_cov_6.828859	127	173	1	20	46	0.4347826
NODE_78898_length_397_cov_6.828859	127	173	2	17	46	0.3695652
NODE_78913_length_397_cov_4.902685	293	364	0	71	71	1.0000000
NODE_78933_length_397_cov_3.765101	164	244	0	1	80	0.0125000
NODE_78933_length_397_cov_3.765101	164	244	2	79	80	0.9875000
NODE_78951_length_397_cov_3.325503	107	187	0	4	80	0.0500000
NODE_78951_length_397_cov_3.325503	107	187	2	10	80	0.1250000
NODE_78951_length_397_cov_3.325503	107	187	4	66	80	0.8250000
NODE_78951_length_397_cov_3.325503	163	236	0	21	73	0.2876712
NODE_78951_length_397_cov_3.325503	163	236	2	24	73	0.3287671
NODE_78951_length_397_cov_3.325503	163	236	4	28	73	0.3835616
NODE_78999_length_397_cov_2.530201	269	312	0	43	43	1.0000000
NODE_79047_length_397_cov_1.959732	154	193	0	39	39	1.0000000
NODE_79072_length_397_cov_1.791946	218	283	2	13	65	0.2000000
NODE_79072_length_397_cov_1.791946	218	283	4	18	65	0.2769231
NODE_79072_length_397_cov_1.791946	218	283	6	6	65	0.0923077
NODE_79072_length_397_cov_1.791946	218	283	8	3	65	0.0461538
NODE_79072_length_397_cov_1.791946	218	283	10	16	65	0.2461538
NODE_79072_length_397_cov_1.791946	218	283	12	9	65	0.1384615
NODE_79127_length_397_cov_1.560403	183	240	0	57	57	1.0000000
NODE_79456_length_396_cov_11.632997	162	242	0	80	80	1.0000000
NODE_79456_length_396_cov_11.632997	215	295	0	80	80	1.0000000
NODE_79460_length_396_cov_7.053872	71	101	2	30	30	1.0000000
NODE_79464_length_396_cov_6.097643	229	309	0	80	80	1.0000000
NODE_79464_length_396_cov_6.097643	282	362	0	80	80	1.0000000
NODE_79471_length_396_cov_5.484848	125	205	4	8	80	0.1000000
NODE_79471_length_396_cov_5.484848	125	205	6	4	80	0.0500000
NODE_79471_length_396_cov_5.484848	125	205	8	28	80	0.3500000
NODE_79471_length_396_cov_5.484848	125	205	10	40	80	0.5000000
NODE_79471_length_396_cov_5.484848	178	259	0	8	81	0.0987654
NODE_79471_length_396_cov_5.484848	178	259	2	26	81	0.3209876
NODE_79471_length_396_cov_5.484848	178	259	4	4	81	0.0493827
NODE_79471_length_396_cov_5.484848	178	259	6	7	81	0.0864198
NODE_79471_length_396_cov_5.484848	178	259	8	14	81	0.1728395
NODE_79471_length_396_cov_5.484848	178	259	10	22	81	0.2716049
NODE_79473_length_396_cov_5.434343	224	275	0	44	51	0.8627451
NODE_79473_length_396_cov_5.434343	224	275	2	7	51	0.1372549
NODE_79473_length_396_cov_5.434343	272	331	0	59	59	1.0000000
NODE_79483_length_396_cov_4.414141	189	264	0	15	75	0.2000000
NODE_79483_length_396_cov_4.414141	189	264	4	60	75	0.8000000
NODE_79483_length_396_cov_4.414141	241	317	0	68	76	0.8947368
NODE_79483_length_396_cov_4.414141	241	317	4	8	76	0.1052632
NODE_79493_length_396_cov_4.010101	163	205	10	26	42	0.6190476
NODE_79493_length_396_cov_4.010101	163	205	12	16	42	0.3809524
NODE_79522_length_396_cov_3.080808	95	161	0	66	66	1.0000000
NODE_79524_length_396_cov_3.067340	252	316	0	64	64	1.0000000
NODE_79535_length_396_cov_2.892256	136	217	4	26	81	0.3209876
NODE_79535_length_396_cov_2.892256	136	217	6	55	81	0.6790124
NODE_79557_length_396_cov_2.710438	88	168	4	2	80	0.0250000
NODE_79557_length_396_cov_2.710438	88	168	8	5	80	0.0625000
NODE_79557_length_396_cov_2.710438	88	168	10	7	80	0.0875000
NODE_79557_length_396_cov_2.710438	88	168	13	4	80	0.0500000
NODE_79557_length_396_cov_2.710438	88	168	14	7	80	0.0875000
NODE_79557_length_396_cov_2.710438	88	168	16	7	80	0.0875000
NODE_79557_length_396_cov_2.710438	88	168	18	2	80	0.0250000
NODE_79557_length_396_cov_2.710438	88	168	20	1	80	0.0125000
NODE_79557_length_396_cov_2.710438	88	168	22	2	80	0.0250000
NODE_79557_length_396_cov_2.710438	88	168	24	3	80	0.0375000
NODE_79557_length_396_cov_2.710438	88	168	28	1	80	0.0125000
NODE_79557_length_396_cov_2.710438	88	168	34	11	80	0.1375000
NODE_79557_length_396_cov_2.710438	88	168	35	1	80	0.0125000
NODE_79557_length_396_cov_2.710438	88	168	36	27	80	0.3375000
NODE_79561_length_396_cov_2.680135	297	335	0	38	38	1.0000000
NODE_79562_length_396_cov_2.659933	68	148	0	80	80	1.0000000
NODE_79562_length_396_cov_2.659933	121	168	0	47	47	1.0000000
NODE_79616_length_396_cov_2.060606	308	388	0	1	80	0.0125000
NODE_79616_length_396_cov_2.060606	308	388	2	79	80	0.9875000
NODE_79643_length_396_cov_1.939394	63	142	0	12	79	0.1518987
NODE_79643_length_396_cov_1.939394	63	142	2	67	79	0.8481013
NODE_79643_length_396_cov_1.939394	115	164	2	43	49	0.8775510
NODE_79643_length_396_cov_1.939394	115	164	6	2	49	0.0408163
NODE_79643_length_396_cov_1.939394	115	164	10	4	49	0.0816327
NODE_79683_length_396_cov_1.811448	82	162	0	80	80	1.0000000
NODE_79692_length_396_cov_1.734007	88	119	0	31	31	1.0000000
NODE_79930_length_396_cov_0.905724	101	151	5	1	50	0.0200000
NODE_79930_length_396_cov_0.905724	101	151	7	10	50	0.2000000
NODE_79930_length_396_cov_0.905724	101	151	8	39	50	0.7800000
NODE_80057_length_395_cov_449.327703	0	79	20	1	79	0.0126582
NODE_80057_length_395_cov_449.327703	0	79	39	1	79	0.0126582
NODE_80057_length_395_cov_449.327703	0	79	44	1	79	0.0126582
NODE_80057_length_395_cov_449.327703	0	79	46	1	79	0.0126582
NODE_80057_length_395_cov_449.327703	0	79	49	1	79	0.0126582
NODE_80057_length_395_cov_449.327703	0	79	61	1	79	0.0126582
NODE_80057_length_395_cov_449.327703	0	79	63	3	79	0.0379747
NODE_80057_length_395_cov_449.327703	0	79	66	1	79	0.0126582
NODE_80057_length_395_cov_449.327703	0	79	70	2	79	0.0253165
NODE_80057_length_395_cov_449.327703	0	79	74	1	79	0.0126582
NODE_80057_length_395_cov_449.327703	0	79	78	1	79	0.0126582
NODE_80057_length_395_cov_449.327703	0	79	79	1	79	0.0126582
NODE_80057_length_395_cov_449.327703	0	79	81	1	79	0.0126582
NODE_80057_length_395_cov_449.327703	0	79	87	1	79	0.0126582
NODE_80057_length_395_cov_449.327703	0	79	91	2	79	0.0253165
NODE_80057_length_395_cov_449.327703	0	79	93	1	79	0.0126582
NODE_80057_length_395_cov_449.327703	0	79	97	1	79	0.0126582
NODE_80057_length_395_cov_449.327703	0	79	105	1	79	0.0126582
NODE_80057_length_395_cov_449.327703	0	79	109	1	79	0.0126582
NODE_80057_length_395_cov_449.327703	0	79	112	1	79	0.0126582
NODE_80057_length_395_cov_449.327703	0	79	114	1	79	0.0126582
NODE_80057_length_395_cov_449.327703	0	79	116	1	79	0.0126582
NODE_80057_length_395_cov_449.327703	0	79	121	1	79	0.0126582
NODE_80057_length_395_cov_449.327703	0	79	125	2	79	0.0253165
NODE_80057_length_395_cov_449.327703	0	79	127	1	79	0.0126582
NODE_80057_length_395_cov_449.327703	0	79	130	1	79	0.0126582
NODE_80057_length_395_cov_449.327703	0	79	131	1	79	0.0126582
NODE_80057_length_395_cov_449.327703	0	79	135	1	79	0.0126582
NODE_80057_length_395_cov_449.327703	0	79	138	1	79	0.0126582
NODE_80057_length_395_cov_449.327703	0	79	142	1	79	0.0126582
NODE_80057_length_395_cov_449.327703	0	79	143	1	79	0.0126582
NODE_80057_length_395_cov_449.327703	0	79	144	1	79	0.0126582
NODE_80057_length_395_cov_449.327703	0	79	148	1	79	0.0126582
NODE_80057_length_395_cov_449.327703	0	79	149	1	79	0.0126582
NODE_80057_length_395_cov_449.327703	0	79	163	1	79	0.0126582
NODE_80057_length_395_cov_449.327703	0	79	165	1	79	0.0126582
NODE_80057_length_395_cov_449.327703	0	79	167	2	79	0.0253165
NODE_80057_length_395_cov_449.327703	0	79	179	1	79	0.0126582
NODE_80057_length_395_cov_449.327703	0	79	181	2	79	0.0253165
NODE_80057_length_395_cov_449.327703	0	79	186	1	79	0.0126582
NODE_80057_length_395_cov_449.327703	0	79	188	1	79	0.0126582
NODE_80057_length_395_cov_449.327703	0	79	193	1	79	0.0126582
NODE_80057_length_395_cov_449.327703	0	79	195	3	79	0.0379747
NODE_80057_length_395_cov_449.327703	0	79	197	1	79	0.0126582
NODE_80057_length_395_cov_449.327703	0	79	199	2	79	0.0253165
NODE_80057_length_395_cov_449.327703	0	79	202	2	79	0.0253165
NODE_80057_length_395_cov_449.327703	0	79	204	2	79	0.0253165
NODE_80057_length_395_cov_449.327703	0	79	206	1	79	0.0126582
NODE_80057_length_395_cov_449.327703	0	79	210	1	79	0.0126582
NODE_80057_length_395_cov_449.327703	0	79	214	2	79	0.0253165
NODE_80057_length_395_cov_449.327703	0	79	222	1	79	0.0126582
NODE_80057_length_395_cov_449.327703	0	79	226	1	79	0.0126582
NODE_80057_length_395_cov_449.327703	0	79	229	2	79	0.0253165
NODE_80057_length_395_cov_449.327703	0	79	233	1	79	0.0126582
NODE_80057_length_395_cov_449.327703	0	79	235	1	79	0.0126582
NODE_80057_length_395_cov_449.327703	0	79	237	3	79	0.0379747
NODE_80057_length_395_cov_449.327703	0	79	240	1	79	0.0126582
NODE_80057_length_395_cov_449.327703	0	79	242	1	79	0.0126582
NODE_80057_length_395_cov_449.327703	0	79	243	1	79	0.0126582
NODE_80057_length_395_cov_449.327703	0	79	248	1	79	0.0126582
NODE_80057_length_395_cov_449.327703	0	79	250	1	79	0.0126582
NODE_80057_length_395_cov_449.327703	0	79	254	1	79	0.0126582
NODE_80057_length_395_cov_449.327703	0	79	256	1	79	0.0126582
NODE_80058_length_395_cov_13.695946	113	193	0	80	80	1.0000000
NODE_80058_length_395_cov_13.695946	166	246	0	80	80	1.0000000
NODE_80086_length_395_cov_4.179054	152	232	0	78	80	0.9750000
NODE_80086_length_395_cov_4.179054	152	232	8	2	80	0.0250000
NODE_80116_length_395_cov_2.962838	118	198	2	2	80	0.0250000
NODE_80116_length_395_cov_2.962838	118	198	4	10	80	0.1250000
NODE_80116_length_395_cov_2.962838	118	198	6	6	80	0.0750000
NODE_80116_length_395_cov_2.962838	118	198	8	62	80	0.7750000
NODE_80116_length_395_cov_2.962838	171	237	0	23	66	0.3484848
NODE_80116_length_395_cov_2.962838	171	237	2	18	66	0.2727273
NODE_80116_length_395_cov_2.962838	171	237	4	1	66	0.0151515
NODE_80116_length_395_cov_2.962838	171	237	6	5	66	0.0757576
NODE_80116_length_395_cov_2.962838	171	237	8	19	66	0.2878788
NODE_80121_length_395_cov_2.878378	261	301	0	39	40	0.9750000
NODE_80121_length_395_cov_2.878378	261	301	2	1	40	0.0250000
NODE_80139_length_395_cov_2.587838	111	188	2	59	77	0.7662337
NODE_80139_length_395_cov_2.587838	111	188	4	18	77	0.2337662
NODE_80139_length_395_cov_2.587838	232	301	2	6	69	0.0869565
NODE_80139_length_395_cov_2.587838	232	301	4	16	69	0.2318841
NODE_80139_length_395_cov_2.587838	232	301	6	47	69	0.6811594
NODE_80139_length_395_cov_2.587838	258	302	4	17	44	0.3863636
NODE_80139_length_395_cov_2.587838	258	302	6	27	44	0.6136364
NODE_80141_length_395_cov_2.560811	123	187	0	64	64	1.0000000
NODE_80146_length_395_cov_2.527027	194	274	0	80	80	1.0000000
NODE_80146_length_395_cov_2.527027	247	327	0	80	80	1.0000000
NODE_80439_length_395_cov_1.033784	103	151	2	6	48	0.1250000
NODE_80439_length_395_cov_1.033784	103	151	4	42	48	0.8750000
NODE_80448_length_395_cov_1.010135	85	105	0	20	20	1.0000000
NODE_80639_length_394_cov_9.464407	211	291	0	80	80	1.0000000
NODE_80639_length_394_cov_9.464407	264	344	0	80	80	1.0000000
NODE_80643_length_394_cov_7.437288	221	301	4	2	80	0.0250000
NODE_80643_length_394_cov_7.437288	221	301	10	16	80	0.2000000
NODE_80643_length_394_cov_7.437288	221	301	12	22	80	0.2750000
NODE_80643_length_394_cov_7.437288	221	301	14	40	80	0.5000000
NODE_80643_length_394_cov_7.437288	274	331	8	5	57	0.0877193
NODE_80643_length_394_cov_7.437288	274	331	10	41	57	0.7192982
NODE_80643_length_394_cov_7.437288	274	331	14	11	57	0.1929825
NODE_80647_length_394_cov_6.444068	187	267	0	38	80	0.4750000
NODE_80647_length_394_cov_6.444068	187	267	2	42	80	0.5250000
NODE_80647_length_394_cov_6.444068	240	320	0	80	80	1.0000000
NODE_80709_length_394_cov_2.932203	119	140	0	19	21	0.9047619
NODE_80709_length_394_cov_2.932203	119	140	2	2	21	0.0952381
NODE_80710_length_394_cov_2.894915	79	135	2	56	56	1.0000000
NODE_80710_length_394_cov_2.894915	166	202	0	36	36	1.0000000
NODE_81216_length_393_cov_4.261905	201	267	0	66	66	1.0000000
NODE_81216_length_393_cov_4.261905	240	282	0	42	42	1.0000000
NODE_81240_length_393_cov_3.503401	121	201	2	7	80	0.0875000
NODE_81240_length_393_cov_3.503401	121	201	4	9	80	0.1125000
NODE_81240_length_393_cov_3.503401	121	201	6	51	80	0.6375000
NODE_81240_length_393_cov_3.503401	121	201	8	13	80	0.1625000
NODE_81240_length_393_cov_3.503401	174	246	2	52	72	0.7222222
NODE_81240_length_393_cov_3.503401	174	246	4	9	72	0.1250000
NODE_81240_length_393_cov_3.503401	174	246	8	11	72	0.1527778
NODE_81277_length_393_cov_2.704082	198	271	0	31	73	0.4246575
NODE_81277_length_393_cov_2.704082	198	271	2	42	73	0.5753425
NODE_81289_length_393_cov_2.493197	136	216	0	80	80	1.0000000
NODE_81289_length_393_cov_2.493197	189	269	0	80	80	1.0000000
NODE_81296_length_393_cov_2.360544	195	252	0	43	57	0.7543859
NODE_81296_length_393_cov_2.360544	195	252	4	14	57	0.2456140
NODE_81416_length_393_cov_1.608844	207	270	0	63	63	1.0000000
NODE_81778_length_392_cov_7.873720	161	241	0	80	80	1.0000000
NODE_81778_length_392_cov_7.873720	214	294	0	80	80	1.0000000
NODE_81790_length_392_cov_5.262799	218	248	0	30	30	1.0000000
NODE_81805_length_392_cov_3.655290	109	157	0	48	48	1.0000000
NODE_81805_length_392_cov_3.655290	306	386	0	80	80	1.0000000
NODE_81823_length_392_cov_3.197952	102	171	0	57	69	0.8260869
NODE_81823_length_392_cov_3.197952	102	171	2	12	69	0.1739130
NODE_81823_length_392_cov_3.197952	233	314	0	81	81	1.0000000
NODE_81857_length_392_cov_2.511945	67	133	22	3	66	0.0454545
NODE_81857_length_392_cov_2.511945	67	133	26	1	66	0.0151515
NODE_81857_length_392_cov_2.511945	67	133	28	2	66	0.0303030
NODE_81857_length_392_cov_2.511945	67	133	34	9	66	0.1363636
NODE_81857_length_392_cov_2.511945	67	133	36	1	66	0.0151515
NODE_81857_length_392_cov_2.511945	67	133	38	2	66	0.0303030
NODE_81857_length_392_cov_2.511945	67	133	42	2	66	0.0303030
NODE_81857_length_392_cov_2.511945	67	133	44	2	66	0.0303030
NODE_81857_length_392_cov_2.511945	67	133	46	3	66	0.0454545
NODE_81857_length_392_cov_2.511945	67	133	48	3	66	0.0454545
NODE_81857_length_392_cov_2.511945	67	133	52	1	66	0.0151515
NODE_81857_length_392_cov_2.511945	67	133	54	7	66	0.1060606
NODE_81857_length_392_cov_2.511945	67	133	58	1	66	0.0151515
NODE_81857_length_392_cov_2.511945	67	133	59	5	66	0.0757576
NODE_81857_length_392_cov_2.511945	67	133	61	2	66	0.0303030
NODE_81857_length_392_cov_2.511945	67	133	63	6	66	0.0909091
NODE_81857_length_392_cov_2.511945	67	133	64	3	66	0.0454545
NODE_81857_length_392_cov_2.511945	67	133	65	6	66	0.0909091
NODE_81857_length_392_cov_2.511945	67	133	67	3	66	0.0454545
NODE_81857_length_392_cov_2.511945	67	133	71	2	66	0.0303030
NODE_81857_length_392_cov_2.511945	67	133	75	1	66	0.0151515
NODE_81857_length_392_cov_2.511945	67	133	81	1	66	0.0151515
NODE_81857_length_392_cov_2.511945	120	206	63	2	86	0.0232558
NODE_81857_length_392_cov_2.511945	120	206	64	3	86	0.0348837
NODE_81857_length_392_cov_2.511945	120	206	65	3	86	0.0348837
NODE_81857_length_392_cov_2.511945	120	206	67	1	86	0.0116279
NODE_81857_length_392_cov_2.511945	120	206	71	2	86	0.0232558
NODE_81857_length_392_cov_2.511945	120	206	75	1	86	0.0116279
NODE_81857_length_392_cov_2.511945	120	206	81	1	86	0.0116279
NODE_81857_length_392_cov_2.511945	120	206	82	2	86	0.0232558
NODE_81857_length_392_cov_2.511945	120	206	84	9	86	0.1046512
NODE_81857_length_392_cov_2.511945	120	206	85	9	86	0.1046512
NODE_81857_length_392_cov_2.511945	120	206	86	2	86	0.0232558
NODE_81857_length_392_cov_2.511945	120	206	87	1	86	0.0116279
NODE_81857_length_392_cov_2.511945	120	206	89	2	86	0.0232558
NODE_81857_length_392_cov_2.511945	120	206	91	1	86	0.0116279
NODE_81857_length_392_cov_2.511945	120	206	92	1	86	0.0116279
NODE_81857_length_392_cov_2.511945	120	206	94	1	86	0.0116279
NODE_81857_length_392_cov_2.511945	120	206	95	3	86	0.0348837
NODE_81857_length_392_cov_2.511945	120	206	96	2	86	0.0232558
NODE_81857_length_392_cov_2.511945	120	206	98	1	86	0.0116279
NODE_81857_length_392_cov_2.511945	120	206	99	5	86	0.0581395
NODE_81857_length_392_cov_2.511945	120	206	101	6	86	0.0697674
NODE_81857_length_392_cov_2.511945	120	206	102	6	86	0.0697674
NODE_81857_length_392_cov_2.511945	120	206	103	6	86	0.0697674
NODE_81857_length_392_cov_2.511945	120	206	104	1	86	0.0116279
NODE_81857_length_392_cov_2.511945	120	206	105	1	86	0.0116279
NODE_81857_length_392_cov_2.511945	120	206	106	1	86	0.0116279
NODE_81857_length_392_cov_2.511945	120	206	107	1	86	0.0116279
NODE_81857_length_392_cov_2.511945	120	206	109	3	86	0.0348837
NODE_81857_length_392_cov_2.511945	120	206	113	6	86	0.0697674
NODE_81857_length_392_cov_2.511945	120	206	115	3	86	0.0348837
NODE_81914_length_392_cov_2.075085	268	349	4	77	81	0.9506173
NODE_81914_length_392_cov_2.075085	268	349	6	4	81	0.0493827
NODE_81914_length_392_cov_2.075085	322	387	0	3	65	0.0461538
NODE_81914_length_392_cov_2.075085	322	387	2	28	65	0.4307692
NODE_81914_length_392_cov_2.075085	322	387	4	34	65	0.5230770
NODE_81928_length_392_cov_1.955631	11	56	0	43	45	0.9555556
NODE_81928_length_392_cov_1.955631	11	56	2	2	45	0.0444444
NODE_81929_length_392_cov_1.952218	40	59	0	5	19	0.2631579
NODE_81929_length_392_cov_1.952218	40	59	2	14	19	0.7368421
NODE_81940_length_392_cov_1.911263	238	315	0	42	77	0.5454546
NODE_81940_length_392_cov_1.911263	238	315	2	35	77	0.4545455
NODE_81994_length_392_cov_1.631399	114	139	24	2	25	0.0800000
NODE_81994_length_392_cov_1.631399	114	139	26	2	25	0.0800000
NODE_81994_length_392_cov_1.631399	114	139	29	2	25	0.0800000
NODE_81994_length_392_cov_1.631399	114	139	30	2	25	0.0800000
NODE_81994_length_392_cov_1.631399	114	139	31	2	25	0.0800000
NODE_81994_length_392_cov_1.631399	114	139	32	1	25	0.0400000
NODE_81994_length_392_cov_1.631399	114	139	34	2	25	0.0800000
NODE_81994_length_392_cov_1.631399	114	139	38	2	25	0.0800000
NODE_81994_length_392_cov_1.631399	114	139	40	2	25	0.0800000
NODE_81994_length_392_cov_1.631399	114	139	42	4	25	0.1600000
NODE_81994_length_392_cov_1.631399	114	139	44	4	25	0.1600000
NODE_82008_length_392_cov_1.559727	83	163	8	67	80	0.8375000
NODE_82008_length_392_cov_1.559727	83	163	10	13	80	0.1625000
NODE_82015_length_392_cov_1.552901	32	52	0	20	20	1.0000000
NODE_82390_length_391_cov_69.510274	9	89	39	2	80	0.0250000
NODE_82390_length_391_cov_69.510274	9	89	46	1	80	0.0125000
NODE_82390_length_391_cov_69.510274	9	89	54	1	80	0.0125000
NODE_82390_length_391_cov_69.510274	9	89	58	1	80	0.0125000
NODE_82390_length_391_cov_69.510274	9	89	60	1	80	0.0125000
NODE_82390_length_391_cov_69.510274	9	89	70	2	80	0.0250000
NODE_82390_length_391_cov_69.510274	9	89	72	2	80	0.0250000
NODE_82390_length_391_cov_69.510274	9	89	74	1	80	0.0125000
NODE_82390_length_391_cov_69.510274	9	89	78	1	80	0.0125000
NODE_82390_length_391_cov_69.510274	9	89	80	2	80	0.0250000
NODE_82390_length_391_cov_69.510274	9	89	83	1	80	0.0125000
NODE_82390_length_391_cov_69.510274	9	89	85	1	80	0.0125000
NODE_82390_length_391_cov_69.510274	9	89	92	2	80	0.0250000
NODE_82390_length_391_cov_69.510274	9	89	94	4	80	0.0500000
NODE_82390_length_391_cov_69.510274	9	89	100	1	80	0.0125000
NODE_82390_length_391_cov_69.510274	9	89	103	1	80	0.0125000
NODE_82390_length_391_cov_69.510274	9	89	105	1	80	0.0125000
NODE_82390_length_391_cov_69.510274	9	89	107	1	80	0.0125000
NODE_82390_length_391_cov_69.510274	9	89	111	1	80	0.0125000
NODE_82390_length_391_cov_69.510274	9	89	113	1	80	0.0125000
NODE_82390_length_391_cov_69.510274	9	89	119	1	80	0.0125000
NODE_82390_length_391_cov_69.510274	9	89	121	1	80	0.0125000
NODE_82390_length_391_cov_69.510274	9	89	125	2	80	0.0250000
NODE_82390_length_391_cov_69.510274	9	89	127	1	80	0.0125000
NODE_82390_length_391_cov_69.510274	9	89	129	1	80	0.0125000
NODE_82390_length_391_cov_69.510274	9	89	135	2	80	0.0250000
NODE_82390_length_391_cov_69.510274	9	89	142	1	80	0.0125000
NODE_82390_length_391_cov_69.510274	9	89	144	1	80	0.0125000
NODE_82390_length_391_cov_69.510274	9	89	150	2	80	0.0250000
NODE_82390_length_391_cov_69.510274	9	89	161	2	80	0.0250000
NODE_82390_length_391_cov_69.510274	9	89	165	2	80	0.0250000
NODE_82390_length_391_cov_69.510274	9	89	173	1	80	0.0125000
NODE_82390_length_391_cov_69.510274	9	89	177	1	80	0.0125000
NODE_82390_length_391_cov_69.510274	9	89	179	2	80	0.0250000
NODE_82390_length_391_cov_69.510274	9	89	181	1	80	0.0125000
NODE_82390_length_391_cov_69.510274	9	89	183	3	80	0.0375000
NODE_82390_length_391_cov_69.510274	9	89	185	2	80	0.0250000
NODE_82390_length_391_cov_69.510274	9	89	191	1	80	0.0125000
NODE_82390_length_391_cov_69.510274	9	89	192	2	80	0.0250000
NODE_82390_length_391_cov_69.510274	9	89	194	1	80	0.0125000
NODE_82390_length_391_cov_69.510274	9	89	196	2	80	0.0250000
NODE_82390_length_391_cov_69.510274	9	89	200	1	80	0.0125000
NODE_82390_length_391_cov_69.510274	9	89	202	1	80	0.0125000
NODE_82390_length_391_cov_69.510274	9	89	204	1	80	0.0125000
NODE_82390_length_391_cov_69.510274	9	89	206	1	80	0.0125000
NODE_82390_length_391_cov_69.510274	9	89	212	1	80	0.0125000
NODE_82390_length_391_cov_69.510274	9	89	213	1	80	0.0125000
NODE_82390_length_391_cov_69.510274	9	89	215	2	80	0.0250000
NODE_82390_length_391_cov_69.510274	9	89	217	4	80	0.0500000
NODE_82390_length_391_cov_69.510274	9	89	219	2	80	0.0250000
NODE_82390_length_391_cov_69.510274	9	89	221	1	80	0.0125000
NODE_82390_length_391_cov_69.510274	9	89	223	3	80	0.0375000
NODE_82390_length_391_cov_69.510274	9	89	227	1	80	0.0125000
NODE_82390_length_391_cov_69.510274	9	89	228	1	80	0.0125000
NODE_82391_length_391_cov_39.414384	0	66	4	9	66	0.1363636
NODE_82391_length_391_cov_39.414384	0	66	6	3	66	0.0454545
NODE_82391_length_391_cov_39.414384	0	66	8	11	66	0.1666667
NODE_82391_length_391_cov_39.414384	0	66	11	2	66	0.0303030
NODE_82391_length_391_cov_39.414384	0	66	12	5	66	0.0757576
NODE_82391_length_391_cov_39.414384	0	66	16	23	66	0.3484848
NODE_82391_length_391_cov_39.414384	0	66	18	1	66	0.0151515
NODE_82391_length_391_cov_39.414384	0	66	20	7	66	0.1060606
NODE_82391_length_391_cov_39.414384	0	66	22	5	66	0.0757576
NODE_82391_length_391_cov_39.414384	0	71	4	9	71	0.1267606
NODE_82391_length_391_cov_39.414384	0	71	6	3	71	0.0422535
NODE_82391_length_391_cov_39.414384	0	71	8	11	71	0.1549296
NODE_82391_length_391_cov_39.414384	0	71	11	2	71	0.0281690
NODE_82391_length_391_cov_39.414384	0	71	12	5	71	0.0704225
NODE_82391_length_391_cov_39.414384	0	71	16	23	71	0.3239437
NODE_82391_length_391_cov_39.414384	0	71	18	1	71	0.0140845
NODE_82391_length_391_cov_39.414384	0	71	20	7	71	0.0985916
NODE_82391_length_391_cov_39.414384	0	71	22	10	71	0.1408451
NODE_82391_length_391_cov_39.414384	44	124	16	9	80	0.1125000
NODE_82391_length_391_cov_39.414384	44	124	18	1	80	0.0125000
NODE_82391_length_391_cov_39.414384	44	124	20	9	80	0.1125000
NODE_82391_length_391_cov_39.414384	44	124	22	20	80	0.2500000
NODE_82391_length_391_cov_39.414384	44	124	24	8	80	0.1000000
NODE_82391_length_391_cov_39.414384	44	124	26	33	80	0.4125000
NODE_82394_length_391_cov_10.352740	156	235	0	79	79	1.0000000
NODE_82415_length_391_cov_5.030822	85	166	4	10	81	0.1234568
NODE_82415_length_391_cov_5.030822	85	166	10	2	81	0.0246914
NODE_82415_length_391_cov_5.030822	85	166	14	13	81	0.1604938
NODE_82415_length_391_cov_5.030822	85	166	16	23	81	0.2839506
NODE_82415_length_391_cov_5.030822	85	166	18	21	81	0.2592593
NODE_82415_length_391_cov_5.030822	85	166	20	12	81	0.1481481
NODE_82498_length_391_cov_2.660959	267	343	10	1	76	0.0131579
NODE_82498_length_391_cov_2.660959	267	343	11	1	76	0.0131579
NODE_82498_length_391_cov_2.660959	267	343	13	4	76	0.0526316
NODE_82498_length_391_cov_2.660959	267	343	15	1	76	0.0131579
NODE_82498_length_391_cov_2.660959	267	343	16	1	76	0.0131579
NODE_82498_length_391_cov_2.660959	267	343	18	68	76	0.8947368
NODE_82552_length_391_cov_2.089041	176	256	8	80	80	1.0000000
NODE_82552_length_391_cov_2.089041	229	280	0	19	51	0.3725490
NODE_82552_length_391_cov_2.089041	229	280	2	2	51	0.0392157
NODE_82552_length_391_cov_2.089041	229	280	4	2	51	0.0392157
NODE_82552_length_391_cov_2.089041	229	280	8	28	51	0.5490196
NODE_82574_length_391_cov_1.907534	200	257	0	57	57	1.0000000
NODE_82597_length_391_cov_1.773973	160	190	0	30	30	1.0000000
NODE_82632_length_391_cov_1.647260	298	378	0	80	80	1.0000000
NODE_82662_length_391_cov_1.561644	241	261	0	20	20	1.0000000
NODE_83015_length_390_cov_29.030928	86	166	2	20	80	0.2500000
NODE_83015_length_390_cov_29.030928	86	166	4	10	80	0.1250000
NODE_83015_length_390_cov_29.030928	86	166	12	9	80	0.1125000
NODE_83015_length_390_cov_29.030928	86	166	14	41	80	0.5125000
NODE_83015_length_390_cov_29.030928	139	219	0	1	80	0.0125000
NODE_83015_length_390_cov_29.030928	139	219	8	1	80	0.0125000
NODE_83015_length_390_cov_29.030928	139	219	10	8	80	0.1000000
NODE_83015_length_390_cov_29.030928	139	219	12	45	80	0.5625000
NODE_83015_length_390_cov_29.030928	139	219	14	25	80	0.3125000
NODE_83016_length_390_cov_22.319588	118	198	0	80	80	1.0000000
NODE_83016_length_390_cov_22.319588	171	251	0	80	80	1.0000000
NODE_83044_length_390_cov_4.481100	208	277	0	69	69	1.0000000
NODE_83044_length_390_cov_4.481100	286	327	2	41	41	1.0000000
NODE_83045_length_390_cov_4.481100	93	171	8	2	78	0.0256410
NODE_83045_length_390_cov_4.481100	93	171	10	14	78	0.1794872
NODE_83045_length_390_cov_4.481100	93	171	12	43	78	0.5512820
NODE_83045_length_390_cov_4.481100	93	171	14	19	78	0.2435897
NODE_83045_length_390_cov_4.481100	144	210	0	3	66	0.0454545
NODE_83045_length_390_cov_4.481100	144	210	2	1	66	0.0151515
NODE_83045_length_390_cov_4.481100	144	210	4	8	66	0.1212121
NODE_83045_length_390_cov_4.481100	144	210	6	6	66	0.0909091
NODE_83045_length_390_cov_4.481100	144	210	10	29	66	0.4393939
NODE_83045_length_390_cov_4.481100	144	210	14	19	66	0.2878788
NODE_83060_length_390_cov_3.814433	66	99	0	33	33	1.0000000
NODE_83061_length_390_cov_3.783505	188	268	0	36	80	0.4500000
NODE_83061_length_390_cov_3.783505	188	268	2	44	80	0.5500000
NODE_83061_length_390_cov_3.783505	241	321	2	57	80	0.7125000
NODE_83061_length_390_cov_3.783505	241	321	4	23	80	0.2875000
NODE_83066_length_390_cov_3.560137	304	367	2	63	63	1.0000000
NODE_83066_length_390_cov_3.560137	340	381	0	8	41	0.1951219
NODE_83066_length_390_cov_3.560137	340	381	2	33	41	0.8048781
NODE_83169_length_390_cov_2.127148	242	322	4	6	80	0.0750000
NODE_83169_length_390_cov_2.127148	242	322	6	1	80	0.0125000
NODE_83169_length_390_cov_2.127148	242	322	8	9	80	0.1125000
NODE_83169_length_390_cov_2.127148	242	322	10	6	80	0.0750000
NODE_83169_length_390_cov_2.127148	242	322	12	2	80	0.0250000
NODE_83169_length_390_cov_2.127148	242	322	14	56	80	0.7000000
NODE_83171_length_390_cov_2.123711	133	177	0	4	44	0.0909091
NODE_83171_length_390_cov_2.123711	133	177	2	8	44	0.1818182
NODE_83171_length_390_cov_2.123711	133	177	4	2	44	0.0454545
NODE_83171_length_390_cov_2.123711	133	177	6	3	44	0.0681818
NODE_83171_length_390_cov_2.123711	133	177	8	7	44	0.1590909
NODE_83171_length_390_cov_2.123711	133	177	10	10	44	0.2272727
NODE_83171_length_390_cov_2.123711	133	177	12	4	44	0.0909091
NODE_83171_length_390_cov_2.123711	133	177	14	6	44	0.1363636
NODE_83171_length_390_cov_2.123711	157	237	10	10	80	0.1250000
NODE_83171_length_390_cov_2.123711	157	237	12	4	80	0.0500000
NODE_83171_length_390_cov_2.123711	157	237	14	6	80	0.0750000
NODE_83171_length_390_cov_2.123711	157	237	16	2	80	0.0250000
NODE_83171_length_390_cov_2.123711	157	237	20	3	80	0.0375000
NODE_83171_length_390_cov_2.123711	157	237	22	55	80	0.6875000
NODE_83288_length_390_cov_1.536082	223	276	0	53	53	1.0000000
NODE_83338_length_390_cov_1.398625	49	110	57	1	61	0.0163934
NODE_83338_length_390_cov_1.398625	49	110	59	1	61	0.0163934
NODE_83338_length_390_cov_1.398625	49	110	63	4	61	0.0655738
NODE_83338_length_390_cov_1.398625	49	110	71	2	61	0.0327869
NODE_83338_length_390_cov_1.398625	49	110	73	3	61	0.0491803
NODE_83338_length_390_cov_1.398625	49	110	75	1	61	0.0163934
NODE_83338_length_390_cov_1.398625	49	110	81	1	61	0.0163934
NODE_83338_length_390_cov_1.398625	49	110	85	1	61	0.0163934
NODE_83338_length_390_cov_1.398625	49	110	93	1	61	0.0163934
NODE_83338_length_390_cov_1.398625	49	110	95	3	61	0.0491803
NODE_83338_length_390_cov_1.398625	49	110	101	8	61	0.1311475
NODE_83338_length_390_cov_1.398625	49	110	109	1	61	0.0163934
NODE_83338_length_390_cov_1.398625	49	110	113	3	61	0.0491803
NODE_83338_length_390_cov_1.398625	49	110	114	1	61	0.0163934
NODE_83338_length_390_cov_1.398625	49	110	116	4	61	0.0655738
NODE_83338_length_390_cov_1.398625	49	110	117	4	61	0.0655738
NODE_83338_length_390_cov_1.398625	49	110	119	2	61	0.0327869
NODE_83338_length_390_cov_1.398625	49	110	121	3	61	0.0491803
NODE_83338_length_390_cov_1.398625	49	110	125	12	61	0.1967213
NODE_83338_length_390_cov_1.398625	49	110	127	5	61	0.0819672
NODE_83463_length_390_cov_1.034364	78	158	0	21	80	0.2625000
NODE_83463_length_390_cov_1.034364	78	158	2	59	80	0.7375000
NODE_83633_length_389_cov_63.710345	32	112	0	80	80	1.0000000
NODE_83633_length_389_cov_63.710345	85	165	0	80	80	1.0000000
NODE_83633_length_389_cov_63.710345	161	241	0	80	80	1.0000000
NODE_83633_length_389_cov_63.710345	214	294	0	80	80	1.0000000
NODE_83650_length_389_cov_5.382759	154	234	0	80	80	1.0000000
NODE_83662_length_389_cov_4.468966	199	269	0	47	70	0.6714286
NODE_83662_length_389_cov_4.468966	199	269	4	23	70	0.3285714
NODE_83663_length_389_cov_4.424138	68	148	60	2	80	0.0250000
NODE_83663_length_389_cov_4.424138	68	148	62	12	80	0.1500000
NODE_83663_length_389_cov_4.424138	68	148	64	1	80	0.0125000
NODE_83663_length_389_cov_4.424138	68	148	66	2	80	0.0250000
NODE_83663_length_389_cov_4.424138	68	148	67	2	80	0.0250000
NODE_83663_length_389_cov_4.424138	68	148	68	3	80	0.0375000
NODE_83663_length_389_cov_4.424138	68	148	70	5	80	0.0625000
NODE_83663_length_389_cov_4.424138	68	148	72	6	80	0.0750000
NODE_83663_length_389_cov_4.424138	68	148	74	3	80	0.0375000
NODE_83663_length_389_cov_4.424138	68	148	76	11	80	0.1375000
NODE_83663_length_389_cov_4.424138	68	148	78	28	80	0.3500000
NODE_83663_length_389_cov_4.424138	68	148	80	5	80	0.0625000
NODE_83685_length_389_cov_3.782759	194	225	0	31	31	1.0000000
NODE_83689_length_389_cov_3.555172	107	153	0	46	46	1.0000000
NODE_83695_length_389_cov_3.251724	120	163	0	3	43	0.0697674
NODE_83695_length_389_cov_3.251724	120	163	2	40	43	0.9302326
NODE_83695_length_389_cov_3.251724	136	206	2	70	70	1.0000000
NODE_83816_length_389_cov_1.951724	68	148	0	80	80	1.0000000
NODE_83819_length_389_cov_1.937931	53	82	2	29	29	1.0000000
NODE_83819_length_389_cov_1.937931	153	233	8	5	80	0.0625000
NODE_83819_length_389_cov_1.937931	153	233	10	26	80	0.3250000
NODE_83819_length_389_cov_1.937931	153	233	12	9	80	0.1125000
NODE_83819_length_389_cov_1.937931	153	233	14	25	80	0.3125000
NODE_83819_length_389_cov_1.937931	153	233	16	15	80	0.1875000
NODE_83829_length_389_cov_1.920690	296	365	2	45	69	0.6521739
NODE_83829_length_389_cov_1.920690	296	365	4	24	69	0.3478261
NODE_84182_length_389_cov_0.720690	294	374	2	6	80	0.0750000
NODE_84182_length_389_cov_0.720690	294	374	4	74	80	0.9250000
NODE_84267_length_388_cov_9.179931	47	127	0	80	80	1.0000000
NODE_84267_length_388_cov_9.179931	100	180	0	80	80	1.0000000
NODE_84270_length_388_cov_7.249135	171	251	0	80	80	1.0000000
NODE_84270_length_388_cov_7.249135	224	304	0	80	80	1.0000000
NODE_84305_length_388_cov_3.913495	151	231	0	48	80	0.6000000
NODE_84305_length_388_cov_3.913495	151	231	2	5	80	0.0625000
NODE_84305_length_388_cov_3.913495	151	231	4	27	80	0.3375000
NODE_84308_length_388_cov_3.809689	233	277	0	44	44	1.0000000
NODE_84332_length_388_cov_3.103806	101	166	0	65	65	1.0000000
NODE_84332_length_388_cov_3.103806	147	227	0	80	80	1.0000000
NODE_84334_length_388_cov_3.041522	48	128	0	80	80	1.0000000
NODE_84410_length_388_cov_2.114187	82	141	0	59	59	1.0000000
NODE_84410_length_388_cov_2.114187	135	194	0	59	59	1.0000000
NODE_84423_length_388_cov_2.017301	99	151	0	52	52	1.0000000
NODE_84427_length_388_cov_1.989619	0	76	0	6	76	0.0789474
NODE_84427_length_388_cov_1.989619	0	76	2	70	76	0.9210526
NODE_84427_length_388_cov_1.989619	49	114	0	25	65	0.3846154
NODE_84427_length_388_cov_1.989619	49	114	2	40	65	0.6153846
NODE_84587_length_388_cov_1.352941	172	247	0	7	75	0.0933333
NODE_84587_length_388_cov_1.352941	172	247	2	68	75	0.9066667
NODE_84631_length_388_cov_1.228374	308	339	0	31	31	1.0000000
NODE_84885_length_387_cov_33.052083	194	274	0	1	80	0.0125000
NODE_84885_length_387_cov_33.052083	194	274	2	20	80	0.2500000
NODE_84885_length_387_cov_33.052083	194	274	4	59	80	0.7375000
NODE_84885_length_387_cov_33.052083	247	327	0	19	80	0.2375000
NODE_84885_length_387_cov_33.052083	247	327	1	8	80	0.1000000
NODE_84885_length_387_cov_33.052083	247	327	2	9	80	0.1125000
NODE_84885_length_387_cov_33.052083	247	327	4	44	80	0.5500000
NODE_84890_length_387_cov_6.871528	26	106	0	27	80	0.3375000
NODE_84890_length_387_cov_6.871528	26	106	2	53	80	0.6625000
NODE_84890_length_387_cov_6.871528	79	159	0	9	80	0.1125000
NODE_84890_length_387_cov_6.871528	79	159	2	71	80	0.8875000
NODE_84902_length_387_cov_5.420139	286	341	2	27	55	0.4909091
NODE_84902_length_387_cov_5.420139	286	341	4	28	55	0.5090909
NODE_84946_length_387_cov_3.364583	287	367	0	80	80	1.0000000
NODE_85007_length_387_cov_2.260417	140	210	2	48	70	0.6857143
NODE_85007_length_387_cov_2.260417	140	210	4	22	70	0.3142857
NODE_85019_length_387_cov_2.128472	220	286	0	66	66	1.0000000
NODE_85019_length_387_cov_2.128472	273	329	0	56	56	1.0000000
NODE_85032_length_387_cov_2.090278	318	352	0	34	34	1.0000000
NODE_85037_length_387_cov_2.055556	23	45	0	22	22	1.0000000
NODE_85047_length_387_cov_1.979167	259	316	0	57	57	1.0000000
NODE_85047_length_387_cov_1.979167	312	369	0	57	57	1.0000000
NODE_85091_length_387_cov_1.770833	315	361	0	14	46	0.3043478
NODE_85091_length_387_cov_1.770833	315	361	1	5	46	0.1086956
NODE_85091_length_387_cov_1.770833	315	361	6	2	46	0.0434783
NODE_85091_length_387_cov_1.770833	315	361	8	1	46	0.0217391
NODE_85091_length_387_cov_1.770833	315	361	10	1	46	0.0217391
NODE_85091_length_387_cov_1.770833	315	361	12	7	46	0.1521739
NODE_85091_length_387_cov_1.770833	315	361	14	16	46	0.3478261
NODE_85528_length_386_cov_9.979094	38	118	0	80	80	1.0000000
NODE_85528_length_386_cov_9.979094	91	174	0	31	83	0.3734940
NODE_85528_length_386_cov_9.979094	91	174	10	52	83	0.6265060
NODE_85546_length_386_cov_4.428571	197	249	2	52	52	1.0000000
NODE_85570_length_386_cov_3.355401	151	231	0	80	80	1.0000000
NODE_85570_length_386_cov_3.355401	204	265	0	61	61	1.0000000
NODE_85602_length_386_cov_2.686411	293	325	0	32	32	1.0000000
NODE_85602_length_386_cov_2.686411	349	379	0	30	30	1.0000000
NODE_85629_length_386_cov_2.442509	55	135	0	20	80	0.2500000
NODE_85629_length_386_cov_2.442509	55	135	2	60	80	0.7500000
NODE_85629_length_386_cov_2.442509	108	164	2	56	56	1.0000000
NODE_85793_length_386_cov_1.494774	79	121	4	22	42	0.5238096
NODE_85793_length_386_cov_1.494774	79	121	6	20	42	0.4761905
NODE_85793_length_386_cov_1.494774	93	156	4	8	63	0.1269841
NODE_85793_length_386_cov_1.494774	93	156	6	36	63	0.5714286
NODE_85793_length_386_cov_1.494774	93	156	8	19	63	0.3015873
NODE_85816_length_386_cov_1.421603	160	236	0	43	76	0.5657895
NODE_85816_length_386_cov_1.421603	160	236	1	12	76	0.1578947
NODE_85816_length_386_cov_1.421603	160	236	2	21	76	0.2763158
NODE_85845_length_386_cov_1.372822	62	142	0	80	80	1.0000000
NODE_85845_length_386_cov_1.372822	115	195	0	74	80	0.9250000
NODE_85845_length_386_cov_1.372822	115	195	2	6	80	0.0750000
NODE_85858_length_386_cov_1.317073	124	161	19	3	37	0.0810811
NODE_85858_length_386_cov_1.317073	124	161	21	1	37	0.0270270
NODE_85858_length_386_cov_1.317073	124	161	22	33	37	0.8918919
NODE_85902_length_386_cov_1.170732	260	308	4	41	48	0.8541667
NODE_85902_length_386_cov_1.170732	260	308	6	3	48	0.0625000
NODE_85902_length_386_cov_1.170732	260	308	8	4	48	0.0833333
NODE_86143_length_385_cov_167.877622	103	164	199	1	61	0.0163934
NODE_86143_length_385_cov_167.877622	103	164	205	1	61	0.0163934
NODE_86143_length_385_cov_167.877622	103	164	208	1	61	0.0163934
NODE_86143_length_385_cov_167.877622	103	164	213	2	61	0.0327869
NODE_86143_length_385_cov_167.877622	103	164	214	1	61	0.0163934
NODE_86143_length_385_cov_167.877622	103	164	215	3	61	0.0491803
NODE_86143_length_385_cov_167.877622	103	164	216	4	61	0.0655738
NODE_86143_length_385_cov_167.877622	103	164	219	3	61	0.0491803
NODE_86143_length_385_cov_167.877622	103	164	220	4	61	0.0655738
NODE_86143_length_385_cov_167.877622	103	164	221	3	61	0.0491803
NODE_86143_length_385_cov_167.877622	103	164	229	2	61	0.0327869
NODE_86143_length_385_cov_167.877622	103	164	231	2	61	0.0327869
NODE_86143_length_385_cov_167.877622	103	164	233	1	61	0.0163934
NODE_86143_length_385_cov_167.877622	103	164	242	1	61	0.0163934
NODE_86143_length_385_cov_167.877622	103	164	248	5	61	0.0819672
NODE_86143_length_385_cov_167.877622	103	164	249	2	61	0.0327869
NODE_86143_length_385_cov_167.877622	103	164	252	3	61	0.0491803
NODE_86143_length_385_cov_167.877622	103	164	254	2	61	0.0327869
NODE_86143_length_385_cov_167.877622	103	164	255	7	61	0.1147541
NODE_86143_length_385_cov_167.877622	103	164	257	5	61	0.0819672
NODE_86143_length_385_cov_167.877622	103	164	258	2	61	0.0327869
NODE_86143_length_385_cov_167.877622	103	164	259	1	61	0.0163934
NODE_86143_length_385_cov_167.877622	103	164	260	1	61	0.0163934
NODE_86143_length_385_cov_167.877622	103	164	261	2	61	0.0327869
NODE_86143_length_385_cov_167.877622	103	164	263	1	61	0.0163934
NODE_86143_length_385_cov_167.877622	103	164	264	1	61	0.0163934
NODE_86144_length_385_cov_38.695804	164	244	0	80	80	1.0000000
NODE_86144_length_385_cov_38.695804	217	297	0	80	80	1.0000000
NODE_86169_length_385_cov_4.335664	173	250	0	50	77	0.6493506
NODE_86169_length_385_cov_4.335664	173	250	2	17	77	0.2207792
NODE_86169_length_385_cov_4.335664	173	250	4	10	77	0.1298701
NODE_86185_length_385_cov_3.793706	215	297	0	50	82	0.6097561
NODE_86185_length_385_cov_3.793706	215	297	2	32	82	0.3902439
NODE_86230_length_385_cov_2.786713	99	179	4	29	80	0.3625000
NODE_86230_length_385_cov_2.786713	99	179	6	7	80	0.0875000
NODE_86230_length_385_cov_2.786713	99	179	7	1	80	0.0125000
NODE_86230_length_385_cov_2.786713	99	179	8	4	80	0.0500000
NODE_86230_length_385_cov_2.786713	99	179	9	3	80	0.0375000
NODE_86230_length_385_cov_2.786713	99	179	10	12	80	0.1500000
NODE_86230_length_385_cov_2.786713	99	179	11	24	80	0.3000000
NODE_86230_length_385_cov_2.786713	152	232	0	44	80	0.5500000
NODE_86230_length_385_cov_2.786713	152	232	4	36	80	0.4500000
NODE_86230_length_385_cov_2.786713	281	362	0	81	81	1.0000000
NODE_86448_length_385_cov_1.381119	71	145	0	48	74	0.6486486
NODE_86448_length_385_cov_1.381119	71	145	2	3	74	0.0405405
NODE_86448_length_385_cov_1.381119	71	145	4	5	74	0.0675676
NODE_86448_length_385_cov_1.381119	71	145	6	18	74	0.2432432
NODE_86448_length_385_cov_1.381119	118	198	0	1	80	0.0125000
NODE_86448_length_385_cov_1.381119	118	198	2	3	80	0.0375000
NODE_86448_length_385_cov_1.381119	118	198	4	5	80	0.0625000
NODE_86448_length_385_cov_1.381119	118	198	6	27	80	0.3375000
NODE_86448_length_385_cov_1.381119	118	198	8	8	80	0.1000000
NODE_86448_length_385_cov_1.381119	118	198	10	1	80	0.0125000
NODE_86448_length_385_cov_1.381119	118	198	12	1	80	0.0125000
NODE_86448_length_385_cov_1.381119	118	198	16	31	80	0.3875000
NODE_86448_length_385_cov_1.381119	118	198	18	3	80	0.0375000
NODE_86798_length_384_cov_3.996491	135	217	2	38	82	0.4634146
NODE_86798_length_384_cov_3.996491	135	217	4	24	82	0.2926829
NODE_86798_length_384_cov_3.996491	135	217	6	20	82	0.2439024
NODE_86809_length_384_cov_3.729825	181	228	4	29	47	0.6170213
NODE_86809_length_384_cov_3.729825	181	228	6	14	47	0.2978723
NODE_86809_length_384_cov_3.729825	181	228	12	4	47	0.0851064
NODE_86812_length_384_cov_3.715789	145	221	0	17	76	0.2236842
NODE_86812_length_384_cov_3.715789	145	221	2	54	76	0.7105263
NODE_86812_length_384_cov_3.715789	145	221	6	5	76	0.0657895
NODE_86841_length_384_cov_2.996491	147	227	2	10	80	0.1250000
NODE_86841_length_384_cov_2.996491	147	227	4	15	80	0.1875000
NODE_86841_length_384_cov_2.996491	147	227	6	5	80	0.0625000
NODE_86841_length_384_cov_2.996491	147	227	8	7	80	0.0875000
NODE_86841_length_384_cov_2.996491	147	227	10	6	80	0.0750000
NODE_86841_length_384_cov_2.996491	147	227	12	3	80	0.0375000
NODE_86841_length_384_cov_2.996491	147	227	14	5	80	0.0625000
NODE_86841_length_384_cov_2.996491	147	227	16	1	80	0.0125000
NODE_86841_length_384_cov_2.996491	147	227	18	6	80	0.0750000
NODE_86841_length_384_cov_2.996491	147	227	20	22	80	0.2750000
NODE_86847_length_384_cov_2.835088	65	145	4	22	80	0.2750000
NODE_86847_length_384_cov_2.835088	65	145	6	8	80	0.1000000
NODE_86847_length_384_cov_2.835088	65	145	8	1	80	0.0125000
NODE_86847_length_384_cov_2.835088	65	145	10	8	80	0.1000000
NODE_86847_length_384_cov_2.835088	65	145	12	3	80	0.0375000
NODE_86847_length_384_cov_2.835088	65	145	14	9	80	0.1125000
NODE_86847_length_384_cov_2.835088	65	145	16	11	80	0.1375000
NODE_86847_length_384_cov_2.835088	65	145	18	18	80	0.2250000
NODE_86866_length_384_cov_2.575439	151	224	16	4	73	0.0547945
NODE_86866_length_384_cov_2.575439	151	224	18	20	73	0.2739726
NODE_86866_length_384_cov_2.575439	151	224	20	6	73	0.0821918
NODE_86866_length_384_cov_2.575439	151	224	22	11	73	0.1506849
NODE_86866_length_384_cov_2.575439	151	224	24	32	73	0.4383562
NODE_86866_length_384_cov_2.575439	197	281	0	13	84	0.1547619
NODE_86866_length_384_cov_2.575439	197	281	2	5	84	0.0595238
NODE_86866_length_384_cov_2.575439	197	281	4	4	84	0.0476190
NODE_86866_length_384_cov_2.575439	197	281	6	2	84	0.0238095
NODE_86866_length_384_cov_2.575439	197	281	10	13	84	0.1547619
NODE_86866_length_384_cov_2.575439	197	281	11	1	84	0.0119048
NODE_86866_length_384_cov_2.575439	197	281	12	3	84	0.0357143
NODE_86866_length_384_cov_2.575439	197	281	14	12	84	0.1428571
NODE_86866_length_384_cov_2.575439	197	281	16	2	84	0.0238095
NODE_86866_length_384_cov_2.575439	197	281	18	20	84	0.2380952
NODE_86866_length_384_cov_2.575439	197	281	20	2	84	0.0238095
NODE_86866_length_384_cov_2.575439	197	281	22	7	84	0.0833333
NODE_86907_length_384_cov_2.231579	78	153	0	75	75	1.0000000
NODE_86942_length_384_cov_1.940351	73	153	0	80	80	1.0000000
NODE_87431_length_383_cov_4.869718	117	197	0	45	80	0.5625000
NODE_87431_length_383_cov_4.869718	117	197	2	35	80	0.4375000
NODE_87431_length_383_cov_4.869718	170	250	2	80	80	1.0000000
NODE_87432_length_383_cov_4.841549	121	180	0	59	59	1.0000000
NODE_87438_length_383_cov_4.559859	33	109	0	50	76	0.6578947
NODE_87438_length_383_cov_4.559859	33	109	2	26	76	0.3421053
NODE_87487_length_383_cov_2.940141	185	265	0	70	80	0.8750000
NODE_87487_length_383_cov_2.940141	185	265	2	10	80	0.1250000
NODE_87495_length_383_cov_2.760563	123	203	336	1	80	0.0125000
NODE_87495_length_383_cov_2.760563	123	203	344	1	80	0.0125000
NODE_87495_length_383_cov_2.760563	123	203	349	1	80	0.0125000
NODE_87495_length_383_cov_2.760563	123	203	356	1	80	0.0125000
NODE_87495_length_383_cov_2.760563	123	203	357	1	80	0.0125000
NODE_87495_length_383_cov_2.760563	123	203	358	1	80	0.0125000
NODE_87495_length_383_cov_2.760563	123	203	363	2	80	0.0250000
NODE_87495_length_383_cov_2.760563	123	203	365	1	80	0.0125000
NODE_87495_length_383_cov_2.760563	123	203	367	1	80	0.0125000
NODE_87495_length_383_cov_2.760563	123	203	368	1	80	0.0125000
NODE_87495_length_383_cov_2.760563	123	203	369	1	80	0.0125000
NODE_87495_length_383_cov_2.760563	123	203	371	1	80	0.0125000
NODE_87495_length_383_cov_2.760563	123	203	373	1	80	0.0125000
NODE_87495_length_383_cov_2.760563	123	203	376	1	80	0.0125000
NODE_87495_length_383_cov_2.760563	123	203	377	3	80	0.0375000
NODE_87495_length_383_cov_2.760563	123	203	380	1	80	0.0125000
NODE_87495_length_383_cov_2.760563	123	203	381	1	80	0.0125000
NODE_87495_length_383_cov_2.760563	123	203	382	1	80	0.0125000
NODE_87495_length_383_cov_2.760563	123	203	392	1	80	0.0125000
NODE_87495_length_383_cov_2.760563	123	203	394	4	80	0.0500000
NODE_87495_length_383_cov_2.760563	123	203	397	2	80	0.0250000
NODE_87495_length_383_cov_2.760563	123	203	400	1	80	0.0125000
NODE_87495_length_383_cov_2.760563	123	203	401	1	80	0.0125000
NODE_87495_length_383_cov_2.760563	123	203	402	1	80	0.0125000
NODE_87495_length_383_cov_2.760563	123	203	403	1	80	0.0125000
NODE_87495_length_383_cov_2.760563	123	203	405	3	80	0.0375000
NODE_87495_length_383_cov_2.760563	123	203	411	1	80	0.0125000
NODE_87495_length_383_cov_2.760563	123	203	412	1	80	0.0125000
NODE_87495_length_383_cov_2.760563	123	203	417	1	80	0.0125000
NODE_87495_length_383_cov_2.760563	123	203	419	1	80	0.0125000
NODE_87495_length_383_cov_2.760563	123	203	420	1	80	0.0125000
NODE_87495_length_383_cov_2.760563	123	203	422	2	80	0.0250000
NODE_87495_length_383_cov_2.760563	123	203	423	1	80	0.0125000
NODE_87495_length_383_cov_2.760563	123	203	424	1	80	0.0125000
NODE_87495_length_383_cov_2.760563	123	203	430	1	80	0.0125000
NODE_87495_length_383_cov_2.760563	123	203	431	1	80	0.0125000
NODE_87495_length_383_cov_2.760563	123	203	432	1	80	0.0125000
NODE_87495_length_383_cov_2.760563	123	203	434	2	80	0.0250000
NODE_87495_length_383_cov_2.760563	123	203	436	1	80	0.0125000
NODE_87495_length_383_cov_2.760563	123	203	440	1	80	0.0125000
NODE_87495_length_383_cov_2.760563	123	203	442	2	80	0.0250000
NODE_87495_length_383_cov_2.760563	123	203	443	1	80	0.0125000
NODE_87495_length_383_cov_2.760563	123	203	445	2	80	0.0250000
NODE_87495_length_383_cov_2.760563	123	203	447	1	80	0.0125000
NODE_87495_length_383_cov_2.760563	123	203	448	2	80	0.0250000
NODE_87495_length_383_cov_2.760563	123	203	455	2	80	0.0250000
NODE_87495_length_383_cov_2.760563	123	203	456	1	80	0.0125000
NODE_87495_length_383_cov_2.760563	123	203	460	1	80	0.0125000
NODE_87495_length_383_cov_2.760563	123	203	462	1	80	0.0125000
NODE_87495_length_383_cov_2.760563	123	203	466	1	80	0.0125000
NODE_87495_length_383_cov_2.760563	123	203	469	1	80	0.0125000
NODE_87495_length_383_cov_2.760563	123	203	473	1	80	0.0125000
NODE_87495_length_383_cov_2.760563	123	203	476	2	80	0.0250000
NODE_87495_length_383_cov_2.760563	123	203	477	7	80	0.0875000
NODE_87495_length_383_cov_2.760563	123	203	478	1	80	0.0125000
NODE_87495_length_383_cov_2.760563	123	203	479	1	80	0.0125000
NODE_87495_length_383_cov_2.760563	123	203	481	2	80	0.0250000
NODE_87495_length_383_cov_2.760563	169	249	138	1	80	0.0125000
NODE_87495_length_383_cov_2.760563	169	249	145	1	80	0.0125000
NODE_87495_length_383_cov_2.760563	169	249	147	1	80	0.0125000
NODE_87495_length_383_cov_2.760563	169	249	151	1	80	0.0125000
NODE_87495_length_383_cov_2.760563	169	249	162	1	80	0.0125000
NODE_87495_length_383_cov_2.760563	169	249	167	2	80	0.0250000
NODE_87495_length_383_cov_2.760563	169	249	170	3	80	0.0375000
NODE_87495_length_383_cov_2.760563	169	249	174	1	80	0.0125000
NODE_87495_length_383_cov_2.760563	169	249	176	1	80	0.0125000
NODE_87495_length_383_cov_2.760563	169	249	178	3	80	0.0375000
NODE_87495_length_383_cov_2.760563	169	249	184	1	80	0.0125000
NODE_87495_length_383_cov_2.760563	169	249	189	1	80	0.0125000
NODE_87495_length_383_cov_2.760563	169	249	191	1	80	0.0125000
NODE_87495_length_383_cov_2.760563	169	249	196	1	80	0.0125000
NODE_87495_length_383_cov_2.760563	169	249	207	1	80	0.0125000
NODE_87495_length_383_cov_2.760563	169	249	245	1	80	0.0125000
NODE_87495_length_383_cov_2.760563	169	249	246	1	80	0.0125000
NODE_87495_length_383_cov_2.760563	169	249	250	1	80	0.0125000
NODE_87495_length_383_cov_2.760563	169	249	253	1	80	0.0125000
NODE_87495_length_383_cov_2.760563	169	249	274	1	80	0.0125000
NODE_87495_length_383_cov_2.760563	169	249	280	1	80	0.0125000
NODE_87495_length_383_cov_2.760563	169	249	283	1	80	0.0125000
NODE_87495_length_383_cov_2.760563	169	249	284	3	80	0.0375000
NODE_87495_length_383_cov_2.760563	169	249	285	2	80	0.0250000
NODE_87495_length_383_cov_2.760563	169	249	293	1	80	0.0125000
NODE_87495_length_383_cov_2.760563	169	249	299	1	80	0.0125000
NODE_87495_length_383_cov_2.760563	169	249	301	2	80	0.0250000
NODE_87495_length_383_cov_2.760563	169	249	304	1	80	0.0125000
NODE_87495_length_383_cov_2.760563	169	249	305	1	80	0.0125000
NODE_87495_length_383_cov_2.760563	169	249	307	1	80	0.0125000
NODE_87495_length_383_cov_2.760563	169	249	315	3	80	0.0375000
NODE_87495_length_383_cov_2.760563	169	249	319	2	80	0.0250000
NODE_87495_length_383_cov_2.760563	169	249	321	1	80	0.0125000
NODE_87495_length_383_cov_2.760563	169	249	335	1	80	0.0125000
NODE_87495_length_383_cov_2.760563	169	249	336	1	80	0.0125000
NODE_87495_length_383_cov_2.760563	169	249	344	1	80	0.0125000
NODE_87495_length_383_cov_2.760563	169	249	349	1	80	0.0125000
NODE_87495_length_383_cov_2.760563	169	249	358	1	80	0.0125000
NODE_87495_length_383_cov_2.760563	169	249	367	1	80	0.0125000
NODE_87495_length_383_cov_2.760563	169	249	376	1	80	0.0125000
NODE_87495_length_383_cov_2.760563	169	249	381	1	80	0.0125000
NODE_87495_length_383_cov_2.760563	169	249	392	1	80	0.0125000
NODE_87495_length_383_cov_2.760563	169	249	394	2	80	0.0250000
NODE_87495_length_383_cov_2.760563	169	249	402	1	80	0.0125000
NODE_87495_length_383_cov_2.760563	169	249	405	3	80	0.0375000
NODE_87495_length_383_cov_2.760563	169	249	412	1	80	0.0125000
NODE_87495_length_383_cov_2.760563	169	249	420	1	80	0.0125000
NODE_87495_length_383_cov_2.760563	169	249	422	1	80	0.0125000
NODE_87495_length_383_cov_2.760563	169	249	431	1	80	0.0125000
NODE_87495_length_383_cov_2.760563	169	249	432	1	80	0.0125000
NODE_87495_length_383_cov_2.760563	169	249	442	1	80	0.0125000
NODE_87495_length_383_cov_2.760563	169	249	443	1	80	0.0125000
NODE_87495_length_383_cov_2.760563	169	249	445	1	80	0.0125000
NODE_87495_length_383_cov_2.760563	169	249	448	2	80	0.0250000
NODE_87495_length_383_cov_2.760563	169	249	455	1	80	0.0125000
NODE_87495_length_383_cov_2.760563	169	249	460	1	80	0.0125000
NODE_87495_length_383_cov_2.760563	169	249	466	1	80	0.0125000
NODE_87495_length_383_cov_2.760563	169	249	469	1	80	0.0125000
NODE_87495_length_383_cov_2.760563	169	249	476	1	80	0.0125000
NODE_87495_length_383_cov_2.760563	169	249	477	5	80	0.0625000
NODE_87495_length_383_cov_2.760563	222	302	6	8	80	0.1000000
NODE_87495_length_383_cov_2.760563	222	302	8	2	80	0.0250000
NODE_87495_length_383_cov_2.760563	222	302	10	7	80	0.0875000
NODE_87495_length_383_cov_2.760563	222	302	12	7	80	0.0875000
NODE_87495_length_383_cov_2.760563	222	302	14	2	80	0.0250000
NODE_87495_length_383_cov_2.760563	222	302	20	5	80	0.0625000
NODE_87495_length_383_cov_2.760563	222	302	22	1	80	0.0125000
NODE_87495_length_383_cov_2.760563	222	302	32	1	80	0.0125000
NODE_87495_length_383_cov_2.760563	222	302	40	1	80	0.0125000
NODE_87495_length_383_cov_2.760563	222	302	50	3	80	0.0375000
NODE_87495_length_383_cov_2.760563	222	302	52	1	80	0.0125000
NODE_87495_length_383_cov_2.760563	222	302	54	1	80	0.0125000
NODE_87495_length_383_cov_2.760563	222	302	59	1	80	0.0125000
NODE_87495_length_383_cov_2.760563	222	302	78	1	80	0.0125000
NODE_87495_length_383_cov_2.760563	222	302	82	1	80	0.0125000
NODE_87495_length_383_cov_2.760563	222	302	84	1	80	0.0125000
NODE_87495_length_383_cov_2.760563	222	302	85	1	80	0.0125000
NODE_87495_length_383_cov_2.760563	222	302	99	1	80	0.0125000
NODE_87495_length_383_cov_2.760563	222	302	106	2	80	0.0250000
NODE_87495_length_383_cov_2.760563	222	302	109	1	80	0.0125000
NODE_87495_length_383_cov_2.760563	222	302	113	2	80	0.0250000
NODE_87495_length_383_cov_2.760563	222	302	119	1	80	0.0125000
NODE_87495_length_383_cov_2.760563	222	302	128	1	80	0.0125000
NODE_87495_length_383_cov_2.760563	222	302	136	1	80	0.0125000
NODE_87495_length_383_cov_2.760563	222	302	138	1	80	0.0125000
NODE_87495_length_383_cov_2.760563	222	302	145	1	80	0.0125000
NODE_87495_length_383_cov_2.760563	222	302	147	1	80	0.0125000
NODE_87495_length_383_cov_2.760563	222	302	151	1	80	0.0125000
NODE_87495_length_383_cov_2.760563	222	302	162	1	80	0.0125000
NODE_87495_length_383_cov_2.760563	222	302	167	2	80	0.0250000
NODE_87495_length_383_cov_2.760563	222	302	170	3	80	0.0375000
NODE_87495_length_383_cov_2.760563	222	302	174	1	80	0.0125000
NODE_87495_length_383_cov_2.760563	222	302	176	1	80	0.0125000
NODE_87495_length_383_cov_2.760563	222	302	178	3	80	0.0375000
NODE_87495_length_383_cov_2.760563	222	302	184	1	80	0.0125000
NODE_87495_length_383_cov_2.760563	222	302	189	1	80	0.0125000
NODE_87495_length_383_cov_2.760563	222	302	191	1	80	0.0125000
NODE_87495_length_383_cov_2.760563	222	302	196	1	80	0.0125000
NODE_87495_length_383_cov_2.760563	222	302	207	1	80	0.0125000
NODE_87495_length_383_cov_2.760563	222	302	245	1	80	0.0125000
NODE_87495_length_383_cov_2.760563	222	302	246	1	80	0.0125000
NODE_87495_length_383_cov_2.760563	222	302	250	1	80	0.0125000
NODE_87495_length_383_cov_2.760563	222	302	253	1	80	0.0125000
NODE_87495_length_383_cov_2.760563	222	302	274	1	80	0.0125000
NODE_87495_length_383_cov_2.760563	222	302	280	1	80	0.0125000
NODE_87495_length_383_cov_2.760563	222	302	284	1	80	0.0125000
NODE_87566_length_383_cov_2.123239	29	94	0	62	65	0.9538462
NODE_87566_length_383_cov_2.123239	29	94	1	3	65	0.0461538
NODE_87566_length_383_cov_2.123239	93	173	1	80	80	1.0000000
NODE_87566_length_383_cov_2.123239	146	193	1	47	47	1.0000000
NODE_87634_length_383_cov_1.728873	196	257	12	4	61	0.0655738
NODE_87634_length_383_cov_1.728873	196	257	14	2	61	0.0327869
NODE_87634_length_383_cov_1.728873	196	257	18	1	61	0.0163934
NODE_87634_length_383_cov_1.728873	196	257	20	1	61	0.0163934
NODE_87634_length_383_cov_1.728873	196	257	22	3	61	0.0491803
NODE_87634_length_383_cov_1.728873	196	257	24	5	61	0.0819672
NODE_87634_length_383_cov_1.728873	196	257	26	36	61	0.5901639
NODE_87634_length_383_cov_1.728873	196	257	28	6	61	0.0983607
NODE_87634_length_383_cov_1.728873	196	257	30	3	61	0.0491803
NODE_87634_length_383_cov_1.728873	239	310	16	2	71	0.0281690
NODE_87634_length_383_cov_1.728873	239	310	18	17	71	0.2394366
NODE_87634_length_383_cov_1.728873	239	310	20	14	71	0.1971831
NODE_87634_length_383_cov_1.728873	239	310	22	3	71	0.0422535
NODE_87634_length_383_cov_1.728873	239	310	24	3	71	0.0422535
NODE_87634_length_383_cov_1.728873	239	310	26	27	71	0.3802817
NODE_87634_length_383_cov_1.728873	239	310	28	5	71	0.0704225
NODE_88039_length_382_cov_43.724382	245	325	0	80	80	1.0000000
NODE_88039_length_382_cov_43.724382	298	378	0	80	80	1.0000000
NODE_88040_length_382_cov_35.908127	163	243	0	80	80	1.0000000
NODE_88040_length_382_cov_35.908127	216	296	0	80	80	1.0000000
NODE_88040_length_382_cov_35.908127	292	372	0	80	80	1.0000000
NODE_88041_length_382_cov_26.240283	57	137	0	19	80	0.2375000
NODE_88041_length_382_cov_26.240283	57	137	2	2	80	0.0250000
NODE_88041_length_382_cov_26.240283	57	137	4	59	80	0.7375000
NODE_88041_length_382_cov_26.240283	110	190	2	9	80	0.1125000
NODE_88041_length_382_cov_26.240283	110	190	4	50	80	0.6250000
NODE_88041_length_382_cov_26.240283	110	190	6	21	80	0.2625000
NODE_88054_length_382_cov_5.583039	63	143	0	80	80	1.0000000
NODE_88054_length_382_cov_5.583039	116	196	0	80	80	1.0000000
NODE_88063_length_382_cov_4.837456	19	78	0	25	59	0.4237288
NODE_88063_length_382_cov_4.837456	19	78	2	34	59	0.5762712
NODE_88067_length_382_cov_4.618375	0	55	0	55	55	1.0000000
NODE_88067_length_382_cov_4.618375	104	184	6	3	80	0.0375000
NODE_88067_length_382_cov_4.618375	104	184	8	1	80	0.0125000
NODE_88067_length_382_cov_4.618375	104	184	10	3	80	0.0375000
NODE_88067_length_382_cov_4.618375	104	184	12	56	80	0.7000000
NODE_88067_length_382_cov_4.618375	104	184	14	5	80	0.0625000
NODE_88067_length_382_cov_4.618375	104	184	16	1	80	0.0125000
NODE_88067_length_382_cov_4.618375	104	184	20	2	80	0.0250000
NODE_88067_length_382_cov_4.618375	104	184	22	3	80	0.0375000
NODE_88067_length_382_cov_4.618375	104	184	23	3	80	0.0375000
NODE_88067_length_382_cov_4.618375	104	184	24	1	80	0.0125000
NODE_88067_length_382_cov_4.618375	104	184	25	2	80	0.0250000
NODE_88067_length_382_cov_4.618375	157	237	12	10	80	0.1250000
NODE_88067_length_382_cov_4.618375	157	237	14	5	80	0.0625000
NODE_88067_length_382_cov_4.618375	157	237	15	1	80	0.0125000
NODE_88067_length_382_cov_4.618375	157	237	16	2	80	0.0250000
NODE_88067_length_382_cov_4.618375	157	237	18	8	80	0.1000000
NODE_88067_length_382_cov_4.618375	157	237	20	8	80	0.1000000
NODE_88067_length_382_cov_4.618375	157	237	22	37	80	0.4625000
NODE_88067_length_382_cov_4.618375	157	237	23	4	80	0.0500000
NODE_88067_length_382_cov_4.618375	157	237	24	3	80	0.0375000
NODE_88067_length_382_cov_4.618375	157	237	25	2	80	0.0250000
NODE_88075_length_382_cov_4.268551	71	152	0	27	81	0.3333333
NODE_88075_length_382_cov_4.268551	71	152	2	54	81	0.6666667
NODE_88075_length_382_cov_4.268551	124	205	0	41	81	0.5061728
NODE_88075_length_382_cov_4.268551	124	205	2	40	81	0.4938272
NODE_88080_length_382_cov_4.091873	30	92	0	62	62	1.0000000
NODE_88121_length_382_cov_3.031802	173	253	0	6	80	0.0750000
NODE_88121_length_382_cov_3.031802	173	253	2	18	80	0.2250000
NODE_88121_length_382_cov_3.031802	173	253	4	2	80	0.0250000
NODE_88121_length_382_cov_3.031802	173	253	6	10	80	0.1250000
NODE_88121_length_382_cov_3.031802	173	253	8	10	80	0.1250000
NODE_88121_length_382_cov_3.031802	173	253	10	6	80	0.0750000
NODE_88121_length_382_cov_3.031802	173	253	12	23	80	0.2875000
NODE_88121_length_382_cov_3.031802	173	253	14	5	80	0.0625000
NODE_88121_length_382_cov_3.031802	226	295	12	22	69	0.3188406
NODE_88121_length_382_cov_3.031802	226	295	14	47	69	0.6811594
NODE_88135_length_382_cov_2.798587	231	293	0	62	62	1.0000000
NODE_88136_length_382_cov_2.791519	195	244	4	49	49	1.0000000
NODE_88136_length_382_cov_2.791519	217	297	4	80	80	1.0000000
NODE_88164_length_382_cov_2.611307	301	368	0	67	67	1.0000000
NODE_88276_length_382_cov_1.802120	0	60	0	60	60	1.0000000
NODE_88660_length_382_cov_0.738516	48	95	4	47	47	1.0000000
NODE_88660_length_382_cov_0.738516	68	148	4	80	80	1.0000000
NODE_88758_length_381_cov_12.010638	195	274	0	79	79	1.0000000
NODE_88865_length_381_cov_2.606383	68	98	4	3	30	0.1000000
NODE_88865_length_381_cov_2.606383	68	98	6	13	30	0.4333333
NODE_88865_length_381_cov_2.606383	68	98	10	11	30	0.3666667
NODE_88865_length_381_cov_2.606383	68	98	15	1	30	0.0333333
NODE_88865_length_381_cov_2.606383	68	98	16	2	30	0.0666667
NODE_88867_length_381_cov_2.570922	115	175	0	60	60	1.0000000
NODE_88872_length_381_cov_2.514184	225	307	2	5	82	0.0609756
NODE_88872_length_381_cov_2.514184	225	307	4	25	82	0.3048781
NODE_88872_length_381_cov_2.514184	225	307	5	1	82	0.0121951
NODE_88872_length_381_cov_2.514184	225	307	6	51	82	0.6219512
NODE_88900_length_381_cov_2.198582	193	276	0	19	83	0.2289157
NODE_88900_length_381_cov_2.198582	193	276	2	27	83	0.3253012
NODE_88900_length_381_cov_2.198582	193	276	4	10	83	0.1204819
NODE_88900_length_381_cov_2.198582	193	276	6	11	83	0.1325301
NODE_88900_length_381_cov_2.198582	193	276	8	16	83	0.1927711
NODE_88935_length_381_cov_1.989362	279	325	0	33	46	0.7173913
NODE_88935_length_381_cov_1.989362	279	325	2	13	46	0.2826087
NODE_89009_length_381_cov_1.663121	51	128	0	29	77	0.3766234
NODE_89009_length_381_cov_1.663121	51	128	2	14	77	0.1818182
NODE_89009_length_381_cov_1.663121	51	128	4	34	77	0.4415585
NODE_89009_length_381_cov_1.663121	101	181	4	28	80	0.3500000
NODE_89009_length_381_cov_1.663121	101	181	6	4	80	0.0500000
NODE_89009_length_381_cov_1.663121	101	181	8	7	80	0.0875000
NODE_89009_length_381_cov_1.663121	101	181	10	22	80	0.2750000
NODE_89009_length_381_cov_1.663121	101	181	12	10	80	0.1250000
NODE_89009_length_381_cov_1.663121	101	181	14	9	80	0.1125000
NODE_89090_length_381_cov_1.400709	254	334	0	23	80	0.2875000
NODE_89090_length_381_cov_1.400709	254	334	2	57	80	0.7125000
NODE_89090_length_381_cov_1.400709	254	334	0	23	80	0.2875000
NODE_89090_length_381_cov_1.400709	254	334	2	57	80	0.7125000
NODE_89090_length_381_cov_1.400709	309	373	0	23	64	0.3593750
NODE_89090_length_381_cov_1.400709	309	373	2	41	64	0.6406250
NODE_89482_length_380_cov_57.604982	196	276	6	80	80	1.0000000
NODE_89482_length_380_cov_57.604982	249	329	2	10	80	0.1250000
NODE_89482_length_380_cov_57.604982	249	329	4	5	80	0.0625000
NODE_89482_length_380_cov_57.604982	249	329	6	65	80	0.8125000
NODE_89482_length_380_cov_57.604982	325	359	0	28	34	0.8235294
NODE_89482_length_380_cov_57.604982	325	359	2	6	34	0.1764706
NODE_89483_length_380_cov_11.185053	79	161	2	82	82	1.0000000
NODE_89483_length_380_cov_11.185053	134	214	0	33	80	0.4125000
NODE_89483_length_380_cov_11.185053	134	214	2	47	80	0.5875000
NODE_89491_length_380_cov_5.811388	100	156	2	5	56	0.0892857
NODE_89491_length_380_cov_5.811388	100	156	4	51	56	0.9107143
NODE_89491_length_380_cov_5.811388	177	213	0	5	36	0.1388889
NODE_89491_length_380_cov_5.811388	177	213	2	31	36	0.8611111
NODE_89495_length_380_cov_5.377224	242	271	28	1	29	0.0344828
NODE_89495_length_380_cov_5.377224	242	271	30	15	29	0.5172414
NODE_89495_length_380_cov_5.377224	242	271	32	7	29	0.2413793
NODE_89495_length_380_cov_5.377224	242	271	34	2	29	0.0689655
NODE_89495_length_380_cov_5.377224	242	271	36	4	29	0.1379310
NODE_89508_length_380_cov_4.185053	158	230	0	72	72	1.0000000
NODE_89508_length_380_cov_4.185053	159	229	0	70	70	1.0000000
NODE_89508_length_380_cov_4.185053	203	283	0	80	80	1.0000000
NODE_89508_length_380_cov_4.185053	203	283	0	80	80	1.0000000
NODE_89527_length_380_cov_3.423488	164	233	0	51	69	0.7391304
NODE_89527_length_380_cov_3.423488	164	233	2	15	69	0.2173913
NODE_89527_length_380_cov_3.423488	164	233	5	3	69	0.0434783
NODE_89540_length_380_cov_3.153025	188	260	6	43	72	0.5972222
NODE_89540_length_380_cov_3.153025	188	260	8	25	72	0.3472222
NODE_89540_length_380_cov_3.153025	188	260	10	4	72	0.0555556
NODE_89568_length_380_cov_2.718861	51	131	0	15	80	0.1875000
NODE_89568_length_380_cov_2.718861	51	131	2	64	80	0.8000000
NODE_89568_length_380_cov_2.718861	51	131	4	1	80	0.0125000
NODE_89568_length_380_cov_2.718861	104	184	2	26	80	0.3250000
NODE_89568_length_380_cov_2.718861	104	184	4	14	80	0.1750000
NODE_89568_length_380_cov_2.718861	104	184	6	39	80	0.4875000
NODE_89568_length_380_cov_2.718861	104	184	8	1	80	0.0125000
NODE_89658_length_380_cov_1.943060	22	56	3	3	34	0.0882353
NODE_89658_length_380_cov_1.943060	22	56	5	2	34	0.0588235
NODE_89658_length_380_cov_1.943060	22	56	7	2	34	0.0588235
NODE_89658_length_380_cov_1.943060	22	56	9	11	34	0.3235294
NODE_89658_length_380_cov_1.943060	22	56	13	16	34	0.4705882
NODE_89750_length_380_cov_1.601423	292	332	33	6	40	0.1500000
NODE_89750_length_380_cov_1.601423	292	332	34	1	40	0.0250000
NODE_89750_length_380_cov_1.601423	292	332	36	1	40	0.0250000
NODE_89750_length_380_cov_1.601423	292	332	38	7	40	0.1750000
NODE_89750_length_380_cov_1.601423	292	332	39	4	40	0.1000000
NODE_89750_length_380_cov_1.601423	292	332	41	8	40	0.2000000
NODE_89750_length_380_cov_1.601423	292	332	43	1	40	0.0250000
NODE_89750_length_380_cov_1.601423	292	332	45	1	40	0.0250000
NODE_89750_length_380_cov_1.601423	292	332	47	2	40	0.0500000
NODE_89750_length_380_cov_1.601423	292	332	48	2	40	0.0500000
NODE_89750_length_380_cov_1.601423	292	332	50	2	40	0.0500000
NODE_89750_length_380_cov_1.601423	292	332	52	2	40	0.0500000
NODE_89750_length_380_cov_1.601423	292	332	56	1	40	0.0250000
NODE_89750_length_380_cov_1.601423	292	332	58	2	40	0.0500000
NODE_89911_length_380_cov_1.088968	312	353	2	10	41	0.2439024
NODE_89911_length_380_cov_1.088968	312	353	4	26	41	0.6341463
NODE_89911_length_380_cov_1.088968	312	353	6	5	41	0.1219512
NODE_89911_length_380_cov_1.088968	326	380	0	14	54	0.2592593
NODE_89911_length_380_cov_1.088968	326	380	2	23	54	0.4259259
NODE_89911_length_380_cov_1.088968	326	380	4	17	54	0.3148148
NODE_90152_length_379_cov_42.339286	10	90	0	45	80	0.5625000
NODE_90152_length_379_cov_42.339286	10	90	2	35	80	0.4375000
NODE_90152_length_379_cov_42.339286	86	166	2	39	80	0.4875000
NODE_90152_length_379_cov_42.339286	86	166	6	30	80	0.3750000
NODE_90152_length_379_cov_42.339286	86	166	8	11	80	0.1375000
NODE_90152_length_379_cov_42.339286	139	219	4	8	80	0.1000000
NODE_90152_length_379_cov_42.339286	139	219	6	61	80	0.7625000
NODE_90152_length_379_cov_42.339286	139	219	8	11	80	0.1375000
NODE_90153_length_379_cov_32.075000	0	62	0	62	62	1.0000000
NODE_90165_length_379_cov_5.607143	279	338	0	59	59	1.0000000
NODE_90180_length_379_cov_4.432143	219	243	0	24	24	1.0000000
NODE_90193_length_379_cov_3.778571	271	300	2	29	29	1.0000000
NODE_90198_length_379_cov_3.585714	128	152	0	24	24	1.0000000
NODE_90198_length_379_cov_3.585714	169	249	0	80	80	1.0000000
NODE_90203_length_379_cov_3.375000	19	43	2	24	24	1.0000000
NODE_90247_length_379_cov_2.692857	121	201	0	5	80	0.0625000
NODE_90247_length_379_cov_2.692857	121	201	2	75	80	0.9375000
NODE_90247_length_379_cov_2.692857	174	221	0	21	47	0.4468085
NODE_90247_length_379_cov_2.692857	174	221	2	26	47	0.5531915
NODE_90789_length_378_cov_53.039427	147	227	0	80	80	1.0000000
NODE_90789_length_378_cov_53.039427	200	280	0	80	80	1.0000000
NODE_90789_length_378_cov_53.039427	276	356	0	80	80	1.0000000
NODE_90789_length_378_cov_53.039427	329	378	0	49	49	1.0000000
NODE_90794_length_378_cov_6.569892	223	304	8	16	81	0.1975309
NODE_90794_length_378_cov_6.569892	223	304	10	19	81	0.2345679
NODE_90794_length_378_cov_6.569892	223	304	11	1	81	0.0123457
NODE_90794_length_378_cov_6.569892	223	304	12	37	81	0.4567901
NODE_90794_length_378_cov_6.569892	223	304	14	8	81	0.0987654
NODE_90795_length_378_cov_6.444444	217	297	0	80	80	1.0000000
NODE_90795_length_378_cov_6.444444	270	350	0	80	80	1.0000000
NODE_90808_length_378_cov_4.899642	135	191	2	7	56	0.1250000
NODE_90808_length_378_cov_4.899642	135	191	4	49	56	0.8750000
NODE_90855_length_378_cov_3.236559	143	212	6	3	69	0.0434783
NODE_90855_length_378_cov_3.236559	143	212	10	66	69	0.9565217
NODE_90859_length_378_cov_3.132616	238	280	0	42	42	1.0000000
NODE_90898_length_378_cov_2.534050	203	243	0	9	40	0.2250000
NODE_90898_length_378_cov_2.534050	203	243	2	31	40	0.7750000
NODE_90898_length_378_cov_2.534050	271	347	0	29	76	0.3815790
NODE_90898_length_378_cov_2.534050	271	347	2	47	76	0.6184211
NODE_90898_length_378_cov_2.534050	331	360	0	29	29	1.0000000
NODE_90948_length_378_cov_2.093190	179	250	0	20	71	0.2816902
NODE_90948_length_378_cov_2.093190	179	250	2	51	71	0.7183099
NODE_90948_length_378_cov_2.093190	183	219	0	16	36	0.4444444
NODE_90948_length_378_cov_2.093190	183	219	2	20	36	0.5555556
NODE_91002_length_378_cov_1.813620	36	89	0	49	53	0.9245283
NODE_91002_length_378_cov_1.813620	36	89	2	4	53	0.0754717
NODE_91475_length_377_cov_71.723022	19	99	0	80	80	1.0000000
NODE_91475_length_377_cov_71.723022	72	152	0	80	80	1.0000000
NODE_91475_length_377_cov_71.723022	148	228	0	73	80	0.9125000
NODE_91475_length_377_cov_71.723022	148	228	2	7	80	0.0875000
NODE_91475_length_377_cov_71.723022	201	281	0	20	80	0.2500000
NODE_91475_length_377_cov_71.723022	201	281	2	32	80	0.4000000
NODE_91475_length_377_cov_71.723022	201	281	4	4	80	0.0500000
NODE_91475_length_377_cov_71.723022	201	281	6	24	80	0.3000000
NODE_91477_length_377_cov_41.787770	210	290	0	18	80	0.2250000
NODE_91477_length_377_cov_41.787770	210	290	4	5	80	0.0625000
NODE_91477_length_377_cov_41.787770	210	290	6	13	80	0.1625000
NODE_91477_length_377_cov_41.787770	210	290	8	44	80	0.5500000
NODE_91477_length_377_cov_41.787770	263	343	0	71	80	0.8875000
NODE_91477_length_377_cov_41.787770	263	343	4	5	80	0.0625000
NODE_91477_length_377_cov_41.787770	263	343	6	4	80	0.0500000
NODE_91478_length_377_cov_9.982014	32	83	0	51	51	1.0000000
NODE_91486_length_377_cov_6.244604	101	177	0	76	76	1.0000000
NODE_91494_length_377_cov_5.183453	169	224	0	33	55	0.6000000
NODE_91494_length_377_cov_5.183453	169	224	2	22	55	0.4000000
NODE_91499_length_377_cov_4.586331	186	266	0	80	80	1.0000000
NODE_91499_length_377_cov_4.586331	239	319	0	80	80	1.0000000
NODE_91500_length_377_cov_4.431655	139	216	0	57	77	0.7402598
NODE_91500_length_377_cov_4.431655	139	216	1	20	77	0.2597403
NODE_91502_length_377_cov_4.330935	134	214	0	80	80	1.0000000
NODE_91502_length_377_cov_4.330935	187	267	0	80	80	1.0000000
NODE_91506_length_377_cov_4.032374	124	181	4	35	57	0.6140351
NODE_91506_length_377_cov_4.032374	124	181	6	22	57	0.3859649
NODE_91506_length_377_cov_4.032374	154	201	2	13	47	0.2765957
NODE_91506_length_377_cov_4.032374	154	201	4	19	47	0.4042553
NODE_91506_length_377_cov_4.032374	154	201	6	15	47	0.3191489
NODE_91526_length_377_cov_3.615108	82	140	0	58	58	1.0000000
NODE_91526_length_377_cov_3.615108	82	140	0	58	58	1.0000000
NODE_91526_length_377_cov_3.615108	113	193	0	80	80	1.0000000
NODE_91526_length_377_cov_3.615108	113	193	0	80	80	1.0000000
NODE_91526_length_377_cov_3.615108	189	258	0	69	69	1.0000000
NODE_91526_length_377_cov_3.615108	243	313	0	70	70	1.0000000
NODE_91553_length_377_cov_2.913669	38	61	0	23	23	1.0000000
NODE_91553_length_377_cov_2.913669	167	228	2	10	61	0.1639344
NODE_91553_length_377_cov_2.913669	167	228	4	9	61	0.1475410
NODE_91553_length_377_cov_2.913669	167	228	6	42	61	0.6885246
NODE_91619_length_377_cov_2.104317	137	188	0	6	51	0.1176471
NODE_91619_length_377_cov_2.104317	137	188	2	45	51	0.8823529
NODE_91619_length_377_cov_2.104317	168	211	2	43	43	1.0000000
NODE_91619_length_377_cov_2.104317	190	241	2	51	51	1.0000000
NODE_91727_length_377_cov_1.622302	123	181	6	36	58	0.6206896
NODE_91727_length_377_cov_1.622302	123	181	8	19	58	0.3275862
NODE_91727_length_377_cov_1.622302	123	181	10	3	58	0.0517241
NODE_91727_length_377_cov_1.622302	176	234	0	1	58	0.0172414
NODE_91727_length_377_cov_1.622302	176	234	2	8	58	0.1379310
NODE_91727_length_377_cov_1.622302	176	234	4	1	58	0.0172414
NODE_91727_length_377_cov_1.622302	176	234	6	48	58	0.8275862
NODE_91749_length_377_cov_1.539568	230	310	0	80	80	1.0000000
NODE_91749_length_377_cov_1.539568	230	310	0	80	80	1.0000000
NODE_91749_length_377_cov_1.539568	306	377	0	71	71	1.0000000
NODE_91749_length_377_cov_1.539568	327	351	0	24	24	1.0000000
NODE_91765_length_377_cov_1.471223	118	198	11	11	80	0.1375000
NODE_91765_length_377_cov_1.471223	118	198	12	2	80	0.0250000
NODE_91765_length_377_cov_1.471223	118	198	13	25	80	0.3125000
NODE_91765_length_377_cov_1.471223	118	198	14	42	80	0.5250000
NODE_91790_length_377_cov_1.456835	177	257	0	80	80	1.0000000
NODE_91790_length_377_cov_1.456835	230	310	0	80	80	1.0000000
NODE_91817_length_377_cov_1.330935	0	44	0	17	44	0.3863636
NODE_91817_length_377_cov_1.330935	0	44	2	27	44	0.6136364
NODE_91817_length_377_cov_1.330935	45	117	0	22	72	0.3055556
NODE_91817_length_377_cov_1.330935	45	117	2	50	72	0.6944444
NODE_92046_length_377_cov_0.762590	299	330	0	31	31	1.0000000
NODE_92166_length_376_cov_6.938628	0	63	2	10	63	0.1587302
NODE_92166_length_376_cov_6.938628	0	63	8	1	63	0.0158730
NODE_92166_length_376_cov_6.938628	0	63	10	4	63	0.0634921
NODE_92166_length_376_cov_6.938628	0	63	15	1	63	0.0158730
NODE_92166_length_376_cov_6.938628	0	63	16	2	63	0.0317460
NODE_92166_length_376_cov_6.938628	0	63	18	9	63	0.1428571
NODE_92166_length_376_cov_6.938628	0	63	20	8	63	0.1269841
NODE_92166_length_376_cov_6.938628	0	63	22	5	63	0.0793651
NODE_92166_length_376_cov_6.938628	0	63	24	7	63	0.1111111
NODE_92166_length_376_cov_6.938628	0	63	26	1	63	0.0158730
NODE_92166_length_376_cov_6.938628	0	63	32	5	63	0.0793651
NODE_92166_length_376_cov_6.938628	0	63	36	2	63	0.0317460
NODE_92166_length_376_cov_6.938628	0	63	38	1	63	0.0158730
NODE_92166_length_376_cov_6.938628	0	63	40	1	63	0.0158730
NODE_92166_length_376_cov_6.938628	0	63	48	2	63	0.0317460
NODE_92166_length_376_cov_6.938628	0	63	50	1	63	0.0158730
NODE_92166_length_376_cov_6.938628	0	63	52	1	63	0.0158730
NODE_92166_length_376_cov_6.938628	0	63	54	1	63	0.0158730
NODE_92166_length_376_cov_6.938628	0	63	56	1	63	0.0158730
NODE_92166_length_376_cov_6.938628	269	340	20	3	71	0.0422535
NODE_92166_length_376_cov_6.938628	269	340	22	7	71	0.0985916
NODE_92166_length_376_cov_6.938628	269	340	24	5	71	0.0704225
NODE_92166_length_376_cov_6.938628	269	340	28	2	71	0.0281690
NODE_92166_length_376_cov_6.938628	269	340	30	2	71	0.0281690
NODE_92166_length_376_cov_6.938628	269	340	32	18	71	0.2535211
NODE_92166_length_376_cov_6.938628	269	340	34	34	71	0.4788733
NODE_92168_length_376_cov_6.415162	177	257	0	20	80	0.2500000
NODE_92168_length_376_cov_6.415162	177	257	2	1	80	0.0125000
NODE_92168_length_376_cov_6.415162	177	257	3	1	80	0.0125000
NODE_92168_length_376_cov_6.415162	177	257	5	58	80	0.7250000
NODE_92168_length_376_cov_6.415162	230	310	5	29	80	0.3625000
NODE_92168_length_376_cov_6.415162	230	310	6	51	80	0.6375000
NODE_92173_length_376_cov_5.722022	100	171	4	1	71	0.0140845
NODE_92173_length_376_cov_5.722022	100	171	5	2	71	0.0281690
NODE_92173_length_376_cov_5.722022	100	171	6	58	71	0.8169014
NODE_92173_length_376_cov_5.722022	100	171	8	10	71	0.1408451
NODE_92173_length_376_cov_5.722022	155	192	6	15	37	0.4054054
NODE_92173_length_376_cov_5.722022	155	192	8	22	37	0.5945946
NODE_92191_length_376_cov_4.148014	300	330	2	30	30	1.0000000
NODE_92196_length_376_cov_3.859206	168	236	2	14	68	0.2058824
NODE_92196_length_376_cov_3.859206	168	236	6	54	68	0.7941176
NODE_92219_length_376_cov_3.140794	122	188	2	66	66	1.0000000
NODE_92442_length_376_cov_1.516245	57	106	14	5	49	0.1020408
NODE_92442_length_376_cov_1.516245	57	106	16	2	49	0.0408163
NODE_92442_length_376_cov_1.516245	57	106	17	1	49	0.0204082
NODE_92442_length_376_cov_1.516245	57	106	18	1	49	0.0204082
NODE_92442_length_376_cov_1.516245	57	106	20	8	49	0.1632653
NODE_92442_length_376_cov_1.516245	57	106	22	6	49	0.1224490
NODE_92442_length_376_cov_1.516245	57	106	24	26	49	0.5306122
NODE_92879_length_375_cov_4.217391	321	350	0	29	29	1.0000000
NODE_92897_length_375_cov_3.699275	287	367	0	80	80	1.0000000
NODE_92911_length_375_cov_3.376812	70	136	0	66	66	1.0000000
NODE_93031_length_375_cov_2.032609	162	224	0	23	62	0.3709677
NODE_93031_length_375_cov_2.032609	162	224	2	26	62	0.4193548
NODE_93031_length_375_cov_2.032609	162	224	4	13	62	0.2096774
NODE_93031_length_375_cov_2.032609	215	272	2	4	57	0.0701754
NODE_93031_length_375_cov_2.032609	215	272	4	39	57	0.6842105
NODE_93031_length_375_cov_2.032609	215	272	6	14	57	0.2456140
NODE_93050_length_375_cov_1.967391	131	190	4	25	59	0.4237288
NODE_93050_length_375_cov_1.967391	131	190	6	34	59	0.5762712
NODE_93050_length_375_cov_1.967391	184	235	6	51	51	1.0000000
NODE_93081_length_375_cov_1.840580	195	276	0	2	81	0.0246914
NODE_93081_length_375_cov_1.840580	195	276	2	50	81	0.6172839
NODE_93081_length_375_cov_1.840580	195	276	4	29	81	0.3580247
NODE_93386_length_375_cov_1.000000	320	375	0	55	55	1.0000000
NODE_93609_length_374_cov_4.563636	93	160	2	1	67	0.0149254
NODE_93609_length_374_cov_4.563636	93	160	4	6	67	0.0895522
NODE_93609_length_374_cov_4.563636	93	160	8	45	67	0.6716418
NODE_93609_length_374_cov_4.563636	93	160	10	9	67	0.1343284
NODE_93609_length_374_cov_4.563636	93	160	11	1	67	0.0149254
NODE_93609_length_374_cov_4.563636	93	160	12	5	67	0.0746269
NODE_93609_length_374_cov_4.563636	146	213	10	15	67	0.2238806
NODE_93609_length_374_cov_4.563636	146	213	11	10	67	0.1492537
NODE_93609_length_374_cov_4.563636	146	213	12	5	67	0.0746269
NODE_93609_length_374_cov_4.563636	146	213	13	37	67	0.5522388
NODE_93612_length_374_cov_4.523636	23	101	0	11	78	0.1410256
NODE_93612_length_374_cov_4.523636	23	101	2	67	78	0.8589743
NODE_93612_length_374_cov_4.523636	81	154	0	64	73	0.8767123
NODE_93612_length_374_cov_4.523636	81	154	2	9	73	0.1232877
NODE_93628_length_374_cov_3.810909	130	189	3	2	59	0.0338983
NODE_93628_length_374_cov_3.810909	130	189	9	1	59	0.0169492
NODE_93628_length_374_cov_3.810909	130	189	15	1	59	0.0169492
NODE_93628_length_374_cov_3.810909	130	189	19	4	59	0.0677966
NODE_93628_length_374_cov_3.810909	130	189	20	7	59	0.1186441
NODE_93628_length_374_cov_3.810909	130	189	22	1	59	0.0169492
NODE_93628_length_374_cov_3.810909	130	189	26	17	59	0.2881356
NODE_93628_length_374_cov_3.810909	130	189	28	26	59	0.4406780
NODE_93628_length_374_cov_3.810909	162	242	2	9	80	0.1125000
NODE_93628_length_374_cov_3.810909	162	242	12	2	80	0.0250000
NODE_93628_length_374_cov_3.810909	162	242	14	3	80	0.0375000
NODE_93628_length_374_cov_3.810909	162	242	20	5	80	0.0625000
NODE_93628_length_374_cov_3.810909	162	242	21	2	80	0.0250000
NODE_93628_length_374_cov_3.810909	162	242	22	5	80	0.0625000
NODE_93628_length_374_cov_3.810909	162	242	24	4	80	0.0500000
NODE_93628_length_374_cov_3.810909	162	242	26	7	80	0.0875000
NODE_93628_length_374_cov_3.810909	162	242	28	43	80	0.5375000
NODE_93630_length_374_cov_3.789091	236	271	0	35	35	1.0000000
NODE_93630_length_374_cov_3.789091	238	280	0	42	42	1.0000000
NODE_93637_length_374_cov_3.458182	190	248	2	58	58	1.0000000
NODE_93688_length_374_cov_2.600000	142	217	0	5	75	0.0666667
NODE_93688_length_374_cov_2.600000	142	217	2	14	75	0.1866667
NODE_93688_length_374_cov_2.600000	142	217	6	17	75	0.2266667
NODE_93688_length_374_cov_2.600000	142	217	8	18	75	0.2400000
NODE_93688_length_374_cov_2.600000	142	217	10	21	75	0.2800000
NODE_93688_length_374_cov_2.600000	190	270	8	6	80	0.0750000
NODE_93688_length_374_cov_2.600000	190	270	10	43	80	0.5375000
NODE_93688_length_374_cov_2.600000	190	270	12	6	80	0.0750000
NODE_93688_length_374_cov_2.600000	190	270	15	22	80	0.2750000
NODE_93688_length_374_cov_2.600000	190	270	16	3	80	0.0375000
NODE_93718_length_374_cov_2.330909	40	120	0	80	80	1.0000000
NODE_93769_length_374_cov_2.010909	40	105	0	65	65	1.0000000
NODE_93821_length_374_cov_1.796364	254	288	0	34	34	1.0000000
NODE_93852_length_374_cov_1.661818	95	157	2	6	62	0.0967742
NODE_93852_length_374_cov_1.661818	95	157	4	54	62	0.8709677
NODE_93852_length_374_cov_1.661818	95	157	6	2	62	0.0322581
NODE_93859_length_374_cov_1.621818	202	254	0	38	52	0.7307692
NODE_93859_length_374_cov_1.621818	202	254	2	14	52	0.2692308
NODE_93936_length_374_cov_1.360000	211	291	2	28	80	0.3500000
NODE_93936_length_374_cov_1.360000	211	291	4	46	80	0.5750000
NODE_93936_length_374_cov_1.360000	211	291	6	6	80	0.0750000
NODE_93981_length_374_cov_1.236364	263	336	0	73	73	1.0000000
NODE_94321_length_373_cov_31.302920	0	53	0	1	53	0.0188679
NODE_94321_length_373_cov_31.302920	0	53	2	18	53	0.3396226
NODE_94321_length_373_cov_31.302920	0	53	4	12	53	0.2264151
NODE_94321_length_373_cov_31.302920	0	53	5	5	53	0.0943396
NODE_94321_length_373_cov_31.302920	0	53	9	17	53	0.3207547
NODE_94321_length_373_cov_31.302920	0	53	0	1	53	0.0188679
NODE_94321_length_373_cov_31.302920	0	53	2	18	53	0.3396226
NODE_94321_length_373_cov_31.302920	0	53	4	12	53	0.2264151
NODE_94321_length_373_cov_31.302920	0	53	5	5	53	0.0943396
NODE_94321_length_373_cov_31.302920	0	53	9	17	53	0.3207547
NODE_94321_length_373_cov_31.302920	0	53	0	1	53	0.0188679
NODE_94321_length_373_cov_31.302920	0	53	2	18	53	0.3396226
NODE_94321_length_373_cov_31.302920	0	53	4	12	53	0.2264151
NODE_94321_length_373_cov_31.302920	0	53	5	5	53	0.0943396
NODE_94321_length_373_cov_31.302920	0	53	9	17	53	0.3207547
NODE_94321_length_373_cov_31.302920	26	106	4	5	80	0.0625000
NODE_94321_length_373_cov_31.302920	26	106	5	5	80	0.0625000
NODE_94321_length_373_cov_31.302920	26	106	9	41	80	0.5125000
NODE_94321_length_373_cov_31.302920	26	106	10	29	80	0.3625000
NODE_94340_length_373_cov_4.671533	76	142	10	5	66	0.0757576
NODE_94340_length_373_cov_4.671533	76	142	12	22	66	0.3333333
NODE_94340_length_373_cov_4.671533	76	142	14	39	66	0.5909091
NODE_94340_length_373_cov_4.671533	115	195	6	11	80	0.1375000
NODE_94340_length_373_cov_4.671533	115	195	8	1	80	0.0125000
NODE_94340_length_373_cov_4.671533	115	195	10	19	80	0.2375000
NODE_94340_length_373_cov_4.671533	115	195	12	9	80	0.1125000
NODE_94340_length_373_cov_4.671533	115	195	14	40	80	0.5000000
NODE_94340_length_373_cov_4.671533	115	195	6	11	80	0.1375000
NODE_94340_length_373_cov_4.671533	115	195	8	1	80	0.0125000
NODE_94340_length_373_cov_4.671533	115	195	10	19	80	0.2375000
NODE_94340_length_373_cov_4.671533	115	195	12	9	80	0.1125000
NODE_94340_length_373_cov_4.671533	115	195	14	40	80	0.5000000
NODE_94340_length_373_cov_4.671533	288	368	0	80	80	1.0000000
NODE_94352_length_373_cov_4.080292	109	189	2	10	80	0.1250000
NODE_94352_length_373_cov_4.080292	109	189	4	38	80	0.4750000
NODE_94352_length_373_cov_4.080292	109	189	6	32	80	0.4000000
NODE_94352_length_373_cov_4.080292	162	220	4	33	58	0.5689655
NODE_94352_length_373_cov_4.080292	162	220	6	19	58	0.3275862
NODE_94352_length_373_cov_4.080292	162	220	7	6	58	0.1034483
NODE_94380_length_373_cov_3.167883	131	210	0	79	79	1.0000000
NODE_94414_length_373_cov_2.751825	80	151	0	71	71	1.0000000
NODE_94414_length_373_cov_2.751825	124	162	0	38	38	1.0000000
NODE_94493_length_373_cov_2.036496	248	326	0	78	78	1.0000000
NODE_94493_length_373_cov_2.036496	299	359	0	60	60	1.0000000
NODE_94500_length_373_cov_2.003650	150	194	0	44	44	1.0000000
NODE_94937_length_373_cov_0.759124	62	114	0	52	52	1.0000000
NODE_95051_length_372_cov_30.135531	111	191	0	80	80	1.0000000
NODE_95051_length_372_cov_30.135531	159	222	0	63	63	1.0000000
NODE_95051_length_372_cov_30.135531	164	239	0	75	75	1.0000000
NODE_95051_length_372_cov_30.135531	182	253	0	71	71	1.0000000
NODE_95051_length_372_cov_30.135531	195	275	0	80	80	1.0000000
NODE_95051_length_372_cov_30.135531	213	276	0	63	63	1.0000000
NODE_95053_length_372_cov_9.091575	150	230	4	27	80	0.3375000
NODE_95053_length_372_cov_9.091575	150	230	6	53	80	0.6625000
NODE_95053_length_372_cov_9.091575	203	283	0	46	80	0.5750000
NODE_95053_length_372_cov_9.091575	203	283	4	34	80	0.4250000
NODE_95063_length_372_cov_5.706960	168	208	0	40	40	1.0000000
NODE_95067_length_372_cov_5.124542	146	211	0	65	65	1.0000000
NODE_95067_length_372_cov_5.124542	189	264	0	75	75	1.0000000
NODE_95090_length_372_cov_3.761905	177	221	2	30	44	0.6818182
NODE_95090_length_372_cov_3.761905	177	221	4	14	44	0.3181818
NODE_95109_length_372_cov_3.186813	137	218	0	81	81	1.0000000
NODE_95159_length_372_cov_2.582418	167	239	12	4	72	0.0555556
NODE_95159_length_372_cov_2.582418	167	239	13	1	72	0.0138889
NODE_95159_length_372_cov_2.582418	167	239	14	4	72	0.0555556
NODE_95159_length_372_cov_2.582418	167	239	15	2	72	0.0277778
NODE_95159_length_372_cov_2.582418	167	239	18	2	72	0.0277778
NODE_95159_length_372_cov_2.582418	167	239	20	2	72	0.0277778
NODE_95159_length_372_cov_2.582418	167	239	22	9	72	0.1250000
NODE_95159_length_372_cov_2.582418	167	239	24	6	72	0.0833333
NODE_95159_length_372_cov_2.582418	167	239	26	34	72	0.4722222
NODE_95159_length_372_cov_2.582418	167	239	28	8	72	0.1111111
NODE_95159_length_372_cov_2.582418	212	292	5	12	80	0.1500000
NODE_95159_length_372_cov_2.582418	212	292	9	1	80	0.0125000
NODE_95159_length_372_cov_2.582418	212	292	12	2	80	0.0250000
NODE_95159_length_372_cov_2.582418	212	292	14	1	80	0.0125000
NODE_95159_length_372_cov_2.582418	212	292	16	10	80	0.1250000
NODE_95159_length_372_cov_2.582418	212	292	18	10	80	0.1250000
NODE_95159_length_372_cov_2.582418	212	292	20	3	80	0.0375000
NODE_95159_length_372_cov_2.582418	212	292	22	2	80	0.0250000
NODE_95159_length_372_cov_2.582418	212	292	24	1	80	0.0125000
NODE_95159_length_372_cov_2.582418	212	292	26	19	80	0.2375000
NODE_95159_length_372_cov_2.582418	212	292	28	19	80	0.2375000
NODE_95183_length_372_cov_2.347985	97	141	0	44	44	1.0000000
NODE_95183_length_372_cov_2.347985	98	133	0	35	35	1.0000000
NODE_95183_length_372_cov_2.347985	178	243	2	43	65	0.6615385
NODE_95183_length_372_cov_2.347985	178	243	4	2	65	0.0307692
NODE_95183_length_372_cov_2.347985	178	243	6	20	65	0.3076923
NODE_95303_length_372_cov_1.699634	195	276	24	6	81	0.0740741
NODE_95303_length_372_cov_1.699634	195	276	26	9	81	0.1111111
NODE_95303_length_372_cov_1.699634	195	276	28	15	81	0.1851852
NODE_95303_length_372_cov_1.699634	195	276	32	3	81	0.0370370
NODE_95303_length_372_cov_1.699634	195	276	36	10	81	0.1234568
NODE_95303_length_372_cov_1.699634	195	276	38	10	81	0.1234568
NODE_95303_length_372_cov_1.699634	195	276	40	28	81	0.3456790
NODE_95453_length_372_cov_1.223443	264	334	0	70	70	1.0000000
NODE_95784_length_371_cov_52.040441	104	184	0	35	80	0.4375000
NODE_95784_length_371_cov_52.040441	104	184	2	40	80	0.5000000
NODE_95784_length_371_cov_52.040441	104	184	4	5	80	0.0625000
NODE_95784_length_371_cov_52.040441	157	237	2	22	80	0.2750000
NODE_95784_length_371_cov_52.040441	157	237	4	29	80	0.3625000
NODE_95784_length_371_cov_52.040441	157	237	5	7	80	0.0875000
NODE_95784_length_371_cov_52.040441	157	237	6	8	80	0.1000000
NODE_95784_length_371_cov_52.040441	157	237	8	12	80	0.1500000
NODE_95784_length_371_cov_52.040441	157	237	10	1	80	0.0125000
NODE_95784_length_371_cov_52.040441	157	237	12	1	80	0.0125000
NODE_95784_length_371_cov_52.040441	180	232	4	28	52	0.5384616
NODE_95784_length_371_cov_52.040441	180	232	5	7	52	0.1346154
NODE_95784_length_371_cov_52.040441	180	232	6	8	52	0.1538462
NODE_95784_length_371_cov_52.040441	180	232	8	9	52	0.1730769
NODE_95785_length_371_cov_24.878676	91	171	0	10	80	0.1250000
NODE_95785_length_371_cov_24.878676	91	171	2	70	80	0.8750000
NODE_95785_length_371_cov_24.878676	144	224	0	52	80	0.6500000
NODE_95785_length_371_cov_24.878676	144	224	2	28	80	0.3500000
NODE_95797_length_371_cov_5.738971	170	245	0	29	75	0.3866667
NODE_95797_length_371_cov_5.738971	170	245	2	22	75	0.2933333
NODE_95797_length_371_cov_5.738971	170	245	4	24	75	0.3200000
NODE_95797_length_371_cov_5.738971	218	298	2	3	80	0.0375000
NODE_95797_length_371_cov_5.738971	218	298	4	32	80	0.4000000
NODE_95797_length_371_cov_5.738971	218	298	6	21	80	0.2625000
NODE_95797_length_371_cov_5.738971	218	298	8	24	80	0.3000000
NODE_95807_length_371_cov_4.452206	65	145	0	80	80	1.0000000
NODE_95807_length_371_cov_4.452206	118	198	0	80	80	1.0000000
NODE_95863_length_371_cov_2.841912	288	350	0	60	62	0.9677419
NODE_95863_length_371_cov_2.841912	288	350	23	2	62	0.0322581
NODE_96013_length_371_cov_1.790441	188	235	0	16	47	0.3404255
NODE_96013_length_371_cov_1.790441	188	235	2	31	47	0.6595744
NODE_96105_length_371_cov_1.422794	199	287	0	88	88	1.0000000
NODE_96500_length_370_cov_50.380074	144	224	0	80	80	1.0000000
NODE_96500_length_370_cov_50.380074	197	277	0	80	80	1.0000000
NODE_96504_length_370_cov_7.553506	105	162	1	4	57	0.0701754
NODE_96504_length_370_cov_7.553506	105	162	2	49	57	0.8596491
NODE_96504_length_370_cov_7.553506	105	162	4	4	57	0.0701754
NODE_96510_length_370_cov_5.811808	153	221	0	67	68	0.9852941
NODE_96510_length_370_cov_5.811808	153	221	2	1	68	0.0147059
NODE_96510_length_370_cov_5.811808	206	286	0	80	80	1.0000000
NODE_96522_length_370_cov_4.915129	157	207	7	30	50	0.6000000
NODE_96522_length_370_cov_4.915129	157	207	8	4	50	0.0800000
NODE_96522_length_370_cov_4.915129	157	207	10	16	50	0.3200000
NODE_96528_length_370_cov_4.535055	141	221	0	8	80	0.1000000
NODE_96528_length_370_cov_4.535055	141	221	2	72	80	0.9000000
NODE_96528_length_370_cov_4.535055	194	274	0	10	80	0.1250000
NODE_96528_length_370_cov_4.535055	194	274	2	70	80	0.8750000
NODE_96532_length_370_cov_4.199262	230	275	0	4	45	0.0888889
NODE_96532_length_370_cov_4.199262	230	275	2	41	45	0.9111111
NODE_96533_length_370_cov_4.151292	142	209	6	2	67	0.0298507
NODE_96533_length_370_cov_4.151292	142	209	8	65	67	0.9701493
NODE_96542_length_370_cov_3.719557	214	251	40	15	37	0.4054054
NODE_96542_length_370_cov_3.719557	214	251	42	3	37	0.0810811
NODE_96542_length_370_cov_3.719557	214	251	44	5	37	0.1351351
NODE_96542_length_370_cov_3.719557	214	251	46	8	37	0.2162162
NODE_96542_length_370_cov_3.719557	214	251	47	4	37	0.1081081
NODE_96542_length_370_cov_3.719557	214	251	49	2	37	0.0540541
NODE_96581_length_370_cov_2.822878	126	173	0	47	47	1.0000000
NODE_96668_length_370_cov_2.081181	0	52	0	2	52	0.0384615
NODE_96668_length_370_cov_2.081181	0	52	2	3	52	0.0576923
NODE_96668_length_370_cov_2.081181	0	52	4	4	52	0.0769231
NODE_96668_length_370_cov_2.081181	0	52	6	10	52	0.1923077
NODE_96668_length_370_cov_2.081181	0	52	8	12	52	0.2307692
NODE_96668_length_370_cov_2.081181	0	52	10	12	52	0.2307692
NODE_96668_length_370_cov_2.081181	0	52	14	2	52	0.0384615
NODE_96668_length_370_cov_2.081181	0	52	16	3	52	0.0576923
NODE_96668_length_370_cov_2.081181	0	52	18	4	52	0.0769231
NODE_97207_length_369_cov_36.811111	273	358	0	11	85	0.1294118
NODE_97207_length_369_cov_36.811111	273	358	4	10	85	0.1176471
NODE_97207_length_369_cov_36.811111	273	358	6	3	85	0.0352941
NODE_97207_length_369_cov_36.811111	273	358	8	19	85	0.2235294
NODE_97207_length_369_cov_36.811111	273	358	10	42	85	0.4941176
NODE_97207_length_369_cov_36.811111	273	358	0	11	85	0.1294118
NODE_97207_length_369_cov_36.811111	273	358	4	10	85	0.1176471
NODE_97207_length_369_cov_36.811111	273	358	6	3	85	0.0352941
NODE_97207_length_369_cov_36.811111	273	358	8	19	85	0.2235294
NODE_97207_length_369_cov_36.811111	273	358	10	42	85	0.4941176
NODE_97207_length_369_cov_36.811111	273	358	0	11	85	0.1294118
NODE_97207_length_369_cov_36.811111	273	358	4	10	85	0.1176471
NODE_97207_length_369_cov_36.811111	273	358	6	3	85	0.0352941
NODE_97207_length_369_cov_36.811111	273	358	8	19	85	0.2235294
NODE_97207_length_369_cov_36.811111	273	358	10	42	85	0.4941176
NODE_97211_length_369_cov_8.751852	107	187	0	35	80	0.4375000
NODE_97211_length_369_cov_8.751852	107	187	4	45	80	0.5625000
NODE_97226_length_369_cov_6.677778	189	269	0	3	80	0.0375000
NODE_97226_length_369_cov_6.677778	189	269	2	10	80	0.1250000
NODE_97226_length_369_cov_6.677778	189	269	4	21	80	0.2625000
NODE_97226_length_369_cov_6.677778	189	269	7	12	80	0.1500000
NODE_97226_length_369_cov_6.677778	189	269	8	34	80	0.4250000
NODE_97226_length_369_cov_6.677778	242	323	4	43	81	0.5308642
NODE_97226_length_369_cov_6.677778	242	323	6	3	81	0.0370370
NODE_97226_length_369_cov_6.677778	242	323	8	35	81	0.4320988
NODE_97236_length_369_cov_5.337037	199	264	2	2	65	0.0307692
NODE_97236_length_369_cov_5.337037	199	264	4	61	65	0.9384615
NODE_97236_length_369_cov_5.337037	199	264	6	2	65	0.0307692
NODE_97249_length_369_cov_4.459259	89	157	0	68	68	1.0000000
NODE_97249_length_369_cov_4.459259	130	210	0	80	80	1.0000000
NODE_97255_length_369_cov_4.111111	216	279	2	32	63	0.5079365
NODE_97255_length_369_cov_4.111111	216	279	4	31	63	0.4920635
NODE_97265_length_369_cov_3.837037	205	238	0	33	33	1.0000000
NODE_97265_length_369_cov_3.837037	211	291	0	80	80	1.0000000
NODE_97265_length_369_cov_3.837037	287	316	0	29	29	1.0000000
NODE_97346_length_369_cov_2.355556	62	142	0	54	80	0.6750000
NODE_97346_length_369_cov_2.355556	62	142	2	26	80	0.3250000
NODE_97346_length_369_cov_2.355556	114	195	0	2	81	0.0246914
NODE_97346_length_369_cov_2.355556	114	195	2	58	81	0.7160494
NODE_97346_length_369_cov_2.355556	114	195	6	21	81	0.2592593
NODE_97440_length_369_cov_1.803704	170	235	0	65	65	1.0000000
NODE_97936_length_368_cov_42.208178	231	311	0	8	80	0.1000000
NODE_97936_length_368_cov_42.208178	231	311	4	72	80	0.9000000
NODE_97936_length_368_cov_42.208178	284	364	0	11	80	0.1375000
NODE_97936_length_368_cov_42.208178	284	364	4	69	80	0.8625000
NODE_97939_length_368_cov_11.988848	47	127	0	59	80	0.7375000
NODE_97939_length_368_cov_11.988848	47	127	2	21	80	0.2625000
NODE_97939_length_368_cov_11.988848	100	180	0	16	80	0.2000000
NODE_97939_length_368_cov_11.988848	100	180	2	64	80	0.8000000
NODE_97945_length_368_cov_6.267658	133	213	0	75	80	0.9375000
NODE_97945_length_368_cov_6.267658	133	213	1	1	80	0.0125000
NODE_97945_length_368_cov_6.267658	133	213	2	4	80	0.0500000
NODE_97945_length_368_cov_6.267658	186	266	0	80	80	1.0000000
NODE_97997_length_368_cov_3.486989	127	207	4	9	80	0.1125000
NODE_97997_length_368_cov_3.486989	127	207	5	14	80	0.1750000
NODE_97997_length_368_cov_3.486989	127	207	6	57	80	0.7125000
NODE_98008_length_368_cov_3.282528	182	255	2	36	73	0.4931507
NODE_98008_length_368_cov_3.282528	182	255	4	7	73	0.0958904
NODE_98008_length_368_cov_3.282528	182	255	6	24	73	0.3287671
NODE_98008_length_368_cov_3.282528	182	255	8	6	73	0.0821918
NODE_98058_length_368_cov_2.605948	192	246	0	39	54	0.7222222
NODE_98058_length_368_cov_2.605948	192	246	2	10	54	0.1851852
NODE_98058_length_368_cov_2.605948	192	246	4	5	54	0.0925926
NODE_98123_length_368_cov_2.182156	85	145	0	46	60	0.7666667
NODE_98123_length_368_cov_2.182156	85	145	2	14	60	0.2333333
NODE_98129_length_368_cov_2.137546	66	107	0	2	41	0.0487805
NODE_98129_length_368_cov_2.137546	66	107	4	14	41	0.3414634
NODE_98129_length_368_cov_2.137546	66	107	6	25	41	0.6097561
NODE_98157_length_368_cov_1.944238	192	272	2	28	80	0.3500000
NODE_98157_length_368_cov_1.944238	192	272	4	11	80	0.1375000
NODE_98157_length_368_cov_1.944238	192	272	6	5	80	0.0625000
NODE_98157_length_368_cov_1.944238	192	272	8	36	80	0.4500000
NODE_98723_length_367_cov_7.156716	174	254	0	8	80	0.1000000
NODE_98723_length_367_cov_7.156716	174	254	2	72	80	0.9000000
NODE_98723_length_367_cov_7.156716	227	307	0	3	80	0.0375000
NODE_98723_length_367_cov_7.156716	227	307	2	77	80	0.9625000
NODE_98734_length_367_cov_5.313433	148	206	0	11	58	0.1896552
NODE_98734_length_367_cov_5.313433	148	206	3	6	58	0.1034483
NODE_98734_length_367_cov_5.313433	148	206	8	1	58	0.0172414
NODE_98734_length_367_cov_5.313433	148	206	14	1	58	0.0172414
NODE_98734_length_367_cov_5.313433	148	206	17	2	58	0.0344828
NODE_98734_length_367_cov_5.313433	148	206	18	2	58	0.0344828
NODE_98734_length_367_cov_5.313433	148	206	20	4	58	0.0689655
NODE_98734_length_367_cov_5.313433	148	206	22	12	58	0.2068966
NODE_98734_length_367_cov_5.313433	148	206	26	14	58	0.2413793
NODE_98734_length_367_cov_5.313433	148	206	28	5	58	0.0862069
NODE_98737_length_367_cov_5.138060	58	138	0	16	80	0.2000000
NODE_98737_length_367_cov_5.138060	58	138	1	34	80	0.4250000
NODE_98737_length_367_cov_5.138060	58	138	2	30	80	0.3750000
NODE_98737_length_367_cov_5.138060	111	191	2	80	80	1.0000000
NODE_98796_length_367_cov_3.059701	110	154	2	44	44	1.0000000
NODE_98796_length_367_cov_3.059701	111	146	2	35	35	1.0000000
NODE_98843_length_367_cov_2.384328	246	326	2	33	80	0.4125000
NODE_98843_length_367_cov_2.384328	246	326	6	4	80	0.0500000
NODE_98843_length_367_cov_2.384328	246	326	10	9	80	0.1125000
NODE_98843_length_367_cov_2.384328	246	326	12	8	80	0.1000000
NODE_98843_length_367_cov_2.384328	246	326	14	4	80	0.0500000
NODE_98843_length_367_cov_2.384328	246	326	16	22	80	0.2750000
NODE_98843_length_367_cov_2.384328	299	367	0	15	68	0.2205882
NODE_98843_length_367_cov_2.384328	299	367	2	53	68	0.7794118
NODE_98849_length_367_cov_2.332090	127	207	2	26	80	0.3250000
NODE_98849_length_367_cov_2.332090	127	207	4	46	80	0.5750000
NODE_98849_length_367_cov_2.332090	127	207	6	8	80	0.1000000
NODE_98909_length_367_cov_1.944030	91	156	0	65	65	1.0000000
NODE_98980_length_367_cov_1.679104	173	252	2	4	79	0.0506329
NODE_98980_length_367_cov_1.679104	173	252	4	6	79	0.0759494
NODE_98980_length_367_cov_1.679104	173	252	6	15	79	0.1898734
NODE_98980_length_367_cov_1.679104	173	252	10	3	79	0.0379747
NODE_98980_length_367_cov_1.679104	173	252	11	10	79	0.1265823
NODE_98980_length_367_cov_1.679104	173	252	13	12	79	0.1518987
NODE_98980_length_367_cov_1.679104	173	252	15	29	79	0.3670886
NODE_99005_length_367_cov_1.552239	148	200	6	38	52	0.7307692
NODE_99005_length_367_cov_1.552239	148	200	8	14	52	0.2692308
NODE_99138_length_367_cov_1.201493	79	159	0	32	80	0.4000000
NODE_99138_length_367_cov_1.201493	79	159	2	48	80	0.6000000
NODE_99138_length_367_cov_1.201493	136	179	2	43	43	1.0000000
NODE_99318_length_367_cov_0.761194	288	357	0	69	69	1.0000000
NODE_99451_length_366_cov_5.239700	193	253	0	7	60	0.1166667
NODE_99451_length_366_cov_5.239700	193	253	2	53	60	0.8833333
NODE_99472_length_366_cov_4.168539	302	355	0	53	53	1.0000000
NODE_99478_length_366_cov_3.913858	183	229	6	46	46	1.0000000
NODE_99478_length_366_cov_3.913858	203	282	0	14	79	0.1772152
NODE_99478_length_366_cov_3.913858	203	282	2	6	79	0.0759494
NODE_99478_length_366_cov_3.913858	203	282	6	59	79	0.7468355
NODE_99496_length_366_cov_3.168539	88	160	0	72	72	1.0000000
NODE_99496_length_366_cov_3.168539	133	193	0	60	60	1.0000000
NODE_100137_length_365_cov_140.101504	40	107	74	3	67	0.0447761
NODE_100137_length_365_cov_140.101504	40	107	78	1	67	0.0149254
NODE_100137_length_365_cov_140.101504	40	107	80	1	67	0.0149254
NODE_100137_length_365_cov_140.101504	40	107	82	2	67	0.0298507
NODE_100137_length_365_cov_140.101504	40	107	86	1	67	0.0149254
NODE_100137_length_365_cov_140.101504	40	107	88	1	67	0.0149254
NODE_100137_length_365_cov_140.101504	40	107	90	3	67	0.0447761
NODE_100137_length_365_cov_140.101504	40	107	92	1	67	0.0149254
NODE_100137_length_365_cov_140.101504	40	107	104	1	67	0.0149254
NODE_100137_length_365_cov_140.101504	40	107	108	6	67	0.0895522
NODE_100137_length_365_cov_140.101504	40	107	110	2	67	0.0298507
NODE_100137_length_365_cov_140.101504	40	107	114	1	67	0.0149254
NODE_100137_length_365_cov_140.101504	40	107	116	1	67	0.0149254
NODE_100137_length_365_cov_140.101504	40	107	118	1	67	0.0149254
NODE_100137_length_365_cov_140.101504	40	107	120	1	67	0.0149254
NODE_100137_length_365_cov_140.101504	40	107	122	1	67	0.0149254
NODE_100137_length_365_cov_140.101504	40	107	128	2	67	0.0298507
NODE_100137_length_365_cov_140.101504	40	107	135	1	67	0.0149254
NODE_100137_length_365_cov_140.101504	40	107	138	1	67	0.0149254
NODE_100137_length_365_cov_140.101504	40	107	140	1	67	0.0149254
NODE_100137_length_365_cov_140.101504	40	107	144	4	67	0.0597015
NODE_100137_length_365_cov_140.101504	40	107	146	2	67	0.0298507
NODE_100137_length_365_cov_140.101504	40	107	148	3	67	0.0447761
NODE_100137_length_365_cov_140.101504	40	107	150	3	67	0.0447761
NODE_100137_length_365_cov_140.101504	40	107	152	4	67	0.0597015
NODE_100137_length_365_cov_140.101504	40	107	154	2	67	0.0298507
NODE_100137_length_365_cov_140.101504	40	107	156	1	67	0.0149254
NODE_100137_length_365_cov_140.101504	40	107	158	15	67	0.2238806
NODE_100137_length_365_cov_140.101504	40	107	160	1	67	0.0149254
NODE_100138_length_365_cov_45.815789	0	38	0	38	38	1.0000000
NODE_100138_length_365_cov_45.815789	11	91	0	80	80	1.0000000
NODE_100140_length_365_cov_8.169173	191	244	5	13	53	0.2452830
NODE_100140_length_365_cov_8.169173	191	244	7	1	53	0.0188679
NODE_100140_length_365_cov_8.169173	191	244	8	39	53	0.7358491
NODE_100140_length_365_cov_8.169173	217	297	0	10	80	0.1250000
NODE_100140_length_365_cov_8.169173	217	297	2	9	80	0.1125000
NODE_100140_length_365_cov_8.169173	217	297	3	1	80	0.0125000
NODE_100140_length_365_cov_8.169173	217	297	4	8	80	0.1000000
NODE_100140_length_365_cov_8.169173	217	297	6	6	80	0.0750000
NODE_100140_length_365_cov_8.169173	217	297	8	46	80	0.5750000
NODE_100145_length_365_cov_5.954887	136	216	2	71	80	0.8875000
NODE_100145_length_365_cov_5.954887	136	216	4	9	80	0.1125000
NODE_100145_length_365_cov_5.954887	189	269	2	73	80	0.9125000
NODE_100145_length_365_cov_5.954887	189	269	4	7	80	0.0875000
NODE_100147_length_365_cov_5.721805	37	78	0	41	41	1.0000000
NODE_100168_length_365_cov_4.195489	269	329	4	6	60	0.1000000
NODE_100168_length_365_cov_4.195489	269	329	6	7	60	0.1166667
NODE_100168_length_365_cov_4.195489	269	329	8	2	60	0.0333333
NODE_100168_length_365_cov_4.195489	269	329	10	45	60	0.7500000
NODE_100172_length_365_cov_4.071429	106	186	0	80	80	1.0000000
NODE_100172_length_365_cov_4.071429	159	239	0	80	80	1.0000000
NODE_100180_length_365_cov_3.879699	131	187	1	21	56	0.3750000
NODE_100180_length_365_cov_3.879699	131	187	2	20	56	0.3571429
NODE_100180_length_365_cov_3.879699	131	187	4	15	56	0.2678571
NODE_100206_length_365_cov_3.270677	211	280	2	33	69	0.4782609
NODE_100206_length_365_cov_3.270677	211	280	4	24	69	0.3478261
NODE_100206_length_365_cov_3.270677	211	280	6	12	69	0.1739130
NODE_100253_length_365_cov_2.601504	189	265	0	14	76	0.1842105
NODE_100253_length_365_cov_2.601504	189	265	2	12	76	0.1578947
NODE_100253_length_365_cov_2.601504	189	265	4	50	76	0.6578947
NODE_100293_length_365_cov_2.289474	169	249	0	80	80	1.0000000
NODE_100407_length_365_cov_1.635338	156	235	0	2	79	0.0253165
NODE_100407_length_365_cov_1.635338	156	235	1	15	79	0.1898734
NODE_100407_length_365_cov_1.635338	156	235	2	4	79	0.0506329
NODE_100407_length_365_cov_1.635338	156	235	4	2	79	0.0253165
NODE_100407_length_365_cov_1.635338	156	235	6	2	79	0.0253165
NODE_100407_length_365_cov_1.635338	156	235	8	1	79	0.0126582
NODE_100407_length_365_cov_1.635338	156	235	9	4	79	0.0506329
NODE_100407_length_365_cov_1.635338	156	235	11	2	79	0.0253165
NODE_100407_length_365_cov_1.635338	156	235	12	1	79	0.0126582
NODE_100407_length_365_cov_1.635338	156	235	18	4	79	0.0506329
NODE_100407_length_365_cov_1.635338	156	235	22	3	79	0.0379747
NODE_100407_length_365_cov_1.635338	156	235	26	6	79	0.0759494
NODE_100407_length_365_cov_1.635338	156	235	28	1	79	0.0126582
NODE_100407_length_365_cov_1.635338	156	235	29	10	79	0.1265823
NODE_100407_length_365_cov_1.635338	156	235	34	7	79	0.0886076
NODE_100407_length_365_cov_1.635338	156	235	36	7	79	0.0886076
NODE_100407_length_365_cov_1.635338	156	235	37	8	79	0.1012658
NODE_100485_length_365_cov_1.421053	228	309	0	81	81	1.0000000
NODE_100570_length_365_cov_1.169173	57	137	0	41	80	0.5125000
NODE_100570_length_365_cov_1.169173	57	137	2	39	80	0.4875000
NODE_100570_length_365_cov_1.169173	65	145	0	33	80	0.4125000
NODE_100570_length_365_cov_1.169173	65	145	2	47	80	0.5875000
NODE_100570_length_365_cov_1.169173	194	274	4	23	80	0.2875000
NODE_100570_length_365_cov_1.169173	194	274	6	2	80	0.0250000
NODE_100570_length_365_cov_1.169173	194	274	8	1	80	0.0125000
NODE_100570_length_365_cov_1.169173	194	274	10	18	80	0.2250000
NODE_100570_length_365_cov_1.169173	194	274	14	1	80	0.0125000
NODE_100570_length_365_cov_1.169173	194	274	16	23	80	0.2875000
NODE_100570_length_365_cov_1.169173	194	274	20	8	80	0.1000000
NODE_100570_length_365_cov_1.169173	194	274	22	4	80	0.0500000
NODE_100893_length_364_cov_24.600000	101	181	0	80	80	1.0000000
NODE_100893_length_364_cov_24.600000	154	234	0	80	80	1.0000000
NODE_100896_length_364_cov_7.377358	0	50	0	50	50	1.0000000
NODE_100933_length_364_cov_3.988679	122	168	0	46	46	1.0000000
NODE_100935_length_364_cov_3.913208	151	208	0	5	57	0.0877193
NODE_100935_length_364_cov_3.913208	151	208	2	44	57	0.7719298
NODE_100935_length_364_cov_3.913208	151	208	4	8	57	0.1403509
NODE_100959_length_364_cov_3.305660	296	358	0	27	62	0.4354839
NODE_100959_length_364_cov_3.305660	296	358	1	2	62	0.0322581
NODE_100959_length_364_cov_3.305660	296	358	2	33	62	0.5322581
NODE_100966_length_364_cov_3.181132	78	138	0	60	60	1.0000000
NODE_100975_length_364_cov_3.041509	264	321	0	57	57	1.0000000
NODE_100975_length_364_cov_3.041509	294	359	0	65	65	1.0000000
NODE_100978_length_364_cov_3.015094	238	274	2	2	36	0.0555556
NODE_100978_length_364_cov_3.015094	238	274	4	34	36	0.9444444
NODE_101087_length_364_cov_1.977358	126	201	6	2	75	0.0266667
NODE_101087_length_364_cov_1.977358	126	201	8	13	75	0.1733333
NODE_101087_length_364_cov_1.977358	126	201	10	57	75	0.7600000
NODE_101087_length_364_cov_1.977358	126	201	11	1	75	0.0133333
NODE_101087_length_364_cov_1.977358	126	201	12	2	75	0.0266667
NODE_101141_length_364_cov_1.811321	209	256	0	47	47	1.0000000
NODE_101148_length_364_cov_1.781132	130	203	0	1	73	0.0136986
NODE_101148_length_364_cov_1.781132	130	203	2	3	73	0.0410959
NODE_101148_length_364_cov_1.781132	130	203	4	4	73	0.0547945
NODE_101148_length_364_cov_1.781132	130	203	6	49	73	0.6712329
NODE_101148_length_364_cov_1.781132	130	203	8	16	73	0.2191781
NODE_101148_length_364_cov_1.781132	183	203	0	1	20	0.0500000
NODE_101148_length_364_cov_1.781132	183	203	2	3	20	0.1500000
NODE_101148_length_364_cov_1.781132	183	203	4	4	20	0.2000000
NODE_101148_length_364_cov_1.781132	183	203	6	12	20	0.6000000
NODE_101720_length_363_cov_7.791667	121	200	0	79	79	1.0000000
NODE_101725_length_363_cov_6.484848	33	90	0	2	57	0.0350877
NODE_101725_length_363_cov_6.484848	33	90	2	27	57	0.4736842
NODE_101725_length_363_cov_6.484848	33	90	4	14	57	0.2456140
NODE_101725_length_363_cov_6.484848	33	90	6	14	57	0.2456140
NODE_101725_length_363_cov_6.484848	93	146	2	5	53	0.0943396
NODE_101725_length_363_cov_6.484848	93	146	4	8	53	0.1509434
NODE_101725_length_363_cov_6.484848	93	146	6	40	53	0.7547170
NODE_101734_length_363_cov_4.825758	154	215	0	61	61	1.0000000
NODE_101760_length_363_cov_3.950758	112	183	2	10	71	0.1408451
NODE_101760_length_363_cov_3.950758	112	183	4	58	71	0.8169014
NODE_101760_length_363_cov_3.950758	112	183	6	3	71	0.0422535
NODE_101760_length_363_cov_3.950758	156	236	0	6	80	0.0750000
NODE_101760_length_363_cov_3.950758	156	236	2	15	80	0.1875000
NODE_101760_length_363_cov_3.950758	156	236	4	59	80	0.7375000
NODE_101769_length_363_cov_3.617424	16	79	0	63	63	1.0000000
NODE_101774_length_363_cov_3.409091	241	267	0	26	26	1.0000000
NODE_101791_length_363_cov_3.087121	228	308	4	12	80	0.1500000
NODE_101791_length_363_cov_3.087121	228	308	6	1	80	0.0125000
NODE_101791_length_363_cov_3.087121	228	308	8	5	80	0.0625000
NODE_101791_length_363_cov_3.087121	228	308	10	33	80	0.4125000
NODE_101791_length_363_cov_3.087121	228	308	12	29	80	0.3625000
NODE_101809_length_363_cov_2.795455	240	320	13	1	80	0.0125000
NODE_101809_length_363_cov_2.795455	240	320	15	2	80	0.0250000
NODE_101809_length_363_cov_2.795455	240	320	17	9	80	0.1125000
NODE_101809_length_363_cov_2.795455	240	320	21	3	80	0.0375000
NODE_101809_length_363_cov_2.795455	240	320	23	2	80	0.0250000
NODE_101809_length_363_cov_2.795455	240	320	25	7	80	0.0875000
NODE_101809_length_363_cov_2.795455	240	320	26	1	80	0.0125000
NODE_101809_length_363_cov_2.795455	240	320	28	1	80	0.0125000
NODE_101809_length_363_cov_2.795455	240	320	29	4	80	0.0500000
NODE_101809_length_363_cov_2.795455	240	320	31	2	80	0.0250000
NODE_101809_length_363_cov_2.795455	240	320	34	2	80	0.0250000
NODE_101809_length_363_cov_2.795455	240	320	38	2	80	0.0250000
NODE_101809_length_363_cov_2.795455	240	320	40	2	80	0.0250000
NODE_101809_length_363_cov_2.795455	240	320	41	6	80	0.0750000
NODE_101809_length_363_cov_2.795455	240	320	45	6	80	0.0750000
NODE_101809_length_363_cov_2.795455	240	320	46	1	80	0.0125000
NODE_101809_length_363_cov_2.795455	240	320	48	2	80	0.0250000
NODE_101809_length_363_cov_2.795455	240	320	50	2	80	0.0250000
NODE_101809_length_363_cov_2.795455	240	320	52	1	80	0.0125000
NODE_101809_length_363_cov_2.795455	240	320	55	1	80	0.0125000
NODE_101809_length_363_cov_2.795455	240	320	56	9	80	0.1125000
NODE_101809_length_363_cov_2.795455	240	320	58	2	80	0.0250000
NODE_101809_length_363_cov_2.795455	240	320	59	1	80	0.0125000
NODE_101809_length_363_cov_2.795455	240	320	60	5	80	0.0625000
NODE_101809_length_363_cov_2.795455	240	320	62	6	80	0.0750000
NODE_101822_length_363_cov_2.481061	86	166	0	80	80	1.0000000
NODE_101822_length_363_cov_2.481061	139	219	0	80	80	1.0000000
NODE_101879_length_363_cov_2.034091	46	126	0	80	80	1.0000000
NODE_101879_length_363_cov_2.034091	99	153	0	54	54	1.0000000
NODE_101992_length_363_cov_1.541667	235	315	0	25	80	0.3125000
NODE_101992_length_363_cov_1.541667	235	315	2	55	80	0.6875000
NODE_102022_length_363_cov_1.477273	141	202	2	6	61	0.0983607
NODE_102022_length_363_cov_1.477273	141	202	6	4	61	0.0655738
NODE_102022_length_363_cov_1.477273	141	202	8	5	61	0.0819672
NODE_102022_length_363_cov_1.477273	141	202	12	12	61	0.1967213
NODE_102022_length_363_cov_1.477273	141	202	14	18	61	0.2950820
NODE_102022_length_363_cov_1.477273	141	202	16	16	61	0.2622951
NODE_102022_length_363_cov_1.477273	153	210	8	3	57	0.0526316
NODE_102022_length_363_cov_1.477273	153	210	12	12	57	0.2105263
NODE_102022_length_363_cov_1.477273	153	210	14	18	57	0.3157895
NODE_102022_length_363_cov_1.477273	153	210	16	24	57	0.4210526
NODE_102187_length_363_cov_1.113636	245	316	0	4	71	0.0563380
NODE_102187_length_363_cov_1.113636	245	316	8	67	71	0.9436620
NODE_102464_length_362_cov_54.927757	52	116	0	64	64	1.0000000
NODE_102465_length_362_cov_29.273764	86	166	0	80	80	1.0000000
NODE_102465_length_362_cov_29.273764	139	219	0	80	80	1.0000000
NODE_102467_length_362_cov_14.847909	130	210	0	41	80	0.5125000
NODE_102467_length_362_cov_14.847909	130	210	2	39	80	0.4875000
NODE_102467_length_362_cov_14.847909	183	263	0	5	80	0.0625000
NODE_102467_length_362_cov_14.847909	183	263	2	75	80	0.9375000
NODE_102633_length_362_cov_2.159696	133	216	0	83	83	1.0000000
NODE_103259_length_361_cov_4.641221	249	312	0	11	63	0.1746032
NODE_103259_length_361_cov_4.641221	249	312	6	11	63	0.1746032
NODE_103259_length_361_cov_4.641221	249	312	7	3	63	0.0476190
NODE_103259_length_361_cov_4.641221	249	312	8	3	63	0.0476190
NODE_103259_length_361_cov_4.641221	249	312	10	35	63	0.5555556
NODE_103280_length_361_cov_3.717557	185	265	0	29	80	0.3625000
NODE_103280_length_361_cov_3.717557	185	265	1	1	80	0.0125000
NODE_103280_length_361_cov_3.717557	185	265	2	26	80	0.3250000
NODE_103280_length_361_cov_3.717557	185	265	3	24	80	0.3000000
NODE_103280_length_361_cov_3.717557	238	265	0	27	27	1.0000000
NODE_103314_length_361_cov_2.988550	121	201	0	80	80	1.0000000
NODE_103314_length_361_cov_2.988550	174	216	0	42	42	1.0000000
NODE_103338_length_361_cov_2.641221	4	33	6	8	29	0.2758621
NODE_103338_length_361_cov_2.641221	4	33	8	3	29	0.1034483
NODE_103338_length_361_cov_2.641221	4	33	10	18	29	0.6206896
NODE_103338_length_361_cov_2.641221	101	182	0	81	81	1.0000000
NODE_103391_length_361_cov_2.137405	138	194	0	56	56	1.0000000
NODE_103396_length_361_cov_2.106870	192	256	0	64	64	1.0000000
NODE_103418_length_361_cov_1.969466	137	198	4	60	61	0.9836066
NODE_103418_length_361_cov_1.969466	137	198	6	1	61	0.0163934
NODE_103632_length_361_cov_1.343511	171	250	0	79	79	1.0000000
NODE_103802_length_361_cov_1.000000	60	123	0	63	63	1.0000000
NODE_104057_length_360_cov_8.191571	171	242	2	32	71	0.4507042
NODE_104057_length_360_cov_8.191571	171	242	4	13	71	0.1830986
NODE_104057_length_360_cov_8.191571	171	242	6	26	71	0.3661972
NODE_104057_length_360_cov_8.191571	176	242	2	27	66	0.4090909
NODE_104057_length_360_cov_8.191571	176	242	4	13	66	0.1969697
NODE_104057_length_360_cov_8.191571	176	242	6	26	66	0.3939394
NODE_104057_length_360_cov_8.191571	215	279	4	5	64	0.0781250
NODE_104057_length_360_cov_8.191571	215	279	6	59	64	0.9218750
NODE_104057_length_360_cov_8.191571	215	279	4	5	64	0.0781250
NODE_104057_length_360_cov_8.191571	215	279	6	59	64	0.9218750
NODE_104079_length_360_cov_5.003831	86	166	0	80	80	1.0000000
NODE_104091_length_360_cov_4.111111	158	238	47	2	80	0.0250000
NODE_104091_length_360_cov_4.111111	158	238	58	1	80	0.0125000
NODE_104091_length_360_cov_4.111111	158	238	64	2	80	0.0250000
NODE_104091_length_360_cov_4.111111	158	238	68	1	80	0.0125000
NODE_104091_length_360_cov_4.111111	158	238	70	2	80	0.0250000
NODE_104091_length_360_cov_4.111111	158	238	72	2	80	0.0250000
NODE_104091_length_360_cov_4.111111	158	238	80	2	80	0.0250000
NODE_104091_length_360_cov_4.111111	158	238	86	2	80	0.0250000
NODE_104091_length_360_cov_4.111111	158	238	87	1	80	0.0125000
NODE_104091_length_360_cov_4.111111	158	238	88	6	80	0.0750000
NODE_104091_length_360_cov_4.111111	158	238	90	17	80	0.2125000
NODE_104091_length_360_cov_4.111111	158	238	92	26	80	0.3250000
NODE_104091_length_360_cov_4.111111	158	238	94	16	80	0.2000000
NODE_104102_length_360_cov_3.613027	123	203	2	5	80	0.0625000
NODE_104102_length_360_cov_3.613027	123	203	4	75	80	0.9375000
NODE_104102_length_360_cov_3.613027	176	256	0	51	80	0.6375000
NODE_104102_length_360_cov_3.613027	176	256	2	7	80	0.0875000
NODE_104102_length_360_cov_3.613027	176	256	4	22	80	0.2750000
NODE_104129_length_360_cov_3.080460	48	70	0	22	22	1.0000000
NODE_104162_length_360_cov_2.689655	118	198	8	1	80	0.0125000
NODE_104162_length_360_cov_2.689655	118	198	10	6	80	0.0750000
NODE_104162_length_360_cov_2.689655	118	198	12	2	80	0.0250000
NODE_104162_length_360_cov_2.689655	118	198	14	61	80	0.7625000
NODE_104162_length_360_cov_2.689655	118	198	16	10	80	0.1250000
NODE_104261_length_360_cov_1.977011	235	286	0	51	51	1.0000000
NODE_104572_length_360_cov_1.149425	273	353	0	6	80	0.0750000
NODE_104572_length_360_cov_1.149425	273	353	2	74	80	0.9250000
NODE_104669_length_360_cov_0.965517	119	175	0	53	56	0.9464286
NODE_104669_length_360_cov_0.965517	119	175	2	3	56	0.0535714
NODE_104671_length_360_cov_0.957854	140	186	0	23	46	0.5000000
NODE_104671_length_360_cov_0.957854	140	186	2	23	46	0.5000000
NODE_104858_length_359_cov_45.519231	140	220	4	14	80	0.1750000
NODE_104858_length_359_cov_45.519231	140	220	8	66	80	0.8250000
NODE_104858_length_359_cov_45.519231	193	273	0	29	80	0.3625000
NODE_104858_length_359_cov_45.519231	193	273	3	19	80	0.2375000
NODE_104858_length_359_cov_45.519231	193	273	4	4	80	0.0500000
NODE_104858_length_359_cov_45.519231	193	273	8	28	80	0.3500000
NODE_104932_length_359_cov_3.296154	67	147	2	10	80	0.1250000
NODE_104932_length_359_cov_3.296154	67	147	6	4	80	0.0500000
NODE_104932_length_359_cov_3.296154	67	147	8	11	80	0.1375000
NODE_104932_length_359_cov_3.296154	67	147	10	8	80	0.1000000
NODE_104932_length_359_cov_3.296154	67	147	12	7	80	0.0875000
NODE_104932_length_359_cov_3.296154	67	147	14	7	80	0.0875000
NODE_104932_length_359_cov_3.296154	67	147	16	12	80	0.1500000
NODE_104932_length_359_cov_3.296154	67	147	17	11	80	0.1375000
NODE_104932_length_359_cov_3.296154	67	147	18	7	80	0.0875000
NODE_104932_length_359_cov_3.296154	67	147	20	3	80	0.0375000
NODE_104932_length_359_cov_3.296154	120	177	14	3	57	0.0526316
NODE_104932_length_359_cov_3.296154	120	177	16	24	57	0.4210526
NODE_104932_length_359_cov_3.296154	120	177	17	11	57	0.1929825
NODE_104932_length_359_cov_3.296154	120	177	18	7	57	0.1228070
NODE_104932_length_359_cov_3.296154	120	177	20	12	57	0.2105263
NODE_104932_length_359_cov_3.296154	201	256	8	10	55	0.1818182
NODE_104932_length_359_cov_3.296154	201	256	10	4	55	0.0727273
NODE_104932_length_359_cov_3.296154	201	256	12	41	55	0.7454545
NODE_104936_length_359_cov_3.276923	5	95	0	90	90	1.0000000
NODE_104954_length_359_cov_3.007692	156	212	4	9	56	0.1607143
NODE_104954_length_359_cov_3.007692	156	212	6	3	56	0.0535714
NODE_104954_length_359_cov_3.007692	156	212	8	44	56	0.7857143
NODE_104998_length_359_cov_2.523077	148	228	0	80	80	1.0000000
NODE_104998_length_359_cov_2.523077	201	278	0	77	77	1.0000000
NODE_105002_length_359_cov_2.419231	106	186	2	49	80	0.6125000
NODE_105002_length_359_cov_2.419231	106	186	4	31	80	0.3875000
NODE_105002_length_359_cov_2.419231	159	211	2	3	52	0.0576923
NODE_105002_length_359_cov_2.419231	159	211	4	46	52	0.8846154
NODE_105002_length_359_cov_2.419231	159	211	6	1	52	0.0192308
NODE_105002_length_359_cov_2.419231	159	211	20	2	52	0.0384615
NODE_105006_length_359_cov_2.353846	172	243	0	71	71	1.0000000
NODE_105006_length_359_cov_2.353846	216	296	0	80	80	1.0000000
NODE_105026_length_359_cov_2.257692	211	270	0	19	59	0.3220339
NODE_105026_length_359_cov_2.257692	211	270	2	40	59	0.6779661
NODE_105063_length_359_cov_2.003846	8	88	0	80	80	1.0000000
NODE_105063_length_359_cov_2.003846	61	139	0	78	78	1.0000000
NODE_105106_length_359_cov_1.815385	126	207	0	81	81	1.0000000
NODE_105106_length_359_cov_1.815385	180	227	0	47	47	1.0000000
NODE_105142_length_359_cov_1.692308	88	116	0	25	28	0.8928571
NODE_105142_length_359_cov_1.692308	88	116	2	3	28	0.1071429
NODE_105373_length_359_cov_1.096154	64	89	0	1	25	0.0400000
NODE_105373_length_359_cov_1.096154	64	89	2	24	25	0.9600000
NODE_105599_length_359_cov_0.711538	222	248	0	26	26	1.0000000
NODE_105600_length_359_cov_0.707692	10	90	0	32	80	0.4000000
NODE_105600_length_359_cov_0.707692	10	90	2	14	80	0.1750000
NODE_105600_length_359_cov_0.707692	10	90	4	34	80	0.4250000
NODE_105600_length_359_cov_0.707692	10	90	0	32	80	0.4000000
NODE_105600_length_359_cov_0.707692	10	90	2	14	80	0.1750000
NODE_105600_length_359_cov_0.707692	10	90	4	34	80	0.4250000
NODE_105600_length_359_cov_0.707692	63	143	2	2	80	0.0250000
NODE_105600_length_359_cov_0.707692	63	143	4	78	80	0.9750000
NODE_105678_length_358_cov_19.760618	213	293	0	44	80	0.5500000
NODE_105678_length_358_cov_19.760618	213	293	2	36	80	0.4500000
NODE_105678_length_358_cov_19.760618	266	346	0	80	80	1.0000000
NODE_105679_length_358_cov_18.455598	303	358	0	2	55	0.0363636
NODE_105679_length_358_cov_18.455598	303	358	6	3	55	0.0545455
NODE_105679_length_358_cov_18.455598	303	358	8	50	55	0.9090909
NODE_105680_length_358_cov_17.023166	0	63	0	2	63	0.0317460
NODE_105680_length_358_cov_17.023166	0	63	2	22	63	0.3492064
NODE_105680_length_358_cov_17.023166	0	63	4	22	63	0.3492064
NODE_105680_length_358_cov_17.023166	0	63	6	7	63	0.1111111
NODE_105680_length_358_cov_17.023166	0	63	8	2	63	0.0317460
NODE_105680_length_358_cov_17.023166	0	63	10	2	63	0.0317460
NODE_105680_length_358_cov_17.023166	0	63	16	6	63	0.0952381
NODE_105680_length_358_cov_17.023166	0	63	0	2	63	0.0317460
NODE_105680_length_358_cov_17.023166	0	63	2	22	63	0.3492064
NODE_105680_length_358_cov_17.023166	0	63	4	22	63	0.3492064
NODE_105680_length_358_cov_17.023166	0	63	6	7	63	0.1111111
NODE_105680_length_358_cov_17.023166	0	63	8	2	63	0.0317460
NODE_105680_length_358_cov_17.023166	0	63	10	2	63	0.0317460
NODE_105680_length_358_cov_17.023166	0	63	16	6	63	0.0952381
NODE_105680_length_358_cov_17.023166	0	63	0	2	63	0.0317460
NODE_105680_length_358_cov_17.023166	0	63	2	22	63	0.3492064
NODE_105680_length_358_cov_17.023166	0	63	4	22	63	0.3492064
NODE_105680_length_358_cov_17.023166	0	63	6	7	63	0.1111111
NODE_105680_length_358_cov_17.023166	0	63	8	2	63	0.0317460
NODE_105680_length_358_cov_17.023166	0	63	10	2	63	0.0317460
NODE_105680_length_358_cov_17.023166	0	63	16	6	63	0.0952381
NODE_105680_length_358_cov_17.023166	36	116	4	10	80	0.1250000
NODE_105680_length_358_cov_17.023166	36	116	6	7	80	0.0875000
NODE_105680_length_358_cov_17.023166	36	116	8	2	80	0.0250000
NODE_105680_length_358_cov_17.023166	36	116	10	2	80	0.0250000
NODE_105680_length_358_cov_17.023166	36	116	16	57	80	0.7125000
NODE_105680_length_358_cov_17.023166	36	116	18	2	80	0.0250000
NODE_105680_length_358_cov_17.023166	53	115	8	2	62	0.0322581
NODE_105680_length_358_cov_17.023166	53	115	10	2	62	0.0322581
NODE_105680_length_358_cov_17.023166	53	115	16	56	62	0.9032258
NODE_105680_length_358_cov_17.023166	53	115	18	2	62	0.0322581
NODE_105686_length_358_cov_6.509653	109	155	0	46	46	1.0000000
NODE_105710_length_358_cov_4.239382	114	143	2	6	29	0.2068966
NODE_105710_length_358_cov_4.239382	114	143	4	1	29	0.0344828
NODE_105710_length_358_cov_4.239382	114	143	6	8	29	0.2758621
NODE_105710_length_358_cov_4.239382	114	143	8	4	29	0.1379310
NODE_105710_length_358_cov_4.239382	114	143	12	4	29	0.1379310
NODE_105710_length_358_cov_4.239382	114	143	16	6	29	0.2068966
NODE_105710_length_358_cov_4.239382	180	245	10	8	65	0.1230769
NODE_105710_length_358_cov_4.239382	180	245	12	6	65	0.0923077
NODE_105710_length_358_cov_4.239382	180	245	14	10	65	0.1538462
NODE_105710_length_358_cov_4.239382	180	245	16	41	65	0.6307693
NODE_105710_length_358_cov_4.239382	218	298	4	37	80	0.4625000
NODE_105710_length_358_cov_4.239382	218	298	5	2	80	0.0250000
NODE_105710_length_358_cov_4.239382	218	298	6	9	80	0.1125000
NODE_105710_length_358_cov_4.239382	218	298	8	1	80	0.0125000
NODE_105710_length_358_cov_4.239382	218	298	10	12	80	0.1500000
NODE_105710_length_358_cov_4.239382	218	298	12	6	80	0.0750000
NODE_105710_length_358_cov_4.239382	218	298	14	6	80	0.0750000
NODE_105710_length_358_cov_4.239382	218	298	16	7	80	0.0875000
NODE_105846_length_358_cov_2.162162	229	305	0	30	76	0.3947369
NODE_105846_length_358_cov_2.162162	229	305	3	2	76	0.0263158
NODE_105846_length_358_cov_2.162162	229	305	4	13	76	0.1710526
NODE_105846_length_358_cov_2.162162	229	305	6	31	76	0.4078947
NODE_105902_length_358_cov_1.926641	290	358	0	13	68	0.1911765
NODE_105902_length_358_cov_1.926641	290	358	2	11	68	0.1617647
NODE_105902_length_358_cov_1.926641	290	358	4	44	68	0.6470588
NODE_105910_length_358_cov_1.884170	250	317	2	10	67	0.1492537
NODE_105910_length_358_cov_1.884170	250	317	4	57	67	0.8507463
NODE_105923_length_358_cov_1.841699	189	269	6	3	80	0.0375000
NODE_105923_length_358_cov_1.841699	189	269	8	2	80	0.0250000
NODE_105923_length_358_cov_1.841699	189	269	10	1	80	0.0125000
NODE_105923_length_358_cov_1.841699	189	269	14	2	80	0.0250000
NODE_105923_length_358_cov_1.841699	189	269	16	2	80	0.0250000
NODE_105923_length_358_cov_1.841699	189	269	21	1	80	0.0125000
NODE_105923_length_358_cov_1.841699	189	269	23	1	80	0.0125000
NODE_105923_length_358_cov_1.841699	189	269	25	3	80	0.0375000
NODE_105923_length_358_cov_1.841699	189	269	27	1	80	0.0125000
NODE_105923_length_358_cov_1.841699	189	269	29	5	80	0.0625000
NODE_105923_length_358_cov_1.841699	189	269	31	3	80	0.0375000
NODE_105923_length_358_cov_1.841699	189	269	33	1	80	0.0125000
NODE_105923_length_358_cov_1.841699	189	269	36	2	80	0.0250000
NODE_105923_length_358_cov_1.841699	189	269	37	7	80	0.0875000
NODE_105923_length_358_cov_1.841699	189	269	39	4	80	0.0500000
NODE_105923_length_358_cov_1.841699	189	269	43	1	80	0.0125000
NODE_105923_length_358_cov_1.841699	189	269	47	15	80	0.1875000
NODE_105923_length_358_cov_1.841699	189	269	51	25	80	0.3125000
NODE_105923_length_358_cov_1.841699	189	269	53	1	80	0.0125000
NODE_106096_length_358_cov_1.235521	99	179	18	11	80	0.1375000
NODE_106096_length_358_cov_1.235521	99	179	20	32	80	0.4000000
NODE_106096_length_358_cov_1.235521	99	179	22	31	80	0.3875000
NODE_106096_length_358_cov_1.235521	99	179	24	6	80	0.0750000
NODE_106096_length_358_cov_1.235521	152	222	4	18	70	0.2571429
NODE_106096_length_358_cov_1.235521	152	222	6	4	70	0.0571429
NODE_106096_length_358_cov_1.235521	152	222	10	1	70	0.0142857
NODE_106096_length_358_cov_1.235521	152	222	12	2	70	0.0285714
NODE_106096_length_358_cov_1.235521	152	222	18	26	70	0.3714286
NODE_106096_length_358_cov_1.235521	152	222	20	19	70	0.2714286
NODE_106189_length_358_cov_1.096525	148	228	2	80	80	1.0000000
NODE_106233_length_358_cov_0.984556	193	265	0	65	72	0.9027778
NODE_106233_length_358_cov_0.984556	193	265	2	7	72	0.0972222
NODE_106489_length_357_cov_381.833333	244	324	102	7	80	0.0875000
NODE_106489_length_357_cov_381.833333	244	324	106	1	80	0.0125000
NODE_106489_length_357_cov_381.833333	244	324	109	1	80	0.0125000
NODE_106489_length_357_cov_381.833333	244	324	113	1	80	0.0125000
NODE_106489_length_357_cov_381.833333	244	324	119	1	80	0.0125000
NODE_106489_length_357_cov_381.833333	244	324	122	1	80	0.0125000
NODE_106489_length_357_cov_381.833333	244	324	142	3	80	0.0375000
NODE_106489_length_357_cov_381.833333	244	324	146	1	80	0.0125000
NODE_106489_length_357_cov_381.833333	244	324	150	2	80	0.0250000
NODE_106489_length_357_cov_381.833333	244	324	153	1	80	0.0125000
NODE_106489_length_357_cov_381.833333	244	324	154	2	80	0.0250000
NODE_106489_length_357_cov_381.833333	244	324	157	1	80	0.0125000
NODE_106489_length_357_cov_381.833333	244	324	160	6	80	0.0750000
NODE_106489_length_357_cov_381.833333	244	324	162	52	80	0.6500000
NODE_106493_length_357_cov_7.643411	45	125	0	63	80	0.7875000
NODE_106493_length_357_cov_7.643411	45	125	2	17	80	0.2125000
NODE_106493_length_357_cov_7.643411	98	178	0	14	80	0.1750000
NODE_106493_length_357_cov_7.643411	98	178	2	66	80	0.8250000
NODE_106495_length_357_cov_7.027132	157	237	0	52	80	0.6500000
NODE_106495_length_357_cov_7.027132	157	237	2	28	80	0.3500000
NODE_106495_length_357_cov_7.027132	210	252	2	42	42	1.0000000
NODE_106496_length_357_cov_6.732558	183	263	10	13	80	0.1625000
NODE_106496_length_357_cov_6.732558	183	263	12	4	80	0.0500000
NODE_106496_length_357_cov_6.732558	183	263	14	26	80	0.3250000
NODE_106496_length_357_cov_6.732558	183	263	16	17	80	0.2125000
NODE_106496_length_357_cov_6.732558	183	263	22	8	80	0.1000000
NODE_106496_length_357_cov_6.732558	183	263	24	12	80	0.1500000
NODE_106529_length_357_cov_4.081395	145	225	0	80	80	1.0000000
NODE_106529_length_357_cov_4.081395	198	271	0	73	73	1.0000000
NODE_106542_length_357_cov_3.724806	192	265	6	73	73	1.0000000
NODE_106558_length_357_cov_3.341085	205	285	0	80	80	1.0000000
NODE_106558_length_357_cov_3.341085	258	338	0	80	80	1.0000000
NODE_106625_length_357_cov_2.414729	245	302	0	48	57	0.8421053
NODE_106625_length_357_cov_2.414729	245	302	2	9	57	0.1578947
NODE_106625_length_357_cov_2.414729	275	355	0	80	80	1.0000000
NODE_106661_length_357_cov_2.174419	250	330	0	80	80	1.0000000
NODE_106666_length_357_cov_2.166667	103	133	0	30	30	1.0000000
NODE_106666_length_357_cov_2.166667	112	133	0	21	21	1.0000000
NODE_106702_length_357_cov_1.961240	150	169	9	14	19	0.7368421
NODE_106702_length_357_cov_1.961240	150	169	10	5	19	0.2631579
NODE_106708_length_357_cov_1.918605	173	253	6	9	80	0.1125000
NODE_106708_length_357_cov_1.918605	173	253	8	4	80	0.0500000
NODE_106708_length_357_cov_1.918605	173	253	10	3	80	0.0375000
NODE_106708_length_357_cov_1.918605	173	253	12	16	80	0.2000000
NODE_106708_length_357_cov_1.918605	173	253	14	21	80	0.2625000
NODE_106708_length_357_cov_1.918605	173	253	16	10	80	0.1250000
NODE_106708_length_357_cov_1.918605	173	253	18	11	80	0.1375000
NODE_106708_length_357_cov_1.918605	173	253	19	6	80	0.0750000
NODE_106737_length_357_cov_1.782946	73	142	0	6	69	0.0869565
NODE_106737_length_357_cov_1.782946	73	142	2	7	69	0.1014493
NODE_106737_length_357_cov_1.782946	73	142	4	56	69	0.8115942
NODE_106737_length_357_cov_1.782946	115	195	0	2	80	0.0250000
NODE_106737_length_357_cov_1.782946	115	195	2	23	80	0.2875000
NODE_106737_length_357_cov_1.782946	115	195	4	55	80	0.6875000
NODE_107002_length_357_cov_1.127907	98	129	1	31	31	1.0000000
NODE_107306_length_356_cov_5.299611	140	200	22	4	60	0.0666667
NODE_107306_length_356_cov_5.299611	140	200	24	2	60	0.0333333
NODE_107306_length_356_cov_5.299611	140	200	26	21	60	0.3500000
NODE_107306_length_356_cov_5.299611	140	200	28	33	60	0.5500000
NODE_107347_length_356_cov_3.400778	255	317	2	14	62	0.2258064
NODE_107347_length_356_cov_3.400778	255	317	4	48	62	0.7741935
NODE_107347_length_356_cov_3.400778	308	353	0	9	45	0.2000000
NODE_107347_length_356_cov_3.400778	308	353	2	20	45	0.4444444
NODE_107347_length_356_cov_3.400778	308	353	4	16	45	0.3555556
NODE_107402_length_356_cov_2.657588	256	298	53	9	42	0.2142857
NODE_107402_length_356_cov_2.657588	256	298	55	10	42	0.2380952
NODE_107402_length_356_cov_2.657588	256	298	57	1	42	0.0238095
NODE_107402_length_356_cov_2.657588	256	298	59	1	42	0.0238095
NODE_107402_length_356_cov_2.657588	256	298	63	3	42	0.0714286
NODE_107402_length_356_cov_2.657588	256	298	64	6	42	0.1428571
NODE_107402_length_356_cov_2.657588	256	298	66	12	42	0.2857143
NODE_107402_length_356_cov_2.657588	265	338	30	1	73	0.0136986
NODE_107402_length_356_cov_2.657588	265	338	37	1	73	0.0136986
NODE_107402_length_356_cov_2.657588	265	338	41	1	73	0.0136986
NODE_107402_length_356_cov_2.657588	265	338	42	3	73	0.0410959
NODE_107402_length_356_cov_2.657588	265	338	44	8	73	0.1095890
NODE_107402_length_356_cov_2.657588	265	338	46	13	73	0.1780822
NODE_107402_length_356_cov_2.657588	265	338	48	4	73	0.0547945
NODE_107402_length_356_cov_2.657588	265	338	50	4	73	0.0547945
NODE_107402_length_356_cov_2.657588	265	338	51	2	73	0.0273973
NODE_107402_length_356_cov_2.657588	265	338	53	12	73	0.1643836
NODE_107402_length_356_cov_2.657588	265	338	55	10	73	0.1369863
NODE_107402_length_356_cov_2.657588	265	338	57	1	73	0.0136986
NODE_107402_length_356_cov_2.657588	265	338	59	1	73	0.0136986
NODE_107402_length_356_cov_2.657588	265	338	63	3	73	0.0410959
NODE_107402_length_356_cov_2.657588	265	338	64	6	73	0.0821918
NODE_107402_length_356_cov_2.657588	265	338	66	3	73	0.0410959
NODE_107402_length_356_cov_2.657588	299	351	9	4	52	0.0769231
NODE_107402_length_356_cov_2.657588	299	351	15	2	52	0.0384615
NODE_107402_length_356_cov_2.657588	299	351	16	1	52	0.0192308
NODE_107402_length_356_cov_2.657588	299	351	17	1	52	0.0192308
NODE_107402_length_356_cov_2.657588	299	351	25	1	52	0.0192308
NODE_107402_length_356_cov_2.657588	299	351	26	1	52	0.0192308
NODE_107402_length_356_cov_2.657588	299	351	27	2	52	0.0384615
NODE_107402_length_356_cov_2.657588	299	351	29	1	52	0.0192308
NODE_107402_length_356_cov_2.657588	299	351	30	1	52	0.0192308
NODE_107402_length_356_cov_2.657588	299	351	37	1	52	0.0192308
NODE_107402_length_356_cov_2.657588	299	351	41	1	52	0.0192308
NODE_107402_length_356_cov_2.657588	299	351	42	3	52	0.0576923
NODE_107402_length_356_cov_2.657588	299	351	44	8	52	0.1538462
NODE_107402_length_356_cov_2.657588	299	351	46	13	52	0.2500000
NODE_107402_length_356_cov_2.657588	299	351	48	4	52	0.0769231
NODE_107402_length_356_cov_2.657588	299	351	50	4	52	0.0769231
NODE_107402_length_356_cov_2.657588	299	351	51	2	52	0.0384615
NODE_107402_length_356_cov_2.657588	299	351	53	2	52	0.0384615
NODE_107452_length_356_cov_2.237354	90	135	0	2	45	0.0444444
NODE_107452_length_356_cov_2.237354	90	135	2	5	45	0.1111111
NODE_107452_length_356_cov_2.237354	90	135	6	7	45	0.1555556
NODE_107452_length_356_cov_2.237354	90	135	8	31	45	0.6888889
NODE_107475_length_356_cov_1.996109	127	194	0	66	67	0.9850746
NODE_107475_length_356_cov_1.996109	127	194	2	1	67	0.0149254
NODE_107521_length_356_cov_1.813230	296	341	2	45	45	1.0000000
NODE_107606_length_356_cov_1.560311	192	272	0	63	80	0.7875000
NODE_107606_length_356_cov_1.560311	192	272	2	2	80	0.0250000
NODE_107606_length_356_cov_1.560311	192	272	4	15	80	0.1875000
NODE_107606_length_356_cov_1.560311	245	319	0	74	74	1.0000000
NODE_108122_length_355_cov_6.796875	127	173	0	46	46	1.0000000
NODE_108210_length_355_cov_2.734375	111	162	0	51	51	1.0000000
NODE_108210_length_355_cov_2.734375	142	222	0	80	80	1.0000000
NODE_108215_length_355_cov_2.707031	277	314	0	37	37	1.0000000
NODE_108215_length_355_cov_2.707031	287	353	0	66	66	1.0000000
NODE_108239_length_355_cov_2.500000	38	82	2	23	44	0.5227273
NODE_108239_length_355_cov_2.500000	38	82	4	3	44	0.0681818
NODE_108239_length_355_cov_2.500000	38	82	6	18	44	0.4090909
NODE_108278_length_355_cov_2.207031	258	308	0	50	50	1.0000000
NODE_108284_length_355_cov_2.179688	153	233	2	73	80	0.9125000
NODE_108284_length_355_cov_2.179688	153	233	4	7	80	0.0875000
NODE_108284_length_355_cov_2.179688	206	286	0	30	80	0.3750000
NODE_108284_length_355_cov_2.179688	206	286	1	2	80	0.0250000
NODE_108284_length_355_cov_2.179688	206	286	2	48	80	0.6000000
NODE_108291_length_355_cov_2.132812	261	334	0	73	73	1.0000000
NODE_108291_length_355_cov_2.132812	301	342	0	41	41	1.0000000
NODE_108315_length_355_cov_2.007812	281	347	0	66	66	1.0000000
NODE_108395_length_355_cov_1.765625	186	247	0	27	61	0.4426230
NODE_108395_length_355_cov_1.765625	186	247	2	34	61	0.5573770
NODE_108395_length_355_cov_1.765625	220	300	2	29	80	0.3625000
NODE_108395_length_355_cov_1.765625	220	300	4	25	80	0.3125000
NODE_108395_length_355_cov_1.765625	220	300	6	26	80	0.3250000
NODE_109015_length_354_cov_6.843137	53	132	0	79	79	1.0000000
NODE_109015_length_354_cov_6.843137	53	132	0	79	79	1.0000000
NODE_109015_length_354_cov_6.843137	105	185	0	80	80	1.0000000
NODE_109015_length_354_cov_6.843137	105	185	0	80	80	1.0000000
NODE_109033_length_354_cov_4.823529	208	255	0	47	47	1.0000000
NODE_109054_length_354_cov_3.956863	145	208	0	63	63	1.0000000
NODE_109054_length_354_cov_3.956863	181	261	0	80	80	1.0000000
NODE_109057_length_354_cov_3.878431	198	244	2	46	46	1.0000000
NODE_109089_length_354_cov_3.207843	130	199	0	69	69	1.0000000
NODE_109126_length_354_cov_2.725490	179	259	0	53	80	0.6625000
NODE_109126_length_354_cov_2.725490	179	259	2	3	80	0.0375000
NODE_109126_length_354_cov_2.725490	179	259	4	24	80	0.3000000
NODE_109126_length_354_cov_2.725490	235	312	4	42	77	0.5454546
NODE_109126_length_354_cov_2.725490	235	312	6	35	77	0.4545455
NODE_109128_length_354_cov_2.713725	16	76	0	60	60	1.0000000
NODE_109128_length_354_cov_2.713725	90	149	0	59	59	1.0000000
NODE_109140_length_354_cov_2.580392	176	234	0	16	58	0.2758621
NODE_109140_length_354_cov_2.580392	176	234	2	7	58	0.1206897
NODE_109140_length_354_cov_2.580392	176	234	4	19	58	0.3275862
NODE_109140_length_354_cov_2.580392	176	234	6	6	58	0.1034483
NODE_109140_length_354_cov_2.580392	176	234	8	10	58	0.1724138
NODE_109140_length_354_cov_2.580392	207	251	4	11	44	0.2500000
NODE_109140_length_354_cov_2.580392	207	251	6	6	44	0.1363636
NODE_109140_length_354_cov_2.580392	207	251	8	27	44	0.6136364
NODE_109237_length_354_cov_1.996078	79	145	0	66	66	1.0000000
NODE_109237_length_354_cov_1.996078	118	200	0	82	82	1.0000000
NODE_109244_length_354_cov_1.988235	7	77	0	44	70	0.6285715
NODE_109244_length_354_cov_1.988235	7	77	4	26	70	0.3714286
NODE_109244_length_354_cov_1.988235	64	130	4	66	66	1.0000000
NODE_109321_length_354_cov_1.682353	99	171	0	72	72	1.0000000
NODE_109321_length_354_cov_1.682353	144	224	0	80	80	1.0000000
NODE_109852_length_353_cov_11.169291	14	90	0	76	76	1.0000000
NODE_109852_length_353_cov_11.169291	67	143	0	76	76	1.0000000
NODE_109911_length_353_cov_3.874016	220	256	0	36	36	1.0000000
NODE_109911_length_353_cov_3.874016	265	334	0	69	69	1.0000000
NODE_109928_length_353_cov_3.488189	200	282	6	29	82	0.3536585
NODE_109928_length_353_cov_3.488189	200	282	8	7	82	0.0853659
NODE_109928_length_353_cov_3.488189	200	282	10	5	82	0.0609756
NODE_109928_length_353_cov_3.488189	200	282	12	1	82	0.0121951
NODE_109928_length_353_cov_3.488189	200	282	14	8	82	0.0975610
NODE_109928_length_353_cov_3.488189	200	282	16	32	82	0.3902439
NODE_109976_length_353_cov_2.826772	8	88	0	31	80	0.3875000
NODE_109976_length_353_cov_2.826772	8	88	2	4	80	0.0500000
NODE_109976_length_353_cov_2.826772	8	88	4	45	80	0.5625000
NODE_109976_length_353_cov_2.826772	61	120	4	59	59	1.0000000
NODE_110022_length_353_cov_2.417323	260	336	0	14	76	0.1842105
NODE_110022_length_353_cov_2.417323	260	336	2	62	76	0.8157895
NODE_110610_length_353_cov_0.744094	299	318	0	19	19	1.0000000
NODE_110708_length_352_cov_34.691700	110	203	0	45	93	0.4838710
NODE_110708_length_352_cov_34.691700	110	203	2	4	93	0.0430108
NODE_110708_length_352_cov_34.691700	110	203	6	43	93	0.4623656
NODE_110708_length_352_cov_34.691700	110	203	18	1	93	0.0107527
NODE_110710_length_352_cov_17.944664	20	100	0	80	80	1.0000000
NODE_110710_length_352_cov_17.944664	73	153	0	80	80	1.0000000
NODE_110710_length_352_cov_17.944664	273	352	0	47	79	0.5949367
NODE_110710_length_352_cov_17.944664	273	352	2	32	79	0.4050633
NODE_110735_length_352_cov_4.707510	157	237	0	20	80	0.2500000
NODE_110735_length_352_cov_4.707510	157	237	2	60	80	0.7500000
NODE_110749_length_352_cov_4.221344	144	205	0	61	61	1.0000000
NODE_110749_length_352_cov_4.221344	178	259	0	81	81	1.0000000
NODE_110754_length_352_cov_4.011858	98	143	0	45	45	1.0000000
NODE_110754_length_352_cov_4.011858	151	228	0	77	77	1.0000000
NODE_110798_length_352_cov_2.849802	74	154	0	61	80	0.7625000
NODE_110798_length_352_cov_2.849802	74	154	2	19	80	0.2375000
NODE_110798_length_352_cov_2.849802	127	198	0	71	71	1.0000000
NODE_110820_length_352_cov_2.683794	0	77	2	1	77	0.0129870
NODE_110820_length_352_cov_2.683794	0	77	4	76	77	0.9870130
NODE_110820_length_352_cov_2.683794	50	130	4	43	80	0.5375000
NODE_110820_length_352_cov_2.683794	50	130	6	9	80	0.1125000
NODE_110820_length_352_cov_2.683794	50	130	8	28	80	0.3500000
NODE_110832_length_352_cov_2.608696	90	136	0	46	46	1.0000000
NODE_110832_length_352_cov_2.608696	144	189	0	45	45	1.0000000
NODE_110838_length_352_cov_2.577075	111	191	2	8	80	0.1000000
NODE_110838_length_352_cov_2.577075	111	191	4	62	80	0.7750000
NODE_110838_length_352_cov_2.577075	111	191	6	10	80	0.1250000
NODE_110876_length_352_cov_2.264822	171	251	0	80	80	1.0000000
NODE_110938_length_352_cov_2.007905	277	326	0	29	49	0.5918368
NODE_110938_length_352_cov_2.007905	277	326	2	20	49	0.4081633
NODE_111439_length_352_cov_0.806324	165	238	17	1	73	0.0136986
NODE_111439_length_352_cov_0.806324	165	238	27	1	73	0.0136986
NODE_111439_length_352_cov_0.806324	165	238	31	1	73	0.0136986
NODE_111439_length_352_cov_0.806324	165	238	33	1	73	0.0136986
NODE_111439_length_352_cov_0.806324	165	238	37	1	73	0.0136986
NODE_111439_length_352_cov_0.806324	165	238	47	1	73	0.0136986
NODE_111439_length_352_cov_0.806324	165	238	49	1	73	0.0136986
NODE_111439_length_352_cov_0.806324	165	238	51	1	73	0.0136986
NODE_111439_length_352_cov_0.806324	165	238	53	2	73	0.0273973
NODE_111439_length_352_cov_0.806324	165	238	55	1	73	0.0136986
NODE_111439_length_352_cov_0.806324	165	238	57	5	73	0.0684932
NODE_111439_length_352_cov_0.806324	165	238	59	2	73	0.0273973
NODE_111439_length_352_cov_0.806324	165	238	64	1	73	0.0136986
NODE_111439_length_352_cov_0.806324	165	238	65	7	73	0.0958904
NODE_111439_length_352_cov_0.806324	165	238	67	3	73	0.0410959
NODE_111439_length_352_cov_0.806324	165	238	69	1	73	0.0136986
NODE_111439_length_352_cov_0.806324	165	238	73	1	73	0.0136986
NODE_111439_length_352_cov_0.806324	165	238	75	1	73	0.0136986
NODE_111439_length_352_cov_0.806324	165	238	77	3	73	0.0410959
NODE_111439_length_352_cov_0.806324	165	238	79	1	73	0.0136986
NODE_111439_length_352_cov_0.806324	165	238	81	3	73	0.0410959
NODE_111439_length_352_cov_0.806324	165	238	83	4	73	0.0547945
NODE_111439_length_352_cov_0.806324	165	238	85	4	73	0.0547945
NODE_111439_length_352_cov_0.806324	165	238	87	2	73	0.0273973
NODE_111439_length_352_cov_0.806324	165	238	89	1	73	0.0136986
NODE_111439_length_352_cov_0.806324	165	238	93	1	73	0.0136986
NODE_111439_length_352_cov_0.806324	165	238	97	5	73	0.0684932
NODE_111439_length_352_cov_0.806324	165	238	101	1	73	0.0136986
NODE_111439_length_352_cov_0.806324	165	238	103	2	73	0.0273973
NODE_111439_length_352_cov_0.806324	165	238	105	1	73	0.0136986
NODE_111439_length_352_cov_0.806324	165	238	107	4	73	0.0547945
NODE_111439_length_352_cov_0.806324	165	238	108	1	73	0.0136986
NODE_111439_length_352_cov_0.806324	165	238	109	8	73	0.1095890
NODE_111593_length_351_cov_5.003968	115	195	0	80	80	1.0000000
NODE_111662_length_351_cov_2.900794	289	320	0	31	31	1.0000000
NODE_111738_length_351_cov_2.376984	79	159	0	14	80	0.1750000
NODE_111738_length_351_cov_2.376984	79	159	1	1	80	0.0125000
NODE_111738_length_351_cov_2.376984	79	159	2	7	80	0.0875000
NODE_111738_length_351_cov_2.376984	79	159	4	22	80	0.2750000
NODE_111738_length_351_cov_2.376984	79	159	6	14	80	0.1750000
NODE_111738_length_351_cov_2.376984	79	159	8	4	80	0.0500000
NODE_111738_length_351_cov_2.376984	79	159	10	10	80	0.1250000
NODE_111738_length_351_cov_2.376984	79	159	12	4	80	0.0500000
NODE_111738_length_351_cov_2.376984	79	159	14	4	80	0.0500000
NODE_111759_length_351_cov_2.226190	116	170	24	2	54	0.0370370
NODE_111759_length_351_cov_2.226190	116	170	28	1	54	0.0185185
NODE_111759_length_351_cov_2.226190	116	170	30	3	54	0.0555556
NODE_111759_length_351_cov_2.226190	116	170	32	3	54	0.0555556
NODE_111759_length_351_cov_2.226190	116	170	36	45	54	0.8333333
NODE_111769_length_351_cov_2.186508	198	277	0	79	79	1.0000000
NODE_111861_length_351_cov_1.809524	276	309	0	33	33	1.0000000
NODE_111969_length_351_cov_1.515873	228	299	0	58	71	0.8169014
NODE_111969_length_351_cov_1.515873	228	299	2	13	71	0.1830986
NODE_112493_length_350_cov_232.529880	25	92	32	1	67	0.0149254
NODE_112493_length_350_cov_232.529880	25	92	34	2	67	0.0298507
NODE_112493_length_350_cov_232.529880	25	92	36	3	67	0.0447761
NODE_112493_length_350_cov_232.529880	25	92	38	1	67	0.0149254
NODE_112493_length_350_cov_232.529880	25	92	42	3	67	0.0447761
NODE_112493_length_350_cov_232.529880	25	92	46	1	67	0.0149254
NODE_112493_length_350_cov_232.529880	25	92	48	1	67	0.0149254
NODE_112493_length_350_cov_232.529880	25	92	50	1	67	0.0149254
NODE_112493_length_350_cov_232.529880	25	92	58	5	67	0.0746269
NODE_112493_length_350_cov_232.529880	25	92	60	3	67	0.0447761
NODE_112493_length_350_cov_232.529880	25	92	64	1	67	0.0149254
NODE_112493_length_350_cov_232.529880	25	92	66	1	67	0.0149254
NODE_112493_length_350_cov_232.529880	25	92	70	1	67	0.0149254
NODE_112493_length_350_cov_232.529880	25	92	72	3	67	0.0447761
NODE_112493_length_350_cov_232.529880	25	92	74	1	67	0.0149254
NODE_112493_length_350_cov_232.529880	25	92	78	1	67	0.0149254
NODE_112493_length_350_cov_232.529880	25	92	80	1	67	0.0149254
NODE_112493_length_350_cov_232.529880	25	92	82	1	67	0.0149254
NODE_112493_length_350_cov_232.529880	25	92	84	1	67	0.0149254
NODE_112493_length_350_cov_232.529880	25	92	88	3	67	0.0447761
NODE_112493_length_350_cov_232.529880	25	92	96	2	67	0.0298507
NODE_112493_length_350_cov_232.529880	25	92	98	1	67	0.0149254
NODE_112493_length_350_cov_232.529880	25	92	100	5	67	0.0746269
NODE_112493_length_350_cov_232.529880	25	92	102	1	67	0.0149254
NODE_112493_length_350_cov_232.529880	25	92	104	1	67	0.0149254
NODE_112493_length_350_cov_232.529880	25	92	106	7	67	0.1044776
NODE_112493_length_350_cov_232.529880	25	92	108	1	67	0.0149254
NODE_112493_length_350_cov_232.529880	25	92	112	9	67	0.1343284
NODE_112493_length_350_cov_232.529880	25	92	114	5	67	0.0746269
NODE_112494_length_350_cov_40.677291	181	246	185	1	65	0.0153846
NODE_112494_length_350_cov_40.677291	181	246	189	3	65	0.0461538
NODE_112494_length_350_cov_40.677291	181	246	191	1	65	0.0153846
NODE_112494_length_350_cov_40.677291	181	246	192	1	65	0.0153846
NODE_112494_length_350_cov_40.677291	181	246	193	1	65	0.0153846
NODE_112494_length_350_cov_40.677291	181	246	195	1	65	0.0153846
NODE_112494_length_350_cov_40.677291	181	246	197	1	65	0.0153846
NODE_112494_length_350_cov_40.677291	181	246	201	1	65	0.0153846
NODE_112494_length_350_cov_40.677291	181	246	204	1	65	0.0153846
NODE_112494_length_350_cov_40.677291	181	246	209	1	65	0.0153846
NODE_112494_length_350_cov_40.677291	181	246	213	1	65	0.0153846
NODE_112494_length_350_cov_40.677291	181	246	215	1	65	0.0153846
NODE_112494_length_350_cov_40.677291	181	246	216	1	65	0.0153846
NODE_112494_length_350_cov_40.677291	181	246	222	1	65	0.0153846
NODE_112494_length_350_cov_40.677291	181	246	224	1	65	0.0153846
NODE_112494_length_350_cov_40.677291	181	246	226	2	65	0.0307692
NODE_112494_length_350_cov_40.677291	181	246	227	7	65	0.1076923
NODE_112494_length_350_cov_40.677291	181	246	228	2	65	0.0307692
NODE_112494_length_350_cov_40.677291	181	246	229	4	65	0.0615385
NODE_112494_length_350_cov_40.677291	181	246	230	1	65	0.0153846
NODE_112494_length_350_cov_40.677291	181	246	232	4	65	0.0615385
NODE_112494_length_350_cov_40.677291	181	246	234	4	65	0.0615385
NODE_112494_length_350_cov_40.677291	181	246	235	1	65	0.0153846
NODE_112494_length_350_cov_40.677291	181	246	236	1	65	0.0153846
NODE_112494_length_350_cov_40.677291	181	246	239	3	65	0.0461538
NODE_112494_length_350_cov_40.677291	181	246	241	1	65	0.0153846
NODE_112494_length_350_cov_40.677291	181	246	243	1	65	0.0153846
NODE_112494_length_350_cov_40.677291	181	246	244	1	65	0.0153846
NODE_112494_length_350_cov_40.677291	181	246	245	1	65	0.0153846
NODE_112494_length_350_cov_40.677291	181	246	246	1	65	0.0153846
NODE_112494_length_350_cov_40.677291	181	246	247	1	65	0.0153846
NODE_112494_length_350_cov_40.677291	181	246	250	2	65	0.0307692
NODE_112494_length_350_cov_40.677291	181	246	251	2	65	0.0307692
NODE_112494_length_350_cov_40.677291	181	246	252	1	65	0.0153846
NODE_112494_length_350_cov_40.677291	181	246	253	2	65	0.0307692
NODE_112494_length_350_cov_40.677291	181	246	254	3	65	0.0461538
NODE_112494_length_350_cov_40.677291	181	246	258	3	65	0.0461538
NODE_112535_length_350_cov_4.179283	114	194	0	2	80	0.0250000
NODE_112535_length_350_cov_4.179283	114	194	2	78	80	0.9750000
NODE_112535_length_350_cov_4.179283	167	244	0	2	77	0.0259740
NODE_112535_length_350_cov_4.179283	167	244	2	31	77	0.4025974
NODE_112535_length_350_cov_4.179283	167	244	4	7	77	0.0909091
NODE_112535_length_350_cov_4.179283	167	244	6	3	77	0.0389610
NODE_112535_length_350_cov_4.179283	167	244	9	11	77	0.1428571
NODE_112535_length_350_cov_4.179283	167	244	11	9	77	0.1168831
NODE_112535_length_350_cov_4.179283	167	244	13	2	77	0.0259740
NODE_112535_length_350_cov_4.179283	167	244	15	2	77	0.0259740
NODE_112535_length_350_cov_4.179283	167	244	17	10	77	0.1298701
NODE_112554_length_350_cov_3.573705	128	202	6	33	74	0.4459459
NODE_112554_length_350_cov_3.573705	128	202	28	2	74	0.0270270
NODE_112554_length_350_cov_3.573705	128	202	30	3	74	0.0405405
NODE_112554_length_350_cov_3.573705	128	202	36	1	74	0.0135135
NODE_112554_length_350_cov_3.573705	128	202	42	10	74	0.1351351
NODE_112554_length_350_cov_3.573705	128	202	44	25	74	0.3378378
NODE_112554_length_350_cov_3.573705	178	241	5	2	63	0.0317460
NODE_112554_length_350_cov_3.573705	178	241	6	28	63	0.4444444
NODE_112554_length_350_cov_3.573705	178	241	8	33	63	0.5238096
NODE_112627_length_350_cov_2.478088	266	297	0	31	31	1.0000000
NODE_112647_length_350_cov_2.346614	97	148	53	1	51	0.0196078
NODE_112647_length_350_cov_2.346614	97	148	55	1	51	0.0196078
NODE_112647_length_350_cov_2.346614	97	148	58	2	51	0.0392157
NODE_112647_length_350_cov_2.346614	97	148	59	4	51	0.0784314
NODE_112647_length_350_cov_2.346614	97	148	60	10	51	0.1960784
NODE_112647_length_350_cov_2.346614	97	148	62	3	51	0.0588235
NODE_112647_length_350_cov_2.346614	97	148	64	3	51	0.0588235
NODE_112647_length_350_cov_2.346614	97	148	68	1	51	0.0196078
NODE_112647_length_350_cov_2.346614	97	148	70	1	51	0.0196078
NODE_112647_length_350_cov_2.346614	97	148	72	3	51	0.0588235
NODE_112647_length_350_cov_2.346614	97	148	74	1	51	0.0196078
NODE_112647_length_350_cov_2.346614	97	148	78	1	51	0.0196078
NODE_112647_length_350_cov_2.346614	97	148	79	2	51	0.0392157
NODE_112647_length_350_cov_2.346614	97	148	80	1	51	0.0196078
NODE_112647_length_350_cov_2.346614	97	148	81	9	51	0.1764706
NODE_112647_length_350_cov_2.346614	97	148	83	1	51	0.0196078
NODE_112647_length_350_cov_2.346614	97	148	84	1	51	0.0196078
NODE_112647_length_350_cov_2.346614	97	148	85	1	51	0.0196078
NODE_112647_length_350_cov_2.346614	97	148	86	5	51	0.0980392
NODE_112714_length_350_cov_2.031873	181	238	26	6	57	0.1052632
NODE_112714_length_350_cov_2.031873	181	238	28	36	57	0.6315789
NODE_112714_length_350_cov_2.031873	181	238	30	15	57	0.2631579
NODE_112997_length_350_cov_1.223108	202	275	0	36	73	0.4931507
NODE_112997_length_350_cov_1.223108	202	275	2	5	73	0.0684932
NODE_112997_length_350_cov_1.223108	202	275	4	2	73	0.0273973
NODE_112997_length_350_cov_1.223108	202	275	6	1	73	0.0136986
NODE_112997_length_350_cov_1.223108	202	275	8	11	73	0.1506849
NODE_112997_length_350_cov_1.223108	202	275	10	1	73	0.0136986
NODE_112997_length_350_cov_1.223108	202	275	12	1	73	0.0136986
NODE_112997_length_350_cov_1.223108	202	275	14	3	73	0.0410959
NODE_112997_length_350_cov_1.223108	202	275	19	1	73	0.0136986
NODE_112997_length_350_cov_1.223108	202	275	20	1	73	0.0136986
NODE_112997_length_350_cov_1.223108	202	275	22	4	73	0.0547945
NODE_112997_length_350_cov_1.223108	202	275	24	7	73	0.0958904
NODE_113450_length_349_cov_4.268000	83	163	0	47	80	0.5875000
NODE_113450_length_349_cov_4.268000	83	163	2	33	80	0.4125000
NODE_113450_length_349_cov_4.268000	83	163	0	47	80	0.5875000
NODE_113450_length_349_cov_4.268000	83	163	2	33	80	0.4125000
NODE_113450_length_349_cov_4.268000	136	216	0	1	80	0.0125000
NODE_113450_length_349_cov_4.268000	136	216	2	79	80	0.9875000
NODE_113450_length_349_cov_4.268000	145	180	2	35	35	1.0000000
NODE_113473_length_349_cov_3.648000	219	300	4	12	81	0.1481481
NODE_113473_length_349_cov_3.648000	219	300	6	15	81	0.1851852
NODE_113473_length_349_cov_3.648000	219	300	8	11	81	0.1358025
NODE_113473_length_349_cov_3.648000	219	300	10	21	81	0.2592593
NODE_113473_length_349_cov_3.648000	219	300	12	22	81	0.2716049
NODE_113480_length_349_cov_3.484000	196	276	6	8	80	0.1000000
NODE_113480_length_349_cov_3.484000	196	276	8	12	80	0.1500000
NODE_113480_length_349_cov_3.484000	196	276	10	16	80	0.2000000
NODE_113480_length_349_cov_3.484000	196	276	12	1	80	0.0125000
NODE_113480_length_349_cov_3.484000	196	276	14	11	80	0.1375000
NODE_113480_length_349_cov_3.484000	196	276	16	32	80	0.4000000
NODE_113486_length_349_cov_3.364000	219	284	10	24	65	0.3692308
NODE_113486_length_349_cov_3.364000	219	284	12	41	65	0.6307693
NODE_113511_length_349_cov_2.916000	94	189	4	10	95	0.1052632
NODE_113511_length_349_cov_2.916000	94	189	6	3	95	0.0315789
NODE_113511_length_349_cov_2.916000	94	189	8	7	95	0.0736842
NODE_113511_length_349_cov_2.916000	94	189	10	69	95	0.7263158
NODE_113511_length_349_cov_2.916000	94	189	12	6	95	0.0631579
NODE_113571_length_349_cov_2.420000	35	54	0	19	19	1.0000000
NODE_113647_length_349_cov_1.964000	32	63	0	31	31	1.0000000
NODE_113654_length_349_cov_1.928000	9	77	0	68	68	1.0000000
NODE_113654_length_349_cov_1.928000	62	115	0	53	53	1.0000000
NODE_113710_length_349_cov_1.684000	225	265	2	1	40	0.0250000
NODE_113710_length_349_cov_1.684000	225	265	4	32	40	0.8000000
NODE_113710_length_349_cov_1.684000	225	265	8	4	40	0.1000000
NODE_113710_length_349_cov_1.684000	225	265	10	1	40	0.0250000
NODE_113710_length_349_cov_1.684000	225	265	12	1	40	0.0250000
NODE_113710_length_349_cov_1.684000	225	265	14	1	40	0.0250000
NODE_113825_length_349_cov_1.392000	32	95	0	63	63	1.0000000
NODE_113961_length_349_cov_1.056000	316	339	4	23	23	1.0000000
NODE_114002_length_349_cov_1.020000	177	257	0	17	80	0.2125000
NODE_114002_length_349_cov_1.020000	177	257	2	63	80	0.7875000
NODE_114263_length_348_cov_34.867470	156	236	0	80	80	1.0000000
NODE_114263_length_348_cov_34.867470	209	289	0	80	80	1.0000000
NODE_114296_length_348_cov_4.180723	106	186	0	80	80	1.0000000
NODE_114296_length_348_cov_4.180723	159	239	0	80	80	1.0000000
NODE_114330_length_348_cov_3.277108	83	137	0	31	54	0.5740741
NODE_114330_length_348_cov_3.277108	83	137	2	7	54	0.1296296
NODE_114330_length_348_cov_3.277108	83	137	4	16	54	0.2962963
NODE_114330_length_348_cov_3.277108	145	197	4	52	52	1.0000000
NODE_114424_length_348_cov_2.305221	204	273	2	20	69	0.2898551
NODE_114424_length_348_cov_2.305221	204	273	4	49	69	0.7101449
NODE_114448_length_348_cov_2.216867	103	152	4	49	49	1.0000000
NODE_114505_length_348_cov_1.995984	170	239	4	38	69	0.5507246
NODE_114505_length_348_cov_1.995984	170	239	6	31	69	0.4492754
NODE_114591_length_348_cov_1.638554	309	346	0	37	37	1.0000000
NODE_114643_length_348_cov_1.485944	9	60	4	51	51	1.0000000
NODE_115147_length_347_cov_15.100806	57	137	2	23	80	0.2875000
NODE_115147_length_347_cov_15.100806	57	137	4	10	80	0.1250000
NODE_115147_length_347_cov_15.100806	57	137	6	47	80	0.5875000
NODE_115147_length_347_cov_15.100806	110	152	0	6	42	0.1428571
NODE_115147_length_347_cov_15.100806	110	152	2	32	42	0.7619048
NODE_115147_length_347_cov_15.100806	110	152	6	4	42	0.0952381
NODE_115147_length_347_cov_15.100806	182	209	0	27	27	1.0000000
NODE_115147_length_347_cov_15.100806	290	317	0	27	27	1.0000000
NODE_115161_length_347_cov_5.967742	110	173	2	63	63	1.0000000
NODE_115195_length_347_cov_4.028226	260	329	0	69	69	1.0000000
NODE_115321_length_347_cov_2.463710	99	141	4	30	42	0.7142857
NODE_115321_length_347_cov_2.463710	99	141	6	12	42	0.2857143
NODE_115321_length_347_cov_2.463710	108	143	4	21	35	0.6000000
NODE_115321_length_347_cov_2.463710	108	143	6	12	35	0.3428572
NODE_115321_length_347_cov_2.463710	108	143	10	2	35	0.0571429
NODE_115331_length_347_cov_2.391129	35	70	0	35	35	1.0000000
NODE_115331_length_347_cov_2.391129	37	79	0	42	42	1.0000000
NODE_115331_length_347_cov_2.391129	77	105	0	28	28	1.0000000
NODE_115397_length_347_cov_2.048387	15	34	0	19	19	1.0000000
NODE_115417_length_347_cov_1.967742	205	268	0	29	63	0.4603175
NODE_115417_length_347_cov_1.967742	205	268	2	1	63	0.0158730
NODE_115417_length_347_cov_1.967742	205	268	4	33	63	0.5238096
NODE_115450_length_347_cov_1.818548	109	156	0	47	47	1.0000000
NODE_115771_length_347_cov_1.028226	230	255	0	25	25	1.0000000
NODE_116114_length_346_cov_74.433198	10	90	0	12	80	0.1500000
NODE_116114_length_346_cov_74.433198	10	90	8	68	80	0.8500000
NODE_116114_length_346_cov_74.433198	19	90	0	3	71	0.0422535
NODE_116114_length_346_cov_74.433198	19	90	8	68	71	0.9577465
NODE_116114_length_346_cov_74.433198	192	272	4	3	80	0.0375000
NODE_116114_length_346_cov_74.433198	192	272	6	77	80	0.9625000
NODE_116115_length_346_cov_67.834008	133	213	0	17	80	0.2125000
NODE_116115_length_346_cov_67.834008	133	213	2	28	80	0.3500000
NODE_116115_length_346_cov_67.834008	133	213	3	35	80	0.4375000
NODE_116115_length_346_cov_67.834008	186	266	1	23	80	0.2875000
NODE_116115_length_346_cov_67.834008	186	266	3	57	80	0.7125000
NODE_116117_length_346_cov_10.299595	190	270	0	80	80	1.0000000
NODE_116117_length_346_cov_10.299595	243	323	0	80	80	1.0000000
NODE_116119_length_346_cov_9.566802	159	239	0	7	80	0.0875000
NODE_116119_length_346_cov_9.566802	159	239	2	4	80	0.0500000
NODE_116119_length_346_cov_9.566802	159	239	4	25	80	0.3125000
NODE_116119_length_346_cov_9.566802	159	239	7	8	80	0.1000000
NODE_116119_length_346_cov_9.566802	159	239	9	8	80	0.1000000
NODE_116119_length_346_cov_9.566802	159	239	12	11	80	0.1375000
NODE_116119_length_346_cov_9.566802	159	239	14	13	80	0.1625000
NODE_116119_length_346_cov_9.566802	159	239	16	4	80	0.0500000
NODE_116119_length_346_cov_9.566802	212	292	12	10	80	0.1250000
NODE_116119_length_346_cov_9.566802	212	292	14	13	80	0.1625000
NODE_116119_length_346_cov_9.566802	212	292	16	38	80	0.4750000
NODE_116119_length_346_cov_9.566802	212	292	18	19	80	0.2375000
NODE_116134_length_346_cov_5.506073	157	238	6	2	81	0.0246914
NODE_116134_length_346_cov_5.506073	157	238	8	11	81	0.1358025
NODE_116134_length_346_cov_5.506073	157	238	10	12	81	0.1481481
NODE_116134_length_346_cov_5.506073	157	238	12	1	81	0.0123457
NODE_116134_length_346_cov_5.506073	157	238	14	29	81	0.3580247
NODE_116134_length_346_cov_5.506073	157	238	16	26	81	0.3209876
NODE_116155_length_346_cov_4.368421	205	264	0	59	59	1.0000000
NODE_116159_length_346_cov_4.032389	121	141	2	20	20	1.0000000
NODE_116184_length_346_cov_3.400810	194	253	0	59	59	1.0000000
NODE_116212_length_346_cov_3.008097	183	263	0	80	80	1.0000000
NODE_116257_length_346_cov_2.538462	47	102	0	55	55	1.0000000
NODE_116257_length_346_cov_2.538462	118	173	0	55	55	1.0000000
NODE_116439_length_346_cov_1.700405	71	107	0	36	36	1.0000000
NODE_117035_length_345_cov_47.699187	0	66	0	66	66	1.0000000
NODE_117035_length_345_cov_47.699187	39	119	0	80	80	1.0000000
NODE_117035_length_345_cov_47.699187	115	182	0	67	67	1.0000000
NODE_117035_length_345_cov_47.699187	246	311	0	65	65	1.0000000
NODE_117036_length_345_cov_13.439024	28	108	0	80	80	1.0000000
NODE_117036_length_345_cov_13.439024	81	161	0	80	80	1.0000000
NODE_117037_length_345_cov_9.906504	224	283	0	59	59	1.0000000
NODE_117051_length_345_cov_5.475610	52	132	4	19	80	0.2375000
NODE_117051_length_345_cov_5.475610	52	132	6	3	80	0.0375000
NODE_117051_length_345_cov_5.475610	52	132	8	6	80	0.0750000
NODE_117051_length_345_cov_5.475610	52	132	10	5	80	0.0625000
NODE_117051_length_345_cov_5.475610	52	132	12	2	80	0.0250000
NODE_117051_length_345_cov_5.475610	52	132	14	1	80	0.0125000
NODE_117051_length_345_cov_5.475610	52	132	16	8	80	0.1000000
NODE_117051_length_345_cov_5.475610	52	132	18	10	80	0.1250000
NODE_117051_length_345_cov_5.475610	52	132	20	4	80	0.0500000
NODE_117051_length_345_cov_5.475610	52	132	22	22	80	0.2750000
NODE_117051_length_345_cov_5.475610	105	185	2	23	80	0.2875000
NODE_117051_length_345_cov_5.475610	105	185	4	49	80	0.6125000
NODE_117051_length_345_cov_5.475610	105	185	6	3	80	0.0375000
NODE_117051_length_345_cov_5.475610	105	185	8	5	80	0.0625000
NODE_117055_length_345_cov_5.321138	104	152	0	48	48	1.0000000
NODE_117065_length_345_cov_4.524390	205	269	0	64	64	1.0000000
NODE_117075_length_345_cov_4.109756	95	157	2	33	62	0.5322581
NODE_117075_length_345_cov_4.109756	95	157	4	29	62	0.4677419
NODE_117075_length_345_cov_4.109756	162	204	0	41	42	0.9761904
NODE_117075_length_345_cov_4.109756	162	204	2	1	42	0.0238095
NODE_117076_length_345_cov_4.073171	251	326	0	71	75	0.9466667
NODE_117076_length_345_cov_4.073171	251	326	2	4	75	0.0533333
NODE_117084_length_345_cov_3.776423	199	273	0	1	74	0.0135135
NODE_117084_length_345_cov_3.776423	199	273	2	33	74	0.4459459
NODE_117084_length_345_cov_3.776423	199	273	4	40	74	0.5405405
NODE_117084_length_345_cov_3.776423	246	326	0	9	80	0.1125000
NODE_117084_length_345_cov_3.776423	246	326	2	45	80	0.5625000
NODE_117084_length_345_cov_3.776423	246	326	4	26	80	0.3250000
NODE_117148_length_345_cov_2.821138	61	141	0	31	80	0.3875000
NODE_117148_length_345_cov_2.821138	61	141	2	49	80	0.6125000
NODE_117205_length_345_cov_2.333333	47	90	5	8	43	0.1860465
NODE_117205_length_345_cov_2.333333	47	90	7	3	43	0.0697674
NODE_117205_length_345_cov_2.333333	47	90	11	1	43	0.0232558
NODE_117205_length_345_cov_2.333333	47	90	13	5	43	0.1162791
NODE_117205_length_345_cov_2.333333	47	90	15	2	43	0.0465116
NODE_117205_length_345_cov_2.333333	47	90	16	6	43	0.1395349
NODE_117205_length_345_cov_2.333333	47	90	18	1	43	0.0232558
NODE_117205_length_345_cov_2.333333	47	90	20	3	43	0.0697674
NODE_117205_length_345_cov_2.333333	47	90	22	2	43	0.0465116
NODE_117205_length_345_cov_2.333333	47	90	24	3	43	0.0697674
NODE_117205_length_345_cov_2.333333	47	90	26	9	43	0.2093023
NODE_117205_length_345_cov_2.333333	63	147	13	1	84	0.0119048
NODE_117205_length_345_cov_2.333333	63	147	15	2	84	0.0238095
NODE_117205_length_345_cov_2.333333	63	147	16	6	84	0.0714286
NODE_117205_length_345_cov_2.333333	63	147	18	1	84	0.0119048
NODE_117205_length_345_cov_2.333333	63	147	20	3	84	0.0357143
NODE_117205_length_345_cov_2.333333	63	147	22	2	84	0.0238095
NODE_117205_length_345_cov_2.333333	63	147	24	11	84	0.1309524
NODE_117205_length_345_cov_2.333333	63	147	26	58	84	0.6904762
NODE_117219_length_345_cov_2.239837	0	81	2	1	81	0.0123457
NODE_117219_length_345_cov_2.239837	0	81	4	7	81	0.0864198
NODE_117219_length_345_cov_2.239837	0	81	6	2	81	0.0246914
NODE_117219_length_345_cov_2.239837	0	81	8	5	81	0.0617284
NODE_117219_length_345_cov_2.239837	0	81	18	3	81	0.0370370
NODE_117219_length_345_cov_2.239837	0	81	19	1	81	0.0123457
NODE_117219_length_345_cov_2.239837	0	81	20	1	81	0.0123457
NODE_117219_length_345_cov_2.239837	0	81	22	5	81	0.0617284
NODE_117219_length_345_cov_2.239837	0	81	24	4	81	0.0493827
NODE_117219_length_345_cov_2.239837	0	81	28	1	81	0.0123457
NODE_117219_length_345_cov_2.239837	0	81	29	1	81	0.0123457
NODE_117219_length_345_cov_2.239837	0	81	32	2	81	0.0246914
NODE_117219_length_345_cov_2.239837	0	81	34	3	81	0.0370370
NODE_117219_length_345_cov_2.239837	0	81	36	4	81	0.0493827
NODE_117219_length_345_cov_2.239837	0	81	38	1	81	0.0123457
NODE_117219_length_345_cov_2.239837	0	81	40	1	81	0.0123457
NODE_117219_length_345_cov_2.239837	0	81	43	3	81	0.0370370
NODE_117219_length_345_cov_2.239837	0	81	45	3	81	0.0370370
NODE_117219_length_345_cov_2.239837	0	81	47	21	81	0.2592593
NODE_117219_length_345_cov_2.239837	0	81	49	8	81	0.0987654
NODE_117219_length_345_cov_2.239837	0	81	51	4	81	0.0493827
NODE_117669_length_345_cov_1.040650	6	73	2	1	67	0.0149254
NODE_117669_length_345_cov_1.040650	6	73	4	8	67	0.1194030
NODE_117669_length_345_cov_1.040650	6	73	6	7	67	0.1044776
NODE_117669_length_345_cov_1.040650	6	73	10	7	67	0.1044776
NODE_117669_length_345_cov_1.040650	6	73	12	10	67	0.1492537
NODE_117669_length_345_cov_1.040650	6	73	16	2	67	0.0298507
NODE_117669_length_345_cov_1.040650	6	73	18	32	67	0.4776119
NODE_117989_length_344_cov_54.020408	6	55	1	13	49	0.2653061
NODE_117989_length_344_cov_54.020408	6	55	3	24	49	0.4897959
NODE_117989_length_344_cov_54.020408	6	55	4	5	49	0.1020408
NODE_117989_length_344_cov_54.020408	6	55	6	4	49	0.0816327
NODE_117989_length_344_cov_54.020408	6	55	8	3	49	0.0612245
NODE_117989_length_344_cov_54.020408	28	105	3	15	77	0.1948052
NODE_117989_length_344_cov_54.020408	28	105	4	5	77	0.0649351
NODE_117989_length_344_cov_54.020408	28	105	6	4	77	0.0519481
NODE_117989_length_344_cov_54.020408	28	105	8	48	77	0.6233766
NODE_117989_length_344_cov_54.020408	28	105	12	5	77	0.0649351
NODE_117989_length_344_cov_54.020408	28	105	3	15	77	0.1948052
NODE_117989_length_344_cov_54.020408	28	105	4	5	77	0.0649351
NODE_117989_length_344_cov_54.020408	28	105	6	4	77	0.0519481
NODE_117989_length_344_cov_54.020408	28	105	8	48	77	0.6233766
NODE_117989_length_344_cov_54.020408	28	105	12	5	77	0.0649351
NODE_117989_length_344_cov_54.020408	112	178	7	1	66	0.0151515
NODE_117989_length_344_cov_54.020408	112	178	9	21	66	0.3181818
NODE_117989_length_344_cov_54.020408	112	178	11	5	66	0.0757576
NODE_117989_length_344_cov_54.020408	112	178	12	4	66	0.0606061
NODE_117989_length_344_cov_54.020408	112	178	13	7	66	0.1060606
NODE_117989_length_344_cov_54.020408	112	178	14	28	66	0.4242424
NODE_118009_length_344_cov_5.016327	72	125	16	3	53	0.0566038
NODE_118009_length_344_cov_5.016327	72	125	18	1	53	0.0188679
NODE_118009_length_344_cov_5.016327	72	125	20	4	53	0.0754717
NODE_118009_length_344_cov_5.016327	72	125	26	7	53	0.1320755
NODE_118009_length_344_cov_5.016327	72	125	27	8	53	0.1509434
NODE_118009_length_344_cov_5.016327	72	125	28	4	53	0.0754717
NODE_118009_length_344_cov_5.016327	72	125	30	1	53	0.0188679
NODE_118009_length_344_cov_5.016327	72	125	32	8	53	0.1509434
NODE_118009_length_344_cov_5.016327	72	125	34	17	53	0.3207547
NODE_118009_length_344_cov_5.016327	136	203	22	11	67	0.1641791
NODE_118009_length_344_cov_5.016327	136	203	24	14	67	0.2089552
NODE_118009_length_344_cov_5.016327	136	203	26	3	67	0.0447761
NODE_118009_length_344_cov_5.016327	136	203	28	20	67	0.2985075
NODE_118009_length_344_cov_5.016327	136	203	30	16	67	0.2388060
NODE_118009_length_344_cov_5.016327	136	203	32	3	67	0.0447761
NODE_118017_length_344_cov_4.579592	172	254	2	1	82	0.0121951
NODE_118017_length_344_cov_4.579592	172	254	4	81	82	0.9878049
NODE_118045_length_344_cov_3.840816	197	240	2	43	43	1.0000000
NODE_118074_length_344_cov_3.293878	149	189	1	2	40	0.0500000
NODE_118074_length_344_cov_3.293878	149	189	5	38	40	0.9500000
NODE_118074_length_344_cov_3.293878	162	229	1	16	67	0.2388060
NODE_118074_length_344_cov_3.293878	162	229	3	26	67	0.3880597
NODE_118074_length_344_cov_3.293878	162	229	5	25	67	0.3731343
NODE_118111_length_344_cov_2.751020	24	87	0	60	63	0.9523810
NODE_118111_length_344_cov_2.751020	24	87	2	3	63	0.0476190
NODE_118179_length_344_cov_2.126531	274	305	6	31	31	1.0000000
NODE_118243_length_344_cov_1.914286	114	194	0	15	80	0.1875000
NODE_118243_length_344_cov_1.914286	114	194	2	65	80	0.8125000
NODE_118243_length_344_cov_1.914286	167	247	0	18	80	0.2250000
NODE_118243_length_344_cov_1.914286	167	247	2	42	80	0.5250000
NODE_118243_length_344_cov_1.914286	167	247	4	20	80	0.2500000
NODE_118297_length_344_cov_1.685714	180	220	0	9	40	0.2250000
NODE_118297_length_344_cov_1.685714	180	220	1	4	40	0.1000000
NODE_118297_length_344_cov_1.685714	180	220	2	27	40	0.6750000
NODE_118393_length_344_cov_1.457143	160	240	5	4	80	0.0500000
NODE_118393_length_344_cov_1.457143	160	240	7	6	80	0.0750000
NODE_118393_length_344_cov_1.457143	160	240	9	9	80	0.1125000
NODE_118393_length_344_cov_1.457143	160	240	10	1	80	0.0125000
NODE_118393_length_344_cov_1.457143	160	240	14	5	80	0.0625000
NODE_118393_length_344_cov_1.457143	160	240	16	1	80	0.0125000
NODE_118393_length_344_cov_1.457143	160	240	18	2	80	0.0250000
NODE_118393_length_344_cov_1.457143	160	240	20	38	80	0.4750000
NODE_118393_length_344_cov_1.457143	160	240	22	14	80	0.1750000
NODE_118393_length_344_cov_1.457143	213	273	2	8	60	0.1333333
NODE_118393_length_344_cov_1.457143	213	273	4	8	60	0.1333333
NODE_118393_length_344_cov_1.457143	213	273	5	21	60	0.3500000
NODE_118393_length_344_cov_1.457143	213	273	7	6	60	0.1000000
NODE_118393_length_344_cov_1.457143	213	273	9	9	60	0.1500000
NODE_118393_length_344_cov_1.457143	213	273	10	1	60	0.0166667
NODE_118393_length_344_cov_1.457143	213	273	14	5	60	0.0833333
NODE_118393_length_344_cov_1.457143	213	273	16	1	60	0.0166667
NODE_118393_length_344_cov_1.457143	213	273	18	1	60	0.0166667
NODE_118743_length_344_cov_0.800000	123	163	0	40	40	1.0000000
NODE_118899_length_343_cov_3.770492	2	60	0	1	58	0.0172414
NODE_118899_length_343_cov_3.770492	2	60	2	57	58	0.9827586
NODE_118905_length_343_cov_3.598361	97	170	4	48	73	0.6575342
NODE_118905_length_343_cov_3.598361	97	170	6	22	73	0.3013699
NODE_118905_length_343_cov_3.598361	97	170	8	3	73	0.0410959
NODE_118905_length_343_cov_3.598361	150	223	0	5	73	0.0684932
NODE_118905_length_343_cov_3.598361	150	223	2	21	73	0.2876712
NODE_118905_length_343_cov_3.598361	150	223	4	47	73	0.6438356
NODE_118911_length_343_cov_3.401639	48	128	2	2	80	0.0250000
NODE_118911_length_343_cov_3.401639	48	128	6	1	80	0.0125000
NODE_118911_length_343_cov_3.401639	48	128	8	2	80	0.0250000
NODE_118911_length_343_cov_3.401639	48	128	10	2	80	0.0250000
NODE_118911_length_343_cov_3.401639	48	128	12	1	80	0.0125000
NODE_118911_length_343_cov_3.401639	48	128	14	3	80	0.0375000
NODE_118911_length_343_cov_3.401639	48	128	16	1	80	0.0125000
NODE_118911_length_343_cov_3.401639	48	128	18	2	80	0.0250000
NODE_118911_length_343_cov_3.401639	48	128	20	4	80	0.0500000
NODE_118911_length_343_cov_3.401639	48	128	22	2	80	0.0250000
NODE_118911_length_343_cov_3.401639	48	128	26	2	80	0.0250000
NODE_118911_length_343_cov_3.401639	48	128	28	1	80	0.0125000
NODE_118911_length_343_cov_3.401639	48	128	30	2	80	0.0250000
NODE_118911_length_343_cov_3.401639	48	128	32	1	80	0.0125000
NODE_118911_length_343_cov_3.401639	48	128	36	1	80	0.0125000
NODE_118911_length_343_cov_3.401639	48	128	38	1	80	0.0125000
NODE_118911_length_343_cov_3.401639	48	128	40	4	80	0.0500000
NODE_118911_length_343_cov_3.401639	48	128	42	2	80	0.0250000
NODE_118911_length_343_cov_3.401639	48	128	46	12	80	0.1500000
NODE_118911_length_343_cov_3.401639	48	128	48	8	80	0.1000000
NODE_118911_length_343_cov_3.401639	48	128	50	8	80	0.1000000
NODE_118911_length_343_cov_3.401639	48	128	52	1	80	0.0125000
NODE_118911_length_343_cov_3.401639	48	128	53	4	80	0.0500000
NODE_118911_length_343_cov_3.401639	48	128	55	8	80	0.1000000
NODE_118911_length_343_cov_3.401639	48	128	57	5	80	0.0625000
NODE_118941_length_343_cov_3.049180	12	62	0	50	50	1.0000000
NODE_118941_length_343_cov_3.049180	82	111	0	17	29	0.5862069
NODE_118941_length_343_cov_3.049180	82	111	2	12	29	0.4137931
NODE_118941_length_343_cov_3.049180	133	205	2	15	72	0.2083333
NODE_118941_length_343_cov_3.049180	133	205	4	45	72	0.6250000
NODE_118941_length_343_cov_3.049180	133	205	6	8	72	0.1111111
NODE_118941_length_343_cov_3.049180	133	205	8	4	72	0.0555556
NODE_118957_length_343_cov_2.770492	236	316	10	2	80	0.0250000
NODE_118957_length_343_cov_2.770492	236	316	12	3	80	0.0375000
NODE_118957_length_343_cov_2.770492	236	316	13	1	80	0.0125000
NODE_118957_length_343_cov_2.770492	236	316	14	5	80	0.0625000
NODE_118957_length_343_cov_2.770492	236	316	16	1	80	0.0125000
NODE_118957_length_343_cov_2.770492	236	316	18	6	80	0.0750000
NODE_118957_length_343_cov_2.770492	236	316	20	1	80	0.0125000
NODE_118957_length_343_cov_2.770492	236	316	24	8	80	0.1000000
NODE_118957_length_343_cov_2.770492	236	316	26	5	80	0.0625000
NODE_118957_length_343_cov_2.770492	236	316	28	5	80	0.0625000
NODE_118957_length_343_cov_2.770492	236	316	32	1	80	0.0125000
NODE_118957_length_343_cov_2.770492	236	316	37	1	80	0.0125000
NODE_118957_length_343_cov_2.770492	236	316	39	2	80	0.0250000
NODE_118957_length_343_cov_2.770492	236	316	41	4	80	0.0500000
NODE_118957_length_343_cov_2.770492	236	316	42	4	80	0.0500000
NODE_118957_length_343_cov_2.770492	236	316	44	2	80	0.0250000
NODE_118957_length_343_cov_2.770492	236	316	46	1	80	0.0125000
NODE_118957_length_343_cov_2.770492	236	316	48	1	80	0.0125000
NODE_118957_length_343_cov_2.770492	236	316	50	2	80	0.0250000
NODE_118957_length_343_cov_2.770492	236	316	52	1	80	0.0125000
NODE_118957_length_343_cov_2.770492	236	316	54	2	80	0.0250000
NODE_118957_length_343_cov_2.770492	236	316	58	1	80	0.0125000
NODE_118957_length_343_cov_2.770492	236	316	60	1	80	0.0125000
NODE_118957_length_343_cov_2.770492	236	316	62	1	80	0.0125000
NODE_118957_length_343_cov_2.770492	236	316	64	11	80	0.1375000
NODE_118957_length_343_cov_2.770492	236	316	66	4	80	0.0500000
NODE_118957_length_343_cov_2.770492	236	316	68	1	80	0.0125000
NODE_118957_length_343_cov_2.770492	236	316	70	3	80	0.0375000
NODE_118978_length_343_cov_2.590164	167	225	0	27	58	0.4655173
NODE_118978_length_343_cov_2.590164	167	225	2	15	58	0.2586207
NODE_118978_length_343_cov_2.590164	167	225	3	8	58	0.1379310
NODE_118978_length_343_cov_2.590164	167	225	5	7	58	0.1206897
NODE_118978_length_343_cov_2.590164	167	225	6	1	58	0.0172414
NODE_118998_length_343_cov_2.430328	208	274	2	37	66	0.5606061
NODE_118998_length_343_cov_2.430328	208	274	4	29	66	0.4393939
NODE_119040_length_343_cov_2.209016	32	111	0	41	79	0.5189874
NODE_119040_length_343_cov_2.209016	32	111	2	38	79	0.4810127
NODE_119067_length_343_cov_2.081967	95	177	0	82	82	1.0000000
NODE_119067_length_343_cov_2.081967	150	199	0	49	49	1.0000000
NODE_119202_length_343_cov_1.635246	0	52	0	38	52	0.7307692
NODE_119202_length_343_cov_1.635246	0	52	2	14	52	0.2692308
NODE_119439_length_343_cov_1.143443	60	120	0	60	60	1.0000000
NODE_119834_length_342_cov_3.872428	136	216	2	47	80	0.5875000
NODE_119834_length_342_cov_3.872428	136	216	4	33	80	0.4125000
NODE_119834_length_342_cov_3.872428	189	259	0	13	70	0.1857143
NODE_119834_length_342_cov_3.872428	189	259	2	57	70	0.8142857
NODE_119840_length_342_cov_3.769547	146	212	0	66	66	1.0000000
NODE_119841_length_342_cov_3.740741	113	146	0	13	33	0.3939394
NODE_119841_length_342_cov_3.740741	113	146	4	9	33	0.2727273
NODE_119841_length_342_cov_3.740741	113	146	5	11	33	0.3333333
NODE_119846_length_342_cov_3.674897	20	100	0	12	80	0.1500000
NODE_119846_length_342_cov_3.674897	20	100	2	68	80	0.8500000
NODE_119846_length_342_cov_3.674897	73	153	0	39	80	0.4875000
NODE_119846_length_342_cov_3.674897	73	153	2	41	80	0.5125000
NODE_119847_length_342_cov_3.588477	117	197	8	63	80	0.7875000
NODE_119847_length_342_cov_3.588477	117	197	10	17	80	0.2125000
NODE_119849_length_342_cov_3.530864	72	151	0	79	79	1.0000000
NODE_119852_length_342_cov_3.423868	172	252	4	79	80	0.9875000
NODE_119852_length_342_cov_3.423868	172	252	6	1	80	0.0125000
NODE_119852_length_342_cov_3.423868	225	283	0	23	58	0.3965517
NODE_119852_length_342_cov_3.423868	225	283	2	1	58	0.0172414
NODE_119852_length_342_cov_3.423868	225	283	4	34	58	0.5862069
NODE_119922_length_342_cov_2.432099	16	81	0	65	65	1.0000000
NODE_119993_length_342_cov_2.049383	249	317	0	68	68	1.0000000
NODE_120047_length_342_cov_1.864198	138	190	2	1	52	0.0192308
NODE_120047_length_342_cov_1.864198	138	190	4	51	52	0.9807692
NODE_120047_length_342_cov_1.864198	183	243	0	10	60	0.1666667
NODE_120047_length_342_cov_1.864198	183	243	2	44	60	0.7333333
NODE_120047_length_342_cov_1.864198	183	243	4	6	60	0.1000000
NODE_120073_length_342_cov_1.720165	91	147	16	19	56	0.3392857
NODE_120073_length_342_cov_1.720165	91	147	18	37	56	0.6607143
NODE_120284_length_342_cov_1.271605	201	240	2	3	39	0.0769231
NODE_120284_length_342_cov_1.271605	201	240	4	10	39	0.2564103
NODE_120284_length_342_cov_1.271605	201	240	5	6	39	0.1538462
NODE_120284_length_342_cov_1.271605	201	240	6	20	39	0.5128205
NODE_120755_length_341_cov_15.896694	50	130	0	20	80	0.2500000
NODE_120755_length_341_cov_15.896694	50	130	2	60	80	0.7500000
NODE_120755_length_341_cov_15.896694	103	183	0	73	80	0.9125000
NODE_120755_length_341_cov_15.896694	103	183	2	7	80	0.0875000
NODE_120757_length_341_cov_9.756198	117	196	0	10	79	0.1265823
NODE_120757_length_341_cov_9.756198	117	196	2	67	79	0.8481013
NODE_120757_length_341_cov_9.756198	117	196	4	2	79	0.0253165
NODE_120770_length_341_cov_5.404959	141	220	0	27	79	0.3417721
NODE_120770_length_341_cov_5.404959	141	220	2	35	79	0.4430380
NODE_120770_length_341_cov_5.404959	141	220	3	5	79	0.0632911
NODE_120770_length_341_cov_5.404959	141	220	4	10	79	0.1265823
NODE_120770_length_341_cov_5.404959	141	220	6	2	79	0.0253165
NODE_120780_length_341_cov_4.669421	301	320	0	19	19	1.0000000
NODE_120783_length_341_cov_4.438017	57	132	0	75	75	1.0000000
NODE_120783_length_341_cov_4.438017	110	185	0	75	75	1.0000000
NODE_120785_length_341_cov_4.400826	164	244	0	80	80	1.0000000
NODE_120785_length_341_cov_4.400826	224	297	0	73	73	1.0000000
NODE_120797_length_341_cov_3.896694	58	122	0	7	64	0.1093750
NODE_120797_length_341_cov_3.896694	58	122	2	17	64	0.2656250
NODE_120797_length_341_cov_3.896694	58	122	4	1	64	0.0156250
NODE_120797_length_341_cov_3.896694	58	122	6	2	64	0.0312500
NODE_120797_length_341_cov_3.896694	58	122	8	8	64	0.1250000
NODE_120797_length_341_cov_3.896694	58	122	10	7	64	0.1093750
NODE_120797_length_341_cov_3.896694	58	122	11	5	64	0.0781250
NODE_120797_length_341_cov_3.896694	58	122	13	8	64	0.1250000
NODE_120797_length_341_cov_3.896694	58	122	15	4	64	0.0625000
NODE_120797_length_341_cov_3.896694	58	122	16	5	64	0.0781250
NODE_120805_length_341_cov_3.727273	191	273	4	2	82	0.0243902
NODE_120805_length_341_cov_3.727273	191	273	6	29	82	0.3536585
NODE_120805_length_341_cov_3.727273	191	273	8	5	82	0.0609756
NODE_120805_length_341_cov_3.727273	191	273	10	46	82	0.5609756
NODE_120805_length_341_cov_3.727273	253	326	2	6	73	0.0821918
NODE_120805_length_341_cov_3.727273	253	326	3	1	73	0.0136986
NODE_120805_length_341_cov_3.727273	253	326	4	4	73	0.0547945
NODE_120805_length_341_cov_3.727273	253	326	6	25	73	0.3424658
NODE_120805_length_341_cov_3.727273	253	326	8	10	73	0.1369863
NODE_120805_length_341_cov_3.727273	253	326	10	27	73	0.3698630
NODE_120839_length_341_cov_3.000000	91	161	2	70	70	1.0000000
NODE_120839_length_341_cov_3.000000	146	215	0	43	69	0.6231884
NODE_120839_length_341_cov_3.000000	146	215	2	26	69	0.3768116
NODE_120840_length_341_cov_3.000000	127	207	0	80	80	1.0000000
NODE_120892_length_341_cov_2.533058	92	172	0	5	80	0.0625000
NODE_120892_length_341_cov_2.533058	92	172	2	48	80	0.6000000
NODE_120892_length_341_cov_2.533058	92	172	4	27	80	0.3375000
NODE_120901_length_341_cov_2.495868	8	89	0	81	81	1.0000000
NODE_120946_length_341_cov_2.235537	10	90	0	80	80	1.0000000
NODE_120972_length_341_cov_2.103306	46	125	0	79	79	1.0000000
NODE_120994_length_341_cov_2.066116	147	184	2	3	37	0.0810811
NODE_120994_length_341_cov_2.066116	147	184	4	2	37	0.0540541
NODE_120994_length_341_cov_2.066116	147	184	6	7	37	0.1891892
NODE_120994_length_341_cov_2.066116	147	184	8	24	37	0.6486486
NODE_120994_length_341_cov_2.066116	147	184	10	1	37	0.0270270
NODE_121052_length_341_cov_1.772727	179	250	0	71	71	1.0000000
NODE_121064_length_341_cov_1.727273	105	185	0	80	80	1.0000000
NODE_121160_length_341_cov_1.475207	120	185	6	23	65	0.3538462
NODE_121160_length_341_cov_1.475207	120	185	8	42	65	0.6461539
NODE_121160_length_341_cov_1.475207	158	238	4	6	80	0.0750000
NODE_121160_length_341_cov_1.475207	158	238	6	12	80	0.1500000
NODE_121160_length_341_cov_1.475207	158	238	8	62	80	0.7750000
NODE_121173_length_341_cov_1.471074	186	266	2	15	80	0.1875000
NODE_121173_length_341_cov_1.471074	186	266	4	65	80	0.8125000
NODE_121173_length_341_cov_1.471074	239	319	2	26	80	0.3250000
NODE_121173_length_341_cov_1.471074	239	319	4	54	80	0.6750000
NODE_121211_length_341_cov_1.342975	284	322	0	38	38	1.0000000
NODE_121431_length_341_cov_0.991736	36	89	0	53	53	1.0000000
NODE_121693_length_340_cov_541.348548	86	144	219	2	58	0.0344828
NODE_121693_length_340_cov_541.348548	86	144	228	1	58	0.0172414
NODE_121693_length_340_cov_541.348548	86	144	232	1	58	0.0172414
NODE_121693_length_340_cov_541.348548	86	144	248	1	58	0.0172414
NODE_121693_length_340_cov_541.348548	86	144	254	1	58	0.0172414
NODE_121693_length_340_cov_541.348548	86	144	262	1	58	0.0172414
NODE_121693_length_340_cov_541.348548	86	144	269	1	58	0.0172414
NODE_121693_length_340_cov_541.348548	86	144	280	1	58	0.0172414
NODE_121693_length_340_cov_541.348548	86	144	285	1	58	0.0172414
NODE_121693_length_340_cov_541.348548	86	144	300	1	58	0.0172414
NODE_121693_length_340_cov_541.348548	86	144	311	1	58	0.0172414
NODE_121693_length_340_cov_541.348548	86	144	327	1	58	0.0172414
NODE_121693_length_340_cov_541.348548	86	144	336	1	58	0.0172414
NODE_121693_length_340_cov_541.348548	86	144	362	1	58	0.0172414
NODE_121693_length_340_cov_541.348548	86	144	369	1	58	0.0172414
NODE_121693_length_340_cov_541.348548	86	144	391	1	58	0.0172414
NODE_121693_length_340_cov_541.348548	86	144	393	1	58	0.0172414
NODE_121693_length_340_cov_541.348548	86	144	397	1	58	0.0172414
NODE_121693_length_340_cov_541.348548	86	144	407	1	58	0.0172414
NODE_121693_length_340_cov_541.348548	86	144	415	1	58	0.0172414
NODE_121693_length_340_cov_541.348548	86	144	432	1	58	0.0172414
NODE_121693_length_340_cov_541.348548	86	144	435	1	58	0.0172414
NODE_121693_length_340_cov_541.348548	86	144	438	1	58	0.0172414
NODE_121693_length_340_cov_541.348548	86	144	453	1	58	0.0172414
NODE_121693_length_340_cov_541.348548	86	144	465	1	58	0.0172414
NODE_121693_length_340_cov_541.348548	86	144	482	2	58	0.0344828
NODE_121693_length_340_cov_541.348548	86	144	489	1	58	0.0172414
NODE_121693_length_340_cov_541.348548	86	144	501	1	58	0.0172414
NODE_121693_length_340_cov_541.348548	86	144	513	1	58	0.0172414
NODE_121693_length_340_cov_541.348548	86	144	520	1	58	0.0172414
NODE_121693_length_340_cov_541.348548	86	144	522	1	58	0.0172414
NODE_121693_length_340_cov_541.348548	86	144	527	1	58	0.0172414
NODE_121693_length_340_cov_541.348548	86	144	536	1	58	0.0172414
NODE_121693_length_340_cov_541.348548	86	144	540	1	58	0.0172414
NODE_121693_length_340_cov_541.348548	86	144	546	1	58	0.0172414
NODE_121693_length_340_cov_541.348548	86	144	552	1	58	0.0172414
NODE_121693_length_340_cov_541.348548	86	144	564	1	58	0.0172414
NODE_121693_length_340_cov_541.348548	86	144	583	1	58	0.0172414
NODE_121693_length_340_cov_541.348548	86	144	601	1	58	0.0172414
NODE_121693_length_340_cov_541.348548	86	144	612	1	58	0.0172414
NODE_121693_length_340_cov_541.348548	86	144	613	1	58	0.0172414
NODE_121693_length_340_cov_541.348548	86	144	628	1	58	0.0172414
NODE_121693_length_340_cov_541.348548	86	144	655	1	58	0.0172414
NODE_121693_length_340_cov_541.348548	86	144	681	1	58	0.0172414
NODE_121693_length_340_cov_541.348548	86	144	692	1	58	0.0172414
NODE_121693_length_340_cov_541.348548	86	144	701	1	58	0.0172414
NODE_121693_length_340_cov_541.348548	86	144	709	1	58	0.0172414
NODE_121693_length_340_cov_541.348548	86	144	727	1	58	0.0172414
NODE_121693_length_340_cov_541.348548	86	144	755	1	58	0.0172414
NODE_121693_length_340_cov_541.348548	86	144	759	1	58	0.0172414
NODE_121693_length_340_cov_541.348548	86	144	764	1	58	0.0172414
NODE_121693_length_340_cov_541.348548	86	144	784	1	58	0.0172414
NODE_121693_length_340_cov_541.348548	86	144	796	1	58	0.0172414
NODE_121693_length_340_cov_541.348548	86	144	810	1	58	0.0172414
NODE_121693_length_340_cov_541.348548	86	144	814	1	58	0.0172414
NODE_121693_length_340_cov_541.348548	86	144	831	1	58	0.0172414
NODE_121693_length_340_cov_541.348548	86	154	219	2	68	0.0294118
NODE_121693_length_340_cov_541.348548	86	154	228	1	68	0.0147059
NODE_121693_length_340_cov_541.348548	86	154	232	1	68	0.0147059
NODE_121693_length_340_cov_541.348548	86	154	248	1	68	0.0147059
NODE_121693_length_340_cov_541.348548	86	154	254	1	68	0.0147059
NODE_121693_length_340_cov_541.348548	86	154	262	1	68	0.0147059
NODE_121693_length_340_cov_541.348548	86	154	269	1	68	0.0147059
NODE_121693_length_340_cov_541.348548	86	154	280	1	68	0.0147059
NODE_121693_length_340_cov_541.348548	86	154	285	1	68	0.0147059
NODE_121693_length_340_cov_541.348548	86	154	300	1	68	0.0147059
NODE_121693_length_340_cov_541.348548	86	154	311	1	68	0.0147059
NODE_121693_length_340_cov_541.348548	86	154	327	1	68	0.0147059
NODE_121693_length_340_cov_541.348548	86	154	336	1	68	0.0147059
NODE_121693_length_340_cov_541.348548	86	154	362	1	68	0.0147059
NODE_121693_length_340_cov_541.348548	86	154	369	1	68	0.0147059
NODE_121693_length_340_cov_541.348548	86	154	391	1	68	0.0147059
NODE_121693_length_340_cov_541.348548	86	154	393	1	68	0.0147059
NODE_121693_length_340_cov_541.348548	86	154	397	1	68	0.0147059
NODE_121693_length_340_cov_541.348548	86	154	407	1	68	0.0147059
NODE_121693_length_340_cov_541.348548	86	154	415	1	68	0.0147059
NODE_121693_length_340_cov_541.348548	86	154	432	1	68	0.0147059
NODE_121693_length_340_cov_541.348548	86	154	435	1	68	0.0147059
NODE_121693_length_340_cov_541.348548	86	154	438	1	68	0.0147059
NODE_121693_length_340_cov_541.348548	86	154	453	1	68	0.0147059
NODE_121693_length_340_cov_541.348548	86	154	465	1	68	0.0147059
NODE_121693_length_340_cov_541.348548	86	154	482	2	68	0.0294118
NODE_121693_length_340_cov_541.348548	86	154	489	1	68	0.0147059
NODE_121693_length_340_cov_541.348548	86	154	501	1	68	0.0147059
NODE_121693_length_340_cov_541.348548	86	154	513	1	68	0.0147059
NODE_121693_length_340_cov_541.348548	86	154	520	1	68	0.0147059
NODE_121693_length_340_cov_541.348548	86	154	522	1	68	0.0147059
NODE_121693_length_340_cov_541.348548	86	154	527	1	68	0.0147059
NODE_121693_length_340_cov_541.348548	86	154	536	1	68	0.0147059
NODE_121693_length_340_cov_541.348548	86	154	540	1	68	0.0147059
NODE_121693_length_340_cov_541.348548	86	154	546	1	68	0.0147059
NODE_121693_length_340_cov_541.348548	86	154	552	1	68	0.0147059
NODE_121693_length_340_cov_541.348548	86	154	564	1	68	0.0147059
NODE_121693_length_340_cov_541.348548	86	154	583	1	68	0.0147059
NODE_121693_length_340_cov_541.348548	86	154	601	1	68	0.0147059
NODE_121693_length_340_cov_541.348548	86	154	612	1	68	0.0147059
NODE_121693_length_340_cov_541.348548	86	154	613	1	68	0.0147059
NODE_121693_length_340_cov_541.348548	86	154	628	1	68	0.0147059
NODE_121693_length_340_cov_541.348548	86	154	655	1	68	0.0147059
NODE_121693_length_340_cov_541.348548	86	154	681	1	68	0.0147059
NODE_121693_length_340_cov_541.348548	86	154	692	1	68	0.0147059
NODE_121693_length_340_cov_541.348548	86	154	701	1	68	0.0147059
NODE_121693_length_340_cov_541.348548	86	154	709	1	68	0.0147059
NODE_121693_length_340_cov_541.348548	86	154	727	1	68	0.0147059
NODE_121693_length_340_cov_541.348548	86	154	755	1	68	0.0147059
NODE_121693_length_340_cov_541.348548	86	154	759	1	68	0.0147059
NODE_121693_length_340_cov_541.348548	86	154	764	1	68	0.0147059
NODE_121693_length_340_cov_541.348548	86	154	784	1	68	0.0147059
NODE_121693_length_340_cov_541.348548	86	154	796	1	68	0.0147059
NODE_121693_length_340_cov_541.348548	86	154	810	1	68	0.0147059
NODE_121693_length_340_cov_541.348548	86	154	814	1	68	0.0147059
NODE_121693_length_340_cov_541.348548	86	154	831	1	68	0.0147059
NODE_121693_length_340_cov_541.348548	86	154	850	1	68	0.0147059
NODE_121693_length_340_cov_541.348548	86	154	857	1	68	0.0147059
NODE_121693_length_340_cov_541.348548	86	154	866	1	68	0.0147059
NODE_121693_length_340_cov_541.348548	86	154	877	1	68	0.0147059
NODE_121693_length_340_cov_541.348548	86	154	884	1	68	0.0147059
NODE_121693_length_340_cov_541.348548	86	154	890	1	68	0.0147059
NODE_121693_length_340_cov_541.348548	86	154	893	1	68	0.0147059
NODE_121693_length_340_cov_541.348548	86	154	909	1	68	0.0147059
NODE_121693_length_340_cov_541.348548	86	154	924	1	68	0.0147059
NODE_121693_length_340_cov_541.348548	86	154	927	1	68	0.0147059
NODE_121693_length_340_cov_541.348548	86	107	219	2	21	0.0952381
NODE_121693_length_340_cov_541.348548	86	107	228	1	21	0.0476190
NODE_121693_length_340_cov_541.348548	86	107	232	1	21	0.0476190
NODE_121693_length_340_cov_541.348548	86	107	248	1	21	0.0476190
NODE_121693_length_340_cov_541.348548	86	107	254	1	21	0.0476190
NODE_121693_length_340_cov_541.348548	86	107	262	1	21	0.0476190
NODE_121693_length_340_cov_541.348548	86	107	269	1	21	0.0476190
NODE_121693_length_340_cov_541.348548	86	107	280	1	21	0.0476190
NODE_121693_length_340_cov_541.348548	86	107	285	1	21	0.0476190
NODE_121693_length_340_cov_541.348548	86	107	300	1	21	0.0476190
NODE_121693_length_340_cov_541.348548	86	107	311	1	21	0.0476190
NODE_121693_length_340_cov_541.348548	86	107	327	1	21	0.0476190
NODE_121693_length_340_cov_541.348548	86	107	336	1	21	0.0476190
NODE_121693_length_340_cov_541.348548	86	107	362	1	21	0.0476190
NODE_121693_length_340_cov_541.348548	86	107	369	1	21	0.0476190
NODE_121693_length_340_cov_541.348548	86	107	391	1	21	0.0476190
NODE_121693_length_340_cov_541.348548	86	107	393	1	21	0.0476190
NODE_121693_length_340_cov_541.348548	86	107	397	1	21	0.0476190
NODE_121693_length_340_cov_541.348548	86	107	407	1	21	0.0476190
NODE_121693_length_340_cov_541.348548	86	107	415	1	21	0.0476190
NODE_121694_length_340_cov_50.755187	196	266	8	8	70	0.1142857
NODE_121694_length_340_cov_50.755187	196	266	10	2	70	0.0285714
NODE_121694_length_340_cov_50.755187	196	266	12	10	70	0.1428571
NODE_121694_length_340_cov_50.755187	196	266	14	29	70	0.4142857
NODE_121694_length_340_cov_50.755187	196	266	15	4	70	0.0571429
NODE_121694_length_340_cov_50.755187	196	266	16	15	70	0.2142857
NODE_121694_length_340_cov_50.755187	196	266	17	2	70	0.0285714
NODE_121696_length_340_cov_8.917012	240	270	0	1	30	0.0333333
NODE_121696_length_340_cov_8.917012	240	270	2	29	30	0.9666666
NODE_121696_length_340_cov_8.917012	243	315	0	46	72	0.6388889
NODE_121696_length_340_cov_8.917012	243	315	2	26	72	0.3611111
NODE_121702_length_340_cov_6.439834	175	255	0	80	80	1.0000000
NODE_121702_length_340_cov_6.439834	228	310	0	82	82	1.0000000
NODE_121708_length_340_cov_5.883817	72	121	0	2	49	0.0408163
NODE_121708_length_340_cov_5.883817	72	121	2	6	49	0.1224490
NODE_121708_length_340_cov_5.883817	72	121	4	1	49	0.0204082
NODE_121708_length_340_cov_5.883817	72	121	6	40	49	0.8163266
NODE_121708_length_340_cov_5.883817	82	113	4	1	31	0.0322581
NODE_121708_length_340_cov_5.883817	82	113	6	30	31	0.9677419
NODE_121714_length_340_cov_5.228216	116	186	0	70	70	1.0000000
NODE_121714_length_340_cov_5.228216	159	201	0	39	42	0.9285714
NODE_121714_length_340_cov_5.228216	159	201	2	3	42	0.0714286
NODE_121730_length_340_cov_4.497925	136	184	0	48	48	1.0000000
NODE_121752_length_340_cov_3.759336	88	169	2	26	81	0.3209876
NODE_121752_length_340_cov_3.759336	88	169	4	55	81	0.6790124
NODE_121849_length_340_cov_2.506224	68	114	0	46	46	1.0000000
NODE_121951_length_340_cov_1.995851	29	101	0	72	72	1.0000000
NODE_121951_length_340_cov_1.995851	96	143	0	6	47	0.1276596
NODE_121951_length_340_cov_1.995851	96	143	2	6	47	0.1276596
NODE_121951_length_340_cov_1.995851	96	143	6	12	47	0.2553191
NODE_121951_length_340_cov_1.995851	96	143	8	8	47	0.1702128
NODE_121951_length_340_cov_1.995851	96	143	10	15	47	0.3191489
NODE_122154_length_340_cov_1.427386	244	274	2	30	30	1.0000000
NODE_122218_length_340_cov_1.282158	71	135	0	64	64	1.0000000
NODE_122218_length_340_cov_1.282158	128	188	0	60	60	1.0000000
NODE_122218_length_340_cov_1.282158	142	189	0	47	47	1.0000000
NODE_122220_length_340_cov_1.278008	51	102	2	38	51	0.7450981
NODE_122220_length_340_cov_1.278008	51	102	4	13	51	0.2549020
NODE_122321_length_340_cov_1.199170	98	160	3	41	62	0.6612903
NODE_122321_length_340_cov_1.199170	98	160	4	21	62	0.3387097
NODE_122381_length_340_cov_1.070539	32	65	0	33	33	1.0000000
NODE_122429_length_340_cov_1.020747	209	228	0	19	19	1.0000000
NODE_122686_length_339_cov_87.841667	149	227	89	2	78	0.0256410
NODE_122686_length_339_cov_87.841667	149	227	93	1	78	0.0128205
NODE_122686_length_339_cov_87.841667	149	227	95	1	78	0.0128205
NODE_122686_length_339_cov_87.841667	149	227	100	2	78	0.0256410
NODE_122686_length_339_cov_87.841667	149	227	104	1	78	0.0128205
NODE_122686_length_339_cov_87.841667	149	227	112	1	78	0.0128205
NODE_122686_length_339_cov_87.841667	149	227	114	3	78	0.0384615
NODE_122686_length_339_cov_87.841667	149	227	118	1	78	0.0128205
NODE_122686_length_339_cov_87.841667	149	227	122	1	78	0.0128205
NODE_122686_length_339_cov_87.841667	149	227	126	1	78	0.0128205
NODE_122686_length_339_cov_87.841667	149	227	128	1	78	0.0128205
NODE_122686_length_339_cov_87.841667	149	227	132	1	78	0.0128205
NODE_122686_length_339_cov_87.841667	149	227	136	1	78	0.0128205
NODE_122686_length_339_cov_87.841667	149	227	140	1	78	0.0128205
NODE_122686_length_339_cov_87.841667	149	227	142	1	78	0.0128205
NODE_122686_length_339_cov_87.841667	149	227	146	1	78	0.0128205
NODE_122686_length_339_cov_87.841667	149	227	157	1	78	0.0128205
NODE_122686_length_339_cov_87.841667	149	227	162	1	78	0.0128205
NODE_122686_length_339_cov_87.841667	149	227	164	2	78	0.0256410
NODE_122686_length_339_cov_87.841667	149	227	168	1	78	0.0128205
NODE_122686_length_339_cov_87.841667	149	227	171	1	78	0.0128205
NODE_122686_length_339_cov_87.841667	149	227	172	4	78	0.0512821
NODE_122686_length_339_cov_87.841667	149	227	173	1	78	0.0128205
NODE_122686_length_339_cov_87.841667	149	227	174	2	78	0.0256410
NODE_122686_length_339_cov_87.841667	149	227	175	1	78	0.0128205
NODE_122686_length_339_cov_87.841667	149	227	181	1	78	0.0128205
NODE_122686_length_339_cov_87.841667	149	227	192	1	78	0.0128205
NODE_122686_length_339_cov_87.841667	149	227	195	3	78	0.0384615
NODE_122686_length_339_cov_87.841667	149	227	198	1	78	0.0128205
NODE_122686_length_339_cov_87.841667	149	227	199	1	78	0.0128205
NODE_122686_length_339_cov_87.841667	149	227	200	3	78	0.0384615
NODE_122686_length_339_cov_87.841667	149	227	201	4	78	0.0512821
NODE_122686_length_339_cov_87.841667	149	227	202	4	78	0.0512821
NODE_122686_length_339_cov_87.841667	149	227	203	2	78	0.0256410
NODE_122686_length_339_cov_87.841667	149	227	204	3	78	0.0384615
NODE_122686_length_339_cov_87.841667	149	227	205	1	78	0.0128205
NODE_122686_length_339_cov_87.841667	149	227	213	1	78	0.0128205
NODE_122686_length_339_cov_87.841667	149	227	221	1	78	0.0128205
NODE_122686_length_339_cov_87.841667	149	227	222	1	78	0.0128205
NODE_122686_length_339_cov_87.841667	149	227	226	1	78	0.0128205
NODE_122686_length_339_cov_87.841667	149	227	227	1	78	0.0128205
NODE_122686_length_339_cov_87.841667	149	227	228	3	78	0.0384615
NODE_122686_length_339_cov_87.841667	149	227	229	2	78	0.0256410
NODE_122686_length_339_cov_87.841667	149	227	230	1	78	0.0128205
NODE_122686_length_339_cov_87.841667	149	227	232	4	78	0.0512821
NODE_122686_length_339_cov_87.841667	149	227	234	1	78	0.0128205
NODE_122686_length_339_cov_87.841667	149	227	238	4	78	0.0512821
NODE_122687_length_339_cov_14.304167	69	138	0	26	69	0.3768116
NODE_122687_length_339_cov_14.304167	69	138	2	8	69	0.1159420
NODE_122687_length_339_cov_14.304167	69	138	4	35	69	0.5072464
NODE_122687_length_339_cov_14.304167	69	138	0	26	69	0.3768116
NODE_122687_length_339_cov_14.304167	69	138	2	8	69	0.1159420
NODE_122687_length_339_cov_14.304167	69	138	4	35	69	0.5072464
NODE_122687_length_339_cov_14.304167	69	138	0	26	69	0.3768116
NODE_122687_length_339_cov_14.304167	69	138	2	8	69	0.1159420
NODE_122687_length_339_cov_14.304167	69	138	4	35	69	0.5072464
NODE_122687_length_339_cov_14.304167	88	138	0	7	50	0.1400000
NODE_122687_length_339_cov_14.304167	88	138	2	8	50	0.1600000
NODE_122687_length_339_cov_14.304167	88	138	4	35	50	0.7000000
NODE_122687_length_339_cov_14.304167	111	160	4	49	49	1.0000000
NODE_122727_length_339_cov_4.320833	187	267	0	67	80	0.8375000
NODE_122727_length_339_cov_4.320833	187	267	1	13	80	0.1625000
NODE_122804_length_339_cov_2.754167	45	125	4	80	80	1.0000000
NODE_122971_length_339_cov_1.841667	265	312	0	47	47	1.0000000
NODE_123041_length_339_cov_1.662500	10	57	2	2	47	0.0425532
NODE_123041_length_339_cov_1.662500	10	57	4	45	47	0.9574468
NODE_123182_length_339_cov_1.275000	247	312	0	65	65	1.0000000
NODE_123285_length_339_cov_1.070833	147	169	0	22	22	1.0000000
NODE_123633_length_338_cov_57.163180	59	120	0	61	61	1.0000000
NODE_123633_length_338_cov_57.163180	102	176	0	74	74	1.0000000
NODE_123674_length_338_cov_4.263598	113	165	0	52	52	1.0000000
NODE_123679_length_338_cov_4.079498	96	151	2	55	55	1.0000000
NODE_123689_length_338_cov_3.841004	122	149	2	6	27	0.2222222
NODE_123689_length_338_cov_3.841004	122	149	4	21	27	0.7777778
NODE_123793_length_338_cov_2.393305	216	288	2	72	72	1.0000000
NODE_123795_length_338_cov_2.380753	29	93	0	64	64	1.0000000
NODE_123919_length_338_cov_1.878661	146	232	8	1	86	0.0116279
NODE_123919_length_338_cov_1.878661	146	232	9	8	86	0.0930233
NODE_123919_length_338_cov_1.878661	146	232	10	1	86	0.0116279
NODE_123919_length_338_cov_1.878661	146	232	12	22	86	0.2558140
NODE_123919_length_338_cov_1.878661	146	232	14	10	86	0.1162791
NODE_123919_length_338_cov_1.878661	146	232	16	2	86	0.0232558
NODE_123919_length_338_cov_1.878661	146	232	18	3	86	0.0348837
NODE_123919_length_338_cov_1.878661	146	232	20	1	86	0.0116279
NODE_123919_length_338_cov_1.878661	146	232	22	5	86	0.0581395
NODE_123919_length_338_cov_1.878661	146	232	24	5	86	0.0581395
NODE_123919_length_338_cov_1.878661	146	232	26	12	86	0.1395349
NODE_123919_length_338_cov_1.878661	146	232	28	6	86	0.0697674
NODE_123919_length_338_cov_1.878661	146	232	30	5	86	0.0581395
NODE_123919_length_338_cov_1.878661	146	232	34	5	86	0.0581395
NODE_123944_length_338_cov_1.740586	79	159	0	6	80	0.0750000
NODE_123944_length_338_cov_1.740586	79	159	2	74	80	0.9250000
NODE_123946_length_338_cov_1.732218	216	257	0	41	41	1.0000000
NODE_124046_length_338_cov_1.493724	14	90	2	76	76	1.0000000
NODE_124247_length_338_cov_1.100418	265	333	0	68	68	1.0000000
NODE_124456_length_338_cov_0.849372	281	338	0	57	57	1.0000000
NODE_124533_length_338_cov_0.711297	188	263	4	8	75	0.1066667
NODE_124533_length_338_cov_0.711297	188	263	6	24	75	0.3200000
NODE_124533_length_338_cov_0.711297	188	263	8	43	75	0.5733333
NODE_124625_length_337_cov_468.180672	107	187	25	9	80	0.1125000
NODE_124625_length_337_cov_468.180672	107	187	27	5	80	0.0625000
NODE_124625_length_337_cov_468.180672	107	187	28	3	80	0.0375000
NODE_124625_length_337_cov_468.180672	107	187	30	1	80	0.0125000
NODE_124625_length_337_cov_468.180672	107	187	32	2	80	0.0250000
NODE_124625_length_337_cov_468.180672	107	187	34	3	80	0.0375000
NODE_124625_length_337_cov_468.180672	107	187	36	6	80	0.0750000
NODE_124625_length_337_cov_468.180672	107	187	38	4	80	0.0500000
NODE_124625_length_337_cov_468.180672	107	187	40	12	80	0.1500000
NODE_124625_length_337_cov_468.180672	107	187	42	9	80	0.1125000
NODE_124625_length_337_cov_468.180672	107	187	44	4	80	0.0500000
NODE_124625_length_337_cov_468.180672	107	187	46	8	80	0.1000000
NODE_124625_length_337_cov_468.180672	107	187	48	6	80	0.0750000
NODE_124625_length_337_cov_468.180672	107	187	50	8	80	0.1000000
NODE_124625_length_337_cov_468.180672	160	230	0	10	70	0.1428571
NODE_124625_length_337_cov_468.180672	160	230	2	5	70	0.0714286
NODE_124625_length_337_cov_468.180672	160	230	4	2	70	0.0285714
NODE_124625_length_337_cov_468.180672	160	230	6	2	70	0.0285714
NODE_124625_length_337_cov_468.180672	160	230	8	2	70	0.0285714
NODE_124625_length_337_cov_468.180672	160	230	10	6	70	0.0857143
NODE_124625_length_337_cov_468.180672	160	230	11	1	70	0.0142857
NODE_124625_length_337_cov_468.180672	160	230	13	1	70	0.0142857
NODE_124625_length_337_cov_468.180672	160	230	16	1	70	0.0142857
NODE_124625_length_337_cov_468.180672	160	230	19	2	70	0.0285714
NODE_124625_length_337_cov_468.180672	160	230	21	3	70	0.0428571
NODE_124625_length_337_cov_468.180672	160	230	23	3	70	0.0428571
NODE_124625_length_337_cov_468.180672	160	230	25	14	70	0.2000000
NODE_124625_length_337_cov_468.180672	160	230	27	5	70	0.0714286
NODE_124625_length_337_cov_468.180672	160	230	28	3	70	0.0428571
NODE_124625_length_337_cov_468.180672	160	230	30	1	70	0.0142857
NODE_124625_length_337_cov_468.180672	160	230	32	2	70	0.0285714
NODE_124625_length_337_cov_468.180672	160	230	34	3	70	0.0428571
NODE_124625_length_337_cov_468.180672	160	230	36	4	70	0.0571429
NODE_124625_length_337_cov_468.180672	226	306	2	2	80	0.0250000
NODE_124625_length_337_cov_468.180672	226	306	6	1	80	0.0125000
NODE_124625_length_337_cov_468.180672	226	306	8	4	80	0.0500000
NODE_124625_length_337_cov_468.180672	226	306	10	73	80	0.9125000
NODE_124625_length_337_cov_468.180672	279	337	4	2	58	0.0344828
NODE_124625_length_337_cov_468.180672	279	337	6	16	58	0.2758621
NODE_124625_length_337_cov_468.180672	279	337	8	13	58	0.2241379
NODE_124625_length_337_cov_468.180672	279	337	10	27	58	0.4655173
NODE_124626_length_337_cov_91.344538	1	50	0	8	49	0.1632653
NODE_124626_length_337_cov_91.344538	1	50	2	12	49	0.2448980
NODE_124626_length_337_cov_91.344538	1	50	3	1	49	0.0204082
NODE_124626_length_337_cov_91.344538	1	50	4	5	49	0.1020408
NODE_124626_length_337_cov_91.344538	1	50	6	2	49	0.0408163
NODE_124626_length_337_cov_91.344538	1	50	7	5	49	0.1020408
NODE_124626_length_337_cov_91.344538	1	50	9	8	49	0.1632653
NODE_124626_length_337_cov_91.344538	1	50	11	1	49	0.0204082
NODE_124626_length_337_cov_91.344538	1	50	13	2	49	0.0408163
NODE_124626_length_337_cov_91.344538	1	50	18	4	49	0.0816327
NODE_124626_length_337_cov_91.344538	1	50	19	1	49	0.0204082
NODE_124626_length_337_cov_91.344538	23	103	4	4	80	0.0500000
NODE_124626_length_337_cov_91.344538	23	103	6	2	80	0.0250000
NODE_124626_length_337_cov_91.344538	23	103	7	5	80	0.0625000
NODE_124626_length_337_cov_91.344538	23	103	9	8	80	0.1000000
NODE_124626_length_337_cov_91.344538	23	103	11	1	80	0.0125000
NODE_124626_length_337_cov_91.344538	23	103	13	2	80	0.0250000
NODE_124626_length_337_cov_91.344538	23	103	18	4	80	0.0500000
NODE_124626_length_337_cov_91.344538	23	103	19	10	80	0.1250000
NODE_124626_length_337_cov_91.344538	23	103	21	1	80	0.0125000
NODE_124626_length_337_cov_91.344538	23	103	24	2	80	0.0250000
NODE_124626_length_337_cov_91.344538	23	103	26	2	80	0.0250000
NODE_124626_length_337_cov_91.344538	23	103	27	8	80	0.1000000
NODE_124626_length_337_cov_91.344538	23	103	31	2	80	0.0250000
NODE_124626_length_337_cov_91.344538	23	103	33	2	80	0.0250000
NODE_124626_length_337_cov_91.344538	23	103	37	1	80	0.0125000
NODE_124626_length_337_cov_91.344538	23	103	39	1	80	0.0125000
NODE_124626_length_337_cov_91.344538	23	103	41	4	80	0.0500000
NODE_124626_length_337_cov_91.344538	23	103	44	1	80	0.0125000
NODE_124626_length_337_cov_91.344538	23	103	45	8	80	0.1000000
NODE_124626_length_337_cov_91.344538	23	103	47	2	80	0.0250000
NODE_124626_length_337_cov_91.344538	23	103	48	1	80	0.0125000
NODE_124626_length_337_cov_91.344538	23	103	50	2	80	0.0250000
NODE_124626_length_337_cov_91.344538	23	103	52	3	80	0.0375000
NODE_124626_length_337_cov_91.344538	23	103	54	1	80	0.0125000
NODE_124626_length_337_cov_91.344538	23	103	55	1	80	0.0125000
NODE_124626_length_337_cov_91.344538	23	103	57	2	80	0.0250000
NODE_124627_length_337_cov_73.352941	71	151	0	80	80	1.0000000
NODE_124627_length_337_cov_73.352941	124	204	0	80	80	1.0000000
NODE_124629_length_337_cov_46.978992	220	305	12	2	85	0.0235294
NODE_124629_length_337_cov_46.978992	220	305	14	10	85	0.1176471
NODE_124629_length_337_cov_46.978992	220	305	16	1	85	0.0117647
NODE_124629_length_337_cov_46.978992	220	305	18	1	85	0.0117647
NODE_124629_length_337_cov_46.978992	220	305	20	2	85	0.0235294
NODE_124629_length_337_cov_46.978992	220	305	22	8	85	0.0941176
NODE_124629_length_337_cov_46.978992	220	305	24	2	85	0.0235294
NODE_124629_length_337_cov_46.978992	220	305	26	7	85	0.0823529
NODE_124629_length_337_cov_46.978992	220	305	28	52	85	0.6117647
NODE_124629_length_337_cov_46.978992	220	305	12	2	85	0.0235294
NODE_124629_length_337_cov_46.978992	220	305	14	10	85	0.1176471
NODE_124629_length_337_cov_46.978992	220	305	16	1	85	0.0117647
NODE_124629_length_337_cov_46.978992	220	305	18	1	85	0.0117647
NODE_124629_length_337_cov_46.978992	220	305	20	2	85	0.0235294
NODE_124629_length_337_cov_46.978992	220	305	22	8	85	0.0941176
NODE_124629_length_337_cov_46.978992	220	305	24	2	85	0.0235294
NODE_124629_length_337_cov_46.978992	220	305	26	7	85	0.0823529
NODE_124629_length_337_cov_46.978992	220	305	28	52	85	0.6117647
NODE_124629_length_337_cov_46.978992	220	305	12	2	85	0.0235294
NODE_124629_length_337_cov_46.978992	220	305	14	10	85	0.1176471
NODE_124629_length_337_cov_46.978992	220	305	16	1	85	0.0117647
NODE_124629_length_337_cov_46.978992	220	305	18	1	85	0.0117647
NODE_124629_length_337_cov_46.978992	220	305	20	2	85	0.0235294
NODE_124629_length_337_cov_46.978992	220	305	22	8	85	0.0941176
NODE_124629_length_337_cov_46.978992	220	305	24	2	85	0.0235294
NODE_124629_length_337_cov_46.978992	220	305	26	7	85	0.0823529
NODE_124629_length_337_cov_46.978992	220	305	28	52	85	0.6117647
NODE_124629_length_337_cov_46.978992	278	327	4	7	49	0.1428571
NODE_124629_length_337_cov_46.978992	278	327	6	15	49	0.3061225
NODE_124629_length_337_cov_46.978992	278	327	12	2	49	0.0408163
NODE_124629_length_337_cov_46.978992	278	327	14	10	49	0.2040816
NODE_124629_length_337_cov_46.978992	278	327	16	1	49	0.0204082
NODE_124629_length_337_cov_46.978992	278	327	18	1	49	0.0204082
NODE_124629_length_337_cov_46.978992	278	327	20	2	49	0.0408163
NODE_124629_length_337_cov_46.978992	278	327	22	2	49	0.0408163
NODE_124629_length_337_cov_46.978992	278	327	24	1	49	0.0204082
NODE_124629_length_337_cov_46.978992	278	327	26	1	49	0.0204082
NODE_124629_length_337_cov_46.978992	278	327	28	7	49	0.1428571
NODE_124629_length_337_cov_46.978992	278	337	0	2	59	0.0338983
NODE_124629_length_337_cov_46.978992	278	337	2	3	59	0.0508475
NODE_124629_length_337_cov_46.978992	278	337	4	12	59	0.2033898
NODE_124629_length_337_cov_46.978992	278	337	6	15	59	0.2542373
NODE_124629_length_337_cov_46.978992	278	337	12	2	59	0.0338983
NODE_124629_length_337_cov_46.978992	278	337	14	10	59	0.1694915
NODE_124629_length_337_cov_46.978992	278	337	16	1	59	0.0169492
NODE_124629_length_337_cov_46.978992	278	337	18	1	59	0.0169492
NODE_124629_length_337_cov_46.978992	278	337	20	2	59	0.0338983
NODE_124629_length_337_cov_46.978992	278	337	22	2	59	0.0338983
NODE_124629_length_337_cov_46.978992	278	337	24	1	59	0.0169492
NODE_124629_length_337_cov_46.978992	278	337	26	1	59	0.0169492
NODE_124629_length_337_cov_46.978992	278	337	28	7	59	0.1186441
NODE_124629_length_337_cov_46.978992	283	337	0	2	54	0.0370370
NODE_124629_length_337_cov_46.978992	283	337	2	3	54	0.0555556
NODE_124629_length_337_cov_46.978992	283	337	4	12	54	0.2222222
NODE_124629_length_337_cov_46.978992	283	337	6	15	54	0.2777778
NODE_124629_length_337_cov_46.978992	283	337	12	2	54	0.0370370
NODE_124629_length_337_cov_46.978992	283	337	14	10	54	0.1851852
NODE_124629_length_337_cov_46.978992	283	337	16	1	54	0.0185185
NODE_124629_length_337_cov_46.978992	283	337	18	1	54	0.0185185
NODE_124629_length_337_cov_46.978992	283	337	20	2	54	0.0370370
NODE_124629_length_337_cov_46.978992	283	337	22	2	54	0.0370370
NODE_124629_length_337_cov_46.978992	283	337	24	1	54	0.0185185
NODE_124629_length_337_cov_46.978992	283	337	26	1	54	0.0185185
NODE_124629_length_337_cov_46.978992	283	337	28	2	54	0.0370370
NODE_124640_length_337_cov_6.214286	52	95	0	43	43	1.0000000
NODE_124669_length_337_cov_4.298319	5	58	0	53	53	1.0000000
NODE_124703_length_337_cov_3.478992	179	259	26	4	80	0.0500000
NODE_124703_length_337_cov_3.478992	179	259	28	9	80	0.1125000
NODE_124703_length_337_cov_3.478992	179	259	30	9	80	0.1125000
NODE_124703_length_337_cov_3.478992	179	259	31	5	80	0.0625000
NODE_124703_length_337_cov_3.478992	179	259	32	2	80	0.0250000
NODE_124703_length_337_cov_3.478992	179	259	33	19	80	0.2375000
NODE_124703_length_337_cov_3.478992	179	259	35	12	80	0.1500000
NODE_124703_length_337_cov_3.478992	179	259	37	2	80	0.0250000
NODE_124703_length_337_cov_3.478992	179	259	38	15	80	0.1875000
NODE_124703_length_337_cov_3.478992	179	259	39	2	80	0.0250000
NODE_124703_length_337_cov_3.478992	179	259	40	1	80	0.0125000
NODE_124703_length_337_cov_3.478992	232	307	5	1	75	0.0133333
NODE_124703_length_337_cov_3.478992	232	307	7	2	75	0.0266667
NODE_124703_length_337_cov_3.478992	232	307	9	1	75	0.0133333
NODE_124703_length_337_cov_3.478992	232	307	11	8	75	0.1066667
NODE_124703_length_337_cov_3.478992	232	307	13	1	75	0.0133333
NODE_124703_length_337_cov_3.478992	232	307	14	2	75	0.0266667
NODE_124703_length_337_cov_3.478992	232	307	16	1	75	0.0133333
NODE_124703_length_337_cov_3.478992	232	307	18	3	75	0.0400000
NODE_124703_length_337_cov_3.478992	232	307	22	12	75	0.1600000
NODE_124703_length_337_cov_3.478992	232	307	24	12	75	0.1600000
NODE_124703_length_337_cov_3.478992	232	307	26	9	75	0.1200000
NODE_124703_length_337_cov_3.478992	232	307	28	9	75	0.1200000
NODE_124703_length_337_cov_3.478992	232	307	30	9	75	0.1200000
NODE_124703_length_337_cov_3.478992	232	307	38	5	75	0.0666667
NODE_124759_length_337_cov_2.647059	80	146	0	32	66	0.4848485
NODE_124759_length_337_cov_2.647059	80	146	2	34	66	0.5151515
NODE_124858_length_337_cov_2.121849	23	103	0	12	80	0.1500000
NODE_124858_length_337_cov_2.121849	23	103	2	68	80	0.8500000
NODE_124858_length_337_cov_2.121849	76	141	2	65	65	1.0000000
NODE_125001_length_337_cov_1.689076	138	218	0	7	80	0.0875000
NODE_125001_length_337_cov_1.689076	138	218	2	73	80	0.9125000
NODE_125024_length_337_cov_1.592437	109	151	0	42	42	1.0000000
NODE_125024_length_337_cov_1.592437	126	204	0	78	78	1.0000000
NODE_125074_length_337_cov_1.466387	266	332	0	66	66	1.0000000
NODE_125271_length_337_cov_1.071429	279	319	4	40	40	1.0000000
NODE_125332_length_337_cov_0.978992	227	272	0	45	45	1.0000000
NODE_125633_length_336_cov_7.843882	151	231	0	80	80	1.0000000
NODE_125645_length_336_cov_5.578059	159	220	0	4	61	0.0655738
NODE_125645_length_336_cov_5.578059	159	220	2	31	61	0.5081967
NODE_125645_length_336_cov_5.578059	159	220	4	26	61	0.4262295
NODE_125645_length_336_cov_5.578059	212	273	2	32	61	0.5245901
NODE_125645_length_336_cov_5.578059	212	273	4	29	61	0.4754098
NODE_125663_length_336_cov_4.481013	129	207	0	27	78	0.3461539
NODE_125663_length_336_cov_4.481013	129	207	2	31	78	0.3974359
NODE_125663_length_336_cov_4.481013	129	207	4	20	78	0.2564103
NODE_125752_length_336_cov_2.755274	83	112	4	17	29	0.5862069
NODE_125752_length_336_cov_2.755274	83	112	6	12	29	0.4137931
NODE_125752_length_336_cov_2.755274	187	268	2	28	81	0.3456790
NODE_125752_length_336_cov_2.755274	187	268	4	2	81	0.0246914
NODE_125752_length_336_cov_2.755274	187	268	5	1	81	0.0123457
NODE_125752_length_336_cov_2.755274	187	268	6	47	81	0.5802469
NODE_125752_length_336_cov_2.755274	187	268	8	3	81	0.0370370
NODE_125806_length_336_cov_2.358650	60	133	0	72	73	0.9863014
NODE_125806_length_336_cov_2.358650	60	133	1	1	73	0.0136986
NODE_125811_length_336_cov_2.337553	93	173	0	80	80	1.0000000
NODE_125965_length_336_cov_1.729958	78	141	0	63	63	1.0000000
NODE_125965_length_336_cov_1.729958	131	194	0	63	63	1.0000000
NODE_126134_length_336_cov_1.333333	34	114	0	32	80	0.4000000
NODE_126134_length_336_cov_1.333333	34	114	2	12	80	0.1500000
NODE_126134_length_336_cov_1.333333	34	114	4	2	80	0.0250000
NODE_126134_length_336_cov_1.333333	34	114	6	5	80	0.0625000
NODE_126134_length_336_cov_1.333333	34	114	8	1	80	0.0125000
NODE_126134_length_336_cov_1.333333	34	114	10	3	80	0.0375000
NODE_126134_length_336_cov_1.333333	34	114	14	1	80	0.0125000
NODE_126134_length_336_cov_1.333333	34	114	16	8	80	0.1000000
NODE_126134_length_336_cov_1.333333	34	114	17	2	80	0.0250000
NODE_126134_length_336_cov_1.333333	34	114	18	14	80	0.1750000
NODE_126134_length_336_cov_1.333333	87	124	10	2	37	0.0540541
NODE_126134_length_336_cov_1.333333	87	124	14	1	37	0.0270270
NODE_126134_length_336_cov_1.333333	87	124	16	18	37	0.4864865
NODE_126134_length_336_cov_1.333333	87	124	17	2	37	0.0540541
NODE_126134_length_336_cov_1.333333	87	124	18	14	37	0.3783784
NODE_126134_length_336_cov_1.333333	182	213	18	22	31	0.7096774
NODE_126134_length_336_cov_1.333333	182	213	20	5	31	0.1612903
NODE_126134_length_336_cov_1.333333	182	213	22	4	31	0.1290323
NODE_126216_length_336_cov_1.244726	222	276	0	54	54	1.0000000
NODE_126216_length_336_cov_1.244726	288	312	0	24	24	1.0000000
NODE_126260_length_336_cov_1.143460	129	154	0	25	25	1.0000000
NODE_126545_length_336_cov_0.670886	259	288	2	29	29	1.0000000
NODE_126606_length_335_cov_16.114407	162	242	0	80	80	1.0000000
NODE_126606_length_335_cov_16.114407	215	295	0	80	80	1.0000000
NODE_126609_length_335_cov_9.258475	177	250	0	57	73	0.7808219
NODE_126609_length_335_cov_9.258475	177	250	2	16	73	0.2191781
NODE_126614_length_335_cov_7.207627	29	109	0	80	80	1.0000000
NODE_126614_length_335_cov_7.207627	82	162	0	80	80	1.0000000
NODE_126636_length_335_cov_5.046610	182	263	1	1	81	0.0123457
NODE_126636_length_335_cov_5.046610	182	263	2	80	81	0.9876543
NODE_126639_length_335_cov_4.995763	144	215	0	71	71	1.0000000
NODE_126665_length_335_cov_3.923729	163	231	0	68	68	1.0000000
NODE_126787_length_335_cov_2.411017	230	294	0	57	64	0.8906250
NODE_126787_length_335_cov_2.411017	230	294	2	7	64	0.1093750
NODE_126791_length_335_cov_2.402542	164	240	2	14	76	0.1842105
NODE_126791_length_335_cov_2.402542	164	240	4	3	76	0.0394737
NODE_126791_length_335_cov_2.402542	164	240	5	7	76	0.0921053
NODE_126791_length_335_cov_2.402542	164	240	6	5	76	0.0657895
NODE_126791_length_335_cov_2.402542	164	240	8	3	76	0.0394737
NODE_126791_length_335_cov_2.402542	164	240	10	2	76	0.0263158
NODE_126791_length_335_cov_2.402542	164	240	12	2	76	0.0263158
NODE_126791_length_335_cov_2.402542	164	240	14	3	76	0.0394737
NODE_126791_length_335_cov_2.402542	164	240	18	1	76	0.0131579
NODE_126791_length_335_cov_2.402542	164	240	20	4	76	0.0526316
NODE_126791_length_335_cov_2.402542	164	240	22	2	76	0.0263158
NODE_126791_length_335_cov_2.402542	164	240	24	2	76	0.0263158
NODE_126791_length_335_cov_2.402542	164	240	30	11	76	0.1447368
NODE_126791_length_335_cov_2.402542	164	240	32	1	76	0.0131579
NODE_126791_length_335_cov_2.402542	164	240	34	1	76	0.0131579
NODE_126791_length_335_cov_2.402542	164	240	36	7	76	0.0921053
NODE_126791_length_335_cov_2.402542	164	240	38	3	76	0.0394737
NODE_126791_length_335_cov_2.402542	164	240	40	3	76	0.0394737
NODE_126791_length_335_cov_2.402542	164	240	42	2	76	0.0263158
NODE_126792_length_335_cov_2.398305	116	179	2	63	63	1.0000000
NODE_126826_length_335_cov_2.161017	82	141	0	59	59	1.0000000
NODE_126835_length_335_cov_2.152542	61	134	0	73	73	1.0000000
NODE_126835_length_335_cov_2.152542	114	134	0	20	20	1.0000000
NODE_126920_length_335_cov_1.766949	257	330	2	9	73	0.1232877
NODE_126920_length_335_cov_1.766949	257	330	4	64	73	0.8767123
NODE_126920_length_335_cov_1.766949	297	335	0	1	38	0.0263158
NODE_126920_length_335_cov_1.766949	297	335	2	13	38	0.3421053
NODE_126920_length_335_cov_1.766949	297	335	4	24	38	0.6315789
NODE_127022_length_335_cov_1.529661	255	320	0	65	65	1.0000000
NODE_127023_length_335_cov_1.525424	222	266	2	15	44	0.3409091
NODE_127023_length_335_cov_1.525424	222	266	4	29	44	0.6590909
NODE_127062_length_335_cov_1.457627	38	87	0	45	49	0.9183673
NODE_127062_length_335_cov_1.457627	38	87	2	4	49	0.0816327
NODE_127130_length_335_cov_1.296610	291	311	0	20	20	1.0000000
NODE_127130_length_335_cov_1.296610	291	311	0	20	20	1.0000000
NODE_127143_length_335_cov_1.292373	202	232	2	9	30	0.3000000
NODE_127143_length_335_cov_1.292373	202	232	4	21	30	0.7000000
NODE_127200_length_335_cov_1.194915	75	156	7	3	81	0.0370370
NODE_127200_length_335_cov_1.194915	75	156	12	9	81	0.1111111
NODE_127200_length_335_cov_1.194915	75	156	14	30	81	0.3703704
NODE_127200_length_335_cov_1.194915	75	156	16	7	81	0.0864198
NODE_127200_length_335_cov_1.194915	75	156	20	4	81	0.0493827
NODE_127200_length_335_cov_1.194915	75	156	22	4	81	0.0493827
NODE_127200_length_335_cov_1.194915	75	156	24	18	81	0.2222222
NODE_127200_length_335_cov_1.194915	75	156	26	6	81	0.0740741
NODE_127200_length_335_cov_1.194915	129	195	3	6	66	0.0909091
NODE_127200_length_335_cov_1.194915	129	195	5	1	66	0.0151515
NODE_127200_length_335_cov_1.194915	129	195	7	16	66	0.2424242
NODE_127200_length_335_cov_1.194915	129	195	9	8	66	0.1212121
NODE_127200_length_335_cov_1.194915	129	195	10	11	66	0.1666667
NODE_127200_length_335_cov_1.194915	129	195	12	9	66	0.1363636
NODE_127200_length_335_cov_1.194915	129	195	14	15	66	0.2272727
NODE_127310_length_335_cov_0.983051	96	117	0	21	21	1.0000000
NODE_127585_length_334_cov_275.425532	135	215	67	3	80	0.0375000
NODE_127585_length_334_cov_275.425532	135	215	71	3	80	0.0375000
NODE_127585_length_334_cov_275.425532	135	215	77	16	80	0.2000000
NODE_127585_length_334_cov_275.425532	135	215	83	5	80	0.0625000
NODE_127585_length_334_cov_275.425532	135	215	85	1	80	0.0125000
NODE_127585_length_334_cov_275.425532	135	215	86	2	80	0.0250000
NODE_127585_length_334_cov_275.425532	135	215	87	2	80	0.0250000
NODE_127585_length_334_cov_275.425532	135	215	89	2	80	0.0250000
NODE_127585_length_334_cov_275.425532	135	215	101	2	80	0.0250000
NODE_127585_length_334_cov_275.425532	135	215	103	3	80	0.0375000
NODE_127585_length_334_cov_275.425532	135	215	105	6	80	0.0750000
NODE_127585_length_334_cov_275.425532	135	215	106	1	80	0.0125000
NODE_127585_length_334_cov_275.425532	135	215	107	3	80	0.0375000
NODE_127585_length_334_cov_275.425532	135	215	108	4	80	0.0500000
NODE_127585_length_334_cov_275.425532	135	215	110	1	80	0.0125000
NODE_127585_length_334_cov_275.425532	135	215	111	3	80	0.0375000
NODE_127585_length_334_cov_275.425532	135	215	112	5	80	0.0625000
NODE_127585_length_334_cov_275.425532	135	215	114	2	80	0.0250000
NODE_127585_length_334_cov_275.425532	135	215	116	6	80	0.0750000
NODE_127585_length_334_cov_275.425532	135	215	117	4	80	0.0500000
NODE_127585_length_334_cov_275.425532	135	215	118	1	80	0.0125000
NODE_127585_length_334_cov_275.425532	135	215	119	3	80	0.0375000
NODE_127585_length_334_cov_275.425532	135	215	120	2	80	0.0250000
NODE_127585_length_334_cov_275.425532	188	269	34	14	81	0.1728395
NODE_127585_length_334_cov_275.425532	188	269	36	7	81	0.0864198
NODE_127585_length_334_cov_275.425532	188	269	37	4	81	0.0493827
NODE_127585_length_334_cov_275.425532	188	269	39	4	81	0.0493827
NODE_127585_length_334_cov_275.425532	188	269	41	1	81	0.0123457
NODE_127585_length_334_cov_275.425532	188	269	45	2	81	0.0246914
NODE_127585_length_334_cov_275.425532	188	269	47	1	81	0.0123457
NODE_127585_length_334_cov_275.425532	188	269	49	6	81	0.0740741
NODE_127585_length_334_cov_275.425532	188	269	50	3	81	0.0370370
NODE_127585_length_334_cov_275.425532	188	269	51	1	81	0.0123457
NODE_127585_length_334_cov_275.425532	188	269	52	1	81	0.0123457
NODE_127585_length_334_cov_275.425532	188	269	54	3	81	0.0370370
NODE_127585_length_334_cov_275.425532	188	269	56	1	81	0.0123457
NODE_127585_length_334_cov_275.425532	188	269	58	1	81	0.0123457
NODE_127585_length_334_cov_275.425532	188	269	61	4	81	0.0493827
NODE_127585_length_334_cov_275.425532	188	269	67	4	81	0.0493827
NODE_127585_length_334_cov_275.425532	188	269	71	3	81	0.0370370
NODE_127585_length_334_cov_275.425532	188	269	77	16	81	0.1975309
NODE_127585_length_334_cov_275.425532	188	269	83	5	81	0.0617284
NODE_127586_length_334_cov_14.753191	135	215	0	80	80	1.0000000
NODE_127586_length_334_cov_14.753191	188	268	0	80	80	1.0000000
NODE_127610_length_334_cov_4.829787	92	174	0	82	82	1.0000000
NODE_127610_length_334_cov_4.829787	151	237	0	86	86	1.0000000
NODE_127612_length_334_cov_4.817021	179	231	0	52	52	1.0000000
NODE_127626_length_334_cov_4.438298	121	201	2	62	80	0.7750000
NODE_127626_length_334_cov_4.438298	121	201	4	18	80	0.2250000
NODE_127672_length_334_cov_3.604255	248	314	0	66	66	1.0000000
NODE_127672_length_334_cov_3.604255	287	334	0	47	47	1.0000000
NODE_127844_length_334_cov_2.165957	0	48	0	48	48	1.0000000
NODE_128026_length_334_cov_1.595745	253	328	0	21	75	0.2800000
NODE_128026_length_334_cov_1.595745	253	328	2	54	75	0.7200000
NODE_128258_length_334_cov_1.157447	146	177	0	31	31	1.0000000
NODE_128665_length_333_cov_5.423077	172	242	0	8	70	0.1142857
NODE_128665_length_333_cov_5.423077	172	242	2	57	70	0.8142857
NODE_128665_length_333_cov_5.423077	172	242	6	5	70	0.0714286
NODE_128673_length_333_cov_4.867521	122	172	0	6	50	0.1200000
NODE_128673_length_333_cov_4.867521	122	172	2	13	50	0.2600000
NODE_128673_length_333_cov_4.867521	122	172	4	13	50	0.2600000
NODE_128673_length_333_cov_4.867521	122	172	6	18	50	0.3600000
NODE_128673_length_333_cov_4.867521	175	255	4	18	80	0.2250000
NODE_128673_length_333_cov_4.867521	175	255	6	18	80	0.2250000
NODE_128673_length_333_cov_4.867521	175	255	8	7	80	0.0875000
NODE_128673_length_333_cov_4.867521	175	255	10	37	80	0.4625000
NODE_128673_length_333_cov_4.867521	194	219	10	25	25	1.0000000
NODE_128717_length_333_cov_3.717949	49	129	0	8	80	0.1000000
NODE_128717_length_333_cov_3.717949	49	129	2	14	80	0.1750000
NODE_128717_length_333_cov_3.717949	49	129	10	58	80	0.7250000
NODE_128717_length_333_cov_3.717949	102	182	10	56	80	0.7000000
NODE_128717_length_333_cov_3.717949	102	182	12	24	80	0.3000000
NODE_128767_length_333_cov_2.897436	59	139	4	4	80	0.0500000
NODE_128767_length_333_cov_2.897436	59	139	6	2	80	0.0250000
NODE_128767_length_333_cov_2.897436	59	139	8	3	80	0.0375000
NODE_128767_length_333_cov_2.897436	59	139	10	7	80	0.0875000
NODE_128767_length_333_cov_2.897436	59	139	14	12	80	0.1500000
NODE_128767_length_333_cov_2.897436	59	139	16	12	80	0.1500000
NODE_128767_length_333_cov_2.897436	59	139	20	6	80	0.0750000
NODE_128767_length_333_cov_2.897436	59	139	22	34	80	0.4250000
NODE_128850_length_333_cov_2.307692	68	148	2	11	80	0.1375000
NODE_128850_length_333_cov_2.307692	68	148	4	33	80	0.4125000
NODE_128850_length_333_cov_2.307692	68	148	6	36	80	0.4500000
NODE_128933_length_333_cov_1.940171	135	215	0	80	80	1.0000000
NODE_129252_length_333_cov_1.200855	0	80	0	80	80	1.0000000
NODE_129263_length_333_cov_1.170940	146	193	0	10	47	0.2127660
NODE_129263_length_333_cov_1.170940	146	193	2	37	47	0.7872341
NODE_129263_length_333_cov_1.170940	203	243	2	18	40	0.4500000
NODE_129263_length_333_cov_1.170940	203	243	4	22	40	0.5500000
NODE_129303_length_333_cov_1.089744	241	306	0	65	65	1.0000000
NODE_129310_length_333_cov_1.089744	206	226	0	20	20	1.0000000
NODE_129665_length_332_cov_5.386266	101	167	0	66	66	1.0000000
NODE_129680_length_332_cov_4.768240	221	250	4	17	29	0.5862069
NODE_129680_length_332_cov_4.768240	221	250	6	12	29	0.4137931
NODE_129695_length_332_cov_4.343348	130	179	0	30	49	0.6122449
NODE_129695_length_332_cov_4.343348	130	179	2	19	49	0.3877551
NODE_129698_length_332_cov_4.201717	191	237	0	46	46	1.0000000
NODE_129698_length_332_cov_4.201717	211	290	0	79	79	1.0000000
NODE_129879_length_332_cov_2.274678	187	227	18	10	40	0.2500000
NODE_129879_length_332_cov_2.274678	187	227	20	1	40	0.0250000
NODE_129879_length_332_cov_2.274678	187	227	22	1	40	0.0250000
NODE_129879_length_332_cov_2.274678	187	227	24	1	40	0.0250000
NODE_129879_length_332_cov_2.274678	187	227	30	1	40	0.0250000
NODE_129879_length_332_cov_2.274678	187	227	32	5	40	0.1250000
NODE_129879_length_332_cov_2.274678	187	227	34	1	40	0.0250000
NODE_129879_length_332_cov_2.274678	187	227	36	1	40	0.0250000
NODE_129879_length_332_cov_2.274678	187	227	40	1	40	0.0250000
NODE_129879_length_332_cov_2.274678	187	227	42	3	40	0.0750000
NODE_129879_length_332_cov_2.274678	187	227	50	1	40	0.0250000
NODE_129879_length_332_cov_2.274678	187	227	54	4	40	0.1000000
NODE_129879_length_332_cov_2.274678	187	227	56	1	40	0.0250000
NODE_129879_length_332_cov_2.274678	187	227	58	1	40	0.0250000
NODE_129879_length_332_cov_2.274678	187	227	61	1	40	0.0250000
NODE_129879_length_332_cov_2.274678	187	227	62	7	40	0.1750000
NODE_129901_length_332_cov_2.184549	194	258	0	44	64	0.6875000
NODE_129901_length_332_cov_2.184549	194	258	2	20	64	0.3125000
NODE_130053_length_332_cov_1.682403	241	316	0	75	75	1.0000000
NODE_130055_length_332_cov_1.673820	157	220	0	63	63	1.0000000
NODE_130183_length_332_cov_1.364807	132	212	0	33	80	0.4125000
NODE_130183_length_332_cov_1.364807	132	212	2	5	80	0.0625000
NODE_130183_length_332_cov_1.364807	132	212	4	3	80	0.0375000
NODE_130183_length_332_cov_1.364807	132	212	6	23	80	0.2875000
NODE_130183_length_332_cov_1.364807	132	212	8	16	80	0.2000000
NODE_130187_length_332_cov_1.356223	276	332	0	1	56	0.0178571
NODE_130187_length_332_cov_1.356223	276	332	4	1	56	0.0178571
NODE_130187_length_332_cov_1.356223	276	332	6	1	56	0.0178571
NODE_130187_length_332_cov_1.356223	276	332	8	53	56	0.9464286
NODE_130312_length_332_cov_1.210300	120	176	0	1	56	0.0178571
NODE_130312_length_332_cov_1.210300	120	176	3	2	56	0.0357143
NODE_130312_length_332_cov_1.210300	120	176	4	5	56	0.0892857
NODE_130312_length_332_cov_1.210300	120	176	5	14	56	0.2500000
NODE_130312_length_332_cov_1.210300	120	176	6	34	56	0.6071429
NODE_130757_length_331_cov_5.254310	141	221	0	22	80	0.2750000
NODE_130757_length_331_cov_5.254310	141	221	2	58	80	0.7250000
NODE_130757_length_331_cov_5.254310	194	274	0	28	80	0.3500000
NODE_130757_length_331_cov_5.254310	194	274	2	52	80	0.6500000
NODE_130781_length_331_cov_4.323276	26	108	2	4	82	0.0487805
NODE_130781_length_331_cov_4.323276	26	108	4	20	82	0.2439024
NODE_130781_length_331_cov_4.323276	26	108	6	12	82	0.1463415
NODE_130781_length_331_cov_4.323276	26	108	10	6	82	0.0731707
NODE_130781_length_331_cov_4.323276	26	108	12	6	82	0.0731707
NODE_130781_length_331_cov_4.323276	26	108	14	34	82	0.4146341
NODE_130902_length_331_cov_2.603448	128	181	0	36	53	0.6792453
NODE_130902_length_331_cov_2.603448	128	181	2	5	53	0.0943396
NODE_130902_length_331_cov_2.603448	128	181	3	12	53	0.2264151
NODE_131036_length_331_cov_1.965517	183	216	2	33	33	1.0000000
NODE_131054_length_331_cov_1.896552	266	331	0	5	65	0.0769231
NODE_131054_length_331_cov_1.896552	266	331	2	16	65	0.2461538
NODE_131054_length_331_cov_1.896552	266	331	4	14	65	0.2153846
NODE_131054_length_331_cov_1.896552	266	331	7	1	65	0.0153846
NODE_131054_length_331_cov_1.896552	266	331	8	11	65	0.1692308
NODE_131054_length_331_cov_1.896552	266	331	10	7	65	0.1076923
NODE_131054_length_331_cov_1.896552	266	331	12	11	65	0.1692308
NODE_131817_length_330_cov_14.731602	209	280	12	5	71	0.0704225
NODE_131817_length_330_cov_14.731602	209	280	13	8	71	0.1126761
NODE_131817_length_330_cov_14.731602	209	280	18	10	71	0.1408451
NODE_131817_length_330_cov_14.731602	209	280	19	48	71	0.6760563
NODE_131840_length_330_cov_4.935065	16	97	2	10	81	0.1234568
NODE_131840_length_330_cov_4.935065	16	97	4	1	81	0.0123457
NODE_131840_length_330_cov_4.935065	16	97	6	15	81	0.1851852
NODE_131840_length_330_cov_4.935065	16	97	8	12	81	0.1481481
NODE_131840_length_330_cov_4.935065	16	97	10	43	81	0.5308642
NODE_131840_length_330_cov_4.935065	81	149	4	23	68	0.3382353
NODE_131840_length_330_cov_4.935065	81	149	6	20	68	0.2941177
NODE_131840_length_330_cov_4.935065	81	149	8	19	68	0.2794118
NODE_131840_length_330_cov_4.935065	81	149	10	6	68	0.0882353
NODE_131841_length_330_cov_4.891775	177	255	0	4	78	0.0512821
NODE_131841_length_330_cov_4.891775	177	255	2	46	78	0.5897436
NODE_131841_length_330_cov_4.891775	177	255	4	28	78	0.3589744
NODE_131845_length_330_cov_4.740260	134	209	0	1	75	0.0133333
NODE_131845_length_330_cov_4.740260	134	209	2	32	75	0.4266667
NODE_131845_length_330_cov_4.740260	134	209	4	29	75	0.3866667
NODE_131845_length_330_cov_4.740260	134	209	6	7	75	0.0933333
NODE_131845_length_330_cov_4.740260	134	209	8	6	75	0.0800000
NODE_131892_length_330_cov_3.467532	161	225	0	64	64	1.0000000
NODE_131969_length_330_cov_2.601732	8	88	0	80	80	1.0000000
NODE_132188_length_330_cov_1.623377	154	200	0	7	46	0.1521739
NODE_132188_length_330_cov_1.623377	154	200	2	39	46	0.8478261
NODE_132238_length_330_cov_1.541126	98	156	0	58	58	1.0000000
NODE_132268_length_330_cov_1.467532	234	287	0	53	53	1.0000000
NODE_132268_length_330_cov_1.467532	242	283	0	41	41	1.0000000
NODE_132306_length_330_cov_1.346320	230	296	2	9	66	0.1363636
NODE_132306_length_330_cov_1.346320	230	296	4	38	66	0.5757576
NODE_132306_length_330_cov_1.346320	230	296	6	19	66	0.2878788
NODE_132306_length_330_cov_1.346320	230	257	2	9	27	0.3333333
NODE_132306_length_330_cov_1.346320	230	257	6	18	27	0.6666667
NODE_132410_length_330_cov_1.220779	249	272	0	23	23	1.0000000
NODE_132478_length_330_cov_1.103896	189	227	0	38	38	1.0000000
NODE_132542_length_330_cov_1.038961	219	297	17	1	78	0.0128205
NODE_132542_length_330_cov_1.038961	219	297	18	1	78	0.0128205
NODE_132542_length_330_cov_1.038961	219	297	20	3	78	0.0384615
NODE_132542_length_330_cov_1.038961	219	297	22	3	78	0.0384615
NODE_132542_length_330_cov_1.038961	219	297	24	3	78	0.0384615
NODE_132542_length_330_cov_1.038961	219	297	25	7	78	0.0897436
NODE_132542_length_330_cov_1.038961	219	297	31	1	78	0.0128205
NODE_132542_length_330_cov_1.038961	219	297	35	5	78	0.0641026
NODE_132542_length_330_cov_1.038961	219	297	37	3	78	0.0384615
NODE_132542_length_330_cov_1.038961	219	297	38	3	78	0.0384615
NODE_132542_length_330_cov_1.038961	219	297	40	12	78	0.1538462
NODE_132542_length_330_cov_1.038961	219	297	42	3	78	0.0384615
NODE_132542_length_330_cov_1.038961	219	297	45	1	78	0.0128205
NODE_132542_length_330_cov_1.038961	219	297	49	2	78	0.0256410
NODE_132542_length_330_cov_1.038961	219	297	51	4	78	0.0512821
NODE_132542_length_330_cov_1.038961	219	297	57	1	78	0.0128205
NODE_132542_length_330_cov_1.038961	219	297	58	1	78	0.0128205
NODE_132542_length_330_cov_1.038961	219	297	72	1	78	0.0128205
NODE_132542_length_330_cov_1.038961	219	297	78	1	78	0.0128205
NODE_132542_length_330_cov_1.038961	219	297	82	6	78	0.0769231
NODE_132542_length_330_cov_1.038961	219	297	89	1	78	0.0128205
NODE_132542_length_330_cov_1.038961	219	297	91	2	78	0.0256410
NODE_132542_length_330_cov_1.038961	219	297	93	1	78	0.0128205
NODE_132542_length_330_cov_1.038961	219	297	95	1	78	0.0128205
NODE_132542_length_330_cov_1.038961	219	297	103	1	78	0.0128205
NODE_132542_length_330_cov_1.038961	219	297	115	1	78	0.0128205
NODE_132542_length_330_cov_1.038961	219	297	117	2	78	0.0256410
NODE_132542_length_330_cov_1.038961	219	297	120	3	78	0.0384615
NODE_132542_length_330_cov_1.038961	219	297	121	1	78	0.0128205
NODE_132542_length_330_cov_1.038961	219	297	122	1	78	0.0128205
NODE_132542_length_330_cov_1.038961	219	297	124	1	78	0.0128205
NODE_132542_length_330_cov_1.038961	219	297	126	1	78	0.0128205
NODE_132688_length_330_cov_0.883117	284	330	0	46	46	1.0000000
NODE_132873_length_329_cov_110.178261	138	167	31	3	29	0.1034483
NODE_132873_length_329_cov_110.178261	138	167	33	3	29	0.1034483
NODE_132873_length_329_cov_110.178261	138	167	34	1	29	0.0344828
NODE_132873_length_329_cov_110.178261	138	167	35	3	29	0.1034483
NODE_132873_length_329_cov_110.178261	138	167	38	2	29	0.0689655
NODE_132873_length_329_cov_110.178261	138	167	39	1	29	0.0344828
NODE_132873_length_329_cov_110.178261	138	167	41	1	29	0.0344828
NODE_132873_length_329_cov_110.178261	138	167	42	10	29	0.3448276
NODE_132873_length_329_cov_110.178261	138	167	44	5	29	0.1724138
NODE_132873_length_329_cov_110.178261	189	269	59	2	80	0.0250000
NODE_132873_length_329_cov_110.178261	189	269	63	2	80	0.0250000
NODE_132873_length_329_cov_110.178261	189	269	65	1	80	0.0125000
NODE_132873_length_329_cov_110.178261	189	269	67	4	80	0.0500000
NODE_132873_length_329_cov_110.178261	189	269	71	2	80	0.0250000
NODE_132873_length_329_cov_110.178261	189	269	73	2	80	0.0250000
NODE_132873_length_329_cov_110.178261	189	269	75	2	80	0.0250000
NODE_132873_length_329_cov_110.178261	189	269	77	1	80	0.0125000
NODE_132873_length_329_cov_110.178261	189	269	79	2	80	0.0250000
NODE_132873_length_329_cov_110.178261	189	269	81	6	80	0.0750000
NODE_132873_length_329_cov_110.178261	189	269	83	5	80	0.0625000
NODE_132873_length_329_cov_110.178261	189	269	85	15	80	0.1875000
NODE_132873_length_329_cov_110.178261	189	269	87	5	80	0.0625000
NODE_132873_length_329_cov_110.178261	189	269	88	2	80	0.0250000
NODE_132873_length_329_cov_110.178261	189	269	90	7	80	0.0875000
NODE_132873_length_329_cov_110.178261	189	269	92	1	80	0.0125000
NODE_132873_length_329_cov_110.178261	189	269	93	4	80	0.0500000
NODE_132873_length_329_cov_110.178261	189	269	94	4	80	0.0500000
NODE_132873_length_329_cov_110.178261	189	269	95	13	80	0.1625000
NODE_132873_length_329_cov_110.178261	242	322	8	1	80	0.0125000
NODE_132873_length_329_cov_110.178261	242	322	10	1	80	0.0125000
NODE_132873_length_329_cov_110.178261	242	322	12	1	80	0.0125000
NODE_132873_length_329_cov_110.178261	242	322	14	1	80	0.0125000
NODE_132873_length_329_cov_110.178261	242	322	16	4	80	0.0500000
NODE_132873_length_329_cov_110.178261	242	322	18	1	80	0.0125000
NODE_132873_length_329_cov_110.178261	242	322	24	1	80	0.0125000
NODE_132873_length_329_cov_110.178261	242	322	28	5	80	0.0625000
NODE_132873_length_329_cov_110.178261	242	322	30	7	80	0.0875000
NODE_132873_length_329_cov_110.178261	242	322	32	1	80	0.0125000
NODE_132873_length_329_cov_110.178261	242	322	34	1	80	0.0125000
NODE_132873_length_329_cov_110.178261	242	322	36	7	80	0.0875000
NODE_132873_length_329_cov_110.178261	242	322	38	3	80	0.0375000
NODE_132873_length_329_cov_110.178261	242	322	40	2	80	0.0250000
NODE_132873_length_329_cov_110.178261	242	322	43	6	80	0.0750000
NODE_132873_length_329_cov_110.178261	242	322	47	1	80	0.0125000
NODE_132873_length_329_cov_110.178261	242	322	55	1	80	0.0125000
NODE_132873_length_329_cov_110.178261	242	322	57	1	80	0.0125000
NODE_132873_length_329_cov_110.178261	242	322	63	8	80	0.1000000
NODE_132873_length_329_cov_110.178261	242	322	65	1	80	0.0125000
NODE_132873_length_329_cov_110.178261	242	322	67	4	80	0.0500000
NODE_132873_length_329_cov_110.178261	242	322	71	2	80	0.0250000
NODE_132873_length_329_cov_110.178261	242	322	75	1	80	0.0125000
NODE_132873_length_329_cov_110.178261	242	322	77	1	80	0.0125000
NODE_132873_length_329_cov_110.178261	242	322	79	1	80	0.0125000
NODE_132873_length_329_cov_110.178261	242	322	81	4	80	0.0500000
NODE_132873_length_329_cov_110.178261	242	322	83	4	80	0.0500000
NODE_132873_length_329_cov_110.178261	242	322	85	9	80	0.1125000
NODE_132879_length_329_cov_8.882609	61	141	0	80	80	1.0000000
NODE_132879_length_329_cov_8.882609	114	194	0	80	80	1.0000000
NODE_132885_length_329_cov_6.586957	166	207	0	41	41	1.0000000
NODE_132908_length_329_cov_4.617391	175	229	0	54	54	1.0000000
NODE_132970_length_329_cov_3.160870	59	139	0	80	80	1.0000000
NODE_133003_length_329_cov_2.821739	164	209	2	44	45	0.9777778
NODE_133003_length_329_cov_2.821739	164	209	4	1	45	0.0222222
NODE_133003_length_329_cov_2.821739	184	262	2	39	78	0.5000000
NODE_133003_length_329_cov_2.821739	184	262	4	39	78	0.5000000
NODE_133033_length_329_cov_2.560870	139	201	0	62	62	1.0000000
NODE_133036_length_329_cov_2.543478	145	206	14	6	61	0.0983607
NODE_133036_length_329_cov_2.543478	145	206	16	4	61	0.0655738
NODE_133036_length_329_cov_2.543478	145	206	18	9	61	0.1475410
NODE_133036_length_329_cov_2.543478	145	206	20	42	61	0.6885246
NODE_133123_length_329_cov_2.143478	39	119	12	22	80	0.2750000
NODE_133123_length_329_cov_2.143478	39	119	14	2	80	0.0250000
NODE_133123_length_329_cov_2.143478	39	119	16	2	80	0.0250000
NODE_133123_length_329_cov_2.143478	39	119	18	7	80	0.0875000
NODE_133123_length_329_cov_2.143478	39	119	20	9	80	0.1125000
NODE_133123_length_329_cov_2.143478	39	119	23	2	80	0.0250000
NODE_133123_length_329_cov_2.143478	39	119	25	6	80	0.0750000
NODE_133123_length_329_cov_2.143478	39	119	27	10	80	0.1250000
NODE_133123_length_329_cov_2.143478	39	119	29	10	80	0.1250000
NODE_133123_length_329_cov_2.143478	39	119	31	10	80	0.1250000
NODE_133123_length_329_cov_2.143478	92	158	21	4	66	0.0606061
NODE_133123_length_329_cov_2.143478	92	158	23	8	66	0.1212121
NODE_133123_length_329_cov_2.143478	92	158	25	3	66	0.0454545
NODE_133123_length_329_cov_2.143478	92	158	27	9	66	0.1363636
NODE_133123_length_329_cov_2.143478	92	158	29	14	66	0.2121212
NODE_133123_length_329_cov_2.143478	92	158	31	28	66	0.4242424
NODE_133184_length_329_cov_1.865217	182	252	0	1	70	0.0142857
NODE_133184_length_329_cov_1.865217	182	252	1	1	70	0.0142857
NODE_133184_length_329_cov_1.865217	182	252	2	13	70	0.1857143
NODE_133184_length_329_cov_1.865217	182	252	6	42	70	0.6000000
NODE_133184_length_329_cov_1.865217	182	252	8	2	70	0.0285714
NODE_133184_length_329_cov_1.865217	182	252	10	8	70	0.1142857
NODE_133184_length_329_cov_1.865217	182	252	14	3	70	0.0428571
NODE_133200_length_329_cov_1.791304	50	84	0	34	34	1.0000000
NODE_133200_length_329_cov_1.791304	92	149	0	29	57	0.5087720
NODE_133200_length_329_cov_1.791304	92	149	2	18	57	0.3157895
NODE_133200_length_329_cov_1.791304	92	149	4	2	57	0.0350877
NODE_133200_length_329_cov_1.791304	92	149	6	8	57	0.1403509
NODE_133200_length_329_cov_1.791304	145	203	6	58	58	1.0000000
NODE_133332_length_329_cov_1.508696	261	323	4	62	62	1.0000000
NODE_133348_length_329_cov_1.469565	168	237	0	28	69	0.4057971
NODE_133348_length_329_cov_1.469565	168	237	2	41	69	0.5942029
NODE_133376_length_329_cov_1.391304	275	307	10	5	32	0.1562500
NODE_133376_length_329_cov_1.391304	275	307	12	13	32	0.4062500
NODE_133376_length_329_cov_1.391304	275	307	14	9	32	0.2812500
NODE_133376_length_329_cov_1.391304	275	307	18	5	32	0.1562500
NODE_133547_length_329_cov_1.165217	199	242	0	43	43	1.0000000
NODE_133768_length_329_cov_0.878261	221	296	2	36	75	0.4800000
NODE_133768_length_329_cov_0.878261	221	296	4	39	75	0.5200000
NODE_133970_length_328_cov_4.484716	95	175	2	42	80	0.5250000
NODE_133970_length_328_cov_4.484716	95	175	4	38	80	0.4750000
NODE_133989_length_328_cov_4.087336	79	159	0	39	80	0.4875000
NODE_133989_length_328_cov_4.087336	79	159	2	41	80	0.5125000
NODE_133989_length_328_cov_4.087336	132	207	0	68	75	0.9066667
NODE_133989_length_328_cov_4.087336	132	207	1	7	75	0.0933333
NODE_133993_length_328_cov_3.895197	110	190	2	2	80	0.0250000
NODE_133993_length_328_cov_3.895197	110	190	6	1	80	0.0125000
NODE_133993_length_328_cov_3.895197	110	190	8	77	80	0.9625000
NODE_134019_length_328_cov_3.393013	30	78	0	48	48	1.0000000
NODE_134144_length_328_cov_2.161572	103	134	10	11	31	0.3548387
NODE_134144_length_328_cov_2.161572	103	134	12	2	31	0.0645161
NODE_134144_length_328_cov_2.161572	103	134	14	18	31	0.5806451
NODE_134247_length_328_cov_1.781659	16	44	0	28	28	1.0000000
NODE_134335_length_328_cov_1.567686	0	76	2	35	76	0.4605263
NODE_134335_length_328_cov_1.567686	0	76	4	1	76	0.0131579
NODE_134335_length_328_cov_1.567686	0	76	6	40	76	0.5263158
NODE_134335_length_328_cov_1.567686	49	94	6	44	45	0.9777778
NODE_134335_length_328_cov_1.567686	49	94	14	1	45	0.0222222
NODE_134452_length_328_cov_1.336245	0	73	0	73	73	1.0000000
NODE_134508_length_328_cov_1.266376	78	158	2	80	80	1.0000000
NODE_135002_length_327_cov_4.934211	170	250	0	80	80	1.0000000
NODE_135009_length_327_cov_4.701754	225	305	0	13	80	0.1625000
NODE_135009_length_327_cov_4.701754	225	305	8	67	80	0.8375000
NODE_135018_length_327_cov_4.241228	97	173	0	1	76	0.0131579
NODE_135018_length_327_cov_4.241228	97	173	2	15	76	0.1973684
NODE_135018_length_327_cov_4.241228	97	173	4	60	76	0.7894737
NODE_135037_length_327_cov_3.719298	70	150	0	46	80	0.5750000
NODE_135037_length_327_cov_3.719298	70	150	2	34	80	0.4250000
NODE_135063_length_327_cov_3.350877	156	227	0	12	71	0.1690141
NODE_135063_length_327_cov_3.350877	156	227	2	31	71	0.4366197
NODE_135063_length_327_cov_3.350877	156	227	4	28	71	0.3943662
NODE_135328_length_327_cov_1.780702	191	271	2	13	80	0.1625000
NODE_135328_length_327_cov_1.780702	191	271	10	1	80	0.0125000
NODE_135328_length_327_cov_1.780702	191	271	16	3	80	0.0375000
NODE_135328_length_327_cov_1.780702	191	271	18	3	80	0.0375000
NODE_135328_length_327_cov_1.780702	191	271	22	1	80	0.0125000
NODE_135328_length_327_cov_1.780702	191	271	23	1	80	0.0125000
NODE_135328_length_327_cov_1.780702	191	271	24	1	80	0.0125000
NODE_135328_length_327_cov_1.780702	191	271	26	41	80	0.5125000
NODE_135328_length_327_cov_1.780702	191	271	28	16	80	0.2000000
NODE_136081_length_326_cov_3.964758	178	228	0	50	50	1.0000000
NODE_136100_length_326_cov_3.502203	211	253	2	42	42	1.0000000
NODE_136100_length_326_cov_3.502203	220	255	2	35	35	1.0000000
NODE_136116_length_326_cov_3.202643	149	203	0	8	54	0.1481481
NODE_136116_length_326_cov_3.202643	149	203	1	1	54	0.0185185
NODE_136116_length_326_cov_3.202643	149	203	2	34	54	0.6296296
NODE_136116_length_326_cov_3.202643	149	203	4	11	54	0.2037037
NODE_136130_length_326_cov_3.057269	107	126	2	19	19	1.0000000
NODE_136176_length_326_cov_2.594714	125	196	0	71	71	1.0000000
NODE_136283_length_326_cov_2.123348	184	244	4	38	60	0.6333333
NODE_136283_length_326_cov_2.123348	184	244	6	22	60	0.3666667
NODE_136496_length_326_cov_1.515419	86	166	0	80	80	1.0000000
NODE_137182_length_325_cov_4.893805	142	222	26	7	80	0.0875000
NODE_137182_length_325_cov_4.893805	142	222	28	8	80	0.1000000
NODE_137182_length_325_cov_4.893805	142	222	30	13	80	0.1625000
NODE_137182_length_325_cov_4.893805	142	222	32	15	80	0.1875000
NODE_137182_length_325_cov_4.893805	142	222	34	4	80	0.0500000
NODE_137182_length_325_cov_4.893805	142	222	36	12	80	0.1500000
NODE_137182_length_325_cov_4.893805	142	222	38	21	80	0.2625000
NODE_137182_length_325_cov_4.893805	195	275	8	12	80	0.1500000
NODE_137182_length_325_cov_4.893805	195	275	10	6	80	0.0750000
NODE_137182_length_325_cov_4.893805	195	275	12	7	80	0.0875000
NODE_137182_length_325_cov_4.893805	195	275	14	4	80	0.0500000
NODE_137182_length_325_cov_4.893805	195	275	15	2	80	0.0250000
NODE_137182_length_325_cov_4.893805	195	275	16	2	80	0.0250000
NODE_137182_length_325_cov_4.893805	195	275	18	2	80	0.0250000
NODE_137182_length_325_cov_4.893805	195	275	20	2	80	0.0250000
NODE_137182_length_325_cov_4.893805	195	275	24	7	80	0.0875000
NODE_137182_length_325_cov_4.893805	195	275	26	7	80	0.0875000
NODE_137182_length_325_cov_4.893805	195	275	28	1	80	0.0125000
NODE_137182_length_325_cov_4.893805	195	275	30	4	80	0.0500000
NODE_137182_length_325_cov_4.893805	195	275	32	12	80	0.1500000
NODE_137182_length_325_cov_4.893805	195	275	34	2	80	0.0250000
NODE_137182_length_325_cov_4.893805	195	275	36	5	80	0.0625000
NODE_137182_length_325_cov_4.893805	195	275	38	5	80	0.0625000
NODE_137199_length_325_cov_4.000000	134	198	2	60	64	0.9375000
NODE_137199_length_325_cov_4.000000	134	198	4	4	64	0.0625000
NODE_137221_length_325_cov_3.513274	191	266	4	33	75	0.4400000
NODE_137221_length_325_cov_3.513274	191	266	6	4	75	0.0533333
NODE_137221_length_325_cov_3.513274	191	266	8	6	75	0.0800000
NODE_137221_length_325_cov_3.513274	191	266	10	6	75	0.0800000
NODE_137221_length_325_cov_3.513274	191	266	12	26	75	0.3466667
NODE_137221_length_325_cov_3.513274	240	319	4	75	79	0.9493671
NODE_137221_length_325_cov_3.513274	240	319	6	4	79	0.0506329
NODE_137223_length_325_cov_3.469027	216	278	2	62	62	1.0000000
NODE_137224_length_325_cov_3.429204	178	224	0	46	46	1.0000000
NODE_137243_length_325_cov_3.168142	188	274	0	69	86	0.8023256
NODE_137243_length_325_cov_3.168142	188	274	2	17	86	0.1976744
NODE_137268_length_325_cov_2.880531	72	152	0	11	80	0.1375000
NODE_137268_length_325_cov_2.880531	72	152	2	11	80	0.1375000
NODE_137268_length_325_cov_2.880531	72	152	4	21	80	0.2625000
NODE_137268_length_325_cov_2.880531	72	152	6	37	80	0.4625000
NODE_137268_length_325_cov_2.880531	125	205	4	7	80	0.0875000
NODE_137268_length_325_cov_2.880531	125	205	6	49	80	0.6125000
NODE_137268_length_325_cov_2.880531	125	205	8	24	80	0.3000000
NODE_137291_length_325_cov_2.707965	203	261	0	58	58	1.0000000
NODE_137296_length_325_cov_2.703540	68	148	0	11	80	0.1375000
NODE_137296_length_325_cov_2.703540	68	148	2	69	80	0.8625000
NODE_137330_length_325_cov_2.500000	0	42	0	42	42	1.0000000
NODE_137407_length_325_cov_2.048673	122	202	20	1	80	0.0125000
NODE_137407_length_325_cov_2.048673	122	202	24	3	80	0.0375000
NODE_137407_length_325_cov_2.048673	122	202	25	23	80	0.2875000
NODE_137407_length_325_cov_2.048673	122	202	26	6	80	0.0750000
NODE_137407_length_325_cov_2.048673	122	202	27	1	80	0.0125000
NODE_137407_length_325_cov_2.048673	122	202	28	5	80	0.0625000
NODE_137407_length_325_cov_2.048673	122	202	30	16	80	0.2000000
NODE_137407_length_325_cov_2.048673	122	202	32	25	80	0.3125000
NODE_137409_length_325_cov_2.035398	83	154	0	4	71	0.0563380
NODE_137409_length_325_cov_2.035398	83	154	1	13	71	0.1830986
NODE_137409_length_325_cov_2.035398	83	154	2	54	71	0.7605634
NODE_137642_length_325_cov_1.464602	153	224	0	71	71	1.0000000
NODE_137939_length_325_cov_1.017699	103	134	2	11	31	0.3548387
NODE_137939_length_325_cov_1.017699	103	134	4	20	31	0.6451613
NODE_138113_length_325_cov_0.827434	258	308	0	27	50	0.5400000
NODE_138113_length_325_cov_0.827434	258	308	4	23	50	0.4600000
NODE_138309_length_324_cov_4.737778	113	160	0	47	47	1.0000000
NODE_138309_length_324_cov_4.737778	142	213	0	71	71	1.0000000
NODE_138358_length_324_cov_3.626667	218	273	1	9	55	0.1636364
NODE_138358_length_324_cov_3.626667	218	273	2	7	55	0.1272727
NODE_138358_length_324_cov_3.626667	218	273	4	39	55	0.7090909
NODE_138396_length_324_cov_3.124444	101	181	0	33	80	0.4125000
NODE_138396_length_324_cov_3.124444	101	181	1	5	80	0.0625000
NODE_138396_length_324_cov_3.124444	101	181	2	7	80	0.0875000
NODE_138396_length_324_cov_3.124444	101	181	4	35	80	0.4375000
NODE_138396_length_324_cov_3.124444	256	285	1	1	29	0.0344828
NODE_138396_length_324_cov_3.124444	256	285	2	28	29	0.9655172
NODE_138416_length_324_cov_2.924444	114	198	2	19	84	0.2261905
NODE_138416_length_324_cov_2.924444	114	198	4	12	84	0.1428571
NODE_138416_length_324_cov_2.924444	114	198	6	21	84	0.2500000
NODE_138416_length_324_cov_2.924444	114	198	8	31	84	0.3690476
NODE_138416_length_324_cov_2.924444	114	198	10	1	84	0.0119048
NODE_138416_length_324_cov_2.924444	178	237	6	10	59	0.1694915
NODE_138416_length_324_cov_2.924444	178	237	8	48	59	0.8135593
NODE_138416_length_324_cov_2.924444	178	237	10	1	59	0.0169492
NODE_138418_length_324_cov_2.915556	141	221	0	80	80	1.0000000
NODE_138434_length_324_cov_2.715556	4	51	0	47	47	1.0000000
NODE_138434_length_324_cov_2.715556	24	104	0	80	80	1.0000000
NODE_138463_length_324_cov_2.506667	270	306	0	36	36	1.0000000
NODE_138483_length_324_cov_2.448889	187	238	6	15	51	0.2941177
NODE_138483_length_324_cov_2.448889	187	238	8	2	51	0.0392157
NODE_138483_length_324_cov_2.448889	187	238	12	34	51	0.6666667
NODE_138527_length_324_cov_2.248889	30	96	0	66	66	1.0000000
NODE_138778_length_324_cov_1.502222	10	90	0	12	80	0.1500000
NODE_138778_length_324_cov_1.502222	10	90	2	43	80	0.5375000
NODE_138778_length_324_cov_1.502222	10	90	6	22	80	0.2750000
NODE_138778_length_324_cov_1.502222	10	90	8	3	80	0.0375000
NODE_138792_length_324_cov_1.457778	0	45	0	45	45	1.0000000
NODE_138792_length_324_cov_1.457778	18	75	0	50	57	0.8771930
NODE_138792_length_324_cov_1.457778	18	75	4	2	57	0.0350877
NODE_138792_length_324_cov_1.457778	18	75	6	2	57	0.0350877
NODE_138792_length_324_cov_1.457778	18	75	8	3	57	0.0526316
NODE_138808_length_324_cov_1.382222	263	304	0	41	41	1.0000000
NODE_139129_length_324_cov_1.017778	0	59	0	59	59	1.0000000
NODE_139497_length_323_cov_6.669643	215	286	0	16	71	0.2253521
NODE_139497_length_323_cov_6.669643	215	286	2	3	71	0.0422535
NODE_139497_length_323_cov_6.669643	215	286	4	31	71	0.4366197
NODE_139497_length_323_cov_6.669643	215	286	6	21	71	0.2957746
NODE_139497_length_323_cov_6.669643	268	315	0	45	47	0.9574468
NODE_139497_length_323_cov_6.669643	268	315	2	2	47	0.0425532
NODE_139511_length_323_cov_5.089286	224	290	0	66	66	1.0000000
NODE_139511_length_323_cov_5.089286	263	319	0	56	56	1.0000000
NODE_139572_length_323_cov_3.276786	189	269	0	11	80	0.1375000
NODE_139572_length_323_cov_3.276786	189	269	6	1	80	0.0125000
NODE_139572_length_323_cov_3.276786	189	269	7	5	80	0.0625000
NODE_139572_length_323_cov_3.276786	189	269	9	13	80	0.1625000
NODE_139572_length_323_cov_3.276786	189	269	13	7	80	0.0875000
NODE_139572_length_323_cov_3.276786	189	269	20	10	80	0.1250000
NODE_139572_length_323_cov_3.276786	189	269	24	3	80	0.0375000
NODE_139572_length_323_cov_3.276786	189	269	28	4	80	0.0500000
NODE_139572_length_323_cov_3.276786	189	269	30	10	80	0.1250000
NODE_139572_length_323_cov_3.276786	189	269	32	4	80	0.0500000
NODE_139572_length_323_cov_3.276786	189	269	34	10	80	0.1250000
NODE_139572_length_323_cov_3.276786	189	269	36	1	80	0.0125000
NODE_139572_length_323_cov_3.276786	189	269	37	1	80	0.0125000
NODE_139575_length_323_cov_3.263393	101	181	2	17	80	0.2125000
NODE_139575_length_323_cov_3.263393	101	181	4	9	80	0.1125000
NODE_139575_length_323_cov_3.263393	101	181	6	54	80	0.6750000
NODE_139591_length_323_cov_3.089286	128	208	2	80	80	1.0000000
NODE_139591_length_323_cov_3.089286	166	208	2	42	42	1.0000000
NODE_139591_length_323_cov_3.089286	181	261	0	48	80	0.6000000
NODE_139591_length_323_cov_3.089286	181	261	2	32	80	0.4000000
NODE_139591_length_323_cov_3.089286	181	261	0	48	80	0.6000000
NODE_139591_length_323_cov_3.089286	181	261	2	32	80	0.4000000
NODE_139629_length_323_cov_2.683036	144	215	8	4	71	0.0563380
NODE_139629_length_323_cov_2.683036	144	215	10	27	71	0.3802817
NODE_139629_length_323_cov_2.683036	144	215	12	40	71	0.5633803
NODE_139746_length_323_cov_2.089286	64	144	0	6	80	0.0750000
NODE_139746_length_323_cov_2.089286	64	144	4	19	80	0.2375000
NODE_139746_length_323_cov_2.089286	64	144	6	55	80	0.6875000
NODE_139797_length_323_cov_1.888393	148	207	0	36	59	0.6101695
NODE_139797_length_323_cov_1.888393	148	207	2	1	59	0.0169492
NODE_139797_length_323_cov_1.888393	148	207	4	22	59	0.3728814
NODE_139901_length_323_cov_1.705357	195	262	0	67	67	1.0000000
NODE_139901_length_323_cov_1.705357	235	315	0	80	80	1.0000000
NODE_140651_length_322_cov_5.475336	56	136	0	80	80	1.0000000
NODE_140651_length_322_cov_5.475336	113	189	0	76	76	1.0000000
NODE_140692_length_322_cov_3.753363	63	133	0	70	70	1.0000000
NODE_140692_length_322_cov_3.753363	116	190	0	74	74	1.0000000
NODE_140693_length_322_cov_3.735426	60	86	0	26	26	1.0000000
NODE_140693_length_322_cov_3.735426	99	139	0	40	40	1.0000000
NODE_140701_length_322_cov_3.605381	73	116	2	32	43	0.7441860
NODE_140701_length_322_cov_3.605381	73	116	4	11	43	0.2558140
NODE_140702_length_322_cov_3.600897	75	145	0	37	70	0.5285714
NODE_140702_length_322_cov_3.600897	75	145	2	20	70	0.2857143
NODE_140702_length_322_cov_3.600897	75	145	6	13	70	0.1857143
NODE_140820_length_322_cov_2.304933	182	213	6	31	31	1.0000000
NODE_141738_length_321_cov_8.527027	176	240	4	12	64	0.1875000
NODE_141738_length_321_cov_8.527027	176	240	6	52	64	0.8125000
NODE_141786_length_321_cov_4.094595	196	266	0	70	70	1.0000000
NODE_141811_length_321_cov_3.563063	59	131	2	56	72	0.7777778
NODE_141811_length_321_cov_3.563063	59	131	4	16	72	0.2222222
NODE_141811_length_321_cov_3.563063	112	183	2	71	71	1.0000000
NODE_141813_length_321_cov_3.540541	112	141	4	21	29	0.7241379
NODE_141813_length_321_cov_3.540541	112	141	6	5	29	0.1724138
NODE_141813_length_321_cov_3.540541	112	141	8	3	29	0.1034483
NODE_141833_length_321_cov_3.049550	65	115	26	5	50	0.1000000
NODE_141833_length_321_cov_3.049550	65	115	28	8	50	0.1600000
NODE_141833_length_321_cov_3.049550	65	115	32	3	50	0.0600000
NODE_141833_length_321_cov_3.049550	65	115	34	9	50	0.1800000
NODE_141833_length_321_cov_3.049550	65	115	36	22	50	0.4400000
NODE_141833_length_321_cov_3.049550	65	115	38	3	50	0.0600000
NODE_141833_length_321_cov_3.049550	95	138	28	10	43	0.2325581
NODE_141833_length_321_cov_3.049550	95	138	30	6	43	0.1395349
NODE_141833_length_321_cov_3.049550	95	138	32	10	43	0.2325581
NODE_141833_length_321_cov_3.049550	95	138	34	7	43	0.1627907
NODE_141833_length_321_cov_3.049550	95	138	36	10	43	0.2325581
NODE_141833_length_321_cov_3.049550	118	168	0	1	50	0.0200000
NODE_141833_length_321_cov_3.049550	118	168	4	1	50	0.0200000
NODE_141833_length_321_cov_3.049550	118	168	6	1	50	0.0200000
NODE_141833_length_321_cov_3.049550	118	168	10	1	50	0.0200000
NODE_141833_length_321_cov_3.049550	118	168	12	1	50	0.0200000
NODE_141833_length_321_cov_3.049550	118	168	16	1	50	0.0200000
NODE_141833_length_321_cov_3.049550	118	168	18	5	50	0.1000000
NODE_141833_length_321_cov_3.049550	118	168	22	2	50	0.0400000
NODE_141833_length_321_cov_3.049550	118	168	24	10	50	0.2000000
NODE_141833_length_321_cov_3.049550	118	168	28	17	50	0.3400000
NODE_141833_length_321_cov_3.049550	118	168	30	6	50	0.1200000
NODE_141833_length_321_cov_3.049550	118	168	32	4	50	0.0800000
NODE_141837_length_321_cov_2.995495	146	220	0	51	74	0.6891892
NODE_141837_length_321_cov_2.995495	146	220	4	23	74	0.3108108
NODE_141842_length_321_cov_2.981982	251	304	0	53	53	1.0000000
NODE_141876_length_321_cov_2.734234	239	306	2	67	67	1.0000000
NODE_141910_length_321_cov_2.427928	221	265	0	44	44	1.0000000
NODE_141922_length_321_cov_2.315315	22	65	0	43	43	1.0000000
NODE_141951_length_321_cov_2.270270	43	105	0	62	62	1.0000000
NODE_141951_length_321_cov_2.270270	120	203	2	83	83	1.0000000
NODE_141951_length_321_cov_2.270270	127	208	2	81	81	1.0000000
NODE_142200_length_321_cov_1.576577	241	321	0	80	80	1.0000000
NODE_142363_length_321_cov_1.319820	253	304	0	51	51	1.0000000
NODE_142484_length_321_cov_1.130631	0	43	0	43	43	1.0000000
NODE_142700_length_321_cov_0.869369	248	294	0	8	46	0.1739130
NODE_142700_length_321_cov_0.869369	248	294	2	38	46	0.8260869
NODE_142885_length_320_cov_200.484163	264	320	2	1	56	0.0178571
NODE_142885_length_320_cov_200.484163	264	320	6	7	56	0.1250000
NODE_142885_length_320_cov_200.484163	264	320	8	5	56	0.0892857
NODE_142885_length_320_cov_200.484163	264	320	10	1	56	0.0178571
NODE_142885_length_320_cov_200.484163	264	320	14	1	56	0.0178571
NODE_142885_length_320_cov_200.484163	264	320	16	2	56	0.0357143
NODE_142885_length_320_cov_200.484163	264	320	20	2	56	0.0357143
NODE_142885_length_320_cov_200.484163	264	320	26	2	56	0.0357143
NODE_142885_length_320_cov_200.484163	264	320	30	1	56	0.0178571
NODE_142885_length_320_cov_200.484163	264	320	32	1	56	0.0178571
NODE_142885_length_320_cov_200.484163	264	320	34	13	56	0.2321429
NODE_142885_length_320_cov_200.484163	264	320	36	5	56	0.0892857
NODE_142885_length_320_cov_200.484163	264	320	38	13	56	0.2321429
NODE_142885_length_320_cov_200.484163	264	320	40	2	56	0.0357143
NODE_142886_length_320_cov_73.357466	51	97	0	46	46	1.0000000
NODE_142886_length_320_cov_73.357466	108	154	0	46	46	1.0000000
NODE_142886_length_320_cov_73.357466	165	245	0	7	80	0.0875000
NODE_142886_length_320_cov_73.357466	165	245	6	39	80	0.4875000
NODE_142886_length_320_cov_73.357466	165	245	8	34	80	0.4250000
NODE_142886_length_320_cov_73.357466	218	296	8	78	78	1.0000000
NODE_142887_length_320_cov_35.787330	212	292	12	1	80	0.0125000
NODE_142887_length_320_cov_35.787330	212	292	14	5	80	0.0625000
NODE_142887_length_320_cov_35.787330	212	292	16	4	80	0.0500000
NODE_142887_length_320_cov_35.787330	212	292	18	11	80	0.1375000
NODE_142887_length_320_cov_35.787330	212	292	20	1	80	0.0125000
NODE_142887_length_320_cov_35.787330	212	292	22	4	80	0.0500000
NODE_142887_length_320_cov_35.787330	212	292	24	6	80	0.0750000
NODE_142887_length_320_cov_35.787330	212	292	26	2	80	0.0250000
NODE_142887_length_320_cov_35.787330	212	292	28	46	80	0.5750000
NODE_142887_length_320_cov_35.787330	212	292	12	1	80	0.0125000
NODE_142887_length_320_cov_35.787330	212	292	14	5	80	0.0625000
NODE_142887_length_320_cov_35.787330	212	292	16	4	80	0.0500000
NODE_142887_length_320_cov_35.787330	212	292	18	11	80	0.1375000
NODE_142887_length_320_cov_35.787330	212	292	20	1	80	0.0125000
NODE_142887_length_320_cov_35.787330	212	292	22	4	80	0.0500000
NODE_142887_length_320_cov_35.787330	212	292	24	6	80	0.0750000
NODE_142887_length_320_cov_35.787330	212	292	26	2	80	0.0250000
NODE_142887_length_320_cov_35.787330	212	292	28	46	80	0.5750000
NODE_142887_length_320_cov_35.787330	212	292	12	1	80	0.0125000
NODE_142887_length_320_cov_35.787330	212	292	14	5	80	0.0625000
NODE_142887_length_320_cov_35.787330	212	292	16	4	80	0.0500000
NODE_142887_length_320_cov_35.787330	212	292	18	11	80	0.1375000
NODE_142887_length_320_cov_35.787330	212	292	20	1	80	0.0125000
NODE_142887_length_320_cov_35.787330	212	292	22	4	80	0.0500000
NODE_142887_length_320_cov_35.787330	212	292	24	6	80	0.0750000
NODE_142887_length_320_cov_35.787330	212	292	26	2	80	0.0250000
NODE_142887_length_320_cov_35.787330	212	292	28	46	80	0.5750000
NODE_142887_length_320_cov_35.787330	212	292	12	1	80	0.0125000
NODE_142887_length_320_cov_35.787330	212	292	14	5	80	0.0625000
NODE_142887_length_320_cov_35.787330	212	292	16	4	80	0.0500000
NODE_142887_length_320_cov_35.787330	212	292	18	11	80	0.1375000
NODE_142887_length_320_cov_35.787330	212	292	20	1	80	0.0125000
NODE_142887_length_320_cov_35.787330	212	292	22	4	80	0.0500000
NODE_142887_length_320_cov_35.787330	212	292	24	6	80	0.0750000
NODE_142887_length_320_cov_35.787330	212	292	26	2	80	0.0250000
NODE_142887_length_320_cov_35.787330	212	292	28	46	80	0.5750000
NODE_142887_length_320_cov_35.787330	212	292	12	1	80	0.0125000
NODE_142887_length_320_cov_35.787330	212	292	14	5	80	0.0625000
NODE_142887_length_320_cov_35.787330	212	292	16	4	80	0.0500000
NODE_142887_length_320_cov_35.787330	212	292	18	11	80	0.1375000
NODE_142887_length_320_cov_35.787330	212	292	20	1	80	0.0125000
NODE_142887_length_320_cov_35.787330	212	292	22	4	80	0.0500000
NODE_142887_length_320_cov_35.787330	212	292	24	6	80	0.0750000
NODE_142887_length_320_cov_35.787330	212	292	26	2	80	0.0250000
NODE_142887_length_320_cov_35.787330	212	292	28	46	80	0.5750000
NODE_142887_length_320_cov_35.787330	265	314	0	7	49	0.1428571
NODE_142887_length_320_cov_35.787330	265	314	2	4	49	0.0816327
NODE_142887_length_320_cov_35.787330	265	314	4	8	49	0.1632653
NODE_142887_length_320_cov_35.787330	265	314	6	2	49	0.0408163
NODE_142887_length_320_cov_35.787330	265	314	12	2	49	0.0408163
NODE_142887_length_320_cov_35.787330	265	314	14	5	49	0.1020408
NODE_142887_length_320_cov_35.787330	265	314	16	4	49	0.0816327
NODE_142887_length_320_cov_35.787330	265	314	18	9	49	0.1836735
NODE_142887_length_320_cov_35.787330	265	314	22	3	49	0.0612245
NODE_142887_length_320_cov_35.787330	265	314	24	5	49	0.1020408
NODE_142887_length_320_cov_35.787330	265	320	0	13	55	0.2363636
NODE_142887_length_320_cov_35.787330	265	320	2	4	55	0.0727273
NODE_142887_length_320_cov_35.787330	265	320	4	8	55	0.1454545
NODE_142887_length_320_cov_35.787330	265	320	6	2	55	0.0363636
NODE_142887_length_320_cov_35.787330	265	320	12	2	55	0.0363636
NODE_142887_length_320_cov_35.787330	265	320	14	5	55	0.0909091
NODE_142887_length_320_cov_35.787330	265	320	16	4	55	0.0727273
NODE_142887_length_320_cov_35.787330	265	320	18	9	55	0.1636364
NODE_142887_length_320_cov_35.787330	265	320	22	3	55	0.0545455
NODE_142887_length_320_cov_35.787330	265	320	24	5	55	0.0909091
NODE_142887_length_320_cov_35.787330	265	320	0	13	55	0.2363636
NODE_142887_length_320_cov_35.787330	265	320	2	4	55	0.0727273
NODE_142887_length_320_cov_35.787330	265	320	4	8	55	0.1454545
NODE_142887_length_320_cov_35.787330	265	320	6	2	55	0.0363636
NODE_142887_length_320_cov_35.787330	265	320	12	2	55	0.0363636
NODE_142887_length_320_cov_35.787330	265	320	14	5	55	0.0909091
NODE_142887_length_320_cov_35.787330	265	320	16	4	55	0.0727273
NODE_142887_length_320_cov_35.787330	265	320	18	9	55	0.1636364
NODE_142887_length_320_cov_35.787330	265	320	22	3	55	0.0545455
NODE_142887_length_320_cov_35.787330	265	320	24	5	55	0.0909091
NODE_142887_length_320_cov_35.787330	268	320	0	13	52	0.2500000
NODE_142887_length_320_cov_35.787330	268	320	2	4	52	0.0769231
NODE_142887_length_320_cov_35.787330	268	320	4	8	52	0.1538462
NODE_142887_length_320_cov_35.787330	268	320	6	2	52	0.0384615
NODE_142887_length_320_cov_35.787330	268	320	12	2	52	0.0384615
NODE_142887_length_320_cov_35.787330	268	320	14	5	52	0.0961538
NODE_142887_length_320_cov_35.787330	268	320	16	4	52	0.0769231
NODE_142887_length_320_cov_35.787330	268	320	18	9	52	0.1730769
NODE_142887_length_320_cov_35.787330	268	320	22	3	52	0.0576923
NODE_142887_length_320_cov_35.787330	268	320	24	2	52	0.0384615
NODE_142887_length_320_cov_35.787330	270	320	0	13	50	0.2600000
NODE_142887_length_320_cov_35.787330	270	320	2	4	50	0.0800000
NODE_142887_length_320_cov_35.787330	270	320	4	8	50	0.1600000
NODE_142887_length_320_cov_35.787330	270	320	6	2	50	0.0400000
NODE_142887_length_320_cov_35.787330	270	320	12	2	50	0.0400000
NODE_142887_length_320_cov_35.787330	270	320	14	5	50	0.1000000
NODE_142887_length_320_cov_35.787330	270	320	16	4	50	0.0800000
NODE_142887_length_320_cov_35.787330	270	320	18	9	50	0.1800000
NODE_142887_length_320_cov_35.787330	270	320	22	3	50	0.0600000
NODE_142900_length_320_cov_5.841629	115	172	1	14	57	0.2456140
NODE_142900_length_320_cov_5.841629	115	172	4	15	57	0.2631579
NODE_142900_length_320_cov_5.841629	115	172	5	28	57	0.4912281
NODE_142900_length_320_cov_5.841629	168	225	4	57	57	1.0000000
NODE_142934_length_320_cov_4.153846	134	200	0	66	66	1.0000000
NODE_142958_length_320_cov_3.733032	5	40	0	35	35	1.0000000
NODE_142985_length_320_cov_3.402715	142	222	0	80	80	1.0000000
NODE_143076_length_320_cov_2.475113	120	187	0	17	67	0.2537313
NODE_143076_length_320_cov_2.475113	120	187	2	14	67	0.2089552
NODE_143076_length_320_cov_2.475113	120	187	4	7	67	0.1044776
NODE_143076_length_320_cov_2.475113	120	187	6	2	67	0.0298507
NODE_143076_length_320_cov_2.475113	120	187	8	2	67	0.0298507
NODE_143076_length_320_cov_2.475113	120	187	12	3	67	0.0447761
NODE_143076_length_320_cov_2.475113	120	187	16	6	67	0.0895522
NODE_143076_length_320_cov_2.475113	120	187	18	1	67	0.0149254
NODE_143076_length_320_cov_2.475113	120	187	20	3	67	0.0447761
NODE_143076_length_320_cov_2.475113	120	187	22	4	67	0.0597015
NODE_143076_length_320_cov_2.475113	120	187	25	1	67	0.0149254
NODE_143076_length_320_cov_2.475113	120	187	27	1	67	0.0149254
NODE_143076_length_320_cov_2.475113	120	187	29	1	67	0.0149254
NODE_143076_length_320_cov_2.475113	120	187	37	1	67	0.0149254
NODE_143076_length_320_cov_2.475113	120	187	39	2	67	0.0298507
NODE_143076_length_320_cov_2.475113	120	187	41	1	67	0.0149254
NODE_143076_length_320_cov_2.475113	120	187	42	1	67	0.0149254
NODE_143142_length_320_cov_2.171946	16	96	0	1	80	0.0125000
NODE_143142_length_320_cov_2.171946	16	96	2	1	80	0.0125000
NODE_143142_length_320_cov_2.171946	16	96	3	5	80	0.0625000
NODE_143142_length_320_cov_2.171946	16	96	5	7	80	0.0875000
NODE_143142_length_320_cov_2.171946	16	96	8	4	80	0.0500000
NODE_143142_length_320_cov_2.171946	16	96	18	1	80	0.0125000
NODE_143142_length_320_cov_2.171946	16	96	19	7	80	0.0875000
NODE_143142_length_320_cov_2.171946	16	96	20	1	80	0.0125000
NODE_143142_length_320_cov_2.171946	16	96	22	1	80	0.0125000
NODE_143142_length_320_cov_2.171946	16	96	23	3	80	0.0375000
NODE_143142_length_320_cov_2.171946	16	96	24	8	80	0.1000000
NODE_143142_length_320_cov_2.171946	16	96	26	7	80	0.0875000
NODE_143142_length_320_cov_2.171946	16	96	28	7	80	0.0875000
NODE_143142_length_320_cov_2.171946	16	96	30	27	80	0.3375000
NODE_143142_length_320_cov_2.171946	69	149	30	37	80	0.4625000
NODE_143142_length_320_cov_2.171946	69	149	34	3	80	0.0375000
NODE_143142_length_320_cov_2.171946	69	149	35	7	80	0.0875000
NODE_143142_length_320_cov_2.171946	69	149	40	24	80	0.3000000
NODE_143142_length_320_cov_2.171946	69	149	41	4	80	0.0500000
NODE_143142_length_320_cov_2.171946	69	149	42	5	80	0.0625000
NODE_143207_length_320_cov_1.900452	37	117	2	4	80	0.0500000
NODE_143207_length_320_cov_1.900452	37	117	4	1	80	0.0125000
NODE_143207_length_320_cov_1.900452	37	117	6	3	80	0.0375000
NODE_143207_length_320_cov_1.900452	37	117	15	6	80	0.0750000
NODE_143207_length_320_cov_1.900452	37	117	17	10	80	0.1250000
NODE_143207_length_320_cov_1.900452	37	117	18	56	80	0.7000000
NODE_143207_length_320_cov_1.900452	90	164	0	44	74	0.5945946
NODE_143207_length_320_cov_1.900452	90	164	2	7	74	0.0945946
NODE_143207_length_320_cov_1.900452	90	164	4	1	74	0.0135135
NODE_143207_length_320_cov_1.900452	90	164	6	3	74	0.0405405
NODE_143207_length_320_cov_1.900452	90	164	18	19	74	0.2567568
NODE_143230_length_320_cov_1.846154	188	220	0	32	32	1.0000000
NODE_143309_length_320_cov_1.665158	144	198	2	2	54	0.0370370
NODE_143309_length_320_cov_1.665158	144	198	5	1	54	0.0185185
NODE_143309_length_320_cov_1.665158	144	198	6	51	54	0.9444444
NODE_143309_length_320_cov_1.665158	198	251	4	11	53	0.2075472
NODE_143309_length_320_cov_1.665158	198	251	6	42	53	0.7924528
NODE_143351_length_320_cov_1.601810	157	181	0	1	24	0.0416667
NODE_143351_length_320_cov_1.601810	157	181	2	5	24	0.2083333
NODE_143351_length_320_cov_1.601810	157	181	4	6	24	0.2500000
NODE_143351_length_320_cov_1.601810	157	181	6	1	24	0.0416667
NODE_143351_length_320_cov_1.601810	157	181	8	11	24	0.4583333
NODE_143351_length_320_cov_1.601810	231	290	6	22	59	0.3728814
NODE_143351_length_320_cov_1.601810	231	290	8	2	59	0.0338983
NODE_143351_length_320_cov_1.601810	231	290	10	23	59	0.3898305
NODE_143351_length_320_cov_1.601810	231	290	12	12	59	0.2033898
NODE_143366_length_320_cov_1.556561	0	39	0	16	39	0.4102564
NODE_143366_length_320_cov_1.556561	0	39	2	5	39	0.1282051
NODE_143366_length_320_cov_1.556561	0	39	4	6	39	0.1538462
NODE_143366_length_320_cov_1.556561	0	39	12	12	39	0.3076923
NODE_143442_length_320_cov_1.384615	18	98	0	29	80	0.3625000
NODE_143442_length_320_cov_1.384615	18	98	2	35	80	0.4375000
NODE_143442_length_320_cov_1.384615	18	98	6	16	80	0.2000000
NODE_143442_length_320_cov_1.384615	71	145	2	11	74	0.1486486
NODE_143442_length_320_cov_1.384615	71	145	6	47	74	0.6351351
NODE_143442_length_320_cov_1.384615	71	145	8	5	74	0.0675676
NODE_143442_length_320_cov_1.384615	71	145	10	11	74	0.1486486
NODE_143521_length_320_cov_1.312217	117	170	0	6	53	0.1132075
NODE_143521_length_320_cov_1.312217	117	170	1	2	53	0.0377358
NODE_143521_length_320_cov_1.312217	117	170	2	45	53	0.8490566
NODE_143670_length_320_cov_1.117647	58	109	0	6	51	0.1176471
NODE_143670_length_320_cov_1.117647	58	109	2	10	51	0.1960784
NODE_143670_length_320_cov_1.117647	58	109	4	35	51	0.6862745
NODE_144091_length_319_cov_5.940909	122	202	0	3	80	0.0375000
NODE_144091_length_319_cov_5.940909	122	202	2	76	80	0.9500000
NODE_144091_length_319_cov_5.940909	122	202	4	1	80	0.0125000
NODE_144107_length_319_cov_4.700000	16	47	0	31	31	1.0000000
NODE_144137_length_319_cov_4.068182	5	36	0	31	31	1.0000000
NODE_144162_length_319_cov_3.568182	149	229	0	80	80	1.0000000
NODE_144206_length_319_cov_3.036364	112	174	0	62	62	1.0000000
NODE_144226_length_319_cov_2.800000	25	106	0	6	81	0.0740741
NODE_144226_length_319_cov_2.800000	25	106	2	1	81	0.0123457
NODE_144226_length_319_cov_2.800000	25	106	10	1	81	0.0123457
NODE_144226_length_319_cov_2.800000	25	106	12	1	81	0.0123457
NODE_144226_length_319_cov_2.800000	25	106	20	1	81	0.0123457
NODE_144226_length_319_cov_2.800000	25	106	25	1	81	0.0123457
NODE_144226_length_319_cov_2.800000	25	106	27	2	81	0.0246914
NODE_144226_length_319_cov_2.800000	25	106	28	2	81	0.0246914
NODE_144226_length_319_cov_2.800000	25	106	30	1	81	0.0123457
NODE_144226_length_319_cov_2.800000	25	106	35	3	81	0.0370370
NODE_144226_length_319_cov_2.800000	25	106	36	7	81	0.0864198
NODE_144226_length_319_cov_2.800000	25	106	38	3	81	0.0370370
NODE_144226_length_319_cov_2.800000	25	106	42	1	81	0.0123457
NODE_144226_length_319_cov_2.800000	25	106	44	5	81	0.0617284
NODE_144226_length_319_cov_2.800000	25	106	54	3	81	0.0370370
NODE_144226_length_319_cov_2.800000	25	106	56	1	81	0.0123457
NODE_144226_length_319_cov_2.800000	25	106	64	2	81	0.0246914
NODE_144226_length_319_cov_2.800000	25	106	65	1	81	0.0123457
NODE_144226_length_319_cov_2.800000	25	106	81	4	81	0.0493827
NODE_144226_length_319_cov_2.800000	25	106	83	1	81	0.0123457
NODE_144226_length_319_cov_2.800000	25	106	85	1	81	0.0123457
NODE_144226_length_319_cov_2.800000	25	106	87	1	81	0.0123457
NODE_144226_length_319_cov_2.800000	25	106	89	2	81	0.0246914
NODE_144226_length_319_cov_2.800000	25	106	92	1	81	0.0123457
NODE_144226_length_319_cov_2.800000	25	106	94	1	81	0.0123457
NODE_144226_length_319_cov_2.800000	25	106	96	3	81	0.0370370
NODE_144226_length_319_cov_2.800000	25	106	101	1	81	0.0123457
NODE_144226_length_319_cov_2.800000	25	106	110	6	81	0.0740741
NODE_144226_length_319_cov_2.800000	25	106	118	1	81	0.0123457
NODE_144226_length_319_cov_2.800000	25	106	121	1	81	0.0123457
NODE_144226_length_319_cov_2.800000	25	106	123	1	81	0.0123457
NODE_144226_length_319_cov_2.800000	25	106	129	2	81	0.0246914
NODE_144226_length_319_cov_2.800000	25	106	133	1	81	0.0123457
NODE_144226_length_319_cov_2.800000	25	106	135	3	81	0.0370370
NODE_144226_length_319_cov_2.800000	25	106	139	9	81	0.1111111
NODE_144226_length_319_cov_2.800000	79	158	96	2	79	0.0253165
NODE_144226_length_319_cov_2.800000	79	158	101	1	79	0.0126582
NODE_144226_length_319_cov_2.800000	79	158	110	6	79	0.0759494
NODE_144226_length_319_cov_2.800000	79	158	118	1	79	0.0126582
NODE_144226_length_319_cov_2.800000	79	158	121	1	79	0.0126582
NODE_144226_length_319_cov_2.800000	79	158	123	1	79	0.0126582
NODE_144226_length_319_cov_2.800000	79	158	124	1	79	0.0126582
NODE_144226_length_319_cov_2.800000	79	158	128	8	79	0.1012658
NODE_144226_length_319_cov_2.800000	79	158	129	2	79	0.0253165
NODE_144226_length_319_cov_2.800000	79	158	132	2	79	0.0253165
NODE_144226_length_319_cov_2.800000	79	158	133	3	79	0.0379747
NODE_144226_length_319_cov_2.800000	79	158	135	3	79	0.0379747
NODE_144226_length_319_cov_2.800000	79	158	138	2	79	0.0253165
NODE_144226_length_319_cov_2.800000	79	158	139	12	79	0.1518987
NODE_144226_length_319_cov_2.800000	79	158	140	12	79	0.1518987
NODE_144226_length_319_cov_2.800000	79	158	142	5	79	0.0632911
NODE_144226_length_319_cov_2.800000	79	158	145	17	79	0.2151899
NODE_144237_length_319_cov_2.740909	67	147	16	9	80	0.1125000
NODE_144237_length_319_cov_2.740909	67	147	18	4	80	0.0500000
NODE_144237_length_319_cov_2.740909	67	147	21	10	80	0.1250000
NODE_144237_length_319_cov_2.740909	67	147	22	2	80	0.0250000
NODE_144237_length_319_cov_2.740909	67	147	23	14	80	0.1750000
NODE_144237_length_319_cov_2.740909	67	147	25	41	80	0.5125000
NODE_144252_length_319_cov_2.586364	247	319	0	72	72	1.0000000
NODE_144272_length_319_cov_2.463636	90	153	0	25	63	0.3968254
NODE_144272_length_319_cov_2.463636	90	153	2	38	63	0.6031746
NODE_144272_length_319_cov_2.463636	163	216	0	53	53	1.0000000
NODE_144316_length_319_cov_2.259091	146	212	0	31	66	0.4696970
NODE_144316_length_319_cov_2.259091	146	212	2	35	66	0.5303030
NODE_144340_length_319_cov_2.163636	213	275	0	62	62	1.0000000
NODE_144390_length_319_cov_1.968182	120	200	2	59	80	0.7375000
NODE_144390_length_319_cov_1.968182	120	200	4	21	80	0.2625000
NODE_144616_length_319_cov_1.431818	111	157	0	46	46	1.0000000
NODE_144629_length_319_cov_1.395455	129	179	0	50	50	1.0000000
NODE_144788_length_319_cov_1.190909	119	182	0	63	63	1.0000000
NODE_144788_length_319_cov_1.190909	197	232	0	35	35	1.0000000
NODE_145289_length_318_cov_232.639269	169	198	175	1	29	0.0344828
NODE_145289_length_318_cov_232.639269	169	198	183	1	29	0.0344828
NODE_145289_length_318_cov_232.639269	169	198	189	1	29	0.0344828
NODE_145289_length_318_cov_232.639269	169	198	191	2	29	0.0689655
NODE_145289_length_318_cov_232.639269	169	198	198	1	29	0.0344828
NODE_145289_length_318_cov_232.639269	169	198	201	1	29	0.0344828
NODE_145289_length_318_cov_232.639269	169	198	215	1	29	0.0344828
NODE_145289_length_318_cov_232.639269	169	198	216	1	29	0.0344828
NODE_145289_length_318_cov_232.639269	169	198	228	1	29	0.0344828
NODE_145289_length_318_cov_232.639269	169	198	231	1	29	0.0344828
NODE_145289_length_318_cov_232.639269	169	198	232	3	29	0.1034483
NODE_145289_length_318_cov_232.639269	169	198	233	1	29	0.0344828
NODE_145289_length_318_cov_232.639269	169	198	238	1	29	0.0344828
NODE_145289_length_318_cov_232.639269	169	198	240	6	29	0.2068966
NODE_145289_length_318_cov_232.639269	169	198	242	3	29	0.1034483
NODE_145289_length_318_cov_232.639269	169	198	244	1	29	0.0344828
NODE_145289_length_318_cov_232.639269	169	198	247	1	29	0.0344828
NODE_145289_length_318_cov_232.639269	169	198	249	1	29	0.0344828
NODE_145289_length_318_cov_232.639269	169	198	251	1	29	0.0344828
NODE_145289_length_318_cov_232.639269	171	246	187	1	75	0.0133333
NODE_145289_length_318_cov_232.639269	171	246	189	3	75	0.0400000
NODE_145289_length_318_cov_232.639269	171	246	191	6	75	0.0800000
NODE_145289_length_318_cov_232.639269	171	246	193	1	75	0.0133333
NODE_145289_length_318_cov_232.639269	171	246	195	2	75	0.0266667
NODE_145289_length_318_cov_232.639269	171	246	198	1	75	0.0133333
NODE_145289_length_318_cov_232.639269	171	246	201	1	75	0.0133333
NODE_145289_length_318_cov_232.639269	171	246	203	2	75	0.0266667
NODE_145289_length_318_cov_232.639269	171	246	207	1	75	0.0133333
NODE_145289_length_318_cov_232.639269	171	246	209	3	75	0.0400000
NODE_145289_length_318_cov_232.639269	171	246	211	3	75	0.0400000
NODE_145289_length_318_cov_232.639269	171	246	213	1	75	0.0133333
NODE_145289_length_318_cov_232.639269	171	246	215	2	75	0.0266667
NODE_145289_length_318_cov_232.639269	171	246	216	1	75	0.0133333
NODE_145289_length_318_cov_232.639269	171	246	219	1	75	0.0133333
NODE_145289_length_318_cov_232.639269	171	246	223	2	75	0.0266667
NODE_145289_length_318_cov_232.639269	171	246	228	1	75	0.0133333
NODE_145289_length_318_cov_232.639269	171	246	229	2	75	0.0266667
NODE_145289_length_318_cov_232.639269	171	246	231	2	75	0.0266667
NODE_145289_length_318_cov_232.639269	171	246	232	3	75	0.0400000
NODE_145289_length_318_cov_232.639269	171	246	233	2	75	0.0266667
NODE_145289_length_318_cov_232.639269	171	246	235	4	75	0.0533333
NODE_145289_length_318_cov_232.639269	171	246	237	6	75	0.0800000
NODE_145289_length_318_cov_232.639269	171	246	238	1	75	0.0133333
NODE_145289_length_318_cov_232.639269	171	246	239	1	75	0.0133333
NODE_145289_length_318_cov_232.639269	171	246	240	6	75	0.0800000
NODE_145289_length_318_cov_232.639269	171	246	241	2	75	0.0266667
NODE_145289_length_318_cov_232.639269	171	246	242	3	75	0.0400000
NODE_145289_length_318_cov_232.639269	171	246	244	2	75	0.0266667
NODE_145289_length_318_cov_232.639269	171	246	246	3	75	0.0400000
NODE_145289_length_318_cov_232.639269	171	246	247	1	75	0.0133333
NODE_145289_length_318_cov_232.639269	171	246	249	2	75	0.0266667
NODE_145289_length_318_cov_232.639269	171	246	251	3	75	0.0400000
NODE_145333_length_318_cov_4.237443	222	294	0	10	72	0.1388889
NODE_145333_length_318_cov_4.237443	222	294	2	13	72	0.1805556
NODE_145333_length_318_cov_4.237443	222	294	4	12	72	0.1666667
NODE_145333_length_318_cov_4.237443	222	294	6	37	72	0.5138889
NODE_145348_length_318_cov_3.721461	98	148	0	50	50	1.0000000
NODE_145362_length_318_cov_3.515982	60	129	0	69	69	1.0000000
NODE_145362_length_318_cov_3.515982	60	140	0	80	80	1.0000000
NODE_145362_length_318_cov_3.515982	60	140	0	80	80	1.0000000
NODE_145362_length_318_cov_3.515982	113	153	0	40	40	1.0000000
NODE_145362_length_318_cov_3.515982	122	153	0	31	31	1.0000000
NODE_145465_length_318_cov_2.557078	205	247	4	21	42	0.5000000
NODE_145465_length_318_cov_2.557078	205	247	6	21	42	0.5000000
NODE_145551_length_318_cov_2.109589	70	150	0	80	80	1.0000000
NODE_145619_length_318_cov_1.945205	229	286	0	57	57	1.0000000
NODE_145709_length_318_cov_1.739726	242	308	0	66	66	1.0000000
NODE_145725_length_318_cov_1.684932	49	80	4	31	31	1.0000000
NODE_145787_length_318_cov_1.561644	99	158	8	2	59	0.0338983
NODE_145787_length_318_cov_1.561644	99	158	9	1	59	0.0169492
NODE_145787_length_318_cov_1.561644	99	158	11	1	59	0.0169492
NODE_145787_length_318_cov_1.561644	99	158	13	1	59	0.0169492
NODE_145787_length_318_cov_1.561644	99	158	15	17	59	0.2881356
NODE_145787_length_318_cov_1.561644	99	158	17	2	59	0.0338983
NODE_145787_length_318_cov_1.561644	99	158	19	35	59	0.5932204
NODE_145807_length_318_cov_1.493151	151	195	0	19	44	0.4318182
NODE_145807_length_318_cov_1.493151	151	195	2	14	44	0.3181818
NODE_145807_length_318_cov_1.493151	151	195	4	11	44	0.2500000
NODE_145807_length_318_cov_1.493151	199	258	2	4	59	0.0677966
NODE_145807_length_318_cov_1.493151	199	258	4	55	59	0.9322034
NODE_145968_length_318_cov_1.301370	91	141	2	50	50	1.0000000
NODE_146017_length_318_cov_1.173516	83	150	8	36	67	0.5373135
NODE_146017_length_318_cov_1.173516	83	150	10	31	67	0.4626866
NODE_146065_length_318_cov_1.127854	24	51	0	27	27	1.0000000
NODE_146065_length_318_cov_1.127854	24	60	0	36	36	1.0000000
NODE_146467_length_317_cov_55.467890	172	243	28	3	71	0.0422535
NODE_146467_length_317_cov_55.467890	172	243	30	1	71	0.0140845
NODE_146467_length_317_cov_55.467890	172	243	32	1	71	0.0140845
NODE_146467_length_317_cov_55.467890	172	243	34	6	71	0.0845070
NODE_146467_length_317_cov_55.467890	172	243	36	4	71	0.0563380
NODE_146467_length_317_cov_55.467890	172	243	38	1	71	0.0140845
NODE_146467_length_317_cov_55.467890	172	243	42	1	71	0.0140845
NODE_146467_length_317_cov_55.467890	172	243	44	2	71	0.0281690
NODE_146467_length_317_cov_55.467890	172	243	46	4	71	0.0563380
NODE_146467_length_317_cov_55.467890	172	243	50	7	71	0.0985916
NODE_146467_length_317_cov_55.467890	172	243	52	5	71	0.0704225
NODE_146467_length_317_cov_55.467890	172	243	54	3	71	0.0422535
NODE_146467_length_317_cov_55.467890	172	243	56	6	71	0.0845070
NODE_146467_length_317_cov_55.467890	172	243	58	27	71	0.3802817
NODE_146487_length_317_cov_5.252294	247	307	4	45	60	0.7500000
NODE_146487_length_317_cov_5.252294	247	307	6	7	60	0.1166667
NODE_146487_length_317_cov_5.252294	247	307	7	8	60	0.1333333
NODE_146503_length_317_cov_4.467890	105	185	0	49	80	0.6125000
NODE_146503_length_317_cov_4.467890	105	185	2	2	80	0.0250000
NODE_146503_length_317_cov_4.467890	105	185	4	29	80	0.3625000
NODE_146503_length_317_cov_4.467890	113	193	0	41	80	0.5125000
NODE_146503_length_317_cov_4.467890	113	193	2	2	80	0.0250000
NODE_146503_length_317_cov_4.467890	113	193	4	37	80	0.4625000
NODE_146554_length_317_cov_3.298165	146	206	0	1	60	0.0166667
NODE_146554_length_317_cov_3.298165	146	206	2	1	60	0.0166667
NODE_146554_length_317_cov_3.298165	146	206	4	20	60	0.3333333
NODE_146554_length_317_cov_3.298165	146	206	6	38	60	0.6333333
NODE_146562_length_317_cov_3.266055	111	191	0	11	80	0.1375000
NODE_146562_length_317_cov_3.266055	111	191	2	38	80	0.4750000
NODE_146562_length_317_cov_3.266055	111	191	4	15	80	0.1875000
NODE_146562_length_317_cov_3.266055	111	191	8	16	80	0.2000000
NODE_146562_length_317_cov_3.266055	164	244	0	64	80	0.8000000
NODE_146562_length_317_cov_3.266055	164	244	2	16	80	0.2000000
NODE_146585_length_317_cov_3.036697	3	79	0	76	76	1.0000000
NODE_146601_length_317_cov_2.825688	14	94	2	12	80	0.1500000
NODE_146601_length_317_cov_2.825688	14	94	4	26	80	0.3250000
NODE_146601_length_317_cov_2.825688	14	94	6	42	80	0.5250000
NODE_146601_length_317_cov_2.825688	67	147	2	1	80	0.0125000
NODE_146601_length_317_cov_2.825688	67	147	4	54	80	0.6750000
NODE_146601_length_317_cov_2.825688	67	147	6	25	80	0.3125000
NODE_146602_length_317_cov_2.821101	142	208	2	66	66	1.0000000
NODE_146604_length_317_cov_2.816514	121	201	0	80	80	1.0000000
NODE_146612_length_317_cov_2.779817	67	138	0	23	71	0.3239437
NODE_146612_length_317_cov_2.779817	67	138	2	44	71	0.6197183
NODE_146612_length_317_cov_2.779817	67	138	4	4	71	0.0563380
NODE_147046_length_317_cov_1.353211	166	239	0	62	73	0.8493150
NODE_147046_length_317_cov_1.353211	166	239	2	11	73	0.1506849
NODE_147046_length_317_cov_1.353211	212	292	0	16	80	0.2000000
NODE_147046_length_317_cov_1.353211	212	292	2	64	80	0.8000000
NODE_147172_length_317_cov_1.160550	58	117	2	12	59	0.2033898
NODE_147172_length_317_cov_1.160550	58	117	4	47	59	0.7966102
NODE_147172_length_317_cov_1.160550	90	170	4	27	80	0.3375000
NODE_147172_length_317_cov_1.160550	90	170	6	18	80	0.2250000
NODE_147172_length_317_cov_1.160550	90	170	8	7	80	0.0875000
NODE_147172_length_317_cov_1.160550	90	170	10	1	80	0.0125000
NODE_147172_length_317_cov_1.160550	90	170	12	12	80	0.1500000
NODE_147172_length_317_cov_1.160550	90	170	14	7	80	0.0875000
NODE_147172_length_317_cov_1.160550	90	170	16	5	80	0.0625000
NODE_147172_length_317_cov_1.160550	90	170	18	2	80	0.0250000
NODE_147172_length_317_cov_1.160550	90	170	20	1	80	0.0125000
NODE_147187_length_317_cov_1.137615	245	313	0	68	68	1.0000000
NODE_147259_length_317_cov_0.967890	170	211	0	41	41	1.0000000
NODE_147373_length_317_cov_0.926606	194	232	2	38	38	1.0000000
NODE_147383_length_317_cov_0.912844	186	244	0	58	58	1.0000000
NODE_147595_length_316_cov_31.502304	96	174	2	9	78	0.1153846
NODE_147595_length_316_cov_31.502304	96	174	4	10	78	0.1282051
NODE_147595_length_316_cov_31.502304	96	174	6	3	78	0.0384615
NODE_147595_length_316_cov_31.502304	96	174	8	2	78	0.0256410
NODE_147595_length_316_cov_31.502304	96	174	14	5	78	0.0641026
NODE_147595_length_316_cov_31.502304	96	174	18	1	78	0.0128205
NODE_147595_length_316_cov_31.502304	96	174	20	7	78	0.0897436
NODE_147595_length_316_cov_31.502304	96	174	22	5	78	0.0641026
NODE_147595_length_316_cov_31.502304	96	174	23	2	78	0.0256410
NODE_147595_length_316_cov_31.502304	96	174	24	13	78	0.1666667
NODE_147595_length_316_cov_31.502304	96	174	32	4	78	0.0512821
NODE_147595_length_316_cov_31.502304	96	174	34	1	78	0.0128205
NODE_147595_length_316_cov_31.502304	96	174	37	1	78	0.0128205
NODE_147595_length_316_cov_31.502304	96	174	38	4	78	0.0512821
NODE_147595_length_316_cov_31.502304	96	174	40	3	78	0.0384615
NODE_147595_length_316_cov_31.502304	96	174	42	5	78	0.0641026
NODE_147595_length_316_cov_31.502304	96	174	44	1	78	0.0128205
NODE_147595_length_316_cov_31.502304	96	174	50	2	78	0.0256410
NODE_147595_length_316_cov_31.502304	96	121	2	9	25	0.3600000
NODE_147595_length_316_cov_31.502304	96	121	4	10	25	0.4000000
NODE_147595_length_316_cov_31.502304	96	121	6	3	25	0.1200000
NODE_147595_length_316_cov_31.502304	96	121	8	2	25	0.0800000
NODE_147595_length_316_cov_31.502304	96	121	14	1	25	0.0400000
NODE_147609_length_316_cov_6.179724	225	278	0	52	53	0.9811321
NODE_147609_length_316_cov_6.179724	225	278	2	1	53	0.0188679
NODE_147623_length_316_cov_5.539171	91	171	2	2	80	0.0250000
NODE_147623_length_316_cov_5.539171	91	171	4	49	80	0.6125000
NODE_147623_length_316_cov_5.539171	91	171	6	29	80	0.3625000
NODE_147668_length_316_cov_3.732719	128	208	0	77	80	0.9625000
NODE_147668_length_316_cov_3.732719	128	208	2	3	80	0.0375000
NODE_147668_length_316_cov_3.732719	181	257	0	24	76	0.3157895
NODE_147668_length_316_cov_3.732719	181	257	2	52	76	0.6842105
NODE_147680_length_316_cov_3.589862	185	247	0	62	62	1.0000000
NODE_147684_length_316_cov_3.520737	101	143	0	42	42	1.0000000
NODE_147702_length_316_cov_3.221198	108	184	0	17	76	0.2236842
NODE_147702_length_316_cov_3.221198	108	184	2	1	76	0.0131579
NODE_147702_length_316_cov_3.221198	108	184	4	12	76	0.1578947
NODE_147702_length_316_cov_3.221198	108	184	6	1	76	0.0131579
NODE_147702_length_316_cov_3.221198	108	184	8	45	76	0.5921053
NODE_147734_length_316_cov_2.824885	274	311	4	37	37	1.0000000
NODE_147736_length_316_cov_2.820276	200	280	0	80	80	1.0000000
NODE_147757_length_316_cov_2.672811	23	80	0	57	57	1.0000000
NODE_147796_length_316_cov_2.456221	104	144	0	34	40	0.8500000
NODE_147796_length_316_cov_2.456221	104	144	2	6	40	0.1500000
NODE_147985_length_316_cov_1.751152	73	122	4	4	49	0.0816327
NODE_147985_length_316_cov_1.751152	73	122	8	23	49	0.4693878
NODE_147985_length_316_cov_1.751152	73	122	10	22	49	0.4489796
NODE_148030_length_316_cov_1.640553	218	300	0	27	82	0.3292683
NODE_148030_length_316_cov_1.640553	218	300	2	31	82	0.3780488
NODE_148030_length_316_cov_1.640553	218	300	3	5	82	0.0609756
NODE_148030_length_316_cov_1.640553	218	300	4	19	82	0.2317073
NODE_148042_length_316_cov_1.631336	180	233	0	53	53	1.0000000
NODE_148042_length_316_cov_1.631336	180	215	0	35	35	1.0000000
NODE_148080_length_316_cov_1.520737	194	275	0	81	81	1.0000000
NODE_148080_length_316_cov_1.520737	248	302	0	54	54	1.0000000
NODE_148086_length_316_cov_1.493088	64	144	2	2	80	0.0250000
NODE_148086_length_316_cov_1.493088	64	144	4	6	80	0.0750000
NODE_148086_length_316_cov_1.493088	64	144	6	45	80	0.5625000
NODE_148086_length_316_cov_1.493088	64	144	8	27	80	0.3375000
NODE_148193_length_316_cov_1.377880	22	64	4	3	42	0.0714286
NODE_148193_length_316_cov_1.377880	22	64	6	39	42	0.9285714
NODE_148204_length_316_cov_1.350230	74	117	0	21	43	0.4883721
NODE_148204_length_316_cov_1.350230	74	117	2	9	43	0.2093023
NODE_148204_length_316_cov_1.350230	74	117	4	13	43	0.3023256
NODE_148204_length_316_cov_1.350230	90	140	0	44	50	0.8800000
NODE_148204_length_316_cov_1.350230	90	140	2	6	50	0.1200000
NODE_148533_length_316_cov_0.940092	104	180	0	2	76	0.0263158
NODE_148533_length_316_cov_0.940092	104	180	2	25	76	0.3289474
NODE_148533_length_316_cov_0.940092	104	180	4	49	76	0.6447368
NODE_148533_length_316_cov_0.940092	155	234	0	7	79	0.0886076
NODE_148533_length_316_cov_0.940092	155	234	2	6	79	0.0759494
NODE_148533_length_316_cov_0.940092	155	234	4	66	79	0.8354430
NODE_148693_length_316_cov_0.695853	232	267	8	35	35	1.0000000
NODE_148778_length_315_cov_6.967593	127	191	4	26	64	0.4062500
NODE_148778_length_315_cov_6.967593	127	191	6	4	64	0.0625000
NODE_148778_length_315_cov_6.967593	127	191	8	34	64	0.5312500
NODE_148786_length_315_cov_6.300926	67	147	0	10	80	0.1250000
NODE_148786_length_315_cov_6.300926	67	147	3	23	80	0.2875000
NODE_148786_length_315_cov_6.300926	67	147	4	14	80	0.1750000
NODE_148786_length_315_cov_6.300926	67	147	5	2	80	0.0250000
NODE_148786_length_315_cov_6.300926	67	147	6	31	80	0.3875000
NODE_148786_length_315_cov_6.300926	120	200	6	80	80	1.0000000
NODE_148812_length_315_cov_4.449074	125	205	0	31	80	0.3875000
NODE_148812_length_315_cov_4.449074	125	205	2	3	80	0.0375000
NODE_148812_length_315_cov_4.449074	125	205	4	21	80	0.2625000
NODE_148812_length_315_cov_4.449074	125	205	6	15	80	0.1875000
NODE_148812_length_315_cov_4.449074	125	205	8	10	80	0.1250000
NODE_148812_length_315_cov_4.449074	178	225	0	47	47	1.0000000
NODE_148834_length_315_cov_4.009259	0	61	0	61	61	1.0000000
NODE_148834_length_315_cov_4.009259	42	61	0	19	19	1.0000000
NODE_148872_length_315_cov_3.421296	37	120	0	29	83	0.3493976
NODE_148872_length_315_cov_3.421296	37	120	2	22	83	0.2650602
NODE_148872_length_315_cov_3.421296	37	120	6	1	83	0.0120482
NODE_148872_length_315_cov_3.421296	37	120	10	31	83	0.3734940
NODE_148915_length_315_cov_2.847222	0	74	0	74	74	1.0000000
NODE_148915_length_315_cov_2.847222	47	127	0	80	80	1.0000000
NODE_148921_length_315_cov_2.833333	186	253	0	2	67	0.0298507
NODE_148921_length_315_cov_2.833333	186	253	3	11	67	0.1641791
NODE_148921_length_315_cov_2.833333	186	253	6	54	67	0.8059701
NODE_148921_length_315_cov_2.833333	186	253	0	2	67	0.0298507
NODE_148921_length_315_cov_2.833333	186	253	3	11	67	0.1641791
NODE_148921_length_315_cov_2.833333	186	253	6	54	67	0.8059701
NODE_148991_length_315_cov_2.416667	44	117	12	6	73	0.0821918
NODE_148991_length_315_cov_2.416667	44	117	15	7	73	0.0958904
NODE_148991_length_315_cov_2.416667	44	117	19	5	73	0.0684932
NODE_148991_length_315_cov_2.416667	44	117	21	2	73	0.0273973
NODE_148991_length_315_cov_2.416667	44	117	24	2	73	0.0273973
NODE_148991_length_315_cov_2.416667	44	117	26	10	73	0.1369863
NODE_148991_length_315_cov_2.416667	44	117	28	5	73	0.0684932
NODE_148991_length_315_cov_2.416667	44	117	29	3	73	0.0410959
NODE_148991_length_315_cov_2.416667	44	117	30	1	73	0.0136986
NODE_148991_length_315_cov_2.416667	44	117	31	2	73	0.0273973
NODE_148991_length_315_cov_2.416667	44	117	32	2	73	0.0273973
NODE_148991_length_315_cov_2.416667	44	117	34	3	73	0.0410959
NODE_148991_length_315_cov_2.416667	44	117	38	1	73	0.0136986
NODE_148991_length_315_cov_2.416667	44	117	42	5	73	0.0684932
NODE_148991_length_315_cov_2.416667	44	117	44	17	73	0.2328767
NODE_148991_length_315_cov_2.416667	44	117	47	2	73	0.0273973
NODE_149074_length_315_cov_2.115741	128	193	0	35	65	0.5384616
NODE_149074_length_315_cov_2.115741	128	193	2	30	65	0.4615385
NODE_149095_length_315_cov_2.004630	270	315	0	45	45	1.0000000
NODE_149201_length_315_cov_1.731481	125	202	0	43	77	0.5584416
NODE_149201_length_315_cov_1.731481	125	202	2	5	77	0.0649351
NODE_149201_length_315_cov_1.731481	125	202	4	29	77	0.3766234
NODE_149391_length_315_cov_1.384259	183	233	0	50	50	1.0000000
NODE_149935_length_315_cov_0.430556	125	145	2	17	20	0.8500000
NODE_149935_length_315_cov_0.430556	125	145	4	3	20	0.1500000
NODE_149943_length_314_cov_108.139535	151	213	86	1	62	0.0161290
NODE_149943_length_314_cov_108.139535	151	213	88	3	62	0.0483871
NODE_149943_length_314_cov_108.139535	151	213	90	1	62	0.0161290
NODE_149943_length_314_cov_108.139535	151	213	94	2	62	0.0322581
NODE_149943_length_314_cov_108.139535	151	213	96	2	62	0.0322581
NODE_149943_length_314_cov_108.139535	151	213	97	1	62	0.0161290
NODE_149943_length_314_cov_108.139535	151	213	98	1	62	0.0161290
NODE_149943_length_314_cov_108.139535	151	213	100	1	62	0.0161290
NODE_149943_length_314_cov_108.139535	151	213	101	3	62	0.0483871
NODE_149943_length_314_cov_108.139535	151	213	104	3	62	0.0483871
NODE_149943_length_314_cov_108.139535	151	213	105	8	62	0.1290323
NODE_149943_length_314_cov_108.139535	151	213	106	7	62	0.1129032
NODE_149943_length_314_cov_108.139535	151	213	108	5	62	0.0806452
NODE_149943_length_314_cov_108.139535	151	213	109	7	62	0.1129032
NODE_149943_length_314_cov_108.139535	151	213	110	3	62	0.0483871
NODE_149943_length_314_cov_108.139535	151	213	111	1	62	0.0161290
NODE_149943_length_314_cov_108.139535	151	213	112	6	62	0.0967742
NODE_149943_length_314_cov_108.139535	151	213	113	5	62	0.0806452
NODE_149943_length_314_cov_108.139535	151	213	114	1	62	0.0161290
NODE_149943_length_314_cov_108.139535	151	213	115	1	62	0.0161290
NODE_149943_length_314_cov_108.139535	160	213	97	1	53	0.0188679
NODE_149943_length_314_cov_108.139535	160	213	98	1	53	0.0188679
NODE_149943_length_314_cov_108.139535	160	213	100	1	53	0.0188679
NODE_149943_length_314_cov_108.139535	160	213	101	3	53	0.0566038
NODE_149943_length_314_cov_108.139535	160	213	104	3	53	0.0566038
NODE_149943_length_314_cov_108.139535	160	213	105	8	53	0.1509434
NODE_149943_length_314_cov_108.139535	160	213	106	7	53	0.1320755
NODE_149943_length_314_cov_108.139535	160	213	108	5	53	0.0943396
NODE_149943_length_314_cov_108.139535	160	213	109	7	53	0.1320755
NODE_149943_length_314_cov_108.139535	160	213	110	3	53	0.0566038
NODE_149943_length_314_cov_108.139535	160	213	111	1	53	0.0188679
NODE_149943_length_314_cov_108.139535	160	213	112	6	53	0.1132075
NODE_149943_length_314_cov_108.139535	160	213	113	5	53	0.0943396
NODE_149943_length_314_cov_108.139535	160	213	114	1	53	0.0188679
NODE_149943_length_314_cov_108.139535	160	213	115	1	53	0.0188679
NODE_149944_length_314_cov_48.134884	245	314	0	69	69	1.0000000
NODE_149946_length_314_cov_9.097674	149	206	0	11	57	0.1929825
NODE_149946_length_314_cov_9.097674	149	206	2	2	57	0.0350877
NODE_149946_length_314_cov_9.097674	149	206	4	44	57	0.7719298
NODE_149967_length_314_cov_4.897674	109	189	2	4	80	0.0500000
NODE_149967_length_314_cov_4.897674	109	189	4	58	80	0.7250000
NODE_149967_length_314_cov_4.897674	109	189	6	18	80	0.2250000
NODE_150004_length_314_cov_3.823256	119	199	0	70	80	0.8750000
NODE_150004_length_314_cov_3.823256	119	199	2	9	80	0.1125000
NODE_150004_length_314_cov_3.823256	119	199	4	1	80	0.0125000
NODE_150020_length_314_cov_3.558140	32	92	6	1	60	0.0166667
NODE_150020_length_314_cov_3.558140	32	92	8	3	60	0.0500000
NODE_150020_length_314_cov_3.558140	32	92	10	2	60	0.0333333
NODE_150020_length_314_cov_3.558140	32	92	11	17	60	0.2833333
NODE_150020_length_314_cov_3.558140	32	92	12	22	60	0.3666667
NODE_150020_length_314_cov_3.558140	32	92	13	15	60	0.2500000
NODE_150035_length_314_cov_3.316279	84	126	10	10	42	0.2380952
NODE_150035_length_314_cov_3.316279	84	126	12	3	42	0.0714286
NODE_150035_length_314_cov_3.316279	84	126	14	3	42	0.0714286
NODE_150035_length_314_cov_3.316279	84	126	16	5	42	0.1190476
NODE_150035_length_314_cov_3.316279	84	126	18	21	42	0.5000000
NODE_150035_length_314_cov_3.316279	127	180	0	6	53	0.1132075
NODE_150035_length_314_cov_3.316279	127	180	2	1	53	0.0188679
NODE_150035_length_314_cov_3.316279	127	180	4	2	53	0.0377358
NODE_150035_length_314_cov_3.316279	127	180	6	32	53	0.6037736
NODE_150035_length_314_cov_3.316279	127	180	8	3	53	0.0566038
NODE_150035_length_314_cov_3.316279	127	180	10	9	53	0.1698113
NODE_150035_length_314_cov_3.316279	128	148	6	9	20	0.4500000
NODE_150035_length_314_cov_3.316279	128	148	8	3	20	0.1500000
NODE_150035_length_314_cov_3.316279	128	148	10	8	20	0.4000000
NODE_150066_length_314_cov_3.032558	252	308	0	13	56	0.2321429
NODE_150066_length_314_cov_3.032558	252	308	2	21	56	0.3750000
NODE_150066_length_314_cov_3.032558	252	308	4	2	56	0.0357143
NODE_150066_length_314_cov_3.032558	252	308	5	1	56	0.0178571
NODE_150066_length_314_cov_3.032558	252	308	6	19	56	0.3392857
NODE_150141_length_314_cov_2.520930	0	61	0	61	61	1.0000000
NODE_150141_length_314_cov_2.520930	34	93	0	59	59	1.0000000
NODE_150153_length_314_cov_2.441860	48	84	0	34	36	0.9444444
NODE_150153_length_314_cov_2.441860	48	84	2	2	36	0.0555556
NODE_150159_length_314_cov_2.395349	62	112	4	50	50	1.0000000
NODE_150200_length_314_cov_2.265116	7	53	0	17	46	0.3695652
NODE_150200_length_314_cov_2.265116	7	53	2	29	46	0.6304348
NODE_150220_length_314_cov_2.144186	224	264	0	40	40	1.0000000
NODE_150257_length_314_cov_2.004651	68	148	0	80	80	1.0000000
NODE_150257_length_314_cov_2.004651	121	201	0	80	80	1.0000000
NODE_150385_length_314_cov_1.665116	204	242	0	38	38	1.0000000
NODE_150385_length_314_cov_1.665116	215	295	0	80	80	1.0000000
NODE_150647_length_314_cov_1.223256	7	87	0	80	80	1.0000000
NODE_150709_length_314_cov_1.167442	1	69	0	68	68	1.0000000
NODE_151193_length_313_cov_156.051402	177	254	0	2	77	0.0259740
NODE_151193_length_313_cov_156.051402	177	254	2	4	77	0.0519481
NODE_151193_length_313_cov_156.051402	177	254	6	2	77	0.0259740
NODE_151193_length_313_cov_156.051402	177	254	10	3	77	0.0389610
NODE_151193_length_313_cov_156.051402	177	254	12	12	77	0.1558442
NODE_151193_length_313_cov_156.051402	177	254	14	2	77	0.0259740
NODE_151193_length_313_cov_156.051402	177	254	16	52	77	0.6753247
NODE_151193_length_313_cov_156.051402	177	254	0	2	77	0.0259740
NODE_151193_length_313_cov_156.051402	177	254	2	4	77	0.0519481
NODE_151193_length_313_cov_156.051402	177	254	6	2	77	0.0259740
NODE_151193_length_313_cov_156.051402	177	254	10	3	77	0.0389610
NODE_151193_length_313_cov_156.051402	177	254	12	12	77	0.1558442
NODE_151193_length_313_cov_156.051402	177	254	14	2	77	0.0259740
NODE_151193_length_313_cov_156.051402	177	254	16	52	77	0.6753247
NODE_151214_length_313_cov_5.359813	135	196	0	61	61	1.0000000
NODE_151214_length_313_cov_5.359813	169	241	0	72	72	1.0000000
NODE_151230_length_313_cov_4.794393	126	206	0	54	80	0.6750000
NODE_151230_length_313_cov_4.794393	126	206	2	2	80	0.0250000
NODE_151230_length_313_cov_4.794393	126	206	4	12	80	0.1500000
NODE_151230_length_313_cov_4.794393	126	206	6	12	80	0.1500000
NODE_151230_length_313_cov_4.794393	179	259	0	80	80	1.0000000
NODE_151232_length_313_cov_4.761682	104	162	0	58	58	1.0000000
NODE_151232_length_313_cov_4.761682	135	215	0	80	80	1.0000000
NODE_151277_length_313_cov_3.560748	106	186	4	32	80	0.4000000
NODE_151277_length_313_cov_3.560748	106	186	6	9	80	0.1125000
NODE_151277_length_313_cov_3.560748	106	186	8	39	80	0.4875000
NODE_151331_length_313_cov_2.953271	92	153	2	61	61	1.0000000
NODE_151364_length_313_cov_2.640187	110	182	3	2	72	0.0277778
NODE_151364_length_313_cov_2.640187	110	182	5	1	72	0.0138889
NODE_151364_length_313_cov_2.640187	110	182	6	60	72	0.8333333
NODE_151364_length_313_cov_2.640187	110	182	8	9	72	0.1250000
NODE_151364_length_313_cov_2.640187	113	184	0	1	71	0.0140845
NODE_151364_length_313_cov_2.640187	113	184	3	3	71	0.0422535
NODE_151364_length_313_cov_2.640187	113	184	5	1	71	0.0140845
NODE_151364_length_313_cov_2.640187	113	184	6	60	71	0.8450704
NODE_151364_length_313_cov_2.640187	113	184	8	6	71	0.0845070
NODE_151409_length_313_cov_2.383178	58	137	0	79	79	1.0000000
NODE_151409_length_313_cov_2.383178	110	190	0	72	80	0.9000000
NODE_151409_length_313_cov_2.383178	110	190	2	6	80	0.0750000
NODE_151409_length_313_cov_2.383178	110	190	4	1	80	0.0125000
NODE_151409_length_313_cov_2.383178	110	190	6	1	80	0.0125000
NODE_151474_length_313_cov_2.107477	153	221	0	23	68	0.3382353
NODE_151474_length_313_cov_2.107477	153	221	2	35	68	0.5147059
NODE_151474_length_313_cov_2.107477	153	221	6	10	68	0.1470588
NODE_151510_length_313_cov_1.934579	107	187	2	4	80	0.0500000
NODE_151510_length_313_cov_1.934579	107	187	3	4	80	0.0500000
NODE_151510_length_313_cov_1.934579	107	187	7	19	80	0.2375000
NODE_151510_length_313_cov_1.934579	107	187	9	6	80	0.0750000
NODE_151510_length_313_cov_1.934579	107	187	17	5	80	0.0625000
NODE_151510_length_313_cov_1.934579	107	187	19	1	80	0.0125000
NODE_151510_length_313_cov_1.934579	107	187	21	2	80	0.0250000
NODE_151510_length_313_cov_1.934579	107	187	22	2	80	0.0250000
NODE_151510_length_313_cov_1.934579	107	187	24	3	80	0.0375000
NODE_151510_length_313_cov_1.934579	107	187	26	6	80	0.0750000
NODE_151510_length_313_cov_1.934579	107	187	28	1	80	0.0125000
NODE_151510_length_313_cov_1.934579	107	187	30	2	80	0.0250000
NODE_151510_length_313_cov_1.934579	107	187	32	1	80	0.0125000
NODE_151510_length_313_cov_1.934579	107	187	34	1	80	0.0125000
NODE_151510_length_313_cov_1.934579	107	187	36	8	80	0.1000000
NODE_151510_length_313_cov_1.934579	107	187	38	1	80	0.0125000
NODE_151510_length_313_cov_1.934579	107	187	42	2	80	0.0250000
NODE_151510_length_313_cov_1.934579	107	187	46	1	80	0.0125000
NODE_151510_length_313_cov_1.934579	107	187	48	2	80	0.0250000
NODE_151510_length_313_cov_1.934579	107	187	52	2	80	0.0250000
NODE_151510_length_313_cov_1.934579	107	187	58	3	80	0.0375000
NODE_151510_length_313_cov_1.934579	107	187	60	4	80	0.0500000
NODE_151510_length_313_cov_1.934579	160	240	30	2	80	0.0250000
NODE_151510_length_313_cov_1.934579	160	240	32	1	80	0.0125000
NODE_151510_length_313_cov_1.934579	160	240	34	1	80	0.0125000
NODE_151510_length_313_cov_1.934579	160	240	36	8	80	0.1000000
NODE_151510_length_313_cov_1.934579	160	240	38	1	80	0.0125000
NODE_151510_length_313_cov_1.934579	160	240	42	2	80	0.0250000
NODE_151510_length_313_cov_1.934579	160	240	46	1	80	0.0125000
NODE_151510_length_313_cov_1.934579	160	240	48	2	80	0.0250000
NODE_151510_length_313_cov_1.934579	160	240	52	2	80	0.0250000
NODE_151510_length_313_cov_1.934579	160	240	58	3	80	0.0375000
NODE_151510_length_313_cov_1.934579	160	240	60	14	80	0.1750000
NODE_151510_length_313_cov_1.934579	160	240	62	14	80	0.1750000
NODE_151510_length_313_cov_1.934579	160	240	64	10	80	0.1250000
NODE_151510_length_313_cov_1.934579	160	240	66	19	80	0.2375000
NODE_151576_length_313_cov_1.780374	236	296	0	60	60	1.0000000
NODE_151623_length_313_cov_1.663551	58	135	1	15	77	0.1948052
NODE_151623_length_313_cov_1.663551	58	135	2	9	77	0.1168831
NODE_151623_length_313_cov_1.663551	58	135	4	53	77	0.6883117
NODE_151703_length_313_cov_1.439252	0	64	0	64	64	1.0000000
NODE_151703_length_313_cov_1.439252	37	82	0	45	45	1.0000000
NODE_151753_length_313_cov_1.429907	74	111	2	2	37	0.0540541
NODE_151753_length_313_cov_1.429907	74	111	4	25	37	0.6756757
NODE_151753_length_313_cov_1.429907	74	111	6	10	37	0.2702703
NODE_151753_length_313_cov_1.429907	109	172	2	16	63	0.2539683
NODE_151753_length_313_cov_1.429907	109	172	4	47	63	0.7460318
NODE_151953_length_313_cov_1.172897	106	161	0	55	55	1.0000000
NODE_151953_length_313_cov_1.172897	149	214	0	32	65	0.4923077
NODE_151953_length_313_cov_1.172897	149	214	4	6	65	0.0923077
NODE_151953_length_313_cov_1.172897	149	214	8	13	65	0.2000000
NODE_151953_length_313_cov_1.172897	149	214	10	8	65	0.1230769
NODE_151953_length_313_cov_1.172897	149	214	12	6	65	0.0923077
NODE_152525_length_312_cov_3.723005	178	238	4	46	60	0.7666667
NODE_152525_length_312_cov_3.723005	178	238	6	14	60	0.2333333
NODE_152525_length_312_cov_3.723005	231	291	0	21	60	0.3500000
NODE_152525_length_312_cov_3.723005	231	291	2	31	60	0.5166667
NODE_152525_length_312_cov_3.723005	231	291	4	8	60	0.1333333
NODE_152609_length_312_cov_2.723005	34	96	0	1	62	0.0161290
NODE_152609_length_312_cov_2.723005	34	96	2	61	62	0.9838710
NODE_152609_length_312_cov_2.723005	87	149	0	54	62	0.8709677
NODE_152609_length_312_cov_2.723005	87	149	2	8	62	0.1290323
NODE_152680_length_312_cov_2.333333	6	70	0	64	64	1.0000000
NODE_152680_length_312_cov_2.333333	43	123	0	80	80	1.0000000
NODE_152686_length_312_cov_2.267606	176	208	0	32	32	1.0000000
NODE_152697_length_312_cov_2.234742	108	169	2	60	61	0.9836066
NODE_152697_length_312_cov_2.234742	108	169	4	1	61	0.0163934
NODE_152751_length_312_cov_2.014085	141	205	2	64	64	1.0000000
NODE_152751_length_312_cov_2.014085	178	258	2	80	80	1.0000000
NODE_152827_length_312_cov_1.835681	176	221	0	45	45	1.0000000
NODE_152827_length_312_cov_1.835681	194	269	0	75	75	1.0000000
NODE_153222_length_312_cov_1.173709	87	133	0	6	46	0.1304348
NODE_153222_length_312_cov_1.173709	87	133	2	5	46	0.1086956
NODE_153222_length_312_cov_1.173709	87	133	4	4	46	0.0869565
NODE_153222_length_312_cov_1.173709	87	133	6	2	46	0.0434783
NODE_153222_length_312_cov_1.173709	87	133	7	29	46	0.6304348
NODE_153222_length_312_cov_1.173709	150	217	26	1	67	0.0149254
NODE_153222_length_312_cov_1.173709	150	217	28	23	67	0.3432836
NODE_153222_length_312_cov_1.173709	150	217	30	10	67	0.1492537
NODE_153222_length_312_cov_1.173709	150	217	32	1	67	0.0149254
NODE_153222_length_312_cov_1.173709	150	217	34	3	67	0.0447761
NODE_153222_length_312_cov_1.173709	150	217	36	12	67	0.1791045
NODE_153222_length_312_cov_1.173709	150	217	38	8	67	0.1194030
NODE_153222_length_312_cov_1.173709	150	217	40	4	67	0.0597015
NODE_153222_length_312_cov_1.173709	150	217	42	4	67	0.0597015
NODE_153222_length_312_cov_1.173709	150	217	44	1	67	0.0149254
NODE_153532_length_312_cov_0.788732	49	110	0	61	61	1.0000000
NODE_153532_length_312_cov_0.788732	102	163	0	61	61	1.0000000
NODE_153708_length_311_cov_5.179245	155	235	0	80	80	1.0000000
NODE_153721_length_311_cov_4.589623	133	200	0	67	67	1.0000000
NODE_153730_length_311_cov_4.358491	199	263	0	64	64	1.0000000
NODE_153743_length_311_cov_3.929245	91	127	0	36	36	1.0000000
NODE_153755_length_311_cov_3.825472	224	304	0	37	80	0.4625000
NODE_153755_length_311_cov_3.825472	224	304	2	5	80	0.0625000
NODE_153755_length_311_cov_3.825472	224	304	4	9	80	0.1125000
NODE_153755_length_311_cov_3.825472	224	304	6	22	80	0.2750000
NODE_153755_length_311_cov_3.825472	224	304	7	2	80	0.0250000
NODE_153755_length_311_cov_3.825472	224	304	8	5	80	0.0625000
NODE_153773_length_311_cov_3.466981	106	186	0	14	80	0.1750000
NODE_153773_length_311_cov_3.466981	106	186	2	55	80	0.6875000
NODE_153773_length_311_cov_3.466981	106	186	4	11	80	0.1375000
NODE_153796_length_311_cov_3.188679	39	96	0	57	57	1.0000000
NODE_153846_length_311_cov_2.702830	144	193	2	49	49	1.0000000
NODE_153850_length_311_cov_2.665094	43	113	2	70	70	1.0000000
NODE_153859_length_311_cov_2.617925	206	284	0	78	78	1.0000000
NODE_153859_length_311_cov_2.617925	257	301	0	44	44	1.0000000
NODE_153913_length_311_cov_2.349057	177	204	0	27	27	1.0000000
NODE_153919_length_311_cov_2.325472	74	138	0	64	64	1.0000000
NODE_153947_length_311_cov_2.188679	21	92	0	71	71	1.0000000
NODE_154014_length_311_cov_1.924528	46	65	0	19	19	1.0000000
NODE_154056_length_311_cov_1.891509	122	180	2	23	58	0.3965517
NODE_154056_length_311_cov_1.891509	122	180	4	35	58	0.6034483
NODE_154188_length_311_cov_1.594340	0	35	0	35	35	1.0000000
NODE_154190_length_311_cov_1.589623	96	151	1	22	55	0.4000000
NODE_154190_length_311_cov_1.589623	96	151	3	28	55	0.5090909
NODE_154190_length_311_cov_1.589623	96	151	5	5	55	0.0909091
NODE_154194_length_311_cov_1.570755	125	145	0	20	20	1.0000000
NODE_154957_length_311_cov_0.613208	136	216	0	80	80	1.0000000
NODE_154957_length_311_cov_0.613208	189	264	0	75	75	1.0000000
NODE_154996_length_310_cov_96.995261	211	249	66	3	38	0.0789474
NODE_154996_length_310_cov_96.995261	211	249	70	1	38	0.0263158
NODE_154996_length_310_cov_96.995261	211	249	72	1	38	0.0263158
NODE_154996_length_310_cov_96.995261	211	249	76	3	38	0.0789474
NODE_154996_length_310_cov_96.995261	211	249	80	1	38	0.0263158
NODE_154996_length_310_cov_96.995261	211	249	82	18	38	0.4736842
NODE_154996_length_310_cov_96.995261	211	249	84	2	38	0.0526316
NODE_154996_length_310_cov_96.995261	211	249	86	1	38	0.0263158
NODE_154996_length_310_cov_96.995261	211	249	88	1	38	0.0263158
NODE_154996_length_310_cov_96.995261	211	249	94	2	38	0.0526316
NODE_154996_length_310_cov_96.995261	211	249	98	4	38	0.1052632
NODE_154996_length_310_cov_96.995261	211	249	100	1	38	0.0263158
NODE_155001_length_310_cov_7.767773	80	151	0	7	71	0.0985916
NODE_155001_length_310_cov_7.767773	80	151	2	64	71	0.9014084
NODE_155001_length_310_cov_7.767773	134	189	0	33	55	0.6000000
NODE_155001_length_310_cov_7.767773	134	189	2	22	55	0.4000000
NODE_155017_length_310_cov_5.914692	84	134	0	50	50	1.0000000
NODE_155017_length_310_cov_5.914692	113	134	0	21	21	1.0000000
NODE_155017_length_310_cov_5.914692	113	188	0	75	75	1.0000000
NODE_155066_length_310_cov_3.777251	146	226	2	7	80	0.0875000
NODE_155066_length_310_cov_3.777251	146	226	4	53	80	0.6625000
NODE_155066_length_310_cov_3.777251	146	226	6	20	80	0.2500000
NODE_155115_length_310_cov_3.180095	137	211	0	39	74	0.5270270
NODE_155115_length_310_cov_3.180095	137	211	1	5	74	0.0675676
NODE_155115_length_310_cov_3.180095	137	211	4	20	74	0.2702703
NODE_155115_length_310_cov_3.180095	137	211	6	4	74	0.0540541
NODE_155115_length_310_cov_3.180095	137	211	8	2	74	0.0270270
NODE_155115_length_310_cov_3.180095	137	211	9	4	74	0.0540541
NODE_155179_length_310_cov_2.630332	122	174	0	52	52	1.0000000
NODE_155179_length_310_cov_2.630332	175	222	0	47	47	1.0000000
NODE_155180_length_310_cov_2.625592	258	301	0	43	43	1.0000000
NODE_155195_length_310_cov_2.563981	149	196	4	1	47	0.0212766
NODE_155195_length_310_cov_2.563981	149	196	5	1	47	0.0212766
NODE_155195_length_310_cov_2.563981	149	196	6	12	47	0.2553191
NODE_155195_length_310_cov_2.563981	149	196	8	8	47	0.1702128
NODE_155195_length_310_cov_2.563981	149	196	10	8	47	0.1702128
NODE_155195_length_310_cov_2.563981	149	196	11	4	47	0.0851064
NODE_155195_length_310_cov_2.563981	149	196	13	7	47	0.1489362
NODE_155195_length_310_cov_2.563981	149	196	15	6	47	0.1276596
NODE_155195_length_310_cov_2.563981	169	249	2	50	80	0.6250000
NODE_155195_length_310_cov_2.563981	169	249	4	4	80	0.0500000
NODE_155195_length_310_cov_2.563981	169	249	5	1	80	0.0125000
NODE_155195_length_310_cov_2.563981	169	249	6	12	80	0.1500000
NODE_155195_length_310_cov_2.563981	169	249	8	8	80	0.1000000
NODE_155195_length_310_cov_2.563981	169	249	10	5	80	0.0625000
NODE_155261_length_310_cov_2.298578	213	259	0	1	46	0.0217391
NODE_155261_length_310_cov_2.298578	213	259	2	45	46	0.9782609
NODE_155334_length_310_cov_2.009479	223	303	0	8	80	0.1000000
NODE_155334_length_310_cov_2.009479	223	303	2	55	80	0.6875000
NODE_155334_length_310_cov_2.009479	223	303	4	1	80	0.0125000
NODE_155334_length_310_cov_2.009479	223	303	6	14	80	0.1750000
NODE_155334_length_310_cov_2.009479	223	303	10	2	80	0.0250000
NODE_155439_length_310_cov_1.729858	53	91	0	38	38	1.0000000
NODE_155768_length_310_cov_1.222749	181	244	4	63	63	1.0000000
NODE_155864_length_310_cov_1.142180	65	135	3	1	70	0.0142857
NODE_155864_length_310_cov_1.142180	65	135	5	2	70	0.0285714
NODE_155864_length_310_cov_1.142180	65	135	6	2	70	0.0285714
NODE_155864_length_310_cov_1.142180	65	135	8	3	70	0.0428571
NODE_155864_length_310_cov_1.142180	65	135	10	1	70	0.0142857
NODE_155864_length_310_cov_1.142180	65	135	12	2	70	0.0285714
NODE_155864_length_310_cov_1.142180	65	135	16	13	70	0.1857143
NODE_155864_length_310_cov_1.142180	65	135	18	3	70	0.0428571
NODE_155864_length_310_cov_1.142180	65	135	20	43	70	0.6142857
NODE_155937_length_310_cov_0.966825	131	212	0	81	81	1.0000000
NODE_155937_length_310_cov_0.966825	193	256	0	63	63	1.0000000
NODE_156078_length_310_cov_0.924171	180	222	2	42	42	1.0000000
NODE_156174_length_310_cov_0.739336	208	288	0	80	80	1.0000000
NODE_156332_length_309_cov_8.552381	154	234	0	29	80	0.3625000
NODE_156332_length_309_cov_8.552381	154	234	2	51	80	0.6375000
NODE_156340_length_309_cov_6.147619	20	83	0	63	63	1.0000000
NODE_156349_length_309_cov_5.147619	213	291	0	78	78	1.0000000
NODE_156364_length_309_cov_4.585714	15	95	0	80	80	1.0000000
NODE_156472_length_309_cov_3.028571	0	47	0	47	47	1.0000000
NODE_156472_length_309_cov_3.028571	20	101	0	81	81	1.0000000
NODE_156563_length_309_cov_2.304762	179	218	2	18	39	0.4615385
NODE_156563_length_309_cov_2.304762	179	218	3	1	39	0.0256410
NODE_156563_length_309_cov_2.304762	179	218	4	10	39	0.2564103
NODE_156563_length_309_cov_2.304762	179	218	6	1	39	0.0256410
NODE_156563_length_309_cov_2.304762	179	218	7	9	39	0.2307692
NODE_156615_length_309_cov_2.095238	55	85	0	30	30	1.0000000
NODE_156678_length_309_cov_1.938095	2	73	0	71	71	1.0000000
NODE_156950_length_309_cov_1.414286	189	231	0	42	42	1.0000000
NODE_156978_length_309_cov_1.376190	94	168	0	74	74	1.0000000
NODE_157334_length_309_cov_0.966667	134	153	0	19	19	1.0000000
NODE_157469_length_309_cov_0.738095	150	215	16	4	65	0.0615385
NODE_157469_length_309_cov_0.738095	150	215	18	26	65	0.4000000
NODE_157469_length_309_cov_0.738095	150	215	20	6	65	0.0923077
NODE_157469_length_309_cov_0.738095	150	215	22	1	65	0.0153846
NODE_157469_length_309_cov_0.738095	150	215	24	23	65	0.3538462
NODE_157469_length_309_cov_0.738095	150	215	26	5	65	0.0769231
NODE_157661_length_308_cov_4.775120	137	174	0	10	37	0.2702703
NODE_157661_length_308_cov_4.775120	137	174	4	27	37	0.7297297
NODE_157690_length_308_cov_3.966507	126	206	0	48	80	0.6000000
NODE_157690_length_308_cov_3.966507	126	206	2	3	80	0.0375000
NODE_157690_length_308_cov_3.966507	126	206	4	7	80	0.0875000
NODE_157690_length_308_cov_3.966507	126	206	8	9	80	0.1125000
NODE_157690_length_308_cov_3.966507	126	206	10	13	80	0.1625000
NODE_157705_length_308_cov_3.665072	11	75	0	64	64	1.0000000
NODE_157819_length_308_cov_2.593301	137	193	0	56	56	1.0000000
NODE_157852_length_308_cov_2.435407	14	58	0	44	44	1.0000000
NODE_157852_length_308_cov_2.435407	31	111	0	80	80	1.0000000
NODE_157898_length_308_cov_2.191388	14	80	0	66	66	1.0000000
NODE_157903_length_308_cov_2.191388	236	296	0	60	60	1.0000000
NODE_157969_length_308_cov_1.952153	251	296	0	45	45	1.0000000
NODE_158083_length_308_cov_1.708134	102	148	2	4	46	0.0869565
NODE_158083_length_308_cov_1.708134	102	148	4	42	46	0.9130435
NODE_158276_length_308_cov_1.435407	196	276	0	80	80	1.0000000
NODE_158439_length_308_cov_1.162679	260	300	0	40	40	1.0000000
NODE_158439_length_308_cov_1.162679	273	307	0	34	34	1.0000000
NODE_158447_length_308_cov_1.148325	35	83	0	40	48	0.8333333
NODE_158447_length_308_cov_1.148325	35	83	2	8	48	0.1666667
NODE_158448_length_308_cov_1.148325	253	308	0	26	55	0.4727273
NODE_158448_length_308_cov_1.148325	253	308	2	29	55	0.5272727
NODE_158510_length_308_cov_1.038278	147	202	0	55	55	1.0000000
NODE_158811_length_308_cov_0.684211	196	275	0	79	79	1.0000000
NODE_158821_length_308_cov_0.660287	109	157	0	2	48	0.0416667
NODE_158821_length_308_cov_0.660287	109	157	2	19	48	0.3958333
NODE_158821_length_308_cov_0.660287	109	157	8	3	48	0.0625000
NODE_158821_length_308_cov_0.660287	109	157	13	1	48	0.0208333
NODE_158821_length_308_cov_0.660287	109	157	15	1	48	0.0208333
NODE_158821_length_308_cov_0.660287	109	157	17	1	48	0.0208333
NODE_158821_length_308_cov_0.660287	109	157	18	12	48	0.2500000
NODE_158821_length_308_cov_0.660287	109	157	22	9	48	0.1875000
NODE_158821_length_308_cov_0.660287	130	210	8	3	80	0.0375000
NODE_158821_length_308_cov_0.660287	130	210	13	1	80	0.0125000
NODE_158821_length_308_cov_0.660287	130	210	15	1	80	0.0125000
NODE_158821_length_308_cov_0.660287	130	210	17	1	80	0.0125000
NODE_158821_length_308_cov_0.660287	130	210	18	12	80	0.1500000
NODE_158821_length_308_cov_0.660287	130	210	22	62	80	0.7750000
NODE_158905_length_307_cov_30.725962	0	73	0	33	73	0.4520548
NODE_158905_length_307_cov_30.725962	0	73	2	26	73	0.3561644
NODE_158905_length_307_cov_30.725962	0	73	4	14	73	0.1917808
NODE_158905_length_307_cov_30.725962	46	99	2	13	53	0.2452830
NODE_158905_length_307_cov_30.725962	46	99	4	40	53	0.7547170
NODE_158906_length_307_cov_25.096154	84	164	0	45	80	0.5625000
NODE_158906_length_307_cov_25.096154	84	164	2	35	80	0.4375000
NODE_158906_length_307_cov_25.096154	137	217	0	15	80	0.1875000
NODE_158906_length_307_cov_25.096154	137	217	2	65	80	0.8125000
NODE_158933_length_307_cov_5.524038	150	221	0	71	71	1.0000000
NODE_158983_length_307_cov_3.730769	172	252	0	80	80	1.0000000
NODE_158983_length_307_cov_3.730769	225	305	0	80	80	1.0000000
NODE_158999_length_307_cov_3.322115	20	100	0	80	80	1.0000000
NODE_158999_length_307_cov_3.322115	78	153	0	75	75	1.0000000
NODE_159000_length_307_cov_3.317308	12	94	0	14	82	0.1707317
NODE_159000_length_307_cov_3.317308	12	94	2	68	82	0.8292683
NODE_159000_length_307_cov_3.317308	76	134	0	19	58	0.3275862
NODE_159000_length_307_cov_3.317308	76	134	2	39	58	0.6724138
NODE_159053_length_307_cov_2.870192	43	108	0	65	65	1.0000000
NODE_159084_length_307_cov_2.653846	117	177	20	2	60	0.0333333
NODE_159084_length_307_cov_2.653846	117	177	22	5	60	0.0833333
NODE_159084_length_307_cov_2.653846	117	177	24	16	60	0.2666667
NODE_159084_length_307_cov_2.653846	117	177	26	21	60	0.3500000
NODE_159084_length_307_cov_2.653846	117	177	28	8	60	0.1333333
NODE_159084_length_307_cov_2.653846	117	177	30	8	60	0.1333333
NODE_159142_length_307_cov_2.346154	54	105	0	51	51	1.0000000
NODE_159351_length_307_cov_1.716346	124	165	4	41	41	1.0000000
NODE_159362_length_307_cov_1.716346	30	93	2	44	63	0.6984127
NODE_159362_length_307_cov_1.716346	30	93	4	19	63	0.3015873
NODE_159407_length_307_cov_1.600962	221	269	2	48	48	1.0000000
NODE_159407_length_307_cov_1.600962	242	307	0	5	65	0.0769231
NODE_159407_length_307_cov_1.600962	242	307	2	60	65	0.9230769
NODE_159447_length_307_cov_1.475962	252	307	4	55	55	1.0000000
NODE_159585_length_307_cov_1.326923	96	142	0	3	46	0.0652174
NODE_159585_length_307_cov_1.326923	96	142	2	7	46	0.1521739
NODE_159585_length_307_cov_1.326923	96	142	3	12	46	0.2608696
NODE_159585_length_307_cov_1.326923	96	142	4	9	46	0.1956522
NODE_159585_length_307_cov_1.326923	96	142	6	10	46	0.2173913
NODE_159585_length_307_cov_1.326923	96	142	8	5	46	0.1086956
NODE_159585_length_307_cov_1.326923	115	195	3	3	80	0.0375000
NODE_159585_length_307_cov_1.326923	115	195	4	9	80	0.1125000
NODE_159585_length_307_cov_1.326923	115	195	6	10	80	0.1250000
NODE_159585_length_307_cov_1.326923	115	195	8	49	80	0.6125000
NODE_159585_length_307_cov_1.326923	115	195	10	9	80	0.1125000
NODE_159618_length_307_cov_1.264423	13	61	0	48	48	1.0000000
NODE_159618_length_307_cov_1.264423	23	54	0	31	31	1.0000000
NODE_159696_length_307_cov_1.197115	92	121	0	17	29	0.5862069
NODE_159696_length_307_cov_1.197115	92	121	2	12	29	0.4137931
NODE_159787_length_307_cov_1.000000	132	168	0	36	36	1.0000000
NODE_160213_length_306_cov_74.526570	68	136	0	24	68	0.3529412
NODE_160213_length_306_cov_74.526570	68	136	2	44	68	0.6470588
NODE_160213_length_306_cov_74.526570	68	148	0	32	80	0.4000000
NODE_160213_length_306_cov_74.526570	68	148	2	48	80	0.6000000
NODE_160213_length_306_cov_74.526570	121	201	0	23	80	0.2875000
NODE_160213_length_306_cov_74.526570	121	201	2	18	80	0.2250000
NODE_160213_length_306_cov_74.526570	121	201	4	11	80	0.1375000
NODE_160213_length_306_cov_74.526570	121	201	6	27	80	0.3375000
NODE_160213_length_306_cov_74.526570	121	201	8	1	80	0.0125000
NODE_160213_length_306_cov_74.526570	121	201	0	23	80	0.2875000
NODE_160213_length_306_cov_74.526570	121	201	2	18	80	0.2250000
NODE_160213_length_306_cov_74.526570	121	201	4	11	80	0.1375000
NODE_160213_length_306_cov_74.526570	121	201	6	27	80	0.3375000
NODE_160213_length_306_cov_74.526570	121	201	8	1	80	0.0125000
NODE_160213_length_306_cov_74.526570	197	277	2	5	80	0.0625000
NODE_160213_length_306_cov_74.526570	197	277	4	3	80	0.0375000
NODE_160213_length_306_cov_74.526570	197	277	6	11	80	0.1375000
NODE_160213_length_306_cov_74.526570	197	277	8	61	80	0.7625000
NODE_160213_length_306_cov_74.526570	197	277	2	5	80	0.0625000
NODE_160213_length_306_cov_74.526570	197	277	4	3	80	0.0375000
NODE_160213_length_306_cov_74.526570	197	277	6	11	80	0.1375000
NODE_160213_length_306_cov_74.526570	197	277	8	61	80	0.7625000
NODE_160213_length_306_cov_74.526570	197	277	2	5	80	0.0625000
NODE_160213_length_306_cov_74.526570	197	277	4	3	80	0.0375000
NODE_160213_length_306_cov_74.526570	197	277	6	11	80	0.1375000
NODE_160213_length_306_cov_74.526570	197	277	8	61	80	0.7625000
NODE_160213_length_306_cov_74.526570	250	299	0	20	49	0.4081633
NODE_160213_length_306_cov_74.526570	250	299	2	7	49	0.1428571
NODE_160213_length_306_cov_74.526570	250	299	4	3	49	0.0612245
NODE_160213_length_306_cov_74.526570	250	299	6	8	49	0.1632653
NODE_160213_length_306_cov_74.526570	250	299	8	11	49	0.2244898
NODE_160213_length_306_cov_74.526570	250	306	0	27	56	0.4821429
NODE_160213_length_306_cov_74.526570	250	306	2	7	56	0.1250000
NODE_160213_length_306_cov_74.526570	250	306	4	3	56	0.0535714
NODE_160213_length_306_cov_74.526570	250	306	6	8	56	0.1428571
NODE_160213_length_306_cov_74.526570	250	306	8	11	56	0.1964286
NODE_160213_length_306_cov_74.526570	255	306	0	27	51	0.5294118
NODE_160213_length_306_cov_74.526570	255	306	2	7	51	0.1372549
NODE_160213_length_306_cov_74.526570	255	306	4	3	51	0.0588235
NODE_160213_length_306_cov_74.526570	255	306	6	8	51	0.1568628
NODE_160213_length_306_cov_74.526570	255	306	8	6	51	0.1176471
NODE_160217_length_306_cov_7.396135	23	117	0	94	94	1.0000000
NODE_160217_length_306_cov_7.396135	90	170	0	80	80	1.0000000
NODE_160261_length_306_cov_4.275362	67	147	1	6	80	0.0750000
NODE_160261_length_306_cov_4.275362	67	147	2	74	80	0.9250000
NODE_160275_length_306_cov_3.937198	104	176	0	72	72	1.0000000
NODE_160300_length_306_cov_3.444444	130	206	0	76	76	1.0000000
NODE_160323_length_306_cov_3.217391	198	278	0	4	80	0.0500000
NODE_160323_length_306_cov_3.217391	198	278	2	33	80	0.4125000
NODE_160323_length_306_cov_3.217391	198	278	6	13	80	0.1625000
NODE_160323_length_306_cov_3.217391	198	278	8	2	80	0.0250000
NODE_160323_length_306_cov_3.217391	198	278	10	28	80	0.3500000
NODE_160333_length_306_cov_3.043478	90	171	0	16	81	0.1975309
NODE_160333_length_306_cov_3.043478	90	171	2	4	81	0.0493827
NODE_160333_length_306_cov_3.043478	90	171	4	16	81	0.1975309
NODE_160333_length_306_cov_3.043478	90	171	6	45	81	0.5555556
NODE_160333_length_306_cov_3.043478	144	202	0	8	58	0.1379310
NODE_160333_length_306_cov_3.043478	144	202	2	8	58	0.1379310
NODE_160333_length_306_cov_3.043478	144	202	4	12	58	0.2068966
NODE_160333_length_306_cov_3.043478	144	202	6	30	58	0.5172414
NODE_160340_length_306_cov_2.956522	242	273	0	31	31	1.0000000
NODE_160355_length_306_cov_2.884058	173	243	0	16	70	0.2285714
NODE_160355_length_306_cov_2.884058	173	243	2	54	70	0.7714286
NODE_160403_length_306_cov_2.574879	122	203	2	21	81	0.2592593
NODE_160403_length_306_cov_2.574879	122	203	4	60	81	0.7407407
NODE_160403_length_306_cov_2.574879	176	254	0	32	78	0.4102564
NODE_160403_length_306_cov_2.574879	176	254	2	40	78	0.5128205
NODE_160403_length_306_cov_2.574879	176	254	4	6	78	0.0769231
NODE_160475_length_306_cov_2.265700	223	278	6	16	55	0.2909091
NODE_160475_length_306_cov_2.265700	223	278	8	16	55	0.2909091
NODE_160475_length_306_cov_2.265700	223	278	10	23	55	0.4181818
NODE_160512_length_306_cov_2.106280	73	149	2	76	76	1.0000000
NODE_160512_length_306_cov_2.106280	125	205	0	5	80	0.0625000
NODE_160512_length_306_cov_2.106280	125	205	2	75	80	0.9375000
NODE_160608_length_306_cov_1.879227	165	196	6	31	31	1.0000000
NODE_160752_length_306_cov_1.478261	206	237	2	31	31	1.0000000
NODE_160761_length_306_cov_1.478261	157	220	0	63	63	1.0000000
NODE_160833_length_306_cov_1.434783	40	88	0	48	48	1.0000000
NODE_160875_length_306_cov_1.357488	128	171	0	6	43	0.1395349
NODE_160875_length_306_cov_1.357488	128	171	2	8	43	0.1860465
NODE_160875_length_306_cov_1.357488	128	171	4	29	43	0.6744186
NODE_160992_length_306_cov_1.222222	216	252	0	36	36	1.0000000
NODE_160992_length_306_cov_1.222222	230	305	0	75	75	1.0000000
NODE_161018_length_306_cov_1.188406	79	159	0	76	80	0.9500000
NODE_161018_length_306_cov_1.188406	79	159	2	4	80	0.0500000
NODE_161042_length_306_cov_1.130435	122	202	0	80	80	1.0000000
NODE_161042_length_306_cov_1.130435	175	255	0	80	80	1.0000000
NODE_161078_length_306_cov_1.067633	156	188	0	32	32	1.0000000
NODE_161234_length_306_cov_0.975845	219	247	0	28	28	1.0000000
NODE_161246_length_306_cov_0.956522	206	284	0	78	78	1.0000000
NODE_161550_length_305_cov_5.718447	177	243	0	66	66	1.0000000
NODE_161566_length_305_cov_4.854369	55	135	2	80	80	1.0000000
NODE_161584_length_305_cov_4.266990	186	266	0	31	80	0.3875000
NODE_161584_length_305_cov_4.266990	186	266	2	8	80	0.1000000
NODE_161584_length_305_cov_4.266990	186	266	4	13	80	0.1625000
NODE_161584_length_305_cov_4.266990	186	266	6	27	80	0.3375000
NODE_161584_length_305_cov_4.266990	186	266	7	1	80	0.0125000
NODE_161723_length_305_cov_2.616505	220	263	0	43	43	1.0000000
NODE_161723_length_305_cov_2.616505	236	305	0	69	69	1.0000000
NODE_161726_length_305_cov_2.597087	171	256	69	2	85	0.0235294
NODE_161726_length_305_cov_2.597087	171	256	71	6	85	0.0705882
NODE_161726_length_305_cov_2.597087	171	256	73	1	85	0.0117647
NODE_161726_length_305_cov_2.597087	171	256	75	1	85	0.0117647
NODE_161726_length_305_cov_2.597087	171	256	77	3	85	0.0352941
NODE_161726_length_305_cov_2.597087	171	256	80	3	85	0.0352941
NODE_161726_length_305_cov_2.597087	171	256	84	2	85	0.0235294
NODE_161726_length_305_cov_2.597087	171	256	92	2	85	0.0235294
NODE_161726_length_305_cov_2.597087	171	256	98	1	85	0.0117647
NODE_161726_length_305_cov_2.597087	171	256	100	1	85	0.0117647
NODE_161726_length_305_cov_2.597087	171	256	112	1	85	0.0117647
NODE_161726_length_305_cov_2.597087	171	256	114	2	85	0.0235294
NODE_161726_length_305_cov_2.597087	171	256	121	2	85	0.0235294
NODE_161726_length_305_cov_2.597087	171	256	126	1	85	0.0117647
NODE_161726_length_305_cov_2.597087	171	256	127	1	85	0.0117647
NODE_161726_length_305_cov_2.597087	171	256	130	2	85	0.0235294
NODE_161726_length_305_cov_2.597087	171	256	132	1	85	0.0117647
NODE_161726_length_305_cov_2.597087	171	256	152	1	85	0.0117647
NODE_161726_length_305_cov_2.597087	171	256	156	1	85	0.0117647
NODE_161726_length_305_cov_2.597087	171	256	158	1	85	0.0117647
NODE_161726_length_305_cov_2.597087	171	256	160	2	85	0.0235294
NODE_161726_length_305_cov_2.597087	171	256	168	2	85	0.0235294
NODE_161726_length_305_cov_2.597087	171	256	172	1	85	0.0117647
NODE_161726_length_305_cov_2.597087	171	256	178	1	85	0.0117647
NODE_161726_length_305_cov_2.597087	171	256	184	1	85	0.0117647
NODE_161726_length_305_cov_2.597087	171	256	186	1	85	0.0117647
NODE_161726_length_305_cov_2.597087	171	256	189	1	85	0.0117647
NODE_161726_length_305_cov_2.597087	171	256	195	1	85	0.0117647
NODE_161726_length_305_cov_2.597087	171	256	197	1	85	0.0117647
NODE_161726_length_305_cov_2.597087	171	256	209	1	85	0.0117647
NODE_161726_length_305_cov_2.597087	171	256	217	2	85	0.0235294
NODE_161726_length_305_cov_2.597087	171	256	223	1	85	0.0117647
NODE_161726_length_305_cov_2.597087	171	256	226	14	85	0.1647059
NODE_161726_length_305_cov_2.597087	171	256	227	3	85	0.0352941
NODE_161726_length_305_cov_2.597087	171	256	231	8	85	0.0941176
NODE_161726_length_305_cov_2.597087	171	256	233	1	85	0.0117647
NODE_161726_length_305_cov_2.597087	171	256	234	7	85	0.0823529
NODE_161726_length_305_cov_2.597087	171	256	236	2	85	0.0235294
NODE_161732_length_305_cov_2.533981	3	57	2	54	54	1.0000000
NODE_161775_length_305_cov_2.339806	149	237	12	46	88	0.5227273
NODE_161775_length_305_cov_2.339806	149	237	14	42	88	0.4772727
NODE_161795_length_305_cov_2.228155	194	274	0	80	80	1.0000000
NODE_161795_length_305_cov_2.228155	247	300	0	53	53	1.0000000
NODE_161877_length_305_cov_1.975728	44	116	2	44	72	0.6111111
NODE_161877_length_305_cov_1.975728	44	116	4	28	72	0.3888889
NODE_161908_length_305_cov_1.883495	135	172	35	3	37	0.0810811
NODE_161908_length_305_cov_1.883495	135	172	39	4	37	0.1081081
NODE_161908_length_305_cov_1.883495	135	172	43	4	37	0.1081081
NODE_161908_length_305_cov_1.883495	135	172	45	2	37	0.0540541
NODE_161908_length_305_cov_1.883495	135	172	47	4	37	0.1081081
NODE_161908_length_305_cov_1.883495	135	172	51	1	37	0.0270270
NODE_161908_length_305_cov_1.883495	135	172	53	1	37	0.0270270
NODE_161908_length_305_cov_1.883495	135	172	57	5	37	0.1351351
NODE_161908_length_305_cov_1.883495	135	172	62	2	37	0.0540541
NODE_161908_length_305_cov_1.883495	135	172	63	2	37	0.0540541
NODE_161908_length_305_cov_1.883495	135	172	64	1	37	0.0270270
NODE_161908_length_305_cov_1.883495	135	172	66	3	37	0.0810811
NODE_161908_length_305_cov_1.883495	135	172	68	1	37	0.0270270
NODE_161908_length_305_cov_1.883495	135	172	70	2	37	0.0540541
NODE_161908_length_305_cov_1.883495	135	172	72	2	37	0.0540541
NODE_161990_length_305_cov_1.674757	14	80	0	4	66	0.0606061
NODE_161990_length_305_cov_1.674757	14	80	2	62	66	0.9393939
NODE_161990_length_305_cov_1.674757	53	133	0	56	80	0.7000000
NODE_161990_length_305_cov_1.674757	53	133	2	24	80	0.3000000
NODE_161996_length_305_cov_1.655340	110	179	6	5	69	0.0724638
NODE_161996_length_305_cov_1.655340	110	179	8	2	69	0.0289855
NODE_161996_length_305_cov_1.655340	110	179	10	15	69	0.2173913
NODE_161996_length_305_cov_1.655340	110	179	12	5	69	0.0724638
NODE_161996_length_305_cov_1.655340	110	179	14	42	69	0.6086956
NODE_162123_length_305_cov_1.466019	153	238	2	7	85	0.0823529
NODE_162123_length_305_cov_1.466019	153	238	6	22	85	0.2588235
NODE_162123_length_305_cov_1.466019	153	238	8	3	85	0.0352941
NODE_162123_length_305_cov_1.466019	153	238	10	2	85	0.0235294
NODE_162123_length_305_cov_1.466019	153	238	12	1	85	0.0117647
NODE_162123_length_305_cov_1.466019	153	238	15	1	85	0.0117647
NODE_162123_length_305_cov_1.466019	153	238	16	16	85	0.1882353
NODE_162123_length_305_cov_1.466019	153	238	18	17	85	0.2000000
NODE_162123_length_305_cov_1.466019	153	238	22	2	85	0.0235294
NODE_162123_length_305_cov_1.466019	153	238	26	4	85	0.0470588
NODE_162123_length_305_cov_1.466019	153	238	28	10	85	0.1176471
NODE_162123_length_305_cov_1.466019	222	284	22	2	62	0.0322581
NODE_162123_length_305_cov_1.466019	222	284	26	4	62	0.0645161
NODE_162123_length_305_cov_1.466019	222	284	28	18	62	0.2903226
NODE_162123_length_305_cov_1.466019	222	284	30	2	62	0.0322581
NODE_162123_length_305_cov_1.466019	222	284	32	21	62	0.3387097
NODE_162123_length_305_cov_1.466019	222	284	34	15	62	0.2419355
NODE_162169_length_305_cov_1.398058	28	75	0	47	47	1.0000000
NODE_162198_length_305_cov_1.330097	212	292	1	6	80	0.0750000
NODE_162198_length_305_cov_1.330097	212	292	3	3	80	0.0375000
NODE_162198_length_305_cov_1.330097	212	292	5	1	80	0.0125000
NODE_162198_length_305_cov_1.330097	212	292	8	2	80	0.0250000
NODE_162198_length_305_cov_1.330097	212	292	10	3	80	0.0375000
NODE_162198_length_305_cov_1.330097	212	292	16	1	80	0.0125000
NODE_162198_length_305_cov_1.330097	212	292	18	1	80	0.0125000
NODE_162198_length_305_cov_1.330097	212	292	22	5	80	0.0625000
NODE_162198_length_305_cov_1.330097	212	292	23	1	80	0.0125000
NODE_162198_length_305_cov_1.330097	212	292	25	1	80	0.0125000
NODE_162198_length_305_cov_1.330097	212	292	26	3	80	0.0375000
NODE_162198_length_305_cov_1.330097	212	292	28	1	80	0.0125000
NODE_162198_length_305_cov_1.330097	212	292	30	1	80	0.0125000
NODE_162198_length_305_cov_1.330097	212	292	34	4	80	0.0500000
NODE_162198_length_305_cov_1.330097	212	292	36	3	80	0.0375000
NODE_162198_length_305_cov_1.330097	212	292	38	1	80	0.0125000
NODE_162198_length_305_cov_1.330097	212	292	40	3	80	0.0375000
NODE_162198_length_305_cov_1.330097	212	292	42	2	80	0.0250000
NODE_162198_length_305_cov_1.330097	212	292	46	5	80	0.0625000
NODE_162198_length_305_cov_1.330097	212	292	48	1	80	0.0125000
NODE_162198_length_305_cov_1.330097	212	292	50	1	80	0.0125000
NODE_162198_length_305_cov_1.330097	212	292	54	2	80	0.0250000
NODE_162198_length_305_cov_1.330097	212	292	58	2	80	0.0250000
NODE_162198_length_305_cov_1.330097	212	292	62	2	80	0.0250000
NODE_162198_length_305_cov_1.330097	212	292	64	1	80	0.0125000
NODE_162198_length_305_cov_1.330097	212	292	66	1	80	0.0125000
NODE_162198_length_305_cov_1.330097	212	292	68	3	80	0.0375000
NODE_162198_length_305_cov_1.330097	212	292	70	5	80	0.0625000
NODE_162198_length_305_cov_1.330097	212	292	72	1	80	0.0125000
NODE_162198_length_305_cov_1.330097	212	292	74	5	80	0.0625000
NODE_162198_length_305_cov_1.330097	212	292	76	3	80	0.0375000
NODE_162198_length_305_cov_1.330097	212	292	78	2	80	0.0250000
NODE_162198_length_305_cov_1.330097	212	292	80	4	80	0.0500000
NODE_162198_length_305_cov_1.330097	265	305	0	8	40	0.2000000
NODE_162198_length_305_cov_1.330097	265	305	1	11	40	0.2750000
NODE_162198_length_305_cov_1.330097	265	305	3	3	40	0.0750000
NODE_162198_length_305_cov_1.330097	265	305	5	1	40	0.0250000
NODE_162198_length_305_cov_1.330097	265	305	8	2	40	0.0500000
NODE_162198_length_305_cov_1.330097	265	305	10	3	40	0.0750000
NODE_162198_length_305_cov_1.330097	265	305	16	1	40	0.0250000
NODE_162198_length_305_cov_1.330097	265	305	18	1	40	0.0250000
NODE_162198_length_305_cov_1.330097	265	305	22	5	40	0.1250000
NODE_162198_length_305_cov_1.330097	265	305	23	1	40	0.0250000
NODE_162198_length_305_cov_1.330097	265	305	25	1	40	0.0250000
NODE_162198_length_305_cov_1.330097	265	305	26	3	40	0.0750000
NODE_162359_length_305_cov_1.111650	245	275	0	30	30	1.0000000
NODE_162411_length_305_cov_0.990291	46	126	0	80	80	1.0000000
NODE_162593_length_305_cov_0.873786	73	109	0	36	36	1.0000000
NODE_162782_length_305_cov_0.631068	86	166	0	80	80	1.0000000
NODE_162782_length_305_cov_0.631068	139	186	0	47	47	1.0000000
NODE_162854_length_304_cov_44.482927	61	102	87	3	41	0.0731707
NODE_162854_length_304_cov_44.482927	61	102	89	5	41	0.1219512
NODE_162854_length_304_cov_44.482927	61	102	91	1	41	0.0243902
NODE_162854_length_304_cov_44.482927	61	102	93	5	41	0.1219512
NODE_162854_length_304_cov_44.482927	61	102	97	11	41	0.2682927
NODE_162854_length_304_cov_44.482927	61	102	98	2	41	0.0487805
NODE_162854_length_304_cov_44.482927	61	102	100	4	41	0.0975610
NODE_162854_length_304_cov_44.482927	61	102	104	4	41	0.0975610
NODE_162854_length_304_cov_44.482927	61	102	106	4	41	0.0975610
NODE_162854_length_304_cov_44.482927	61	102	108	2	41	0.0487805
NODE_162855_length_304_cov_30.678049	205	281	0	76	76	1.0000000
NODE_162855_length_304_cov_30.678049	254	304	0	50	50	1.0000000
NODE_162886_length_304_cov_4.956098	72	152	2	6	80	0.0750000
NODE_162886_length_304_cov_4.956098	72	152	4	74	80	0.9250000
NODE_162919_length_304_cov_3.980488	46	126	0	80	80	1.0000000
NODE_162919_length_304_cov_3.980488	99	179	0	80	80	1.0000000
NODE_162932_length_304_cov_3.809756	108	156	0	24	48	0.5000000
NODE_162932_length_304_cov_3.809756	108	156	2	24	48	0.5000000
NODE_162955_length_304_cov_3.424390	67	129	0	62	62	1.0000000
NODE_162955_length_304_cov_3.424390	120	182	0	56	62	0.9032258
NODE_162955_length_304_cov_3.424390	120	182	2	6	62	0.0967742
NODE_162997_length_304_cov_2.980488	105	126	2	21	21	1.0000000
NODE_163048_length_304_cov_2.629268	106	186	0	80	80	1.0000000
NODE_163048_length_304_cov_2.629268	159	209	0	50	50	1.0000000
NODE_163116_length_304_cov_2.239024	57	137	2	3	80	0.0375000
NODE_163116_length_304_cov_2.239024	57	137	6	77	80	0.9625000
NODE_163116_length_304_cov_2.239024	110	152	0	11	42	0.2619048
NODE_163116_length_304_cov_2.239024	110	152	1	1	42	0.0238095
NODE_163116_length_304_cov_2.239024	110	152	2	6	42	0.1428571
NODE_163116_length_304_cov_2.239024	110	152	6	24	42	0.5714286
NODE_163148_length_304_cov_2.170732	112	145	0	21	33	0.6363636
NODE_163148_length_304_cov_2.170732	112	145	1	2	33	0.0606061
NODE_163148_length_304_cov_2.170732	112	145	5	3	33	0.0909091
NODE_163148_length_304_cov_2.170732	112	145	7	6	33	0.1818182
NODE_163148_length_304_cov_2.170732	112	145	9	1	33	0.0303030
NODE_163148_length_304_cov_2.170732	146	198	9	52	52	1.0000000
NODE_163333_length_304_cov_1.687805	219	288	0	67	69	0.9710145
NODE_163333_length_304_cov_1.687805	219	288	2	2	69	0.0289855
NODE_163432_length_304_cov_1.492683	190	238	2	48	48	1.0000000
NODE_163559_length_304_cov_1.287805	99	165	6	22	66	0.3333333
NODE_163559_length_304_cov_1.287805	99	165	8	35	66	0.5303030
NODE_163559_length_304_cov_1.287805	99	165	10	3	66	0.0454545
NODE_163559_length_304_cov_1.287805	99	165	12	6	66	0.0909091
NODE_163670_length_304_cov_1.175610	0	30	0	30	30	1.0000000
NODE_163895_length_304_cov_0.951220	70	150	6	12	80	0.1500000
NODE_163895_length_304_cov_0.951220	70	150	8	6	80	0.0750000
NODE_163895_length_304_cov_0.951220	70	150	10	41	80	0.5125000
NODE_163895_length_304_cov_0.951220	70	150	12	21	80	0.2625000
NODE_164171_length_303_cov_30.843137	46	97	0	51	51	1.0000000
NODE_164194_length_303_cov_5.401961	33	79	0	46	46	1.0000000
NODE_164224_length_303_cov_4.210784	136	205	12	1	69	0.0144928
NODE_164224_length_303_cov_4.210784	136	205	14	4	69	0.0579710
NODE_164224_length_303_cov_4.210784	136	205	18	11	69	0.1594203
NODE_164224_length_303_cov_4.210784	136	205	20	8	69	0.1159420
NODE_164224_length_303_cov_4.210784	136	205	22	1	69	0.0144928
NODE_164224_length_303_cov_4.210784	136	205	24	20	69	0.2898551
NODE_164224_length_303_cov_4.210784	136	205	26	24	69	0.3478261
NODE_164224_length_303_cov_4.210784	178	259	0	33	81	0.4074074
NODE_164224_length_303_cov_4.210784	178	259	2	17	81	0.2098765
NODE_164224_length_303_cov_4.210784	178	259	10	4	81	0.0493827
NODE_164224_length_303_cov_4.210784	178	259	12	1	81	0.0123457
NODE_164224_length_303_cov_4.210784	178	259	14	4	81	0.0493827
NODE_164224_length_303_cov_4.210784	178	259	18	11	81	0.1358025
NODE_164224_length_303_cov_4.210784	178	259	20	8	81	0.0987654
NODE_164224_length_303_cov_4.210784	178	259	22	1	81	0.0123457
NODE_164224_length_303_cov_4.210784	178	259	24	2	81	0.0246914
NODE_164251_length_303_cov_3.671569	9	75	0	39	66	0.5909091
NODE_164251_length_303_cov_3.671569	9	75	2	27	66	0.4090909
NODE_164251_length_303_cov_3.671569	48	128	2	59	80	0.7375000
NODE_164251_length_303_cov_3.671569	48	128	4	21	80	0.2625000
NODE_164251_length_303_cov_3.671569	48	128	2	59	80	0.7375000
NODE_164251_length_303_cov_3.671569	48	128	4	21	80	0.2625000
NODE_164251_length_303_cov_3.671569	220	300	0	21	80	0.2625000
NODE_164251_length_303_cov_3.671569	220	300	2	13	80	0.1625000
NODE_164251_length_303_cov_3.671569	220	300	4	46	80	0.5750000
NODE_164267_length_303_cov_3.500000	55	123	0	10	68	0.1470588
NODE_164267_length_303_cov_3.500000	55	123	2	58	68	0.8529412
NODE_164272_length_303_cov_3.460784	0	67	4	2	67	0.0298507
NODE_164272_length_303_cov_3.460784	0	67	6	2	67	0.0298507
NODE_164272_length_303_cov_3.460784	0	67	8	12	67	0.1791045
NODE_164272_length_303_cov_3.460784	0	67	12	4	67	0.0597015
NODE_164272_length_303_cov_3.460784	0	67	16	1	67	0.0149254
NODE_164272_length_303_cov_3.460784	0	67	18	2	67	0.0298507
NODE_164272_length_303_cov_3.460784	0	67	22	1	67	0.0149254
NODE_164272_length_303_cov_3.460784	0	67	26	1	67	0.0149254
NODE_164272_length_303_cov_3.460784	0	67	30	1	67	0.0149254
NODE_164272_length_303_cov_3.460784	0	67	31	1	67	0.0149254
NODE_164272_length_303_cov_3.460784	0	67	33	1	67	0.0149254
NODE_164272_length_303_cov_3.460784	0	67	35	2	67	0.0298507
NODE_164272_length_303_cov_3.460784	0	67	37	1	67	0.0149254
NODE_164272_length_303_cov_3.460784	0	67	39	1	67	0.0149254
NODE_164272_length_303_cov_3.460784	0	67	41	2	67	0.0298507
NODE_164272_length_303_cov_3.460784	0	67	43	1	67	0.0149254
NODE_164272_length_303_cov_3.460784	0	67	45	1	67	0.0149254
NODE_164272_length_303_cov_3.460784	0	67	49	1	67	0.0149254
NODE_164272_length_303_cov_3.460784	0	67	55	1	67	0.0149254
NODE_164272_length_303_cov_3.460784	0	67	65	1	67	0.0149254
NODE_164272_length_303_cov_3.460784	0	67	79	1	67	0.0149254
NODE_164272_length_303_cov_3.460784	0	67	83	1	67	0.0149254
NODE_164272_length_303_cov_3.460784	0	67	87	2	67	0.0298507
NODE_164272_length_303_cov_3.460784	0	67	91	1	67	0.0149254
NODE_164272_length_303_cov_3.460784	0	67	102	1	67	0.0149254
NODE_164272_length_303_cov_3.460784	0	67	105	1	67	0.0149254
NODE_164272_length_303_cov_3.460784	0	67	109	1	67	0.0149254
NODE_164272_length_303_cov_3.460784	0	67	111	2	67	0.0298507
NODE_164272_length_303_cov_3.460784	0	67	113	1	67	0.0149254
NODE_164272_length_303_cov_3.460784	0	67	115	1	67	0.0149254
NODE_164272_length_303_cov_3.460784	0	67	121	1	67	0.0149254
NODE_164272_length_303_cov_3.460784	0	67	128	1	67	0.0149254
NODE_164272_length_303_cov_3.460784	0	67	129	1	67	0.0149254
NODE_164272_length_303_cov_3.460784	0	67	139	2	67	0.0298507
NODE_164272_length_303_cov_3.460784	0	67	141	1	67	0.0149254
NODE_164272_length_303_cov_3.460784	0	67	143	3	67	0.0447761
NODE_164272_length_303_cov_3.460784	0	67	145	1	67	0.0149254
NODE_164272_length_303_cov_3.460784	0	67	149	1	67	0.0149254
NODE_164272_length_303_cov_3.460784	0	67	153	1	67	0.0149254
NODE_164272_length_303_cov_3.460784	0	67	155	1	67	0.0149254
NODE_164272_length_303_cov_3.460784	0	67	157	1	67	0.0149254
NODE_164272_length_303_cov_3.460784	0	67	159	2	67	0.0298507
NODE_164272_length_303_cov_3.460784	98	178	308	1	80	0.0125000
NODE_164272_length_303_cov_3.460784	98	178	324	1	80	0.0125000
NODE_164272_length_303_cov_3.460784	98	178	328	1	80	0.0125000
NODE_164272_length_303_cov_3.460784	98	178	332	1	80	0.0125000
NODE_164272_length_303_cov_3.460784	98	178	336	1	80	0.0125000
NODE_164272_length_303_cov_3.460784	98	178	348	1	80	0.0125000
NODE_164272_length_303_cov_3.460784	98	178	352	1	80	0.0125000
NODE_164272_length_303_cov_3.460784	98	178	354	1	80	0.0125000
NODE_164272_length_303_cov_3.460784	98	178	355	1	80	0.0125000
NODE_164272_length_303_cov_3.460784	98	178	356	1	80	0.0125000
NODE_164272_length_303_cov_3.460784	98	178	358	3	80	0.0375000
NODE_164272_length_303_cov_3.460784	98	178	359	1	80	0.0125000
NODE_164272_length_303_cov_3.460784	98	178	360	2	80	0.0250000
NODE_164272_length_303_cov_3.460784	98	178	361	1	80	0.0125000
NODE_164272_length_303_cov_3.460784	98	178	364	1	80	0.0125000
NODE_164272_length_303_cov_3.460784	98	178	368	1	80	0.0125000
NODE_164272_length_303_cov_3.460784	98	178	369	1	80	0.0125000
NODE_164272_length_303_cov_3.460784	98	178	371	1	80	0.0125000
NODE_164272_length_303_cov_3.460784	98	178	373	1	80	0.0125000
NODE_164272_length_303_cov_3.460784	98	178	374	3	80	0.0375000
NODE_164272_length_303_cov_3.460784	98	178	375	1	80	0.0125000
NODE_164272_length_303_cov_3.460784	98	178	376	1	80	0.0125000
NODE_164272_length_303_cov_3.460784	98	178	378	4	80	0.0500000
NODE_164272_length_303_cov_3.460784	98	178	379	1	80	0.0125000
NODE_164272_length_303_cov_3.460784	98	178	380	2	80	0.0250000
NODE_164272_length_303_cov_3.460784	98	178	381	2	80	0.0250000
NODE_164272_length_303_cov_3.460784	98	178	382	2	80	0.0250000
NODE_164272_length_303_cov_3.460784	98	178	383	1	80	0.0125000
NODE_164272_length_303_cov_3.460784	98	178	384	4	80	0.0500000
NODE_164272_length_303_cov_3.460784	98	178	385	3	80	0.0375000
NODE_164272_length_303_cov_3.460784	98	178	386	4	80	0.0500000
NODE_164272_length_303_cov_3.460784	98	178	388	3	80	0.0375000
NODE_164272_length_303_cov_3.460784	98	178	389	5	80	0.0625000
NODE_164272_length_303_cov_3.460784	98	178	390	1	80	0.0125000
NODE_164272_length_303_cov_3.460784	98	178	391	4	80	0.0500000
NODE_164272_length_303_cov_3.460784	98	178	392	1	80	0.0125000
NODE_164272_length_303_cov_3.460784	98	178	393	1	80	0.0125000
NODE_164272_length_303_cov_3.460784	98	178	399	1	80	0.0125000
NODE_164272_length_303_cov_3.460784	98	178	400	1	80	0.0125000
NODE_164272_length_303_cov_3.460784	98	178	401	3	80	0.0375000
NODE_164272_length_303_cov_3.460784	98	178	402	3	80	0.0375000
NODE_164272_length_303_cov_3.460784	98	178	404	1	80	0.0125000
NODE_164272_length_303_cov_3.460784	98	178	405	2	80	0.0250000
NODE_164272_length_303_cov_3.460784	98	178	406	2	80	0.0250000
NODE_164272_length_303_cov_3.460784	98	178	410	2	80	0.0250000
NODE_164272_length_303_cov_3.460784	151	191	332	1	40	0.0250000
NODE_164272_length_303_cov_3.460784	151	191	334	1	40	0.0250000
NODE_164272_length_303_cov_3.460784	151	191	345	1	40	0.0250000
NODE_164272_length_303_cov_3.460784	151	191	347	2	40	0.0500000
NODE_164272_length_303_cov_3.460784	151	191	350	1	40	0.0250000
NODE_164272_length_303_cov_3.460784	151	191	351	2	40	0.0500000
NODE_164272_length_303_cov_3.460784	151	191	353	2	40	0.0500000
NODE_164272_length_303_cov_3.460784	151	191	355	3	40	0.0750000
NODE_164272_length_303_cov_3.460784	151	191	356	1	40	0.0250000
NODE_164272_length_303_cov_3.460784	151	191	358	3	40	0.0750000
NODE_164272_length_303_cov_3.460784	151	191	359	2	40	0.0500000
NODE_164272_length_303_cov_3.460784	151	191	361	1	40	0.0250000
NODE_164272_length_303_cov_3.460784	151	191	364	1	40	0.0250000
NODE_164272_length_303_cov_3.460784	151	191	369	1	40	0.0250000
NODE_164272_length_303_cov_3.460784	151	191	371	1	40	0.0250000
NODE_164272_length_303_cov_3.460784	151	191	373	1	40	0.0250000
NODE_164272_length_303_cov_3.460784	151	191	374	2	40	0.0500000
NODE_164272_length_303_cov_3.460784	151	191	375	1	40	0.0250000
NODE_164272_length_303_cov_3.460784	151	191	380	2	40	0.0500000
NODE_164272_length_303_cov_3.460784	151	191	381	1	40	0.0250000
NODE_164272_length_303_cov_3.460784	151	191	382	1	40	0.0250000
NODE_164272_length_303_cov_3.460784	151	191	383	1	40	0.0250000
NODE_164272_length_303_cov_3.460784	151	191	384	1	40	0.0250000
NODE_164272_length_303_cov_3.460784	151	191	385	1	40	0.0250000
NODE_164272_length_303_cov_3.460784	151	191	386	1	40	0.0250000
NODE_164272_length_303_cov_3.460784	151	191	389	4	40	0.1000000
NODE_164272_length_303_cov_3.460784	151	191	393	1	40	0.0250000
NODE_164283_length_303_cov_3.352941	77	146	6	8	69	0.1159420
NODE_164283_length_303_cov_3.352941	77	146	8	17	69	0.2463768
NODE_164283_length_303_cov_3.352941	77	146	12	12	69	0.1739130
NODE_164283_length_303_cov_3.352941	77	146	14	2	69	0.0289855
NODE_164283_length_303_cov_3.352941	77	146	16	30	69	0.4347826
NODE_164433_length_303_cov_2.284314	78	158	0	80	80	1.0000000
NODE_164433_length_303_cov_2.284314	215	295	0	80	80	1.0000000
NODE_164581_length_303_cov_1.848039	90	170	0	80	80	1.0000000
NODE_164581_length_303_cov_1.848039	143	223	0	80	80	1.0000000
NODE_164581_length_303_cov_1.848039	212	235	0	23	23	1.0000000
NODE_164668_length_303_cov_1.686275	62	88	0	26	26	1.0000000
NODE_164695_length_303_cov_1.583333	206	270	0	2	64	0.0312500
NODE_164695_length_303_cov_1.583333	206	270	2	62	64	0.9687500
NODE_164800_length_303_cov_1.475490	155	221	0	40	66	0.6060606
NODE_164800_length_303_cov_1.475490	155	221	4	26	66	0.3939394
NODE_164846_length_303_cov_1.392157	135	213	6	34	78	0.4358974
NODE_164846_length_303_cov_1.392157	135	213	8	44	78	0.5641026
NODE_164878_length_303_cov_1.318627	0	75	0	29	75	0.3866667
NODE_164878_length_303_cov_1.318627	0	75	2	16	75	0.2133333
NODE_164878_length_303_cov_1.318627	0	75	4	30	75	0.4000000
NODE_164974_length_303_cov_1.215686	278	297	0	19	19	1.0000000
NODE_165498_length_302_cov_10.852217	266	300	0	34	34	1.0000000
NODE_165502_length_302_cov_7.896552	46	131	0	85	85	1.0000000
NODE_165502_length_302_cov_7.896552	104	160	0	56	56	1.0000000
NODE_165505_length_302_cov_7.266010	135	191	0	56	56	1.0000000
NODE_165507_length_302_cov_7.216749	93	149	0	56	56	1.0000000
NODE_165507_length_302_cov_7.216749	155	226	0	71	71	1.0000000
NODE_165517_length_302_cov_6.172414	179	243	0	64	64	1.0000000
NODE_165517_length_302_cov_6.172414	232	287	0	55	55	1.0000000
NODE_165528_length_302_cov_5.586207	221	293	4	7	72	0.0972222
NODE_165528_length_302_cov_5.586207	221	293	6	6	72	0.0833333
NODE_165528_length_302_cov_5.586207	221	293	8	21	72	0.2916667
NODE_165528_length_302_cov_5.586207	221	293	10	11	72	0.1527778
NODE_165528_length_302_cov_5.586207	221	293	12	4	72	0.0555556
NODE_165528_length_302_cov_5.586207	221	293	14	3	72	0.0416667
NODE_165528_length_302_cov_5.586207	221	293	16	9	72	0.1250000
NODE_165528_length_302_cov_5.586207	221	293	18	1	72	0.0138889
NODE_165528_length_302_cov_5.586207	221	293	20	9	72	0.1250000
NODE_165528_length_302_cov_5.586207	221	293	22	1	72	0.0138889
NODE_165641_length_302_cov_2.985222	104	186	4	10	82	0.1219512
NODE_165641_length_302_cov_2.985222	104	186	6	5	82	0.0609756
NODE_165641_length_302_cov_2.985222	104	186	12	6	82	0.0731707
NODE_165641_length_302_cov_2.985222	104	186	14	30	82	0.3658537
NODE_165641_length_302_cov_2.985222	104	186	16	31	82	0.3780488
NODE_165848_length_302_cov_2.009852	12	34	0	22	22	1.0000000
NODE_165934_length_302_cov_1.758621	98	152	2	13	54	0.2407407
NODE_165934_length_302_cov_1.758621	98	152	3	2	54	0.0370370
NODE_165934_length_302_cov_1.758621	98	152	4	39	54	0.7222222
NODE_165945_length_302_cov_1.758621	230	294	0	64	64	1.0000000
NODE_166007_length_302_cov_1.620690	172	232	0	38	60	0.6333333
NODE_166007_length_302_cov_1.620690	172	232	2	4	60	0.0666667
NODE_166007_length_302_cov_1.620690	172	232	4	11	60	0.1833333
NODE_166007_length_302_cov_1.620690	172	232	6	7	60	0.1166667
NODE_166007_length_302_cov_1.620690	225	277	0	52	52	1.0000000
NODE_166320_length_302_cov_1.172414	34	103	0	69	69	1.0000000
NODE_166381_length_302_cov_1.044335	54	130	0	10	76	0.1315790
NODE_166381_length_302_cov_1.044335	54	130	2	11	76	0.1447368
NODE_166381_length_302_cov_1.044335	54	130	3	55	76	0.7236842
NODE_166617_length_302_cov_0.847291	94	172	13	1	78	0.0128205
NODE_166617_length_302_cov_0.847291	94	172	19	2	78	0.0256410
NODE_166617_length_302_cov_0.847291	94	172	21	19	78	0.2435897
NODE_166617_length_302_cov_0.847291	94	172	26	7	78	0.0897436
NODE_166617_length_302_cov_0.847291	94	172	28	5	78	0.0641026
NODE_166617_length_302_cov_0.847291	94	172	30	4	78	0.0512821
NODE_166617_length_302_cov_0.847291	94	172	31	5	78	0.0641026
NODE_166617_length_302_cov_0.847291	94	172	33	1	78	0.0128205
NODE_166617_length_302_cov_0.847291	94	172	36	5	78	0.0641026
NODE_166617_length_302_cov_0.847291	94	172	38	9	78	0.1153846
NODE_166617_length_302_cov_0.847291	94	172	46	13	78	0.1666667
NODE_166617_length_302_cov_0.847291	94	172	48	2	78	0.0256410
NODE_166617_length_302_cov_0.847291	94	172	50	5	78	0.0641026
NODE_166617_length_302_cov_0.847291	94	172	13	1	78	0.0128205
NODE_166617_length_302_cov_0.847291	94	172	19	2	78	0.0256410
NODE_166617_length_302_cov_0.847291	94	172	21	19	78	0.2435897
NODE_166617_length_302_cov_0.847291	94	172	26	7	78	0.0897436
NODE_166617_length_302_cov_0.847291	94	172	28	5	78	0.0641026
NODE_166617_length_302_cov_0.847291	94	172	30	4	78	0.0512821
NODE_166617_length_302_cov_0.847291	94	172	31	5	78	0.0641026
NODE_166617_length_302_cov_0.847291	94	172	33	1	78	0.0128205
NODE_166617_length_302_cov_0.847291	94	172	36	5	78	0.0641026
NODE_166617_length_302_cov_0.847291	94	172	38	9	78	0.1153846
NODE_166617_length_302_cov_0.847291	94	172	46	13	78	0.1666667
NODE_166617_length_302_cov_0.847291	94	172	48	2	78	0.0256410
NODE_166617_length_302_cov_0.847291	94	172	50	5	78	0.0641026
NODE_166617_length_302_cov_0.847291	103	172	21	13	69	0.1884058
NODE_166617_length_302_cov_0.847291	103	172	26	7	69	0.1014493
NODE_166617_length_302_cov_0.847291	103	172	28	5	69	0.0724638
NODE_166617_length_302_cov_0.847291	103	172	30	4	69	0.0579710
NODE_166617_length_302_cov_0.847291	103	172	31	5	69	0.0724638
NODE_166617_length_302_cov_0.847291	103	172	33	1	69	0.0144928
NODE_166617_length_302_cov_0.847291	103	172	36	5	69	0.0724638
NODE_166617_length_302_cov_0.847291	103	172	38	9	69	0.1304348
NODE_166617_length_302_cov_0.847291	103	172	46	13	69	0.1884058
NODE_166617_length_302_cov_0.847291	103	172	48	2	69	0.0289855
NODE_166617_length_302_cov_0.847291	103	172	50	5	69	0.0724638
NODE_166638_length_302_cov_0.807882	97	177	0	80	80	1.0000000
NODE_166819_length_301_cov_6.960396	268	299	0	31	31	1.0000000
NODE_166827_length_301_cov_6.148515	214	283	0	69	69	1.0000000
NODE_166889_length_301_cov_3.747525	116	196	0	57	80	0.7125000
NODE_166889_length_301_cov_3.747525	116	196	2	23	80	0.2875000
NODE_166904_length_301_cov_3.509901	217	277	2	12	60	0.2000000
NODE_166904_length_301_cov_3.509901	217	277	4	5	60	0.0833333
NODE_166904_length_301_cov_3.509901	217	277	5	1	60	0.0166667
NODE_166904_length_301_cov_3.509901	217	277	7	4	60	0.0666667
NODE_166904_length_301_cov_3.509901	217	277	10	2	60	0.0333333
NODE_166904_length_301_cov_3.509901	217	277	12	7	60	0.1166667
NODE_166904_length_301_cov_3.509901	217	277	18	4	60	0.0666667
NODE_166904_length_301_cov_3.509901	217	277	20	1	60	0.0166667
NODE_166904_length_301_cov_3.509901	217	277	22	1	60	0.0166667
NODE_166904_length_301_cov_3.509901	217	277	26	2	60	0.0333333
NODE_166904_length_301_cov_3.509901	217	277	29	1	60	0.0166667
NODE_166904_length_301_cov_3.509901	217	277	30	2	60	0.0333333
NODE_166904_length_301_cov_3.509901	217	277	34	1	60	0.0166667
NODE_166904_length_301_cov_3.509901	217	277	36	1	60	0.0166667
NODE_166904_length_301_cov_3.509901	217	277	39	1	60	0.0166667
NODE_166904_length_301_cov_3.509901	217	277	43	3	60	0.0500000
NODE_166904_length_301_cov_3.509901	217	277	45	2	60	0.0333333
NODE_166904_length_301_cov_3.509901	217	277	47	3	60	0.0500000
NODE_166904_length_301_cov_3.509901	217	277	53	1	60	0.0166667
NODE_166904_length_301_cov_3.509901	217	277	57	1	60	0.0166667
NODE_166904_length_301_cov_3.509901	217	277	63	1	60	0.0166667
NODE_166904_length_301_cov_3.509901	217	277	67	1	60	0.0166667
NODE_166904_length_301_cov_3.509901	217	277	69	2	60	0.0333333
NODE_166904_length_301_cov_3.509901	217	277	71	1	60	0.0166667
NODE_166993_length_301_cov_2.653465	133	213	0	2	80	0.0250000
NODE_166993_length_301_cov_2.653465	133	213	2	78	80	0.9750000
NODE_167126_length_301_cov_2.084158	178	258	20	2	80	0.0250000
NODE_167126_length_301_cov_2.084158	178	258	22	3	80	0.0375000
NODE_167126_length_301_cov_2.084158	178	258	27	3	80	0.0375000
NODE_167126_length_301_cov_2.084158	178	258	28	1	80	0.0125000
NODE_167126_length_301_cov_2.084158	178	258	29	2	80	0.0250000
NODE_167126_length_301_cov_2.084158	178	258	31	3	80	0.0375000
NODE_167126_length_301_cov_2.084158	178	258	33	1	80	0.0125000
NODE_167126_length_301_cov_2.084158	178	258	35	2	80	0.0250000
NODE_167126_length_301_cov_2.084158	178	258	37	5	80	0.0625000
NODE_167126_length_301_cov_2.084158	178	258	45	2	80	0.0250000
NODE_167126_length_301_cov_2.084158	178	258	48	2	80	0.0250000
NODE_167126_length_301_cov_2.084158	178	258	51	1	80	0.0125000
NODE_167126_length_301_cov_2.084158	178	258	53	1	80	0.0125000
NODE_167126_length_301_cov_2.084158	178	258	67	14	80	0.1750000
NODE_167126_length_301_cov_2.084158	178	258	68	1	80	0.0125000
NODE_167126_length_301_cov_2.084158	178	258	69	24	80	0.3000000
NODE_167126_length_301_cov_2.084158	178	258	70	13	80	0.1625000
NODE_167215_length_301_cov_1.831683	111	175	0	64	64	1.0000000
NODE_167215_length_301_cov_1.831683	164	228	0	64	64	1.0000000
NODE_167308_length_301_cov_1.603960	173	233	0	60	60	1.0000000
NODE_167313_length_301_cov_1.584158	30	108	0	78	78	1.0000000
NODE_167434_length_301_cov_1.470297	90	165	0	75	75	1.0000000
NODE_167508_length_301_cov_1.326733	175	247	4	33	72	0.4583333
NODE_167508_length_301_cov_1.326733	175	247	6	39	72	0.5416667
NODE_167612_length_301_cov_1.247525	29	73	0	44	44	1.0000000
NODE_167642_length_301_cov_1.183168	123	203	0	3	80	0.0375000
NODE_167642_length_301_cov_1.183168	123	203	2	5	80	0.0625000
NODE_167642_length_301_cov_1.183168	123	203	4	22	80	0.2750000
NODE_167642_length_301_cov_1.183168	123	203	6	1	80	0.0125000
NODE_167642_length_301_cov_1.183168	123	203	8	5	80	0.0625000
NODE_167642_length_301_cov_1.183168	123	203	12	8	80	0.1000000
NODE_167642_length_301_cov_1.183168	123	203	13	5	80	0.0625000
NODE_167642_length_301_cov_1.183168	123	203	15	1	80	0.0125000
NODE_167642_length_301_cov_1.183168	123	203	17	3	80	0.0375000
NODE_167642_length_301_cov_1.183168	123	203	18	5	80	0.0625000
NODE_167642_length_301_cov_1.183168	123	203	22	1	80	0.0125000
NODE_167642_length_301_cov_1.183168	123	203	24	1	80	0.0125000
NODE_167642_length_301_cov_1.183168	123	203	26	1	80	0.0125000
NODE_167642_length_301_cov_1.183168	123	203	29	1	80	0.0125000
NODE_167642_length_301_cov_1.183168	123	203	30	3	80	0.0375000
NODE_167642_length_301_cov_1.183168	123	203	32	15	80	0.1875000
NODE_167659_length_301_cov_1.163366	10	83	0	73	73	1.0000000
NODE_167659_length_301_cov_1.163366	91	121	0	30	30	1.0000000
NODE_167668_length_301_cov_1.148515	161	209	0	48	48	1.0000000
NODE_167880_length_301_cov_0.980198	242	297	0	55	55	1.0000000
NODE_167891_length_301_cov_0.960396	22	63	0	41	41	1.0000000
NODE_168253_length_300_cov_3.402985	44	124	0	20	80	0.2500000
NODE_168253_length_300_cov_3.402985	44	124	4	60	80	0.7500000
NODE_168253_length_300_cov_3.402985	97	177	0	12	80	0.1500000
NODE_168253_length_300_cov_3.402985	97	177	4	68	80	0.8500000
NODE_168253_length_300_cov_3.402985	173	254	0	36	81	0.4444444
NODE_168253_length_300_cov_3.402985	173	254	2	45	81	0.5555556
NODE_168253_length_300_cov_3.402985	233	300	0	11	67	0.1641791
NODE_168253_length_300_cov_3.402985	233	300	2	56	67	0.8358209
NODE_168265_length_300_cov_3.298507	18	98	0	1	80	0.0125000
NODE_168265_length_300_cov_3.298507	18	98	4	79	80	0.9875000
NODE_168360_length_300_cov_2.597015	110	182	2	2	72	0.0277778
NODE_168360_length_300_cov_2.597015	110	182	4	5	72	0.0694444
NODE_168360_length_300_cov_2.597015	110	182	6	65	72	0.9027778
NODE_168363_length_300_cov_2.572139	28	102	0	11	74	0.1486486
NODE_168363_length_300_cov_2.572139	28	102	2	40	74	0.5405405
NODE_168363_length_300_cov_2.572139	28	102	4	3	74	0.0405405
NODE_168363_length_300_cov_2.572139	28	102	6	3	74	0.0405405
NODE_168363_length_300_cov_2.572139	28	102	7	1	74	0.0135135
NODE_168363_length_300_cov_2.572139	28	102	9	1	74	0.0135135
NODE_168363_length_300_cov_2.572139	28	102	10	15	74	0.2027027
NODE_168363_length_300_cov_2.572139	75	141	2	4	66	0.0606061
NODE_168363_length_300_cov_2.572139	75	141	4	3	66	0.0454545
NODE_168363_length_300_cov_2.572139	75	141	6	3	66	0.0454545
NODE_168363_length_300_cov_2.572139	75	141	7	1	66	0.0151515
NODE_168363_length_300_cov_2.572139	75	141	9	1	66	0.0151515
NODE_168363_length_300_cov_2.572139	75	141	10	16	66	0.2424242
NODE_168363_length_300_cov_2.572139	75	141	12	6	66	0.0909091
NODE_168363_length_300_cov_2.572139	75	141	13	1	66	0.0151515
NODE_168363_length_300_cov_2.572139	75	141	16	31	66	0.4696970
NODE_168402_length_300_cov_2.417910	0	44	4	44	44	1.0000000
NODE_168459_length_300_cov_2.174129	117	197	2	8	80	0.1000000
NODE_168459_length_300_cov_2.174129	117	197	3	5	80	0.0625000
NODE_168459_length_300_cov_2.174129	117	197	4	2	80	0.0250000
NODE_168459_length_300_cov_2.174129	117	197	5	1	80	0.0125000
NODE_168459_length_300_cov_2.174129	117	197	6	3	80	0.0375000
NODE_168459_length_300_cov_2.174129	117	197	8	2	80	0.0250000
NODE_168459_length_300_cov_2.174129	117	197	10	7	80	0.0875000
NODE_168459_length_300_cov_2.174129	117	197	12	18	80	0.2250000
NODE_168459_length_300_cov_2.174129	117	197	14	8	80	0.1000000
NODE_168459_length_300_cov_2.174129	117	197	16	13	80	0.1625000
NODE_168459_length_300_cov_2.174129	117	197	18	13	80	0.1625000
NODE_168459_length_300_cov_2.174129	170	250	12	2	80	0.0250000
NODE_168459_length_300_cov_2.174129	170	250	14	3	80	0.0375000
NODE_168459_length_300_cov_2.174129	170	250	16	9	80	0.1125000
NODE_168459_length_300_cov_2.174129	170	250	18	25	80	0.3125000
NODE_168459_length_300_cov_2.174129	170	250	20	1	80	0.0125000
NODE_168459_length_300_cov_2.174129	170	250	22	1	80	0.0125000
NODE_168459_length_300_cov_2.174129	170	250	26	2	80	0.0250000
NODE_168459_length_300_cov_2.174129	170	250	42	1	80	0.0125000
NODE_168459_length_300_cov_2.174129	170	250	48	1	80	0.0125000
NODE_168459_length_300_cov_2.174129	170	250	50	1	80	0.0125000
NODE_168459_length_300_cov_2.174129	170	250	52	1	80	0.0125000
NODE_168459_length_300_cov_2.174129	170	250	54	1	80	0.0125000
NODE_168459_length_300_cov_2.174129	170	250	58	1	80	0.0125000
NODE_168459_length_300_cov_2.174129	170	250	62	1	80	0.0125000
NODE_168459_length_300_cov_2.174129	170	250	68	1	80	0.0125000
NODE_168459_length_300_cov_2.174129	170	250	78	1	80	0.0125000
NODE_168459_length_300_cov_2.174129	170	250	80	7	80	0.0875000
NODE_168459_length_300_cov_2.174129	170	250	82	2	80	0.0250000
NODE_168459_length_300_cov_2.174129	170	250	84	10	80	0.1250000
NODE_168459_length_300_cov_2.174129	170	250	86	9	80	0.1125000
NODE_168459_length_300_cov_2.174129	216	296	49	1	80	0.0125000
NODE_168459_length_300_cov_2.174129	216	296	52	1	80	0.0125000
NODE_168459_length_300_cov_2.174129	216	296	54	1	80	0.0125000
NODE_168459_length_300_cov_2.174129	216	296	55	1	80	0.0125000
NODE_168459_length_300_cov_2.174129	216	296	58	1	80	0.0125000
NODE_168459_length_300_cov_2.174129	216	296	61	1	80	0.0125000
NODE_168459_length_300_cov_2.174129	216	296	62	1	80	0.0125000
NODE_168459_length_300_cov_2.174129	216	296	68	1	80	0.0125000
NODE_168459_length_300_cov_2.174129	216	296	70	5	80	0.0625000
NODE_168459_length_300_cov_2.174129	216	296	72	1	80	0.0125000
NODE_168459_length_300_cov_2.174129	216	296	74	6	80	0.0750000
NODE_168459_length_300_cov_2.174129	216	296	78	5	80	0.0625000
NODE_168459_length_300_cov_2.174129	216	296	80	15	80	0.1875000
NODE_168459_length_300_cov_2.174129	216	296	82	12	80	0.1500000
NODE_168459_length_300_cov_2.174129	216	296	84	19	80	0.2375000
NODE_168459_length_300_cov_2.174129	216	296	86	9	80	0.1125000
NODE_168462_length_300_cov_2.164179	122	141	0	19	19	1.0000000
NODE_168479_length_300_cov_2.079602	127	207	0	44	80	0.5500000
NODE_168479_length_300_cov_2.079602	127	207	6	36	80	0.4500000
NODE_168479_length_300_cov_2.079602	203	273	0	70	70	1.0000000
NODE_168541_length_300_cov_1.965174	15	86	0	71	71	1.0000000
NODE_168656_length_300_cov_1.731343	31	88	2	57	57	1.0000000
NODE_168906_length_300_cov_1.268657	62	98	0	36	36	1.0000000
NODE_168906_length_300_cov_1.268657	151	186	0	35	35	1.0000000
NODE_169014_length_300_cov_1.104478	86	165	10	2	79	0.0253165
NODE_169014_length_300_cov_1.104478	86	165	12	9	79	0.1139240
NODE_169014_length_300_cov_1.104478	86	165	14	51	79	0.6455696
NODE_169014_length_300_cov_1.104478	86	165	16	17	79	0.2151899
NODE_169053_length_300_cov_1.029851	110	177	2	25	67	0.3731343
NODE_169053_length_300_cov_1.029851	110	177	4	5	67	0.0746269
NODE_169053_length_300_cov_1.029851	110	177	6	37	67	0.5522388
NODE_169053_length_300_cov_1.029851	120	177	2	25	57	0.4385965
NODE_169053_length_300_cov_1.029851	120	177	4	5	57	0.0877193
NODE_169053_length_300_cov_1.029851	120	177	6	27	57	0.4736842
NODE_169378_length_300_cov_0.716418	191	210	0	19	19	1.0000000
NODE_169528_length_299_cov_4.435000	48	128	4	3	80	0.0375000
NODE_169528_length_299_cov_4.435000	48	128	6	48	80	0.6000000
NODE_169528_length_299_cov_4.435000	48	128	8	29	80	0.3625000
NODE_169528_length_299_cov_4.435000	101	167	2	6	66	0.0909091
NODE_169528_length_299_cov_4.435000	101	167	3	1	66	0.0151515
NODE_169528_length_299_cov_4.435000	101	167	4	17	66	0.2575758
NODE_169528_length_299_cov_4.435000	101	167	6	42	66	0.6363636
NODE_169567_length_299_cov_3.780000	114	181	0	54	67	0.8059701
NODE_169567_length_299_cov_3.780000	114	181	2	13	67	0.1940299
NODE_169631_length_299_cov_3.095000	0	73	0	73	73	1.0000000
NODE_169631_length_299_cov_3.095000	0	20	0	20	20	1.0000000
NODE_169725_length_299_cov_2.495000	46	126	0	43	80	0.5375000
NODE_169725_length_299_cov_2.495000	46	126	2	37	80	0.4625000
NODE_169725_length_299_cov_2.495000	99	179	2	80	80	1.0000000
NODE_169769_length_299_cov_2.275000	127	192	4	21	65	0.3230769
NODE_169769_length_299_cov_2.275000	127	192	6	19	65	0.2923077
NODE_169769_length_299_cov_2.275000	127	192	8	25	65	0.3846154
NODE_169781_length_299_cov_2.250000	72	135	2	8	63	0.1269841
NODE_169781_length_299_cov_2.250000	72	135	4	55	63	0.8730159
NODE_169781_length_299_cov_2.250000	108	188	0	17	80	0.2125000
NODE_169781_length_299_cov_2.250000	108	188	2	21	80	0.2625000
NODE_169781_length_299_cov_2.250000	108	188	4	42	80	0.5250000
NODE_169811_length_299_cov_2.090000	25	105	0	80	80	1.0000000
NODE_169888_length_299_cov_1.955000	173	214	10	1	41	0.0243902
NODE_169888_length_299_cov_1.955000	173	214	14	2	41	0.0487805
NODE_169888_length_299_cov_1.955000	173	214	16	6	41	0.1463415
NODE_169888_length_299_cov_1.955000	173	214	20	6	41	0.1463415
NODE_169888_length_299_cov_1.955000	173	214	22	2	41	0.0487805
NODE_169888_length_299_cov_1.955000	173	214	24	2	41	0.0487805
NODE_169888_length_299_cov_1.955000	173	214	26	4	41	0.0975610
NODE_169888_length_299_cov_1.955000	173	214	28	2	41	0.0487805
NODE_169888_length_299_cov_1.955000	173	214	34	1	41	0.0243902
NODE_169888_length_299_cov_1.955000	173	214	36	2	41	0.0487805
NODE_169888_length_299_cov_1.955000	173	214	38	1	41	0.0243902
NODE_169888_length_299_cov_1.955000	173	214	40	1	41	0.0243902
NODE_169888_length_299_cov_1.955000	173	214	42	3	41	0.0731707
NODE_169888_length_299_cov_1.955000	173	214	44	1	41	0.0243902
NODE_169888_length_299_cov_1.955000	173	214	48	3	41	0.0731707
NODE_169888_length_299_cov_1.955000	173	214	50	1	41	0.0243902
NODE_169888_length_299_cov_1.955000	173	214	54	1	41	0.0243902
NODE_169888_length_299_cov_1.955000	173	214	58	2	41	0.0487805
NODE_169888_length_299_cov_1.955000	187	227	20	1	40	0.0250000
NODE_169888_length_299_cov_1.955000	187	227	22	2	40	0.0500000
NODE_169888_length_299_cov_1.955000	187	227	24	2	40	0.0500000
NODE_169888_length_299_cov_1.955000	187	227	26	4	40	0.1000000
NODE_169888_length_299_cov_1.955000	187	227	28	2	40	0.0500000
NODE_169888_length_299_cov_1.955000	187	227	34	1	40	0.0250000
NODE_169888_length_299_cov_1.955000	187	227	36	2	40	0.0500000
NODE_169888_length_299_cov_1.955000	187	227	38	1	40	0.0250000
NODE_169888_length_299_cov_1.955000	187	227	40	1	40	0.0250000
NODE_169888_length_299_cov_1.955000	187	227	42	3	40	0.0750000
NODE_169888_length_299_cov_1.955000	187	227	44	1	40	0.0250000
NODE_169888_length_299_cov_1.955000	187	227	48	3	40	0.0750000
NODE_169888_length_299_cov_1.955000	187	227	50	1	40	0.0250000
NODE_169888_length_299_cov_1.955000	187	227	54	1	40	0.0250000
NODE_169888_length_299_cov_1.955000	187	227	58	6	40	0.1500000
NODE_169888_length_299_cov_1.955000	187	227	60	4	40	0.1000000
NODE_169888_length_299_cov_1.955000	187	227	62	3	40	0.0750000
NODE_169888_length_299_cov_1.955000	187	227	64	2	40	0.0500000
NODE_169916_length_299_cov_1.885000	29	109	0	8	80	0.1000000
NODE_169916_length_299_cov_1.885000	29	109	2	2	80	0.0250000
NODE_169916_length_299_cov_1.885000	29	109	4	70	80	0.8750000
NODE_169920_length_299_cov_1.880000	204	236	0	3	32	0.0937500
NODE_169920_length_299_cov_1.880000	204	236	1	1	32	0.0312500
NODE_169920_length_299_cov_1.880000	204	236	2	28	32	0.8750000
NODE_169938_length_299_cov_1.840000	154	190	0	36	36	1.0000000
NODE_169995_length_299_cov_1.710000	211	291	0	80	80	1.0000000
NODE_170048_length_299_cov_1.550000	174	205	2	31	31	1.0000000
NODE_170501_length_299_cov_1.020000	42	115	0	73	73	1.0000000
NODE_170546_length_299_cov_1.020000	132	175	4	43	43	1.0000000
NODE_170620_length_299_cov_0.935000	173	216	6	37	43	0.8604651
NODE_170620_length_299_cov_0.935000	173	216	10	6	43	0.1395349
NODE_170691_length_299_cov_0.765000	86	128	2	42	42	1.0000000
NODE_170887_length_298_cov_20.894472	70	150	0	64	80	0.8000000
NODE_170887_length_298_cov_20.894472	70	150	2	16	80	0.2000000
NODE_170887_length_298_cov_20.894472	123	203	0	11	80	0.1375000
NODE_170887_length_298_cov_20.894472	123	203	2	69	80	0.8625000
NODE_170888_length_298_cov_13.859296	228	298	2	1	70	0.0142857
NODE_170888_length_298_cov_13.859296	228	298	5	6	70	0.0857143
NODE_170888_length_298_cov_13.859296	228	298	7	10	70	0.1428571
NODE_170888_length_298_cov_13.859296	228	298	9	3	70	0.0428571
NODE_170888_length_298_cov_13.859296	228	298	11	32	70	0.4571429
NODE_170888_length_298_cov_13.859296	228	298	13	3	70	0.0428571
NODE_170888_length_298_cov_13.859296	228	298	17	3	70	0.0428571
NODE_170888_length_298_cov_13.859296	228	298	19	3	70	0.0428571
NODE_170888_length_298_cov_13.859296	228	298	21	1	70	0.0142857
NODE_170888_length_298_cov_13.859296	228	298	22	8	70	0.1142857
NODE_170909_length_298_cov_5.859296	1	65	6	1	64	0.0156250
NODE_170909_length_298_cov_5.859296	1	65	8	10	64	0.1562500
NODE_170909_length_298_cov_5.859296	1	65	10	13	64	0.2031250
NODE_170909_length_298_cov_5.859296	1	65	12	36	64	0.5625000
NODE_170909_length_298_cov_5.859296	1	65	14	4	64	0.0625000
NODE_170909_length_298_cov_5.859296	38	118	2	9	80	0.1125000
NODE_170909_length_298_cov_5.859296	38	118	4	11	80	0.1375000
NODE_170909_length_298_cov_5.859296	38	118	6	8	80	0.1000000
NODE_170909_length_298_cov_5.859296	38	118	8	4	80	0.0500000
NODE_170909_length_298_cov_5.859296	38	118	12	25	80	0.3125000
NODE_170909_length_298_cov_5.859296	38	118	14	23	80	0.2875000
NODE_170909_length_298_cov_5.859296	114	194	0	7	80	0.0875000
NODE_170909_length_298_cov_5.859296	114	194	2	60	80	0.7500000
NODE_170909_length_298_cov_5.859296	114	194	4	2	80	0.0250000
NODE_170909_length_298_cov_5.859296	114	194	5	1	80	0.0125000
NODE_170909_length_298_cov_5.859296	114	194	6	10	80	0.1250000
NODE_170909_length_298_cov_5.859296	167	238	2	14	71	0.1971831
NODE_170909_length_298_cov_5.859296	167	238	4	2	71	0.0281690
NODE_170909_length_298_cov_5.859296	167	238	5	1	71	0.0140845
NODE_170909_length_298_cov_5.859296	167	238	6	35	71	0.4929577
NODE_170909_length_298_cov_5.859296	167	238	8	19	71	0.2676056
NODE_170964_length_298_cov_3.829146	80	160	42	6	80	0.0750000
NODE_170964_length_298_cov_3.829146	80	160	44	18	80	0.2250000
NODE_170964_length_298_cov_3.829146	80	160	46	3	80	0.0375000
NODE_170964_length_298_cov_3.829146	80	160	52	5	80	0.0625000
NODE_170964_length_298_cov_3.829146	80	160	54	5	80	0.0625000
NODE_170964_length_298_cov_3.829146	80	160	56	3	80	0.0375000
NODE_170964_length_298_cov_3.829146	80	160	57	1	80	0.0125000
NODE_170964_length_298_cov_3.829146	80	160	58	5	80	0.0625000
NODE_170964_length_298_cov_3.829146	80	160	59	4	80	0.0500000
NODE_170964_length_298_cov_3.829146	80	160	60	2	80	0.0250000
NODE_170964_length_298_cov_3.829146	80	160	61	2	80	0.0250000
NODE_170964_length_298_cov_3.829146	80	160	62	4	80	0.0500000
NODE_170964_length_298_cov_3.829146	80	160	63	2	80	0.0250000
NODE_170964_length_298_cov_3.829146	80	160	64	3	80	0.0375000
NODE_170964_length_298_cov_3.829146	80	160	65	2	80	0.0250000
NODE_170964_length_298_cov_3.829146	80	160	66	2	80	0.0250000
NODE_170964_length_298_cov_3.829146	80	160	67	2	80	0.0250000
NODE_170964_length_298_cov_3.829146	80	160	68	1	80	0.0125000
NODE_170964_length_298_cov_3.829146	80	160	70	1	80	0.0125000
NODE_170964_length_298_cov_3.829146	80	160	71	6	80	0.0750000
NODE_170964_length_298_cov_3.829146	80	160	72	3	80	0.0375000
NODE_170964_length_298_cov_3.829146	133	213	4	11	80	0.1375000
NODE_170964_length_298_cov_3.829146	133	213	6	3	80	0.0375000
NODE_170964_length_298_cov_3.829146	133	213	7	1	80	0.0125000
NODE_170964_length_298_cov_3.829146	133	213	8	4	80	0.0500000
NODE_170964_length_298_cov_3.829146	133	213	11	3	80	0.0375000
NODE_170964_length_298_cov_3.829146	133	213	15	1	80	0.0125000
NODE_170964_length_298_cov_3.829146	133	213	19	1	80	0.0125000
NODE_170964_length_298_cov_3.829146	133	213	22	8	80	0.1000000
NODE_170964_length_298_cov_3.829146	133	213	28	1	80	0.0125000
NODE_170964_length_298_cov_3.829146	133	213	30	2	80	0.0250000
NODE_170964_length_298_cov_3.829146	133	213	32	2	80	0.0250000
NODE_170964_length_298_cov_3.829146	133	213	36	1	80	0.0125000
NODE_170964_length_298_cov_3.829146	133	213	38	9	80	0.1125000
NODE_170964_length_298_cov_3.829146	133	213	42	12	80	0.1500000
NODE_170964_length_298_cov_3.829146	133	213	44	18	80	0.2250000
NODE_170964_length_298_cov_3.829146	133	213	46	3	80	0.0375000
NODE_170968_length_298_cov_3.733668	203	283	0	80	80	1.0000000
NODE_170972_length_298_cov_3.673367	117	175	0	19	58	0.3275862
NODE_170972_length_298_cov_3.673367	117	175	2	7	58	0.1206897
NODE_170972_length_298_cov_3.673367	117	175	4	4	58	0.0689655
NODE_170972_length_298_cov_3.673367	117	175	6	12	58	0.2068966
NODE_170972_length_298_cov_3.673367	117	175	8	13	58	0.2241379
NODE_170972_length_298_cov_3.673367	117	175	10	3	58	0.0517241
NODE_171043_length_298_cov_2.924623	159	239	4	12	80	0.1500000
NODE_171043_length_298_cov_2.924623	159	239	6	23	80	0.2875000
NODE_171043_length_298_cov_2.924623	159	239	8	7	80	0.0875000
NODE_171043_length_298_cov_2.924623	159	239	10	22	80	0.2750000
NODE_171043_length_298_cov_2.924623	159	239	12	5	80	0.0625000
NODE_171043_length_298_cov_2.924623	159	239	14	6	80	0.0750000
NODE_171043_length_298_cov_2.924623	159	239	16	3	80	0.0375000
NODE_171043_length_298_cov_2.924623	159	239	18	2	80	0.0250000
NODE_171043_length_298_cov_2.924623	212	265	0	18	53	0.3396226
NODE_171043_length_298_cov_2.924623	212	265	4	20	53	0.3773585
NODE_171043_length_298_cov_2.924623	212	265	6	15	53	0.2830189
NODE_171047_length_298_cov_2.854271	50	120	0	70	70	1.0000000
NODE_171082_length_298_cov_2.663317	87	167	0	30	80	0.3750000
NODE_171082_length_298_cov_2.663317	87	167	2	42	80	0.5250000
NODE_171082_length_298_cov_2.663317	87	167	4	8	80	0.1000000
NODE_171082_length_298_cov_2.663317	140	192	0	35	52	0.6730769
NODE_171082_length_298_cov_2.663317	140	192	2	17	52	0.3269231
NODE_171191_length_298_cov_2.201005	112	166	0	54	54	1.0000000
NODE_171210_length_298_cov_2.120603	135	166	0	31	31	1.0000000
NODE_171226_length_298_cov_2.055276	69	132	0	63	63	1.0000000
NODE_171286_length_298_cov_2.025126	21	92	0	71	71	1.0000000
NODE_171356_length_298_cov_1.798995	0	67	2	25	67	0.3731343
NODE_171356_length_298_cov_1.798995	0	67	4	42	67	0.6268657
NODE_171356_length_298_cov_1.798995	40	106	0	10	66	0.1515152
NODE_171356_length_298_cov_1.798995	40	106	2	19	66	0.2878788
NODE_171356_length_298_cov_1.798995	40	106	4	37	66	0.5606061
NODE_171391_length_298_cov_1.788945	140	197	0	3	57	0.0526316
NODE_171391_length_298_cov_1.788945	140	197	2	44	57	0.7719298
NODE_171391_length_298_cov_1.788945	140	197	4	3	57	0.0526316
NODE_171391_length_298_cov_1.788945	140	197	6	7	57	0.1228070
NODE_171415_length_298_cov_1.733668	56	91	2	4	35	0.1142857
NODE_171415_length_298_cov_1.733668	56	91	4	7	35	0.2000000
NODE_171415_length_298_cov_1.733668	56	91	6	1	35	0.0285714
NODE_171415_length_298_cov_1.733668	56	91	8	7	35	0.2000000
NODE_171415_length_298_cov_1.733668	56	91	10	16	35	0.4571429
NODE_171415_length_298_cov_1.733668	118	172	2	4	54	0.0740741
NODE_171415_length_298_cov_1.733668	118	172	4	6	54	0.1111111
NODE_171415_length_298_cov_1.733668	118	172	8	1	54	0.0185185
NODE_171415_length_298_cov_1.733668	118	172	10	43	54	0.7962963
NODE_171505_length_298_cov_1.537688	101	154	0	53	53	1.0000000
NODE_172083_length_298_cov_0.829146	34	96	0	62	62	1.0000000
NODE_172330_length_297_cov_6.525253	100	122	0	22	22	1.0000000
NODE_172352_length_297_cov_4.888889	150	218	4	2	68	0.0294118
NODE_172352_length_297_cov_4.888889	150	218	6	1	68	0.0147059
NODE_172352_length_297_cov_4.888889	150	218	8	8	68	0.1176471
NODE_172352_length_297_cov_4.888889	150	218	10	57	68	0.8382353
NODE_172356_length_297_cov_4.671717	56	120	0	22	64	0.3437500
NODE_172356_length_297_cov_4.671717	56	120	2	42	64	0.6562500
NODE_172422_length_297_cov_3.338384	96	176	1	3	80	0.0375000
NODE_172422_length_297_cov_3.338384	96	176	3	74	80	0.9250000
NODE_172422_length_297_cov_3.338384	96	176	5	3	80	0.0375000
NODE_172422_length_297_cov_3.338384	149	198	0	21	49	0.4285714
NODE_172422_length_297_cov_3.338384	149	198	1	4	49	0.0816327
NODE_172422_length_297_cov_3.338384	149	198	3	24	49	0.4897959
NODE_172447_length_297_cov_3.040404	0	55	0	55	55	1.0000000
NODE_172447_length_297_cov_3.040404	14	55	0	41	41	1.0000000
NODE_172447_length_297_cov_3.040404	65	119	0	54	54	1.0000000
NODE_172574_length_297_cov_2.308081	8	70	2	17	62	0.2741936
NODE_172574_length_297_cov_2.308081	8	70	4	12	62	0.1935484
NODE_172574_length_297_cov_2.308081	8	70	6	33	62	0.5322581
NODE_172606_length_297_cov_2.196970	219	259	56	1	40	0.0250000
NODE_172606_length_297_cov_2.196970	219	259	60	1	40	0.0250000
NODE_172606_length_297_cov_2.196970	219	259	64	1	40	0.0250000
NODE_172606_length_297_cov_2.196970	219	259	66	1	40	0.0250000
NODE_172606_length_297_cov_2.196970	219	259	68	1	40	0.0250000
NODE_172606_length_297_cov_2.196970	219	259	70	2	40	0.0500000
NODE_172606_length_297_cov_2.196970	219	259	72	1	40	0.0250000
NODE_172606_length_297_cov_2.196970	219	259	76	2	40	0.0500000
NODE_172606_length_297_cov_2.196970	219	259	78	1	40	0.0250000
NODE_172606_length_297_cov_2.196970	219	259	80	1	40	0.0250000
NODE_172606_length_297_cov_2.196970	219	259	88	1	40	0.0250000
NODE_172606_length_297_cov_2.196970	219	259	94	1	40	0.0250000
NODE_172606_length_297_cov_2.196970	219	259	100	1	40	0.0250000
NODE_172606_length_297_cov_2.196970	219	259	102	2	40	0.0500000
NODE_172606_length_297_cov_2.196970	219	259	118	1	40	0.0250000
NODE_172606_length_297_cov_2.196970	219	259	120	1	40	0.0250000
NODE_172606_length_297_cov_2.196970	219	259	126	2	40	0.0500000
NODE_172606_length_297_cov_2.196970	219	259	130	1	40	0.0250000
NODE_172606_length_297_cov_2.196970	219	259	132	2	40	0.0500000
NODE_172606_length_297_cov_2.196970	219	259	136	3	40	0.0750000
NODE_172606_length_297_cov_2.196970	219	259	144	3	40	0.0750000
NODE_172606_length_297_cov_2.196970	219	259	151	1	40	0.0250000
NODE_172606_length_297_cov_2.196970	219	259	152	1	40	0.0250000
NODE_172606_length_297_cov_2.196970	219	259	154	1	40	0.0250000
NODE_172606_length_297_cov_2.196970	219	259	158	2	40	0.0500000
NODE_172606_length_297_cov_2.196970	219	259	160	5	40	0.1250000
NODE_172629_length_297_cov_2.106061	81	161	0	80	80	1.0000000
NODE_172629_length_297_cov_2.106061	134	178	0	44	44	1.0000000
NODE_172668_length_297_cov_2.060606	46	76	0	30	30	1.0000000
NODE_172697_length_297_cov_2.010101	9	85	8	9	76	0.1184211
NODE_172697_length_297_cov_2.010101	9	85	10	4	76	0.0526316
NODE_172697_length_297_cov_2.010101	9	85	12	63	76	0.8289474
NODE_172783_length_297_cov_1.777778	168	208	4	2	40	0.0500000
NODE_172783_length_297_cov_1.777778	168	208	5	1	40	0.0250000
NODE_172783_length_297_cov_1.777778	168	208	6	9	40	0.2250000
NODE_172783_length_297_cov_1.777778	168	208	8	17	40	0.4250000
NODE_172783_length_297_cov_1.777778	168	208	10	5	40	0.1250000
NODE_172783_length_297_cov_1.777778	168	208	12	6	40	0.1500000
NODE_172855_length_297_cov_1.595960	175	255	5	13	80	0.1625000
NODE_172855_length_297_cov_1.595960	175	255	7	14	80	0.1750000
NODE_172855_length_297_cov_1.595960	175	255	9	3	80	0.0375000
NODE_172855_length_297_cov_1.595960	175	255	11	17	80	0.2125000
NODE_172855_length_297_cov_1.595960	175	255	12	1	80	0.0125000
NODE_172855_length_297_cov_1.595960	175	255	14	3	80	0.0375000
NODE_172855_length_297_cov_1.595960	175	255	18	4	80	0.0500000
NODE_172855_length_297_cov_1.595960	175	255	22	4	80	0.0500000
NODE_172855_length_297_cov_1.595960	175	255	24	5	80	0.0625000
NODE_172855_length_297_cov_1.595960	175	255	26	4	80	0.0500000
NODE_172855_length_297_cov_1.595960	175	255	28	12	80	0.1500000
NODE_172862_length_297_cov_1.570707	100	177	2	39	77	0.5064935
NODE_172862_length_297_cov_1.570707	100	177	3	1	77	0.0129870
NODE_172862_length_297_cov_1.570707	100	177	4	36	77	0.4675325
NODE_172862_length_297_cov_1.570707	100	177	5	1	77	0.0129870
NODE_172863_length_297_cov_1.570707	194	275	2	81	81	1.0000000
NODE_173063_length_297_cov_1.338384	140	199	0	59	59	1.0000000
NODE_173136_length_297_cov_1.277778	39	115	0	76	76	1.0000000
NODE_173176_length_297_cov_1.196970	7	87	2	44	80	0.5500000
NODE_173176_length_297_cov_1.196970	7	87	4	36	80	0.4500000
NODE_173176_length_297_cov_1.196970	60	116	2	43	56	0.7678571
NODE_173176_length_297_cov_1.196970	60	116	4	13	56	0.2321429
NODE_173345_length_297_cov_1.030303	0	33	0	33	33	1.0000000
NODE_173467_length_297_cov_0.888889	109	172	0	63	63	1.0000000
NODE_173520_length_297_cov_0.782828	24	104	0	80	80	1.0000000
NODE_173708_length_296_cov_41.390863	189	260	16	2	71	0.0281690
NODE_173708_length_296_cov_41.390863	189	260	18	1	71	0.0140845
NODE_173708_length_296_cov_41.390863	189	260	20	12	71	0.1690141
NODE_173708_length_296_cov_41.390863	189	260	21	3	71	0.0422535
NODE_173708_length_296_cov_41.390863	189	260	22	3	71	0.0422535
NODE_173708_length_296_cov_41.390863	189	260	24	21	71	0.2957746
NODE_173708_length_296_cov_41.390863	189	260	26	29	71	0.4084507
NODE_173709_length_296_cov_34.776650	214	294	0	80	80	1.0000000
NODE_173758_length_296_cov_4.243655	14	54	0	40	40	1.0000000
NODE_173773_length_296_cov_3.954315	120	200	0	80	80	1.0000000
NODE_173787_length_296_cov_3.736041	6	46	0	40	40	1.0000000
NODE_173797_length_296_cov_3.619289	193	251	0	42	58	0.7241379
NODE_173797_length_296_cov_3.619289	193	251	2	16	58	0.2758621
NODE_173797_length_296_cov_3.619289	246	296	0	50	50	1.0000000
NODE_173859_length_296_cov_3.015228	177	257	4	4	80	0.0500000
NODE_173859_length_296_cov_3.015228	177	257	7	45	80	0.5625000
NODE_173859_length_296_cov_3.015228	177	257	13	6	80	0.0750000
NODE_173859_length_296_cov_3.015228	177	257	15	20	80	0.2500000
NODE_173859_length_296_cov_3.015228	177	257	16	4	80	0.0500000
NODE_173859_length_296_cov_3.015228	177	257	18	1	80	0.0125000
NODE_173992_length_296_cov_2.309645	5	77	10	6	72	0.0833333
NODE_173992_length_296_cov_2.309645	5	77	12	1	72	0.0138889
NODE_173992_length_296_cov_2.309645	5	77	14	1	72	0.0138889
NODE_173992_length_296_cov_2.309645	5	77	15	3	72	0.0416667
NODE_173992_length_296_cov_2.309645	5	77	17	10	72	0.1388889
NODE_173992_length_296_cov_2.309645	5	77	19	4	72	0.0555556
NODE_173992_length_296_cov_2.309645	5	77	21	6	72	0.0833333
NODE_173992_length_296_cov_2.309645	5	77	23	9	72	0.1250000
NODE_173992_length_296_cov_2.309645	5	77	25	6	72	0.0833333
NODE_173992_length_296_cov_2.309645	5	77	27	7	72	0.0972222
NODE_173992_length_296_cov_2.309645	5	77	33	5	72	0.0694444
NODE_173992_length_296_cov_2.309645	5	77	35	3	72	0.0416667
NODE_173992_length_296_cov_2.309645	5	77	37	1	72	0.0138889
NODE_173992_length_296_cov_2.309645	5	77	41	8	72	0.1111111
NODE_173992_length_296_cov_2.309645	5	77	45	2	72	0.0277778
NODE_173992_length_296_cov_2.309645	50	130	25	1	80	0.0125000
NODE_173992_length_296_cov_2.309645	50	130	27	7	80	0.0875000
NODE_173992_length_296_cov_2.309645	50	130	33	5	80	0.0625000
NODE_173992_length_296_cov_2.309645	50	130	35	3	80	0.0375000
NODE_173992_length_296_cov_2.309645	50	130	37	1	80	0.0125000
NODE_173992_length_296_cov_2.309645	50	130	41	8	80	0.1000000
NODE_173992_length_296_cov_2.309645	50	130	45	2	80	0.0250000
NODE_173992_length_296_cov_2.309645	50	130	47	1	80	0.0125000
NODE_173992_length_296_cov_2.309645	50	130	49	7	80	0.0875000
NODE_173992_length_296_cov_2.309645	50	130	50	12	80	0.1500000
NODE_173992_length_296_cov_2.309645	50	130	51	9	80	0.1125000
NODE_173992_length_296_cov_2.309645	50	130	52	15	80	0.1875000
NODE_173992_length_296_cov_2.309645	50	130	54	9	80	0.1125000
NODE_174040_length_296_cov_2.081218	90	139	0	49	49	1.0000000
NODE_174167_length_296_cov_1.807107	199	246	0	47	47	1.0000000
NODE_174167_length_296_cov_1.807107	219	296	0	77	77	1.0000000
NODE_174213_length_296_cov_1.670051	28	103	10	37	75	0.4933333
NODE_174213_length_296_cov_1.670051	28	103	12	38	75	0.5066667
NODE_174274_length_296_cov_1.553299	102	179	0	57	77	0.7402598
NODE_174274_length_296_cov_1.553299	102	179	2	20	77	0.2597403
NODE_174274_length_296_cov_1.553299	160	179	0	19	19	1.0000000
NODE_174438_length_296_cov_1.319797	82	162	4	2	80	0.0250000
NODE_174438_length_296_cov_1.319797	82	162	6	56	80	0.7000000
NODE_174438_length_296_cov_1.319797	82	162	7	3	80	0.0375000
NODE_174438_length_296_cov_1.319797	82	162	8	10	80	0.1250000
NODE_174438_length_296_cov_1.319797	82	162	10	9	80	0.1125000
NODE_174438_length_296_cov_1.319797	135	205	4	45	70	0.6428571
NODE_174438_length_296_cov_1.319797	135	205	6	25	70	0.3571429
NODE_174545_length_296_cov_1.258883	222	280	0	58	58	1.0000000
NODE_174554_length_296_cov_1.238579	90	147	4	9	57	0.1578947
NODE_174554_length_296_cov_1.238579	90	147	5	1	57	0.0175439
NODE_174554_length_296_cov_1.238579	90	147	6	47	57	0.8245614
NODE_174614_length_296_cov_1.116751	130	169	8	2	39	0.0512821
NODE_174614_length_296_cov_1.116751	130	169	15	6	39	0.1538462
NODE_174614_length_296_cov_1.116751	130	169	18	3	39	0.0769231
NODE_174614_length_296_cov_1.116751	130	169	20	4	39	0.1025641
NODE_174614_length_296_cov_1.116751	130	169	22	1	39	0.0256410
NODE_174614_length_296_cov_1.116751	130	169	24	4	39	0.1025641
NODE_174614_length_296_cov_1.116751	130	169	26	2	39	0.0512821
NODE_174614_length_296_cov_1.116751	130	169	28	7	39	0.1794872
NODE_174614_length_296_cov_1.116751	130	169	30	10	39	0.2564103
NODE_175210_length_295_cov_4.290816	2	70	2	68	68	1.0000000
NODE_175210_length_295_cov_4.290816	55	123	0	37	68	0.5441176
NODE_175210_length_295_cov_4.290816	55	123	2	31	68	0.4558823
NODE_175220_length_295_cov_4.040816	119	165	2	46	46	1.0000000
NODE_175258_length_295_cov_3.576531	130	198	0	68	68	1.0000000
NODE_175324_length_295_cov_2.918367	0	77	0	7	77	0.0909091
NODE_175324_length_295_cov_2.918367	0	77	2	70	77	0.9090909
NODE_175416_length_295_cov_2.454082	216	277	12	5	61	0.0819672
NODE_175416_length_295_cov_2.454082	216	277	14	39	61	0.6393443
NODE_175416_length_295_cov_2.454082	216	277	15	17	61	0.2786885
NODE_175475_length_295_cov_2.224490	11	91	0	12	80	0.1500000
NODE_175475_length_295_cov_2.224490	11	91	2	68	80	0.8500000
NODE_175483_length_295_cov_2.183673	93	151	0	1	58	0.0172414
NODE_175483_length_295_cov_2.183673	93	151	1	4	58	0.0689655
NODE_175483_length_295_cov_2.183673	93	151	2	1	58	0.0172414
NODE_175483_length_295_cov_2.183673	93	151	3	3	58	0.0517241
NODE_175483_length_295_cov_2.183673	93	151	5	2	58	0.0344828
NODE_175483_length_295_cov_2.183673	93	151	9	2	58	0.0344828
NODE_175483_length_295_cov_2.183673	93	151	10	1	58	0.0172414
NODE_175483_length_295_cov_2.183673	93	151	11	5	58	0.0862069
NODE_175483_length_295_cov_2.183673	93	151	12	1	58	0.0172414
NODE_175483_length_295_cov_2.183673	93	151	14	4	58	0.0689655
NODE_175483_length_295_cov_2.183673	93	151	18	2	58	0.0344828
NODE_175483_length_295_cov_2.183673	93	151	20	12	58	0.2068966
NODE_175483_length_295_cov_2.183673	93	151	22	20	58	0.3448276
NODE_175483_length_295_cov_2.183673	124	204	20	7	80	0.0875000
NODE_175483_length_295_cov_2.183673	124	204	22	73	80	0.9125000
NODE_175597_length_295_cov_1.867347	191	239	4	6	48	0.1250000
NODE_175597_length_295_cov_1.867347	191	239	6	27	48	0.5625000
NODE_175597_length_295_cov_1.867347	191	239	8	15	48	0.3125000
NODE_175598_length_295_cov_1.862245	225	285	0	4	60	0.0666667
NODE_175598_length_295_cov_1.862245	225	285	2	56	60	0.9333333
NODE_175721_length_295_cov_1.596939	173	254	0	30	81	0.3703704
NODE_175721_length_295_cov_1.596939	173	254	2	6	81	0.0740741
NODE_175721_length_295_cov_1.596939	173	254	4	38	81	0.4691358
NODE_175721_length_295_cov_1.596939	173	254	6	3	81	0.0370370
NODE_175721_length_295_cov_1.596939	173	254	8	4	81	0.0493827
NODE_175804_length_295_cov_1.520408	217	282	1	1	65	0.0153846
NODE_175804_length_295_cov_1.520408	217	282	2	19	65	0.2923077
NODE_175804_length_295_cov_1.520408	217	282	4	18	65	0.2769231
NODE_175804_length_295_cov_1.520408	217	282	6	27	65	0.4153846
NODE_175930_length_295_cov_1.301020	99	121	0	22	22	1.0000000
NODE_176250_length_295_cov_0.938776	200	247	0	47	47	1.0000000
NODE_176367_length_295_cov_0.780612	24	44	0	20	20	1.0000000
NODE_176436_length_295_cov_0.724490	6	87	0	75	81	0.9259259
NODE_176436_length_295_cov_0.724490	6	87	2	6	81	0.0740741
NODE_176436_length_295_cov_0.724490	83	163	2	80	80	1.0000000
NODE_176436_length_295_cov_0.724490	136	216	0	35	80	0.4375000
NODE_176436_length_295_cov_0.724490	136	216	2	45	80	0.5625000
NODE_176547_length_294_cov_83.882051	143	173	2	1	30	0.0333333
NODE_176547_length_294_cov_83.882051	143	173	4	13	30	0.4333333
NODE_176547_length_294_cov_83.882051	143	173	7	2	30	0.0666667
NODE_176547_length_294_cov_83.882051	143	173	8	14	30	0.4666667
NODE_176547_length_294_cov_83.882051	209	239	2	30	30	1.0000000
NODE_176549_length_294_cov_50.589744	187	258	24	6	71	0.0845070
NODE_176549_length_294_cov_50.589744	187	258	25	1	71	0.0140845
NODE_176549_length_294_cov_50.589744	187	258	27	1	71	0.0140845
NODE_176549_length_294_cov_50.589744	187	258	31	7	71	0.0985916
NODE_176549_length_294_cov_50.589744	187	258	44	3	71	0.0422535
NODE_176549_length_294_cov_50.589744	187	258	50	7	71	0.0985916
NODE_176549_length_294_cov_50.589744	187	258	51	2	71	0.0281690
NODE_176549_length_294_cov_50.589744	187	258	55	3	71	0.0422535
NODE_176549_length_294_cov_50.589744	187	258	57	1	71	0.0140845
NODE_176549_length_294_cov_50.589744	187	258	58	1	71	0.0140845
NODE_176549_length_294_cov_50.589744	187	258	66	3	71	0.0422535
NODE_176549_length_294_cov_50.589744	187	258	72	1	71	0.0140845
NODE_176549_length_294_cov_50.589744	187	258	76	1	71	0.0140845
NODE_176549_length_294_cov_50.589744	187	258	78	2	71	0.0281690
NODE_176549_length_294_cov_50.589744	187	258	81	1	71	0.0140845
NODE_176549_length_294_cov_50.589744	187	258	84	1	71	0.0140845
NODE_176549_length_294_cov_50.589744	187	258	86	1	71	0.0140845
NODE_176549_length_294_cov_50.589744	187	258	90	2	71	0.0281690
NODE_176549_length_294_cov_50.589744	187	258	92	1	71	0.0140845
NODE_176549_length_294_cov_50.589744	187	258	94	1	71	0.0140845
NODE_176549_length_294_cov_50.589744	187	258	100	1	71	0.0140845
NODE_176549_length_294_cov_50.589744	187	258	102	1	71	0.0140845
NODE_176549_length_294_cov_50.589744	187	258	104	2	71	0.0281690
NODE_176549_length_294_cov_50.589744	187	258	110	2	71	0.0281690
NODE_176549_length_294_cov_50.589744	187	258	112	1	71	0.0140845
NODE_176549_length_294_cov_50.589744	187	258	120	3	71	0.0422535
NODE_176549_length_294_cov_50.589744	187	258	122	1	71	0.0140845
NODE_176549_length_294_cov_50.589744	187	258	126	3	71	0.0422535
NODE_176549_length_294_cov_50.589744	187	258	128	2	71	0.0281690
NODE_176549_length_294_cov_50.589744	187	258	130	1	71	0.0140845
NODE_176549_length_294_cov_50.589744	187	258	134	1	71	0.0140845
NODE_176549_length_294_cov_50.589744	187	258	136	1	71	0.0140845
NODE_176549_length_294_cov_50.589744	187	258	140	6	71	0.0845070
NODE_176561_length_294_cov_6.676923	61	138	2	67	77	0.8701299
NODE_176561_length_294_cov_6.676923	61	138	4	10	77	0.1298701
NODE_176596_length_294_cov_4.538462	127	214	2	17	87	0.1954023
NODE_176596_length_294_cov_4.538462	127	214	6	10	87	0.1149425
NODE_176596_length_294_cov_4.538462	127	214	8	2	87	0.0229885
NODE_176596_length_294_cov_4.538462	127	214	10	5	87	0.0574713
NODE_176596_length_294_cov_4.538462	127	214	11	13	87	0.1494253
NODE_176596_length_294_cov_4.538462	127	214	12	40	87	0.4597701
NODE_176598_length_294_cov_4.512821	218	248	0	30	30	1.0000000
NODE_176600_length_294_cov_4.497436	159	200	0	41	41	1.0000000
NODE_176697_length_294_cov_2.953846	114	194	0	1	80	0.0125000
NODE_176697_length_294_cov_2.953846	114	194	2	17	80	0.2125000
NODE_176697_length_294_cov_2.953846	114	194	10	1	80	0.0125000
NODE_176697_length_294_cov_2.953846	114	194	12	13	80	0.1625000
NODE_176697_length_294_cov_2.953846	114	194	14	22	80	0.2750000
NODE_176697_length_294_cov_2.953846	114	194	16	10	80	0.1250000
NODE_176697_length_294_cov_2.953846	114	194	18	2	80	0.0250000
NODE_176697_length_294_cov_2.953846	114	194	20	8	80	0.1000000
NODE_176697_length_294_cov_2.953846	114	194	22	6	80	0.0750000
NODE_176727_length_294_cov_2.764103	103	183	0	71	80	0.8875000
NODE_176727_length_294_cov_2.764103	103	183	2	9	80	0.1125000
NODE_176727_length_294_cov_2.764103	156	236	0	18	80	0.2250000
NODE_176727_length_294_cov_2.764103	156	236	2	62	80	0.7750000
NODE_176728_length_294_cov_2.764103	224	282	2	16	58	0.2758621
NODE_176728_length_294_cov_2.764103	224	282	4	4	58	0.0689655
NODE_176728_length_294_cov_2.764103	224	282	6	34	58	0.5862069
NODE_176728_length_294_cov_2.764103	224	282	10	4	58	0.0689655
NODE_176728_length_294_cov_2.764103	225	277	2	11	52	0.2115385
NODE_176728_length_294_cov_2.764103	225	277	4	4	52	0.0769231
NODE_176728_length_294_cov_2.764103	225	277	6	34	52	0.6538461
NODE_176728_length_294_cov_2.764103	225	277	10	3	52	0.0576923
NODE_176735_length_294_cov_2.697436	204	261	2	57	57	1.0000000
NODE_176735_length_294_cov_2.697436	234	294	0	2	60	0.0333333
NODE_176735_length_294_cov_2.697436	234	294	2	58	60	0.9666666
NODE_176779_length_294_cov_2.517949	23	85	2	62	62	1.0000000
NODE_176816_length_294_cov_2.353846	129	167	14	15	38	0.3947369
NODE_176816_length_294_cov_2.353846	129	167	16	23	38	0.6052632
NODE_176833_length_294_cov_2.338462	133	213	7	29	80	0.3625000
NODE_176833_length_294_cov_2.338462	133	213	9	9	80	0.1125000
NODE_176833_length_294_cov_2.338462	133	213	10	1	80	0.0125000
NODE_176833_length_294_cov_2.338462	133	213	11	3	80	0.0375000
NODE_176833_length_294_cov_2.338462	133	213	12	18	80	0.2250000
NODE_176833_length_294_cov_2.338462	133	213	14	3	80	0.0375000
NODE_176833_length_294_cov_2.338462	133	213	21	4	80	0.0500000
NODE_176833_length_294_cov_2.338462	133	213	23	13	80	0.1625000
NODE_176943_length_294_cov_2.046154	219	269	0	50	50	1.0000000
NODE_176957_length_294_cov_2.010256	191	235	0	5	44	0.1136364
NODE_176957_length_294_cov_2.010256	191	235	2	39	44	0.8863636
NODE_176999_length_294_cov_1.902564	52	83	8	31	31	1.0000000
NODE_177102_length_294_cov_1.692308	46	112	0	66	66	1.0000000
NODE_177187_length_294_cov_1.569231	49	95	0	46	46	1.0000000
NODE_177252_length_294_cov_1.482051	28	108	0	80	80	1.0000000
NODE_177252_length_294_cov_1.482051	201	281	0	22	80	0.2750000
NODE_177252_length_294_cov_1.482051	201	281	2	58	80	0.7250000
NODE_177252_length_294_cov_1.482051	201	281	0	22	80	0.2750000
NODE_177252_length_294_cov_1.482051	201	281	2	58	80	0.7250000
NODE_177298_length_294_cov_1.420513	216	262	0	46	46	1.0000000
NODE_177298_length_294_cov_1.420513	235	294	0	59	59	1.0000000
NODE_177972_length_294_cov_0.666667	245	293	0	48	48	1.0000000
NODE_178066_length_293_cov_6.257732	167	247	0	80	80	1.0000000
NODE_178161_length_293_cov_3.567010	50	130	2	80	80	1.0000000
NODE_178226_length_293_cov_2.907216	218	281	0	52	63	0.8253968
NODE_178226_length_293_cov_2.907216	218	281	2	11	63	0.1746032
NODE_178246_length_293_cov_2.768041	95	175	0	37	80	0.4625000
NODE_178246_length_293_cov_2.768041	95	175	4	43	80	0.5375000
NODE_178246_length_293_cov_2.768041	148	228	0	27	80	0.3375000
NODE_178246_length_293_cov_2.768041	148	228	4	53	80	0.6625000
NODE_178268_length_293_cov_2.628866	207	266	2	26	59	0.4406780
NODE_178268_length_293_cov_2.628866	207	266	4	8	59	0.1355932
NODE_178268_length_293_cov_2.628866	207	266	6	25	59	0.4237288
NODE_178277_length_293_cov_2.623711	182	223	8	12	41	0.2926829
NODE_178277_length_293_cov_2.623711	182	223	10	4	41	0.0975610
NODE_178277_length_293_cov_2.623711	182	223	12	25	41	0.6097561
NODE_178299_length_293_cov_2.561856	139	192	0	44	53	0.8301887
NODE_178299_length_293_cov_2.561856	139	192	2	9	53	0.1698113
NODE_178299_length_293_cov_2.561856	177	223	0	6	46	0.1304348
NODE_178299_length_293_cov_2.561856	177	223	2	40	46	0.8695652
NODE_178317_length_293_cov_2.448454	98	158	0	17	60	0.2833333
NODE_178317_length_293_cov_2.448454	98	158	2	43	60	0.7166666
NODE_178351_length_293_cov_2.335052	62	91	0	29	29	1.0000000
NODE_178357_length_293_cov_2.314433	35	89	0	35	54	0.6481481
NODE_178357_length_293_cov_2.314433	35	89	2	19	54	0.3518519
NODE_178523_length_293_cov_1.840206	27	107	0	27	80	0.3375000
NODE_178523_length_293_cov_1.840206	27	107	2	53	80	0.6625000
NODE_178523_length_293_cov_1.840206	80	160	2	80	80	1.0000000
NODE_178560_length_293_cov_1.804124	144	173	10	16	29	0.5517241
NODE_178560_length_293_cov_1.804124	144	173	12	13	29	0.4482759
NODE_178570_length_293_cov_1.778351	224	258	0	34	34	1.0000000
NODE_178646_length_293_cov_1.577320	158	177	0	19	19	1.0000000
NODE_178692_length_293_cov_1.577320	161	225	0	64	64	1.0000000
NODE_178693_length_293_cov_1.577320	15	55	0	38	40	0.9500000
NODE_178693_length_293_cov_1.577320	15	55	2	2	40	0.0500000
NODE_178788_length_293_cov_1.402062	3	72	0	28	69	0.4057971
NODE_178788_length_293_cov_1.402062	3	72	2	41	69	0.5942029
NODE_178822_length_293_cov_1.319588	202	268	2	8	66	0.1212121
NODE_178822_length_293_cov_1.319588	202	268	4	1	66	0.0151515
NODE_178822_length_293_cov_1.319588	202	268	6	57	66	0.8636364
NODE_178927_length_293_cov_1.226804	84	141	0	57	57	1.0000000
NODE_179542_length_292_cov_4.523316	240	290	0	50	50	1.0000000
NODE_179552_length_292_cov_4.145078	106	186	0	80	80	1.0000000
NODE_179604_length_292_cov_3.502591	129	205	6	11	76	0.1447368
NODE_179604_length_292_cov_3.502591	129	205	8	4	76	0.0526316
NODE_179604_length_292_cov_3.502591	129	205	9	1	76	0.0131579
NODE_179604_length_292_cov_3.502591	129	205	10	8	76	0.1052632
NODE_179604_length_292_cov_3.502591	129	205	11	1	76	0.0131579
NODE_179604_length_292_cov_3.502591	129	205	13	2	76	0.0263158
NODE_179604_length_292_cov_3.502591	129	205	14	1	76	0.0131579
NODE_179604_length_292_cov_3.502591	129	205	16	7	76	0.0921053
NODE_179604_length_292_cov_3.502591	129	205	18	2	76	0.0263158
NODE_179604_length_292_cov_3.502591	129	205	22	39	76	0.5131579
NODE_179613_length_292_cov_3.435233	176	200	0	24	24	1.0000000
NODE_179621_length_292_cov_3.341969	70	150	2	52	80	0.6500000
NODE_179621_length_292_cov_3.341969	70	150	4	13	80	0.1625000
NODE_179621_length_292_cov_3.341969	70	150	6	15	80	0.1875000
NODE_179621_length_292_cov_3.341969	118	175	0	24	57	0.4210526
NODE_179621_length_292_cov_3.341969	118	175	2	33	57	0.5789474
NODE_179627_length_292_cov_3.222798	47	127	0	80	80	1.0000000
NODE_179627_length_292_cov_3.222798	100	129	0	29	29	1.0000000
NODE_179819_length_292_cov_2.238342	211	290	0	79	79	1.0000000
NODE_179943_length_292_cov_1.865285	34	114	18	8	80	0.1000000
NODE_179943_length_292_cov_1.865285	34	114	20	1	80	0.0125000
NODE_179943_length_292_cov_1.865285	34	114	24	4	80	0.0500000
NODE_179943_length_292_cov_1.865285	34	114	25	6	80	0.0750000
NODE_179943_length_292_cov_1.865285	34	114	26	24	80	0.3000000
NODE_179943_length_292_cov_1.865285	34	114	27	18	80	0.2250000
NODE_179943_length_292_cov_1.865285	34	114	28	11	80	0.1375000
NODE_179943_length_292_cov_1.865285	34	114	29	8	80	0.1000000
NODE_179943_length_292_cov_1.865285	87	167	4	4	80	0.0500000
NODE_179943_length_292_cov_1.865285	87	167	6	5	80	0.0625000
NODE_179943_length_292_cov_1.865285	87	167	10	14	80	0.1750000
NODE_179943_length_292_cov_1.865285	87	167	12	26	80	0.3250000
NODE_179943_length_292_cov_1.865285	87	167	16	2	80	0.0250000
NODE_179943_length_292_cov_1.865285	87	167	18	10	80	0.1250000
NODE_179943_length_292_cov_1.865285	87	167	20	1	80	0.0125000
NODE_179943_length_292_cov_1.865285	87	167	24	4	80	0.0500000
NODE_179943_length_292_cov_1.865285	87	167	26	5	80	0.0625000
NODE_179943_length_292_cov_1.865285	87	167	27	1	80	0.0125000
NODE_179943_length_292_cov_1.865285	87	167	29	8	80	0.1000000
NODE_180013_length_292_cov_1.761658	174	254	0	80	80	1.0000000
NODE_180029_length_292_cov_1.699482	0	80	0	54	80	0.6750000
NODE_180029_length_292_cov_1.699482	0	80	2	3	80	0.0375000
NODE_180029_length_292_cov_1.699482	0	80	4	1	80	0.0125000
NODE_180029_length_292_cov_1.699482	0	80	8	12	80	0.1500000
NODE_180029_length_292_cov_1.699482	0	80	10	10	80	0.1250000
NODE_180068_length_292_cov_1.611399	89	157	0	68	68	1.0000000
NODE_180210_length_292_cov_1.455959	72	115	4	15	43	0.3488372
NODE_180210_length_292_cov_1.455959	72	115	6	9	43	0.2093023
NODE_180210_length_292_cov_1.455959	72	115	8	19	43	0.4418605
NODE_180210_length_292_cov_1.455959	203	265	0	16	62	0.2580645
NODE_180210_length_292_cov_1.455959	203	265	4	11	62	0.1774193
NODE_180210_length_292_cov_1.455959	203	265	6	25	62	0.4032258
NODE_180210_length_292_cov_1.455959	203	265	7	10	62	0.1612903
NODE_180302_length_292_cov_1.321244	102	182	0	80	80	1.0000000
NODE_180302_length_292_cov_1.321244	155	217	0	62	62	1.0000000
NODE_180968_length_291_cov_45.031250	71	145	26	4	74	0.0540541
NODE_180968_length_291_cov_45.031250	71	145	28	8	74	0.1081081
NODE_180968_length_291_cov_45.031250	71	145	30	18	74	0.2432432
NODE_180968_length_291_cov_45.031250	71	145	32	7	74	0.0945946
NODE_180968_length_291_cov_45.031250	71	145	33	6	74	0.0810811
NODE_180968_length_291_cov_45.031250	71	145	34	1	74	0.0135135
NODE_180968_length_291_cov_45.031250	71	145	35	3	74	0.0405405
NODE_180968_length_291_cov_45.031250	71	145	36	27	74	0.3648649
NODE_180968_length_291_cov_45.031250	71	145	26	4	74	0.0540541
NODE_180968_length_291_cov_45.031250	71	145	28	8	74	0.1081081
NODE_180968_length_291_cov_45.031250	71	145	30	18	74	0.2432432
NODE_180968_length_291_cov_45.031250	71	145	32	7	74	0.0945946
NODE_180968_length_291_cov_45.031250	71	145	33	6	74	0.0810811
NODE_180968_length_291_cov_45.031250	71	145	34	1	74	0.0135135
NODE_180968_length_291_cov_45.031250	71	145	35	3	74	0.0405405
NODE_180968_length_291_cov_45.031250	71	145	36	27	74	0.3648649
NODE_180968_length_291_cov_45.031250	118	184	26	4	66	0.0606061
NODE_180968_length_291_cov_45.031250	118	184	28	10	66	0.1515152
NODE_180968_length_291_cov_45.031250	118	184	30	9	66	0.1363636
NODE_180968_length_291_cov_45.031250	118	184	31	4	66	0.0606061
NODE_180968_length_291_cov_45.031250	118	184	32	7	66	0.1060606
NODE_180968_length_291_cov_45.031250	118	184	33	7	66	0.1060606
NODE_180968_length_291_cov_45.031250	118	184	34	3	66	0.0454545
NODE_180968_length_291_cov_45.031250	118	184	35	4	66	0.0606061
NODE_180968_length_291_cov_45.031250	118	184	36	4	66	0.0606061
NODE_180968_length_291_cov_45.031250	118	184	41	6	66	0.0909091
NODE_180968_length_291_cov_45.031250	118	184	42	2	66	0.0303030
NODE_180968_length_291_cov_45.031250	118	184	43	1	66	0.0151515
NODE_180968_length_291_cov_45.031250	118	184	50	5	66	0.0757576
NODE_180969_length_291_cov_14.791667	125	205	0	80	80	1.0000000
NODE_180969_length_291_cov_14.791667	178	258	0	80	80	1.0000000
NODE_180983_length_291_cov_5.536458	97	169	0	72	72	1.0000000
NODE_180986_length_291_cov_5.401042	77	130	0	53	53	1.0000000
NODE_180998_length_291_cov_4.859375	185	257	4	1	72	0.0138889
NODE_180998_length_291_cov_4.859375	185	257	6	4	72	0.0555556
NODE_180998_length_291_cov_4.859375	185	257	8	67	72	0.9305556
NODE_181043_length_291_cov_3.723958	196	276	4	80	80	1.0000000
NODE_181057_length_291_cov_3.531250	129	152	2	23	23	1.0000000
NODE_181191_length_291_cov_2.390625	18	80	0	61	62	0.9838710
NODE_181191_length_291_cov_2.390625	18	80	2	1	62	0.0161290
NODE_181272_length_291_cov_2.125000	70	117	0	47	47	1.0000000
NODE_181391_length_291_cov_1.859375	197	228	2	31	31	1.0000000
NODE_181497_length_291_cov_1.593750	144	175	0	20	31	0.6451613
NODE_181497_length_291_cov_1.593750	144	175	2	11	31	0.3548387
NODE_181530_length_291_cov_1.593750	206	281	2	75	75	1.0000000
NODE_181599_length_291_cov_1.552083	189	269	0	12	80	0.1500000
NODE_181599_length_291_cov_1.552083	189	269	1	13	80	0.1625000
NODE_181599_length_291_cov_1.552083	189	269	2	11	80	0.1375000
NODE_181599_length_291_cov_1.552083	189	269	3	44	80	0.5500000
NODE_181615_length_291_cov_1.520833	180	258	0	78	78	1.0000000
NODE_181623_length_291_cov_1.510417	245	291	0	46	46	1.0000000
NODE_181696_length_291_cov_1.385417	80	120	0	25	40	0.6250000
NODE_181696_length_291_cov_1.385417	80	120	2	15	40	0.3750000
NODE_181791_length_291_cov_1.322917	70	96	0	26	26	1.0000000
NODE_181799_length_291_cov_1.307292	108	188	2	23	80	0.2875000
NODE_181799_length_291_cov_1.307292	108	188	4	7	80	0.0875000
NODE_181799_length_291_cov_1.307292	108	188	6	17	80	0.2125000
NODE_181799_length_291_cov_1.307292	108	188	8	8	80	0.1000000
NODE_181799_length_291_cov_1.307292	108	188	14	2	80	0.0250000
NODE_181799_length_291_cov_1.307292	108	188	18	8	80	0.1000000
NODE_181799_length_291_cov_1.307292	108	188	20	15	80	0.1875000
NODE_181907_length_291_cov_1.114583	79	174	32	2	95	0.0210526
NODE_181907_length_291_cov_1.114583	79	174	33	2	95	0.0210526
NODE_181907_length_291_cov_1.114583	79	174	35	4	95	0.0421053
NODE_181907_length_291_cov_1.114583	79	174	37	2	95	0.0210526
NODE_181907_length_291_cov_1.114583	79	174	41	1	95	0.0105263
NODE_181907_length_291_cov_1.114583	79	174	47	1	95	0.0105263
NODE_181907_length_291_cov_1.114583	79	174	50	1	95	0.0105263
NODE_181907_length_291_cov_1.114583	79	174	53	3	95	0.0315789
NODE_181907_length_291_cov_1.114583	79	174	55	2	95	0.0210526
NODE_181907_length_291_cov_1.114583	79	174	57	13	95	0.1368421
NODE_181907_length_291_cov_1.114583	79	174	59	8	95	0.0842105
NODE_181907_length_291_cov_1.114583	79	174	61	9	95	0.0947368
NODE_181907_length_291_cov_1.114583	79	174	63	19	95	0.2000000
NODE_181907_length_291_cov_1.114583	79	174	64	28	95	0.2947368
NODE_181930_length_291_cov_1.078125	4	85	0	40	81	0.4938272
NODE_181930_length_291_cov_1.078125	4	85	2	8	81	0.0987654
NODE_181930_length_291_cov_1.078125	4	85	4	10	81	0.1234568
NODE_181930_length_291_cov_1.078125	4	85	8	23	81	0.2839506
NODE_182112_length_291_cov_1.031250	5	50	0	45	45	1.0000000
NODE_182205_length_291_cov_0.890625	0	55	0	30	55	0.5454546
NODE_182205_length_291_cov_0.890625	0	55	2	25	55	0.4545455
NODE_182252_length_291_cov_0.802083	80	160	1	9	80	0.1125000
NODE_182252_length_291_cov_0.802083	80	160	3	52	80	0.6500000
NODE_182252_length_291_cov_0.802083	80	160	4	2	80	0.0250000
NODE_182252_length_291_cov_0.802083	80	160	5	10	80	0.1250000
NODE_182252_length_291_cov_0.802083	80	160	7	1	80	0.0125000
NODE_182252_length_291_cov_0.802083	80	160	9	6	80	0.0750000
NODE_182491_length_290_cov_96.963351	44	124	0	80	80	1.0000000
NODE_182491_length_290_cov_96.963351	97	177	0	80	80	1.0000000
NODE_182512_length_290_cov_5.968586	89	150	0	15	61	0.2459016
NODE_182512_length_290_cov_5.968586	89	150	2	15	61	0.2459016
NODE_182512_length_290_cov_5.968586	89	150	4	3	61	0.0491803
NODE_182512_length_290_cov_5.968586	89	150	6	28	61	0.4590164
NODE_182512_length_290_cov_5.968586	142	203	6	31	61	0.5081967
NODE_182512_length_290_cov_5.968586	142	203	8	4	61	0.0655738
NODE_182512_length_290_cov_5.968586	142	203	10	15	61	0.2459016
NODE_182512_length_290_cov_5.968586	142	203	12	11	61	0.1803279
NODE_182535_length_290_cov_4.968586	32	52	2	20	20	1.0000000
NODE_182535_length_290_cov_4.968586	73	93	2	20	20	1.0000000
NODE_182547_length_290_cov_4.670157	63	139	2	76	76	1.0000000
NODE_182550_length_290_cov_4.575916	110	153	0	43	43	1.0000000
NODE_182589_length_290_cov_3.816754	113	186	0	73	73	1.0000000
NODE_182607_length_290_cov_3.612565	114	181	2	30	67	0.4477612
NODE_182607_length_290_cov_3.612565	114	181	4	37	67	0.5522388
NODE_182622_length_290_cov_3.445026	91	150	0	59	59	1.0000000
NODE_182772_length_290_cov_2.596859	189	218	2	29	29	1.0000000
NODE_182844_length_290_cov_2.319372	45	74	2	29	29	1.0000000
NODE_182973_length_290_cov_2.041885	59	139	2	13	80	0.1625000
NODE_182973_length_290_cov_2.041885	59	139	4	67	80	0.8375000
NODE_182995_length_290_cov_1.979058	229	271	18	4	42	0.0952381
NODE_182995_length_290_cov_1.979058	229	271	22	1	42	0.0238095
NODE_182995_length_290_cov_1.979058	229	271	24	3	42	0.0714286
NODE_182995_length_290_cov_1.979058	229	271	25	3	42	0.0714286
NODE_182995_length_290_cov_1.979058	229	271	27	1	42	0.0238095
NODE_182995_length_290_cov_1.979058	229	271	29	2	42	0.0476190
NODE_182995_length_290_cov_1.979058	229	271	30	3	42	0.0714286
NODE_182995_length_290_cov_1.979058	229	271	32	5	42	0.1190476
NODE_182995_length_290_cov_1.979058	229	271	34	20	42	0.4761905
NODE_183288_length_290_cov_1.602094	16	68	0	52	52	1.0000000
NODE_183347_length_290_cov_1.575916	173	250	0	77	77	1.0000000
NODE_183373_length_290_cov_1.544503	151	203	0	11	52	0.2115385
NODE_183373_length_290_cov_1.544503	151	203	2	38	52	0.7307692
NODE_183373_length_290_cov_1.544503	151	203	4	3	52	0.0576923
NODE_183403_length_290_cov_1.513089	22	107	0	85	85	1.0000000
NODE_183436_length_290_cov_1.460733	11	91	2	5	80	0.0625000
NODE_183436_length_290_cov_1.460733	11	91	4	75	80	0.9375000
NODE_183546_length_290_cov_1.335079	91	163	2	16	72	0.2222222
NODE_183546_length_290_cov_1.335079	91	163	4	12	72	0.1666667
NODE_183546_length_290_cov_1.335079	91	163	6	44	72	0.6111111
NODE_183546_length_290_cov_1.335079	144	216	2	19	72	0.2638889
NODE_183546_length_290_cov_1.335079	144	216	4	22	72	0.3055556
NODE_183546_length_290_cov_1.335079	144	216	6	14	72	0.1944444
NODE_183546_length_290_cov_1.335079	144	216	10	17	72	0.2361111
NODE_183642_length_290_cov_1.314136	0	80	0	80	80	1.0000000
NODE_183663_length_290_cov_1.287958	17	97	0	80	80	1.0000000
NODE_183946_length_290_cov_1.068063	0	60	0	60	60	1.0000000
NODE_183946_length_290_cov_1.068063	33	113	0	80	80	1.0000000
NODE_184119_length_290_cov_1.000000	198	254	56	1	56	0.0178571
NODE_184119_length_290_cov_1.000000	198	254	62	1	56	0.0178571
NODE_184119_length_290_cov_1.000000	198	254	64	1	56	0.0178571
NODE_184119_length_290_cov_1.000000	198	254	66	1	56	0.0178571
NODE_184119_length_290_cov_1.000000	198	254	68	11	56	0.1964286
NODE_184119_length_290_cov_1.000000	198	254	70	18	56	0.3214286
NODE_184119_length_290_cov_1.000000	198	254	72	1	56	0.0178571
NODE_184119_length_290_cov_1.000000	198	254	74	18	56	0.3214286
NODE_184119_length_290_cov_1.000000	198	254	76	4	56	0.0714286
NODE_184326_length_290_cov_0.832461	154	236	2	82	82	1.0000000
NODE_184585_length_290_cov_0.701571	201	281	0	80	80	1.0000000
NODE_184716_length_289_cov_554.947368	45	125	171	3	80	0.0375000
NODE_184716_length_289_cov_554.947368	45	125	174	1	80	0.0125000
NODE_184716_length_289_cov_554.947368	45	125	176	1	80	0.0125000
NODE_184716_length_289_cov_554.947368	45	125	182	1	80	0.0125000
NODE_184716_length_289_cov_554.947368	45	125	184	1	80	0.0125000
NODE_184716_length_289_cov_554.947368	45	125	186	1	80	0.0125000
NODE_184716_length_289_cov_554.947368	45	125	188	3	80	0.0375000
NODE_184716_length_289_cov_554.947368	45	125	194	1	80	0.0125000
NODE_184716_length_289_cov_554.947368	45	125	196	1	80	0.0125000
NODE_184716_length_289_cov_554.947368	45	125	198	7	80	0.0875000
NODE_184716_length_289_cov_554.947368	45	125	202	1	80	0.0125000
NODE_184716_length_289_cov_554.947368	45	125	204	2	80	0.0250000
NODE_184716_length_289_cov_554.947368	45	125	206	3	80	0.0375000
NODE_184716_length_289_cov_554.947368	45	125	208	2	80	0.0250000
NODE_184716_length_289_cov_554.947368	45	125	209	1	80	0.0125000
NODE_184716_length_289_cov_554.947368	45	125	210	2	80	0.0250000
NODE_184716_length_289_cov_554.947368	45	125	211	4	80	0.0500000
NODE_184716_length_289_cov_554.947368	45	125	213	3	80	0.0375000
NODE_184716_length_289_cov_554.947368	45	125	215	3	80	0.0375000
NODE_184716_length_289_cov_554.947368	45	125	216	3	80	0.0375000
NODE_184716_length_289_cov_554.947368	45	125	217	13	80	0.1625000
NODE_184716_length_289_cov_554.947368	45	125	218	2	80	0.0250000
NODE_184716_length_289_cov_554.947368	45	125	219	3	80	0.0375000
NODE_184716_length_289_cov_554.947368	45	125	221	1	80	0.0125000
NODE_184716_length_289_cov_554.947368	45	125	223	17	80	0.2125000
NODE_184729_length_289_cov_7.436842	181	229	0	45	48	0.9375000
NODE_184729_length_289_cov_7.436842	181	229	2	3	48	0.0625000
NODE_184745_length_289_cov_5.789474	35	100	2	65	65	1.0000000
NODE_184745_length_289_cov_5.789474	85	153	0	22	68	0.3235294
NODE_184745_length_289_cov_5.789474	85	153	2	46	68	0.6764706
NODE_184745_length_289_cov_5.789474	146	181	0	35	35	1.0000000
NODE_184781_length_289_cov_4.515789	192	254	0	62	62	1.0000000
NODE_184806_length_289_cov_4.136842	101	148	4	47	47	1.0000000
NODE_184892_length_289_cov_2.973684	38	83	0	45	45	1.0000000
NODE_184960_length_289_cov_2.678947	105	168	4	24	63	0.3809524
NODE_184960_length_289_cov_2.678947	105	168	5	3	63	0.0476190
NODE_184960_length_289_cov_2.678947	105	168	6	7	63	0.1111111
NODE_184960_length_289_cov_2.678947	105	168	7	29	63	0.4603175
NODE_184960_length_289_cov_2.678947	158	204	1	1	46	0.0217391
NODE_184960_length_289_cov_2.678947	158	204	3	21	46	0.4565217
NODE_184960_length_289_cov_2.678947	158	204	5	17	46	0.3695652
NODE_184960_length_289_cov_2.678947	158	204	7	7	46	0.1521739
NODE_184963_length_289_cov_2.673684	216	263	0	47	47	1.0000000
NODE_185036_length_289_cov_2.378947	233	289	0	56	56	1.0000000
NODE_185152_length_289_cov_2.089474	26	91	0	65	65	1.0000000
NODE_185213_length_289_cov_1.921053	0	54	6	9	54	0.1666667
NODE_185213_length_289_cov_1.921053	0	54	8	9	54	0.1666667
NODE_185213_length_289_cov_1.921053	0	54	10	36	54	0.6666667
NODE_185383_length_289_cov_1.642105	58	123	2	65	65	1.0000000
NODE_185570_length_289_cov_1.547368	81	124	2	43	43	1.0000000
NODE_185617_length_289_cov_1.489474	192	274	0	82	82	1.0000000
NODE_185622_length_289_cov_1.484211	50	69	0	19	19	1.0000000
NODE_185708_length_289_cov_1.357895	31	74	0	43	43	1.0000000
NODE_185852_length_289_cov_1.278947	239	270	0	31	31	1.0000000
NODE_185864_length_289_cov_1.252632	23	66	4	43	43	1.0000000
NODE_185926_length_289_cov_1.168421	40	100	0	13	60	0.2166667
NODE_185926_length_289_cov_1.168421	40	100	2	47	60	0.7833334
NODE_185937_length_289_cov_1.152632	0	50	0	50	50	1.0000000
NODE_185937_length_289_cov_1.152632	41	103	0	62	62	1.0000000
NODE_186095_length_289_cov_1.073684	152	198	0	5	46	0.1086956
NODE_186095_length_289_cov_1.073684	152	198	2	41	46	0.8913044
NODE_186491_length_289_cov_0.878947	113	193	2	5	80	0.0625000
NODE_186491_length_289_cov_0.878947	113	193	4	13	80	0.1625000
NODE_186491_length_289_cov_0.878947	113	193	6	16	80	0.2000000
NODE_186491_length_289_cov_0.878947	113	193	8	15	80	0.1875000
NODE_186491_length_289_cov_0.878947	113	193	12	31	80	0.3875000
NODE_186491_length_289_cov_0.878947	166	246	4	14	80	0.1750000
NODE_186491_length_289_cov_0.878947	166	246	8	4	80	0.0500000
NODE_186491_length_289_cov_0.878947	166	246	10	25	80	0.3125000
NODE_186491_length_289_cov_0.878947	166	246	12	37	80	0.4625000
NODE_186507_length_289_cov_0.863158	116	211	3	1	95	0.0105263
NODE_186507_length_289_cov_0.863158	116	211	4	6	95	0.0631579
NODE_186507_length_289_cov_0.863158	116	211	6	1	95	0.0105263
NODE_186507_length_289_cov_0.863158	116	211	8	2	95	0.0210526
NODE_186507_length_289_cov_0.863158	116	211	10	17	95	0.1789474
NODE_186507_length_289_cov_0.863158	116	211	12	4	95	0.0421053
NODE_186507_length_289_cov_0.863158	116	211	14	64	95	0.6736842
NODE_186515_length_289_cov_0.857895	6	75	0	25	69	0.3623188
NODE_186515_length_289_cov_0.857895	6	75	2	44	69	0.6376812
NODE_186547_length_289_cov_0.831579	230	289	0	13	59	0.2203390
NODE_186547_length_289_cov_0.831579	230	289	2	9	59	0.1525424
NODE_186547_length_289_cov_0.831579	230	289	6	16	59	0.2711864
NODE_186547_length_289_cov_0.831579	230	289	9	1	59	0.0169492
NODE_186547_length_289_cov_0.831579	230	289	11	2	59	0.0338983
NODE_186547_length_289_cov_0.831579	230	289	13	4	59	0.0677966
NODE_186547_length_289_cov_0.831579	230	289	15	2	59	0.0338983
NODE_186547_length_289_cov_0.831579	230	289	17	3	59	0.0508475
NODE_186547_length_289_cov_0.831579	230	289	19	2	59	0.0338983
NODE_186547_length_289_cov_0.831579	230	289	21	2	59	0.0338983
NODE_186547_length_289_cov_0.831579	230	289	22	5	59	0.0847458
NODE_186631_length_289_cov_0.805263	98	159	4	7	61	0.1147541
NODE_186631_length_289_cov_0.805263	98	159	8	54	61	0.8852459
NODE_186865_length_289_cov_0.568421	141	213	0	72	72	1.0000000
NODE_186934_length_288_cov_11.089947	135	195	5	26	60	0.4333333
NODE_186934_length_288_cov_11.089947	135	195	7	34	60	0.5666667
NODE_187025_length_288_cov_3.587302	108	188	2	80	80	1.0000000
NODE_187049_length_288_cov_3.296296	61	125	0	64	64	1.0000000
NODE_187049_length_288_cov_3.296296	102	178	0	76	76	1.0000000
NODE_187062_length_288_cov_3.206349	149	202	0	53	53	1.0000000
NODE_187170_length_288_cov_2.539683	4	68	26	1	64	0.0156250
NODE_187170_length_288_cov_2.539683	4	68	28	1	64	0.0156250
NODE_187170_length_288_cov_2.539683	4	68	36	1	64	0.0156250
NODE_187170_length_288_cov_2.539683	4	68	38	2	64	0.0312500
NODE_187170_length_288_cov_2.539683	4	68	42	1	64	0.0156250
NODE_187170_length_288_cov_2.539683	4	68	44	2	64	0.0312500
NODE_187170_length_288_cov_2.539683	4	68	46	19	64	0.2968750
NODE_187170_length_288_cov_2.539683	4	68	48	2	64	0.0312500
NODE_187170_length_288_cov_2.539683	4	68	49	19	64	0.2968750
NODE_187170_length_288_cov_2.539683	4	68	51	9	64	0.1406250
NODE_187170_length_288_cov_2.539683	4	68	53	3	64	0.0468750
NODE_187170_length_288_cov_2.539683	4	68	55	4	64	0.0625000
NODE_187187_length_288_cov_2.465608	137	182	4	17	45	0.3777778
NODE_187187_length_288_cov_2.465608	137	182	6	28	45	0.6222222
NODE_187191_length_288_cov_2.449735	216	278	4	23	62	0.3709677
NODE_187191_length_288_cov_2.449735	216	278	6	39	62	0.6290323
NODE_187191_length_288_cov_2.449735	237	273	4	18	36	0.5000000
NODE_187191_length_288_cov_2.449735	237	273	6	18	36	0.5000000
NODE_187248_length_288_cov_2.275132	10	46	2	36	36	1.0000000
NODE_187248_length_288_cov_2.275132	13	86	0	2	73	0.0273973
NODE_187248_length_288_cov_2.275132	13	86	2	71	73	0.9726027
NODE_187248_length_288_cov_2.275132	47	100	0	16	53	0.3018868
NODE_187248_length_288_cov_2.275132	47	100	2	37	53	0.6981132
NODE_187318_length_288_cov_2.153439	50	81	0	31	31	1.0000000
NODE_187431_length_288_cov_1.915344	0	75	0	75	75	1.0000000
NODE_187443_length_288_cov_1.888889	49	125	0	15	76	0.1973684
NODE_187443_length_288_cov_1.888889	49	125	2	9	76	0.1184211
NODE_187443_length_288_cov_1.888889	49	125	4	18	76	0.2368421
NODE_187443_length_288_cov_1.888889	49	125	6	2	76	0.0263158
NODE_187443_length_288_cov_1.888889	49	125	8	16	76	0.2105263
NODE_187443_length_288_cov_1.888889	49	125	10	16	76	0.2105263
NODE_187484_length_288_cov_1.878307	0	42	0	42	42	1.0000000
NODE_187484_length_288_cov_1.878307	15	63	0	48	48	1.0000000
NODE_187810_length_288_cov_1.492063	0	42	0	42	42	1.0000000
NODE_188135_length_288_cov_1.158730	213	288	0	75	75	1.0000000
NODE_188161_length_288_cov_1.100529	256	288	0	32	32	1.0000000
NODE_188169_length_288_cov_1.079365	10	74	0	64	64	1.0000000
NODE_188169_length_288_cov_1.079365	65	110	0	35	45	0.7777778
NODE_188169_length_288_cov_1.079365	65	110	2	10	45	0.2222222
NODE_188760_length_288_cov_0.809524	141	170	0	24	29	0.8275862
NODE_188760_length_288_cov_0.809524	141	170	2	3	29	0.1034483
NODE_188760_length_288_cov_0.809524	141	170	4	2	29	0.0689655
NODE_189068_length_287_cov_7.632979	117	184	24	3	67	0.0447761
NODE_189068_length_287_cov_7.632979	117	184	26	8	67	0.1194030
NODE_189068_length_287_cov_7.632979	117	184	28	9	67	0.1343284
NODE_189068_length_287_cov_7.632979	117	184	30	47	67	0.7014925
NODE_189079_length_287_cov_6.510638	20	100	0	80	80	1.0000000
NODE_189097_length_287_cov_5.781915	164	246	2	56	82	0.6829268
NODE_189097_length_287_cov_5.781915	164	246	4	26	82	0.3170732
NODE_189182_length_287_cov_3.590426	114	194	0	32	80	0.4000000
NODE_189182_length_287_cov_3.590426	114	194	2	48	80	0.6000000
NODE_189192_length_287_cov_3.452128	0	52	0	52	52	1.0000000
NODE_189208_length_287_cov_3.281915	263	286	0	1	23	0.0434783
NODE_189208_length_287_cov_3.281915	263	286	2	15	23	0.6521739
NODE_189208_length_287_cov_3.281915	263	286	6	7	23	0.3043478
NODE_189266_length_287_cov_2.936170	41	110	0	69	69	1.0000000
NODE_189266_length_287_cov_2.936170	41	111	0	70	70	1.0000000
NODE_189266_length_287_cov_2.936170	94	167	0	19	73	0.2602740
NODE_189266_length_287_cov_2.936170	94	167	6	54	73	0.7397260
NODE_189266_length_287_cov_2.936170	156	179	6	23	23	1.0000000
NODE_189330_length_287_cov_2.638298	22	86	0	64	64	1.0000000
NODE_189381_length_287_cov_2.436170	182	262	0	11	80	0.1375000
NODE_189381_length_287_cov_2.436170	182	262	2	14	80	0.1750000
NODE_189381_length_287_cov_2.436170	182	262	4	55	80	0.6875000
NODE_189582_length_287_cov_1.984043	137	166	14	15	29	0.5172414
NODE_189582_length_287_cov_1.984043	137	166	16	7	29	0.2413793
NODE_189582_length_287_cov_1.984043	137	166	18	4	29	0.1379310
NODE_189582_length_287_cov_1.984043	137	166	20	3	29	0.1034483
NODE_189594_length_287_cov_1.941489	56	123	0	67	67	1.0000000
NODE_189614_length_287_cov_1.904255	8	51	2	12	43	0.2790698
NODE_189614_length_287_cov_1.904255	8	51	4	7	43	0.1627907
NODE_189614_length_287_cov_1.904255	8	51	6	24	43	0.5581396
NODE_189710_length_287_cov_1.803191	146	217	0	71	71	1.0000000
NODE_189843_length_287_cov_1.627660	113	175	9	9	62	0.1451613
NODE_189843_length_287_cov_1.627660	113	175	10	1	62	0.0161290
NODE_189843_length_287_cov_1.627660	113	175	13	9	62	0.1451613
NODE_189843_length_287_cov_1.627660	113	175	14	1	62	0.0161290
NODE_189843_length_287_cov_1.627660	113	175	15	19	62	0.3064516
NODE_189843_length_287_cov_1.627660	113	175	17	9	62	0.1451613
NODE_189843_length_287_cov_1.627660	113	175	19	9	62	0.1451613
NODE_189843_length_287_cov_1.627660	113	175	21	5	62	0.0806452
NODE_189843_length_287_cov_1.627660	148	228	13	3	80	0.0375000
NODE_189843_length_287_cov_1.627660	148	228	15	1	80	0.0125000
NODE_189843_length_287_cov_1.627660	148	228	16	5	80	0.0625000
NODE_189843_length_287_cov_1.627660	148	228	17	44	80	0.5500000
NODE_189843_length_287_cov_1.627660	148	228	18	13	80	0.1625000
NODE_189843_length_287_cov_1.627660	148	228	19	9	80	0.1125000
NODE_189843_length_287_cov_1.627660	148	228	21	5	80	0.0625000
NODE_189864_length_287_cov_1.627660	14	59	0	45	45	1.0000000
NODE_189864_length_287_cov_1.627660	41	112	0	71	71	1.0000000
NODE_189949_length_287_cov_1.574468	150	220	0	70	70	1.0000000
NODE_189985_length_287_cov_1.531915	123	154	0	31	31	1.0000000
NODE_190122_length_287_cov_1.356383	93	147	0	54	54	1.0000000
NODE_190142_length_287_cov_1.356383	135	199	0	1	64	0.0156250
NODE_190142_length_287_cov_1.356383	135	199	2	63	64	0.9843750
NODE_190189_length_287_cov_1.335106	149	201	0	47	52	0.9038461
NODE_190189_length_287_cov_1.335106	149	201	2	5	52	0.0961538
NODE_190654_length_287_cov_1.037234	23	44	0	21	21	1.0000000
NODE_190701_length_287_cov_0.994681	206	225	0	19	19	1.0000000
NODE_190802_length_287_cov_0.898936	0	57	0	7	57	0.1228070
NODE_190802_length_287_cov_0.898936	0	57	2	26	57	0.4561403
NODE_190802_length_287_cov_0.898936	0	57	4	8	57	0.1403509
NODE_190802_length_287_cov_0.898936	0	57	6	2	57	0.0350877
NODE_190802_length_287_cov_0.898936	0	57	8	1	57	0.0175439
NODE_190802_length_287_cov_0.898936	0	57	10	1	57	0.0175439
NODE_190802_length_287_cov_0.898936	0	57	11	1	57	0.0175439
NODE_190802_length_287_cov_0.898936	0	57	16	1	57	0.0175439
NODE_190802_length_287_cov_0.898936	0	57	18	3	57	0.0526316
NODE_190802_length_287_cov_0.898936	0	57	20	3	57	0.0526316
NODE_190802_length_287_cov_0.898936	0	57	22	1	57	0.0175439
NODE_190802_length_287_cov_0.898936	0	57	24	2	57	0.0350877
NODE_190802_length_287_cov_0.898936	0	57	26	1	57	0.0175439
NODE_190873_length_287_cov_0.840426	46	121	0	11	75	0.1466667
NODE_190873_length_287_cov_0.840426	46	121	2	6	75	0.0800000
NODE_190873_length_287_cov_0.840426	46	121	3	6	75	0.0800000
NODE_190873_length_287_cov_0.840426	46	121	4	10	75	0.1333333
NODE_190873_length_287_cov_0.840426	46	121	6	42	75	0.5600000
NODE_191306_length_286_cov_141.540107	4	63	0	59	59	1.0000000
NODE_191389_length_286_cov_3.935829	79	123	2	44	44	1.0000000
NODE_191391_length_286_cov_3.871658	45	121	0	1	76	0.0131579
NODE_191391_length_286_cov_3.871658	45	121	2	75	76	0.9868421
NODE_191391_length_286_cov_3.871658	102	169	2	67	67	1.0000000
NODE_191393_length_286_cov_3.812834	62	142	2	14	80	0.1750000
NODE_191393_length_286_cov_3.812834	62	142	4	66	80	0.8250000
NODE_191430_length_286_cov_3.352941	63	143	0	80	80	1.0000000
NODE_191430_length_286_cov_3.352941	116	196	0	80	80	1.0000000
NODE_191466_length_286_cov_3.101604	217	271	0	29	54	0.5370370
NODE_191466_length_286_cov_3.101604	217	271	2	2	54	0.0370370
NODE_191466_length_286_cov_3.101604	217	271	4	23	54	0.4259259
NODE_191509_length_286_cov_2.823529	56	122	8	7	66	0.1060606
NODE_191509_length_286_cov_2.823529	56	122	12	2	66	0.0303030
NODE_191509_length_286_cov_2.823529	56	122	14	1	66	0.0151515
NODE_191509_length_286_cov_2.823529	56	122	16	1	66	0.0151515
NODE_191509_length_286_cov_2.823529	56	122	20	1	66	0.0151515
NODE_191509_length_286_cov_2.823529	56	122	26	1	66	0.0151515
NODE_191509_length_286_cov_2.823529	56	122	30	1	66	0.0151515
NODE_191509_length_286_cov_2.823529	56	122	32	4	66	0.0606061
NODE_191509_length_286_cov_2.823529	56	122	34	2	66	0.0303030
NODE_191509_length_286_cov_2.823529	56	122	40	1	66	0.0151515
NODE_191509_length_286_cov_2.823529	56	122	46	2	66	0.0303030
NODE_191509_length_286_cov_2.823529	56	122	48	1	66	0.0151515
NODE_191509_length_286_cov_2.823529	56	122	50	1	66	0.0151515
NODE_191509_length_286_cov_2.823529	56	122	52	1	66	0.0151515
NODE_191509_length_286_cov_2.823529	56	122	60	1	66	0.0151515
NODE_191509_length_286_cov_2.823529	56	122	64	1	66	0.0151515
NODE_191509_length_286_cov_2.823529	56	122	66	1	66	0.0151515
NODE_191509_length_286_cov_2.823529	56	122	68	1	66	0.0151515
NODE_191509_length_286_cov_2.823529	56	122	70	1	66	0.0151515
NODE_191509_length_286_cov_2.823529	56	122	74	1	66	0.0151515
NODE_191509_length_286_cov_2.823529	56	122	87	1	66	0.0151515
NODE_191509_length_286_cov_2.823529	56	122	89	1	66	0.0151515
NODE_191509_length_286_cov_2.823529	56	122	92	3	66	0.0454545
NODE_191509_length_286_cov_2.823529	56	122	94	1	66	0.0151515
NODE_191509_length_286_cov_2.823529	56	122	96	1	66	0.0151515
NODE_191509_length_286_cov_2.823529	56	122	100	1	66	0.0151515
NODE_191509_length_286_cov_2.823529	56	122	102	1	66	0.0151515
NODE_191509_length_286_cov_2.823529	56	122	104	1	66	0.0151515
NODE_191509_length_286_cov_2.823529	56	122	106	2	66	0.0303030
NODE_191509_length_286_cov_2.823529	56	122	108	1	66	0.0151515
NODE_191509_length_286_cov_2.823529	56	122	110	7	66	0.1060606
NODE_191509_length_286_cov_2.823529	56	122	112	2	66	0.0303030
NODE_191509_length_286_cov_2.823529	56	122	114	12	66	0.1818182
NODE_191598_length_286_cov_2.438503	151	218	0	37	67	0.5522388
NODE_191598_length_286_cov_2.438503	151	218	2	30	67	0.4477612
NODE_191754_length_286_cov_2.037433	57	138	0	4	81	0.0493827
NODE_191754_length_286_cov_2.037433	57	138	2	31	81	0.3827161
NODE_191754_length_286_cov_2.037433	57	138	4	46	81	0.5679013
NODE_191892_length_286_cov_1.807487	186	232	0	46	46	1.0000000
NODE_191892_length_286_cov_1.807487	239	285	0	46	46	1.0000000
NODE_192100_length_286_cov_1.566845	112	160	2	37	48	0.7708333
NODE_192100_length_286_cov_1.566845	112	160	4	11	48	0.2291667
NODE_192100_length_286_cov_1.566845	165	213	0	22	48	0.4583333
NODE_192100_length_286_cov_1.566845	165	213	2	26	48	0.5416667
NODE_192150_length_286_cov_1.497326	107	160	2	53	53	1.0000000
NODE_192233_length_286_cov_1.363636	20	87	0	67	67	1.0000000
NODE_192302_length_286_cov_1.358289	218	262	2	3	44	0.0681818
NODE_192302_length_286_cov_1.358289	218	262	4	31	44	0.7045454
NODE_192302_length_286_cov_1.358289	218	262	6	10	44	0.2272727
NODE_192357_length_286_cov_1.304813	147	205	4	58	58	1.0000000
NODE_192427_length_286_cov_1.203209	30	76	0	46	46	1.0000000
NODE_192427_length_286_cov_1.203209	49	129	0	56	80	0.7000000
NODE_192427_length_286_cov_1.203209	49	129	2	24	80	0.3000000
NODE_192757_length_286_cov_1.074866	160	220	0	60	60	1.0000000
NODE_193023_length_286_cov_0.871658	218	279	0	61	61	1.0000000
NODE_193038_length_286_cov_0.855615	224	281	0	18	57	0.3157895
NODE_193038_length_286_cov_0.855615	224	281	1	8	57	0.1403509
NODE_193038_length_286_cov_0.855615	224	281	2	3	57	0.0526316
NODE_193038_length_286_cov_0.855615	224	281	4	28	57	0.4912281
NODE_193362_length_286_cov_0.625668	110	190	4	80	80	1.0000000
NODE_193362_length_286_cov_0.625668	163	240	0	26	77	0.3376623
NODE_193362_length_286_cov_0.625668	163	240	1	14	77	0.1818182
NODE_193362_length_286_cov_0.625668	163	240	2	10	77	0.1298701
NODE_193362_length_286_cov_0.625668	163	240	4	27	77	0.3506494
NODE_193481_length_285_cov_7.392473	91	152	0	61	61	1.0000000
NODE_193481_length_285_cov_7.392473	150	184	0	34	34	1.0000000
NODE_193513_length_285_cov_4.650538	0	74	0	74	74	1.0000000
NODE_193513_length_285_cov_4.650538	47	127	0	80	80	1.0000000
NODE_193513_length_285_cov_4.650538	123	203	0	80	80	1.0000000
NODE_193513_length_285_cov_4.650538	176	256	0	80	80	1.0000000
NODE_193532_length_285_cov_4.091398	91	154	0	63	63	1.0000000
NODE_193538_length_285_cov_4.010753	120	201	2	20	81	0.2469136
NODE_193538_length_285_cov_4.010753	120	201	4	61	81	0.7530864
NODE_193547_length_285_cov_3.854839	97	151	0	54	54	1.0000000
NODE_193547_length_285_cov_3.854839	106	153	0	47	47	1.0000000
NODE_193566_length_285_cov_3.607527	197	258	0	48	61	0.7868853
NODE_193566_length_285_cov_3.607527	197	258	2	4	61	0.0655738
NODE_193566_length_285_cov_3.607527	197	258	4	8	61	0.1311475
NODE_193566_length_285_cov_3.607527	197	258	8	1	61	0.0163934
NODE_193624_length_285_cov_3.037634	190	272	0	82	82	1.0000000
NODE_193660_length_285_cov_2.806452	215	279	0	64	64	1.0000000
NODE_193688_length_285_cov_2.736559	106	173	0	67	67	1.0000000
NODE_193784_length_285_cov_2.311828	220	262	0	42	42	1.0000000
NODE_193883_length_285_cov_2.043011	77	150	0	73	73	1.0000000
NODE_193883_length_285_cov_2.043011	155	197	0	42	42	1.0000000
NODE_193978_length_285_cov_1.876344	67	110	2	32	43	0.7441860
NODE_193978_length_285_cov_1.876344	67	110	6	11	43	0.2558140
NODE_194150_length_285_cov_1.645161	112	160	4	8	48	0.1666667
NODE_194150_length_285_cov_1.645161	112	160	6	40	48	0.8333333
NODE_194260_length_285_cov_1.548387	124	172	0	48	48	1.0000000
NODE_194332_length_285_cov_1.456989	210	277	0	6	67	0.0895522
NODE_194332_length_285_cov_1.456989	210	277	2	61	67	0.9104478
NODE_194499_length_285_cov_1.327957	114	191	6	19	77	0.2467532
NODE_194499_length_285_cov_1.327957	114	191	8	3	77	0.0389610
NODE_194499_length_285_cov_1.327957	114	191	10	2	77	0.0259740
NODE_194499_length_285_cov_1.327957	114	191	12	1	77	0.0129870
NODE_194499_length_285_cov_1.327957	114	191	16	3	77	0.0389610
NODE_194499_length_285_cov_1.327957	114	191	18	19	77	0.2467532
NODE_194499_length_285_cov_1.327957	114	191	20	1	77	0.0129870
NODE_194499_length_285_cov_1.327957	114	191	22	29	77	0.3766234
NODE_194865_length_285_cov_1.096774	175	229	0	54	54	1.0000000
NODE_194865_length_285_cov_1.096774	230	271	0	41	41	1.0000000
NODE_195109_length_285_cov_0.924731	128	208	2	72	80	0.9000000
NODE_195109_length_285_cov_0.924731	128	208	4	8	80	0.1000000
NODE_195115_length_285_cov_0.919355	5	65	0	60	60	1.0000000
NODE_195124_length_285_cov_0.913978	6	80	0	74	74	1.0000000
NODE_195124_length_285_cov_0.913978	58	133	0	75	75	1.0000000
NODE_195642_length_284_cov_7.967568	143	207	0	1	64	0.0156250
NODE_195642_length_284_cov_7.967568	143	207	4	1	64	0.0156250
NODE_195642_length_284_cov_7.967568	143	207	6	2	64	0.0312500
NODE_195642_length_284_cov_7.967568	143	207	8	12	64	0.1875000
NODE_195642_length_284_cov_7.967568	143	207	10	11	64	0.1718750
NODE_195642_length_284_cov_7.967568	143	207	12	37	64	0.5781250
NODE_195667_length_284_cov_5.016216	115	169	2	54	54	1.0000000
NODE_195715_length_284_cov_3.913514	26	82	0	56	56	1.0000000
NODE_195760_length_284_cov_3.405405	209	283	0	9	74	0.1216216
NODE_195760_length_284_cov_3.405405	209	283	2	4	74	0.0540541
NODE_195760_length_284_cov_3.405405	209	283	4	5	74	0.0675676
NODE_195760_length_284_cov_3.405405	209	283	6	56	74	0.7567568
NODE_195863_length_284_cov_2.718919	138	162	0	24	24	1.0000000
NODE_195863_length_284_cov_2.718919	138	215	0	77	77	1.0000000
NODE_196090_length_284_cov_2.097297	46	122	0	27	76	0.3552631
NODE_196090_length_284_cov_2.097297	46	122	2	17	76	0.2236842
NODE_196090_length_284_cov_2.097297	46	122	4	32	76	0.4210526
NODE_196253_length_284_cov_1.756757	27	100	0	7	73	0.0958904
NODE_196253_length_284_cov_1.756757	27	100	2	2	73	0.0273973
NODE_196253_length_284_cov_1.756757	27	100	4	8	73	0.1095890
NODE_196253_length_284_cov_1.756757	27	100	6	56	73	0.7671233
NODE_196253_length_284_cov_1.756757	97	153	2	12	56	0.2142857
NODE_196253_length_284_cov_1.756757	97	153	4	11	56	0.1964286
NODE_196253_length_284_cov_1.756757	97	153	6	33	56	0.5892857
NODE_196273_length_284_cov_1.713514	24	59	0	9	35	0.2571429
NODE_196273_length_284_cov_1.713514	24	59	2	26	35	0.7428572
NODE_196372_length_284_cov_1.654054	207	251	0	16	44	0.3636364
NODE_196372_length_284_cov_1.654054	207	251	2	3	44	0.0681818
NODE_196372_length_284_cov_1.654054	207	251	4	1	44	0.0227273
NODE_196372_length_284_cov_1.654054	207	251	6	24	44	0.5454546
NODE_196426_length_284_cov_1.643243	180	239	0	59	59	1.0000000
NODE_196505_length_284_cov_1.540541	148	186	14	5	38	0.1315790
NODE_196505_length_284_cov_1.540541	148	186	18	4	38	0.1052632
NODE_196505_length_284_cov_1.540541	148	186	20	4	38	0.1052632
NODE_196505_length_284_cov_1.540541	148	186	22	6	38	0.1578947
NODE_196505_length_284_cov_1.540541	148	186	26	4	38	0.1052632
NODE_196505_length_284_cov_1.540541	148	186	28	5	38	0.1315790
NODE_196505_length_284_cov_1.540541	148	186	30	1	38	0.0263158
NODE_196505_length_284_cov_1.540541	148	186	33	9	38	0.2368421
NODE_196670_length_284_cov_1.378378	65	145	4	10	80	0.1250000
NODE_196670_length_284_cov_1.378378	65	145	6	28	80	0.3500000
NODE_196670_length_284_cov_1.378378	65	145	8	8	80	0.1000000
NODE_196670_length_284_cov_1.378378	65	145	9	2	80	0.0250000
NODE_196670_length_284_cov_1.378378	65	145	10	6	80	0.0750000
NODE_196670_length_284_cov_1.378378	65	145	12	2	80	0.0250000
NODE_196670_length_284_cov_1.378378	65	145	16	1	80	0.0125000
NODE_196670_length_284_cov_1.378378	65	145	18	11	80	0.1375000
NODE_196670_length_284_cov_1.378378	65	145	20	4	80	0.0500000
NODE_196670_length_284_cov_1.378378	65	145	21	2	80	0.0250000
NODE_196670_length_284_cov_1.378378	65	145	23	1	80	0.0125000
NODE_196670_length_284_cov_1.378378	65	145	26	2	80	0.0250000
NODE_196670_length_284_cov_1.378378	65	145	28	1	80	0.0125000
NODE_196670_length_284_cov_1.378378	65	145	30	1	80	0.0125000
NODE_196670_length_284_cov_1.378378	65	145	32	1	80	0.0125000
NODE_196670_length_284_cov_1.378378	118	165	10	1	47	0.0212766
NODE_196670_length_284_cov_1.378378	118	165	12	2	47	0.0425532
NODE_196670_length_284_cov_1.378378	118	165	16	1	47	0.0212766
NODE_196670_length_284_cov_1.378378	118	165	18	11	47	0.2340426
NODE_196670_length_284_cov_1.378378	118	165	20	4	47	0.0851064
NODE_196670_length_284_cov_1.378378	118	165	21	2	47	0.0425532
NODE_196670_length_284_cov_1.378378	118	165	23	1	47	0.0212766
NODE_196670_length_284_cov_1.378378	118	165	26	2	47	0.0425532
NODE_196670_length_284_cov_1.378378	118	165	28	1	47	0.0212766
NODE_196670_length_284_cov_1.378378	118	165	30	1	47	0.0212766
NODE_196670_length_284_cov_1.378378	118	165	32	1	47	0.0212766
NODE_196670_length_284_cov_1.378378	118	165	38	4	47	0.0851064
NODE_196670_length_284_cov_1.378378	118	165	40	11	47	0.2340426
NODE_196670_length_284_cov_1.378378	118	165	42	2	47	0.0425532
NODE_196670_length_284_cov_1.378378	118	165	44	3	47	0.0638298
NODE_196733_length_284_cov_1.329730	114	170	0	56	56	1.0000000
NODE_197755_length_284_cov_0.686486	13	94	0	25	81	0.3086420
NODE_197755_length_284_cov_0.686486	13	94	2	56	81	0.6913580
NODE_197755_length_284_cov_0.686486	13	94	0	25	81	0.3086420
NODE_197755_length_284_cov_0.686486	13	94	2	56	81	0.6913580
NODE_197755_length_284_cov_0.686486	13	94	0	25	81	0.3086420
NODE_197755_length_284_cov_0.686486	13	94	2	56	81	0.6913580
NODE_197835_length_284_cov_0.551351	167	219	0	52	52	1.0000000
NODE_197936_length_283_cov_4.434783	81	137	35	2	56	0.0357143
NODE_197936_length_283_cov_4.434783	81	137	37	5	56	0.0892857
NODE_197936_length_283_cov_4.434783	81	137	40	13	56	0.2321429
NODE_197936_length_283_cov_4.434783	81	137	42	11	56	0.1964286
NODE_197936_length_283_cov_4.434783	81	137	44	5	56	0.0892857
NODE_197936_length_283_cov_4.434783	81	137	46	1	56	0.0178571
NODE_197936_length_283_cov_4.434783	81	137	48	3	56	0.0535714
NODE_197936_length_283_cov_4.434783	81	137	50	2	56	0.0357143
NODE_197936_length_283_cov_4.434783	81	137	54	1	56	0.0178571
NODE_197936_length_283_cov_4.434783	81	137	56	1	56	0.0178571
NODE_197936_length_283_cov_4.434783	81	137	58	12	56	0.2142857
NODE_197936_length_283_cov_4.434783	114	190	0	6	76	0.0789474
NODE_197936_length_283_cov_4.434783	114	190	2	1	76	0.0131579
NODE_197936_length_283_cov_4.434783	114	190	4	7	76	0.0921053
NODE_197936_length_283_cov_4.434783	114	190	5	6	76	0.0789474
NODE_197936_length_283_cov_4.434783	114	190	6	9	76	0.1184211
NODE_197936_length_283_cov_4.434783	114	190	8	1	76	0.0131579
NODE_197936_length_283_cov_4.434783	114	190	12	6	76	0.0789474
NODE_197936_length_283_cov_4.434783	114	190	14	1	76	0.0131579
NODE_197936_length_283_cov_4.434783	114	190	24	1	76	0.0131579
NODE_197936_length_283_cov_4.434783	114	190	25	2	76	0.0263158
NODE_197936_length_283_cov_4.434783	114	190	27	4	76	0.0526316
NODE_197936_length_283_cov_4.434783	114	190	29	2	76	0.0263158
NODE_197936_length_283_cov_4.434783	114	190	30	1	76	0.0131579
NODE_197936_length_283_cov_4.434783	114	190	31	1	76	0.0131579
NODE_197936_length_283_cov_4.434783	114	190	32	3	76	0.0394737
NODE_197936_length_283_cov_4.434783	114	190	35	4	76	0.0526316
NODE_197936_length_283_cov_4.434783	114	190	37	5	76	0.0657895
NODE_197936_length_283_cov_4.434783	114	190	40	13	76	0.1710526
NODE_197936_length_283_cov_4.434783	114	190	42	3	76	0.0394737
NODE_197936_length_283_cov_4.434783	190	270	2	15	80	0.1875000
NODE_197936_length_283_cov_4.434783	190	270	4	65	80	0.8125000
NODE_197937_length_283_cov_4.429348	104	168	9	16	64	0.2500000
NODE_197937_length_283_cov_4.429348	104	168	10	35	64	0.5468750
NODE_197937_length_283_cov_4.429348	104	168	11	13	64	0.2031250
NODE_197937_length_283_cov_4.429348	104	168	9	16	64	0.2500000
NODE_197937_length_283_cov_4.429348	104	168	10	35	64	0.5468750
NODE_197937_length_283_cov_4.429348	104	168	11	13	64	0.2031250
NODE_197937_length_283_cov_4.429348	141	207	2	6	66	0.0909091
NODE_197937_length_283_cov_4.429348	141	207	4	11	66	0.1666667
NODE_197937_length_283_cov_4.429348	141	207	6	16	66	0.2424242
NODE_197937_length_283_cov_4.429348	141	207	10	33	66	0.5000000
NODE_197937_length_283_cov_4.429348	141	221	2	20	80	0.2500000
NODE_197937_length_283_cov_4.429348	141	221	4	11	80	0.1375000
NODE_197937_length_283_cov_4.429348	141	221	6	16	80	0.2000000
NODE_197937_length_283_cov_4.429348	141	221	10	33	80	0.4125000
NODE_198007_length_283_cov_3.369565	0	35	0	35	35	1.0000000
NODE_198022_length_283_cov_3.309783	47	91	0	44	44	1.0000000
NODE_198081_length_283_cov_2.923913	95	137	4	9	42	0.2142857
NODE_198081_length_283_cov_2.923913	95	137	6	18	42	0.4285714
NODE_198081_length_283_cov_2.923913	95	137	8	15	42	0.3571429
NODE_198081_length_283_cov_2.923913	110	190	6	12	80	0.1500000
NODE_198081_length_283_cov_2.923913	110	190	8	68	80	0.8500000
NODE_198098_length_283_cov_2.782609	120	200	0	10	80	0.1250000
NODE_198098_length_283_cov_2.782609	120	200	2	21	80	0.2625000
NODE_198098_length_283_cov_2.782609	120	200	4	49	80	0.6125000
NODE_198109_length_283_cov_2.771739	29	72	0	43	43	1.0000000
NODE_198171_length_283_cov_2.494565	186	229	0	43	43	1.0000000
NODE_198176_length_283_cov_2.494565	181	238	2	25	57	0.4385965
NODE_198176_length_283_cov_2.494565	181	238	4	32	57	0.5614035
NODE_198271_length_283_cov_2.217391	222	281	0	59	59	1.0000000
NODE_198518_length_283_cov_1.777174	40	120	0	80	80	1.0000000
NODE_198745_length_283_cov_1.543478	125	161	0	3	36	0.0833333
NODE_198745_length_283_cov_1.543478	125	161	5	2	36	0.0555556
NODE_198745_length_283_cov_1.543478	125	161	8	14	36	0.3888889
NODE_198745_length_283_cov_1.543478	125	161	11	1	36	0.0277778
NODE_198745_length_283_cov_1.543478	125	161	12	5	36	0.1388889
NODE_198745_length_283_cov_1.543478	125	161	14	2	36	0.0555556
NODE_198745_length_283_cov_1.543478	125	161	18	1	36	0.0277778
NODE_198745_length_283_cov_1.543478	125	161	20	5	36	0.1388889
NODE_198745_length_283_cov_1.543478	125	161	22	3	36	0.0833333
NODE_198751_length_283_cov_1.538043	182	203	0	21	21	1.0000000
NODE_198986_length_283_cov_1.304348	208	270	30	8	62	0.1290323
NODE_198986_length_283_cov_1.304348	208	270	32	7	62	0.1129032
NODE_198986_length_283_cov_1.304348	208	270	34	8	62	0.1290323
NODE_198986_length_283_cov_1.304348	208	270	36	39	62	0.6290323
NODE_199042_length_283_cov_1.211957	157	234	0	46	77	0.5974026
NODE_199042_length_283_cov_1.211957	157	234	2	31	77	0.4025974
NODE_199070_length_283_cov_1.168478	183	250	6	2	67	0.0298507
NODE_199070_length_283_cov_1.168478	183	250	10	65	67	0.9701493
NODE_199606_length_283_cov_0.918478	146	226	2	9	80	0.1125000
NODE_199606_length_283_cov_0.918478	146	226	4	71	80	0.8875000
NODE_199606_length_283_cov_0.918478	199	279	1	6	80	0.0750000
NODE_199606_length_283_cov_0.918478	199	279	2	44	80	0.5500000
NODE_199606_length_283_cov_0.918478	199	279	4	30	80	0.3750000
NODE_199641_length_283_cov_0.885870	143	205	2	62	62	1.0000000
NODE_199958_length_283_cov_0.706522	119	159	0	40	40	1.0000000
NODE_200085_length_282_cov_51.027322	219	280	0	61	61	1.0000000
NODE_200085_length_282_cov_51.027322	219	282	0	63	63	1.0000000
NODE_200166_length_282_cov_3.901639	38	118	0	80	80	1.0000000
NODE_200166_length_282_cov_3.901639	91	171	0	51	80	0.6375000
NODE_200166_length_282_cov_3.901639	91	171	1	29	80	0.3625000
NODE_200171_length_282_cov_3.874317	96	116	0	20	20	1.0000000
NODE_200201_length_282_cov_3.562842	224	279	0	55	55	1.0000000
NODE_200270_length_282_cov_2.890710	41	123	0	82	82	1.0000000
NODE_200276_length_282_cov_2.846995	26	47	2	21	21	1.0000000
NODE_200304_length_282_cov_2.770492	145	225	4	56	80	0.7000000
NODE_200304_length_282_cov_2.770492	145	225	6	24	80	0.3000000
NODE_200304_length_282_cov_2.770492	198	278	0	6	80	0.0750000
NODE_200304_length_282_cov_2.770492	198	278	2	23	80	0.2875000
NODE_200304_length_282_cov_2.770492	198	278	4	35	80	0.4375000
NODE_200304_length_282_cov_2.770492	198	278	6	16	80	0.2000000
NODE_200329_length_282_cov_2.655738	46	119	2	73	73	1.0000000
NODE_200329_length_282_cov_2.655738	100	159	0	3	59	0.0508475
NODE_200329_length_282_cov_2.655738	100	159	2	56	59	0.9491525
NODE_200335_length_282_cov_2.622951	0	36	0	12	36	0.3333333
NODE_200335_length_282_cov_2.622951	0	36	2	24	36	0.6666667
NODE_200335_length_282_cov_2.622951	9	89	0	3	80	0.0375000
NODE_200335_length_282_cov_2.622951	9	89	2	35	80	0.4375000
NODE_200335_length_282_cov_2.622951	9	89	6	9	80	0.1125000
NODE_200335_length_282_cov_2.622951	9	89	7	1	80	0.0125000
NODE_200335_length_282_cov_2.622951	9	89	8	32	80	0.4000000
NODE_200336_length_282_cov_2.622951	38	111	0	27	73	0.3698630
NODE_200336_length_282_cov_2.622951	38	111	2	46	73	0.6301370
NODE_200336_length_282_cov_2.622951	98	144	0	33	46	0.7173913
NODE_200336_length_282_cov_2.622951	98	144	2	13	46	0.2826087
NODE_200367_length_282_cov_2.508197	138	186	0	48	48	1.0000000
NODE_200367_length_282_cov_2.508197	191	234	0	43	43	1.0000000
NODE_200425_length_282_cov_2.289617	68	137	2	12	69	0.1739130
NODE_200425_length_282_cov_2.289617	68	137	4	57	69	0.8260869
NODE_200443_length_282_cov_2.229508	169	249	0	60	80	0.7500000
NODE_200443_length_282_cov_2.229508	169	249	4	20	80	0.2500000
NODE_200501_length_282_cov_2.163934	138	192	0	54	54	1.0000000
NODE_200634_length_282_cov_1.901639	149	216	8	32	67	0.4776119
NODE_200634_length_282_cov_1.901639	149	216	10	35	67	0.5223880
NODE_200924_length_282_cov_1.612022	123	162	2	39	39	1.0000000
NODE_201084_length_282_cov_1.393443	158	225	0	35	67	0.5223880
NODE_201084_length_282_cov_1.393443	158	225	2	23	67	0.3432836
NODE_201084_length_282_cov_1.393443	158	225	4	9	67	0.1343284
NODE_201219_length_282_cov_1.273224	91	140	0	49	49	1.0000000
NODE_201413_length_282_cov_1.114754	5	53	0	32	48	0.6666667
NODE_201413_length_282_cov_1.114754	5	53	2	16	48	0.3333333
NODE_202284_length_281_cov_7.895604	165	210	12	1	45	0.0222222
NODE_202284_length_281_cov_7.895604	165	210	14	1	45	0.0222222
NODE_202284_length_281_cov_7.895604	165	210	16	6	45	0.1333333
NODE_202284_length_281_cov_7.895604	165	210	18	18	45	0.4000000
NODE_202284_length_281_cov_7.895604	165	210	20	18	45	0.4000000
NODE_202284_length_281_cov_7.895604	165	210	26	1	45	0.0222222
NODE_202284_length_281_cov_7.895604	183	263	4	3	80	0.0375000
NODE_202284_length_281_cov_7.895604	183	263	12	5	80	0.0625000
NODE_202284_length_281_cov_7.895604	183	263	14	16	80	0.2000000
NODE_202284_length_281_cov_7.895604	183	263	16	16	80	0.2000000
NODE_202284_length_281_cov_7.895604	183	263	18	30	80	0.3750000
NODE_202284_length_281_cov_7.895604	183	263	20	10	80	0.1250000
NODE_202294_length_281_cov_6.379121	151	231	0	80	80	1.0000000
NODE_202333_length_281_cov_4.565934	71	127	0	56	56	1.0000000
NODE_202337_length_281_cov_4.494505	211	261	4	50	50	1.0000000
NODE_202356_length_281_cov_4.219780	85	135	0	50	50	1.0000000
NODE_202356_length_281_cov_4.219780	145	188	0	43	43	1.0000000
NODE_202401_length_281_cov_3.620879	245	281	0	36	36	1.0000000
NODE_202421_length_281_cov_3.324176	104	161	0	34	57	0.5964912
NODE_202421_length_281_cov_3.324176	104	161	2	23	57	0.4035088
NODE_202421_length_281_cov_3.324176	112	192	0	65	80	0.8125000
NODE_202421_length_281_cov_3.324176	112	192	2	15	80	0.1875000
NODE_202436_length_281_cov_3.197802	6	80	0	74	74	1.0000000
NODE_202473_length_281_cov_2.923077	92	150	0	58	58	1.0000000
NODE_202650_length_281_cov_2.241758	5	58	0	53	53	1.0000000
NODE_202712_length_281_cov_2.120879	56	136	0	19	80	0.2375000
NODE_202712_length_281_cov_2.120879	56	136	2	61	80	0.7625000
NODE_202788_length_281_cov_1.961538	199	270	0	71	71	1.0000000
NODE_203008_length_281_cov_1.675824	147	199	2	3	52	0.0576923
NODE_203008_length_281_cov_1.675824	147	199	4	49	52	0.9423077
NODE_203008_length_281_cov_1.675824	178	198	4	20	20	1.0000000
NODE_203008_length_281_cov_1.675824	200	241	0	12	41	0.2926829
NODE_203008_length_281_cov_1.675824	200	241	2	23	41	0.5609756
NODE_203008_length_281_cov_1.675824	200	241	4	6	41	0.1463415
NODE_203065_length_281_cov_1.653846	29	65	0	36	36	1.0000000
NODE_203168_length_281_cov_1.483516	85	135	0	50	50	1.0000000
NODE_203168_length_281_cov_1.483516	86	166	0	80	80	1.0000000
NODE_203168_length_281_cov_1.483516	139	184	0	45	45	1.0000000
NODE_203183_length_281_cov_1.461538	223	276	0	53	53	1.0000000
NODE_203262_length_281_cov_1.401099	237	281	0	44	44	1.0000000
NODE_203281_length_281_cov_1.401099	150	214	0	24	64	0.3750000
NODE_203281_length_281_cov_1.401099	150	214	2	6	64	0.0937500
NODE_203281_length_281_cov_1.401099	150	214	4	34	64	0.5312500
NODE_203281_length_281_cov_1.401099	187	267	0	77	80	0.9625000
NODE_203281_length_281_cov_1.401099	187	267	2	3	80	0.0375000
NODE_203292_length_281_cov_1.401099	31	111	0	80	80	1.0000000
NODE_203440_length_281_cov_1.186813	0	79	0	20	79	0.2531646
NODE_203440_length_281_cov_1.186813	0	79	5	14	79	0.1772152
NODE_203440_length_281_cov_1.186813	0	79	7	14	79	0.1772152
NODE_203440_length_281_cov_1.186813	0	79	9	1	79	0.0126582
NODE_203440_length_281_cov_1.186813	0	79	13	2	79	0.0253165
NODE_203440_length_281_cov_1.186813	0	79	15	1	79	0.0126582
NODE_203440_length_281_cov_1.186813	0	79	17	3	79	0.0379747
NODE_203440_length_281_cov_1.186813	0	79	18	4	79	0.0506329
NODE_203440_length_281_cov_1.186813	0	79	22	4	79	0.0506329
NODE_203440_length_281_cov_1.186813	0	79	24	8	79	0.1012658
NODE_203440_length_281_cov_1.186813	0	79	26	8	79	0.1012658
NODE_203440_length_281_cov_1.186813	52	132	17	3	80	0.0375000
NODE_203440_length_281_cov_1.186813	52	132	18	4	80	0.0500000
NODE_203440_length_281_cov_1.186813	52	132	22	4	80	0.0500000
NODE_203440_length_281_cov_1.186813	52	132	24	8	80	0.1000000
NODE_203440_length_281_cov_1.186813	52	132	26	9	80	0.1125000
NODE_203440_length_281_cov_1.186813	52	132	28	4	80	0.0500000
NODE_203440_length_281_cov_1.186813	52	132	30	2	80	0.0250000
NODE_203440_length_281_cov_1.186813	52	132	32	2	80	0.0250000
NODE_203440_length_281_cov_1.186813	52	132	34	44	80	0.5500000
NODE_203516_length_281_cov_1.120879	47	82	0	1	35	0.0285714
NODE_203516_length_281_cov_1.120879	47	82	2	34	35	0.9714286
NODE_203534_length_281_cov_1.120879	243	276	0	33	33	1.0000000
NODE_203544_length_281_cov_1.120879	216	281	0	65	65	1.0000000
NODE_203785_length_281_cov_1.060440	139	179	14	2	40	0.0500000
NODE_203785_length_281_cov_1.060440	139	179	16	22	40	0.5500000
NODE_203785_length_281_cov_1.060440	139	179	18	4	40	0.1000000
NODE_203785_length_281_cov_1.060440	139	179	20	12	40	0.3000000
NODE_204094_length_281_cov_0.840659	72	138	4	66	66	1.0000000
NODE_204094_length_281_cov_0.840659	111	191	0	47	80	0.5875000
NODE_204094_length_281_cov_0.840659	111	191	2	6	80	0.0750000
NODE_204094_length_281_cov_0.840659	111	191	4	27	80	0.3375000
NODE_204467_length_280_cov_39.320442	118	198	0	80	80	1.0000000
NODE_204467_length_280_cov_39.320442	181	251	0	70	70	1.0000000
NODE_204468_length_280_cov_34.259669	97	137	0	1	40	0.0250000
NODE_204468_length_280_cov_34.259669	97	137	2	1	40	0.0250000
NODE_204468_length_280_cov_34.259669	97	137	4	3	40	0.0750000
NODE_204468_length_280_cov_34.259669	97	137	5	18	40	0.4500000
NODE_204468_length_280_cov_34.259669	97	137	7	7	40	0.1750000
NODE_204468_length_280_cov_34.259669	97	137	8	1	40	0.0250000
NODE_204468_length_280_cov_34.259669	97	137	10	3	40	0.0750000
NODE_204468_length_280_cov_34.259669	97	137	11	2	40	0.0500000
NODE_204468_length_280_cov_34.259669	97	137	12	4	40	0.1000000
NODE_204532_length_280_cov_4.287293	53	100	0	47	47	1.0000000
NODE_204532_length_280_cov_4.287293	129	186	0	57	57	1.0000000
NODE_204596_length_280_cov_3.436464	34	103	27	1	69	0.0144928
NODE_204596_length_280_cov_3.436464	34	103	30	3	69	0.0434783
NODE_204596_length_280_cov_3.436464	34	103	32	2	69	0.0289855
NODE_204596_length_280_cov_3.436464	34	103	36	12	69	0.1739130
NODE_204596_length_280_cov_3.436464	34	103	38	1	69	0.0144928
NODE_204596_length_280_cov_3.436464	34	103	40	1	69	0.0144928
NODE_204596_length_280_cov_3.436464	34	103	48	2	69	0.0289855
NODE_204596_length_280_cov_3.436464	34	103	50	1	69	0.0144928
NODE_204596_length_280_cov_3.436464	34	103	52	4	69	0.0579710
NODE_204596_length_280_cov_3.436464	34	103	54	3	69	0.0434783
NODE_204596_length_280_cov_3.436464	34	103	56	8	69	0.1159420
NODE_204596_length_280_cov_3.436464	34	103	58	3	69	0.0434783
NODE_204596_length_280_cov_3.436464	34	103	60	28	69	0.4057971
NODE_204597_length_280_cov_3.430939	17	97	3	1	80	0.0125000
NODE_204597_length_280_cov_3.430939	17	97	4	18	80	0.2250000
NODE_204597_length_280_cov_3.430939	17	97	5	15	80	0.1875000
NODE_204597_length_280_cov_3.430939	17	97	6	1	80	0.0125000
NODE_204597_length_280_cov_3.430939	17	97	8	45	80	0.5625000
NODE_204597_length_280_cov_3.430939	27	97	4	9	70	0.1285714
NODE_204597_length_280_cov_3.430939	27	97	5	15	70	0.2142857
NODE_204597_length_280_cov_3.430939	27	97	6	1	70	0.0142857
NODE_204597_length_280_cov_3.430939	27	97	8	45	70	0.6428571
NODE_204674_length_280_cov_2.988950	118	164	0	46	46	1.0000000
NODE_204938_length_280_cov_2.165746	2	48	0	45	46	0.9782609
NODE_204938_length_280_cov_2.165746	2	48	3	1	46	0.0217391
NODE_204938_length_280_cov_2.165746	6	48	0	41	42	0.9761904
NODE_204938_length_280_cov_2.165746	6	48	3	1	42	0.0238095
NODE_204938_length_280_cov_2.165746	21	101	0	26	80	0.3250000
NODE_204938_length_280_cov_2.165746	21	101	3	54	80	0.6750000
NODE_204938_length_280_cov_2.165746	22	101	0	25	79	0.3164557
NODE_204938_length_280_cov_2.165746	22	101	3	54	79	0.6835443
NODE_204938_length_280_cov_2.165746	32	101	0	15	69	0.2173913
NODE_204938_length_280_cov_2.165746	32	101	3	54	69	0.7826087
NODE_204976_length_280_cov_2.022099	105	148	2	43	43	1.0000000
NODE_204976_length_280_cov_2.022099	121	148	2	27	27	1.0000000
NODE_205044_length_280_cov_1.889503	50	132	0	82	82	1.0000000
NODE_205062_length_280_cov_1.828729	45	75	34	4	30	0.1333333
NODE_205062_length_280_cov_1.828729	45	75	36	2	30	0.0666667
NODE_205062_length_280_cov_1.828729	45	75	38	14	30	0.4666667
NODE_205062_length_280_cov_1.828729	45	75	40	10	30	0.3333333
NODE_205410_length_280_cov_1.425414	17	50	0	33	33	1.0000000
NODE_205410_length_280_cov_1.425414	70	112	4	42	42	1.0000000
NODE_205416_length_280_cov_1.414365	37	97	2	12	60	0.2000000
NODE_205416_length_280_cov_1.414365	37	97	4	48	60	0.8000000
NODE_205633_length_280_cov_1.187845	56	136	0	80	80	1.0000000
NODE_205635_length_280_cov_1.182320	154	234	2	4	80	0.0500000
NODE_205635_length_280_cov_1.182320	154	234	4	1	80	0.0125000
NODE_205635_length_280_cov_1.182320	154	234	6	18	80	0.2250000
NODE_205635_length_280_cov_1.182320	154	234	8	1	80	0.0125000
NODE_205635_length_280_cov_1.182320	154	234	10	45	80	0.5625000
NODE_205635_length_280_cov_1.182320	154	234	12	11	80	0.1375000
NODE_205635_length_280_cov_1.182320	207	280	0	44	73	0.6027398
NODE_205635_length_280_cov_1.182320	207	280	2	6	73	0.0821918
NODE_205635_length_280_cov_1.182320	207	280	4	1	73	0.0136986
NODE_205635_length_280_cov_1.182320	207	280	6	18	73	0.2465753
NODE_205635_length_280_cov_1.182320	207	280	8	1	73	0.0136986
NODE_205635_length_280_cov_1.182320	207	280	10	3	73	0.0410959
NODE_205701_length_280_cov_1.127072	204	265	0	4	61	0.0655738
NODE_205701_length_280_cov_1.127072	204	265	3	16	61	0.2622951
NODE_205701_length_280_cov_1.127072	204	265	5	22	61	0.3606557
NODE_205701_length_280_cov_1.127072	204	265	7	10	61	0.1639344
NODE_205701_length_280_cov_1.127072	204	265	9	4	61	0.0655738
NODE_205701_length_280_cov_1.127072	204	265	11	5	61	0.0819672
NODE_205794_length_280_cov_1.127072	0	39	0	39	39	1.0000000
NODE_205801_length_280_cov_1.127072	218	253	2	35	35	1.0000000
NODE_205894_length_280_cov_1.127072	0	59	0	59	59	1.0000000
NODE_206211_length_280_cov_0.911602	176	256	0	17	80	0.2125000
NODE_206211_length_280_cov_0.911602	176	256	2	63	80	0.7875000
NODE_206211_length_280_cov_0.911602	229	280	0	9	51	0.1764706
NODE_206211_length_280_cov_0.911602	229	280	2	42	51	0.8235294
NODE_206319_length_280_cov_0.845304	211	268	0	57	57	1.0000000
NODE_206531_length_280_cov_0.779006	129	203	8	10	74	0.1351351
NODE_206531_length_280_cov_0.779006	129	203	10	8	74	0.1081081
NODE_206531_length_280_cov_0.779006	129	203	12	3	74	0.0405405
NODE_206531_length_280_cov_0.779006	129	203	14	6	74	0.0810811
NODE_206531_length_280_cov_0.779006	129	203	16	47	74	0.6351351
NODE_206721_length_279_cov_50.005556	51	130	12	5	79	0.0632911
NODE_206721_length_279_cov_50.005556	51	130	14	35	79	0.4430380
NODE_206721_length_279_cov_50.005556	51	130	18	7	79	0.0886076
NODE_206721_length_279_cov_50.005556	51	130	20	32	79	0.4050633
NODE_206721_length_279_cov_50.005556	103	179	2	5	76	0.0657895
NODE_206721_length_279_cov_50.005556	103	179	8	18	76	0.2368421
NODE_206721_length_279_cov_50.005556	103	179	10	12	76	0.1578947
NODE_206721_length_279_cov_50.005556	103	179	12	7	76	0.0921053
NODE_206721_length_279_cov_50.005556	103	179	14	14	76	0.1842105
NODE_206721_length_279_cov_50.005556	103	179	18	7	76	0.0921053
NODE_206721_length_279_cov_50.005556	103	179	20	13	76	0.1710526
NODE_206744_length_279_cov_6.055556	196	228	0	32	32	1.0000000
NODE_206762_length_279_cov_5.166667	197	277	0	80	80	1.0000000
NODE_206788_length_279_cov_4.427778	107	187	0	55	80	0.6875000
NODE_206788_length_279_cov_4.427778	107	187	2	25	80	0.3125000
NODE_206879_length_279_cov_3.200000	205	225	0	20	20	1.0000000
NODE_206886_length_279_cov_3.116667	115	195	0	80	80	1.0000000
NODE_206886_length_279_cov_3.116667	168	248	0	80	80	1.0000000
NODE_206972_length_279_cov_2.600000	67	147	4	70	80	0.8750000
NODE_206972_length_279_cov_2.600000	67	147	6	10	80	0.1250000
NODE_206972_length_279_cov_2.600000	120	199	0	8	79	0.1012658
NODE_206972_length_279_cov_2.600000	120	199	2	1	79	0.0126582
NODE_206972_length_279_cov_2.600000	120	199	4	70	79	0.8860760
NODE_207023_length_279_cov_2.427778	155	199	0	10	44	0.2272727
NODE_207023_length_279_cov_2.427778	155	199	2	2	44	0.0454545
NODE_207023_length_279_cov_2.427778	155	199	4	32	44	0.7272727
NODE_207052_length_279_cov_2.283333	168	240	2	11	72	0.1527778
NODE_207052_length_279_cov_2.283333	168	240	4	61	72	0.8472222
NODE_207054_length_279_cov_2.277778	190	265	0	75	75	1.0000000
NODE_207086_length_279_cov_2.266667	66	109	2	30	43	0.6976744
NODE_207086_length_279_cov_2.266667	66	109	4	13	43	0.3023256
NODE_207115_length_279_cov_2.255556	115	176	0	61	61	1.0000000
NODE_207115_length_279_cov_2.255556	168	222	0	54	54	1.0000000
NODE_207155_length_279_cov_2.200000	57	104	2	9	47	0.1914894
NODE_207155_length_279_cov_2.200000	57	104	4	1	47	0.0212766
NODE_207155_length_279_cov_2.200000	57	104	6	3	47	0.0638298
NODE_207155_length_279_cov_2.200000	57	104	8	1	47	0.0212766
NODE_207155_length_279_cov_2.200000	57	104	10	33	47	0.7021276
NODE_207269_length_279_cov_1.977778	0	62	0	62	62	1.0000000
NODE_207293_length_279_cov_1.944444	63	105	0	42	42	1.0000000
NODE_207306_length_279_cov_1.916667	182	262	0	79	80	0.9875000
NODE_207306_length_279_cov_1.916667	182	262	4	1	80	0.0125000
NODE_207318_length_279_cov_1.866667	63	143	0	39	80	0.4875000
NODE_207318_length_279_cov_1.866667	63	143	2	41	80	0.5125000
NODE_207387_length_279_cov_1.700000	8	37	4	11	29	0.3793103
NODE_207387_length_279_cov_1.700000	8	37	6	18	29	0.6206896
NODE_207389_length_279_cov_1.700000	10	42	0	32	32	1.0000000
NODE_207534_length_279_cov_1.672222	103	183	0	25	80	0.3125000
NODE_207534_length_279_cov_1.672222	103	183	2	55	80	0.6875000
NODE_207641_length_279_cov_1.433333	51	110	2	59	59	1.0000000
NODE_207641_length_279_cov_1.433333	83	119	0	1	36	0.0277778
NODE_207641_length_279_cov_1.433333	83	119	2	35	36	0.9722222
NODE_207929_length_279_cov_1.144444	146	211	0	65	65	1.0000000
NODE_207929_length_279_cov_1.144444	184	266	0	82	82	1.0000000
NODE_207931_length_279_cov_1.138889	125	188	14	3	63	0.0476190
NODE_207931_length_279_cov_1.138889	125	188	15	8	63	0.1269841
NODE_207931_length_279_cov_1.138889	125	188	24	4	63	0.0634921
NODE_207931_length_279_cov_1.138889	125	188	30	3	63	0.0476190
NODE_207931_length_279_cov_1.138889	125	188	32	17	63	0.2698413
NODE_207931_length_279_cov_1.138889	125	188	34	24	63	0.3809524
NODE_207931_length_279_cov_1.138889	125	188	36	4	63	0.0634921
NODE_207932_length_279_cov_1.138889	111	191	0	80	80	1.0000000
NODE_207948_length_279_cov_1.133333	231	271	0	40	40	1.0000000
NODE_208183_length_279_cov_1.116667	15	92	0	77	77	1.0000000
NODE_208334_length_279_cov_0.988889	181	261	0	12	80	0.1500000
NODE_208334_length_279_cov_0.988889	181	261	2	68	80	0.8500000
NODE_208410_length_279_cov_0.927778	50	69	0	19	19	1.0000000
NODE_208410_length_279_cov_0.927778	50	69	0	19	19	1.0000000
NODE_208664_length_279_cov_0.844444	35	70	0	3	35	0.0857143
NODE_208664_length_279_cov_0.844444	35	70	1	32	35	0.9142857
NODE_209293_length_278_cov_44.882682	158	210	6	4	52	0.0769231
NODE_209293_length_278_cov_44.882682	158	210	8	6	52	0.1153846
NODE_209293_length_278_cov_44.882682	158	210	12	11	52	0.2115385
NODE_209293_length_278_cov_44.882682	158	210	14	19	52	0.3653846
NODE_209293_length_278_cov_44.882682	158	210	16	3	52	0.0576923
NODE_209293_length_278_cov_44.882682	158	210	17	5	52	0.0961538
NODE_209293_length_278_cov_44.882682	158	210	19	3	52	0.0576923
NODE_209293_length_278_cov_44.882682	158	210	20	1	52	0.0192308
NODE_209293_length_278_cov_44.882682	206	232	4	22	26	0.8461539
NODE_209293_length_278_cov_44.882682	206	232	6	4	26	0.1538462
NODE_209293_length_278_cov_44.882682	206	265	2	27	59	0.4576271
NODE_209293_length_278_cov_44.882682	206	265	4	28	59	0.4745763
NODE_209293_length_278_cov_44.882682	206	265	6	4	59	0.0677966
NODE_209294_length_278_cov_37.474860	0	52	0	41	52	0.7884616
NODE_209294_length_278_cov_37.474860	0	52	1	7	52	0.1346154
NODE_209294_length_278_cov_37.474860	0	52	2	4	52	0.0769231
NODE_209294_length_278_cov_37.474860	48	128	2	33	80	0.4125000
NODE_209294_length_278_cov_37.474860	48	128	8	45	80	0.5625000
NODE_209294_length_278_cov_37.474860	48	128	10	2	80	0.0250000
NODE_209294_length_278_cov_37.474860	101	181	8	25	80	0.3125000
NODE_209294_length_278_cov_37.474860	101	181	10	55	80	0.6875000
NODE_209295_length_278_cov_21.340782	84	164	0	80	80	1.0000000
NODE_209295_length_278_cov_21.340782	137	217	0	80	80	1.0000000
NODE_209360_length_278_cov_4.156425	132	210	12	41	78	0.5256410
NODE_209360_length_278_cov_4.156425	132	210	14	7	78	0.0897436
NODE_209360_length_278_cov_4.156425	132	210	16	16	78	0.2051282
NODE_209360_length_278_cov_4.156425	132	210	18	1	78	0.0128205
NODE_209360_length_278_cov_4.156425	132	210	20	7	78	0.0897436
NODE_209360_length_278_cov_4.156425	132	210	22	6	78	0.0769231
NODE_209360_length_278_cov_4.156425	193	263	0	9	70	0.1285714
NODE_209360_length_278_cov_4.156425	193	263	2	7	70	0.1000000
NODE_209360_length_278_cov_4.156425	193	263	4	3	70	0.0428571
NODE_209360_length_278_cov_4.156425	193	263	5	1	70	0.0142857
NODE_209360_length_278_cov_4.156425	193	263	6	9	70	0.1285714
NODE_209360_length_278_cov_4.156425	193	263	8	1	70	0.0142857
NODE_209360_length_278_cov_4.156425	193	263	10	14	70	0.2000000
NODE_209360_length_278_cov_4.156425	193	263	12	26	70	0.3714286
NODE_209372_length_278_cov_3.977654	142	221	0	3	79	0.0379747
NODE_209372_length_278_cov_3.977654	142	221	2	76	79	0.9620253
NODE_209378_length_278_cov_3.865922	168	210	0	42	42	1.0000000
NODE_209552_length_278_cov_2.558659	93	123	0	30	30	1.0000000
NODE_209565_length_278_cov_2.513966	54	106	0	52	52	1.0000000
NODE_209565_length_278_cov_2.513966	79	158	0	79	79	1.0000000
NODE_209605_length_278_cov_2.296089	127	207	0	21	80	0.2625000
NODE_209605_length_278_cov_2.296089	127	207	2	41	80	0.5125000
NODE_209605_length_278_cov_2.296089	127	207	4	18	80	0.2250000
NODE_209883_length_278_cov_1.731844	145	194	29	1	49	0.0204082
NODE_209883_length_278_cov_1.731844	145	194	33	2	49	0.0408163
NODE_209883_length_278_cov_1.731844	145	194	37	3	49	0.0612245
NODE_209883_length_278_cov_1.731844	145	194	38	6	49	0.1224490
NODE_209883_length_278_cov_1.731844	145	194	40	2	49	0.0408163
NODE_209883_length_278_cov_1.731844	145	194	48	1	49	0.0204082
NODE_209883_length_278_cov_1.731844	145	194	50	3	49	0.0612245
NODE_209883_length_278_cov_1.731844	145	194	52	2	49	0.0408163
NODE_209883_length_278_cov_1.731844	145	194	54	5	49	0.1020408
NODE_209883_length_278_cov_1.731844	145	194	56	7	49	0.1428571
NODE_209883_length_278_cov_1.731844	145	194	58	3	49	0.0612245
NODE_209883_length_278_cov_1.731844	145	194	60	1	49	0.0204082
NODE_209883_length_278_cov_1.731844	145	194	62	4	49	0.0816327
NODE_209883_length_278_cov_1.731844	145	194	63	9	49	0.1836735
NODE_210038_length_278_cov_1.681564	129	184	0	55	55	1.0000000
NODE_210068_length_278_cov_1.636872	13	41	8	2	28	0.0714286
NODE_210068_length_278_cov_1.636872	13	41	10	26	28	0.9285714
NODE_210373_length_278_cov_1.290503	3	67	6	2	64	0.0312500
NODE_210373_length_278_cov_1.290503	3	67	8	6	64	0.0937500
NODE_210373_length_278_cov_1.290503	3	67	9	2	64	0.0312500
NODE_210373_length_278_cov_1.290503	3	67	10	1	64	0.0156250
NODE_210373_length_278_cov_1.290503	3	67	14	2	64	0.0312500
NODE_210373_length_278_cov_1.290503	3	67	16	1	64	0.0156250
NODE_210373_length_278_cov_1.290503	3	67	18	1	64	0.0156250
NODE_210373_length_278_cov_1.290503	3	67	23	2	64	0.0312500
NODE_210373_length_278_cov_1.290503	3	67	27	2	64	0.0312500
NODE_210373_length_278_cov_1.290503	3	67	29	1	64	0.0156250
NODE_210373_length_278_cov_1.290503	3	67	31	2	64	0.0312500
NODE_210373_length_278_cov_1.290503	3	67	33	2	64	0.0312500
NODE_210373_length_278_cov_1.290503	3	67	35	3	64	0.0468750
NODE_210373_length_278_cov_1.290503	3	67	38	6	64	0.0937500
NODE_210373_length_278_cov_1.290503	3	67	40	3	64	0.0468750
NODE_210373_length_278_cov_1.290503	3	67	41	1	64	0.0156250
NODE_210373_length_278_cov_1.290503	3	67	42	2	64	0.0312500
NODE_210373_length_278_cov_1.290503	3	67	44	3	64	0.0468750
NODE_210373_length_278_cov_1.290503	3	67	46	10	64	0.1562500
NODE_210373_length_278_cov_1.290503	3	67	48	10	64	0.1562500
NODE_210373_length_278_cov_1.290503	3	67	50	2	64	0.0312500
NODE_210373_length_278_cov_1.290503	3	67	6	2	64	0.0312500
NODE_210373_length_278_cov_1.290503	3	67	8	6	64	0.0937500
NODE_210373_length_278_cov_1.290503	3	67	9	2	64	0.0312500
NODE_210373_length_278_cov_1.290503	3	67	10	1	64	0.0156250
NODE_210373_length_278_cov_1.290503	3	67	14	2	64	0.0312500
NODE_210373_length_278_cov_1.290503	3	67	16	1	64	0.0156250
NODE_210373_length_278_cov_1.290503	3	67	18	1	64	0.0156250
NODE_210373_length_278_cov_1.290503	3	67	23	2	64	0.0312500
NODE_210373_length_278_cov_1.290503	3	67	27	2	64	0.0312500
NODE_210373_length_278_cov_1.290503	3	67	29	1	64	0.0156250
NODE_210373_length_278_cov_1.290503	3	67	31	2	64	0.0312500
NODE_210373_length_278_cov_1.290503	3	67	33	2	64	0.0312500
NODE_210373_length_278_cov_1.290503	3	67	35	3	64	0.0468750
NODE_210373_length_278_cov_1.290503	3	67	38	6	64	0.0937500
NODE_210373_length_278_cov_1.290503	3	67	40	3	64	0.0468750
NODE_210373_length_278_cov_1.290503	3	67	41	1	64	0.0156250
NODE_210373_length_278_cov_1.290503	3	67	42	2	64	0.0312500
NODE_210373_length_278_cov_1.290503	3	67	44	3	64	0.0468750
NODE_210373_length_278_cov_1.290503	3	67	46	10	64	0.1562500
NODE_210373_length_278_cov_1.290503	3	67	48	10	64	0.1562500
NODE_210373_length_278_cov_1.290503	3	67	50	2	64	0.0312500
NODE_210373_length_278_cov_1.290503	3	67	6	2	64	0.0312500
NODE_210373_length_278_cov_1.290503	3	67	8	6	64	0.0937500
NODE_210373_length_278_cov_1.290503	3	67	9	2	64	0.0312500
NODE_210373_length_278_cov_1.290503	3	67	10	1	64	0.0156250
NODE_210373_length_278_cov_1.290503	3	67	14	2	64	0.0312500
NODE_210373_length_278_cov_1.290503	3	67	16	1	64	0.0156250
NODE_210373_length_278_cov_1.290503	3	67	18	1	64	0.0156250
NODE_210373_length_278_cov_1.290503	3	67	23	2	64	0.0312500
NODE_210373_length_278_cov_1.290503	3	67	27	2	64	0.0312500
NODE_210373_length_278_cov_1.290503	3	67	29	1	64	0.0156250
NODE_210373_length_278_cov_1.290503	3	67	31	2	64	0.0312500
NODE_210373_length_278_cov_1.290503	3	67	33	2	64	0.0312500
NODE_210373_length_278_cov_1.290503	3	67	35	3	64	0.0468750
NODE_210373_length_278_cov_1.290503	3	67	38	6	64	0.0937500
NODE_210373_length_278_cov_1.290503	3	67	40	3	64	0.0468750
NODE_210373_length_278_cov_1.290503	3	67	41	1	64	0.0156250
NODE_210373_length_278_cov_1.290503	3	67	42	2	64	0.0312500
NODE_210373_length_278_cov_1.290503	3	67	44	3	64	0.0468750
NODE_210373_length_278_cov_1.290503	3	67	46	10	64	0.1562500
NODE_210373_length_278_cov_1.290503	3	67	48	10	64	0.1562500
NODE_210373_length_278_cov_1.290503	3	67	50	2	64	0.0312500
NODE_210463_length_278_cov_1.150838	52	76	6	24	24	1.0000000
NODE_210463_length_278_cov_1.150838	58	84	6	26	26	1.0000000
NODE_210559_length_278_cov_1.139665	108	187	0	79	79	1.0000000
NODE_210612_length_278_cov_1.139665	232	278	0	46	46	1.0000000
NODE_210691_length_278_cov_1.139665	210	278	0	68	68	1.0000000
NODE_212166_length_277_cov_2.691011	0	60	0	60	60	1.0000000
NODE_212166_length_277_cov_2.691011	33	113	0	80	80	1.0000000
NODE_212175_length_277_cov_2.617978	85	127	0	15	42	0.3571429
NODE_212175_length_277_cov_2.617978	85	127	2	10	42	0.2380952
NODE_212175_length_277_cov_2.617978	85	127	4	17	42	0.4047619
NODE_212233_length_277_cov_2.438202	137	218	2	81	81	1.0000000
NODE_212357_length_277_cov_2.140449	234	276	0	42	42	1.0000000
NODE_212377_length_277_cov_2.095506	41	114	0	73	73	1.0000000
NODE_212377_length_277_cov_2.095506	41	114	0	73	73	1.0000000
NODE_212377_length_277_cov_2.095506	94	161	0	67	67	1.0000000
NODE_212525_length_277_cov_1.837079	92	172	0	20	80	0.2500000
NODE_212525_length_277_cov_1.837079	92	172	2	60	80	0.7500000
NODE_212558_length_277_cov_1.764045	115	155	0	13	40	0.3250000
NODE_212558_length_277_cov_1.764045	115	155	2	15	40	0.3750000
NODE_212558_length_277_cov_1.764045	115	155	4	2	40	0.0500000
NODE_212558_length_277_cov_1.764045	115	155	6	2	40	0.0500000
NODE_212558_length_277_cov_1.764045	115	155	8	5	40	0.1250000
NODE_212558_length_277_cov_1.764045	115	155	10	3	40	0.0750000
NODE_212605_length_277_cov_1.719101	150	215	0	65	65	1.0000000
NODE_212845_length_277_cov_1.505618	0	47	0	47	47	1.0000000
NODE_212845_length_277_cov_1.505618	20	100	0	80	80	1.0000000
NODE_212970_length_277_cov_1.426966	113	191	4	33	78	0.4230769
NODE_212970_length_277_cov_1.426966	113	191	6	45	78	0.5769231
NODE_213057_length_277_cov_1.314607	127	176	0	49	49	1.0000000
NODE_213091_length_277_cov_1.258427	141	222	0	81	81	1.0000000
NODE_213223_length_277_cov_1.146067	19	95	2	38	76	0.5000000
NODE_213223_length_277_cov_1.146067	19	95	4	3	76	0.0394737
NODE_213223_length_277_cov_1.146067	19	95	8	2	76	0.0263158
NODE_213223_length_277_cov_1.146067	19	95	10	13	76	0.1710526
NODE_213223_length_277_cov_1.146067	19	95	12	6	76	0.0789474
NODE_213223_length_277_cov_1.146067	19	95	16	2	76	0.0263158
NODE_213223_length_277_cov_1.146067	19	95	18	9	76	0.1184211
NODE_213223_length_277_cov_1.146067	19	95	20	2	76	0.0263158
NODE_213223_length_277_cov_1.146067	19	95	22	1	76	0.0131579
NODE_213490_length_277_cov_1.061798	67	105	6	38	38	1.0000000
NODE_213505_length_277_cov_1.044944	19	77	0	58	58	1.0000000
NODE_214572_length_276_cov_31.774011	91	153	15	5	62	0.0806452
NODE_214572_length_276_cov_31.774011	91	153	19	1	62	0.0161290
NODE_214572_length_276_cov_31.774011	91	153	22	4	62	0.0645161
NODE_214572_length_276_cov_31.774011	91	153	23	4	62	0.0645161
NODE_214572_length_276_cov_31.774011	91	153	24	2	62	0.0322581
NODE_214572_length_276_cov_31.774011	91	153	26	2	62	0.0322581
NODE_214572_length_276_cov_31.774011	91	153	28	3	62	0.0483871
NODE_214572_length_276_cov_31.774011	91	153	30	2	62	0.0322581
NODE_214572_length_276_cov_31.774011	91	153	32	1	62	0.0161290
NODE_214572_length_276_cov_31.774011	91	153	38	1	62	0.0161290
NODE_214572_length_276_cov_31.774011	91	153	40	2	62	0.0322581
NODE_214572_length_276_cov_31.774011	91	153	45	2	62	0.0322581
NODE_214572_length_276_cov_31.774011	91	153	54	1	62	0.0161290
NODE_214572_length_276_cov_31.774011	91	153	59	1	62	0.0161290
NODE_214572_length_276_cov_31.774011	91	153	61	1	62	0.0161290
NODE_214572_length_276_cov_31.774011	91	153	66	1	62	0.0161290
NODE_214572_length_276_cov_31.774011	91	153	67	1	62	0.0161290
NODE_214572_length_276_cov_31.774011	91	153	75	1	62	0.0161290
NODE_214572_length_276_cov_31.774011	91	153	76	1	62	0.0161290
NODE_214572_length_276_cov_31.774011	91	153	78	1	62	0.0161290
NODE_214572_length_276_cov_31.774011	91	153	84	1	62	0.0161290
NODE_214572_length_276_cov_31.774011	91	153	88	1	62	0.0161290
NODE_214572_length_276_cov_31.774011	91	153	90	1	62	0.0161290
NODE_214572_length_276_cov_31.774011	91	153	98	1	62	0.0161290
NODE_214572_length_276_cov_31.774011	91	153	106	2	62	0.0322581
NODE_214572_length_276_cov_31.774011	91	153	107	1	62	0.0161290
NODE_214572_length_276_cov_31.774011	91	153	119	1	62	0.0161290
NODE_214572_length_276_cov_31.774011	91	153	121	1	62	0.0161290
NODE_214572_length_276_cov_31.774011	91	153	127	1	62	0.0161290
NODE_214572_length_276_cov_31.774011	91	153	129	1	62	0.0161290
NODE_214572_length_276_cov_31.774011	91	153	145	1	62	0.0161290
NODE_214572_length_276_cov_31.774011	91	153	148	2	62	0.0322581
NODE_214572_length_276_cov_31.774011	91	153	150	1	62	0.0161290
NODE_214572_length_276_cov_31.774011	91	153	154	1	62	0.0161290
NODE_214572_length_276_cov_31.774011	91	153	156	1	62	0.0161290
NODE_214572_length_276_cov_31.774011	91	153	159	2	62	0.0322581
NODE_214572_length_276_cov_31.774011	91	153	161	1	62	0.0161290
NODE_214572_length_276_cov_31.774011	91	153	163	3	62	0.0483871
NODE_214572_length_276_cov_31.774011	91	153	165	1	62	0.0161290
NODE_214572_length_276_cov_31.774011	91	153	167	1	62	0.0161290
NODE_214576_length_276_cov_10.056497	66	146	0	50	80	0.6250000
NODE_214576_length_276_cov_10.056497	66	146	2	3	80	0.0375000
NODE_214576_length_276_cov_10.056497	66	146	6	4	80	0.0500000
NODE_214576_length_276_cov_10.056497	66	146	8	23	80	0.2875000
NODE_214698_length_276_cov_3.564972	176	256	0	80	80	1.0000000
NODE_214785_length_276_cov_2.920904	203	260	0	57	57	1.0000000
NODE_214785_length_276_cov_2.920904	233	276	0	43	43	1.0000000
NODE_214883_length_276_cov_2.542373	164	204	18	3	40	0.0750000
NODE_214883_length_276_cov_2.542373	164	204	20	1	40	0.0250000
NODE_214883_length_276_cov_2.542373	164	204	22	7	40	0.1750000
NODE_214883_length_276_cov_2.542373	164	204	24	15	40	0.3750000
NODE_214883_length_276_cov_2.542373	164	204	26	14	40	0.3500000
NODE_215016_length_276_cov_2.197740	64	144	2	22	80	0.2750000
NODE_215016_length_276_cov_2.197740	64	144	4	58	80	0.7250000
NODE_215086_length_276_cov_2.022599	136	193	0	21	57	0.3684210
NODE_215086_length_276_cov_2.022599	136	193	4	5	57	0.0877193
NODE_215086_length_276_cov_2.022599	136	193	6	9	57	0.1578947
NODE_215086_length_276_cov_2.022599	136	193	10	3	57	0.0526316
NODE_215086_length_276_cov_2.022599	136	193	11	1	57	0.0175439
NODE_215086_length_276_cov_2.022599	136	193	12	17	57	0.2982456
NODE_215086_length_276_cov_2.022599	136	193	14	1	57	0.0175439
NODE_215105_length_276_cov_2.016949	97	138	0	41	41	1.0000000
NODE_215139_length_276_cov_2.005650	82	153	2	36	71	0.5070422
NODE_215139_length_276_cov_2.005650	82	153	4	35	71	0.4929577
NODE_215234_length_276_cov_1.734463	102	182	8	7	80	0.0875000
NODE_215234_length_276_cov_1.734463	102	182	10	4	80	0.0500000
NODE_215234_length_276_cov_1.734463	102	182	14	2	80	0.0250000
NODE_215234_length_276_cov_1.734463	102	182	20	6	80	0.0750000
NODE_215234_length_276_cov_1.734463	102	182	22	6	80	0.0750000
NODE_215234_length_276_cov_1.734463	102	182	26	3	80	0.0375000
NODE_215234_length_276_cov_1.734463	102	182	28	1	80	0.0125000
NODE_215234_length_276_cov_1.734463	102	182	30	2	80	0.0250000
NODE_215234_length_276_cov_1.734463	102	182	32	1	80	0.0125000
NODE_215234_length_276_cov_1.734463	102	182	34	10	80	0.1250000
NODE_215234_length_276_cov_1.734463	102	182	36	10	80	0.1250000
NODE_215234_length_276_cov_1.734463	102	182	40	20	80	0.2500000
NODE_215234_length_276_cov_1.734463	102	182	42	3	80	0.0375000
NODE_215234_length_276_cov_1.734463	102	182	44	5	80	0.0625000
NODE_215516_length_276_cov_1.525424	70	116	0	44	46	0.9565217
NODE_215516_length_276_cov_1.525424	70	116	2	2	46	0.0434783
NODE_215516_length_276_cov_1.525424	123	169	0	46	46	1.0000000
NODE_215519_length_276_cov_1.514124	115	155	30	10	40	0.2500000
NODE_215519_length_276_cov_1.514124	115	155	32	7	40	0.1750000
NODE_215519_length_276_cov_1.514124	115	155	34	23	40	0.5750000
NODE_215748_length_276_cov_1.288136	114	154	14	9	40	0.2250000
NODE_215748_length_276_cov_1.288136	114	154	15	8	40	0.2000000
NODE_215748_length_276_cov_1.288136	114	154	16	23	40	0.5750000
NODE_216141_length_276_cov_1.124294	122	170	0	48	48	1.0000000
NODE_216141_length_276_cov_1.124294	132	163	0	31	31	1.0000000
NODE_216220_length_276_cov_1.039548	7	68	0	17	61	0.2786885
NODE_216220_length_276_cov_1.039548	7	68	4	44	61	0.7213115
NODE_216220_length_276_cov_1.039548	7	70	0	17	63	0.2698413
NODE_216220_length_276_cov_1.039548	7	70	4	46	63	0.7301587
NODE_216220_length_276_cov_1.039548	7	70	0	17	63	0.2698413
NODE_216220_length_276_cov_1.039548	7	70	4	46	63	0.7301587
NODE_216220_length_276_cov_1.039548	7	70	0	17	63	0.2698413
NODE_216220_length_276_cov_1.039548	7	70	4	46	63	0.7301587
NODE_216269_length_276_cov_1.000000	48	89	2	41	41	1.0000000
NODE_216269_length_276_cov_1.000000	62	106	2	44	44	1.0000000
NODE_216414_length_276_cov_0.898305	54	105	0	51	51	1.0000000
NODE_217265_length_275_cov_85.085227	94	174	10	4	80	0.0500000
NODE_217265_length_275_cov_85.085227	94	174	11	7	80	0.0875000
NODE_217265_length_275_cov_85.085227	94	174	12	38	80	0.4750000
NODE_217265_length_275_cov_85.085227	94	174	14	31	80	0.3875000
NODE_217265_length_275_cov_85.085227	147	227	6	45	80	0.5625000
NODE_217265_length_275_cov_85.085227	147	227	10	12	80	0.1500000
NODE_217265_length_275_cov_85.085227	147	227	12	23	80	0.2875000
NODE_217287_length_275_cov_5.818182	0	44	0	39	44	0.8863636
NODE_217287_length_275_cov_5.818182	0	44	8	5	44	0.1136364
NODE_217355_length_275_cov_3.857955	0	67	0	67	67	1.0000000
NODE_217396_length_275_cov_3.306818	199	275	0	76	76	1.0000000
NODE_217402_length_275_cov_3.284091	127	175	0	48	48	1.0000000
NODE_217433_length_275_cov_2.977273	95	145	2	15	50	0.3000000
NODE_217433_length_275_cov_2.977273	95	145	4	35	50	0.7000000
NODE_217531_length_275_cov_2.585227	85	122	108	3	37	0.0810811
NODE_217531_length_275_cov_2.585227	85	122	110	2	37	0.0540541
NODE_217531_length_275_cov_2.585227	85	122	114	13	37	0.3513514
NODE_217531_length_275_cov_2.585227	85	122	120	3	37	0.0810811
NODE_217531_length_275_cov_2.585227	85	122	122	8	37	0.2162162
NODE_217531_length_275_cov_2.585227	85	122	124	2	37	0.0540541
NODE_217531_length_275_cov_2.585227	85	122	126	6	37	0.1621622
NODE_217714_length_275_cov_2.090909	0	47	0	29	47	0.6170213
NODE_217714_length_275_cov_2.090909	0	47	2	18	47	0.3829787
NODE_217714_length_275_cov_2.090909	20	91	0	9	71	0.1267606
NODE_217714_length_275_cov_2.090909	20	91	2	22	71	0.3098592
NODE_217714_length_275_cov_2.090909	20	91	4	40	71	0.5633803
NODE_217801_length_275_cov_1.960227	198	251	0	6	53	0.1132075
NODE_217801_length_275_cov_1.960227	198	251	2	47	53	0.8867925
NODE_217835_length_275_cov_1.875000	190	247	0	57	57	1.0000000
NODE_217839_length_275_cov_1.857955	52	119	2	21	67	0.3134328
NODE_217839_length_275_cov_1.857955	52	119	4	23	67	0.3432836
NODE_217839_length_275_cov_1.857955	52	119	6	8	67	0.1194030
NODE_217839_length_275_cov_1.857955	52	119	8	15	67	0.2238806
NODE_217839_length_275_cov_1.857955	136	182	6	38	46	0.8260869
NODE_217839_length_275_cov_1.857955	136	182	8	8	46	0.1739130
NODE_217885_length_275_cov_1.755682	21	76	4	12	55	0.2181818
NODE_217885_length_275_cov_1.755682	21	76	6	43	55	0.7818182
NODE_217912_length_275_cov_1.738636	225	256	0	31	31	1.0000000
NODE_217967_length_275_cov_1.738636	161	241	2	27	80	0.3375000
NODE_217967_length_275_cov_1.738636	161	241	4	39	80	0.4875000
NODE_217967_length_275_cov_1.738636	161	241	6	14	80	0.1750000
NODE_218257_length_275_cov_1.448864	123	155	18	32	32	1.0000000
NODE_218402_length_275_cov_1.301136	132	196	0	64	64	1.0000000
NODE_218706_length_275_cov_1.159091	13	93	2	23	80	0.2875000
NODE_218706_length_275_cov_1.159091	13	93	4	57	80	0.7125000
NODE_218734_length_275_cov_1.153409	11	91	0	34	80	0.4250000
NODE_218734_length_275_cov_1.153409	11	91	2	46	80	0.5750000
NODE_219031_length_275_cov_0.937500	13	49	12	1	36	0.0277778
NODE_219031_length_275_cov_0.937500	13	49	14	2	36	0.0555556
NODE_219031_length_275_cov_0.937500	13	49	16	1	36	0.0277778
NODE_219031_length_275_cov_0.937500	13	49	18	2	36	0.0555556
NODE_219031_length_275_cov_0.937500	13	49	20	2	36	0.0555556
NODE_219031_length_275_cov_0.937500	13	49	22	2	36	0.0555556
NODE_219031_length_275_cov_0.937500	13	49	24	3	36	0.0833333
NODE_219031_length_275_cov_0.937500	13	49	26	12	36	0.3333333
NODE_219031_length_275_cov_0.937500	13	49	28	1	36	0.0277778
NODE_219031_length_275_cov_0.937500	13	49	30	4	36	0.1111111
NODE_219031_length_275_cov_0.937500	13	49	34	3	36	0.0833333
NODE_219031_length_275_cov_0.937500	13	49	36	3	36	0.0833333
NODE_219031_length_275_cov_0.937500	22	86	22	1	64	0.0156250
NODE_219031_length_275_cov_0.937500	22	86	24	3	64	0.0468750
NODE_219031_length_275_cov_0.937500	22	86	26	12	64	0.1875000
NODE_219031_length_275_cov_0.937500	22	86	28	1	64	0.0156250
NODE_219031_length_275_cov_0.937500	22	86	30	4	64	0.0625000
NODE_219031_length_275_cov_0.937500	22	86	34	8	64	0.1250000
NODE_219031_length_275_cov_0.937500	22	86	36	31	64	0.4843750
NODE_219031_length_275_cov_0.937500	22	86	38	1	64	0.0156250
NODE_219031_length_275_cov_0.937500	22	86	40	1	64	0.0156250
NODE_219031_length_275_cov_0.937500	22	86	42	2	64	0.0312500
NODE_219220_length_275_cov_0.869318	67	126	0	59	59	1.0000000
NODE_219655_length_275_cov_0.579545	40	70	0	14	30	0.4666667
NODE_219655_length_275_cov_0.579545	40	70	2	16	30	0.5333334
NODE_220021_length_274_cov_6.074286	141	175	0	34	34	1.0000000
NODE_220047_length_274_cov_4.845714	48	105	0	57	57	1.0000000
NODE_220047_length_274_cov_4.845714	113	175	0	62	62	1.0000000
NODE_220078_length_274_cov_4.080000	210	274	0	64	64	1.0000000
NODE_220215_length_274_cov_2.988571	104	161	0	13	57	0.2280702
NODE_220215_length_274_cov_2.988571	104	161	2	44	57	0.7719298
NODE_220221_length_274_cov_2.937143	199	234	0	35	35	1.0000000
NODE_220293_length_274_cov_2.622857	29	76	2	1	47	0.0212766
NODE_220293_length_274_cov_2.622857	29	76	4	17	47	0.3617021
NODE_220293_length_274_cov_2.622857	29	76	6	29	47	0.6170213
NODE_220293_length_274_cov_2.622857	82	157	0	75	75	1.0000000
NODE_220413_length_274_cov_2.308571	51	130	8	8	79	0.1012658
NODE_220413_length_274_cov_2.308571	51	130	10	6	79	0.0759494
NODE_220413_length_274_cov_2.308571	51	130	12	2	79	0.0253165
NODE_220413_length_274_cov_2.308571	51	130	16	3	79	0.0379747
NODE_220413_length_274_cov_2.308571	51	130	18	2	79	0.0253165
NODE_220413_length_274_cov_2.308571	51	130	20	2	79	0.0253165
NODE_220413_length_274_cov_2.308571	51	130	24	1	79	0.0126582
NODE_220413_length_274_cov_2.308571	51	130	26	1	79	0.0126582
NODE_220413_length_274_cov_2.308571	51	130	27	1	79	0.0126582
NODE_220413_length_274_cov_2.308571	51	130	31	1	79	0.0126582
NODE_220413_length_274_cov_2.308571	51	130	38	2	79	0.0253165
NODE_220413_length_274_cov_2.308571	51	130	47	1	79	0.0126582
NODE_220413_length_274_cov_2.308571	51	130	52	1	79	0.0126582
NODE_220413_length_274_cov_2.308571	51	130	54	1	79	0.0126582
NODE_220413_length_274_cov_2.308571	51	130	57	1	79	0.0126582
NODE_220413_length_274_cov_2.308571	51	130	61	1	79	0.0126582
NODE_220413_length_274_cov_2.308571	51	130	65	1	79	0.0126582
NODE_220413_length_274_cov_2.308571	51	130	75	1	79	0.0126582
NODE_220413_length_274_cov_2.308571	51	130	82	2	79	0.0253165
NODE_220413_length_274_cov_2.308571	51	130	91	1	79	0.0126582
NODE_220413_length_274_cov_2.308571	51	130	92	1	79	0.0126582
NODE_220413_length_274_cov_2.308571	51	130	96	4	79	0.0506329
NODE_220413_length_274_cov_2.308571	51	130	97	1	79	0.0126582
NODE_220413_length_274_cov_2.308571	51	130	100	1	79	0.0126582
NODE_220413_length_274_cov_2.308571	51	130	102	4	79	0.0506329
NODE_220413_length_274_cov_2.308571	51	130	106	3	79	0.0379747
NODE_220413_length_274_cov_2.308571	51	130	108	4	79	0.0506329
NODE_220413_length_274_cov_2.308571	51	130	112	1	79	0.0126582
NODE_220413_length_274_cov_2.308571	51	130	116	21	79	0.2658228
NODE_220504_length_274_cov_2.062857	172	242	0	44	70	0.6285715
NODE_220504_length_274_cov_2.062857	172	242	2	26	70	0.3714286
NODE_220504_length_274_cov_2.062857	215	256	0	41	41	1.0000000
NODE_220662_length_274_cov_1.754286	219	259	0	40	40	1.0000000
NODE_220681_length_274_cov_1.748571	168	231	0	63	63	1.0000000
NODE_220806_length_274_cov_1.737143	134	172	0	38	38	1.0000000
NODE_220847_length_274_cov_1.685714	132	189	4	57	57	1.0000000
NODE_220847_length_274_cov_1.685714	141	199	4	58	58	1.0000000
NODE_220966_length_274_cov_1.502857	170	232	0	62	62	1.0000000
NODE_220966_length_274_cov_1.502857	223	274	0	51	51	1.0000000
NODE_221005_length_274_cov_1.457143	118	147	0	29	29	1.0000000
NODE_221101_length_274_cov_1.434286	25	69	0	5	44	0.1136364
NODE_221101_length_274_cov_1.434286	25	69	2	7	44	0.1590909
NODE_221101_length_274_cov_1.434286	25	69	4	32	44	0.7272727
NODE_221211_length_274_cov_1.285714	84	156	0	6	72	0.0833333
NODE_221211_length_274_cov_1.285714	84	156	1	1	72	0.0138889
NODE_221211_length_274_cov_1.285714	84	156	2	65	72	0.9027778
NODE_221612_length_274_cov_1.131429	205	251	0	44	46	0.9565217
NODE_221612_length_274_cov_1.131429	205	251	2	2	46	0.0434783
NODE_221764_length_274_cov_0.994286	219	260	0	41	41	1.0000000
NODE_222849_length_273_cov_4.948276	204	262	2	58	58	1.0000000
NODE_222849_length_273_cov_4.948276	204	258	2	54	54	1.0000000
NODE_222914_length_273_cov_3.712644	103	183	0	1	80	0.0125000
NODE_222914_length_273_cov_3.712644	103	183	3	1	80	0.0125000
NODE_222914_length_273_cov_3.712644	103	183	5	5	80	0.0625000
NODE_222914_length_273_cov_3.712644	103	183	9	8	80	0.1000000
NODE_222914_length_273_cov_3.712644	103	183	11	4	80	0.0500000
NODE_222914_length_273_cov_3.712644	103	183	13	14	80	0.1750000
NODE_222914_length_273_cov_3.712644	103	183	15	35	80	0.4375000
NODE_222914_length_273_cov_3.712644	103	183	17	12	80	0.1500000
NODE_222955_length_273_cov_3.298851	69	100	0	31	31	1.0000000
NODE_222955_length_273_cov_3.298851	73	153	0	80	80	1.0000000
NODE_222974_length_273_cov_3.195402	122	189	0	11	67	0.1641791
NODE_222974_length_273_cov_3.195402	122	189	2	56	67	0.8358209
NODE_222991_length_273_cov_3.063218	76	151	7	1	75	0.0133333
NODE_222991_length_273_cov_3.063218	76	151	9	1	75	0.0133333
NODE_222991_length_273_cov_3.063218	76	151	11	5	75	0.0666667
NODE_222991_length_273_cov_3.063218	76	151	13	4	75	0.0533333
NODE_222991_length_273_cov_3.063218	76	151	15	5	75	0.0666667
NODE_222991_length_273_cov_3.063218	76	151	17	3	75	0.0400000
NODE_222991_length_273_cov_3.063218	76	151	19	7	75	0.0933333
NODE_222991_length_273_cov_3.063218	76	151	21	1	75	0.0133333
NODE_222991_length_273_cov_3.063218	76	151	23	2	75	0.0266667
NODE_222991_length_273_cov_3.063218	76	151	25	3	75	0.0400000
NODE_222991_length_273_cov_3.063218	76	151	27	2	75	0.0266667
NODE_222991_length_273_cov_3.063218	76	151	29	1	75	0.0133333
NODE_222991_length_273_cov_3.063218	76	151	33	6	75	0.0800000
NODE_222991_length_273_cov_3.063218	76	151	35	5	75	0.0666667
NODE_222991_length_273_cov_3.063218	76	151	37	5	75	0.0666667
NODE_222991_length_273_cov_3.063218	76	151	39	5	75	0.0666667
NODE_222991_length_273_cov_3.063218	76	151	41	7	75	0.0933333
NODE_222991_length_273_cov_3.063218	76	151	43	6	75	0.0800000
NODE_222991_length_273_cov_3.063218	76	151	45	4	75	0.0533333
NODE_222991_length_273_cov_3.063218	76	151	49	2	75	0.0266667
NODE_222991_length_273_cov_3.063218	135	191	0	22	56	0.3928571
NODE_222991_length_273_cov_3.063218	135	191	5	1	56	0.0178571
NODE_222991_length_273_cov_3.063218	135	191	6	3	56	0.0535714
NODE_222991_length_273_cov_3.063218	135	191	7	15	56	0.2678571
NODE_222991_length_273_cov_3.063218	135	191	9	1	56	0.0178571
NODE_222991_length_273_cov_3.063218	135	191	11	5	56	0.0892857
NODE_222991_length_273_cov_3.063218	135	191	13	4	56	0.0714286
NODE_222991_length_273_cov_3.063218	135	191	15	5	56	0.0892857
NODE_223066_length_273_cov_2.706897	11	45	6	21	34	0.6176471
NODE_223066_length_273_cov_2.706897	11	45	8	13	34	0.3823529
NODE_223203_length_273_cov_2.339080	69	145	10	11	76	0.1447368
NODE_223203_length_273_cov_2.339080	69	145	12	1	76	0.0131579
NODE_223203_length_273_cov_2.339080	69	145	16	3	76	0.0394737
NODE_223203_length_273_cov_2.339080	69	145	17	1	76	0.0131579
NODE_223203_length_273_cov_2.339080	69	145	18	10	76	0.1315790
NODE_223203_length_273_cov_2.339080	69	145	19	1	76	0.0131579
NODE_223203_length_273_cov_2.339080	69	145	20	3	76	0.0394737
NODE_223203_length_273_cov_2.339080	69	145	22	4	76	0.0526316
NODE_223203_length_273_cov_2.339080	69	145	24	1	76	0.0131579
NODE_223203_length_273_cov_2.339080	69	145	26	1	76	0.0131579
NODE_223203_length_273_cov_2.339080	69	145	28	4	76	0.0526316
NODE_223203_length_273_cov_2.339080	69	145	30	36	76	0.4736842
NODE_223353_length_273_cov_2.051724	31	74	0	43	43	1.0000000
NODE_223377_length_273_cov_2.034483	81	161	2	18	80	0.2250000
NODE_223377_length_273_cov_2.034483	81	161	3	4	80	0.0500000
NODE_223377_length_273_cov_2.034483	81	161	4	49	80	0.6125000
NODE_223377_length_273_cov_2.034483	81	161	5	9	80	0.1125000
NODE_223377_length_273_cov_2.034483	213	263	0	15	50	0.3000000
NODE_223377_length_273_cov_2.034483	213	263	1	2	50	0.0400000
NODE_223377_length_273_cov_2.034483	213	263	2	33	50	0.6600000
NODE_223680_length_273_cov_1.706897	181	238	0	57	57	1.0000000
NODE_223913_length_273_cov_1.442529	5	47	0	23	42	0.5476190
NODE_223913_length_273_cov_1.442529	5	47	1	19	42	0.4523810
NODE_224023_length_273_cov_1.281609	167	247	0	80	80	1.0000000
NODE_224082_length_273_cov_1.189655	120	156	0	36	36	1.0000000
NODE_224082_length_273_cov_1.189655	129	160	0	31	31	1.0000000
NODE_224165_length_273_cov_1.172414	94	130	2	29	36	0.8055556
NODE_224165_length_273_cov_1.172414	94	130	4	7	36	0.1944444
NODE_224254_length_273_cov_1.172414	8	58	2	23	50	0.4600000
NODE_224254_length_273_cov_1.172414	8	58	4	5	50	0.1000000
NODE_224254_length_273_cov_1.172414	8	58	6	22	50	0.4400000
NODE_224367_length_273_cov_1.166667	74	93	0	19	19	1.0000000
NODE_224441_length_273_cov_1.091954	6	42	0	3	36	0.0833333
NODE_224441_length_273_cov_1.091954	6	42	2	33	36	0.9166667
NODE_224441_length_273_cov_1.091954	43	95	0	9	52	0.1730769
NODE_224441_length_273_cov_1.091954	43	95	2	43	52	0.8269231
NODE_224587_length_273_cov_0.971264	188	235	0	47	47	1.0000000
NODE_225303_length_273_cov_0.586207	27	88	0	61	61	1.0000000
NODE_225344_length_273_cov_0.586207	24	79	0	2	55	0.0363636
NODE_225344_length_273_cov_0.586207	24	79	2	15	55	0.2727273
NODE_225344_length_273_cov_0.586207	24	79	4	13	55	0.2363636
NODE_225344_length_273_cov_0.586207	24	79	6	25	55	0.4545455
NODE_225344_length_273_cov_0.586207	81	113	6	32	32	1.0000000
NODE_225592_length_272_cov_6.190751	172	236	2	64	64	1.0000000
NODE_225607_length_272_cov_5.335260	193	272	0	79	79	1.0000000
NODE_225633_length_272_cov_4.716763	228	257	0	29	29	1.0000000
NODE_225656_length_272_cov_4.219653	93	166	2	7	73	0.0958904
NODE_225656_length_272_cov_4.219653	93	166	4	4	73	0.0547945
NODE_225656_length_272_cov_4.219653	93	166	6	22	73	0.3013699
NODE_225656_length_272_cov_4.219653	93	166	8	40	73	0.5479452
NODE_225656_length_272_cov_4.219653	146	219	4	24	73	0.3287671
NODE_225656_length_272_cov_4.219653	146	219	6	32	73	0.4383562
NODE_225656_length_272_cov_4.219653	146	219	8	10	73	0.1369863
NODE_225656_length_272_cov_4.219653	146	219	10	7	73	0.0958904
NODE_225658_length_272_cov_4.184971	75	128	0	53	53	1.0000000
NODE_225739_length_272_cov_3.352601	154	199	2	45	45	1.0000000
NODE_225872_length_272_cov_2.664740	106	186	0	80	80	1.0000000
NODE_226010_length_272_cov_2.335260	33	103	0	70	70	1.0000000
NODE_226029_length_272_cov_2.277457	219	256	0	37	37	1.0000000
NODE_226045_length_272_cov_2.236994	104	184	9	2	80	0.0250000
NODE_226045_length_272_cov_2.236994	104	184	13	2	80	0.0250000
NODE_226045_length_272_cov_2.236994	104	184	15	1	80	0.0125000
NODE_226045_length_272_cov_2.236994	104	184	17	2	80	0.0250000
NODE_226045_length_272_cov_2.236994	104	184	19	2	80	0.0250000
NODE_226045_length_272_cov_2.236994	104	184	20	12	80	0.1500000
NODE_226045_length_272_cov_2.236994	104	184	22	4	80	0.0500000
NODE_226045_length_272_cov_2.236994	104	184	24	3	80	0.0375000
NODE_226045_length_272_cov_2.236994	104	184	28	9	80	0.1125000
NODE_226045_length_272_cov_2.236994	104	184	30	6	80	0.0750000
NODE_226045_length_272_cov_2.236994	104	184	32	17	80	0.2125000
NODE_226045_length_272_cov_2.236994	104	184	34	1	80	0.0125000
NODE_226045_length_272_cov_2.236994	104	184	36	3	80	0.0375000
NODE_226045_length_272_cov_2.236994	104	184	38	16	80	0.2000000
NODE_226169_length_272_cov_1.982659	172	252	8	80	80	1.0000000
NODE_226245_length_272_cov_1.780347	37	99	4	58	62	0.9354839
NODE_226245_length_272_cov_1.780347	37	99	6	4	62	0.0645161
NODE_226245_length_272_cov_1.780347	90	152	2	17	62	0.2741936
NODE_226245_length_272_cov_1.780347	90	152	4	45	62	0.7258065
NODE_226248_length_272_cov_1.768786	12	45	0	25	33	0.7575758
NODE_226248_length_272_cov_1.768786	12	45	2	8	33	0.2424242
NODE_226461_length_272_cov_1.618497	97	160	0	13	63	0.2063492
NODE_226461_length_272_cov_1.618497	97	160	2	6	63	0.0952381
NODE_226461_length_272_cov_1.618497	97	160	4	2	63	0.0317460
NODE_226461_length_272_cov_1.618497	97	160	6	3	63	0.0476190
NODE_226461_length_272_cov_1.618497	97	160	8	5	63	0.0793651
NODE_226461_length_272_cov_1.618497	97	160	10	2	63	0.0317460
NODE_226461_length_272_cov_1.618497	97	160	12	4	63	0.0634921
NODE_226461_length_272_cov_1.618497	97	160	14	9	63	0.1428571
NODE_226461_length_272_cov_1.618497	97	160	16	1	63	0.0158730
NODE_226461_length_272_cov_1.618497	97	160	18	5	63	0.0793651
NODE_226461_length_272_cov_1.618497	97	160	20	3	63	0.0476190
NODE_226461_length_272_cov_1.618497	97	160	22	10	63	0.1587302
NODE_226508_length_272_cov_1.543353	69	137	0	68	68	1.0000000
NODE_227037_length_272_cov_1.173410	147	203	2	56	56	1.0000000
NODE_227265_length_272_cov_0.988439	169	215	0	46	46	1.0000000
NODE_227444_length_272_cov_0.884393	126	163	2	37	37	1.0000000
NODE_228332_length_271_cov_5.238372	103	183	0	39	80	0.4875000
NODE_228332_length_271_cov_5.238372	103	183	2	41	80	0.5125000
NODE_228423_length_271_cov_3.546512	102	165	0	42	63	0.6666667
NODE_228423_length_271_cov_3.546512	102	165	2	21	63	0.3333333
NODE_228429_length_271_cov_3.476744	62	93	0	31	31	1.0000000
NODE_228494_length_271_cov_2.959302	96	176	2	40	80	0.5000000
NODE_228494_length_271_cov_2.959302	96	176	4	28	80	0.3500000
NODE_228494_length_271_cov_2.959302	96	176	6	12	80	0.1500000
NODE_228494_length_271_cov_2.959302	149	229	4	68	80	0.8500000
NODE_228494_length_271_cov_2.959302	149	229	6	12	80	0.1500000
NODE_228554_length_271_cov_2.715116	160	241	0	81	81	1.0000000
NODE_228593_length_271_cov_2.622093	180	253	0	73	73	1.0000000
NODE_228623_length_271_cov_2.465116	45	75	0	30	30	1.0000000
NODE_228731_length_271_cov_2.284884	95	158	2	25	63	0.3968254
NODE_228731_length_271_cov_2.284884	95	158	4	38	63	0.6031746
NODE_228731_length_271_cov_2.284884	131	211	2	67	80	0.8375000
NODE_228731_length_271_cov_2.284884	131	211	4	13	80	0.1625000
NODE_228737_length_271_cov_2.273256	163	219	2	56	56	1.0000000
NODE_228830_length_271_cov_2.069767	130	212	0	82	82	1.0000000
NODE_228932_length_271_cov_1.784884	135	183	0	33	48	0.6875000
NODE_228932_length_271_cov_1.784884	135	183	2	15	48	0.3125000
NODE_228937_length_271_cov_1.779070	204	268	0	64	64	1.0000000
NODE_229085_length_271_cov_1.755814	119	199	2	17	80	0.2125000
NODE_229085_length_271_cov_1.755814	119	199	4	63	80	0.7875000
NODE_229242_length_271_cov_1.523256	122	183	6	61	61	1.0000000
NODE_229254_length_271_cov_1.511628	106	186	40	1	80	0.0125000
NODE_229254_length_271_cov_1.511628	106	186	42	4	80	0.0500000
NODE_229254_length_271_cov_1.511628	106	186	44	1	80	0.0125000
NODE_229254_length_271_cov_1.511628	106	186	46	10	80	0.1250000
NODE_229254_length_271_cov_1.511628	106	186	48	22	80	0.2750000
NODE_229254_length_271_cov_1.511628	106	186	50	9	80	0.1125000
NODE_229254_length_271_cov_1.511628	106	186	52	20	80	0.2500000
NODE_229254_length_271_cov_1.511628	106	186	54	13	80	0.1625000
NODE_229525_length_271_cov_1.226744	119	184	2	36	65	0.5538462
NODE_229525_length_271_cov_1.226744	119	184	4	29	65	0.4461538
NODE_229541_length_271_cov_1.197674	88	145	0	1	57	0.0175439
NODE_229541_length_271_cov_1.197674	88	145	2	23	57	0.4035088
NODE_229541_length_271_cov_1.197674	88	145	6	33	57	0.5789474
NODE_229541_length_271_cov_1.197674	118	192	6	74	74	1.0000000
NODE_230154_length_271_cov_0.918605	155	227	0	72	72	1.0000000
NODE_230255_length_271_cov_0.889535	101	148	0	47	47	1.0000000
NODE_230318_length_271_cov_0.889535	127	188	0	7	61	0.1147541
NODE_230318_length_271_cov_0.889535	127	188	2	54	61	0.8852459
NODE_231165_length_270_cov_4.818713	72	118	0	46	46	1.0000000
NODE_231187_length_270_cov_4.327485	5	82	0	77	77	1.0000000
NODE_231240_length_270_cov_3.666667	87	154	0	12	67	0.1791045
NODE_231240_length_270_cov_3.666667	87	154	2	47	67	0.7014925
NODE_231240_length_270_cov_3.666667	87	154	6	8	67	0.1194030
NODE_231240_length_270_cov_3.666667	140	207	2	6	67	0.0895522
NODE_231240_length_270_cov_3.666667	140	207	6	32	67	0.4776119
NODE_231240_length_270_cov_3.666667	140	207	8	29	67	0.4328358
NODE_231263_length_270_cov_3.491228	186	270	0	67	84	0.7976190
NODE_231263_length_270_cov_3.491228	186	270	2	16	84	0.1904762
NODE_231263_length_270_cov_3.491228	186	270	4	1	84	0.0119048
NODE_231310_length_270_cov_3.105263	43	90	4	20	47	0.4255319
NODE_231310_length_270_cov_3.105263	43	90	6	9	47	0.1914894
NODE_231310_length_270_cov_3.105263	43	90	10	18	47	0.3829787
NODE_231316_length_270_cov_3.046784	64	135	0	71	71	1.0000000
NODE_231439_length_270_cov_2.649123	210	270	0	60	60	1.0000000
NODE_231655_length_270_cov_2.087719	16	55	0	39	39	1.0000000
NODE_231655_length_270_cov_2.087719	78	108	0	30	30	1.0000000
NODE_231714_length_270_cov_2.040936	103	159	8	1	56	0.0178571
NODE_231714_length_270_cov_2.040936	103	159	25	1	56	0.0178571
NODE_231714_length_270_cov_2.040936	103	159	29	2	56	0.0357143
NODE_231714_length_270_cov_2.040936	103	159	35	1	56	0.0178571
NODE_231714_length_270_cov_2.040936	103	159	37	1	56	0.0178571
NODE_231714_length_270_cov_2.040936	103	159	43	2	56	0.0357143
NODE_231714_length_270_cov_2.040936	103	159	45	1	56	0.0178571
NODE_231714_length_270_cov_2.040936	103	159	49	1	56	0.0178571
NODE_231714_length_270_cov_2.040936	103	159	51	1	56	0.0178571
NODE_231714_length_270_cov_2.040936	103	159	55	1	56	0.0178571
NODE_231714_length_270_cov_2.040936	103	159	68	1	56	0.0178571
NODE_231714_length_270_cov_2.040936	103	159	70	1	56	0.0178571
NODE_231714_length_270_cov_2.040936	103	159	71	1	56	0.0178571
NODE_231714_length_270_cov_2.040936	103	159	75	1	56	0.0178571
NODE_231714_length_270_cov_2.040936	103	159	81	2	56	0.0357143
NODE_231714_length_270_cov_2.040936	103	159	86	1	56	0.0178571
NODE_231714_length_270_cov_2.040936	103	159	88	1	56	0.0178571
NODE_231714_length_270_cov_2.040936	103	159	93	1	56	0.0178571
NODE_231714_length_270_cov_2.040936	103	159	95	1	56	0.0178571
NODE_231714_length_270_cov_2.040936	103	159	97	1	56	0.0178571
NODE_231714_length_270_cov_2.040936	103	159	99	4	56	0.0714286
NODE_231714_length_270_cov_2.040936	103	159	101	1	56	0.0178571
NODE_231714_length_270_cov_2.040936	103	159	105	1	56	0.0178571
NODE_231714_length_270_cov_2.040936	103	159	107	1	56	0.0178571
NODE_231714_length_270_cov_2.040936	103	159	113	1	56	0.0178571
NODE_231714_length_270_cov_2.040936	103	159	125	1	56	0.0178571
NODE_231714_length_270_cov_2.040936	103	159	137	3	56	0.0535714
NODE_231714_length_270_cov_2.040936	103	159	143	2	56	0.0357143
NODE_231714_length_270_cov_2.040936	103	159	147	1	56	0.0178571
NODE_231714_length_270_cov_2.040936	103	159	149	2	56	0.0357143
NODE_231714_length_270_cov_2.040936	103	159	151	2	56	0.0357143
NODE_231714_length_270_cov_2.040936	103	159	153	9	56	0.1607143
NODE_231714_length_270_cov_2.040936	103	159	155	3	56	0.0535714
NODE_231714_length_270_cov_2.040936	103	159	157	1	56	0.0178571
NODE_231714_length_270_cov_2.040936	103	159	159	1	56	0.0178571
NODE_231726_length_270_cov_2.017544	1	48	0	47	47	1.0000000
NODE_231820_length_270_cov_1.789474	146	228	0	9	82	0.1097561
NODE_231820_length_270_cov_1.789474	146	228	1	24	82	0.2926829
NODE_231820_length_270_cov_1.789474	146	228	2	49	82	0.5975610
NODE_232008_length_270_cov_1.678363	178	246	0	68	68	1.0000000
NODE_232021_length_270_cov_1.666667	127	191	4	1	64	0.0156250
NODE_232021_length_270_cov_1.666667	127	191	6	9	64	0.1406250
NODE_232021_length_270_cov_1.666667	127	191	10	2	64	0.0312500
NODE_232021_length_270_cov_1.666667	127	191	12	8	64	0.1250000
NODE_232021_length_270_cov_1.666667	127	191	16	3	64	0.0468750
NODE_232021_length_270_cov_1.666667	127	191	18	2	64	0.0312500
NODE_232021_length_270_cov_1.666667	127	191	20	1	64	0.0156250
NODE_232021_length_270_cov_1.666667	127	191	22	6	64	0.0937500
NODE_232021_length_270_cov_1.666667	127	191	24	3	64	0.0468750
NODE_232021_length_270_cov_1.666667	127	191	28	13	64	0.2031250
NODE_232021_length_270_cov_1.666667	127	191	30	5	64	0.0781250
NODE_232021_length_270_cov_1.666667	127	191	32	1	64	0.0156250
NODE_232021_length_270_cov_1.666667	127	191	36	2	64	0.0312500
NODE_232021_length_270_cov_1.666667	127	191	38	3	64	0.0468750
NODE_232021_length_270_cov_1.666667	127	191	40	2	64	0.0312500
NODE_232021_length_270_cov_1.666667	127	191	42	3	64	0.0468750
NODE_232021_length_270_cov_1.666667	180	227	0	30	47	0.6382979
NODE_232021_length_270_cov_1.666667	180	227	2	3	47	0.0638298
NODE_232021_length_270_cov_1.666667	180	227	4	4	47	0.0851064
NODE_232021_length_270_cov_1.666667	180	227	6	9	47	0.1914894
NODE_232021_length_270_cov_1.666667	180	227	10	1	47	0.0212766
NODE_232087_length_270_cov_1.555556	138	218	0	24	80	0.3000000
NODE_232087_length_270_cov_1.555556	138	218	2	56	80	0.7000000
NODE_232331_length_270_cov_1.280702	4	75	0	71	71	1.0000000
NODE_232331_length_270_cov_1.280702	57	137	0	80	80	1.0000000
NODE_232331_length_270_cov_1.280702	65	120	0	55	55	1.0000000
NODE_232331_length_270_cov_1.280702	125	198	0	73	73	1.0000000
NODE_232440_length_270_cov_1.192982	146	194	0	48	48	1.0000000
NODE_232583_length_270_cov_1.192982	61	141	0	80	80	1.0000000
NODE_233290_length_270_cov_0.847953	53	128	0	2	75	0.0266667
NODE_233290_length_270_cov_0.847953	53	128	4	1	75	0.0133333
NODE_233290_length_270_cov_0.847953	53	128	6	2	75	0.0266667
NODE_233290_length_270_cov_0.847953	53	128	8	5	75	0.0666667
NODE_233290_length_270_cov_0.847953	53	128	10	57	75	0.7600000
NODE_233290_length_270_cov_0.847953	53	128	12	8	75	0.1066667
NODE_234072_length_269_cov_3.894118	30	110	0	33	80	0.4125000
NODE_234072_length_269_cov_3.894118	30	110	2	47	80	0.5875000
NODE_234072_length_269_cov_3.894118	83	163	2	80	80	1.0000000
NODE_234100_length_269_cov_3.605882	175	205	2	30	30	1.0000000
NODE_234116_length_269_cov_3.523529	192	233	6	6	41	0.1463415
NODE_234116_length_269_cov_3.523529	192	233	7	11	41	0.2682927
NODE_234116_length_269_cov_3.523529	192	233	12	19	41	0.4634146
NODE_234116_length_269_cov_3.523529	192	233	14	5	41	0.1219512
NODE_234116_length_269_cov_3.523529	206	268	0	5	62	0.0806452
NODE_234116_length_269_cov_3.523529	206	268	2	5	62	0.0806452
NODE_234116_length_269_cov_3.523529	206	268	4	4	62	0.0645161
NODE_234116_length_269_cov_3.523529	206	268	6	27	62	0.4354839
NODE_234116_length_269_cov_3.523529	206	268	7	11	62	0.1774193
NODE_234116_length_269_cov_3.523529	206	268	12	10	62	0.1612903
NODE_234118_length_269_cov_3.505882	13	93	1	28	80	0.3500000
NODE_234118_length_269_cov_3.505882	13	93	2	52	80	0.6500000
NODE_234118_length_269_cov_3.505882	66	145	2	79	79	1.0000000
NODE_234162_length_269_cov_3.147059	134	174	0	40	40	1.0000000
NODE_234167_length_269_cov_3.111765	39	119	0	80	80	1.0000000
NODE_234167_length_269_cov_3.111765	92	169	0	77	77	1.0000000
NODE_234178_length_269_cov_3.000000	166	233	0	54	67	0.8059701
NODE_234178_length_269_cov_3.000000	166	233	2	13	67	0.1940299
NODE_234205_length_269_cov_2.947059	55	123	0	15	68	0.2205882
NODE_234205_length_269_cov_2.947059	55	123	2	10	68	0.1470588
NODE_234205_length_269_cov_2.947059	55	123	4	43	68	0.6323529
NODE_234224_length_269_cov_2.858824	9	89	0	80	80	1.0000000
NODE_234224_length_269_cov_2.858824	62	91	0	29	29	1.0000000
NODE_234228_length_269_cov_2.823529	0	73	0	3	73	0.0410959
NODE_234228_length_269_cov_2.823529	0	73	2	9	73	0.1232877
NODE_234228_length_269_cov_2.823529	0	73	4	2	73	0.0273973
NODE_234228_length_269_cov_2.823529	0	73	6	41	73	0.5616438
NODE_234228_length_269_cov_2.823529	0	73	8	18	73	0.2465753
NODE_234228_length_269_cov_2.823529	46	77	6	9	31	0.2903226
NODE_234228_length_269_cov_2.823529	46	77	8	22	31	0.7096774
NODE_234431_length_269_cov_2.311765	111	157	0	46	46	1.0000000
NODE_234431_length_269_cov_2.311765	130	209	0	79	79	1.0000000
NODE_234606_length_269_cov_1.958824	176	248	4	27	72	0.3750000
NODE_234606_length_269_cov_1.958824	176	248	6	45	72	0.6250000
NODE_234647_length_269_cov_1.847059	72	99	0	10	27	0.3703704
NODE_234647_length_269_cov_1.847059	72	99	2	17	27	0.6296296
NODE_234657_length_269_cov_1.823529	30	81	6	10	51	0.1960784
NODE_234657_length_269_cov_1.823529	30	81	8	5	51	0.0980392
NODE_234657_length_269_cov_1.823529	30	81	12	22	51	0.4313726
NODE_234657_length_269_cov_1.823529	30	81	14	14	51	0.2745098
NODE_234758_length_269_cov_1.800000	0	42	0	42	42	1.0000000
NODE_234978_length_269_cov_1.552941	90	170	0	18	80	0.2250000
NODE_234978_length_269_cov_1.552941	90	170	2	12	80	0.1500000
NODE_234978_length_269_cov_1.552941	90	170	4	50	80	0.6250000
NODE_235157_length_269_cov_1.400000	139	219	4	1	80	0.0125000
NODE_235157_length_269_cov_1.400000	139	219	6	5	80	0.0625000
NODE_235157_length_269_cov_1.400000	139	219	10	36	80	0.4500000
NODE_235157_length_269_cov_1.400000	139	219	12	27	80	0.3375000
NODE_235157_length_269_cov_1.400000	139	219	14	11	80	0.1375000
NODE_235168_length_269_cov_1.388235	185	252	0	67	67	1.0000000
NODE_235239_length_269_cov_1.288235	150	179	0	6	29	0.2068966
NODE_235239_length_269_cov_1.288235	150	179	4	3	29	0.1034483
NODE_235239_length_269_cov_1.288235	150	179	8	1	29	0.0344828
NODE_235239_length_269_cov_1.288235	150	179	10	3	29	0.1034483
NODE_235239_length_269_cov_1.288235	150	179	12	1	29	0.0344828
NODE_235239_length_269_cov_1.288235	150	179	16	1	29	0.0344828
NODE_235239_length_269_cov_1.288235	150	179	18	14	29	0.4827586
NODE_235292_length_269_cov_1.217647	141	221	2	26	80	0.3250000
NODE_235292_length_269_cov_1.217647	141	221	4	54	80	0.6750000
NODE_235561_length_269_cov_1.194118	107	170	0	63	63	1.0000000
NODE_235561_length_269_cov_1.194118	143	221	0	78	78	1.0000000
NODE_235714_length_269_cov_1.094118	38	72	0	34	34	1.0000000
NODE_235780_length_269_cov_1.035294	6	36	0	30	30	1.0000000
NODE_235780_length_269_cov_1.035294	96	150	0	54	54	1.0000000
NODE_235930_length_269_cov_0.917647	4	79	0	75	75	1.0000000
NODE_235930_length_269_cov_0.917647	57	93	0	36	36	1.0000000
NODE_236243_length_269_cov_0.782353	2	52	4	1	50	0.0200000
NODE_236243_length_269_cov_0.782353	2	52	6	5	50	0.1000000
NODE_236243_length_269_cov_0.782353	2	52	8	2	50	0.0400000
NODE_236243_length_269_cov_0.782353	2	52	10	2	50	0.0400000
NODE_236243_length_269_cov_0.782353	2	52	12	8	50	0.1600000
NODE_236243_length_269_cov_0.782353	2	52	14	8	50	0.1600000
NODE_236243_length_269_cov_0.782353	2	52	16	2	50	0.0400000
NODE_236243_length_269_cov_0.782353	2	52	18	3	50	0.0600000
NODE_236243_length_269_cov_0.782353	2	52	20	5	50	0.1000000
NODE_236243_length_269_cov_0.782353	2	52	26	3	50	0.0600000
NODE_236243_length_269_cov_0.782353	2	52	28	8	50	0.1600000
NODE_236243_length_269_cov_0.782353	2	52	30	2	50	0.0400000
NODE_236243_length_269_cov_0.782353	2	52	32	1	50	0.0200000
NODE_236243_length_269_cov_0.782353	76	132	30	2	56	0.0357143
NODE_236243_length_269_cov_0.782353	76	132	31	5	56	0.0892857
NODE_236243_length_269_cov_0.782353	76	132	32	1	56	0.0178571
NODE_236243_length_269_cov_0.782353	76	132	33	1	56	0.0178571
NODE_236243_length_269_cov_0.782353	76	132	34	19	56	0.3392857
NODE_236243_length_269_cov_0.782353	76	132	36	15	56	0.2678571
NODE_236243_length_269_cov_0.782353	76	132	38	13	56	0.2321429
NODE_236856_length_268_cov_223.165680	161	188	2	27	27	1.0000000
NODE_236856_length_268_cov_223.165680	161	241	0	11	80	0.1375000
NODE_236856_length_268_cov_223.165680	161	241	2	69	80	0.8625000
NODE_236878_length_268_cov_6.266272	29	111	2	82	82	1.0000000
NODE_236909_length_268_cov_5.053254	137	217	0	80	80	1.0000000
NODE_236909_length_268_cov_5.053254	190	253	0	63	63	1.0000000
NODE_236911_length_268_cov_4.994083	92	168	0	30	76	0.3947369
NODE_236911_length_268_cov_4.994083	92	168	2	46	76	0.6052632
NODE_236972_length_268_cov_3.905325	1	61	0	60	60	1.0000000
NODE_237107_length_268_cov_2.982249	95	175	12	12	80	0.1500000
NODE_237107_length_268_cov_2.982249	95	175	18	2	80	0.0250000
NODE_237107_length_268_cov_2.982249	95	175	22	1	80	0.0125000
NODE_237107_length_268_cov_2.982249	95	175	24	21	80	0.2625000
NODE_237107_length_268_cov_2.982249	95	175	26	15	80	0.1875000
NODE_237107_length_268_cov_2.982249	95	175	28	29	80	0.3625000
NODE_237115_length_268_cov_2.940828	28	97	0	69	69	1.0000000
NODE_237185_length_268_cov_2.668639	57	110	1	4	53	0.0754717
NODE_237185_length_268_cov_2.668639	57	110	2	23	53	0.4339623
NODE_237185_length_268_cov_2.668639	57	110	4	26	53	0.4905660
NODE_237190_length_268_cov_2.621302	149	176	0	27	27	1.0000000
NODE_237325_length_268_cov_2.289941	87	127	68	1	40	0.0250000
NODE_237325_length_268_cov_2.289941	87	127	70	2	40	0.0500000
NODE_237325_length_268_cov_2.289941	87	127	72	1	40	0.0250000
NODE_237325_length_268_cov_2.289941	87	127	76	1	40	0.0250000
NODE_237325_length_268_cov_2.289941	87	127	78	5	40	0.1250000
NODE_237325_length_268_cov_2.289941	87	127	82	1	40	0.0250000
NODE_237325_length_268_cov_2.289941	87	127	86	3	40	0.0750000
NODE_237325_length_268_cov_2.289941	87	127	88	4	40	0.1000000
NODE_237325_length_268_cov_2.289941	87	127	90	3	40	0.0750000
NODE_237325_length_268_cov_2.289941	87	127	92	1	40	0.0250000
NODE_237325_length_268_cov_2.289941	87	127	94	1	40	0.0250000
NODE_237325_length_268_cov_2.289941	87	127	96	2	40	0.0500000
NODE_237325_length_268_cov_2.289941	87	127	112	5	40	0.1250000
NODE_237325_length_268_cov_2.289941	87	127	114	3	40	0.0750000
NODE_237325_length_268_cov_2.289941	87	127	116	3	40	0.0750000
NODE_237325_length_268_cov_2.289941	87	127	120	4	40	0.1000000
NODE_237345_length_268_cov_2.224852	96	176	4	80	80	1.0000000
NODE_237345_length_268_cov_2.224852	149	229	0	18	80	0.2250000
NODE_237345_length_268_cov_2.224852	149	229	4	62	80	0.7750000
NODE_237457_length_268_cov_2.005917	97	162	0	42	65	0.6461539
NODE_237457_length_268_cov_2.005917	97	162	1	1	65	0.0153846
NODE_237457_length_268_cov_2.005917	97	162	2	22	65	0.3384615
NODE_237502_length_268_cov_1.840237	80	155	0	54	75	0.7200000
NODE_237502_length_268_cov_1.840237	80	155	2	21	75	0.2800000
NODE_237572_length_268_cov_1.810651	8	84	0	47	76	0.6184211
NODE_237572_length_268_cov_1.810651	8	84	2	1	76	0.0131579
NODE_237572_length_268_cov_1.810651	8	84	4	28	76	0.3684210
NODE_237831_length_268_cov_1.532544	186	257	7	2	71	0.0281690
NODE_237831_length_268_cov_1.532544	186	257	11	2	71	0.0281690
NODE_237831_length_268_cov_1.532544	186	257	13	2	71	0.0281690
NODE_237831_length_268_cov_1.532544	186	257	15	9	71	0.1267606
NODE_237831_length_268_cov_1.532544	186	257	16	1	71	0.0140845
NODE_237831_length_268_cov_1.532544	186	257	18	11	71	0.1549296
NODE_237831_length_268_cov_1.532544	186	257	20	4	71	0.0563380
NODE_237831_length_268_cov_1.532544	186	257	31	1	71	0.0140845
NODE_237831_length_268_cov_1.532544	186	257	33	2	71	0.0281690
NODE_237831_length_268_cov_1.532544	186	257	34	4	71	0.0563380
NODE_237831_length_268_cov_1.532544	186	257	38	1	71	0.0140845
NODE_237831_length_268_cov_1.532544	186	257	40	2	71	0.0281690
NODE_237831_length_268_cov_1.532544	186	257	41	3	71	0.0422535
NODE_237831_length_268_cov_1.532544	186	257	45	1	71	0.0140845
NODE_237831_length_268_cov_1.532544	186	257	49	5	71	0.0704225
NODE_237831_length_268_cov_1.532544	186	257	55	6	71	0.0845070
NODE_237831_length_268_cov_1.532544	186	257	59	9	71	0.1267606
NODE_237831_length_268_cov_1.532544	186	257	65	3	71	0.0422535
NODE_237831_length_268_cov_1.532544	186	257	67	3	71	0.0422535
NODE_237906_length_268_cov_1.508876	52	131	1	10	79	0.1265823
NODE_237906_length_268_cov_1.508876	52	131	2	41	79	0.5189874
NODE_237906_length_268_cov_1.508876	52	131	4	28	79	0.3544304
NODE_238009_length_268_cov_1.384615	0	46	0	46	46	1.0000000
NODE_238070_length_268_cov_1.278107	100	175	0	18	75	0.2400000
NODE_238070_length_268_cov_1.278107	100	175	2	57	75	0.7600000
NODE_238153_length_268_cov_1.207101	187	209	2	22	22	1.0000000
NODE_238478_length_268_cov_1.153846	135	195	0	29	60	0.4833333
NODE_238478_length_268_cov_1.153846	135	195	2	31	60	0.5166667
NODE_239018_length_268_cov_0.852071	59	119	12	11	60	0.1833333
NODE_239018_length_268_cov_0.852071	59	119	16	5	60	0.0833333
NODE_239018_length_268_cov_0.852071	59	119	18	37	60	0.6166667
NODE_239018_length_268_cov_0.852071	59	119	20	7	60	0.1166667
NODE_239805_length_267_cov_4.297619	0	52	0	52	52	1.0000000
NODE_239817_length_267_cov_4.119048	41	87	0	25	46	0.5434783
NODE_239817_length_267_cov_4.119048	41	87	2	21	46	0.4565217
NODE_239845_length_267_cov_3.785714	96	163	0	67	67	1.0000000
NODE_239845_length_267_cov_3.785714	136	178	0	42	42	1.0000000
NODE_239873_length_267_cov_3.535714	40	101	0	61	61	1.0000000
NODE_239873_length_267_cov_3.535714	74	154	0	80	80	1.0000000
NODE_239958_length_267_cov_3.005952	216	267	0	51	51	1.0000000
NODE_239959_length_267_cov_3.000000	87	144	2	2	57	0.0350877
NODE_239959_length_267_cov_3.000000	87	144	4	1	57	0.0175439
NODE_239959_length_267_cov_3.000000	87	144	8	16	57	0.2807018
NODE_239959_length_267_cov_3.000000	87	144	10	1	57	0.0175439
NODE_239959_length_267_cov_3.000000	87	144	12	4	57	0.0701754
NODE_239959_length_267_cov_3.000000	87	144	14	2	57	0.0350877
NODE_239959_length_267_cov_3.000000	87	144	16	10	57	0.1754386
NODE_239959_length_267_cov_3.000000	87	144	18	9	57	0.1578947
NODE_239959_length_267_cov_3.000000	87	144	20	5	57	0.0877193
NODE_239959_length_267_cov_3.000000	87	144	22	7	57	0.1228070
NODE_240007_length_267_cov_2.726190	177	220	8	6	43	0.1395349
NODE_240007_length_267_cov_2.726190	177	220	10	5	43	0.1162791
NODE_240007_length_267_cov_2.726190	177	220	12	32	43	0.7441860
NODE_240024_length_267_cov_2.690476	117	170	11	1	53	0.0188679
NODE_240024_length_267_cov_2.690476	117	170	12	3	53	0.0566038
NODE_240024_length_267_cov_2.690476	117	170	14	19	53	0.3584906
NODE_240024_length_267_cov_2.690476	117	170	15	20	53	0.3773585
NODE_240024_length_267_cov_2.690476	117	170	16	10	53	0.1886792
NODE_240029_length_267_cov_2.666667	198	267	0	68	69	0.9855072
NODE_240029_length_267_cov_2.666667	198	267	1	1	69	0.0144928
NODE_240114_length_267_cov_2.428571	189	254	2	6	65	0.0923077
NODE_240114_length_267_cov_2.428571	189	254	4	22	65	0.3384615
NODE_240114_length_267_cov_2.428571	189	254	6	31	65	0.4769231
NODE_240114_length_267_cov_2.428571	189	254	8	3	65	0.0461538
NODE_240114_length_267_cov_2.428571	189	254	16	1	65	0.0153846
NODE_240114_length_267_cov_2.428571	189	254	31	1	65	0.0153846
NODE_240114_length_267_cov_2.428571	189	254	33	1	65	0.0153846
NODE_240207_length_267_cov_2.208333	45	103	2	52	58	0.8965517
NODE_240207_length_267_cov_2.208333	45	103	4	6	58	0.1034483
NODE_240246_length_267_cov_2.125000	124	175	2	51	51	1.0000000
NODE_240303_length_267_cov_2.077381	65	146	0	10	81	0.1234568
NODE_240303_length_267_cov_2.077381	65	146	2	71	81	0.8765432
NODE_240303_length_267_cov_2.077381	229	264	0	35	35	1.0000000
NODE_240331_length_267_cov_2.005952	147	228	2	57	81	0.7037037
NODE_240331_length_267_cov_2.005952	147	228	4	7	81	0.0864198
NODE_240331_length_267_cov_2.005952	147	228	6	1	81	0.0123457
NODE_240331_length_267_cov_2.005952	147	228	8	7	81	0.0864198
NODE_240331_length_267_cov_2.005952	147	228	9	1	81	0.0123457
NODE_240331_length_267_cov_2.005952	147	228	11	3	81	0.0370370
NODE_240331_length_267_cov_2.005952	147	228	12	2	81	0.0246914
NODE_240331_length_267_cov_2.005952	147	228	14	3	81	0.0370370
NODE_240331_length_267_cov_2.005952	201	267	0	18	66	0.2727273
NODE_240331_length_267_cov_2.005952	201	267	2	48	66	0.7272727
NODE_240336_length_267_cov_1.988095	77	157	0	80	80	1.0000000
NODE_240336_length_267_cov_1.988095	130	210	0	80	80	1.0000000
NODE_240620_length_267_cov_1.755952	119	199	0	49	80	0.6125000
NODE_240620_length_267_cov_1.755952	119	199	2	31	80	0.3875000
NODE_240624_length_267_cov_1.750000	23	104	22	1	81	0.0123457
NODE_240624_length_267_cov_1.750000	23	104	24	1	81	0.0123457
NODE_240624_length_267_cov_1.750000	23	104	30	1	81	0.0123457
NODE_240624_length_267_cov_1.750000	23	104	32	6	81	0.0740741
NODE_240624_length_267_cov_1.750000	23	104	34	27	81	0.3333333
NODE_240624_length_267_cov_1.750000	23	104	38	45	81	0.5555556
NODE_240624_length_267_cov_1.750000	179	208	2	29	29	1.0000000
NODE_240653_length_267_cov_1.690476	18	90	0	72	72	1.0000000
NODE_240790_length_267_cov_1.517857	6	43	0	37	37	1.0000000
NODE_241075_length_267_cov_1.214286	37	91	0	54	54	1.0000000
NODE_241240_length_267_cov_1.214286	89	126	0	37	37	1.0000000
NODE_241352_length_267_cov_1.208333	124	164	0	40	40	1.0000000
NODE_241484_length_267_cov_1.125000	57	103	0	46	46	1.0000000
NODE_241512_length_267_cov_1.089286	119	196	0	55	77	0.7142857
NODE_241512_length_267_cov_1.089286	119	196	2	22	77	0.2857143
NODE_241512_length_267_cov_1.089286	169	249	0	80	80	1.0000000
NODE_241517_length_267_cov_1.083333	133	152	26	1	19	0.0526316
NODE_241517_length_267_cov_1.083333	133	152	28	3	19	0.1578947
NODE_241517_length_267_cov_1.083333	133	152	30	15	19	0.7894737
NODE_241517_length_267_cov_1.083333	183	264	0	1	81	0.0123457
NODE_241517_length_267_cov_1.083333	183	264	2	3	81	0.0370370
NODE_241517_length_267_cov_1.083333	183	264	4	22	81	0.2716049
NODE_241517_length_267_cov_1.083333	183	264	6	7	81	0.0864198
NODE_241517_length_267_cov_1.083333	183	264	8	1	81	0.0123457
NODE_241517_length_267_cov_1.083333	183	264	10	6	81	0.0740741
NODE_241517_length_267_cov_1.083333	183	264	12	9	81	0.1111111
NODE_241517_length_267_cov_1.083333	183	264	16	4	81	0.0493827
NODE_241517_length_267_cov_1.083333	183	264	18	7	81	0.0864198
NODE_241517_length_267_cov_1.083333	183	264	20	8	81	0.0987654
NODE_241517_length_267_cov_1.083333	183	264	22	5	81	0.0617284
NODE_241517_length_267_cov_1.083333	183	264	24	8	81	0.0987654
NODE_241588_length_267_cov_1.017857	205	267	0	62	62	1.0000000
NODE_241633_length_267_cov_0.982143	4	75	0	18	71	0.2535211
NODE_241633_length_267_cov_0.982143	4	75	2	53	71	0.7464789
NODE_242999_length_266_cov_5.706587	120	199	0	79	79	1.0000000
NODE_242999_length_266_cov_5.706587	172	239	0	67	67	1.0000000
NODE_243010_length_266_cov_5.107784	68	150	0	17	82	0.2073171
NODE_243010_length_266_cov_5.107784	68	150	2	26	82	0.3170732
NODE_243010_length_266_cov_5.107784	68	150	4	39	82	0.4756097
NODE_243064_length_266_cov_4.125749	99	168	2	4	69	0.0579710
NODE_243064_length_266_cov_4.125749	99	168	4	6	69	0.0869565
NODE_243064_length_266_cov_4.125749	99	168	6	27	69	0.3913043
NODE_243064_length_266_cov_4.125749	99	168	8	16	69	0.2318841
NODE_243064_length_266_cov_4.125749	99	168	10	16	69	0.2318841
NODE_243079_length_266_cov_3.958084	40	120	0	80	80	1.0000000
NODE_243079_length_266_cov_3.958084	93	159	0	66	66	1.0000000
NODE_243136_length_266_cov_3.419162	68	130	0	62	62	1.0000000
NODE_243136_length_266_cov_3.419162	116	183	0	67	67	1.0000000
NODE_243168_length_266_cov_3.137725	6	86	0	80	80	1.0000000
NODE_243168_length_266_cov_3.137725	59	120	0	61	61	1.0000000
NODE_243174_length_266_cov_3.107784	166	232	8	10	66	0.1515152
NODE_243174_length_266_cov_3.107784	166	232	10	12	66	0.1818182
NODE_243174_length_266_cov_3.107784	166	232	11	8	66	0.1212121
NODE_243174_length_266_cov_3.107784	166	232	12	3	66	0.0454545
NODE_243174_length_266_cov_3.107784	166	232	13	1	66	0.0151515
NODE_243174_length_266_cov_3.107784	166	232	14	7	66	0.1060606
NODE_243174_length_266_cov_3.107784	166	232	16	2	66	0.0303030
NODE_243174_length_266_cov_3.107784	166	232	18	2	66	0.0303030
NODE_243174_length_266_cov_3.107784	166	232	20	7	66	0.1060606
NODE_243174_length_266_cov_3.107784	166	232	22	1	66	0.0151515
NODE_243174_length_266_cov_3.107784	166	232	24	4	66	0.0606061
NODE_243174_length_266_cov_3.107784	166	232	26	6	66	0.0909091
NODE_243174_length_266_cov_3.107784	166	232	28	3	66	0.0454545
NODE_243475_length_266_cov_2.179641	110	191	8	18	81	0.2222222
NODE_243475_length_266_cov_2.179641	110	191	12	18	81	0.2222222
NODE_243475_length_266_cov_2.179641	110	191	14	15	81	0.1851852
NODE_243475_length_266_cov_2.179641	110	191	16	7	81	0.0864198
NODE_243475_length_266_cov_2.179641	110	191	18	7	81	0.0864198
NODE_243475_length_266_cov_2.179641	110	191	20	16	81	0.1975309
NODE_243497_length_266_cov_2.137725	156	236	4	80	80	1.0000000
NODE_243570_length_266_cov_2.023952	47	123	0	76	76	1.0000000
NODE_243972_length_266_cov_1.532934	155	235	0	70	80	0.8750000
NODE_243972_length_266_cov_1.532934	155	235	2	10	80	0.1250000
NODE_244681_length_266_cov_1.113772	70	97	0	19	27	0.7037037
NODE_244681_length_266_cov_1.113772	70	97	2	8	27	0.2962963
NODE_244760_length_266_cov_1.023952	144	201	2	24	57	0.4210526
NODE_244760_length_266_cov_1.023952	144	201	4	33	57	0.5789474
NODE_244760_length_266_cov_1.023952	199	265	0	8	66	0.1212121
NODE_244760_length_266_cov_1.023952	199	265	2	6	66	0.0909091
NODE_244760_length_266_cov_1.023952	199	265	4	52	66	0.7878788
NODE_245049_length_266_cov_0.916168	51	122	0	71	71	1.0000000
NODE_245280_length_266_cov_0.730539	132	158	0	26	26	1.0000000
NODE_245538_length_266_cov_0.610778	99	139	0	40	40	1.0000000
NODE_245538_length_266_cov_0.610778	112	156	0	44	44	1.0000000
NODE_246087_length_265_cov_7.843373	128	208	0	37	80	0.4625000
NODE_246087_length_265_cov_7.843373	128	208	1	1	80	0.0125000
NODE_246087_length_265_cov_7.843373	128	208	2	11	80	0.1375000
NODE_246087_length_265_cov_7.843373	128	208	4	3	80	0.0375000
NODE_246087_length_265_cov_7.843373	128	208	6	18	80	0.2250000
NODE_246087_length_265_cov_7.843373	128	208	8	6	80	0.0750000
NODE_246087_length_265_cov_7.843373	128	208	10	4	80	0.0500000
NODE_246192_length_265_cov_4.054217	65	145	0	80	80	1.0000000
NODE_246192_length_265_cov_4.054217	118	198	0	80	80	1.0000000
NODE_246198_length_265_cov_3.993976	195	231	0	36	36	1.0000000
NODE_246284_length_265_cov_3.150602	183	263	0	80	80	1.0000000
NODE_246374_length_265_cov_2.789157	177	238	0	6	61	0.0983607
NODE_246374_length_265_cov_2.789157	177	238	2	11	61	0.1803279
NODE_246374_length_265_cov_2.789157	177	238	6	44	61	0.7213115
NODE_246409_length_265_cov_2.734940	167	247	0	11	80	0.1375000
NODE_246409_length_265_cov_2.734940	167	247	2	69	80	0.8625000
NODE_246432_length_265_cov_2.608434	188	259	0	64	71	0.9014084
NODE_246432_length_265_cov_2.608434	188	259	1	7	71	0.0985916
NODE_246606_length_265_cov_2.156627	197	237	10	1	40	0.0250000
NODE_246606_length_265_cov_2.156627	197	237	16	11	40	0.2750000
NODE_246606_length_265_cov_2.156627	197	237	20	3	40	0.0750000
NODE_246606_length_265_cov_2.156627	197	237	24	13	40	0.3250000
NODE_246606_length_265_cov_2.156627	197	237	28	2	40	0.0500000
NODE_246606_length_265_cov_2.156627	197	237	30	3	40	0.0750000
NODE_246606_length_265_cov_2.156627	197	237	32	5	40	0.1250000
NODE_246606_length_265_cov_2.156627	197	237	34	2	40	0.0500000
NODE_246624_length_265_cov_2.150602	169	218	2	5	49	0.1020408
NODE_246624_length_265_cov_2.150602	169	218	4	44	49	0.8979592
NODE_246692_length_265_cov_1.975904	15	44	0	29	29	1.0000000
NODE_246811_length_265_cov_1.843373	195	265	0	8	70	0.1142857
NODE_246811_length_265_cov_1.843373	195	265	2	62	70	0.8857143
NODE_247028_length_265_cov_1.620482	115	186	0	8	71	0.1126761
NODE_247028_length_265_cov_1.620482	115	186	2	7	71	0.0985916
NODE_247028_length_265_cov_1.620482	115	186	7	23	71	0.3239437
NODE_247028_length_265_cov_1.620482	115	186	8	1	71	0.0140845
NODE_247028_length_265_cov_1.620482	115	186	10	32	71	0.4507042
NODE_247028_length_265_cov_1.620482	117	171	0	6	54	0.1111111
NODE_247028_length_265_cov_1.620482	117	171	2	7	54	0.1296296
NODE_247028_length_265_cov_1.620482	117	171	7	23	54	0.4259259
NODE_247028_length_265_cov_1.620482	117	171	8	1	54	0.0185185
NODE_247028_length_265_cov_1.620482	117	171	10	17	54	0.3148148
NODE_247031_length_265_cov_1.614458	53	113	2	21	60	0.3500000
NODE_247031_length_265_cov_1.614458	53	113	4	12	60	0.2000000
NODE_247031_length_265_cov_1.614458	53	113	8	2	60	0.0333333
NODE_247031_length_265_cov_1.614458	53	113	10	1	60	0.0166667
NODE_247031_length_265_cov_1.614458	53	113	12	10	60	0.1666667
NODE_247031_length_265_cov_1.614458	53	113	15	2	60	0.0333333
NODE_247031_length_265_cov_1.614458	53	113	19	4	60	0.0666667
NODE_247031_length_265_cov_1.614458	53	113	20	8	60	0.1333333
NODE_247031_length_265_cov_1.614458	86	166	8	2	80	0.0250000
NODE_247031_length_265_cov_1.614458	86	166	10	1	80	0.0125000
NODE_247031_length_265_cov_1.614458	86	166	12	10	80	0.1250000
NODE_247031_length_265_cov_1.614458	86	166	15	2	80	0.0250000
NODE_247031_length_265_cov_1.614458	86	166	19	4	80	0.0500000
NODE_247031_length_265_cov_1.614458	86	166	20	11	80	0.1375000
NODE_247031_length_265_cov_1.614458	86	166	22	10	80	0.1250000
NODE_247031_length_265_cov_1.614458	86	166	26	1	80	0.0125000
NODE_247031_length_265_cov_1.614458	86	166	28	1	80	0.0125000
NODE_247031_length_265_cov_1.614458	86	166	30	1	80	0.0125000
NODE_247031_length_265_cov_1.614458	86	166	32	8	80	0.1000000
NODE_247031_length_265_cov_1.614458	86	166	34	2	80	0.0250000
NODE_247031_length_265_cov_1.614458	86	166	36	5	80	0.0625000
NODE_247031_length_265_cov_1.614458	86	166	38	5	80	0.0625000
NODE_247031_length_265_cov_1.614458	86	166	40	2	80	0.0250000
NODE_247031_length_265_cov_1.614458	86	166	42	1	80	0.0125000
NODE_247031_length_265_cov_1.614458	86	166	44	2	80	0.0250000
NODE_247031_length_265_cov_1.614458	86	166	46	6	80	0.0750000
NODE_247031_length_265_cov_1.614458	86	166	50	2	80	0.0250000
NODE_247031_length_265_cov_1.614458	86	166	54	3	80	0.0375000
NODE_247031_length_265_cov_1.614458	86	166	56	1	80	0.0125000
NODE_247314_length_265_cov_1.337349	107	168	6	3	61	0.0491803
NODE_247314_length_265_cov_1.337349	107	168	8	1	61	0.0163934
NODE_247314_length_265_cov_1.337349	107	168	11	1	61	0.0163934
NODE_247314_length_265_cov_1.337349	107	168	12	1	61	0.0163934
NODE_247314_length_265_cov_1.337349	107	168	14	1	61	0.0163934
NODE_247314_length_265_cov_1.337349	107	168	18	3	61	0.0491803
NODE_247314_length_265_cov_1.337349	107	168	20	15	61	0.2459016
NODE_247314_length_265_cov_1.337349	107	168	22	28	61	0.4590164
NODE_247314_length_265_cov_1.337349	107	168	24	8	61	0.1311475
NODE_247952_length_265_cov_1.000000	187	251	5	13	64	0.2031250
NODE_247952_length_265_cov_1.000000	187	251	7	51	64	0.7968750
NODE_247972_length_265_cov_0.987952	44	63	0	19	19	1.0000000
NODE_249395_length_264_cov_4.018182	141	178	2	37	37	1.0000000
NODE_249404_length_264_cov_3.957576	59	132	0	73	73	1.0000000
NODE_249404_length_264_cov_3.957576	112	192	0	71	80	0.8875000
NODE_249404_length_264_cov_3.957576	112	192	2	9	80	0.1125000
NODE_249415_length_264_cov_3.824242	178	220	0	42	42	1.0000000
NODE_249452_length_264_cov_3.400000	73	125	0	52	52	1.0000000
NODE_249452_length_264_cov_3.400000	124	165	0	41	41	1.0000000
NODE_249485_length_264_cov_3.133333	119	186	0	67	67	1.0000000
NODE_249530_length_264_cov_3.012121	122	198	0	35	76	0.4605263
NODE_249530_length_264_cov_3.012121	122	198	2	16	76	0.2105263
NODE_249530_length_264_cov_3.012121	122	198	6	3	76	0.0394737
NODE_249530_length_264_cov_3.012121	122	198	10	2	76	0.0263158
NODE_249530_length_264_cov_3.012121	122	198	12	20	76	0.2631579
NODE_249904_length_264_cov_2.048485	32	98	4	36	66	0.5454546
NODE_249904_length_264_cov_2.048485	32	98	5	4	66	0.0606061
NODE_249904_length_264_cov_2.048485	32	98	6	4	66	0.0606061
NODE_249904_length_264_cov_2.048485	32	98	8	13	66	0.1969697
NODE_249904_length_264_cov_2.048485	32	98	10	1	66	0.0151515
NODE_249904_length_264_cov_2.048485	32	98	11	2	66	0.0303030
NODE_249904_length_264_cov_2.048485	32	98	13	1	66	0.0151515
NODE_249904_length_264_cov_2.048485	32	98	15	2	66	0.0303030
NODE_249904_length_264_cov_2.048485	32	98	17	3	66	0.0454545
NODE_249905_length_264_cov_2.048485	133	176	0	43	43	1.0000000
NODE_249912_length_264_cov_2.012121	20	84	0	64	64	1.0000000
NODE_249931_length_264_cov_1.951515	178	211	2	33	33	1.0000000
NODE_249982_length_264_cov_1.854545	130	161	0	31	31	1.0000000
NODE_250202_length_264_cov_1.745455	26	81	0	55	55	1.0000000
NODE_250202_length_264_cov_1.745455	86	153	0	67	67	1.0000000
NODE_250203_length_264_cov_1.745455	90	169	2	7	79	0.0886076
NODE_250203_length_264_cov_1.745455	90	169	4	11	79	0.1392405
NODE_250203_length_264_cov_1.745455	90	169	8	7	79	0.0886076
NODE_250203_length_264_cov_1.745455	90	169	10	2	79	0.0253165
NODE_250203_length_264_cov_1.745455	90	169	12	4	79	0.0506329
NODE_250203_length_264_cov_1.745455	90	169	14	1	79	0.0126582
NODE_250203_length_264_cov_1.745455	90	169	16	1	79	0.0126582
NODE_250203_length_264_cov_1.745455	90	169	18	3	79	0.0379747
NODE_250203_length_264_cov_1.745455	90	169	20	2	79	0.0253165
NODE_250203_length_264_cov_1.745455	90	169	24	2	79	0.0253165
NODE_250203_length_264_cov_1.745455	90	169	27	3	79	0.0379747
NODE_250203_length_264_cov_1.745455	90	169	29	10	79	0.1265823
NODE_250203_length_264_cov_1.745455	90	169	31	3	79	0.0379747
NODE_250203_length_264_cov_1.745455	90	169	33	5	79	0.0632911
NODE_250203_length_264_cov_1.745455	90	169	35	2	79	0.0253165
NODE_250203_length_264_cov_1.745455	90	169	37	4	79	0.0506329
NODE_250203_length_264_cov_1.745455	90	169	41	5	79	0.0632911
NODE_250203_length_264_cov_1.745455	90	169	43	2	79	0.0253165
NODE_250203_length_264_cov_1.745455	90	169	45	5	79	0.0632911
NODE_250203_length_264_cov_1.745455	143	207	30	2	64	0.0312500
NODE_250203_length_264_cov_1.745455	143	207	31	5	64	0.0781250
NODE_250203_length_264_cov_1.745455	143	207	33	9	64	0.1406250
NODE_250203_length_264_cov_1.745455	143	207	35	2	64	0.0312500
NODE_250203_length_264_cov_1.745455	143	207	37	10	64	0.1562500
NODE_250203_length_264_cov_1.745455	143	207	39	4	64	0.0625000
NODE_250203_length_264_cov_1.745455	143	207	41	6	64	0.0937500
NODE_250203_length_264_cov_1.745455	143	207	43	6	64	0.0937500
NODE_250203_length_264_cov_1.745455	143	207	45	20	64	0.3125000
NODE_250297_length_264_cov_1.569697	173	236	0	63	63	1.0000000
NODE_250314_length_264_cov_1.545455	206	255	6	15	49	0.3061225
NODE_250314_length_264_cov_1.545455	206	255	8	34	49	0.6938776
NODE_250381_length_264_cov_1.545455	35	66	0	31	31	1.0000000
NODE_250446_length_264_cov_1.503030	0	63	0	63	63	1.0000000
NODE_250513_length_264_cov_1.406061	149	230	0	16	81	0.1975309
NODE_250513_length_264_cov_1.406061	149	230	2	65	81	0.8024691
NODE_250513_length_264_cov_1.406061	225	260	0	35	35	1.0000000
NODE_250635_length_264_cov_1.236364	2	63	0	61	61	1.0000000
NODE_251015_length_264_cov_1.151515	11	68	0	57	57	1.0000000
NODE_251529_length_264_cov_0.921212	49	85	0	36	36	1.0000000
NODE_251703_length_264_cov_0.721212	233	252	0	19	19	1.0000000
NODE_252559_length_263_cov_5.115854	132	219	16	9	87	0.1034483
NODE_252559_length_263_cov_5.115854	132	219	18	2	87	0.0229885
NODE_252559_length_263_cov_5.115854	132	219	24	4	87	0.0459770
NODE_252559_length_263_cov_5.115854	132	219	28	1	87	0.0114943
NODE_252559_length_263_cov_5.115854	132	219	29	5	87	0.0574713
NODE_252559_length_263_cov_5.115854	132	219	31	1	87	0.0114943
NODE_252559_length_263_cov_5.115854	132	219	35	2	87	0.0229885
NODE_252559_length_263_cov_5.115854	132	219	36	40	87	0.4597701
NODE_252559_length_263_cov_5.115854	132	219	38	7	87	0.0804598
NODE_252559_length_263_cov_5.115854	132	219	39	1	87	0.0114943
NODE_252559_length_263_cov_5.115854	132	219	40	15	87	0.1724138
NODE_252563_length_263_cov_4.914634	45	117	4	12	72	0.1666667
NODE_252563_length_263_cov_4.914634	45	117	6	32	72	0.4444444
NODE_252563_length_263_cov_4.914634	45	117	8	28	72	0.3888889
NODE_252595_length_263_cov_4.225610	67	124	2	57	57	1.0000000
NODE_252663_length_263_cov_3.518293	104	176	0	72	72	1.0000000
NODE_252766_length_263_cov_2.908537	7	93	0	45	86	0.5232558
NODE_252766_length_263_cov_2.908537	7	93	2	27	86	0.3139535
NODE_252766_length_263_cov_2.908537	7	93	4	4	86	0.0465116
NODE_252766_length_263_cov_2.908537	7	93	6	2	86	0.0232558
NODE_252766_length_263_cov_2.908537	7	93	8	8	86	0.0930233
NODE_252778_length_263_cov_2.798780	67	146	2	12	79	0.1518987
NODE_252778_length_263_cov_2.798780	67	146	6	31	79	0.3924051
NODE_252778_length_263_cov_2.798780	67	146	8	36	79	0.4556962
NODE_252932_length_263_cov_2.396341	207	238	0	31	31	1.0000000
NODE_253261_length_263_cov_1.865854	51	81	12	1	30	0.0333333
NODE_253261_length_263_cov_1.865854	51	81	20	29	30	0.9666666
NODE_253310_length_263_cov_1.847561	113	189	0	76	76	1.0000000
NODE_253379_length_263_cov_1.750000	151	231	0	20	80	0.2500000
NODE_253379_length_263_cov_1.750000	151	231	2	12	80	0.1500000
NODE_253379_length_263_cov_1.750000	151	231	4	41	80	0.5125000
NODE_253379_length_263_cov_1.750000	151	231	6	7	80	0.0875000
NODE_253468_length_263_cov_1.579268	32	95	22	1	63	0.0158730
NODE_253468_length_263_cov_1.579268	32	95	24	5	63	0.0793651
NODE_253468_length_263_cov_1.579268	32	95	26	3	63	0.0476190
NODE_253468_length_263_cov_1.579268	32	95	29	5	63	0.0793651
NODE_253468_length_263_cov_1.579268	32	95	31	9	63	0.1428571
NODE_253468_length_263_cov_1.579268	32	95	33	1	63	0.0158730
NODE_253468_length_263_cov_1.579268	32	95	35	7	63	0.1111111
NODE_253468_length_263_cov_1.579268	32	95	39	1	63	0.0158730
NODE_253468_length_263_cov_1.579268	32	95	43	5	63	0.0793651
NODE_253468_length_263_cov_1.579268	32	95	45	8	63	0.1269841
NODE_253468_length_263_cov_1.579268	32	95	47	1	63	0.0158730
NODE_253468_length_263_cov_1.579268	32	95	49	11	63	0.1746032
NODE_253468_length_263_cov_1.579268	32	95	51	6	63	0.0952381
NODE_253477_length_263_cov_1.567073	98	155	2	57	57	1.0000000
NODE_253619_length_263_cov_1.506098	157	217	0	60	60	1.0000000
NODE_253620_length_263_cov_1.506098	84	113	6	23	29	0.7931035
NODE_253620_length_263_cov_1.506098	84	113	7	4	29	0.1379310
NODE_253620_length_263_cov_1.506098	84	113	8	2	29	0.0689655
NODE_253753_length_263_cov_1.286585	143	223	0	3	80	0.0375000
NODE_253753_length_263_cov_1.286585	143	223	2	16	80	0.2000000
NODE_253753_length_263_cov_1.286585	143	223	3	1	80	0.0125000
NODE_253753_length_263_cov_1.286585	143	223	7	16	80	0.2000000
NODE_253753_length_263_cov_1.286585	143	223	13	1	80	0.0125000
NODE_253753_length_263_cov_1.286585	143	223	15	1	80	0.0125000
NODE_253753_length_263_cov_1.286585	143	223	17	1	80	0.0125000
NODE_253753_length_263_cov_1.286585	143	223	19	1	80	0.0125000
NODE_253753_length_263_cov_1.286585	143	223	22	11	80	0.1375000
NODE_253753_length_263_cov_1.286585	143	223	25	12	80	0.1500000
NODE_253753_length_263_cov_1.286585	143	223	29	14	80	0.1750000
NODE_253753_length_263_cov_1.286585	143	223	30	3	80	0.0375000
NODE_253788_length_263_cov_1.243902	206	263	0	57	57	1.0000000
NODE_254174_length_263_cov_1.170732	12	66	0	54	54	1.0000000
NODE_254174_length_263_cov_1.170732	39	119	0	80	80	1.0000000
NODE_254301_length_263_cov_1.067073	137	202	0	14	65	0.2153846
NODE_254301_length_263_cov_1.067073	137	202	4	51	65	0.7846154
NODE_254301_length_263_cov_1.067073	175	255	0	29	80	0.3625000
NODE_254301_length_263_cov_1.067073	175	255	4	51	80	0.6375000
NODE_254783_length_263_cov_0.810976	163	245	30	2	82	0.0243902
NODE_254783_length_263_cov_0.810976	163	245	36	1	82	0.0121951
NODE_254783_length_263_cov_0.810976	163	245	38	1	82	0.0121951
NODE_254783_length_263_cov_0.810976	163	245	42	2	82	0.0243902
NODE_254783_length_263_cov_0.810976	163	245	44	1	82	0.0121951
NODE_254783_length_263_cov_0.810976	163	245	45	1	82	0.0121951
NODE_254783_length_263_cov_0.810976	163	245	48	1	82	0.0121951
NODE_254783_length_263_cov_0.810976	163	245	55	1	82	0.0121951
NODE_254783_length_263_cov_0.810976	163	245	58	1	82	0.0121951
NODE_254783_length_263_cov_0.810976	163	245	62	1	82	0.0121951
NODE_254783_length_263_cov_0.810976	163	245	68	2	82	0.0243902
NODE_254783_length_263_cov_0.810976	163	245	77	1	82	0.0121951
NODE_254783_length_263_cov_0.810976	163	245	83	1	82	0.0121951
NODE_254783_length_263_cov_0.810976	163	245	87	1	82	0.0121951
NODE_254783_length_263_cov_0.810976	163	245	96	2	82	0.0243902
NODE_254783_length_263_cov_0.810976	163	245	102	1	82	0.0121951
NODE_254783_length_263_cov_0.810976	163	245	107	2	82	0.0243902
NODE_254783_length_263_cov_0.810976	163	245	111	1	82	0.0121951
NODE_254783_length_263_cov_0.810976	163	245	112	1	82	0.0121951
NODE_254783_length_263_cov_0.810976	163	245	116	1	82	0.0121951
NODE_254783_length_263_cov_0.810976	163	245	117	1	82	0.0121951
NODE_254783_length_263_cov_0.810976	163	245	119	1	82	0.0121951
NODE_254783_length_263_cov_0.810976	163	245	122	1	82	0.0121951
NODE_254783_length_263_cov_0.810976	163	245	123	1	82	0.0121951
NODE_254783_length_263_cov_0.810976	163	245	125	2	82	0.0243902
NODE_254783_length_263_cov_0.810976	163	245	129	1	82	0.0121951
NODE_254783_length_263_cov_0.810976	163	245	131	1	82	0.0121951
NODE_254783_length_263_cov_0.810976	163	245	132	1	82	0.0121951
NODE_254783_length_263_cov_0.810976	163	245	139	1	82	0.0121951
NODE_254783_length_263_cov_0.810976	163	245	143	1	82	0.0121951
NODE_254783_length_263_cov_0.810976	163	245	151	1	82	0.0121951
NODE_254783_length_263_cov_0.810976	163	245	162	1	82	0.0121951
NODE_254783_length_263_cov_0.810976	163	245	171	1	82	0.0121951
NODE_254783_length_263_cov_0.810976	163	245	183	1	82	0.0121951
NODE_254783_length_263_cov_0.810976	163	245	190	1	82	0.0121951
NODE_254783_length_263_cov_0.810976	163	245	202	1	82	0.0121951
NODE_254783_length_263_cov_0.810976	163	245	208	1	82	0.0121951
NODE_254783_length_263_cov_0.810976	163	245	220	1	82	0.0121951
NODE_254783_length_263_cov_0.810976	163	245	230	1	82	0.0121951
NODE_254783_length_263_cov_0.810976	163	245	244	1	82	0.0121951
NODE_254783_length_263_cov_0.810976	163	245	250	1	82	0.0121951
NODE_254783_length_263_cov_0.810976	163	245	252	1	82	0.0121951
NODE_254783_length_263_cov_0.810976	163	245	262	1	82	0.0121951
NODE_254783_length_263_cov_0.810976	163	245	269	1	82	0.0121951
NODE_254783_length_263_cov_0.810976	163	245	271	1	82	0.0121951
NODE_254783_length_263_cov_0.810976	163	245	276	1	82	0.0121951
NODE_254783_length_263_cov_0.810976	163	245	279	1	82	0.0121951
NODE_254783_length_263_cov_0.810976	163	245	283	2	82	0.0243902
NODE_254783_length_263_cov_0.810976	163	245	295	2	82	0.0243902
NODE_254783_length_263_cov_0.810976	163	245	297	2	82	0.0243902
NODE_254783_length_263_cov_0.810976	163	245	303	1	82	0.0121951
NODE_254783_length_263_cov_0.810976	163	245	304	1	82	0.0121951
NODE_254783_length_263_cov_0.810976	163	245	308	1	82	0.0121951
NODE_254783_length_263_cov_0.810976	163	245	323	1	82	0.0121951
NODE_254783_length_263_cov_0.810976	163	245	330	1	82	0.0121951
NODE_254783_length_263_cov_0.810976	163	245	335	1	82	0.0121951
NODE_254783_length_263_cov_0.810976	163	245	339	1	82	0.0121951
NODE_254783_length_263_cov_0.810976	163	245	344	1	82	0.0121951
NODE_254783_length_263_cov_0.810976	163	245	351	1	82	0.0121951
NODE_254783_length_263_cov_0.810976	163	245	354	1	82	0.0121951
NODE_254783_length_263_cov_0.810976	163	245	359	1	82	0.0121951
NODE_254783_length_263_cov_0.810976	163	245	361	1	82	0.0121951
NODE_254783_length_263_cov_0.810976	163	245	363	1	82	0.0121951
NODE_254783_length_263_cov_0.810976	163	245	367	1	82	0.0121951
NODE_254783_length_263_cov_0.810976	163	245	373	2	82	0.0243902
NODE_254783_length_263_cov_0.810976	163	245	375	1	82	0.0121951
NODE_254783_length_263_cov_0.810976	163	245	381	1	82	0.0121951
NODE_254783_length_263_cov_0.810976	163	245	383	4	82	0.0487805
NODE_254783_length_263_cov_0.810976	163	245	385	1	82	0.0121951
NODE_255446_length_263_cov_0.621951	212	258	0	46	46	1.0000000
NODE_255524_length_263_cov_0.621951	131	151	0	20	20	1.0000000
NODE_255559_length_263_cov_0.621951	67	86	0	16	19	0.8421053
NODE_255559_length_263_cov_0.621951	67	86	2	3	19	0.1578947
NODE_255727_length_262_cov_5.312883	20	82	2	62	62	1.0000000
NODE_255769_length_262_cov_4.447853	102	155	0	15	53	0.2830189
NODE_255769_length_262_cov_4.447853	102	155	2	10	53	0.1886792
NODE_255769_length_262_cov_4.447853	102	155	4	28	53	0.5283019
NODE_255821_length_262_cov_3.766871	48	89	0	41	41	1.0000000
NODE_255860_length_262_cov_3.435583	158	235	0	36	77	0.4675325
NODE_255860_length_262_cov_3.435583	158	235	2	41	77	0.5324675
NODE_255945_length_262_cov_2.938650	142	222	2	26	80	0.3250000
NODE_255945_length_262_cov_2.938650	142	222	4	54	80	0.6750000
NODE_256009_length_262_cov_2.723926	103	183	0	27	80	0.3375000
NODE_256009_length_262_cov_2.723926	103	183	4	53	80	0.6625000
NODE_256049_length_262_cov_2.509202	88	148	2	7	60	0.1166667
NODE_256049_length_262_cov_2.509202	88	148	6	53	60	0.8833333
NODE_256050_length_262_cov_2.509202	0	61	0	61	61	1.0000000
NODE_256050_length_262_cov_2.509202	107	171	2	64	64	1.0000000
NODE_256050_length_262_cov_2.509202	144	224	0	51	80	0.6375000
NODE_256050_length_262_cov_2.509202	144	224	2	29	80	0.3625000
NODE_256129_length_262_cov_2.429448	14	87	4	35	73	0.4794520
NODE_256129_length_262_cov_2.429448	14	87	6	38	73	0.5205479
NODE_256129_length_262_cov_2.429448	62	149	0	21	87	0.2413793
NODE_256129_length_262_cov_2.429448	62	149	2	41	87	0.4712644
NODE_256129_length_262_cov_2.429448	62	149	4	17	87	0.1954023
NODE_256129_length_262_cov_2.429448	62	149	6	8	87	0.0919540
NODE_256176_length_262_cov_2.226994	2	79	0	77	77	1.0000000
NODE_256187_length_262_cov_2.202454	61	81	0	20	20	1.0000000
NODE_256199_length_262_cov_2.190184	172	235	39	10	63	0.1587302
NODE_256199_length_262_cov_2.190184	172	235	41	5	63	0.0793651
NODE_256199_length_262_cov_2.190184	172	235	43	4	63	0.0634921
NODE_256199_length_262_cov_2.190184	172	235	45	3	63	0.0476190
NODE_256199_length_262_cov_2.190184	172	235	46	6	63	0.0952381
NODE_256199_length_262_cov_2.190184	172	235	47	3	63	0.0476190
NODE_256199_length_262_cov_2.190184	172	235	49	7	63	0.1111111
NODE_256199_length_262_cov_2.190184	172	235	50	25	63	0.3968254
NODE_256239_length_262_cov_2.177914	133	189	0	20	56	0.3571429
NODE_256239_length_262_cov_2.177914	133	189	2	36	56	0.6428571
NODE_256265_length_262_cov_2.122699	96	157	8	25	61	0.4098361
NODE_256265_length_262_cov_2.122699	96	157	10	2	61	0.0327869
NODE_256265_length_262_cov_2.122699	96	157	11	1	61	0.0163934
NODE_256265_length_262_cov_2.122699	96	157	12	33	61	0.5409836
NODE_256386_length_262_cov_1.877301	0	77	0	2	77	0.0259740
NODE_256386_length_262_cov_1.877301	0	77	6	11	77	0.1428571
NODE_256386_length_262_cov_1.877301	0	77	8	2	77	0.0259740
NODE_256386_length_262_cov_1.877301	0	77	10	31	77	0.4025974
NODE_256386_length_262_cov_1.877301	0	77	12	31	77	0.4025974
NODE_256390_length_262_cov_1.877301	77	124	4	1	47	0.0212766
NODE_256390_length_262_cov_1.877301	77	124	8	23	47	0.4893617
NODE_256390_length_262_cov_1.877301	77	124	10	23	47	0.4893617
NODE_256481_length_262_cov_1.871166	192	252	0	60	60	1.0000000
NODE_256596_length_262_cov_1.736196	149	208	0	59	59	1.0000000
NODE_256630_length_262_cov_1.680982	2	82	0	11	80	0.1375000
NODE_256630_length_262_cov_1.680982	2	82	1	1	80	0.0125000
NODE_256630_length_262_cov_1.680982	2	82	2	68	80	0.8500000
NODE_256650_length_262_cov_1.656442	135	166	6	31	31	1.0000000
NODE_256659_length_262_cov_1.638037	111	142	0	3	31	0.0967742
NODE_256659_length_262_cov_1.638037	111	142	2	3	31	0.0967742
NODE_256659_length_262_cov_1.638037	111	142	4	10	31	0.3225806
NODE_256659_length_262_cov_1.638037	111	142	6	4	31	0.1290323
NODE_256659_length_262_cov_1.638037	111	142	8	2	31	0.0645161
NODE_256659_length_262_cov_1.638037	111	142	10	9	31	0.2903226
NODE_256704_length_262_cov_1.576687	102	182	2	57	80	0.7125000
NODE_256704_length_262_cov_1.576687	102	182	4	23	80	0.2875000
NODE_256704_length_262_cov_1.576687	155	221	0	5	66	0.0757576
NODE_256704_length_262_cov_1.576687	155	221	2	61	66	0.9242424
NODE_256742_length_262_cov_1.564417	69	124	0	8	55	0.1454545
NODE_256742_length_262_cov_1.564417	69	124	2	47	55	0.8545455
NODE_256742_length_262_cov_1.564417	106	177	2	24	71	0.3380282
NODE_256742_length_262_cov_1.564417	106	177	4	25	71	0.3521127
NODE_256742_length_262_cov_1.564417	106	177	6	22	71	0.3098592
NODE_256933_length_262_cov_1.349693	52	102	0	18	50	0.3600000
NODE_256933_length_262_cov_1.349693	52	102	2	32	50	0.6400000
NODE_256933_length_262_cov_1.349693	83	149	0	65	66	0.9848485
NODE_256933_length_262_cov_1.349693	83	149	2	1	66	0.0151515
NODE_257199_length_262_cov_1.251534	44	124	2	57	80	0.7125000
NODE_257199_length_262_cov_1.251534	44	124	4	23	80	0.2875000
NODE_257199_length_262_cov_1.251534	97	171	2	69	74	0.9324324
NODE_257199_length_262_cov_1.251534	97	171	4	5	74	0.0675676
NODE_258876_length_261_cov_31.913580	32	112	0	80	80	1.0000000
NODE_258876_length_261_cov_31.913580	85	171	0	86	86	1.0000000
NODE_258901_length_261_cov_6.376543	126	201	0	73	75	0.9733334
NODE_258901_length_261_cov_6.376543	126	201	2	2	75	0.0266667
NODE_258901_length_261_cov_6.376543	179	254	0	75	75	1.0000000
NODE_258929_length_261_cov_5.469136	56	132	0	63	76	0.8289474
NODE_258929_length_261_cov_5.469136	56	132	1	3	76	0.0394737
NODE_258929_length_261_cov_5.469136	56	132	2	10	76	0.1315790
NODE_259329_length_261_cov_2.425926	53	134	2	12	81	0.1481481
NODE_259329_length_261_cov_2.425926	53	134	4	16	81	0.1975309
NODE_259329_length_261_cov_2.425926	53	134	6	53	81	0.6543210
NODE_259361_length_261_cov_2.333333	41	136	2	33	95	0.3473684
NODE_259361_length_261_cov_2.333333	41	136	4	6	95	0.0631579
NODE_259361_length_261_cov_2.333333	41	136	6	56	95	0.5894737
NODE_259435_length_261_cov_2.191358	86	122	2	36	36	1.0000000
NODE_259495_length_261_cov_1.993827	134	214	0	80	80	1.0000000
NODE_259672_length_261_cov_1.882716	51	105	10	1	54	0.0185185
NODE_259672_length_261_cov_1.882716	51	105	12	5	54	0.0925926
NODE_259672_length_261_cov_1.882716	51	105	14	1	54	0.0185185
NODE_259672_length_261_cov_1.882716	51	105	16	2	54	0.0370370
NODE_259672_length_261_cov_1.882716	51	105	17	2	54	0.0370370
NODE_259672_length_261_cov_1.882716	51	105	18	5	54	0.0925926
NODE_259672_length_261_cov_1.882716	51	105	20	3	54	0.0555556
NODE_259672_length_261_cov_1.882716	51	105	22	4	54	0.0740741
NODE_259672_length_261_cov_1.882716	51	105	30	3	54	0.0555556
NODE_259672_length_261_cov_1.882716	51	105	32	2	54	0.0370370
NODE_259672_length_261_cov_1.882716	51	105	34	4	54	0.0740741
NODE_259672_length_261_cov_1.882716	51	105	36	22	54	0.4074074
NODE_259740_length_261_cov_1.839506	118	197	0	2	79	0.0253165
NODE_259740_length_261_cov_1.839506	118	197	2	4	79	0.0506329
NODE_259740_length_261_cov_1.839506	118	197	4	51	79	0.6455696
NODE_259740_length_261_cov_1.839506	118	197	6	22	79	0.2784810
NODE_259769_length_261_cov_1.783951	69	141	2	24	72	0.3333333
NODE_259769_length_261_cov_1.783951	69	141	4	48	72	0.6666667
NODE_260089_length_261_cov_1.388889	202	247	0	45	45	1.0000000
NODE_260090_length_261_cov_1.382716	14	61	0	47	47	1.0000000
NODE_260428_length_261_cov_1.253086	100	138	2	38	38	1.0000000
NODE_260738_length_261_cov_1.030864	122	205	0	35	83	0.4216867
NODE_260738_length_261_cov_1.030864	122	205	2	48	83	0.5783132
NODE_260738_length_261_cov_1.030864	129	210	0	28	81	0.3456790
NODE_260738_length_261_cov_1.030864	129	210	2	53	81	0.6543210
NODE_260738_length_261_cov_1.030864	129	184	0	28	55	0.5090909
NODE_260738_length_261_cov_1.030864	129	184	2	27	55	0.4909091
NODE_260738_length_261_cov_1.030864	187	248	2	61	61	1.0000000
NODE_260767_length_261_cov_1.006173	3	45	0	5	42	0.1190476
NODE_260767_length_261_cov_1.006173	3	45	2	8	42	0.1904762
NODE_260767_length_261_cov_1.006173	3	45	4	29	42	0.6904762
NODE_260767_length_261_cov_1.006173	46	98	0	16	52	0.3076923
NODE_260767_length_261_cov_1.006173	46	98	2	14	52	0.2692308
NODE_260767_length_261_cov_1.006173	46	98	4	22	52	0.4230769
NODE_262062_length_261_cov_0.580247	11	31	0	20	20	1.0000000
NODE_262121_length_260_cov_8.844720	74	138	4	11	64	0.1718750
NODE_262121_length_260_cov_8.844720	74	138	6	11	64	0.1718750
NODE_262121_length_260_cov_8.844720	74	138	8	42	64	0.6562500
NODE_262123_length_260_cov_8.447205	30	110	4	30	80	0.3750000
NODE_262123_length_260_cov_8.447205	30	110	6	50	80	0.6250000
NODE_262123_length_260_cov_8.447205	83	167	0	5	84	0.0595238
NODE_262123_length_260_cov_8.447205	83	167	2	49	84	0.5833333
NODE_262123_length_260_cov_8.447205	83	167	6	30	84	0.3571429
NODE_262123_length_260_cov_8.447205	163	243	0	80	80	1.0000000
NODE_262149_length_260_cov_5.807453	38	118	0	80	80	1.0000000
NODE_262149_length_260_cov_5.807453	91	171	0	80	80	1.0000000
NODE_262264_length_260_cov_3.645963	5	57	0	52	52	1.0000000
NODE_262329_length_260_cov_3.167702	91	163	0	72	72	1.0000000
NODE_262378_length_260_cov_2.981366	58	127	0	24	69	0.3478261
NODE_262378_length_260_cov_2.981366	58	127	2	45	69	0.6521739
NODE_262384_length_260_cov_2.913043	10	90	0	80	80	1.0000000
NODE_262708_length_260_cov_2.161491	174	251	0	77	77	1.0000000
NODE_262733_length_260_cov_2.080745	188	258	0	70	70	1.0000000
NODE_262788_length_260_cov_1.950311	27	85	0	47	58	0.8103448
NODE_262788_length_260_cov_1.950311	27	85	2	11	58	0.1896552
NODE_262930_length_260_cov_1.900621	14	50	0	36	36	1.0000000
NODE_263117_length_260_cov_1.683230	50	130	0	80	80	1.0000000
NODE_263428_length_260_cov_1.347826	38	118	2	80	80	1.0000000
NODE_263533_length_260_cov_1.267081	114	199	0	85	85	1.0000000
NODE_263556_length_260_cov_1.267081	198	244	0	46	46	1.0000000
NODE_263568_length_260_cov_1.267081	145	189	2	44	44	1.0000000
NODE_265483_length_259_cov_4.800000	35	95	0	60	60	1.0000000
NODE_265584_length_259_cov_3.675000	119	161	0	42	42	1.0000000
NODE_265584_length_259_cov_3.675000	134	214	0	80	80	1.0000000
NODE_265592_length_259_cov_3.593750	100	143	2	43	43	1.0000000
NODE_265611_length_259_cov_3.475000	198	259	0	61	61	1.0000000
NODE_265625_length_259_cov_3.331250	72	118	0	46	46	1.0000000
NODE_265636_length_259_cov_3.237500	103	160	0	22	57	0.3859649
NODE_265636_length_259_cov_3.237500	103	160	2	30	57	0.5263158
NODE_265636_length_259_cov_3.237500	103	160	4	5	57	0.0877193
NODE_265704_length_259_cov_2.937500	209	233	1	8	24	0.3333333
NODE_265704_length_259_cov_2.937500	209	233	2	3	24	0.1250000
NODE_265704_length_259_cov_2.937500	209	233	4	2	24	0.0833333
NODE_265704_length_259_cov_2.937500	209	233	6	10	24	0.4166667
NODE_265704_length_259_cov_2.937500	209	233	16	1	24	0.0416667
NODE_265735_length_259_cov_2.850000	0	41	0	41	41	1.0000000
NODE_265735_length_259_cov_2.850000	14	94	0	37	80	0.4625000
NODE_265735_length_259_cov_2.850000	14	94	2	43	80	0.5375000
NODE_265818_length_259_cov_2.550000	9	82	0	6	73	0.0821918
NODE_265818_length_259_cov_2.550000	9	82	2	67	73	0.9178082
NODE_265942_length_259_cov_2.287500	147	225	0	31	78	0.3974359
NODE_265942_length_259_cov_2.287500	147	225	2	47	78	0.6025641
NODE_265942_length_259_cov_2.287500	198	241	0	43	43	1.0000000
NODE_266032_length_259_cov_2.156250	0	72	0	72	72	1.0000000
NODE_266080_length_259_cov_2.012500	8	73	0	11	65	0.1692308
NODE_266080_length_259_cov_2.012500	8	73	2	54	65	0.8307692
NODE_266080_length_259_cov_2.012500	53	126	0	24	73	0.3287671
NODE_266080_length_259_cov_2.012500	53	126	2	49	73	0.6712329
NODE_266101_length_259_cov_1.962500	108	189	6	3	81	0.0370370
NODE_266101_length_259_cov_1.962500	108	189	10	49	81	0.6049383
NODE_266101_length_259_cov_1.962500	108	189	12	29	81	0.3580247
NODE_266117_length_259_cov_1.918750	49	120	0	71	71	1.0000000
NODE_266183_length_259_cov_1.912500	114	177	0	58	63	0.9206349
NODE_266183_length_259_cov_1.912500	114	177	2	5	63	0.0793651
NODE_266365_length_259_cov_1.837500	180	252	2	4	72	0.0555556
NODE_266365_length_259_cov_1.837500	180	252	4	68	72	0.9444444
NODE_266609_length_259_cov_1.593750	27	67	4	40	40	1.0000000
NODE_266746_length_259_cov_1.400000	117	164	0	47	47	1.0000000
NODE_266746_length_259_cov_1.400000	137	217	0	80	80	1.0000000
NODE_268816_length_258_cov_6.415094	129	209	0	34	80	0.4250000
NODE_268816_length_258_cov_6.415094	129	209	2	46	80	0.5750000
NODE_268816_length_258_cov_6.415094	182	258	0	76	76	1.0000000
NODE_268823_length_258_cov_6.157233	1	81	0	80	80	1.0000000
NODE_268823_length_258_cov_6.157233	9	64	0	55	55	1.0000000
NODE_268852_length_258_cov_4.798742	83	163	0	20	80	0.2500000
NODE_268852_length_258_cov_4.798742	83	163	2	28	80	0.3500000
NODE_268852_length_258_cov_4.798742	83	163	4	32	80	0.4000000
NODE_268870_length_258_cov_4.396226	0	44	0	20	44	0.4545455
NODE_268870_length_258_cov_4.396226	0	44	2	24	44	0.5454546
NODE_268870_length_258_cov_4.396226	24	97	2	70	73	0.9589041
NODE_268870_length_258_cov_4.396226	24	97	4	3	73	0.0410959
NODE_268880_length_258_cov_4.301887	0	54	0	54	54	1.0000000
NODE_268942_length_258_cov_3.616352	29	58	0	1	29	0.0344828
NODE_268942_length_258_cov_3.616352	29	58	2	28	29	0.9655172
NODE_268982_length_258_cov_3.352201	47	127	16	1	80	0.0125000
NODE_268982_length_258_cov_3.352201	47	127	18	1	80	0.0125000
NODE_268982_length_258_cov_3.352201	47	127	20	7	80	0.0875000
NODE_268982_length_258_cov_3.352201	47	127	22	5	80	0.0625000
NODE_268982_length_258_cov_3.352201	47	127	24	24	80	0.3000000
NODE_268982_length_258_cov_3.352201	47	127	26	42	80	0.5250000
NODE_269086_length_258_cov_2.886792	102	121	6	2	19	0.1052632
NODE_269086_length_258_cov_2.886792	102	121	8	17	19	0.8947368
NODE_269091_length_258_cov_2.880503	92	172	0	21	80	0.2625000
NODE_269091_length_258_cov_2.880503	92	172	2	59	80	0.7375000
NODE_269102_length_258_cov_2.855346	96	138	27	6	42	0.1428571
NODE_269102_length_258_cov_2.855346	96	138	31	1	42	0.0238095
NODE_269102_length_258_cov_2.855346	96	138	33	6	42	0.1428571
NODE_269102_length_258_cov_2.855346	96	138	35	11	42	0.2619048
NODE_269102_length_258_cov_2.855346	96	138	37	8	42	0.1904762
NODE_269102_length_258_cov_2.855346	96	138	39	10	42	0.2380952
NODE_269102_length_258_cov_2.855346	148	191	0	23	43	0.5348837
NODE_269102_length_258_cov_2.855346	148	191	2	2	43	0.0465116
NODE_269102_length_258_cov_2.855346	148	191	3	2	43	0.0465116
NODE_269102_length_258_cov_2.855346	148	191	5	6	43	0.1395349
NODE_269102_length_258_cov_2.855346	148	191	9	10	43	0.2325581
NODE_269113_length_258_cov_2.817610	10	58	0	21	48	0.4375000
NODE_269113_length_258_cov_2.817610	10	58	2	11	48	0.2291667
NODE_269113_length_258_cov_2.817610	10	58	4	12	48	0.2500000
NODE_269113_length_258_cov_2.817610	10	58	6	2	48	0.0416667
NODE_269113_length_258_cov_2.817610	10	58	10	2	48	0.0416667
NODE_269264_length_258_cov_2.383648	48	128	2	21	80	0.2625000
NODE_269264_length_258_cov_2.383648	48	128	4	23	80	0.2875000
NODE_269264_length_258_cov_2.383648	48	128	5	14	80	0.1750000
NODE_269264_length_258_cov_2.383648	48	128	7	22	80	0.2750000
NODE_269264_length_258_cov_2.383648	101	182	5	31	81	0.3827161
NODE_269264_length_258_cov_2.383648	101	182	6	37	81	0.4567901
NODE_269264_length_258_cov_2.383648	101	182	7	13	81	0.1604938
NODE_269338_length_258_cov_2.238994	61	141	0	25	80	0.3125000
NODE_269338_length_258_cov_2.238994	61	141	2	55	80	0.6875000
NODE_269615_length_258_cov_1.918239	0	51	0	51	51	1.0000000
NODE_269682_length_258_cov_1.855346	26	47	0	8	21	0.3809524
NODE_269682_length_258_cov_1.855346	26	47	4	8	21	0.3809524
NODE_269682_length_258_cov_1.855346	26	47	5	5	21	0.2380952
NODE_269682_length_258_cov_1.855346	71	104	10	31	33	0.9393939
NODE_269682_length_258_cov_1.855346	71	104	11	2	33	0.0606061
NODE_269682_length_258_cov_1.855346	81	156	8	8	75	0.1066667
NODE_269682_length_258_cov_1.855346	81	156	9	4	75	0.0533333
NODE_269682_length_258_cov_1.855346	81	156	10	21	75	0.2800000
NODE_269682_length_258_cov_1.855346	81	156	11	37	75	0.4933333
NODE_269682_length_258_cov_1.855346	81	156	15	5	75	0.0666667
NODE_269749_length_258_cov_1.735849	105	176	6	13	71	0.1830986
NODE_269749_length_258_cov_1.735849	105	176	8	7	71	0.0985916
NODE_269749_length_258_cov_1.735849	105	176	10	16	71	0.2253521
NODE_269749_length_258_cov_1.735849	105	176	12	22	71	0.3098592
NODE_269749_length_258_cov_1.735849	105	176	14	1	71	0.0140845
NODE_269749_length_258_cov_1.735849	105	176	16	10	71	0.1408451
NODE_269749_length_258_cov_1.735849	105	176	18	2	71	0.0281690
NODE_269767_length_258_cov_1.710692	8	49	0	21	41	0.5121951
NODE_269767_length_258_cov_1.710692	8	49	7	2	41	0.0487805
NODE_269767_length_258_cov_1.710692	8	49	8	8	41	0.1951219
NODE_269767_length_258_cov_1.710692	8	49	12	10	41	0.2439024
NODE_270191_length_258_cov_1.283019	127	191	4	19	64	0.2968750
NODE_270191_length_258_cov_1.283019	127	191	6	29	64	0.4531250
NODE_270191_length_258_cov_1.283019	127	191	8	11	64	0.1718750
NODE_270191_length_258_cov_1.283019	127	191	10	5	64	0.0781250
NODE_270191_length_258_cov_1.283019	164	227	6	14	63	0.2222222
NODE_270191_length_258_cov_1.283019	164	227	8	8	63	0.1269841
NODE_270191_length_258_cov_1.283019	164	227	9	28	63	0.4444444
NODE_270191_length_258_cov_1.283019	164	227	10	13	63	0.2063492
NODE_270465_length_258_cov_1.270440	4	55	0	51	51	1.0000000
NODE_270504_length_258_cov_1.232704	90	166	10	2	76	0.0263158
NODE_270504_length_258_cov_1.232704	90	166	12	4	76	0.0526316
NODE_270504_length_258_cov_1.232704	90	166	14	1	76	0.0131579
NODE_270504_length_258_cov_1.232704	90	166	16	1	76	0.0131579
NODE_270504_length_258_cov_1.232704	90	166	18	5	76	0.0657895
NODE_270504_length_258_cov_1.232704	90	166	19	10	76	0.1315790
NODE_270504_length_258_cov_1.232704	90	166	20	33	76	0.4342105
NODE_270504_length_258_cov_1.232704	90	166	22	12	76	0.1578947
NODE_270504_length_258_cov_1.232704	90	166	24	8	76	0.1052632
NODE_270547_length_258_cov_1.201258	49	98	2	39	49	0.7959183
NODE_270547_length_258_cov_1.201258	49	98	4	10	49	0.2040816
NODE_270876_length_258_cov_0.962264	186	258	0	72	72	1.0000000
NODE_270970_length_258_cov_0.962264	69	124	3	12	55	0.2181818
NODE_270970_length_258_cov_0.962264	69	124	5	9	55	0.1636364
NODE_270970_length_258_cov_0.962264	69	124	7	22	55	0.4000000
NODE_270970_length_258_cov_0.962264	69	124	8	3	55	0.0545455
NODE_270970_length_258_cov_0.962264	69	124	10	4	55	0.0727273
NODE_270970_length_258_cov_0.962264	69	124	14	5	55	0.0909091
NODE_272169_length_257_cov_71.158228	81	165	74	9	84	0.1071429
NODE_272169_length_257_cov_71.158228	81	165	76	1	84	0.0119048
NODE_272169_length_257_cov_71.158228	81	165	78	2	84	0.0238095
NODE_272169_length_257_cov_71.158228	81	165	82	1	84	0.0119048
NODE_272169_length_257_cov_71.158228	81	165	86	2	84	0.0238095
NODE_272169_length_257_cov_71.158228	81	165	88	2	84	0.0238095
NODE_272169_length_257_cov_71.158228	81	165	90	2	84	0.0238095
NODE_272169_length_257_cov_71.158228	81	165	92	2	84	0.0238095
NODE_272169_length_257_cov_71.158228	81	165	98	1	84	0.0119048
NODE_272169_length_257_cov_71.158228	81	165	102	1	84	0.0119048
NODE_272169_length_257_cov_71.158228	81	165	104	2	84	0.0238095
NODE_272169_length_257_cov_71.158228	81	165	108	1	84	0.0119048
NODE_272169_length_257_cov_71.158228	81	165	110	1	84	0.0119048
NODE_272169_length_257_cov_71.158228	81	165	112	1	84	0.0119048
NODE_272169_length_257_cov_71.158228	81	165	114	1	84	0.0119048
NODE_272169_length_257_cov_71.158228	81	165	116	1	84	0.0119048
NODE_272169_length_257_cov_71.158228	81	165	118	2	84	0.0238095
NODE_272169_length_257_cov_71.158228	81	165	120	2	84	0.0238095
NODE_272169_length_257_cov_71.158228	81	165	122	1	84	0.0119048
NODE_272169_length_257_cov_71.158228	81	165	124	3	84	0.0357143
NODE_272169_length_257_cov_71.158228	81	165	126	2	84	0.0238095
NODE_272169_length_257_cov_71.158228	81	165	128	7	84	0.0833333
NODE_272169_length_257_cov_71.158228	81	165	130	9	84	0.1071429
NODE_272169_length_257_cov_71.158228	81	165	132	3	84	0.0357143
NODE_272169_length_257_cov_71.158228	81	165	134	8	84	0.0952381
NODE_272169_length_257_cov_71.158228	81	165	136	6	84	0.0714286
NODE_272169_length_257_cov_71.158228	81	165	138	7	84	0.0833333
NODE_272169_length_257_cov_71.158228	81	165	140	4	84	0.0476190
NODE_272169_length_257_cov_71.158228	145	218	16	1	73	0.0136986
NODE_272169_length_257_cov_71.158228	145	218	18	3	73	0.0410959
NODE_272169_length_257_cov_71.158228	145	218	20	2	73	0.0273973
NODE_272169_length_257_cov_71.158228	145	218	23	2	73	0.0273973
NODE_272169_length_257_cov_71.158228	145	218	24	8	73	0.1095890
NODE_272169_length_257_cov_71.158228	145	218	28	1	73	0.0136986
NODE_272169_length_257_cov_71.158228	145	218	31	4	73	0.0547945
NODE_272169_length_257_cov_71.158228	145	218	33	5	73	0.0684932
NODE_272169_length_257_cov_71.158228	145	218	36	1	73	0.0136986
NODE_272169_length_257_cov_71.158228	145	218	37	1	73	0.0136986
NODE_272169_length_257_cov_71.158228	145	218	39	4	73	0.0547945
NODE_272169_length_257_cov_71.158228	145	218	43	1	73	0.0136986
NODE_272169_length_257_cov_71.158228	145	218	47	1	73	0.0136986
NODE_272169_length_257_cov_71.158228	145	218	48	1	73	0.0136986
NODE_272169_length_257_cov_71.158228	145	218	51	2	73	0.0273973
NODE_272169_length_257_cov_71.158228	145	218	53	1	73	0.0136986
NODE_272169_length_257_cov_71.158228	145	218	54	3	73	0.0410959
NODE_272169_length_257_cov_71.158228	145	218	56	1	73	0.0136986
NODE_272169_length_257_cov_71.158228	145	218	58	6	73	0.0821918
NODE_272169_length_257_cov_71.158228	145	218	66	2	73	0.0273973
NODE_272169_length_257_cov_71.158228	145	218	72	3	73	0.0410959
NODE_272169_length_257_cov_71.158228	145	218	74	9	73	0.1232877
NODE_272169_length_257_cov_71.158228	145	218	76	1	73	0.0136986
NODE_272169_length_257_cov_71.158228	145	218	78	2	73	0.0273973
NODE_272169_length_257_cov_71.158228	145	218	82	1	73	0.0136986
NODE_272169_length_257_cov_71.158228	145	218	86	2	73	0.0273973
NODE_272169_length_257_cov_71.158228	145	218	88	2	73	0.0273973
NODE_272169_length_257_cov_71.158228	145	218	90	2	73	0.0273973
NODE_272169_length_257_cov_71.158228	145	218	92	1	73	0.0136986
NODE_272194_length_257_cov_6.329114	15	93	2	9	78	0.1153846
NODE_272194_length_257_cov_6.329114	15	93	4	69	78	0.8846154
NODE_272275_length_257_cov_4.177215	25	86	0	58	61	0.9508197
NODE_272275_length_257_cov_4.177215	25	86	4	3	61	0.0491803
NODE_272291_length_257_cov_3.987342	55	107	0	52	52	1.0000000
NODE_272304_length_257_cov_3.873418	145	225	0	80	80	1.0000000
NODE_272304_length_257_cov_3.873418	198	254	0	56	56	1.0000000
NODE_272322_length_257_cov_3.740506	133	199	9	2	66	0.0303030
NODE_272322_length_257_cov_3.740506	133	199	13	4	66	0.0606061
NODE_272322_length_257_cov_3.740506	133	199	15	2	66	0.0303030
NODE_272322_length_257_cov_3.740506	133	199	16	4	66	0.0606061
NODE_272322_length_257_cov_3.740506	133	199	18	1	66	0.0151515
NODE_272322_length_257_cov_3.740506	133	199	21	1	66	0.0151515
NODE_272322_length_257_cov_3.740506	133	199	23	3	66	0.0454545
NODE_272322_length_257_cov_3.740506	133	199	24	1	66	0.0151515
NODE_272322_length_257_cov_3.740506	133	199	26	2	66	0.0303030
NODE_272322_length_257_cov_3.740506	133	199	30	4	66	0.0606061
NODE_272322_length_257_cov_3.740506	133	199	32	1	66	0.0151515
NODE_272322_length_257_cov_3.740506	133	199	36	4	66	0.0606061
NODE_272322_length_257_cov_3.740506	133	199	38	1	66	0.0151515
NODE_272322_length_257_cov_3.740506	133	199	40	2	66	0.0303030
NODE_272322_length_257_cov_3.740506	133	199	44	1	66	0.0151515
NODE_272322_length_257_cov_3.740506	133	199	52	1	66	0.0151515
NODE_272322_length_257_cov_3.740506	133	199	53	3	66	0.0454545
NODE_272322_length_257_cov_3.740506	133	199	55	1	66	0.0151515
NODE_272322_length_257_cov_3.740506	133	199	57	2	66	0.0303030
NODE_272322_length_257_cov_3.740506	133	199	58	5	66	0.0757576
NODE_272322_length_257_cov_3.740506	133	199	60	1	66	0.0151515
NODE_272322_length_257_cov_3.740506	133	199	62	3	66	0.0454545
NODE_272322_length_257_cov_3.740506	133	199	64	4	66	0.0606061
NODE_272322_length_257_cov_3.740506	133	199	65	5	66	0.0757576
NODE_272322_length_257_cov_3.740506	133	199	66	1	66	0.0151515
NODE_272322_length_257_cov_3.740506	133	199	67	1	66	0.0151515
NODE_272322_length_257_cov_3.740506	133	199	68	3	66	0.0454545
NODE_272322_length_257_cov_3.740506	133	199	69	1	66	0.0151515
NODE_272322_length_257_cov_3.740506	133	199	70	1	66	0.0151515
NODE_272322_length_257_cov_3.740506	133	199	72	1	66	0.0151515
NODE_272322_length_257_cov_3.740506	177	256	0	10	79	0.1265823
NODE_272322_length_257_cov_3.740506	177	256	2	20	79	0.2531646
NODE_272322_length_257_cov_3.740506	177	256	4	18	79	0.2278481
NODE_272322_length_257_cov_3.740506	177	256	5	6	79	0.0759494
NODE_272322_length_257_cov_3.740506	177	256	7	3	79	0.0379747
NODE_272322_length_257_cov_3.740506	177	256	9	2	79	0.0253165
NODE_272322_length_257_cov_3.740506	177	256	13	4	79	0.0506329
NODE_272322_length_257_cov_3.740506	177	256	15	2	79	0.0253165
NODE_272322_length_257_cov_3.740506	177	256	16	4	79	0.0506329
NODE_272322_length_257_cov_3.740506	177	256	18	1	79	0.0126582
NODE_272322_length_257_cov_3.740506	177	256	21	1	79	0.0126582
NODE_272322_length_257_cov_3.740506	177	256	23	3	79	0.0379747
NODE_272322_length_257_cov_3.740506	177	256	24	1	79	0.0126582
NODE_272322_length_257_cov_3.740506	177	256	26	2	79	0.0253165
NODE_272322_length_257_cov_3.740506	177	256	30	2	79	0.0253165
NODE_272486_length_257_cov_2.734177	1	65	0	64	64	1.0000000
NODE_272491_length_257_cov_2.677215	170	250	0	23	80	0.2875000
NODE_272491_length_257_cov_2.677215	170	250	2	20	80	0.2500000
NODE_272491_length_257_cov_2.677215	170	250	4	2	80	0.0250000
NODE_272491_length_257_cov_2.677215	170	250	6	4	80	0.0500000
NODE_272491_length_257_cov_2.677215	170	250	8	11	80	0.1375000
NODE_272491_length_257_cov_2.677215	170	250	10	6	80	0.0750000
NODE_272491_length_257_cov_2.677215	170	250	16	1	80	0.0125000
NODE_272491_length_257_cov_2.677215	170	250	18	1	80	0.0125000
NODE_272491_length_257_cov_2.677215	170	250	24	11	80	0.1375000
NODE_272491_length_257_cov_2.677215	170	250	26	1	80	0.0125000
NODE_272580_length_257_cov_2.537975	60	137	0	75	77	0.9740260
NODE_272580_length_257_cov_2.537975	60	137	2	2	77	0.0259740
NODE_272596_length_257_cov_2.487342	95	172	0	47	77	0.6103896
NODE_272596_length_257_cov_2.487342	95	172	5	3	77	0.0389610
NODE_272596_length_257_cov_2.487342	95	172	9	27	77	0.3506494
NODE_272625_length_257_cov_2.379747	106	186	2	1	80	0.0125000
NODE_272625_length_257_cov_2.379747	106	186	4	6	80	0.0750000
NODE_272625_length_257_cov_2.379747	106	186	8	2	80	0.0250000
NODE_272625_length_257_cov_2.379747	106	186	10	12	80	0.1500000
NODE_272625_length_257_cov_2.379747	106	186	12	59	80	0.7375000
NODE_272625_length_257_cov_2.379747	159	207	2	14	48	0.2916667
NODE_272625_length_257_cov_2.379747	159	207	4	3	48	0.0625000
NODE_272625_length_257_cov_2.379747	159	207	8	5	48	0.1041667
NODE_272625_length_257_cov_2.379747	159	207	12	26	48	0.5416667
NODE_272724_length_257_cov_2.221519	163	240	0	14	77	0.1818182
NODE_272724_length_257_cov_2.221519	163	240	2	63	77	0.8181818
NODE_272729_length_257_cov_2.202532	16	97	0	81	81	1.0000000
NODE_273151_length_257_cov_1.664557	220	239	0	19	19	1.0000000
NODE_273357_length_257_cov_1.500000	85	166	4	81	81	1.0000000
NODE_273462_length_257_cov_1.329114	120	186	6	4	66	0.0606061
NODE_273462_length_257_cov_1.329114	120	186	8	62	66	0.9393939
NODE_273533_length_257_cov_1.291139	13	53	0	40	40	1.0000000
NODE_273697_length_257_cov_1.291139	205	257	0	52	52	1.0000000
NODE_273894_length_257_cov_1.221519	10	74	0	64	64	1.0000000
NODE_273917_length_257_cov_1.196203	70	150	0	20	80	0.2500000
NODE_273917_length_257_cov_1.196203	70	150	2	60	80	0.7500000
NODE_273917_length_257_cov_1.196203	123	204	0	18	81	0.2222222
NODE_273917_length_257_cov_1.196203	123	204	2	63	81	0.7777778
NODE_275399_length_257_cov_0.645570	138	158	0	20	20	1.0000000
NODE_275419_length_257_cov_0.645570	181	241	0	4	60	0.0666667
NODE_275419_length_257_cov_0.645570	181	241	2	54	60	0.9000000
NODE_275419_length_257_cov_0.645570	181	241	6	2	60	0.0333333
NODE_275598_length_256_cov_5.235669	30	77	0	47	47	1.0000000
NODE_275624_length_256_cov_4.598726	100	180	0	80	80	1.0000000
NODE_275624_length_256_cov_4.598726	160	211	0	51	51	1.0000000
NODE_275682_length_256_cov_3.866242	112	166	0	1	54	0.0185185
NODE_275682_length_256_cov_3.866242	112	166	2	8	54	0.1481481
NODE_275682_length_256_cov_3.866242	112	166	4	3	54	0.0555556
NODE_275682_length_256_cov_3.866242	112	166	6	11	54	0.2037037
NODE_275682_length_256_cov_3.866242	112	166	8	31	54	0.5740741
NODE_275840_length_256_cov_2.878981	79	159	0	80	80	1.0000000
NODE_275840_length_256_cov_2.878981	132	212	0	80	80	1.0000000
NODE_275909_length_256_cov_2.598726	157	222	0	65	65	1.0000000
NODE_275909_length_256_cov_2.598726	195	249	0	54	54	1.0000000
NODE_275981_length_256_cov_2.445860	104	183	0	13	79	0.1645570
NODE_275981_length_256_cov_2.445860	104	183	2	66	79	0.8354430
NODE_276082_length_256_cov_2.229299	0	58	0	58	58	1.0000000
NODE_276082_length_256_cov_2.229299	17	68	0	51	51	1.0000000
NODE_276082_length_256_cov_2.229299	41	88	0	47	47	1.0000000
NODE_276082_length_256_cov_2.229299	42	122	0	80	80	1.0000000
NODE_276098_length_256_cov_2.184713	192	246	0	5	54	0.0925926
NODE_276098_length_256_cov_2.184713	192	246	2	12	54	0.2222222
NODE_276098_length_256_cov_2.184713	192	246	4	37	54	0.6851852
NODE_276119_length_256_cov_2.121019	150	236	0	16	86	0.1860465
NODE_276119_length_256_cov_2.121019	150	236	2	18	86	0.2093023
NODE_276119_length_256_cov_2.121019	150	236	4	21	86	0.2441860
NODE_276119_length_256_cov_2.121019	150	236	6	31	86	0.3604651
NODE_276174_length_256_cov_1.974522	130	174	0	44	44	1.0000000
NODE_276471_length_256_cov_1.707006	39	92	2	2	53	0.0377358
NODE_276471_length_256_cov_1.707006	39	92	4	14	53	0.2641509
NODE_276471_length_256_cov_1.707006	39	92	6	4	53	0.0754717
NODE_276471_length_256_cov_1.707006	39	92	9	6	53	0.1132075
NODE_276471_length_256_cov_1.707006	39	92	13	11	53	0.2075472
NODE_276471_length_256_cov_1.707006	39	92	17	4	53	0.0754717
NODE_276471_length_256_cov_1.707006	39	92	19	6	53	0.1132075
NODE_276471_length_256_cov_1.707006	39	92	20	1	53	0.0188679
NODE_276471_length_256_cov_1.707006	39	92	21	5	53	0.0943396
NODE_276471_length_256_cov_1.707006	93	135	19	1	42	0.0238095
NODE_276471_length_256_cov_1.707006	93	135	22	3	42	0.0714286
NODE_276471_length_256_cov_1.707006	93	135	24	1	42	0.0238095
NODE_276471_length_256_cov_1.707006	93	135	26	7	42	0.1666667
NODE_276471_length_256_cov_1.707006	93	135	27	3	42	0.0714286
NODE_276471_length_256_cov_1.707006	93	135	29	2	42	0.0476190
NODE_276471_length_256_cov_1.707006	93	135	36	2	42	0.0476190
NODE_276471_length_256_cov_1.707006	93	135	39	1	42	0.0238095
NODE_276471_length_256_cov_1.707006	93	135	43	3	42	0.0714286
NODE_276471_length_256_cov_1.707006	93	135	45	10	42	0.2380952
NODE_276471_length_256_cov_1.707006	93	135	47	4	42	0.0952381
NODE_276471_length_256_cov_1.707006	93	135	49	5	42	0.1190476
NODE_276484_length_256_cov_1.700637	107	129	0	22	22	1.0000000
NODE_276495_length_256_cov_1.675159	52	98	0	46	46	1.0000000
NODE_276654_length_256_cov_1.598726	125	202	0	77	77	1.0000000
NODE_276654_length_256_cov_1.598726	178	256	0	78	78	1.0000000
NODE_276672_length_256_cov_1.579618	110	172	0	7	62	0.1129032
NODE_276672_length_256_cov_1.579618	110	172	2	55	62	0.8870968
NODE_276672_length_256_cov_1.579618	194	239	0	45	45	1.0000000
NODE_276742_length_256_cov_1.464968	112	135	0	23	23	1.0000000
NODE_276826_length_256_cov_1.331210	138	209	2	71	71	1.0000000
NODE_276826_length_256_cov_1.331210	182	240	0	3	58	0.0517241
NODE_276826_length_256_cov_1.331210	182	240	2	55	58	0.9482759
NODE_277113_length_256_cov_1.299363	88	160	2	24	72	0.3333333
NODE_277113_length_256_cov_1.299363	88	160	4	48	72	0.6666667
NODE_277305_length_256_cov_1.203822	3	43	2	9	40	0.2250000
NODE_277305_length_256_cov_1.203822	3	43	4	8	40	0.2000000
NODE_277305_length_256_cov_1.203822	3	43	10	5	40	0.1250000
NODE_277305_length_256_cov_1.203822	3	43	12	2	40	0.0500000
NODE_277305_length_256_cov_1.203822	3	43	16	4	40	0.1000000
NODE_277305_length_256_cov_1.203822	3	43	20	7	40	0.1750000
NODE_277305_length_256_cov_1.203822	3	43	22	1	40	0.0250000
NODE_277305_length_256_cov_1.203822	3	43	24	4	40	0.1000000
NODE_277305_length_256_cov_1.203822	16	96	4	4	80	0.0500000
NODE_277305_length_256_cov_1.203822	16	96	10	5	80	0.0625000
NODE_277305_length_256_cov_1.203822	16	96	12	2	80	0.0250000
NODE_277305_length_256_cov_1.203822	16	96	16	4	80	0.0500000
NODE_277305_length_256_cov_1.203822	16	96	20	7	80	0.0875000
NODE_277305_length_256_cov_1.203822	16	96	22	1	80	0.0125000
NODE_277305_length_256_cov_1.203822	16	96	24	28	80	0.3500000
NODE_277305_length_256_cov_1.203822	16	96	26	29	80	0.3625000
NODE_278934_length_255_cov_73.756410	52	99	6	47	47	1.0000000
NODE_278934_length_255_cov_73.756410	133	184	16	13	51	0.2549020
NODE_278934_length_255_cov_73.756410	133	184	17	8	51	0.1568628
NODE_278934_length_255_cov_73.756410	133	184	18	30	51	0.5882353
NODE_278934_length_255_cov_73.756410	157	237	7	17	80	0.2125000
NODE_278934_length_255_cov_73.756410	157	237	13	2	80	0.0250000
NODE_278934_length_255_cov_73.756410	157	237	16	47	80	0.5875000
NODE_278934_length_255_cov_73.756410	157	237	18	14	80	0.1750000
NODE_278937_length_255_cov_15.538462	219	255	0	36	36	1.0000000
NODE_279003_length_255_cov_4.884615	157	230	0	71	73	0.9726027
NODE_279003_length_255_cov_4.884615	157	230	2	2	73	0.0273973
NODE_279003_length_255_cov_4.884615	203	248	0	45	45	1.0000000
NODE_279058_length_255_cov_4.012821	68	148	0	8	80	0.1000000
NODE_279058_length_255_cov_4.012821	68	148	2	72	80	0.9000000
NODE_279075_length_255_cov_3.826923	16	80	10	1	64	0.0156250
NODE_279075_length_255_cov_3.826923	16	80	12	21	64	0.3281250
NODE_279075_length_255_cov_3.826923	16	80	14	42	64	0.6562500
NODE_279102_length_255_cov_3.596154	30	60	0	30	30	1.0000000
NODE_279134_length_255_cov_3.423077	64	109	2	45	45	1.0000000
NODE_279166_length_255_cov_3.262821	0	48	0	16	48	0.3333333
NODE_279166_length_255_cov_3.262821	0	48	4	26	48	0.5416667
NODE_279166_length_255_cov_3.262821	0	48	8	6	48	0.1250000
NODE_279166_length_255_cov_3.262821	66	113	10	47	47	1.0000000
NODE_279241_length_255_cov_2.942308	157	176	0	19	19	1.0000000
NODE_279320_length_255_cov_2.621795	227	254	0	27	27	1.0000000
NODE_279379_length_255_cov_2.602564	131	185	7	33	54	0.6111111
NODE_279379_length_255_cov_2.602564	131	185	9	15	54	0.2777778
NODE_279379_length_255_cov_2.602564	131	185	11	6	54	0.1111111
NODE_279427_length_255_cov_2.487179	43	119	2	2	76	0.0263158
NODE_279427_length_255_cov_2.487179	43	119	4	3	76	0.0394737
NODE_279427_length_255_cov_2.487179	43	119	6	5	76	0.0657895
NODE_279427_length_255_cov_2.487179	43	119	10	1	76	0.0131579
NODE_279427_length_255_cov_2.487179	43	119	12	5	76	0.0657895
NODE_279427_length_255_cov_2.487179	43	119	14	60	76	0.7894737
NODE_279447_length_255_cov_2.435897	0	58	0	58	58	1.0000000
NODE_279462_length_255_cov_2.391026	189	255	0	66	66	1.0000000
NODE_279507_length_255_cov_2.288462	0	60	0	60	60	1.0000000
NODE_279510_length_255_cov_2.288462	0	74	0	56	74	0.7567568
NODE_279510_length_255_cov_2.288462	0	74	2	18	74	0.2432432
NODE_279620_length_255_cov_2.089744	105	145	0	40	40	1.0000000
NODE_279649_length_255_cov_1.987179	0	72	0	72	72	1.0000000
NODE_279842_length_255_cov_1.910256	198	255	0	57	57	1.0000000
NODE_279871_length_255_cov_1.871795	16	68	4	52	52	1.0000000
NODE_279892_length_255_cov_1.826923	146	218	0	72	72	1.0000000
NODE_279956_length_255_cov_1.705128	0	45	0	45	45	1.0000000
NODE_279956_length_255_cov_1.705128	41	121	0	80	80	1.0000000
NODE_279956_length_255_cov_1.705128	94	174	0	80	80	1.0000000
NODE_280153_length_255_cov_1.576923	43	117	0	5	74	0.0675676
NODE_280153_length_255_cov_1.576923	43	117	2	1	74	0.0135135
NODE_280153_length_255_cov_1.576923	43	117	3	1	74	0.0135135
NODE_280153_length_255_cov_1.576923	43	117	5	1	74	0.0135135
NODE_280153_length_255_cov_1.576923	43	117	7	1	74	0.0135135
NODE_280153_length_255_cov_1.576923	43	117	8	2	74	0.0270270
NODE_280153_length_255_cov_1.576923	43	117	10	10	74	0.1351351
NODE_280153_length_255_cov_1.576923	43	117	12	6	74	0.0810811
NODE_280153_length_255_cov_1.576923	43	117	13	1	74	0.0135135
NODE_280153_length_255_cov_1.576923	43	117	14	23	74	0.3108108
NODE_280153_length_255_cov_1.576923	43	117	15	1	74	0.0135135
NODE_280153_length_255_cov_1.576923	43	117	16	2	74	0.0270270
NODE_280153_length_255_cov_1.576923	43	117	18	20	74	0.2702703
NODE_280153_length_255_cov_1.576923	90	175	3	1	85	0.0117647
NODE_280153_length_255_cov_1.576923	90	175	5	1	85	0.0117647
NODE_280153_length_255_cov_1.576923	90	175	7	1	85	0.0117647
NODE_280153_length_255_cov_1.576923	90	175	13	1	85	0.0117647
NODE_280153_length_255_cov_1.576923	90	175	15	1	85	0.0117647
NODE_280153_length_255_cov_1.576923	90	175	16	2	85	0.0235294
NODE_280153_length_255_cov_1.576923	90	175	18	26	85	0.3058824
NODE_280153_length_255_cov_1.576923	90	175	20	8	85	0.0941176
NODE_280153_length_255_cov_1.576923	90	175	22	8	85	0.0941176
NODE_280153_length_255_cov_1.576923	90	175	24	36	85	0.4235294
NODE_280168_length_255_cov_1.557692	62	125	0	57	63	0.9047619
NODE_280168_length_255_cov_1.557692	62	125	3	6	63	0.0952381
NODE_280297_length_255_cov_1.358974	178	246	0	68	68	1.0000000
NODE_280904_length_255_cov_1.128205	183	219	0	36	36	1.0000000
NODE_281094_length_255_cov_0.987179	220	241	0	21	21	1.0000000
NODE_281380_length_255_cov_0.955128	119	171	0	3	52	0.0576923
NODE_281380_length_255_cov_0.955128	119	171	2	49	52	0.9423077
NODE_281384_length_255_cov_0.955128	12	92	7	20	80	0.2500000
NODE_281384_length_255_cov_0.955128	12	92	9	41	80	0.5125000
NODE_281384_length_255_cov_0.955128	12	92	10	19	80	0.2375000
NODE_282137_length_255_cov_0.653846	87	106	2	19	19	1.0000000
NODE_282534_length_254_cov_4.935484	144	189	2	45	45	1.0000000
NODE_282534_length_254_cov_4.935484	164	242	0	48	78	0.6153846
NODE_282534_length_254_cov_4.935484	164	242	2	30	78	0.3846154
NODE_282548_length_254_cov_4.722581	44	85	10	41	41	1.0000000
NODE_282576_length_254_cov_4.296774	149	174	0	25	25	1.0000000
NODE_282576_length_254_cov_4.296774	149	223	0	74	74	1.0000000
NODE_282590_length_254_cov_4.206452	57	86	20	10	29	0.3448276
NODE_282590_length_254_cov_4.206452	57	86	22	11	29	0.3793103
NODE_282590_length_254_cov_4.206452	57	86	24	8	29	0.2758621
NODE_282626_length_254_cov_3.677419	7	64	0	5	57	0.0877193
NODE_282626_length_254_cov_3.677419	7	64	2	2	57	0.0350877
NODE_282626_length_254_cov_3.677419	7	64	4	3	57	0.0526316
NODE_282626_length_254_cov_3.677419	7	64	6	10	57	0.1754386
NODE_282626_length_254_cov_3.677419	7	64	8	8	57	0.1403509
NODE_282626_length_254_cov_3.677419	7	64	10	3	57	0.0526316
NODE_282626_length_254_cov_3.677419	7	64	12	26	57	0.4561403
NODE_282626_length_254_cov_3.677419	60	117	8	9	57	0.1578947
NODE_282626_length_254_cov_3.677419	60	117	10	23	57	0.4035088
NODE_282626_length_254_cov_3.677419	60	117	12	25	57	0.4385965
NODE_282642_length_254_cov_3.593548	154	197	0	43	43	1.0000000
NODE_282659_length_254_cov_3.438710	82	129	0	42	47	0.8936170
NODE_282659_length_254_cov_3.438710	82	129	2	5	47	0.1063830
NODE_282659_length_254_cov_3.438710	102	182	0	55	80	0.6875000
NODE_282659_length_254_cov_3.438710	102	182	4	25	80	0.3125000
NODE_282736_length_254_cov_2.961290	5	79	0	74	74	1.0000000
NODE_282736_length_254_cov_2.961290	52	118	0	66	66	1.0000000
NODE_282771_length_254_cov_2.780645	169	252	0	7	83	0.0843373
NODE_282771_length_254_cov_2.780645	169	252	2	1	83	0.0120482
NODE_282771_length_254_cov_2.780645	169	252	4	1	83	0.0120482
NODE_282771_length_254_cov_2.780645	169	252	6	12	83	0.1445783
NODE_282771_length_254_cov_2.780645	169	252	8	2	83	0.0240964
NODE_282771_length_254_cov_2.780645	169	252	12	7	83	0.0843373
NODE_282771_length_254_cov_2.780645	169	252	14	4	83	0.0481928
NODE_282771_length_254_cov_2.780645	169	252	16	1	83	0.0120482
NODE_282771_length_254_cov_2.780645	169	252	18	9	83	0.1084337
NODE_282771_length_254_cov_2.780645	169	252	24	2	83	0.0240964
NODE_282771_length_254_cov_2.780645	169	252	26	8	83	0.0963855
NODE_282771_length_254_cov_2.780645	169	252	28	1	83	0.0120482
NODE_282771_length_254_cov_2.780645	169	252	33	1	83	0.0120482
NODE_282771_length_254_cov_2.780645	169	252	42	2	83	0.0240964
NODE_282771_length_254_cov_2.780645	169	252	45	2	83	0.0240964
NODE_282771_length_254_cov_2.780645	169	252	47	4	83	0.0481928
NODE_282771_length_254_cov_2.780645	169	252	49	1	83	0.0120482
NODE_282771_length_254_cov_2.780645	169	252	51	9	83	0.1084337
NODE_282771_length_254_cov_2.780645	169	252	53	2	83	0.0240964
NODE_282771_length_254_cov_2.780645	169	252	57	1	83	0.0120482
NODE_282771_length_254_cov_2.780645	169	252	59	1	83	0.0120482
NODE_282771_length_254_cov_2.780645	169	252	63	1	83	0.0120482
NODE_282771_length_254_cov_2.780645	169	252	65	2	83	0.0240964
NODE_282771_length_254_cov_2.780645	169	252	67	2	83	0.0240964
NODE_282947_length_254_cov_2.341935	167	201	0	34	34	1.0000000
NODE_283082_length_254_cov_2.161290	14	74	0	60	60	1.0000000
NODE_283244_length_254_cov_1.974194	156	204	0	48	48	1.0000000
NODE_283440_length_254_cov_1.780645	79	126	8	5	47	0.1063830
NODE_283440_length_254_cov_1.780645	79	126	10	5	47	0.1063830
NODE_283440_length_254_cov_1.780645	79	126	14	5	47	0.1063830
NODE_283440_length_254_cov_1.780645	79	126	16	2	47	0.0425532
NODE_283440_length_254_cov_1.780645	79	126	18	3	47	0.0638298
NODE_283440_length_254_cov_1.780645	79	126	20	27	47	0.5744681
NODE_283952_length_254_cov_1.316129	23	87	2	64	64	1.0000000
NODE_284013_length_254_cov_1.316129	193	215	0	22	22	1.0000000
NODE_284256_length_254_cov_1.258065	181	249	0	50	68	0.7352941
NODE_284256_length_254_cov_1.258065	181	249	2	16	68	0.2352941
NODE_284256_length_254_cov_1.258065	181	249	4	2	68	0.0294118
NODE_284275_length_254_cov_1.238710	9	82	0	73	73	1.0000000
NODE_284275_length_254_cov_1.238710	62	82	0	20	20	1.0000000
NODE_284277_length_254_cov_1.238710	54	73	2	11	19	0.5789474
NODE_284277_length_254_cov_1.238710	54	73	4	8	19	0.4210526
NODE_284301_length_254_cov_1.219355	98	157	0	56	59	0.9491525
NODE_284301_length_254_cov_1.219355	98	157	2	1	59	0.0169492
NODE_284301_length_254_cov_1.219355	98	157	4	2	59	0.0338983
NODE_284638_length_254_cov_0.987097	139	193	0	54	54	1.0000000
NODE_284638_length_254_cov_0.987097	205	254	0	10	49	0.2040816
NODE_284638_length_254_cov_0.987097	205	254	2	39	49	0.7959183
NODE_284796_length_254_cov_0.987097	121	152	0	31	31	1.0000000
NODE_285963_length_253_cov_60.311688	137	202	8	1	65	0.0153846
NODE_285963_length_253_cov_60.311688	137	202	22	4	65	0.0615385
NODE_285963_length_253_cov_60.311688	137	202	28	3	65	0.0461538
NODE_285963_length_253_cov_60.311688	137	202	30	2	65	0.0307692
NODE_285963_length_253_cov_60.311688	137	202	32	1	65	0.0153846
NODE_285963_length_253_cov_60.311688	137	202	34	1	65	0.0153846
NODE_285963_length_253_cov_60.311688	137	202	36	1	65	0.0153846
NODE_285963_length_253_cov_60.311688	137	202	38	3	65	0.0461538
NODE_285963_length_253_cov_60.311688	137	202	40	49	65	0.7538462
NODE_285963_length_253_cov_60.311688	175	253	0	1	78	0.0128205
NODE_285963_length_253_cov_60.311688	175	253	8	2	78	0.0256410
NODE_285963_length_253_cov_60.311688	175	253	10	1	78	0.0128205
NODE_285963_length_253_cov_60.311688	175	253	12	1	78	0.0128205
NODE_285963_length_253_cov_60.311688	175	253	16	2	78	0.0256410
NODE_285963_length_253_cov_60.311688	175	253	20	1	78	0.0128205
NODE_285963_length_253_cov_60.311688	175	253	22	2	78	0.0256410
NODE_285963_length_253_cov_60.311688	175	253	24	1	78	0.0128205
NODE_285963_length_253_cov_60.311688	175	253	26	1	78	0.0128205
NODE_285963_length_253_cov_60.311688	175	253	30	2	78	0.0256410
NODE_285963_length_253_cov_60.311688	175	253	36	1	78	0.0128205
NODE_285963_length_253_cov_60.311688	175	253	38	2	78	0.0256410
NODE_285963_length_253_cov_60.311688	175	253	40	61	78	0.7820513
NODE_285965_length_253_cov_41.519481	0	68	3	1	68	0.0147059
NODE_285965_length_253_cov_41.519481	0	68	5	5	68	0.0735294
NODE_285965_length_253_cov_41.519481	0	68	7	1	68	0.0147059
NODE_285965_length_253_cov_41.519481	0	68	10	1	68	0.0147059
NODE_285965_length_253_cov_41.519481	0	68	12	2	68	0.0294118
NODE_285965_length_253_cov_41.519481	0	68	16	9	68	0.1323529
NODE_285965_length_253_cov_41.519481	0	68	20	2	68	0.0294118
NODE_285965_length_253_cov_41.519481	0	68	26	7	68	0.1029412
NODE_285965_length_253_cov_41.519481	0	68	30	2	68	0.0294118
NODE_285965_length_253_cov_41.519481	0	68	34	14	68	0.2058824
NODE_285965_length_253_cov_41.519481	0	68	36	12	68	0.1764706
NODE_285965_length_253_cov_41.519481	0	68	38	9	68	0.1323529
NODE_285965_length_253_cov_41.519481	0	68	39	1	68	0.0147059
NODE_285965_length_253_cov_41.519481	0	68	40	2	68	0.0294118
NODE_285965_length_253_cov_41.519481	0	70	3	1	70	0.0142857
NODE_285965_length_253_cov_41.519481	0	70	5	5	70	0.0714286
NODE_285965_length_253_cov_41.519481	0	70	7	1	70	0.0142857
NODE_285965_length_253_cov_41.519481	0	70	10	1	70	0.0142857
NODE_285965_length_253_cov_41.519481	0	70	12	2	70	0.0285714
NODE_285965_length_253_cov_41.519481	0	70	16	9	70	0.1285714
NODE_285965_length_253_cov_41.519481	0	70	20	2	70	0.0285714
NODE_285965_length_253_cov_41.519481	0	70	26	7	70	0.1000000
NODE_285965_length_253_cov_41.519481	0	70	30	2	70	0.0285714
NODE_285965_length_253_cov_41.519481	0	70	34	14	70	0.2000000
NODE_285965_length_253_cov_41.519481	0	70	36	12	70	0.1714286
NODE_285965_length_253_cov_41.519481	0	70	38	9	70	0.1285714
NODE_285965_length_253_cov_41.519481	0	70	39	1	70	0.0142857
NODE_285965_length_253_cov_41.519481	0	70	40	3	70	0.0428571
NODE_285965_length_253_cov_41.519481	0	70	42	1	70	0.0142857
NODE_285965_length_253_cov_41.519481	2	73	5	4	71	0.0563380
NODE_285965_length_253_cov_41.519481	2	73	7	1	71	0.0140845
NODE_285965_length_253_cov_41.519481	2	73	10	1	71	0.0140845
NODE_285965_length_253_cov_41.519481	2	73	12	2	71	0.0281690
NODE_285965_length_253_cov_41.519481	2	73	16	9	71	0.1267606
NODE_285965_length_253_cov_41.519481	2	73	20	2	71	0.0281690
NODE_285965_length_253_cov_41.519481	2	73	26	7	71	0.0985916
NODE_285965_length_253_cov_41.519481	2	73	30	2	71	0.0281690
NODE_285965_length_253_cov_41.519481	2	73	34	14	71	0.1971831
NODE_285965_length_253_cov_41.519481	2	73	36	12	71	0.1690141
NODE_285965_length_253_cov_41.519481	2	73	38	9	71	0.1267606
NODE_285965_length_253_cov_41.519481	2	73	39	1	71	0.0140845
NODE_285965_length_253_cov_41.519481	2	73	40	3	71	0.0422535
NODE_285965_length_253_cov_41.519481	2	73	42	4	71	0.0563380
NODE_285965_length_253_cov_41.519481	7	73	10	1	66	0.0151515
NODE_285965_length_253_cov_41.519481	7	73	12	2	66	0.0303030
NODE_285965_length_253_cov_41.519481	7	73	16	9	66	0.1363636
NODE_285965_length_253_cov_41.519481	7	73	20	2	66	0.0303030
NODE_285965_length_253_cov_41.519481	7	73	26	7	66	0.1060606
NODE_285965_length_253_cov_41.519481	7	73	30	2	66	0.0303030
NODE_285965_length_253_cov_41.519481	7	73	34	14	66	0.2121212
NODE_285965_length_253_cov_41.519481	7	73	36	12	66	0.1818182
NODE_285965_length_253_cov_41.519481	7	73	38	9	66	0.1363636
NODE_285965_length_253_cov_41.519481	7	73	39	1	66	0.0151515
NODE_285965_length_253_cov_41.519481	7	73	40	3	66	0.0454545
NODE_285965_length_253_cov_41.519481	7	73	42	4	66	0.0606061
NODE_285965_length_253_cov_41.519481	46	123	26	1	77	0.0129870
NODE_285965_length_253_cov_41.519481	46	123	32	9	77	0.1168831
NODE_285965_length_253_cov_41.519481	46	123	36	11	77	0.1428571
NODE_285965_length_253_cov_41.519481	46	123	38	10	77	0.1298701
NODE_285965_length_253_cov_41.519481	46	123	39	1	77	0.0129870
NODE_285965_length_253_cov_41.519481	46	123	40	7	77	0.0909091
NODE_285965_length_253_cov_41.519481	46	123	42	17	77	0.2207792
NODE_285965_length_253_cov_41.519481	46	123	44	15	77	0.1948052
NODE_285965_length_253_cov_41.519481	46	123	46	6	77	0.0779221
NODE_285965_length_253_cov_41.519481	46	123	26	1	77	0.0129870
NODE_285965_length_253_cov_41.519481	46	123	32	9	77	0.1168831
NODE_285965_length_253_cov_41.519481	46	123	36	11	77	0.1428571
NODE_285965_length_253_cov_41.519481	46	123	38	10	77	0.1298701
NODE_285965_length_253_cov_41.519481	46	123	39	1	77	0.0129870
NODE_285965_length_253_cov_41.519481	46	123	40	7	77	0.0909091
NODE_285965_length_253_cov_41.519481	46	123	42	17	77	0.2207792
NODE_285965_length_253_cov_41.519481	46	123	44	15	77	0.1948052
NODE_285965_length_253_cov_41.519481	46	123	46	6	77	0.0779221
NODE_285965_length_253_cov_41.519481	46	123	26	1	77	0.0129870
NODE_285965_length_253_cov_41.519481	46	123	32	9	77	0.1168831
NODE_285965_length_253_cov_41.519481	46	123	36	11	77	0.1428571
NODE_285965_length_253_cov_41.519481	46	123	38	10	77	0.1298701
NODE_285965_length_253_cov_41.519481	46	123	39	1	77	0.0129870
NODE_285965_length_253_cov_41.519481	46	123	40	7	77	0.0909091
NODE_285965_length_253_cov_41.519481	46	123	42	17	77	0.2207792
NODE_285965_length_253_cov_41.519481	46	123	44	15	77	0.1948052
NODE_285965_length_253_cov_41.519481	46	123	46	6	77	0.0779221
NODE_285967_length_253_cov_13.967532	25	105	0	80	80	1.0000000
NODE_285967_length_253_cov_13.967532	78	158	0	80	80	1.0000000
NODE_285969_length_253_cov_12.259740	0	54	0	54	54	1.0000000
NODE_285969_length_253_cov_12.259740	27	62	0	35	35	1.0000000
NODE_285969_length_253_cov_12.259740	51	131	0	80	80	1.0000000
NODE_285969_length_253_cov_12.259740	104	139	0	35	35	1.0000000
NODE_285969_length_253_cov_12.259740	128	208	0	80	80	1.0000000
NODE_285969_length_253_cov_12.259740	181	216	0	35	35	1.0000000
NODE_285987_length_253_cov_7.279221	184	250	0	13	66	0.1969697
NODE_285987_length_253_cov_7.279221	184	250	2	32	66	0.4848485
NODE_285987_length_253_cov_7.279221	184	250	4	21	66	0.3181818
NODE_286022_length_253_cov_5.376623	66	147	2	31	81	0.3827161
NODE_286022_length_253_cov_5.376623	66	147	6	25	81	0.3086420
NODE_286022_length_253_cov_5.376623	66	147	8	6	81	0.0740741
NODE_286022_length_253_cov_5.376623	66	147	10	19	81	0.2345679
NODE_286022_length_253_cov_5.376623	120	185	6	2	65	0.0307692
NODE_286022_length_253_cov_5.376623	120	185	8	6	65	0.0923077
NODE_286022_length_253_cov_5.376623	120	185	10	57	65	0.8769231
NODE_286042_length_253_cov_4.896104	102	182	18	9	80	0.1125000
NODE_286042_length_253_cov_4.896104	102	182	20	1	80	0.0125000
NODE_286042_length_253_cov_4.896104	102	182	24	2	80	0.0250000
NODE_286042_length_253_cov_4.896104	102	182	25	7	80	0.0875000
NODE_286042_length_253_cov_4.896104	102	182	28	1	80	0.0125000
NODE_286042_length_253_cov_4.896104	102	182	32	11	80	0.1375000
NODE_286042_length_253_cov_4.896104	102	182	36	1	80	0.0125000
NODE_286042_length_253_cov_4.896104	102	182	38	14	80	0.1750000
NODE_286042_length_253_cov_4.896104	102	182	40	4	80	0.0500000
NODE_286042_length_253_cov_4.896104	102	182	41	2	80	0.0250000
NODE_286042_length_253_cov_4.896104	102	182	42	13	80	0.1625000
NODE_286042_length_253_cov_4.896104	102	182	44	9	80	0.1125000
NODE_286042_length_253_cov_4.896104	102	182	45	1	80	0.0125000
NODE_286042_length_253_cov_4.896104	102	182	46	1	80	0.0125000
NODE_286042_length_253_cov_4.896104	102	182	47	1	80	0.0125000
NODE_286042_length_253_cov_4.896104	102	182	49	3	80	0.0375000
NODE_286046_length_253_cov_4.798701	199	253	2	54	54	1.0000000
NODE_286069_length_253_cov_4.487013	85	126	2	9	41	0.2195122
NODE_286069_length_253_cov_4.487013	85	126	4	32	41	0.7804878
NODE_286151_length_253_cov_3.500000	44	105	0	61	61	1.0000000
NODE_286151_length_253_cov_3.500000	90	158	0	68	68	1.0000000
NODE_286259_length_253_cov_2.987013	85	165	0	80	80	1.0000000
NODE_286259_length_253_cov_2.987013	138	169	0	31	31	1.0000000
NODE_286275_length_253_cov_2.954545	100	148	0	48	48	1.0000000
NODE_286281_length_253_cov_2.909091	34	99	8	9	65	0.1384615
NODE_286281_length_253_cov_2.909091	34	99	10	7	65	0.1076923
NODE_286281_length_253_cov_2.909091	34	99	12	15	65	0.2307692
NODE_286281_length_253_cov_2.909091	34	99	14	5	65	0.0769231
NODE_286281_length_253_cov_2.909091	34	99	16	29	65	0.4461538
NODE_286288_length_253_cov_2.889610	129	200	11	1	71	0.0140845
NODE_286288_length_253_cov_2.889610	129	200	12	16	71	0.2253521
NODE_286288_length_253_cov_2.889610	129	200	13	4	71	0.0563380
NODE_286288_length_253_cov_2.889610	129	200	14	31	71	0.4366197
NODE_286288_length_253_cov_2.889610	129	200	15	4	71	0.0563380
NODE_286288_length_253_cov_2.889610	129	200	16	6	71	0.0845070
NODE_286288_length_253_cov_2.889610	129	200	17	3	71	0.0422535
NODE_286288_length_253_cov_2.889610	129	200	23	6	71	0.0845070
NODE_286288_length_253_cov_2.889610	173	253	0	3	80	0.0375000
NODE_286288_length_253_cov_2.889610	173	253	4	1	80	0.0125000
NODE_286288_length_253_cov_2.889610	173	253	6	1	80	0.0125000
NODE_286288_length_253_cov_2.889610	173	253	10	5	80	0.0625000
NODE_286288_length_253_cov_2.889610	173	253	12	58	80	0.7250000
NODE_286288_length_253_cov_2.889610	173	253	14	6	80	0.0750000
NODE_286288_length_253_cov_2.889610	173	253	16	6	80	0.0750000
NODE_286289_length_253_cov_2.889610	21	76	0	55	55	1.0000000
NODE_286289_length_253_cov_2.889610	149	229	0	5	80	0.0625000
NODE_286289_length_253_cov_2.889610	149	229	4	75	80	0.9375000
NODE_286379_length_253_cov_2.610390	113	193	0	80	80	1.0000000
NODE_286386_length_253_cov_2.584416	97	154	2	2	57	0.0350877
NODE_286386_length_253_cov_2.584416	97	154	4	55	57	0.9649123
NODE_286545_length_253_cov_2.240260	185	250	0	65	65	1.0000000
NODE_286667_length_253_cov_1.987013	157	237	0	5	80	0.0625000
NODE_286667_length_253_cov_1.987013	157	237	2	1	80	0.0125000
NODE_286667_length_253_cov_1.987013	157	237	4	74	80	0.9250000
NODE_286667_length_253_cov_1.987013	210	253	0	21	43	0.4883721
NODE_286667_length_253_cov_1.987013	210	253	2	1	43	0.0232558
NODE_286667_length_253_cov_1.987013	210	253	4	21	43	0.4883721
NODE_286685_length_253_cov_1.987013	18	60	0	42	42	1.0000000
NODE_286829_length_253_cov_1.961039	186	232	0	46	46	1.0000000
NODE_286837_length_253_cov_1.948052	68	120	0	52	52	1.0000000
NODE_286838_length_253_cov_1.948052	63	114	0	51	51	1.0000000
NODE_286947_length_253_cov_1.746753	164	193	0	29	29	1.0000000
NODE_287031_length_253_cov_1.655844	40	120	0	80	80	1.0000000
NODE_287031_length_253_cov_1.655844	93	152	0	59	59	1.0000000
NODE_287133_length_253_cov_1.590909	102	148	4	8	46	0.1739130
NODE_287133_length_253_cov_1.590909	102	148	6	38	46	0.8260869
NODE_287156_length_253_cov_1.558442	67	149	2	1	82	0.0121951
NODE_287156_length_253_cov_1.558442	67	149	4	38	82	0.4634146
NODE_287156_length_253_cov_1.558442	67	149	6	29	82	0.3536585
NODE_287156_length_253_cov_1.558442	67	149	7	2	82	0.0243902
NODE_287156_length_253_cov_1.558442	67	149	8	12	82	0.1463415
NODE_287230_length_253_cov_1.441558	49	113	0	64	64	1.0000000
NODE_287230_length_253_cov_1.441558	102	166	0	64	64	1.0000000
NODE_287232_length_253_cov_1.441558	121	185	0	64	64	1.0000000
NODE_287234_length_253_cov_1.435065	50	81	0	31	31	1.0000000
NODE_287584_length_253_cov_1.324675	193	239	1	9	46	0.1956522
NODE_287584_length_253_cov_1.324675	193	239	2	32	46	0.6956522
NODE_287584_length_253_cov_1.324675	193	239	4	1	46	0.0217391
NODE_287584_length_253_cov_1.324675	193	239	6	4	46	0.0869565
NODE_287599_length_253_cov_1.324675	90	132	46	12	42	0.2857143
NODE_287599_length_253_cov_1.324675	90	132	48	9	42	0.2142857
NODE_287599_length_253_cov_1.324675	90	132	50	9	42	0.2142857
NODE_287599_length_253_cov_1.324675	90	132	52	4	42	0.0952381
NODE_287599_length_253_cov_1.324675	90	132	54	8	42	0.1904762
NODE_287599_length_253_cov_1.324675	133	185	10	6	52	0.1153846
NODE_287599_length_253_cov_1.324675	133	185	12	5	52	0.0961538
NODE_287599_length_253_cov_1.324675	133	185	14	3	52	0.0576923
NODE_287599_length_253_cov_1.324675	133	185	21	5	52	0.0961538
NODE_287599_length_253_cov_1.324675	133	185	22	1	52	0.0192308
NODE_287599_length_253_cov_1.324675	133	185	24	1	52	0.0192308
NODE_287599_length_253_cov_1.324675	133	185	26	1	52	0.0192308
NODE_287599_length_253_cov_1.324675	133	185	28	1	52	0.0192308
NODE_287599_length_253_cov_1.324675	133	185	42	4	52	0.0769231
NODE_287599_length_253_cov_1.324675	133	185	44	4	52	0.0769231
NODE_287599_length_253_cov_1.324675	133	185	50	11	52	0.2115385
NODE_287599_length_253_cov_1.324675	133	185	52	10	52	0.1923077
NODE_287721_length_253_cov_1.285714	87	125	2	2	38	0.0526316
NODE_287721_length_253_cov_1.285714	87	125	4	36	38	0.9473684
NODE_287794_length_253_cov_1.214286	99	148	2	49	49	1.0000000
NODE_287845_length_253_cov_1.181818	185	247	0	62	62	1.0000000
NODE_287845_length_253_cov_1.181818	185	247	0	62	62	1.0000000
NODE_287989_length_253_cov_1.064935	83	159	6	1	76	0.0131579
NODE_287989_length_253_cov_1.064935	83	159	8	1	76	0.0131579
NODE_287989_length_253_cov_1.064935	83	159	10	3	76	0.0394737
NODE_287989_length_253_cov_1.064935	83	159	12	1	76	0.0131579
NODE_287989_length_253_cov_1.064935	83	159	18	1	76	0.0131579
NODE_287989_length_253_cov_1.064935	83	159	21	4	76	0.0526316
NODE_287989_length_253_cov_1.064935	83	159	25	2	76	0.0263158
NODE_287989_length_253_cov_1.064935	83	159	26	5	76	0.0657895
NODE_287989_length_253_cov_1.064935	83	159	28	11	76	0.1447368
NODE_287989_length_253_cov_1.064935	83	159	32	11	76	0.1447368
NODE_287989_length_253_cov_1.064935	83	159	34	36	76	0.4736842
NODE_288099_length_253_cov_0.993506	0	44	0	26	44	0.5909091
NODE_288099_length_253_cov_0.993506	0	44	2	18	44	0.4090909
NODE_288465_length_253_cov_0.870130	17	46	4	27	29	0.9310345
NODE_288465_length_253_cov_0.870130	17	46	6	2	29	0.0689655
NODE_288478_length_253_cov_0.850649	0	89	0	89	89	1.0000000
NODE_289563_length_252_cov_4.771242	94	148	0	8	54	0.1481481
NODE_289563_length_252_cov_4.771242	94	148	2	46	54	0.8518519
NODE_289574_length_252_cov_4.614379	16	37	0	1	21	0.0476190
NODE_289574_length_252_cov_4.614379	16	37	2	7	21	0.3333333
NODE_289574_length_252_cov_4.614379	16	37	4	13	21	0.6190476
NODE_289624_length_252_cov_3.960784	7	85	0	78	78	1.0000000
NODE_289624_length_252_cov_3.960784	63	136	0	73	73	1.0000000
NODE_289663_length_252_cov_3.549020	89	157	0	68	68	1.0000000
NODE_289672_length_252_cov_3.405229	26	107	4	18	81	0.2222222
NODE_289672_length_252_cov_3.405229	26	107	6	33	81	0.4074074
NODE_289672_length_252_cov_3.405229	26	107	7	1	81	0.0123457
NODE_289672_length_252_cov_3.405229	26	107	8	2	81	0.0246914
NODE_289672_length_252_cov_3.405229	26	107	9	2	81	0.0246914
NODE_289672_length_252_cov_3.405229	26	107	10	6	81	0.0740741
NODE_289672_length_252_cov_3.405229	26	107	12	19	81	0.2345679
NODE_289705_length_252_cov_3.307190	91	141	0	50	50	1.0000000
NODE_289742_length_252_cov_3.032680	135	212	2	10	77	0.1298701
NODE_289742_length_252_cov_3.032680	135	212	4	67	77	0.8701299
NODE_289775_length_252_cov_2.928105	0	57	0	57	57	1.0000000
NODE_289799_length_252_cov_2.803922	41	121	0	79	80	0.9875000
NODE_289799_length_252_cov_2.803922	41	121	2	1	80	0.0125000
NODE_290032_length_252_cov_2.320261	0	64	0	64	64	1.0000000
NODE_290046_length_252_cov_2.281046	120	170	0	50	50	1.0000000
NODE_290066_length_252_cov_2.215686	137	175	66	1	38	0.0263158
NODE_290066_length_252_cov_2.215686	137	175	68	2	38	0.0526316
NODE_290066_length_252_cov_2.215686	137	175	72	1	38	0.0263158
NODE_290066_length_252_cov_2.215686	137	175	74	1	38	0.0263158
NODE_290066_length_252_cov_2.215686	137	175	76	8	38	0.2105263
NODE_290066_length_252_cov_2.215686	137	175	78	4	38	0.1052632
NODE_290066_length_252_cov_2.215686	137	175	80	15	38	0.3947369
NODE_290066_length_252_cov_2.215686	137	175	82	6	38	0.1578947
NODE_290103_length_252_cov_2.052288	18	39	0	21	21	1.0000000
NODE_290238_length_252_cov_1.993464	80	139	0	30	59	0.5084746
NODE_290238_length_252_cov_1.993464	80	139	2	29	59	0.4915254
NODE_290385_length_252_cov_1.810458	3	49	0	23	46	0.5000000
NODE_290385_length_252_cov_1.810458	3	49	2	23	46	0.5000000
NODE_290623_length_252_cov_1.594771	103	156	0	53	53	1.0000000
NODE_290623_length_252_cov_1.594771	152	192	0	38	40	0.9500000
NODE_290623_length_252_cov_1.594771	152	192	2	2	40	0.0500000
NODE_290638_length_252_cov_1.568627	1	68	0	1	67	0.0149254
NODE_290638_length_252_cov_1.568627	1	68	5	1	67	0.0149254
NODE_290638_length_252_cov_1.568627	1	68	6	60	67	0.8955224
NODE_290638_length_252_cov_1.568627	1	68	8	5	67	0.0746269
NODE_290767_length_252_cov_1.359477	26	93	0	29	67	0.4328358
NODE_290767_length_252_cov_1.359477	26	93	2	38	67	0.5671642
NODE_290790_length_252_cov_1.333333	179	232	0	16	53	0.3018868
NODE_290790_length_252_cov_1.333333	179	232	2	37	53	0.6981132
NODE_290850_length_252_cov_1.333333	187	222	4	35	35	1.0000000
NODE_291072_length_252_cov_1.333333	31	111	0	80	80	1.0000000
NODE_291076_length_252_cov_1.333333	90	140	4	3	50	0.0600000
NODE_291076_length_252_cov_1.333333	90	140	8	1	50	0.0200000
NODE_291076_length_252_cov_1.333333	90	140	10	5	50	0.1000000
NODE_291076_length_252_cov_1.333333	90	140	12	10	50	0.2000000
NODE_291076_length_252_cov_1.333333	90	140	13	21	50	0.4200000
NODE_291076_length_252_cov_1.333333	90	140	15	10	50	0.2000000
NODE_291118_length_252_cov_1.326797	112	143	4	31	31	1.0000000
NODE_291351_length_252_cov_1.156863	1	32	0	13	31	0.4193548
NODE_291351_length_252_cov_1.156863	1	32	2	18	31	0.5806451
NODE_291650_length_252_cov_1.000000	49	79	0	30	30	1.0000000
NODE_291911_length_252_cov_0.836601	125	172	0	16	47	0.3404255
NODE_291911_length_252_cov_0.836601	125	172	2	31	47	0.6595744
NODE_293004_length_251_cov_5.032895	0	62	0	62	62	1.0000000
NODE_293005_length_251_cov_5.026316	84	164	0	1	80	0.0125000
NODE_293005_length_251_cov_5.026316	84	164	2	48	80	0.6000000
NODE_293005_length_251_cov_5.026316	84	164	4	31	80	0.3875000
NODE_293165_length_251_cov_3.302632	187	249	0	62	62	1.0000000
NODE_293195_length_251_cov_3.131579	96	148	0	52	52	1.0000000
NODE_293238_length_251_cov_2.980263	11	38	4	1	27	0.0370370
NODE_293238_length_251_cov_2.980263	11	38	5	1	27	0.0370370
NODE_293238_length_251_cov_2.980263	11	38	6	25	27	0.9259259
NODE_293238_length_251_cov_2.980263	11	91	4	1	80	0.0125000
NODE_293238_length_251_cov_2.980263	11	91	5	1	80	0.0125000
NODE_293238_length_251_cov_2.980263	11	91	6	78	80	0.9750000
NODE_293259_length_251_cov_2.842105	170	198	1	11	28	0.3928571
NODE_293259_length_251_cov_2.842105	170	198	3	17	28	0.6071429
NODE_293279_length_251_cov_2.743421	181	232	0	51	51	1.0000000
NODE_293335_length_251_cov_2.677632	35	54	0	19	19	1.0000000
NODE_293454_length_251_cov_2.348684	196	251	0	55	55	1.0000000
NODE_293502_length_251_cov_2.328947	86	149	0	63	63	1.0000000
NODE_293516_length_251_cov_2.296053	91	171	0	66	80	0.8250000
NODE_293516_length_251_cov_2.296053	91	171	2	14	80	0.1750000
NODE_293516_length_251_cov_2.296053	144	224	0	13	80	0.1625000
NODE_293516_length_251_cov_2.296053	144	224	2	67	80	0.8375000
NODE_293591_length_251_cov_2.065789	7	52	0	45	45	1.0000000
NODE_293698_length_251_cov_2.013158	96	179	0	83	83	1.0000000
NODE_293698_length_251_cov_2.013158	96	179	0	83	83	1.0000000
NODE_293698_length_251_cov_2.013158	152	203	0	51	51	1.0000000
NODE_293698_length_251_cov_2.013158	152	201	0	49	49	1.0000000
NODE_293919_length_251_cov_1.710526	135	194	0	59	59	1.0000000
NODE_294028_length_251_cov_1.671053	94	127	2	33	33	1.0000000
NODE_294063_length_251_cov_1.644737	135	164	0	29	29	1.0000000
NODE_294147_length_251_cov_1.473684	137	202	0	50	65	0.7692308
NODE_294147_length_251_cov_1.473684	137	202	1	15	65	0.2307692
NODE_294153_length_251_cov_1.460526	17	78	0	61	61	1.0000000
NODE_294190_length_251_cov_1.407895	182	246	0	21	64	0.3281250
NODE_294190_length_251_cov_1.407895	182	246	2	43	64	0.6718750
NODE_294393_length_251_cov_1.342105	9	89	0	80	80	1.0000000
NODE_294393_length_251_cov_1.342105	62	91	0	29	29	1.0000000
NODE_294624_length_251_cov_1.296053	7	47	0	40	40	1.0000000
NODE_294624_length_251_cov_1.296053	24	47	0	23	23	1.0000000
NODE_295165_length_251_cov_1.006579	4	50	0	46	46	1.0000000
NODE_296033_length_251_cov_0.671053	184	204	0	20	20	1.0000000
NODE_296386_length_251_cov_0.572368	54	74	0	20	20	1.0000000
NODE_296437_length_250_cov_35.662252	33	99	0	66	66	1.0000000
NODE_296437_length_250_cov_35.662252	143	223	0	80	80	1.0000000
NODE_296456_length_250_cov_6.503311	186	250	0	64	64	1.0000000
NODE_296467_length_250_cov_5.867550	99	120	0	21	21	1.0000000
NODE_296520_length_250_cov_4.662252	143	187	0	44	44	1.0000000
NODE_296520_length_250_cov_4.662252	160	227	0	67	67	1.0000000
NODE_296598_length_250_cov_3.715232	37	90	10	2	53	0.0377358
NODE_296598_length_250_cov_3.715232	37	90	12	20	53	0.3773585
NODE_296598_length_250_cov_3.715232	37	90	14	31	53	0.5849057
NODE_296633_length_250_cov_3.417219	113	193	0	37	80	0.4625000
NODE_296633_length_250_cov_3.417219	113	193	2	43	80	0.5375000
NODE_296633_length_250_cov_3.417219	166	246	0	80	80	1.0000000
NODE_296653_length_250_cov_3.364238	0	61	2	4	61	0.0655738
NODE_296653_length_250_cov_3.364238	0	61	4	57	61	0.9344262
NODE_296653_length_250_cov_3.364238	34	94	4	60	60	1.0000000
NODE_296680_length_250_cov_3.225166	157	209	0	52	52	1.0000000
NODE_296680_length_250_cov_3.225166	182	250	0	68	68	1.0000000
NODE_296699_length_250_cov_3.086093	33	67	0	34	34	1.0000000
NODE_296703_length_250_cov_3.052980	29	94	4	5	65	0.0769231
NODE_296703_length_250_cov_3.052980	29	94	6	11	65	0.1692308
NODE_296703_length_250_cov_3.052980	29	94	8	9	65	0.1384615
NODE_296703_length_250_cov_3.052980	29	94	10	13	65	0.2000000
NODE_296703_length_250_cov_3.052980	29	94	12	17	65	0.2615385
NODE_296703_length_250_cov_3.052980	29	94	16	10	65	0.1538462
NODE_296707_length_250_cov_3.039735	51	106	0	9	55	0.1636364
NODE_296707_length_250_cov_3.039735	51	106	2	46	55	0.8363636
NODE_296737_length_250_cov_2.986755	124	185	0	12	61	0.1967213
NODE_296737_length_250_cov_2.986755	124	185	2	6	61	0.0983607
NODE_296737_length_250_cov_2.986755	124	185	4	35	61	0.5737705
NODE_296737_length_250_cov_2.986755	124	185	6	8	61	0.1311475
NODE_296737_length_250_cov_2.986755	172	243	0	70	71	0.9859155
NODE_296737_length_250_cov_2.986755	172	243	2	1	71	0.0140845
NODE_296885_length_250_cov_2.516556	0	49	0	49	49	1.0000000
NODE_296893_length_250_cov_2.476821	94	174	0	80	80	1.0000000
NODE_296893_length_250_cov_2.476821	147	227	0	80	80	1.0000000
NODE_296897_length_250_cov_2.470199	166	212	2	46	46	1.0000000
NODE_297070_length_250_cov_2.059603	150	207	0	57	57	1.0000000
NODE_297211_length_250_cov_2.019868	74	141	17	1	67	0.0149254
NODE_297211_length_250_cov_2.019868	74	141	19	5	67	0.0746269
NODE_297211_length_250_cov_2.019868	74	141	21	31	67	0.4626866
NODE_297211_length_250_cov_2.019868	74	141	23	6	67	0.0895522
NODE_297211_length_250_cov_2.019868	74	141	25	14	67	0.2089552
NODE_297211_length_250_cov_2.019868	74	141	27	1	67	0.0149254
NODE_297211_length_250_cov_2.019868	74	141	28	7	67	0.1044776
NODE_297211_length_250_cov_2.019868	74	141	30	2	67	0.0298507
NODE_297211_length_250_cov_2.019868	158	204	20	3	46	0.0652174
NODE_297211_length_250_cov_2.019868	158	204	21	4	46	0.0869565
NODE_297211_length_250_cov_2.019868	158	204	23	1	46	0.0217391
NODE_297211_length_250_cov_2.019868	158	204	24	5	46	0.1086956
NODE_297211_length_250_cov_2.019868	158	204	25	4	46	0.0869565
NODE_297211_length_250_cov_2.019868	158	204	26	21	46	0.4565217
NODE_297211_length_250_cov_2.019868	158	204	29	8	46	0.1739130
NODE_297550_length_250_cov_1.688742	6	42	0	36	36	1.0000000
NODE_297624_length_250_cov_1.635762	150	191	4	2	41	0.0487805
NODE_297624_length_250_cov_1.635762	150	191	6	39	41	0.9512195
NODE_297679_length_250_cov_1.529801	59	108	0	49	49	1.0000000
NODE_297679_length_250_cov_1.529801	81	161	0	80	80	1.0000000
NODE_297693_length_250_cov_1.516556	124	184	0	34	60	0.5666667
NODE_297693_length_250_cov_1.516556	124	184	2	11	60	0.1833333
NODE_297693_length_250_cov_1.516556	124	184	4	15	60	0.2500000
NODE_297693_length_250_cov_1.516556	166	237	0	71	71	1.0000000
NODE_297762_length_250_cov_1.377483	0	80	0	9	80	0.1125000
NODE_297762_length_250_cov_1.377483	0	80	2	71	80	0.8875000
NODE_297963_length_250_cov_1.350993	40	98	0	58	58	1.0000000
NODE_298213_length_250_cov_1.291391	116	196	2	4	80	0.0500000
NODE_298213_length_250_cov_1.291391	116	196	4	2	80	0.0250000
NODE_298213_length_250_cov_1.291391	116	196	6	2	80	0.0250000
NODE_298213_length_250_cov_1.291391	116	196	8	6	80	0.0750000
NODE_298213_length_250_cov_1.291391	116	196	10	66	80	0.8250000
NODE_298719_length_250_cov_1.013245	126	163	0	37	37	1.0000000
NODE_298794_length_250_cov_1.006623	129	148	0	19	19	1.0000000
NODE_298900_length_250_cov_0.920530	126	178	30	1	52	0.0192308
NODE_298900_length_250_cov_0.920530	126	178	32	1	52	0.0192308
NODE_298900_length_250_cov_0.920530	126	178	34	5	52	0.0961538
NODE_298900_length_250_cov_0.920530	126	178	38	2	52	0.0384615
NODE_298900_length_250_cov_0.920530	126	178	39	9	52	0.1730769
NODE_298900_length_250_cov_0.920530	126	178	40	2	52	0.0384615
NODE_298900_length_250_cov_0.920530	126	178	41	1	52	0.0192308
NODE_298900_length_250_cov_0.920530	126	178	42	9	52	0.1730769
NODE_298900_length_250_cov_0.920530	126	178	44	1	52	0.0192308
NODE_298900_length_250_cov_0.920530	126	178	46	2	52	0.0384615
NODE_298900_length_250_cov_0.920530	126	178	48	19	52	0.3653846
NODE_299979_length_249_cov_55.413333	97	172	0	75	75	1.0000000
NODE_299979_length_249_cov_55.413333	150	225	0	75	75	1.0000000
NODE_300012_length_247_cov_51.243243	172	247	0	75	75	1.0000000
NODE_300014_length_247_cov_37.614865	156	239	0	83	83	1.0000000
NODE_300056_length_245_cov_40.876712	138	202	29	2	64	0.0312500
NODE_300056_length_245_cov_40.876712	138	202	30	5	64	0.0781250
NODE_300056_length_245_cov_40.876712	138	202	32	1	64	0.0156250
NODE_300056_length_245_cov_40.876712	138	202	34	2	64	0.0312500
NODE_300056_length_245_cov_40.876712	138	202	36	2	64	0.0312500
NODE_300056_length_245_cov_40.876712	138	202	37	1	64	0.0156250
NODE_300056_length_245_cov_40.876712	138	202	39	10	64	0.1562500
NODE_300056_length_245_cov_40.876712	138	202	41	1	64	0.0156250
NODE_300056_length_245_cov_40.876712	138	202	43	3	64	0.0468750
NODE_300056_length_245_cov_40.876712	138	202	46	2	64	0.0312500
NODE_300056_length_245_cov_40.876712	138	202	48	1	64	0.0156250
NODE_300056_length_245_cov_40.876712	138	202	50	15	64	0.2343750
NODE_300056_length_245_cov_40.876712	138	202	52	2	64	0.0312500
NODE_300056_length_245_cov_40.876712	138	202	54	1	64	0.0156250
NODE_300056_length_245_cov_40.876712	138	202	56	16	64	0.2500000
NODE_300056_length_245_cov_40.876712	138	202	29	2	64	0.0312500
NODE_300056_length_245_cov_40.876712	138	202	30	5	64	0.0781250
NODE_300056_length_245_cov_40.876712	138	202	32	1	64	0.0156250
NODE_300056_length_245_cov_40.876712	138	202	34	2	64	0.0312500
NODE_300056_length_245_cov_40.876712	138	202	36	2	64	0.0312500
NODE_300056_length_245_cov_40.876712	138	202	37	1	64	0.0156250
NODE_300056_length_245_cov_40.876712	138	202	39	10	64	0.1562500
NODE_300056_length_245_cov_40.876712	138	202	41	1	64	0.0156250
NODE_300056_length_245_cov_40.876712	138	202	43	3	64	0.0468750
NODE_300056_length_245_cov_40.876712	138	202	46	2	64	0.0312500
NODE_300056_length_245_cov_40.876712	138	202	48	1	64	0.0156250
NODE_300056_length_245_cov_40.876712	138	202	50	15	64	0.2343750
NODE_300056_length_245_cov_40.876712	138	202	52	2	64	0.0312500
NODE_300056_length_245_cov_40.876712	138	202	54	1	64	0.0156250
NODE_300056_length_245_cov_40.876712	138	202	56	16	64	0.2500000
NODE_300056_length_245_cov_40.876712	138	202	29	2	64	0.0312500
NODE_300056_length_245_cov_40.876712	138	202	30	5	64	0.0781250
NODE_300056_length_245_cov_40.876712	138	202	32	1	64	0.0156250
NODE_300056_length_245_cov_40.876712	138	202	34	2	64	0.0312500
NODE_300056_length_245_cov_40.876712	138	202	36	2	64	0.0312500
NODE_300056_length_245_cov_40.876712	138	202	37	1	64	0.0156250
NODE_300056_length_245_cov_40.876712	138	202	39	10	64	0.1562500
NODE_300056_length_245_cov_40.876712	138	202	41	1	64	0.0156250
NODE_300056_length_245_cov_40.876712	138	202	43	3	64	0.0468750
NODE_300056_length_245_cov_40.876712	138	202	46	2	64	0.0312500
NODE_300056_length_245_cov_40.876712	138	202	48	1	64	0.0156250
NODE_300056_length_245_cov_40.876712	138	202	50	15	64	0.2343750
NODE_300056_length_245_cov_40.876712	138	202	52	2	64	0.0312500
NODE_300056_length_245_cov_40.876712	138	202	54	1	64	0.0156250
NODE_300056_length_245_cov_40.876712	138	202	56	16	64	0.2500000
NODE_300056_length_245_cov_40.876712	175	241	0	2	66	0.0303030
NODE_300056_length_245_cov_40.876712	175	241	2	2	66	0.0303030
NODE_300056_length_245_cov_40.876712	175	241	4	13	66	0.1969697
NODE_300056_length_245_cov_40.876712	175	241	8	6	66	0.0909091
NODE_300056_length_245_cov_40.876712	175	241	10	2	66	0.0303030
NODE_300056_length_245_cov_40.876712	175	241	12	1	66	0.0151515
NODE_300056_length_245_cov_40.876712	175	241	14	2	66	0.0303030
NODE_300056_length_245_cov_40.876712	175	241	20	1	66	0.0151515
NODE_300056_length_245_cov_40.876712	175	241	22	4	66	0.0606061
NODE_300056_length_245_cov_40.876712	175	241	23	1	66	0.0151515
NODE_300056_length_245_cov_40.876712	175	241	25	1	66	0.0151515
NODE_300056_length_245_cov_40.876712	175	241	29	6	66	0.0909091
NODE_300056_length_245_cov_40.876712	175	241	30	5	66	0.0757576
NODE_300056_length_245_cov_40.876712	175	241	32	1	66	0.0151515
NODE_300056_length_245_cov_40.876712	175	241	34	2	66	0.0303030
NODE_300056_length_245_cov_40.876712	175	241	36	2	66	0.0303030
NODE_300056_length_245_cov_40.876712	175	241	37	1	66	0.0151515
NODE_300056_length_245_cov_40.876712	175	241	39	10	66	0.1515152
NODE_300056_length_245_cov_40.876712	175	241	41	1	66	0.0151515
NODE_300056_length_245_cov_40.876712	175	241	43	3	66	0.0454545
NODE_300147_length_240_cov_80.744681	167	238	0	59	71	0.8309859
NODE_300147_length_240_cov_80.744681	167	238	2	12	71	0.1690141
NODE_300148_length_240_cov_38.035461	31	82	0	2	51	0.0392157
NODE_300148_length_240_cov_38.035461	31	82	2	8	51	0.1568628
NODE_300148_length_240_cov_38.035461	31	82	6	6	51	0.1176471
NODE_300148_length_240_cov_38.035461	31	82	12	3	51	0.0588235
NODE_300148_length_240_cov_38.035461	31	82	16	22	51	0.4313726
NODE_300148_length_240_cov_38.035461	31	82	18	4	51	0.0784314
NODE_300148_length_240_cov_38.035461	31	82	20	6	51	0.1176471
NODE_300165_length_239_cov_72.878571	0	48	0	13	48	0.2708333
NODE_300165_length_239_cov_72.878571	0	48	2	6	48	0.1250000
NODE_300165_length_239_cov_72.878571	0	48	4	29	48	0.6041667
NODE_300165_length_239_cov_72.878571	21	101	4	52	80	0.6500000
NODE_300165_length_239_cov_72.878571	21	101	8	20	80	0.2500000
NODE_300165_length_239_cov_72.878571	21	101	12	8	80	0.1000000
NODE_300165_length_239_cov_72.878571	150	230	0	10	80	0.1250000
NODE_300165_length_239_cov_72.878571	150	230	2	22	80	0.2750000
NODE_300165_length_239_cov_72.878571	150	230	7	10	80	0.1250000
NODE_300165_length_239_cov_72.878571	150	230	9	18	80	0.2250000
NODE_300165_length_239_cov_72.878571	150	230	10	7	80	0.0875000
NODE_300165_length_239_cov_72.878571	150	230	14	8	80	0.1000000
NODE_300165_length_239_cov_72.878571	150	230	18	5	80	0.0625000
NODE_300165_length_239_cov_72.878571	150	230	0	10	80	0.1250000
NODE_300165_length_239_cov_72.878571	150	230	2	22	80	0.2750000
NODE_300165_length_239_cov_72.878571	150	230	7	10	80	0.1250000
NODE_300165_length_239_cov_72.878571	150	230	9	18	80	0.2250000
NODE_300165_length_239_cov_72.878571	150	230	10	7	80	0.0875000
NODE_300165_length_239_cov_72.878571	150	230	14	8	80	0.1000000
NODE_300165_length_239_cov_72.878571	150	230	18	5	80	0.0625000
NODE_300165_length_239_cov_72.878571	150	212	2	14	62	0.2258064
NODE_300165_length_239_cov_72.878571	150	212	7	10	62	0.1612903
NODE_300165_length_239_cov_72.878571	150	212	9	18	62	0.2903226
NODE_300165_length_239_cov_72.878571	150	212	10	7	62	0.1129032
NODE_300165_length_239_cov_72.878571	150	212	14	8	62	0.1290323
NODE_300165_length_239_cov_72.878571	150	212	18	5	62	0.0806452
NODE_300165_length_239_cov_72.878571	150	221	0	1	71	0.0140845
NODE_300165_length_239_cov_72.878571	150	221	2	22	71	0.3098592
NODE_300165_length_239_cov_72.878571	150	221	7	10	71	0.1408451
NODE_300165_length_239_cov_72.878571	150	221	9	18	71	0.2535211
NODE_300165_length_239_cov_72.878571	150	221	10	7	71	0.0985916
NODE_300165_length_239_cov_72.878571	150	221	14	8	71	0.1126761
NODE_300165_length_239_cov_72.878571	150	221	18	5	71	0.0704225
NODE_300208_length_238_cov_385.683453	35	104	42	4	69	0.0579710
NODE_300208_length_238_cov_385.683453	35	104	44	2	69	0.0289855
NODE_300208_length_238_cov_385.683453	35	104	50	1	69	0.0144928
NODE_300208_length_238_cov_385.683453	35	104	52	5	69	0.0724638
NODE_300208_length_238_cov_385.683453	35	104	55	10	69	0.1449275
NODE_300208_length_238_cov_385.683453	35	104	56	3	69	0.0434783
NODE_300208_length_238_cov_385.683453	35	104	60	2	69	0.0289855
NODE_300208_length_238_cov_385.683453	35	104	63	5	69	0.0724638
NODE_300208_length_238_cov_385.683453	35	104	65	2	69	0.0289855
NODE_300208_length_238_cov_385.683453	35	104	67	2	69	0.0289855
NODE_300208_length_238_cov_385.683453	35	104	69	1	69	0.0144928
NODE_300208_length_238_cov_385.683453	35	104	70	1	69	0.0144928
NODE_300208_length_238_cov_385.683453	35	104	74	2	69	0.0289855
NODE_300208_length_238_cov_385.683453	35	104	76	11	69	0.1594203
NODE_300208_length_238_cov_385.683453	35	104	80	4	69	0.0579710
NODE_300208_length_238_cov_385.683453	35	104	82	5	69	0.0724638
NODE_300208_length_238_cov_385.683453	35	104	84	4	69	0.0579710
NODE_300208_length_238_cov_385.683453	35	104	86	1	69	0.0144928
NODE_300208_length_238_cov_385.683453	35	104	88	3	69	0.0434783
NODE_300208_length_238_cov_385.683453	35	104	96	1	69	0.0144928
NODE_300225_length_237_cov_101.543478	83	163	2	3	80	0.0375000
NODE_300225_length_237_cov_101.543478	83	163	4	2	80	0.0250000
NODE_300225_length_237_cov_101.543478	83	163	6	15	80	0.1875000
NODE_300225_length_237_cov_101.543478	83	163	8	56	80	0.7000000
NODE_300225_length_237_cov_101.543478	83	163	10	4	80	0.0500000
NODE_300225_length_237_cov_101.543478	83	163	2	3	80	0.0375000
NODE_300225_length_237_cov_101.543478	83	163	4	2	80	0.0250000
NODE_300225_length_237_cov_101.543478	83	163	6	15	80	0.1875000
NODE_300225_length_237_cov_101.543478	83	163	8	56	80	0.7000000
NODE_300225_length_237_cov_101.543478	83	163	10	4	80	0.0500000
NODE_300225_length_237_cov_101.543478	83	163	2	3	80	0.0375000
NODE_300225_length_237_cov_101.543478	83	163	4	2	80	0.0250000
NODE_300225_length_237_cov_101.543478	83	163	6	15	80	0.1875000
NODE_300225_length_237_cov_101.543478	83	163	8	56	80	0.7000000
NODE_300225_length_237_cov_101.543478	83	163	10	4	80	0.0500000
NODE_300225_length_237_cov_101.543478	83	163	2	3	80	0.0375000
NODE_300225_length_237_cov_101.543478	83	163	4	2	80	0.0250000
NODE_300225_length_237_cov_101.543478	83	163	6	15	80	0.1875000
NODE_300225_length_237_cov_101.543478	83	163	8	56	80	0.7000000
NODE_300225_length_237_cov_101.543478	83	163	10	4	80	0.0500000
NODE_300225_length_237_cov_101.543478	136	216	0	19	80	0.2375000
NODE_300225_length_237_cov_101.543478	136	216	2	10	80	0.1250000
NODE_300225_length_237_cov_101.543478	136	216	4	5	80	0.0625000
NODE_300225_length_237_cov_101.543478	136	216	6	5	80	0.0625000
NODE_300225_length_237_cov_101.543478	136	216	8	41	80	0.5125000
NODE_300225_length_237_cov_101.543478	136	216	0	19	80	0.2375000
NODE_300225_length_237_cov_101.543478	136	216	2	10	80	0.1250000
NODE_300225_length_237_cov_101.543478	136	216	4	5	80	0.0625000
NODE_300225_length_237_cov_101.543478	136	216	6	5	80	0.0625000
NODE_300225_length_237_cov_101.543478	136	216	8	41	80	0.5125000
NODE_300225_length_237_cov_101.543478	136	216	0	19	80	0.2375000
NODE_300225_length_237_cov_101.543478	136	216	2	10	80	0.1250000
NODE_300225_length_237_cov_101.543478	136	216	4	5	80	0.0625000
NODE_300225_length_237_cov_101.543478	136	216	6	5	80	0.0625000
NODE_300225_length_237_cov_101.543478	136	216	8	41	80	0.5125000
NODE_300225_length_237_cov_101.543478	138	216	0	19	78	0.2435897
NODE_300225_length_237_cov_101.543478	138	216	2	10	78	0.1282051
NODE_300225_length_237_cov_101.543478	138	216	4	5	78	0.0641026
NODE_300225_length_237_cov_101.543478	138	216	6	5	78	0.0641026
NODE_300225_length_237_cov_101.543478	138	216	8	39	78	0.5000000
NODE_300225_length_237_cov_101.543478	138	216	0	19	78	0.2435897
NODE_300225_length_237_cov_101.543478	138	216	2	10	78	0.1282051
NODE_300225_length_237_cov_101.543478	138	216	4	5	78	0.0641026
NODE_300225_length_237_cov_101.543478	138	216	6	5	78	0.0641026
NODE_300225_length_237_cov_101.543478	138	216	8	39	78	0.5000000
NODE_300227_length_237_cov_49.623188	13	88	0	75	75	1.0000000
NODE_300227_length_237_cov_49.623188	73	153	0	80	80	1.0000000
NODE_300227_length_237_cov_49.623188	126	206	0	80	80	1.0000000
NODE_300289_length_235_cov_67.904412	0	62	0	62	62	1.0000000
NODE_300289_length_235_cov_67.904412	25	111	0	83	86	0.9651163
NODE_300289_length_235_cov_67.904412	25	111	2	3	86	0.0348837
NODE_300289_length_235_cov_67.904412	69	150	0	39	81	0.4814815
NODE_300289_length_235_cov_67.904412	69	150	2	4	81	0.0493827
NODE_300289_length_235_cov_67.904412	69	150	4	38	81	0.4691358
NODE_300289_length_235_cov_67.904412	113	194	4	81	81	1.0000000
NODE_300289_length_235_cov_67.904412	157	235	0	23	78	0.2948718
NODE_300289_length_235_cov_67.904412	157	235	2	2	78	0.0256410
NODE_300289_length_235_cov_67.904412	157	235	4	53	78	0.6794872
NODE_300322_length_234_cov_76.496296	0	76	0	28	76	0.3684210
NODE_300322_length_234_cov_76.496296	0	76	4	21	76	0.2763158
NODE_300322_length_234_cov_76.496296	0	76	6	9	76	0.1184211
NODE_300322_length_234_cov_76.496296	0	76	7	1	76	0.0131579
NODE_300322_length_234_cov_76.496296	0	76	8	6	76	0.0789474
NODE_300322_length_234_cov_76.496296	0	76	10	11	76	0.1447368
NODE_300322_length_234_cov_76.496296	0	76	0	28	76	0.3684210
NODE_300322_length_234_cov_76.496296	0	76	4	21	76	0.2763158
NODE_300322_length_234_cov_76.496296	0	76	6	9	76	0.1184211
NODE_300322_length_234_cov_76.496296	0	76	7	1	76	0.0131579
NODE_300322_length_234_cov_76.496296	0	76	8	6	76	0.0789474
NODE_300322_length_234_cov_76.496296	0	76	10	11	76	0.1447368
NODE_300322_length_234_cov_76.496296	0	76	0	28	76	0.3684210
NODE_300322_length_234_cov_76.496296	0	76	4	21	76	0.2763158
NODE_300322_length_234_cov_76.496296	0	76	6	9	76	0.1184211
NODE_300322_length_234_cov_76.496296	0	76	7	1	76	0.0131579
NODE_300322_length_234_cov_76.496296	0	76	8	6	76	0.0789474
NODE_300322_length_234_cov_76.496296	0	76	10	11	76	0.1447368
NODE_300322_length_234_cov_76.496296	0	76	0	28	76	0.3684210
NODE_300322_length_234_cov_76.496296	0	76	4	21	76	0.2763158
NODE_300322_length_234_cov_76.496296	0	76	6	9	76	0.1184211
NODE_300322_length_234_cov_76.496296	0	76	7	1	76	0.0131579
NODE_300322_length_234_cov_76.496296	0	76	8	6	76	0.0789474
NODE_300322_length_234_cov_76.496296	0	76	10	11	76	0.1447368
NODE_300322_length_234_cov_76.496296	49	128	6	9	79	0.1139240
NODE_300322_length_234_cov_76.496296	49	128	7	1	79	0.0126582
NODE_300322_length_234_cov_76.496296	49	128	8	6	79	0.0759494
NODE_300322_length_234_cov_76.496296	49	128	10	19	79	0.2405063
NODE_300322_length_234_cov_76.496296	49	128	16	8	79	0.1012658
NODE_300322_length_234_cov_76.496296	49	128	17	1	79	0.0126582
NODE_300322_length_234_cov_76.496296	49	128	18	9	79	0.1139240
NODE_300322_length_234_cov_76.496296	49	128	20	20	79	0.2531646
NODE_300322_length_234_cov_76.496296	49	128	28	1	79	0.0126582
NODE_300322_length_234_cov_76.496296	49	128	31	5	79	0.0632911
NODE_300322_length_234_cov_76.496296	49	128	6	9	79	0.1139240
NODE_300322_length_234_cov_76.496296	49	128	7	1	79	0.0126582
NODE_300322_length_234_cov_76.496296	49	128	8	6	79	0.0759494
NODE_300322_length_234_cov_76.496296	49	128	10	19	79	0.2405063
NODE_300322_length_234_cov_76.496296	49	128	16	8	79	0.1012658
NODE_300322_length_234_cov_76.496296	49	128	17	1	79	0.0126582
NODE_300322_length_234_cov_76.496296	49	128	18	9	79	0.1139240
NODE_300322_length_234_cov_76.496296	49	128	20	20	79	0.2531646
NODE_300322_length_234_cov_76.496296	49	128	28	1	79	0.0126582
NODE_300322_length_234_cov_76.496296	49	128	31	5	79	0.0632911
NODE_300322_length_234_cov_76.496296	124	204	11	12	80	0.1500000
NODE_300322_length_234_cov_76.496296	124	204	15	5	80	0.0625000
NODE_300322_length_234_cov_76.496296	124	204	17	3	80	0.0375000
NODE_300322_length_234_cov_76.496296	124	204	23	1	80	0.0125000
NODE_300322_length_234_cov_76.496296	124	204	25	7	80	0.0875000
NODE_300322_length_234_cov_76.496296	124	204	26	4	80	0.0500000
NODE_300322_length_234_cov_76.496296	124	204	27	8	80	0.1000000
NODE_300322_length_234_cov_76.496296	124	204	28	5	80	0.0625000
NODE_300322_length_234_cov_76.496296	124	204	29	5	80	0.0625000
NODE_300322_length_234_cov_76.496296	124	204	31	29	80	0.3625000
NODE_300322_length_234_cov_76.496296	124	204	33	1	80	0.0125000
NODE_300322_length_234_cov_76.496296	124	204	11	12	80	0.1500000
NODE_300322_length_234_cov_76.496296	124	204	15	5	80	0.0625000
NODE_300322_length_234_cov_76.496296	124	204	17	3	80	0.0375000
NODE_300322_length_234_cov_76.496296	124	204	23	1	80	0.0125000
NODE_300322_length_234_cov_76.496296	124	204	25	7	80	0.0875000
NODE_300322_length_234_cov_76.496296	124	204	26	4	80	0.0500000
NODE_300322_length_234_cov_76.496296	124	204	27	8	80	0.1000000
NODE_300322_length_234_cov_76.496296	124	204	28	5	80	0.0625000
NODE_300322_length_234_cov_76.496296	124	204	29	5	80	0.0625000
NODE_300322_length_234_cov_76.496296	124	204	31	29	80	0.3625000
NODE_300322_length_234_cov_76.496296	124	204	33	1	80	0.0125000
NODE_300322_length_234_cov_76.496296	124	204	11	12	80	0.1500000
NODE_300322_length_234_cov_76.496296	124	204	15	5	80	0.0625000
NODE_300322_length_234_cov_76.496296	124	204	17	3	80	0.0375000
NODE_300322_length_234_cov_76.496296	124	204	23	1	80	0.0125000
NODE_300322_length_234_cov_76.496296	124	204	25	7	80	0.0875000
NODE_300322_length_234_cov_76.496296	124	204	26	4	80	0.0500000
NODE_300322_length_234_cov_76.496296	124	204	27	8	80	0.1000000
NODE_300322_length_234_cov_76.496296	124	204	28	5	80	0.0625000
NODE_300322_length_234_cov_76.496296	124	204	29	5	80	0.0625000
NODE_300322_length_234_cov_76.496296	124	204	31	29	80	0.3625000
NODE_300322_length_234_cov_76.496296	124	204	33	1	80	0.0125000
NODE_300322_length_234_cov_76.496296	177	226	0	15	49	0.3061225
NODE_300322_length_234_cov_76.496296	177	226	9	2	49	0.0408163
NODE_300322_length_234_cov_76.496296	177	226	11	17	49	0.3469388
NODE_300322_length_234_cov_76.496296	177	226	15	5	49	0.1020408
NODE_300322_length_234_cov_76.496296	177	226	17	3	49	0.0612245
NODE_300322_length_234_cov_76.496296	177	226	23	1	49	0.0204082
NODE_300322_length_234_cov_76.496296	177	226	25	6	49	0.1224490
NODE_300322_length_234_cov_76.496296	177	234	0	23	57	0.4035088
NODE_300322_length_234_cov_76.496296	177	234	9	2	57	0.0350877
NODE_300322_length_234_cov_76.496296	177	234	11	17	57	0.2982456
NODE_300322_length_234_cov_76.496296	177	234	15	5	57	0.0877193
NODE_300322_length_234_cov_76.496296	177	234	17	3	57	0.0526316
NODE_300322_length_234_cov_76.496296	177	234	23	1	57	0.0175439
NODE_300322_length_234_cov_76.496296	177	234	25	6	57	0.1052632
NODE_300322_length_234_cov_76.496296	182	234	0	23	52	0.4423077
NODE_300322_length_234_cov_76.496296	182	234	9	2	52	0.0384615
NODE_300322_length_234_cov_76.496296	182	234	11	17	52	0.3269231
NODE_300322_length_234_cov_76.496296	182	234	15	5	52	0.0961538
NODE_300322_length_234_cov_76.496296	182	234	17	3	52	0.0576923
NODE_300322_length_234_cov_76.496296	182	234	23	1	52	0.0192308
NODE_300322_length_234_cov_76.496296	182	234	25	1	52	0.0192308
NODE_300323_length_234_cov_71.548148	90	162	2	72	72	1.0000000
NODE_300323_length_234_cov_71.548148	90	162	2	72	72	1.0000000
NODE_300323_length_234_cov_71.548148	135	215	0	27	80	0.3375000
NODE_300323_length_234_cov_71.548148	135	215	2	53	80	0.6625000
NODE_300323_length_234_cov_71.548148	135	215	0	27	80	0.3375000
NODE_300323_length_234_cov_71.548148	135	215	2	53	80	0.6625000
NODE_300357_length_233_cov_180.701493	0	65	0	30	65	0.4615385
NODE_300357_length_233_cov_180.701493	0	65	6	30	65	0.4615385
NODE_300357_length_233_cov_180.701493	0	65	8	5	65	0.0769231
NODE_300357_length_233_cov_180.701493	38	118	6	22	80	0.2750000
NODE_300357_length_233_cov_180.701493	38	118	8	39	80	0.4875000
NODE_300357_length_233_cov_180.701493	38	118	10	19	80	0.2375000
NODE_300392_length_232_cov_132.045113	53	133	0	22	80	0.2750000
NODE_300392_length_232_cov_132.045113	53	133	8	58	80	0.7250000
NODE_300392_length_232_cov_132.045113	106	186	8	80	80	1.0000000
NODE_300471_length_230_cov_34.427481	0	59	0	59	59	1.0000000
NODE_300471_length_230_cov_34.427481	0	59	0	59	59	1.0000000
NODE_300471_length_230_cov_34.427481	10	59	0	49	49	1.0000000
NODE_300487_length_229_cov_76.907692	94	176	26	5	82	0.0609756
NODE_300487_length_229_cov_76.907692	94	176	28	1	82	0.0121951
NODE_300487_length_229_cov_76.907692	94	176	30	2	82	0.0243902
NODE_300487_length_229_cov_76.907692	94	176	31	1	82	0.0121951
NODE_300487_length_229_cov_76.907692	94	176	33	2	82	0.0243902
NODE_300487_length_229_cov_76.907692	94	176	36	10	82	0.1219512
NODE_300487_length_229_cov_76.907692	94	176	37	1	82	0.0121951
NODE_300487_length_229_cov_76.907692	94	176	40	8	82	0.0975610
NODE_300487_length_229_cov_76.907692	94	176	41	3	82	0.0365854
NODE_300487_length_229_cov_76.907692	94	176	42	25	82	0.3048781
NODE_300487_length_229_cov_76.907692	94	176	44	12	82	0.1463415
NODE_300487_length_229_cov_76.907692	94	176	46	1	82	0.0121951
NODE_300487_length_229_cov_76.907692	94	176	48	9	82	0.1097561
NODE_300487_length_229_cov_76.907692	94	176	50	2	82	0.0243902
NODE_300523_length_228_cov_127.131783	0	76	0	2	76	0.0263158
NODE_300523_length_228_cov_127.131783	0	76	2	12	76	0.1578947
NODE_300523_length_228_cov_127.131783	0	76	6	24	76	0.3157895
NODE_300523_length_228_cov_127.131783	0	76	10	19	76	0.2500000
NODE_300523_length_228_cov_127.131783	0	76	12	19	76	0.2500000
NODE_300523_length_228_cov_127.131783	5	76	2	9	71	0.1267606
NODE_300523_length_228_cov_127.131783	5	76	6	24	71	0.3380282
NODE_300523_length_228_cov_127.131783	5	76	10	19	71	0.2676056
NODE_300523_length_228_cov_127.131783	5	76	12	19	71	0.2676056
NODE_300523_length_228_cov_127.131783	10	76	2	4	66	0.0606061
NODE_300523_length_228_cov_127.131783	10	76	6	24	66	0.3636364
NODE_300523_length_228_cov_127.131783	10	76	10	19	66	0.2878788
NODE_300523_length_228_cov_127.131783	10	76	12	19	66	0.2878788
NODE_300523_length_228_cov_127.131783	49	129	2	3	80	0.0375000
NODE_300523_length_228_cov_127.131783	49	129	4	15	80	0.1875000
NODE_300523_length_228_cov_127.131783	49	129	8	4	80	0.0500000
NODE_300523_length_228_cov_127.131783	49	129	10	8	80	0.1000000
NODE_300523_length_228_cov_127.131783	49	129	12	50	80	0.6250000
NODE_300523_length_228_cov_127.131783	49	129	2	3	80	0.0375000
NODE_300523_length_228_cov_127.131783	49	129	4	15	80	0.1875000
NODE_300523_length_228_cov_127.131783	49	129	8	4	80	0.0500000
NODE_300523_length_228_cov_127.131783	49	129	10	8	80	0.1000000
NODE_300523_length_228_cov_127.131783	49	129	12	50	80	0.6250000
NODE_300523_length_228_cov_127.131783	49	129	2	3	80	0.0375000
NODE_300523_length_228_cov_127.131783	49	129	4	15	80	0.1875000
NODE_300523_length_228_cov_127.131783	49	129	8	4	80	0.0500000
NODE_300523_length_228_cov_127.131783	49	129	10	8	80	0.1000000
NODE_300523_length_228_cov_127.131783	49	129	12	50	80	0.6250000
NODE_300523_length_228_cov_127.131783	125	205	0	41	80	0.5125000
NODE_300523_length_228_cov_127.131783	125	205	2	38	80	0.4750000
NODE_300523_length_228_cov_127.131783	125	205	4	1	80	0.0125000
NODE_300523_length_228_cov_127.131783	125	205	0	41	80	0.5125000
NODE_300523_length_228_cov_127.131783	125	205	2	38	80	0.4750000
NODE_300523_length_228_cov_127.131783	125	205	4	1	80	0.0125000
NODE_300523_length_228_cov_127.131783	125	205	0	41	80	0.5125000
NODE_300523_length_228_cov_127.131783	125	205	2	38	80	0.4750000
NODE_300523_length_228_cov_127.131783	125	205	4	1	80	0.0125000
NODE_300523_length_228_cov_127.131783	178	228	0	50	50	1.0000000
NODE_300523_length_228_cov_127.131783	178	228	0	50	50	1.0000000
NODE_300523_length_228_cov_127.131783	178	228	0	50	50	1.0000000
NODE_300524_length_228_cov_94.255814	34	99	4	29	65	0.4461538
NODE_300524_length_228_cov_94.255814	34	99	6	1	65	0.0153846
NODE_300524_length_228_cov_94.255814	34	99	10	35	65	0.5384616
NODE_300524_length_228_cov_94.255814	34	114	4	29	80	0.3625000
NODE_300524_length_228_cov_94.255814	34	114	6	1	80	0.0125000
NODE_300524_length_228_cov_94.255814	34	114	10	35	80	0.4375000
NODE_300524_length_228_cov_94.255814	34	114	12	4	80	0.0500000
NODE_300524_length_228_cov_94.255814	34	114	14	11	80	0.1375000
NODE_300524_length_228_cov_94.255814	41	111	4	22	70	0.3142857
NODE_300524_length_228_cov_94.255814	41	111	6	1	70	0.0142857
NODE_300524_length_228_cov_94.255814	41	111	10	35	70	0.5000000
NODE_300524_length_228_cov_94.255814	41	111	12	4	70	0.0571429
NODE_300524_length_228_cov_94.255814	41	111	14	8	70	0.1142857
NODE_300524_length_228_cov_94.255814	43	114	4	20	71	0.2816902
NODE_300524_length_228_cov_94.255814	43	114	6	1	71	0.0140845
NODE_300524_length_228_cov_94.255814	43	114	10	35	71	0.4929577
NODE_300524_length_228_cov_94.255814	43	114	12	4	71	0.0563380
NODE_300524_length_228_cov_94.255814	43	114	14	11	71	0.1549296
NODE_300524_length_228_cov_94.255814	87	167	6	7	80	0.0875000
NODE_300524_length_228_cov_94.255814	87	167	10	19	80	0.2375000
NODE_300524_length_228_cov_94.255814	87	167	12	4	80	0.0500000
NODE_300524_length_228_cov_94.255814	87	167	14	20	80	0.2500000
NODE_300524_length_228_cov_94.255814	87	167	16	30	80	0.3750000
NODE_300524_length_228_cov_94.255814	87	167	6	7	80	0.0875000
NODE_300524_length_228_cov_94.255814	87	167	10	19	80	0.2375000
NODE_300524_length_228_cov_94.255814	87	167	12	4	80	0.0500000
NODE_300524_length_228_cov_94.255814	87	167	14	20	80	0.2500000
NODE_300524_length_228_cov_94.255814	87	167	16	30	80	0.3750000
NODE_300524_length_228_cov_94.255814	87	167	6	7	80	0.0875000
NODE_300524_length_228_cov_94.255814	87	167	10	19	80	0.2375000
NODE_300524_length_228_cov_94.255814	87	167	12	4	80	0.0500000
NODE_300524_length_228_cov_94.255814	87	167	14	20	80	0.2500000
NODE_300524_length_228_cov_94.255814	87	167	16	30	80	0.3750000
NODE_300524_length_228_cov_94.255814	87	167	6	7	80	0.0875000
NODE_300524_length_228_cov_94.255814	87	167	10	19	80	0.2375000
NODE_300524_length_228_cov_94.255814	87	167	12	4	80	0.0500000
NODE_300524_length_228_cov_94.255814	87	167	14	20	80	0.2500000
NODE_300524_length_228_cov_94.255814	87	167	16	30	80	0.3750000
NODE_300547_length_228_cov_0.395349	27	107	4	80	80	1.0000000
NODE_300547_length_228_cov_0.395349	70	150	0	39	80	0.4875000
NODE_300547_length_228_cov_0.395349	70	150	4	41	80	0.5125000
NODE_300556_length_227_cov_37.429688	40	111	0	71	71	1.0000000
NODE_300556_length_227_cov_37.429688	49	112	0	63	63	1.0000000
NODE_300556_length_227_cov_37.429688	93	172	0	22	79	0.2784810
NODE_300556_length_227_cov_37.429688	93	172	2	57	79	0.7215190
NODE_300556_length_227_cov_37.429688	168	227	0	30	59	0.5084746
NODE_300556_length_227_cov_37.429688	168	227	2	29	59	0.4915254
NODE_300556_length_227_cov_37.429688	168	227	0	30	59	0.5084746
NODE_300556_length_227_cov_37.429688	168	227	2	29	59	0.4915254
NODE_300595_length_226_cov_547.629921	82	162	611	1	80	0.0125000
NODE_300595_length_226_cov_547.629921	82	162	613	1	80	0.0125000
NODE_300595_length_226_cov_547.629921	82	162	618	1	80	0.0125000
NODE_300595_length_226_cov_547.629921	82	162	620	1	80	0.0125000
NODE_300595_length_226_cov_547.629921	82	162	621	1	80	0.0125000
NODE_300595_length_226_cov_547.629921	82	162	631	1	80	0.0125000
NODE_300595_length_226_cov_547.629921	82	162	635	2	80	0.0250000
NODE_300595_length_226_cov_547.629921	82	162	641	1	80	0.0125000
NODE_300595_length_226_cov_547.629921	82	162	645	2	80	0.0250000
NODE_300595_length_226_cov_547.629921	82	162	652	1	80	0.0125000
NODE_300595_length_226_cov_547.629921	82	162	653	1	80	0.0125000
NODE_300595_length_226_cov_547.629921	82	162	657	2	80	0.0250000
NODE_300595_length_226_cov_547.629921	82	162	658	2	80	0.0250000
NODE_300595_length_226_cov_547.629921	82	162	663	1	80	0.0125000
NODE_300595_length_226_cov_547.629921	82	162	667	1	80	0.0125000
NODE_300595_length_226_cov_547.629921	82	162	670	1	80	0.0125000
NODE_300595_length_226_cov_547.629921	82	162	681	1	80	0.0125000
NODE_300595_length_226_cov_547.629921	82	162	684	1	80	0.0125000
NODE_300595_length_226_cov_547.629921	82	162	689	2	80	0.0250000
NODE_300595_length_226_cov_547.629921	82	162	697	1	80	0.0125000
NODE_300595_length_226_cov_547.629921	82	162	698	1	80	0.0125000
NODE_300595_length_226_cov_547.629921	82	162	707	1	80	0.0125000
NODE_300595_length_226_cov_547.629921	82	162	708	1	80	0.0125000
NODE_300595_length_226_cov_547.629921	82	162	710	1	80	0.0125000
NODE_300595_length_226_cov_547.629921	82	162	713	1	80	0.0125000
NODE_300595_length_226_cov_547.629921	82	162	714	1	80	0.0125000
NODE_300595_length_226_cov_547.629921	82	162	715	1	80	0.0125000
NODE_300595_length_226_cov_547.629921	82	162	718	1	80	0.0125000
NODE_300595_length_226_cov_547.629921	82	162	724	1	80	0.0125000
NODE_300595_length_226_cov_547.629921	82	162	726	1	80	0.0125000
NODE_300595_length_226_cov_547.629921	82	162	732	1	80	0.0125000
NODE_300595_length_226_cov_547.629921	82	162	733	1	80	0.0125000
NODE_300595_length_226_cov_547.629921	82	162	737	2	80	0.0250000
NODE_300595_length_226_cov_547.629921	82	162	739	1	80	0.0125000
NODE_300595_length_226_cov_547.629921	82	162	744	1	80	0.0125000
NODE_300595_length_226_cov_547.629921	82	162	749	1	80	0.0125000
NODE_300595_length_226_cov_547.629921	82	162	751	1	80	0.0125000
NODE_300595_length_226_cov_547.629921	82	162	757	1	80	0.0125000
NODE_300595_length_226_cov_547.629921	82	162	763	1	80	0.0125000
NODE_300595_length_226_cov_547.629921	82	162	766	1	80	0.0125000
NODE_300595_length_226_cov_547.629921	82	162	769	1	80	0.0125000
NODE_300595_length_226_cov_547.629921	82	162	776	1	80	0.0125000
NODE_300595_length_226_cov_547.629921	82	162	781	1	80	0.0125000
NODE_300595_length_226_cov_547.629921	82	162	784	1	80	0.0125000
NODE_300595_length_226_cov_547.629921	82	162	787	1	80	0.0125000
NODE_300595_length_226_cov_547.629921	82	162	788	1	80	0.0125000
NODE_300595_length_226_cov_547.629921	82	162	791	1	80	0.0125000
NODE_300595_length_226_cov_547.629921	82	162	794	1	80	0.0125000
NODE_300595_length_226_cov_547.629921	82	162	795	1	80	0.0125000
NODE_300595_length_226_cov_547.629921	82	162	796	1	80	0.0125000
NODE_300595_length_226_cov_547.629921	82	162	797	3	80	0.0375000
NODE_300595_length_226_cov_547.629921	82	162	798	1	80	0.0125000
NODE_300595_length_226_cov_547.629921	82	162	801	1	80	0.0125000
NODE_300595_length_226_cov_547.629921	82	162	802	1	80	0.0125000
NODE_300595_length_226_cov_547.629921	82	162	804	3	80	0.0375000
NODE_300595_length_226_cov_547.629921	82	162	805	4	80	0.0500000
NODE_300595_length_226_cov_547.629921	82	162	808	1	80	0.0125000
NODE_300595_length_226_cov_547.629921	82	162	811	1	80	0.0125000
NODE_300595_length_226_cov_547.629921	82	162	815	1	80	0.0125000
NODE_300595_length_226_cov_547.629921	82	162	816	1	80	0.0125000
NODE_300595_length_226_cov_547.629921	82	162	818	1	80	0.0125000
NODE_300595_length_226_cov_547.629921	82	162	819	1	80	0.0125000
NODE_300595_length_226_cov_547.629921	82	162	820	1	80	0.0125000
NODE_300595_length_226_cov_547.629921	82	162	822	1	80	0.0125000
NODE_300595_length_226_cov_547.629921	82	162	824	2	80	0.0250000
NODE_300595_length_226_cov_547.629921	82	162	826	1	80	0.0125000
NODE_300617_length_225_cov_41.269841	81	165	12	3	84	0.0357143
NODE_300617_length_225_cov_41.269841	81	165	16	5	84	0.0595238
NODE_300617_length_225_cov_41.269841	81	165	18	2	84	0.0238095
NODE_300617_length_225_cov_41.269841	81	165	20	4	84	0.0476190
NODE_300617_length_225_cov_41.269841	81	165	22	2	84	0.0238095
NODE_300617_length_225_cov_41.269841	81	165	24	3	84	0.0357143
NODE_300617_length_225_cov_41.269841	81	165	26	4	84	0.0476190
NODE_300617_length_225_cov_41.269841	81	165	28	2	84	0.0238095
NODE_300617_length_225_cov_41.269841	81	165	32	3	84	0.0357143
NODE_300617_length_225_cov_41.269841	81	165	36	1	84	0.0119048
NODE_300617_length_225_cov_41.269841	81	165	38	1	84	0.0119048
NODE_300617_length_225_cov_41.269841	81	165	42	2	84	0.0238095
NODE_300617_length_225_cov_41.269841	81	165	48	11	84	0.1309524
NODE_300617_length_225_cov_41.269841	81	165	50	2	84	0.0238095
NODE_300617_length_225_cov_41.269841	81	165	52	1	84	0.0119048
NODE_300617_length_225_cov_41.269841	81	165	54	2	84	0.0238095
NODE_300617_length_225_cov_41.269841	81	165	60	7	84	0.0833333
NODE_300617_length_225_cov_41.269841	81	165	62	7	84	0.0833333
NODE_300617_length_225_cov_41.269841	81	165	64	5	84	0.0595238
NODE_300617_length_225_cov_41.269841	81	165	66	17	84	0.2023810
NODE_300617_length_225_cov_41.269841	134	218	0	19	84	0.2261905
NODE_300617_length_225_cov_41.269841	134	218	2	6	84	0.0714286
NODE_300617_length_225_cov_41.269841	134	218	4	10	84	0.1190476
NODE_300617_length_225_cov_41.269841	134	218	8	13	84	0.1547619
NODE_300617_length_225_cov_41.269841	134	218	10	3	84	0.0357143
NODE_300617_length_225_cov_41.269841	134	218	12	5	84	0.0595238
NODE_300617_length_225_cov_41.269841	134	218	16	5	84	0.0595238
NODE_300617_length_225_cov_41.269841	134	218	18	2	84	0.0238095
NODE_300617_length_225_cov_41.269841	134	218	20	4	84	0.0476190
NODE_300617_length_225_cov_41.269841	134	218	22	2	84	0.0238095
NODE_300617_length_225_cov_41.269841	134	218	24	3	84	0.0357143
NODE_300617_length_225_cov_41.269841	134	218	26	4	84	0.0476190
NODE_300617_length_225_cov_41.269841	134	218	28	2	84	0.0238095
NODE_300617_length_225_cov_41.269841	134	218	32	3	84	0.0357143
NODE_300617_length_225_cov_41.269841	134	218	36	1	84	0.0119048
NODE_300617_length_225_cov_41.269841	134	218	38	1	84	0.0119048
NODE_300617_length_225_cov_41.269841	134	218	42	1	84	0.0119048
NODE_300661_length_224_cov_209.528000	12	84	4	2	72	0.0277778
NODE_300661_length_224_cov_209.528000	12	84	5	5	72	0.0694444
NODE_300661_length_224_cov_209.528000	12	84	13	18	72	0.2500000
NODE_300661_length_224_cov_209.528000	12	84	15	6	72	0.0833333
NODE_300661_length_224_cov_209.528000	12	84	16	4	72	0.0555556
NODE_300661_length_224_cov_209.528000	12	84	18	37	72	0.5138889
NODE_300663_length_224_cov_146.568000	13	72	8	10	59	0.1694915
NODE_300663_length_224_cov_146.568000	13	72	10	2	59	0.0338983
NODE_300663_length_224_cov_146.568000	13	72	12	5	59	0.0847458
NODE_300663_length_224_cov_146.568000	13	72	14	1	59	0.0169492
NODE_300663_length_224_cov_146.568000	13	72	16	3	59	0.0508475
NODE_300663_length_224_cov_146.568000	13	72	18	1	59	0.0169492
NODE_300663_length_224_cov_146.568000	13	72	20	1	59	0.0169492
NODE_300663_length_224_cov_146.568000	13	72	22	4	59	0.0677966
NODE_300663_length_224_cov_146.568000	13	72	24	10	59	0.1694915
NODE_300663_length_224_cov_146.568000	13	72	26	2	59	0.0338983
NODE_300663_length_224_cov_146.568000	13	72	30	4	59	0.0677966
NODE_300663_length_224_cov_146.568000	13	72	32	4	59	0.0677966
NODE_300663_length_224_cov_146.568000	13	72	37	4	59	0.0677966
NODE_300663_length_224_cov_146.568000	13	72	40	1	59	0.0169492
NODE_300663_length_224_cov_146.568000	13	72	41	7	59	0.1186441
NODE_300663_length_224_cov_146.568000	46	72	24	4	26	0.1538462
NODE_300663_length_224_cov_146.568000	46	72	26	2	26	0.0769231
NODE_300663_length_224_cov_146.568000	46	72	30	4	26	0.1538462
NODE_300663_length_224_cov_146.568000	46	72	32	4	26	0.1538462
NODE_300663_length_224_cov_146.568000	46	72	37	4	26	0.1538462
NODE_300663_length_224_cov_146.568000	46	72	40	1	26	0.0384615
NODE_300663_length_224_cov_146.568000	46	72	41	7	26	0.2692308
NODE_300663_length_224_cov_146.568000	68	120	41	7	52	0.1346154
NODE_300663_length_224_cov_146.568000	68	120	43	1	52	0.0192308
NODE_300663_length_224_cov_146.568000	68	120	44	2	52	0.0384615
NODE_300663_length_224_cov_146.568000	68	120	46	3	52	0.0576923
NODE_300663_length_224_cov_146.568000	68	120	50	1	52	0.0192308
NODE_300663_length_224_cov_146.568000	68	120	52	1	52	0.0192308
NODE_300663_length_224_cov_146.568000	68	120	60	1	52	0.0192308
NODE_300663_length_224_cov_146.568000	68	120	64	1	52	0.0192308
NODE_300663_length_224_cov_146.568000	68	120	65	1	52	0.0192308
NODE_300663_length_224_cov_146.568000	68	120	69	2	52	0.0384615
NODE_300663_length_224_cov_146.568000	68	120	70	1	52	0.0192308
NODE_300663_length_224_cov_146.568000	68	120	72	1	52	0.0192308
NODE_300663_length_224_cov_146.568000	68	120	74	1	52	0.0192308
NODE_300663_length_224_cov_146.568000	68	120	76	2	52	0.0384615
NODE_300663_length_224_cov_146.568000	68	120	80	3	52	0.0576923
NODE_300663_length_224_cov_146.568000	68	120	82	2	52	0.0384615
NODE_300663_length_224_cov_146.568000	68	120	84	4	52	0.0769231
NODE_300663_length_224_cov_146.568000	68	120	86	2	52	0.0384615
NODE_300663_length_224_cov_146.568000	68	120	90	2	52	0.0384615
NODE_300663_length_224_cov_146.568000	68	120	92	7	52	0.1346154
NODE_300663_length_224_cov_146.568000	68	120	94	3	52	0.0576923
NODE_300663_length_224_cov_146.568000	68	120	95	1	52	0.0192308
NODE_300663_length_224_cov_146.568000	68	120	98	3	52	0.0576923
NODE_300665_length_224_cov_59.088000	98	178	12	11	80	0.1375000
NODE_300665_length_224_cov_59.088000	98	178	16	40	80	0.5000000
NODE_300665_length_224_cov_59.088000	98	178	18	29	80	0.3625000
NODE_300665_length_224_cov_59.088000	98	178	12	11	80	0.1375000
NODE_300665_length_224_cov_59.088000	98	178	16	40	80	0.5000000
NODE_300665_length_224_cov_59.088000	98	178	18	29	80	0.3625000
NODE_300665_length_224_cov_59.088000	98	178	12	11	80	0.1375000
NODE_300665_length_224_cov_59.088000	98	178	16	40	80	0.5000000
NODE_300665_length_224_cov_59.088000	98	178	18	29	80	0.3625000
NODE_300665_length_224_cov_59.088000	151	217	0	26	66	0.3939394
NODE_300665_length_224_cov_59.088000	151	217	4	1	66	0.0151515
NODE_300665_length_224_cov_59.088000	151	217	8	7	66	0.1060606
NODE_300665_length_224_cov_59.088000	151	217	10	3	66	0.0454545
NODE_300665_length_224_cov_59.088000	151	217	12	13	66	0.1969697
NODE_300665_length_224_cov_59.088000	151	217	16	16	66	0.2424242
NODE_300665_length_224_cov_59.088000	151	224	0	33	73	0.4520548
NODE_300665_length_224_cov_59.088000	151	224	4	1	73	0.0136986
NODE_300665_length_224_cov_59.088000	151	224	8	7	73	0.0958904
NODE_300665_length_224_cov_59.088000	151	224	10	3	73	0.0410959
NODE_300665_length_224_cov_59.088000	151	224	12	13	73	0.1780822
NODE_300665_length_224_cov_59.088000	151	224	16	16	73	0.2191781
NODE_300667_length_224_cov_43.640000	98	157	4	59	59	1.0000000
NODE_300667_length_224_cov_43.640000	98	157	4	59	59	1.0000000
NODE_300667_length_224_cov_43.640000	106	157	4	51	51	1.0000000
NODE_300669_length_224_cov_36.224000	100	171	6	55	71	0.7746479
NODE_300669_length_224_cov_36.224000	100	171	8	16	71	0.2253521
NODE_300669_length_224_cov_36.224000	151	224	0	4	73	0.0547945
NODE_300669_length_224_cov_36.224000	151	224	1	1	73	0.0136986
NODE_300669_length_224_cov_36.224000	151	224	3	1	73	0.0136986
NODE_300669_length_224_cov_36.224000	151	224	4	4	73	0.0547945
NODE_300669_length_224_cov_36.224000	151	224	6	63	73	0.8630137
NODE_300696_length_223_cov_35.814516	0	54	0	20	54	0.3703704
NODE_300696_length_223_cov_35.814516	0	54	2	6	54	0.1111111
NODE_300696_length_223_cov_35.814516	0	54	4	28	54	0.5185185
NODE_300696_length_223_cov_35.814516	30	107	4	40	77	0.5194805
NODE_300696_length_223_cov_35.814516	30	107	6	4	77	0.0519481
NODE_300696_length_223_cov_35.814516	30	107	10	17	77	0.2207792
NODE_300696_length_223_cov_35.814516	30	107	12	9	77	0.1168831
NODE_300696_length_223_cov_35.814516	30	107	14	7	77	0.0909091
NODE_300768_length_221_cov_71.319672	14	94	20	3	80	0.0375000
NODE_300768_length_221_cov_71.319672	14	94	21	3	80	0.0375000
NODE_300768_length_221_cov_71.319672	14	94	22	1	80	0.0125000
NODE_300768_length_221_cov_71.319672	14	94	23	3	80	0.0375000
NODE_300768_length_221_cov_71.319672	14	94	25	2	80	0.0250000
NODE_300768_length_221_cov_71.319672	14	94	28	3	80	0.0375000
NODE_300768_length_221_cov_71.319672	14	94	34	1	80	0.0125000
NODE_300768_length_221_cov_71.319672	14	94	35	3	80	0.0375000
NODE_300768_length_221_cov_71.319672	14	94	41	2	80	0.0250000
NODE_300768_length_221_cov_71.319672	14	94	51	4	80	0.0500000
NODE_300768_length_221_cov_71.319672	14	94	53	1	80	0.0125000
NODE_300768_length_221_cov_71.319672	14	94	55	1	80	0.0125000
NODE_300768_length_221_cov_71.319672	14	94	60	1	80	0.0125000
NODE_300768_length_221_cov_71.319672	14	94	62	1	80	0.0125000
NODE_300768_length_221_cov_71.319672	14	94	63	5	80	0.0625000
NODE_300768_length_221_cov_71.319672	14	94	67	3	80	0.0375000
NODE_300768_length_221_cov_71.319672	14	94	68	1	80	0.0125000
NODE_300768_length_221_cov_71.319672	14	94	75	2	80	0.0250000
NODE_300768_length_221_cov_71.319672	14	94	77	1	80	0.0125000
NODE_300768_length_221_cov_71.319672	14	94	81	1	80	0.0125000
NODE_300768_length_221_cov_71.319672	14	94	91	2	80	0.0250000
NODE_300768_length_221_cov_71.319672	14	94	93	4	80	0.0500000
NODE_300768_length_221_cov_71.319672	14	94	94	32	80	0.4000000
NODE_300800_length_220_cov_42.206612	3	74	6	7	71	0.0985916
NODE_300800_length_220_cov_42.206612	3	74	7	1	71	0.0140845
NODE_300800_length_220_cov_42.206612	3	74	8	4	71	0.0563380
NODE_300800_length_220_cov_42.206612	3	74	10	3	71	0.0422535
NODE_300800_length_220_cov_42.206612	3	74	12	7	71	0.0985916
NODE_300800_length_220_cov_42.206612	3	74	14	1	71	0.0140845
NODE_300800_length_220_cov_42.206612	3	74	20	16	71	0.2253521
NODE_300800_length_220_cov_42.206612	3	74	22	5	71	0.0704225
NODE_300800_length_220_cov_42.206612	3	74	26	27	71	0.3802817
NODE_300800_length_220_cov_42.206612	8	74	6	2	66	0.0303030
NODE_300800_length_220_cov_42.206612	8	74	7	1	66	0.0151515
NODE_300800_length_220_cov_42.206612	8	74	8	4	66	0.0606061
NODE_300800_length_220_cov_42.206612	8	74	10	3	66	0.0454545
NODE_300800_length_220_cov_42.206612	8	74	12	7	66	0.1060606
NODE_300800_length_220_cov_42.206612	8	74	14	1	66	0.0151515
NODE_300800_length_220_cov_42.206612	8	74	20	16	66	0.2424242
NODE_300800_length_220_cov_42.206612	8	74	22	5	66	0.0757576
NODE_300800_length_220_cov_42.206612	8	74	26	27	66	0.4090909
NODE_300800_length_220_cov_42.206612	47	98	26	51	51	1.0000000
NODE_300800_length_220_cov_42.206612	47	98	26	51	51	1.0000000
NODE_300800_length_220_cov_42.206612	47	98	26	51	51	1.0000000
NODE_300874_length_218_cov_244.773109	128	203	6	5	75	0.0666667
NODE_300874_length_218_cov_244.773109	128	203	8	11	75	0.1466667
NODE_300874_length_218_cov_244.773109	128	203	12	5	75	0.0666667
NODE_300874_length_218_cov_244.773109	128	203	14	2	75	0.0266667
NODE_300874_length_218_cov_244.773109	128	203	16	15	75	0.2000000
NODE_300874_length_218_cov_244.773109	128	203	18	3	75	0.0400000
NODE_300874_length_218_cov_244.773109	128	203	20	3	75	0.0400000
NODE_300874_length_218_cov_244.773109	128	203	22	7	75	0.0933333
NODE_300874_length_218_cov_244.773109	128	203	24	1	75	0.0133333
NODE_300874_length_218_cov_244.773109	128	203	26	5	75	0.0666667
NODE_300874_length_218_cov_244.773109	128	203	32	4	75	0.0533333
NODE_300874_length_218_cov_244.773109	128	203	38	1	75	0.0133333
NODE_300874_length_218_cov_244.773109	128	203	40	3	75	0.0400000
NODE_300874_length_218_cov_244.773109	128	203	42	10	75	0.1333333
NODE_300874_length_218_cov_244.773109	176	218	0	5	42	0.1190476
NODE_300874_length_218_cov_244.773109	176	218	2	1	42	0.0238095
NODE_300874_length_218_cov_244.773109	176	218	4	7	42	0.1666667
NODE_300874_length_218_cov_244.773109	176	218	6	7	42	0.1666667
NODE_300874_length_218_cov_244.773109	176	218	8	11	42	0.2619048
NODE_300874_length_218_cov_244.773109	176	218	12	5	42	0.1190476
NODE_300874_length_218_cov_244.773109	176	218	14	2	42	0.0476190
NODE_300874_length_218_cov_244.773109	176	218	16	4	42	0.0952381
NODE_300915_length_217_cov_2.144068	14	49	0	35	35	1.0000000
NODE_300915_length_217_cov_2.144068	132	167	0	35	35	1.0000000
NODE_300924_length_216_cov_215.410256	0	63	0	8	63	0.1269841
NODE_300924_length_216_cov_215.410256	0	63	2	19	63	0.3015873
NODE_300924_length_216_cov_215.410256	0	63	4	5	63	0.0793651
NODE_300924_length_216_cov_215.410256	0	63	6	8	63	0.1269841
NODE_300924_length_216_cov_215.410256	0	63	8	8	63	0.1269841
NODE_300924_length_216_cov_215.410256	0	63	10	15	63	0.2380952
NODE_300924_length_216_cov_215.410256	36	102	6	4	66	0.0606061
NODE_300924_length_216_cov_215.410256	36	102	8	8	66	0.1212121
NODE_300924_length_216_cov_215.410256	36	102	10	32	66	0.4848485
NODE_300924_length_216_cov_215.410256	36	102	12	22	66	0.3333333
NODE_300925_length_216_cov_51.940171	164	216	0	52	52	1.0000000
NODE_300953_length_215_cov_14.784483	0	50	0	50	50	1.0000000
NODE_300953_length_215_cov_14.784483	23	103	0	80	80	1.0000000
NODE_300984_length_214_cov_144.165217	0	62	0	59	62	0.9516129
NODE_300984_length_214_cov_144.165217	0	62	7	3	62	0.0483871
NODE_300984_length_214_cov_144.165217	0	62	0	59	62	0.9516129
NODE_300984_length_214_cov_144.165217	0	62	7	3	62	0.0483871
NODE_300984_length_214_cov_144.165217	35	115	0	24	80	0.3000000
NODE_300984_length_214_cov_144.165217	35	115	7	15	80	0.1875000
NODE_300984_length_214_cov_144.165217	35	115	9	25	80	0.3125000
NODE_300984_length_214_cov_144.165217	35	115	10	16	80	0.2000000
NODE_300984_length_214_cov_144.165217	35	115	0	24	80	0.3000000
NODE_300984_length_214_cov_144.165217	35	115	7	15	80	0.1875000
NODE_300984_length_214_cov_144.165217	35	115	9	25	80	0.3125000
NODE_300984_length_214_cov_144.165217	35	115	10	16	80	0.2000000
NODE_300984_length_214_cov_144.165217	35	115	0	24	80	0.3000000
NODE_300984_length_214_cov_144.165217	35	115	7	15	80	0.1875000
NODE_300984_length_214_cov_144.165217	35	115	9	25	80	0.3125000
NODE_300984_length_214_cov_144.165217	35	115	10	16	80	0.2000000
NODE_300984_length_214_cov_144.165217	111	191	8	25	80	0.3125000
NODE_300984_length_214_cov_144.165217	111	191	10	55	80	0.6875000
NODE_300984_length_214_cov_144.165217	111	191	8	25	80	0.3125000
NODE_300984_length_214_cov_144.165217	111	191	10	55	80	0.6875000
NODE_300984_length_214_cov_144.165217	111	191	8	25	80	0.3125000
NODE_300984_length_214_cov_144.165217	111	191	10	55	80	0.6875000
NODE_300984_length_214_cov_144.165217	164	214	0	8	50	0.1600000
NODE_300984_length_214_cov_144.165217	164	214	8	40	50	0.8000000
NODE_300984_length_214_cov_144.165217	164	214	10	2	50	0.0400000
NODE_300984_length_214_cov_144.165217	164	214	0	8	50	0.1600000
NODE_300984_length_214_cov_144.165217	164	214	8	40	50	0.8000000
NODE_300984_length_214_cov_144.165217	164	214	10	2	50	0.0400000
NODE_300984_length_214_cov_144.165217	164	214	0	8	50	0.1600000
NODE_300984_length_214_cov_144.165217	164	214	8	40	50	0.8000000
NODE_300984_length_214_cov_144.165217	164	214	10	2	50	0.0400000
NODE_301068_length_211_cov_39.571429	4	84	0	9	80	0.1125000
NODE_301068_length_211_cov_39.571429	4	84	3	22	80	0.2750000
NODE_301068_length_211_cov_39.571429	4	84	5	26	80	0.3250000
NODE_301068_length_211_cov_39.571429	4	84	6	23	80	0.2875000
NODE_301169_length_208_cov_45.238532	3	59	0	56	56	1.0000000
NODE_301169_length_208_cov_45.238532	35	112	0	77	77	1.0000000
NODE_301170_length_208_cov_35.229358	76	156	0	80	80	1.0000000
NODE_301179_length_207_cov_341.324074	33	113	4	10	80	0.1250000
NODE_301179_length_207_cov_341.324074	33	113	6	70	80	0.8750000
NODE_301179_length_207_cov_341.324074	86	166	0	37	80	0.4625000
NODE_301179_length_207_cov_341.324074	86	166	2	6	80	0.0750000
NODE_301179_length_207_cov_341.324074	86	166	4	9	80	0.1125000
NODE_301179_length_207_cov_341.324074	86	166	6	28	80	0.3500000
NODE_301248_length_205_cov_64.179245	6	77	1	1	71	0.0140845
NODE_301248_length_205_cov_64.179245	6	77	2	9	71	0.1267606
NODE_301248_length_205_cov_64.179245	6	77	3	13	71	0.1830986
NODE_301248_length_205_cov_64.179245	6	77	5	2	71	0.0281690
NODE_301248_length_205_cov_64.179245	6	77	7	8	71	0.1126761
NODE_301248_length_205_cov_64.179245	6	77	8	1	71	0.0140845
NODE_301248_length_205_cov_64.179245	6	77	10	2	71	0.0281690
NODE_301248_length_205_cov_64.179245	6	77	12	7	71	0.0985916
NODE_301248_length_205_cov_64.179245	6	77	14	11	71	0.1549296
NODE_301248_length_205_cov_64.179245	6	77	18	3	71	0.0422535
NODE_301248_length_205_cov_64.179245	6	77	20	2	71	0.0281690
NODE_301248_length_205_cov_64.179245	6	77	22	5	71	0.0704225
NODE_301248_length_205_cov_64.179245	6	77	24	7	71	0.0985916
NODE_301248_length_205_cov_64.179245	11	77	2	5	66	0.0757576
NODE_301248_length_205_cov_64.179245	11	77	3	13	66	0.1969697
NODE_301248_length_205_cov_64.179245	11	77	5	2	66	0.0303030
NODE_301248_length_205_cov_64.179245	11	77	7	8	66	0.1212121
NODE_301248_length_205_cov_64.179245	11	77	8	1	66	0.0151515
NODE_301248_length_205_cov_64.179245	11	77	10	2	66	0.0303030
NODE_301248_length_205_cov_64.179245	11	77	12	7	66	0.1060606
NODE_301248_length_205_cov_64.179245	11	77	14	11	66	0.1666667
NODE_301248_length_205_cov_64.179245	11	77	18	3	66	0.0454545
NODE_301248_length_205_cov_64.179245	11	77	20	2	66	0.0303030
NODE_301248_length_205_cov_64.179245	11	77	22	5	66	0.0757576
NODE_301248_length_205_cov_64.179245	11	77	24	7	66	0.1060606
NODE_301248_length_205_cov_64.179245	50	98	14	10	48	0.2083333
NODE_301248_length_205_cov_64.179245	50	98	18	3	48	0.0625000
NODE_301248_length_205_cov_64.179245	50	98	20	2	48	0.0416667
NODE_301248_length_205_cov_64.179245	50	98	22	5	48	0.1041667
NODE_301248_length_205_cov_64.179245	50	98	24	25	48	0.5208333
NODE_301248_length_205_cov_64.179245	50	98	26	2	48	0.0416667
NODE_301248_length_205_cov_64.179245	50	98	28	1	48	0.0208333
NODE_301248_length_205_cov_64.179245	50	98	14	10	48	0.2083333
NODE_301248_length_205_cov_64.179245	50	98	18	3	48	0.0625000
NODE_301248_length_205_cov_64.179245	50	98	20	2	48	0.0416667
NODE_301248_length_205_cov_64.179245	50	98	22	5	48	0.1041667
NODE_301248_length_205_cov_64.179245	50	98	24	25	48	0.5208333
NODE_301248_length_205_cov_64.179245	50	98	26	2	48	0.0416667
NODE_301248_length_205_cov_64.179245	50	98	28	1	48	0.0208333
NODE_301248_length_205_cov_64.179245	50	98	14	10	48	0.2083333
NODE_301248_length_205_cov_64.179245	50	98	18	3	48	0.0625000
NODE_301248_length_205_cov_64.179245	50	98	20	2	48	0.0416667
NODE_301248_length_205_cov_64.179245	50	98	22	5	48	0.1041667
NODE_301248_length_205_cov_64.179245	50	98	24	25	48	0.5208333
NODE_301248_length_205_cov_64.179245	50	98	26	2	48	0.0416667
NODE_301248_length_205_cov_64.179245	50	98	28	1	48	0.0208333
NODE_301281_length_204_cov_183.390476	119	199	7	4	80	0.0500000
NODE_301281_length_204_cov_183.390476	119	199	13	1	80	0.0125000
NODE_301281_length_204_cov_183.390476	119	199	15	1	80	0.0125000
NODE_301281_length_204_cov_183.390476	119	199	16	4	80	0.0500000
NODE_301281_length_204_cov_183.390476	119	199	17	1	80	0.0125000
NODE_301281_length_204_cov_183.390476	119	199	18	7	80	0.0875000
NODE_301281_length_204_cov_183.390476	119	199	22	8	80	0.1000000
NODE_301281_length_204_cov_183.390476	119	199	24	9	80	0.1125000
NODE_301281_length_204_cov_183.390476	119	199	26	4	80	0.0500000
NODE_301281_length_204_cov_183.390476	119	199	31	1	80	0.0125000
NODE_301281_length_204_cov_183.390476	119	199	33	7	80	0.0875000
NODE_301281_length_204_cov_183.390476	119	199	34	1	80	0.0125000
NODE_301281_length_204_cov_183.390476	119	199	36	2	80	0.0250000
NODE_301281_length_204_cov_183.390476	119	199	38	15	80	0.1875000
NODE_301281_length_204_cov_183.390476	119	199	40	4	80	0.0500000
NODE_301281_length_204_cov_183.390476	119	199	42	1	80	0.0125000
NODE_301281_length_204_cov_183.390476	119	199	44	5	80	0.0625000
NODE_301281_length_204_cov_183.390476	119	199	46	4	80	0.0500000
NODE_301281_length_204_cov_183.390476	119	199	50	1	80	0.0125000
NODE_301281_length_204_cov_183.390476	172	194	15	1	22	0.0454545
NODE_301281_length_204_cov_183.390476	172	194	16	4	22	0.1818182
NODE_301281_length_204_cov_183.390476	172	194	17	1	22	0.0454545
NODE_301281_length_204_cov_183.390476	172	194	18	7	22	0.3181818
NODE_301281_length_204_cov_183.390476	172	194	22	8	22	0.3636364
NODE_301281_length_204_cov_183.390476	172	194	24	1	22	0.0454545
NODE_301283_length_204_cov_80.095238	10	90	0	62	80	0.7750000
NODE_301283_length_204_cov_80.095238	10	90	2	6	80	0.0750000
NODE_301283_length_204_cov_80.095238	10	90	4	12	80	0.1500000
NODE_301283_length_204_cov_80.095238	63	143	0	11	80	0.1375000
NODE_301283_length_204_cov_80.095238	63	143	2	26	80	0.3250000
NODE_301283_length_204_cov_80.095238	63	143	4	43	80	0.5375000
NODE_301345_length_202_cov_123.184466	0	64	20	1	64	0.0156250
NODE_301345_length_202_cov_123.184466	0	64	26	1	64	0.0156250
NODE_301345_length_202_cov_123.184466	0	64	28	2	64	0.0312500
NODE_301345_length_202_cov_123.184466	0	64	29	2	64	0.0312500
NODE_301345_length_202_cov_123.184466	0	64	31	1	64	0.0156250
NODE_301345_length_202_cov_123.184466	0	64	33	1	64	0.0156250
NODE_301345_length_202_cov_123.184466	0	64	34	2	64	0.0312500
NODE_301345_length_202_cov_123.184466	0	64	35	3	64	0.0468750
NODE_301345_length_202_cov_123.184466	0	64	36	1	64	0.0156250
NODE_301345_length_202_cov_123.184466	0	64	42	4	64	0.0625000
NODE_301345_length_202_cov_123.184466	0	64	48	3	64	0.0468750
NODE_301345_length_202_cov_123.184466	0	64	49	1	64	0.0156250
NODE_301345_length_202_cov_123.184466	0	64	51	1	64	0.0156250
NODE_301345_length_202_cov_123.184466	0	64	54	2	64	0.0312500
NODE_301345_length_202_cov_123.184466	0	64	55	1	64	0.0156250
NODE_301345_length_202_cov_123.184466	0	64	59	3	64	0.0468750
NODE_301345_length_202_cov_123.184466	0	64	60	1	64	0.0156250
NODE_301345_length_202_cov_123.184466	0	64	64	3	64	0.0468750
NODE_301345_length_202_cov_123.184466	0	64	66	1	64	0.0156250
NODE_301345_length_202_cov_123.184466	0	64	69	1	64	0.0156250
NODE_301345_length_202_cov_123.184466	0	64	71	1	64	0.0156250
NODE_301345_length_202_cov_123.184466	0	64	73	1	64	0.0156250
NODE_301345_length_202_cov_123.184466	0	64	76	3	64	0.0468750
NODE_301345_length_202_cov_123.184466	0	64	78	1	64	0.0156250
NODE_301345_length_202_cov_123.184466	0	64	85	1	64	0.0156250
NODE_301345_length_202_cov_123.184466	0	64	89	1	64	0.0156250
NODE_301345_length_202_cov_123.184466	0	64	92	1	64	0.0156250
NODE_301345_length_202_cov_123.184466	0	64	99	3	64	0.0468750
NODE_301345_length_202_cov_123.184466	0	64	103	2	64	0.0312500
NODE_301345_length_202_cov_123.184466	0	64	107	1	64	0.0156250
NODE_301345_length_202_cov_123.184466	0	64	110	1	64	0.0156250
NODE_301345_length_202_cov_123.184466	0	64	115	1	64	0.0156250
NODE_301345_length_202_cov_123.184466	0	64	122	4	64	0.0625000
NODE_301345_length_202_cov_123.184466	0	64	129	1	64	0.0156250
NODE_301345_length_202_cov_123.184466	0	64	132	1	64	0.0156250
NODE_301345_length_202_cov_123.184466	0	64	136	1	64	0.0156250
NODE_301345_length_202_cov_123.184466	0	64	140	1	64	0.0156250
NODE_301345_length_202_cov_123.184466	0	64	142	1	64	0.0156250
NODE_301345_length_202_cov_123.184466	0	64	144	1	64	0.0156250
NODE_301345_length_202_cov_123.184466	0	64	145	2	64	0.0312500
NODE_301345_length_202_cov_123.184466	31	72	64	2	41	0.0487805
NODE_301345_length_202_cov_123.184466	31	72	66	1	41	0.0243902
NODE_301345_length_202_cov_123.184466	31	72	69	1	41	0.0243902
NODE_301345_length_202_cov_123.184466	31	72	71	1	41	0.0243902
NODE_301345_length_202_cov_123.184466	31	72	73	1	41	0.0243902
NODE_301345_length_202_cov_123.184466	31	72	76	3	41	0.0731707
NODE_301345_length_202_cov_123.184466	31	72	78	1	41	0.0243902
NODE_301345_length_202_cov_123.184466	31	72	85	1	41	0.0243902
NODE_301345_length_202_cov_123.184466	31	72	89	1	41	0.0243902
NODE_301345_length_202_cov_123.184466	31	72	92	1	41	0.0243902
NODE_301345_length_202_cov_123.184466	31	72	99	3	41	0.0731707
NODE_301345_length_202_cov_123.184466	31	72	103	2	41	0.0487805
NODE_301345_length_202_cov_123.184466	31	72	107	1	41	0.0243902
NODE_301345_length_202_cov_123.184466	31	72	110	1	41	0.0243902
NODE_301345_length_202_cov_123.184466	31	72	115	1	41	0.0243902
NODE_301345_length_202_cov_123.184466	31	72	122	4	41	0.0975610
NODE_301345_length_202_cov_123.184466	31	72	129	1	41	0.0243902
NODE_301345_length_202_cov_123.184466	31	72	132	1	41	0.0243902
NODE_301345_length_202_cov_123.184466	31	72	136	1	41	0.0243902
NODE_301345_length_202_cov_123.184466	31	72	140	1	41	0.0243902
NODE_301345_length_202_cov_123.184466	31	72	142	1	41	0.0243902
NODE_301345_length_202_cov_123.184466	31	72	144	1	41	0.0243902
NODE_301345_length_202_cov_123.184466	31	72	145	2	41	0.0487805
NODE_301345_length_202_cov_123.184466	31	72	147	1	41	0.0243902
NODE_301345_length_202_cov_123.184466	31	72	160	1	41	0.0243902
NODE_301345_length_202_cov_123.184466	31	72	167	1	41	0.0243902
NODE_301345_length_202_cov_123.184466	31	72	180	1	41	0.0243902
NODE_301345_length_202_cov_123.184466	31	72	188	1	41	0.0243902
NODE_301345_length_202_cov_123.184466	31	72	192	1	41	0.0243902
NODE_301345_length_202_cov_123.184466	31	72	194	1	41	0.0243902
NODE_301345_length_202_cov_123.184466	31	72	198	1	41	0.0243902
NODE_301370_length_201_cov_56.323529	133	201	0	14	68	0.2058824
NODE_301370_length_201_cov_56.323529	133	201	1	4	68	0.0588235
NODE_301370_length_201_cov_56.323529	133	201	3	1	68	0.0147059
NODE_301370_length_201_cov_56.323529	133	201	4	33	68	0.4852941
NODE_301370_length_201_cov_56.323529	133	201	5	6	68	0.0882353
NODE_301370_length_201_cov_56.323529	133	201	8	1	68	0.0147059
NODE_301370_length_201_cov_56.323529	133	201	10	6	68	0.0882353
NODE_301370_length_201_cov_56.323529	133	201	12	2	68	0.0294118
NODE_301370_length_201_cov_56.323529	133	201	14	1	68	0.0147059
NODE_301371_length_201_cov_50.647059	44	99	20	6	55	0.1090909
NODE_301371_length_201_cov_50.647059	44	99	24	3	55	0.0545455
NODE_301371_length_201_cov_50.647059	44	99	26	6	55	0.1090909
NODE_301371_length_201_cov_50.647059	44	99	28	2	55	0.0363636
NODE_301371_length_201_cov_50.647059	44	99	32	1	55	0.0181818
NODE_301371_length_201_cov_50.647059	44	99	38	9	55	0.1636364
NODE_301371_length_201_cov_50.647059	44	99	40	3	55	0.0545455
NODE_301371_length_201_cov_50.647059	44	99	42	6	55	0.1090909
NODE_301371_length_201_cov_50.647059	44	99	44	3	55	0.0545455
NODE_301371_length_201_cov_50.647059	44	99	46	2	55	0.0363636
NODE_301371_length_201_cov_50.647059	44	99	48	5	55	0.0909091
NODE_301371_length_201_cov_50.647059	44	99	50	1	55	0.0181818
NODE_301371_length_201_cov_50.647059	44	99	54	1	55	0.0181818
NODE_301371_length_201_cov_50.647059	44	99	58	2	55	0.0363636
NODE_301371_length_201_cov_50.647059	44	99	60	3	55	0.0545455
NODE_301371_length_201_cov_50.647059	44	99	62	2	55	0.0363636
NODE_301371_length_201_cov_50.647059	136	201	10	6	65	0.0923077
NODE_301371_length_201_cov_50.647059	136	201	12	1	65	0.0153846
NODE_301371_length_201_cov_50.647059	136	201	14	2	65	0.0307692
NODE_301371_length_201_cov_50.647059	136	201	16	3	65	0.0461538
NODE_301371_length_201_cov_50.647059	136	201	18	1	65	0.0153846
NODE_301371_length_201_cov_50.647059	136	201	22	3	65	0.0461538
NODE_301371_length_201_cov_50.647059	136	201	24	5	65	0.0769231
NODE_301371_length_201_cov_50.647059	136	201	26	3	65	0.0461538
NODE_301371_length_201_cov_50.647059	136	201	28	13	65	0.2000000
NODE_301371_length_201_cov_50.647059	136	201	30	4	65	0.0615385
NODE_301371_length_201_cov_50.647059	136	201	34	6	65	0.0923077
NODE_301371_length_201_cov_50.647059	136	201	36	3	65	0.0461538
NODE_301371_length_201_cov_50.647059	136	201	38	1	65	0.0153846
NODE_301371_length_201_cov_50.647059	136	201	40	1	65	0.0153846
NODE_301371_length_201_cov_50.647059	136	201	42	13	65	0.2000000
NODE_301371_length_201_cov_50.647059	136	201	10	6	65	0.0923077
NODE_301371_length_201_cov_50.647059	136	201	12	1	65	0.0153846
NODE_301371_length_201_cov_50.647059	136	201	14	2	65	0.0307692
NODE_301371_length_201_cov_50.647059	136	201	16	3	65	0.0461538
NODE_301371_length_201_cov_50.647059	136	201	18	1	65	0.0153846
NODE_301371_length_201_cov_50.647059	136	201	22	3	65	0.0461538
NODE_301371_length_201_cov_50.647059	136	201	24	5	65	0.0769231
NODE_301371_length_201_cov_50.647059	136	201	26	3	65	0.0461538
NODE_301371_length_201_cov_50.647059	136	201	28	13	65	0.2000000
NODE_301371_length_201_cov_50.647059	136	201	30	4	65	0.0615385
NODE_301371_length_201_cov_50.647059	136	201	34	6	65	0.0923077
NODE_301371_length_201_cov_50.647059	136	201	36	3	65	0.0461538
NODE_301371_length_201_cov_50.647059	136	201	38	1	65	0.0153846
NODE_301371_length_201_cov_50.647059	136	201	40	1	65	0.0153846
NODE_301371_length_201_cov_50.647059	136	201	42	13	65	0.2000000
NODE_301371_length_201_cov_50.647059	136	201	10	6	65	0.0923077
NODE_301371_length_201_cov_50.647059	136	201	12	1	65	0.0153846
NODE_301371_length_201_cov_50.647059	136	201	14	2	65	0.0307692
NODE_301371_length_201_cov_50.647059	136	201	16	3	65	0.0461538
NODE_301371_length_201_cov_50.647059	136	201	18	1	65	0.0153846
NODE_301371_length_201_cov_50.647059	136	201	22	3	65	0.0461538
NODE_301371_length_201_cov_50.647059	136	201	24	5	65	0.0769231
NODE_301371_length_201_cov_50.647059	136	201	26	3	65	0.0461538
NODE_301371_length_201_cov_50.647059	136	201	28	13	65	0.2000000
NODE_301371_length_201_cov_50.647059	136	201	30	4	65	0.0615385
NODE_301371_length_201_cov_50.647059	136	201	34	6	65	0.0923077
NODE_301371_length_201_cov_50.647059	136	201	36	3	65	0.0461538
NODE_301371_length_201_cov_50.647059	136	201	38	1	65	0.0153846
NODE_301371_length_201_cov_50.647059	136	201	40	1	65	0.0153846
NODE_301371_length_201_cov_50.647059	136	201	42	13	65	0.2000000
NODE_301371_length_201_cov_50.647059	136	201	10	6	65	0.0923077
NODE_301371_length_201_cov_50.647059	136	201	12	1	65	0.0153846
NODE_301371_length_201_cov_50.647059	136	201	14	2	65	0.0307692
NODE_301371_length_201_cov_50.647059	136	201	16	3	65	0.0461538
NODE_301371_length_201_cov_50.647059	136	201	18	1	65	0.0153846
NODE_301371_length_201_cov_50.647059	136	201	22	3	65	0.0461538
NODE_301371_length_201_cov_50.647059	136	201	24	5	65	0.0769231
NODE_301371_length_201_cov_50.647059	136	201	26	3	65	0.0461538
NODE_301371_length_201_cov_50.647059	136	201	28	13	65	0.2000000
NODE_301371_length_201_cov_50.647059	136	201	30	4	65	0.0615385
NODE_301371_length_201_cov_50.647059	136	201	34	6	65	0.0923077
NODE_301371_length_201_cov_50.647059	136	201	36	3	65	0.0461538
NODE_301371_length_201_cov_50.647059	136	201	38	1	65	0.0153846
NODE_301371_length_201_cov_50.647059	136	201	40	1	65	0.0153846
NODE_301371_length_201_cov_50.647059	136	201	42	13	65	0.2000000
NODE_301405_length_200_cov_29.118812	0	73	5	2	73	0.0273973
NODE_301405_length_200_cov_29.118812	0	73	7	3	73	0.0410959
NODE_301405_length_200_cov_29.118812	0	73	9	9	73	0.1232877
NODE_301405_length_200_cov_29.118812	0	73	13	9	73	0.1232877
NODE_301405_length_200_cov_29.118812	0	73	16	1	73	0.0136986
NODE_301405_length_200_cov_29.118812	0	73	18	2	73	0.0273973
NODE_301405_length_200_cov_29.118812	0	73	23	7	73	0.0958904
NODE_301405_length_200_cov_29.118812	0	73	25	1	73	0.0136986
NODE_301405_length_200_cov_29.118812	0	73	26	3	73	0.0410959
NODE_301405_length_200_cov_29.118812	0	73	28	10	73	0.1369863
NODE_301405_length_200_cov_29.118812	0	73	30	9	73	0.1232877
NODE_301405_length_200_cov_29.118812	0	73	32	1	73	0.0136986
NODE_301405_length_200_cov_29.118812	0	73	34	6	73	0.0821918
NODE_301405_length_200_cov_29.118812	0	73	36	8	73	0.1095890
NODE_301405_length_200_cov_29.118812	0	73	38	2	73	0.0273973
NODE_301419_length_199_cov_768.700000	94	142	297	1	48	0.0208333
NODE_301419_length_199_cov_768.700000	94	142	298	3	48	0.0625000
NODE_301419_length_199_cov_768.700000	94	142	303	4	48	0.0833333
NODE_301419_length_199_cov_768.700000	94	142	306	5	48	0.1041667
NODE_301419_length_199_cov_768.700000	94	142	308	1	48	0.0208333
NODE_301419_length_199_cov_768.700000	94	142	310	1	48	0.0208333
NODE_301419_length_199_cov_768.700000	94	142	312	3	48	0.0625000
NODE_301419_length_199_cov_768.700000	94	142	314	1	48	0.0208333
NODE_301419_length_199_cov_768.700000	94	142	318	2	48	0.0416667
NODE_301419_length_199_cov_768.700000	94	142	320	1	48	0.0208333
NODE_301419_length_199_cov_768.700000	94	142	322	2	48	0.0416667
NODE_301419_length_199_cov_768.700000	94	142	324	5	48	0.1041667
NODE_301419_length_199_cov_768.700000	94	142	328	6	48	0.1250000
NODE_301419_length_199_cov_768.700000	94	142	330	2	48	0.0416667
NODE_301419_length_199_cov_768.700000	94	142	332	1	48	0.0208333
NODE_301419_length_199_cov_768.700000	94	142	334	10	48	0.2083333
NODE_301419_length_199_cov_768.700000	115	186	83	1	71	0.0140845
NODE_301419_length_199_cov_768.700000	115	186	90	1	71	0.0140845
NODE_301419_length_199_cov_768.700000	115	186	97	1	71	0.0140845
NODE_301419_length_199_cov_768.700000	115	186	103	1	71	0.0140845
NODE_301419_length_199_cov_768.700000	115	186	105	1	71	0.0140845
NODE_301419_length_199_cov_768.700000	115	186	115	1	71	0.0140845
NODE_301419_length_199_cov_768.700000	115	186	117	2	71	0.0281690
NODE_301419_length_199_cov_768.700000	115	186	127	1	71	0.0140845
NODE_301419_length_199_cov_768.700000	115	186	136	2	71	0.0281690
NODE_301419_length_199_cov_768.700000	115	186	141	1	71	0.0140845
NODE_301419_length_199_cov_768.700000	115	186	148	1	71	0.0140845
NODE_301419_length_199_cov_768.700000	115	186	152	1	71	0.0140845
NODE_301419_length_199_cov_768.700000	115	186	156	1	71	0.0140845
NODE_301419_length_199_cov_768.700000	115	186	160	1	71	0.0140845
NODE_301419_length_199_cov_768.700000	115	186	163	1	71	0.0140845
NODE_301419_length_199_cov_768.700000	115	186	168	1	71	0.0140845
NODE_301419_length_199_cov_768.700000	115	186	174	1	71	0.0140845
NODE_301419_length_199_cov_768.700000	115	186	178	1	71	0.0140845
NODE_301419_length_199_cov_768.700000	115	186	180	1	71	0.0140845
NODE_301419_length_199_cov_768.700000	115	186	186	1	71	0.0140845
NODE_301419_length_199_cov_768.700000	115	186	188	1	71	0.0140845
NODE_301419_length_199_cov_768.700000	115	186	196	1	71	0.0140845
NODE_301419_length_199_cov_768.700000	115	186	200	1	71	0.0140845
NODE_301419_length_199_cov_768.700000	115	186	207	1	71	0.0140845
NODE_301419_length_199_cov_768.700000	115	186	208	1	71	0.0140845
NODE_301419_length_199_cov_768.700000	115	186	219	1	71	0.0140845
NODE_301419_length_199_cov_768.700000	115	186	233	1	71	0.0140845
NODE_301419_length_199_cov_768.700000	115	186	240	1	71	0.0140845
NODE_301419_length_199_cov_768.700000	115	186	242	1	71	0.0140845
NODE_301419_length_199_cov_768.700000	115	186	247	2	71	0.0281690
NODE_301419_length_199_cov_768.700000	115	186	249	1	71	0.0140845
NODE_301419_length_199_cov_768.700000	115	186	254	1	71	0.0140845
NODE_301419_length_199_cov_768.700000	115	186	261	1	71	0.0140845
NODE_301419_length_199_cov_768.700000	115	186	272	1	71	0.0140845
NODE_301419_length_199_cov_768.700000	115	186	276	1	71	0.0140845
NODE_301419_length_199_cov_768.700000	115	186	282	1	71	0.0140845
NODE_301419_length_199_cov_768.700000	115	186	284	1	71	0.0140845
NODE_301419_length_199_cov_768.700000	115	186	286	1	71	0.0140845
NODE_301419_length_199_cov_768.700000	115	186	292	1	71	0.0140845
NODE_301419_length_199_cov_768.700000	115	186	296	1	71	0.0140845
NODE_301419_length_199_cov_768.700000	115	186	297	2	71	0.0281690
NODE_301419_length_199_cov_768.700000	115	186	298	3	71	0.0422535
NODE_301419_length_199_cov_768.700000	115	186	303	4	71	0.0563380
NODE_301419_length_199_cov_768.700000	115	186	306	5	71	0.0704225
NODE_301419_length_199_cov_768.700000	115	186	308	1	71	0.0140845
NODE_301419_length_199_cov_768.700000	115	186	310	1	71	0.0140845
NODE_301419_length_199_cov_768.700000	115	186	312	3	71	0.0422535
NODE_301419_length_199_cov_768.700000	115	186	314	1	71	0.0140845
NODE_301419_length_199_cov_768.700000	115	186	318	2	71	0.0281690
NODE_301419_length_199_cov_768.700000	115	186	320	1	71	0.0140845
NODE_301419_length_199_cov_768.700000	115	186	322	2	71	0.0281690
NODE_301419_length_199_cov_768.700000	115	186	324	3	71	0.0422535
NODE_301420_length_199_cov_702.860000	3	78	56	1	75	0.0133333
NODE_301420_length_199_cov_702.860000	3	78	68	1	75	0.0133333
NODE_301420_length_199_cov_702.860000	3	78	70	1	75	0.0133333
NODE_301420_length_199_cov_702.860000	3	78	81	1	75	0.0133333
NODE_301420_length_199_cov_702.860000	3	78	85	4	75	0.0533333
NODE_301420_length_199_cov_702.860000	3	78	88	1	75	0.0133333
NODE_301420_length_199_cov_702.860000	3	78	89	1	75	0.0133333
NODE_301420_length_199_cov_702.860000	3	78	91	1	75	0.0133333
NODE_301420_length_199_cov_702.860000	3	78	101	1	75	0.0133333
NODE_301420_length_199_cov_702.860000	3	78	109	2	75	0.0266667
NODE_301420_length_199_cov_702.860000	3	78	137	2	75	0.0266667
NODE_301420_length_199_cov_702.860000	3	78	141	1	75	0.0133333
NODE_301420_length_199_cov_702.860000	3	78	144	1	75	0.0133333
NODE_301420_length_199_cov_702.860000	3	78	154	1	75	0.0133333
NODE_301420_length_199_cov_702.860000	3	78	164	1	75	0.0133333
NODE_301420_length_199_cov_702.860000	3	78	170	2	75	0.0266667
NODE_301420_length_199_cov_702.860000	3	78	185	1	75	0.0133333
NODE_301420_length_199_cov_702.860000	3	78	201	1	75	0.0133333
NODE_301420_length_199_cov_702.860000	3	78	231	1	75	0.0133333
NODE_301420_length_199_cov_702.860000	3	78	267	1	75	0.0133333
NODE_301420_length_199_cov_702.860000	3	78	273	1	75	0.0133333
NODE_301420_length_199_cov_702.860000	3	78	280	1	75	0.0133333
NODE_301420_length_199_cov_702.860000	3	78	298	1	75	0.0133333
NODE_301420_length_199_cov_702.860000	3	78	304	1	75	0.0133333
NODE_301420_length_199_cov_702.860000	3	78	309	1	75	0.0133333
NODE_301420_length_199_cov_702.860000	3	78	315	1	75	0.0133333
NODE_301420_length_199_cov_702.860000	3	78	319	1	75	0.0133333
NODE_301420_length_199_cov_702.860000	3	78	335	1	75	0.0133333
NODE_301420_length_199_cov_702.860000	3	78	339	1	75	0.0133333
NODE_301420_length_199_cov_702.860000	3	78	349	1	75	0.0133333
NODE_301420_length_199_cov_702.860000	3	78	352	1	75	0.0133333
NODE_301420_length_199_cov_702.860000	3	78	360	1	75	0.0133333
NODE_301420_length_199_cov_702.860000	3	78	375	1	75	0.0133333
NODE_301420_length_199_cov_702.860000	3	78	379	1	75	0.0133333
NODE_301420_length_199_cov_702.860000	3	78	389	2	75	0.0266667
NODE_301420_length_199_cov_702.860000	3	78	407	1	75	0.0133333
NODE_301420_length_199_cov_702.860000	3	78	417	1	75	0.0133333
NODE_301420_length_199_cov_702.860000	3	78	434	1	75	0.0133333
NODE_301420_length_199_cov_702.860000	3	78	435	1	75	0.0133333
NODE_301420_length_199_cov_702.860000	3	78	443	1	75	0.0133333
NODE_301420_length_199_cov_702.860000	3	78	445	1	75	0.0133333
NODE_301420_length_199_cov_702.860000	3	78	449	1	75	0.0133333
NODE_301420_length_199_cov_702.860000	3	78	455	2	75	0.0266667
NODE_301420_length_199_cov_702.860000	3	78	459	1	75	0.0133333
NODE_301420_length_199_cov_702.860000	3	78	463	1	75	0.0133333
NODE_301420_length_199_cov_702.860000	3	78	473	1	75	0.0133333
NODE_301420_length_199_cov_702.860000	3	78	481	1	75	0.0133333
NODE_301420_length_199_cov_702.860000	3	78	487	2	75	0.0266667
NODE_301420_length_199_cov_702.860000	3	78	489	2	75	0.0266667
NODE_301420_length_199_cov_702.860000	3	78	497	3	75	0.0400000
NODE_301420_length_199_cov_702.860000	3	78	503	1	75	0.0133333
NODE_301420_length_199_cov_702.860000	3	78	507	1	75	0.0133333
NODE_301420_length_199_cov_702.860000	3	78	509	1	75	0.0133333
NODE_301420_length_199_cov_702.860000	3	78	511	1	75	0.0133333
NODE_301420_length_199_cov_702.860000	3	78	521	2	75	0.0266667
NODE_301420_length_199_cov_702.860000	3	78	523	2	75	0.0266667
NODE_301420_length_199_cov_702.860000	3	78	527	3	75	0.0400000
NODE_301420_length_199_cov_702.860000	3	78	533	1	75	0.0133333
NODE_301420_length_199_cov_702.860000	3	78	541	1	75	0.0133333
NODE_301420_length_199_cov_702.860000	51	131	330	1	80	0.0125000
NODE_301420_length_199_cov_702.860000	51	131	344	1	80	0.0125000
NODE_301420_length_199_cov_702.860000	51	131	352	1	80	0.0125000
NODE_301420_length_199_cov_702.860000	51	131	362	1	80	0.0125000
NODE_301420_length_199_cov_702.860000	51	131	374	1	80	0.0125000
NODE_301420_length_199_cov_702.860000	51	131	379	1	80	0.0125000
NODE_301420_length_199_cov_702.860000	51	131	382	1	80	0.0125000
NODE_301420_length_199_cov_702.860000	51	131	393	1	80	0.0125000
NODE_301420_length_199_cov_702.860000	51	131	401	1	80	0.0125000
NODE_301420_length_199_cov_702.860000	51	131	424	1	80	0.0125000
NODE_301420_length_199_cov_702.860000	51	131	434	1	80	0.0125000
NODE_301420_length_199_cov_702.860000	51	131	449	1	80	0.0125000
NODE_301420_length_199_cov_702.860000	51	131	453	1	80	0.0125000
NODE_301420_length_199_cov_702.860000	51	131	455	2	80	0.0250000
NODE_301420_length_199_cov_702.860000	51	131	459	1	80	0.0125000
NODE_301420_length_199_cov_702.860000	51	131	463	1	80	0.0125000
NODE_301420_length_199_cov_702.860000	51	131	466	1	80	0.0125000
NODE_301420_length_199_cov_702.860000	51	131	473	1	80	0.0125000
NODE_301420_length_199_cov_702.860000	51	131	481	1	80	0.0125000
NODE_301420_length_199_cov_702.860000	51	131	485	1	80	0.0125000
NODE_301420_length_199_cov_702.860000	51	131	487	2	80	0.0250000
NODE_301420_length_199_cov_702.860000	51	131	489	2	80	0.0250000
NODE_301420_length_199_cov_702.860000	51	131	496	1	80	0.0125000
NODE_301420_length_199_cov_702.860000	51	131	497	3	80	0.0375000
NODE_301420_length_199_cov_702.860000	51	131	503	1	80	0.0125000
NODE_301420_length_199_cov_702.860000	51	131	507	1	80	0.0125000
NODE_301420_length_199_cov_702.860000	51	131	509	1	80	0.0125000
NODE_301420_length_199_cov_702.860000	51	131	511	1	80	0.0125000
NODE_301420_length_199_cov_702.860000	51	131	513	1	80	0.0125000
NODE_301420_length_199_cov_702.860000	51	131	521	2	80	0.0250000
NODE_301420_length_199_cov_702.860000	51	131	523	2	80	0.0250000
NODE_301420_length_199_cov_702.860000	51	131	527	3	80	0.0375000
NODE_301420_length_199_cov_702.860000	51	131	529	1	80	0.0125000
NODE_301420_length_199_cov_702.860000	51	131	533	1	80	0.0125000
NODE_301420_length_199_cov_702.860000	51	131	535	1	80	0.0125000
NODE_301420_length_199_cov_702.860000	51	131	541	1	80	0.0125000
NODE_301420_length_199_cov_702.860000	51	131	543	2	80	0.0250000
NODE_301420_length_199_cov_702.860000	51	131	547	3	80	0.0375000
NODE_301420_length_199_cov_702.860000	51	131	559	1	80	0.0125000
NODE_301420_length_199_cov_702.860000	51	131	566	2	80	0.0250000
NODE_301420_length_199_cov_702.860000	51	131	568	2	80	0.0250000
NODE_301420_length_199_cov_702.860000	51	131	570	2	80	0.0250000
NODE_301420_length_199_cov_702.860000	51	131	574	1	80	0.0125000
NODE_301420_length_199_cov_702.860000	51	131	576	1	80	0.0125000
NODE_301420_length_199_cov_702.860000	51	131	578	1	80	0.0125000
NODE_301420_length_199_cov_702.860000	51	131	580	1	80	0.0125000
NODE_301420_length_199_cov_702.860000	51	131	582	3	80	0.0375000
NODE_301420_length_199_cov_702.860000	51	131	586	5	80	0.0625000
NODE_301420_length_199_cov_702.860000	51	131	588	2	80	0.0250000
NODE_301420_length_199_cov_702.860000	51	131	590	1	80	0.0125000
NODE_301420_length_199_cov_702.860000	51	131	594	8	80	0.1000000
NODE_301421_length_199_cov_670.570000	22	52	88	1	30	0.0333333
NODE_301421_length_199_cov_670.570000	22	52	92	1	30	0.0333333
NODE_301421_length_199_cov_670.570000	22	52	94	1	30	0.0333333
NODE_301421_length_199_cov_670.570000	22	52	98	1	30	0.0333333
NODE_301421_length_199_cov_670.570000	22	52	104	2	30	0.0666667
NODE_301421_length_199_cov_670.570000	22	52	106	1	30	0.0333333
NODE_301421_length_199_cov_670.570000	22	52	108	1	30	0.0333333
NODE_301421_length_199_cov_670.570000	22	52	110	1	30	0.0333333
NODE_301421_length_199_cov_670.570000	22	52	112	1	30	0.0333333
NODE_301421_length_199_cov_670.570000	22	52	114	3	30	0.1000000
NODE_301421_length_199_cov_670.570000	22	52	115	1	30	0.0333333
NODE_301421_length_199_cov_670.570000	22	52	117	2	30	0.0666667
NODE_301421_length_199_cov_670.570000	22	52	121	1	30	0.0333333
NODE_301421_length_199_cov_670.570000	22	52	123	2	30	0.0666667
NODE_301421_length_199_cov_670.570000	22	52	127	1	30	0.0333333
NODE_301421_length_199_cov_670.570000	22	52	129	5	30	0.1666667
NODE_301421_length_199_cov_670.570000	22	52	131	1	30	0.0333333
NODE_301421_length_199_cov_670.570000	22	52	135	1	30	0.0333333
NODE_301421_length_199_cov_670.570000	22	52	137	1	30	0.0333333
NODE_301421_length_199_cov_670.570000	22	52	139	1	30	0.0333333
NODE_301421_length_199_cov_670.570000	22	52	140	1	30	0.0333333
NODE_301421_length_199_cov_670.570000	25	105	98	1	80	0.0125000
NODE_301421_length_199_cov_670.570000	25	105	104	2	80	0.0250000
NODE_301421_length_199_cov_670.570000	25	105	106	1	80	0.0125000
NODE_301421_length_199_cov_670.570000	25	105	108	1	80	0.0125000
NODE_301421_length_199_cov_670.570000	25	105	110	1	80	0.0125000
NODE_301421_length_199_cov_670.570000	25	105	112	1	80	0.0125000
NODE_301421_length_199_cov_670.570000	25	105	114	3	80	0.0375000
NODE_301421_length_199_cov_670.570000	25	105	115	1	80	0.0125000
NODE_301421_length_199_cov_670.570000	25	105	117	2	80	0.0250000
NODE_301421_length_199_cov_670.570000	25	105	121	1	80	0.0125000
NODE_301421_length_199_cov_670.570000	25	105	123	2	80	0.0250000
NODE_301421_length_199_cov_670.570000	25	105	127	1	80	0.0125000
NODE_301421_length_199_cov_670.570000	25	105	129	5	80	0.0625000
NODE_301421_length_199_cov_670.570000	25	105	131	1	80	0.0125000
NODE_301421_length_199_cov_670.570000	25	105	135	1	80	0.0125000
NODE_301421_length_199_cov_670.570000	25	105	137	1	80	0.0125000
NODE_301421_length_199_cov_670.570000	25	105	139	1	80	0.0125000
NODE_301421_length_199_cov_670.570000	25	105	140	1	80	0.0125000
NODE_301421_length_199_cov_670.570000	25	105	142	1	80	0.0125000
NODE_301421_length_199_cov_670.570000	25	105	144	1	80	0.0125000
NODE_301421_length_199_cov_670.570000	25	105	147	1	80	0.0125000
NODE_301421_length_199_cov_670.570000	25	105	153	1	80	0.0125000
NODE_301421_length_199_cov_670.570000	25	105	155	1	80	0.0125000
NODE_301421_length_199_cov_670.570000	25	105	156	1	80	0.0125000
NODE_301421_length_199_cov_670.570000	25	105	158	2	80	0.0250000
NODE_301421_length_199_cov_670.570000	25	105	166	1	80	0.0125000
NODE_301421_length_199_cov_670.570000	25	105	168	1	80	0.0125000
NODE_301421_length_199_cov_670.570000	25	105	172	1	80	0.0125000
NODE_301421_length_199_cov_670.570000	25	105	173	1	80	0.0125000
NODE_301421_length_199_cov_670.570000	25	105	175	1	80	0.0125000
NODE_301421_length_199_cov_670.570000	25	105	177	1	80	0.0125000
NODE_301421_length_199_cov_670.570000	25	105	180	4	80	0.0500000
NODE_301421_length_199_cov_670.570000	25	105	182	1	80	0.0125000
NODE_301421_length_199_cov_670.570000	25	105	186	2	80	0.0250000
NODE_301421_length_199_cov_670.570000	25	105	188	2	80	0.0250000
NODE_301421_length_199_cov_670.570000	25	105	190	1	80	0.0125000
NODE_301421_length_199_cov_670.570000	25	105	192	3	80	0.0375000
NODE_301421_length_199_cov_670.570000	25	105	194	1	80	0.0125000
NODE_301421_length_199_cov_670.570000	25	105	196	1	80	0.0125000
NODE_301421_length_199_cov_670.570000	25	105	200	1	80	0.0125000
NODE_301421_length_199_cov_670.570000	25	105	202	3	80	0.0375000
NODE_301421_length_199_cov_670.570000	25	105	204	1	80	0.0125000
NODE_301421_length_199_cov_670.570000	25	105	216	1	80	0.0125000
NODE_301421_length_199_cov_670.570000	25	105	218	1	80	0.0125000
NODE_301421_length_199_cov_670.570000	25	105	220	3	80	0.0375000
NODE_301421_length_199_cov_670.570000	25	105	222	2	80	0.0250000
NODE_301421_length_199_cov_670.570000	25	105	224	4	80	0.0500000
NODE_301421_length_199_cov_670.570000	25	105	226	8	80	0.1000000
NODE_301430_length_199_cov_215.860000	3	75	2	9	72	0.1250000
NODE_301430_length_199_cov_215.860000	3	75	4	2	72	0.0277778
NODE_301430_length_199_cov_215.860000	3	75	6	1	72	0.0138889
NODE_301430_length_199_cov_215.860000	3	75	8	2	72	0.0277778
NODE_301430_length_199_cov_215.860000	3	75	10	5	72	0.0694444
NODE_301430_length_199_cov_215.860000	3	75	11	1	72	0.0138889
NODE_301430_length_199_cov_215.860000	3	75	12	1	72	0.0138889
NODE_301430_length_199_cov_215.860000	3	75	14	5	72	0.0694444
NODE_301430_length_199_cov_215.860000	3	75	18	3	72	0.0416667
NODE_301430_length_199_cov_215.860000	3	75	22	3	72	0.0416667
NODE_301430_length_199_cov_215.860000	3	75	24	2	72	0.0277778
NODE_301430_length_199_cov_215.860000	3	75	28	2	72	0.0277778
NODE_301430_length_199_cov_215.860000	3	75	34	3	72	0.0416667
NODE_301430_length_199_cov_215.860000	3	75	36	3	72	0.0416667
NODE_301430_length_199_cov_215.860000	3	75	42	5	72	0.0694444
NODE_301430_length_199_cov_215.860000	3	75	44	2	72	0.0277778
NODE_301430_length_199_cov_215.860000	3	75	46	5	72	0.0694444
NODE_301430_length_199_cov_215.860000	3	75	48	4	72	0.0555556
NODE_301430_length_199_cov_215.860000	3	75	50	10	72	0.1388889
NODE_301430_length_199_cov_215.860000	3	75	52	2	72	0.0277778
NODE_301430_length_199_cov_215.860000	3	75	54	2	72	0.0277778
NODE_301430_length_199_cov_215.860000	48	128	30	1	80	0.0125000
NODE_301430_length_199_cov_215.860000	48	128	32	6	80	0.0750000
NODE_301430_length_199_cov_215.860000	48	128	40	1	80	0.0125000
NODE_301430_length_199_cov_215.860000	48	128	42	2	80	0.0250000
NODE_301430_length_199_cov_215.860000	48	128	44	6	80	0.0750000
NODE_301430_length_199_cov_215.860000	48	128	46	5	80	0.0625000
NODE_301430_length_199_cov_215.860000	48	128	48	5	80	0.0625000
NODE_301430_length_199_cov_215.860000	48	128	50	15	80	0.1875000
NODE_301430_length_199_cov_215.860000	48	128	52	9	80	0.1125000
NODE_301430_length_199_cov_215.860000	48	128	54	30	80	0.3750000
NODE_301432_length_199_cov_206.800000	120	199	0	79	79	1.0000000
NODE_301441_length_199_cov_131.120000	97	177	0	80	80	1.0000000
NODE_301448_length_199_cov_97.490000	4	77	6	3	73	0.0410959
NODE_301448_length_199_cov_97.490000	4	77	8	2	73	0.0273973
NODE_301448_length_199_cov_97.490000	4	77	10	4	73	0.0547945
NODE_301448_length_199_cov_97.490000	4	77	11	3	73	0.0410959
NODE_301448_length_199_cov_97.490000	4	77	13	1	73	0.0136986
NODE_301448_length_199_cov_97.490000	4	77	15	1	73	0.0136986
NODE_301448_length_199_cov_97.490000	4	77	19	2	73	0.0273973
NODE_301448_length_199_cov_97.490000	4	77	21	1	73	0.0136986
NODE_301448_length_199_cov_97.490000	4	77	23	2	73	0.0273973
NODE_301448_length_199_cov_97.490000	4	77	24	1	73	0.0136986
NODE_301448_length_199_cov_97.490000	4	77	26	2	73	0.0273973
NODE_301448_length_199_cov_97.490000	4	77	28	2	73	0.0273973
NODE_301448_length_199_cov_97.490000	4	77	31	1	73	0.0136986
NODE_301448_length_199_cov_97.490000	4	77	37	1	73	0.0136986
NODE_301448_length_199_cov_97.490000	4	77	39	1	73	0.0136986
NODE_301448_length_199_cov_97.490000	4	77	41	1	73	0.0136986
NODE_301448_length_199_cov_97.490000	4	77	43	1	73	0.0136986
NODE_301448_length_199_cov_97.490000	4	77	47	2	73	0.0273973
NODE_301448_length_199_cov_97.490000	4	77	51	1	73	0.0136986
NODE_301448_length_199_cov_97.490000	4	77	55	1	73	0.0136986
NODE_301448_length_199_cov_97.490000	4	77	57	1	73	0.0136986
NODE_301448_length_199_cov_97.490000	4	77	61	1	73	0.0136986
NODE_301448_length_199_cov_97.490000	4	77	63	1	73	0.0136986
NODE_301448_length_199_cov_97.490000	4	77	66	1	73	0.0136986
NODE_301448_length_199_cov_97.490000	4	77	70	1	73	0.0136986
NODE_301448_length_199_cov_97.490000	4	77	73	6	73	0.0821918
NODE_301448_length_199_cov_97.490000	4	77	75	1	73	0.0136986
NODE_301448_length_199_cov_97.490000	4	77	77	8	73	0.1095890
NODE_301448_length_199_cov_97.490000	4	77	79	2	73	0.0273973
NODE_301448_length_199_cov_97.490000	4	77	83	2	73	0.0273973
NODE_301448_length_199_cov_97.490000	4	77	87	1	73	0.0136986
NODE_301448_length_199_cov_97.490000	4	77	88	1	73	0.0136986
NODE_301448_length_199_cov_97.490000	4	77	90	4	73	0.0547945
NODE_301448_length_199_cov_97.490000	4	77	92	3	73	0.0410959
NODE_301448_length_199_cov_97.490000	4	77	94	5	73	0.0684932
NODE_301448_length_199_cov_97.490000	4	77	96	2	73	0.0273973
NODE_301449_length_199_cov_96.090000	91	171	4	5	80	0.0625000
NODE_301449_length_199_cov_96.090000	91	171	6	11	80	0.1375000
NODE_301449_length_199_cov_96.090000	91	171	10	12	80	0.1500000
NODE_301449_length_199_cov_96.090000	91	171	12	6	80	0.0750000
NODE_301449_length_199_cov_96.090000	91	171	14	5	80	0.0625000
NODE_301449_length_199_cov_96.090000	91	171	16	4	80	0.0500000
NODE_301449_length_199_cov_96.090000	91	171	18	37	80	0.4625000
NODE_301455_length_199_cov_84.060000	44	75	6	4	31	0.1290323
NODE_301455_length_199_cov_84.060000	44	75	10	19	31	0.6129032
NODE_301455_length_199_cov_84.060000	44	75	12	8	31	0.2580645
NODE_301456_length_199_cov_83.220000	0	64	0	64	64	1.0000000
NODE_301459_length_199_cov_80.390000	15	98	2	2	83	0.0240964
NODE_301459_length_199_cov_80.390000	15	98	6	2	83	0.0240964
NODE_301459_length_199_cov_80.390000	15	98	8	2	83	0.0240964
NODE_301459_length_199_cov_80.390000	15	98	10	20	83	0.2409639
NODE_301459_length_199_cov_80.390000	15	98	12	12	83	0.1445783
NODE_301459_length_199_cov_80.390000	15	98	14	11	83	0.1325301
NODE_301459_length_199_cov_80.390000	15	98	16	30	83	0.3614458
NODE_301459_length_199_cov_80.390000	15	98	18	4	83	0.0481928
NODE_301469_length_199_cov_63.420000	128	194	9	1	66	0.0151515
NODE_301469_length_199_cov_63.420000	128	194	10	1	66	0.0151515
NODE_301469_length_199_cov_63.420000	128	194	11	1	66	0.0151515
NODE_301469_length_199_cov_63.420000	128	194	18	3	66	0.0454545
NODE_301469_length_199_cov_63.420000	128	194	20	1	66	0.0151515
NODE_301469_length_199_cov_63.420000	128	194	22	1	66	0.0151515
NODE_301469_length_199_cov_63.420000	128	194	24	1	66	0.0151515
NODE_301469_length_199_cov_63.420000	128	194	26	2	66	0.0303030
NODE_301469_length_199_cov_63.420000	128	194	29	1	66	0.0151515
NODE_301469_length_199_cov_63.420000	128	194	32	2	66	0.0303030
NODE_301469_length_199_cov_63.420000	128	194	34	1	66	0.0151515
NODE_301469_length_199_cov_63.420000	128	194	36	1	66	0.0151515
NODE_301469_length_199_cov_63.420000	128	194	40	1	66	0.0151515
NODE_301469_length_199_cov_63.420000	128	194	42	1	66	0.0151515
NODE_301469_length_199_cov_63.420000	128	194	44	6	66	0.0909091
NODE_301469_length_199_cov_63.420000	128	194	46	3	66	0.0454545
NODE_301469_length_199_cov_63.420000	128	194	48	1	66	0.0151515
NODE_301469_length_199_cov_63.420000	128	194	57	1	66	0.0151515
NODE_301469_length_199_cov_63.420000	128	194	58	1	66	0.0151515
NODE_301469_length_199_cov_63.420000	128	194	67	1	66	0.0151515
NODE_301469_length_199_cov_63.420000	128	194	70	1	66	0.0151515
NODE_301469_length_199_cov_63.420000	128	194	78	2	66	0.0303030
NODE_301469_length_199_cov_63.420000	128	194	82	2	66	0.0303030
NODE_301469_length_199_cov_63.420000	128	194	85	2	66	0.0303030
NODE_301469_length_199_cov_63.420000	128	194	86	1	66	0.0151515
NODE_301469_length_199_cov_63.420000	128	194	88	3	66	0.0454545
NODE_301469_length_199_cov_63.420000	128	194	89	2	66	0.0303030
NODE_301469_length_199_cov_63.420000	128	194	90	1	66	0.0151515
NODE_301469_length_199_cov_63.420000	128	194	97	1	66	0.0151515
NODE_301469_length_199_cov_63.420000	128	194	103	1	66	0.0151515
NODE_301469_length_199_cov_63.420000	128	194	108	1	66	0.0151515
NODE_301469_length_199_cov_63.420000	128	194	110	1	66	0.0151515
NODE_301469_length_199_cov_63.420000	128	194	111	1	66	0.0151515
NODE_301469_length_199_cov_63.420000	128	194	115	1	66	0.0151515
NODE_301469_length_199_cov_63.420000	128	194	117	2	66	0.0303030
NODE_301469_length_199_cov_63.420000	128	194	119	3	66	0.0454545
NODE_301469_length_199_cov_63.420000	128	194	120	3	66	0.0454545
NODE_301469_length_199_cov_63.420000	128	194	124	3	66	0.0454545
NODE_301469_length_199_cov_63.420000	128	194	125	2	66	0.0303030
NODE_301469_length_199_cov_63.420000	128	194	127	1	66	0.0151515
NODE_301469_length_199_cov_63.420000	128	194	135	1	66	0.0151515
NODE_301477_length_199_cov_58.660000	18	85	0	67	67	1.0000000
NODE_301484_length_199_cov_50.350000	102	183	0	81	81	1.0000000
NODE_301485_length_199_cov_49.630000	5	47	0	17	42	0.4047619
NODE_301485_length_199_cov_49.630000	5	47	2	2	42	0.0476190
NODE_301485_length_199_cov_49.630000	5	47	3	17	42	0.4047619
NODE_301485_length_199_cov_49.630000	5	47	5	1	42	0.0238095
NODE_301485_length_199_cov_49.630000	5	47	7	5	42	0.1190476
NODE_301485_length_199_cov_49.630000	100	163	2	10	63	0.1587302
NODE_301485_length_199_cov_49.630000	100	163	4	2	63	0.0317460
NODE_301485_length_199_cov_49.630000	100	163	6	4	63	0.0634921
NODE_301485_length_199_cov_49.630000	100	163	8	19	63	0.3015873
NODE_301485_length_199_cov_49.630000	100	163	10	28	63	0.4444444
NODE_301485_length_199_cov_49.630000	100	163	2	10	63	0.1587302
NODE_301485_length_199_cov_49.630000	100	163	4	2	63	0.0317460
NODE_301485_length_199_cov_49.630000	100	163	6	4	63	0.0634921
NODE_301485_length_199_cov_49.630000	100	163	8	19	63	0.3015873
NODE_301485_length_199_cov_49.630000	100	163	10	28	63	0.4444444
NODE_301485_length_199_cov_49.630000	100	163	2	10	63	0.1587302
NODE_301485_length_199_cov_49.630000	100	163	4	2	63	0.0317460
NODE_301485_length_199_cov_49.630000	100	163	6	4	63	0.0634921
NODE_301485_length_199_cov_49.630000	100	163	8	19	63	0.3015873
NODE_301485_length_199_cov_49.630000	100	163	10	28	63	0.4444444
NODE_301485_length_199_cov_49.630000	136	185	1	9	49	0.1836735
NODE_301485_length_199_cov_49.630000	136	185	2	23	49	0.4693878
NODE_301485_length_199_cov_49.630000	136	185	4	2	49	0.0408163
NODE_301485_length_199_cov_49.630000	136	185	6	4	49	0.0816327
NODE_301485_length_199_cov_49.630000	136	185	8	11	49	0.2244898
NODE_301485_length_199_cov_49.630000	153	199	1	23	46	0.5000000
NODE_301485_length_199_cov_49.630000	153	199	2	23	46	0.5000000
NODE_301491_length_199_cov_40.000000	0	66	0	35	66	0.5303030
NODE_301491_length_199_cov_40.000000	0	66	2	1	66	0.0151515
NODE_301491_length_199_cov_40.000000	0	66	4	7	66	0.1060606
NODE_301491_length_199_cov_40.000000	0	66	10	4	66	0.0606061
NODE_301491_length_199_cov_40.000000	0	66	12	2	66	0.0303030
NODE_301491_length_199_cov_40.000000	0	66	14	15	66	0.2272727
NODE_301491_length_199_cov_40.000000	0	66	18	2	66	0.0303030
NODE_301491_length_199_cov_40.000000	34	114	0	1	80	0.0125000
NODE_301491_length_199_cov_40.000000	34	114	2	1	80	0.0125000
NODE_301491_length_199_cov_40.000000	34	114	4	7	80	0.0875000
NODE_301491_length_199_cov_40.000000	34	114	10	4	80	0.0500000
NODE_301491_length_199_cov_40.000000	34	114	12	2	80	0.0250000
NODE_301491_length_199_cov_40.000000	34	114	14	15	80	0.1875000
NODE_301491_length_199_cov_40.000000	34	114	16	5	80	0.0625000
NODE_301491_length_199_cov_40.000000	34	114	18	45	80	0.5625000
NODE_301491_length_199_cov_40.000000	39	61	4	4	22	0.1818182
NODE_301491_length_199_cov_40.000000	39	61	10	4	22	0.1818182
NODE_301491_length_199_cov_40.000000	39	61	12	2	22	0.0909091
NODE_301491_length_199_cov_40.000000	39	61	14	12	22	0.5454546
NODE_301498_length_199_cov_31.400000	3	77	0	7	74	0.0945946
NODE_301498_length_199_cov_31.400000	3	77	2	9	74	0.1216216
NODE_301498_length_199_cov_31.400000	3	77	4	31	74	0.4189189
NODE_301498_length_199_cov_31.400000	3	77	6	22	74	0.2972973
NODE_301498_length_199_cov_31.400000	3	77	8	5	74	0.0675676
NODE_301498_length_199_cov_31.400000	76	153	8	4	77	0.0519481
NODE_301498_length_199_cov_31.400000	76	153	10	26	77	0.3376623
NODE_301498_length_199_cov_31.400000	76	153	12	2	77	0.0259740
NODE_301498_length_199_cov_31.400000	76	153	14	3	77	0.0389610
NODE_301498_length_199_cov_31.400000	76	153	16	42	77	0.5454546
NODE_301498_length_199_cov_31.400000	76	153	8	4	77	0.0519481
NODE_301498_length_199_cov_31.400000	76	153	10	26	77	0.3376623
NODE_301498_length_199_cov_31.400000	76	153	12	2	77	0.0259740
NODE_301498_length_199_cov_31.400000	76	153	14	3	77	0.0389610
NODE_301498_length_199_cov_31.400000	76	153	16	42	77	0.5454546
NODE_301498_length_199_cov_31.400000	76	153	8	4	77	0.0519481
NODE_301498_length_199_cov_31.400000	76	153	10	26	77	0.3376623
NODE_301498_length_199_cov_31.400000	76	153	12	2	77	0.0259740
NODE_301498_length_199_cov_31.400000	76	153	14	3	77	0.0389610
NODE_301498_length_199_cov_31.400000	76	153	16	42	77	0.5454546
NODE_301498_length_199_cov_31.400000	126	192	2	22	66	0.3333333
NODE_301498_length_199_cov_31.400000	126	192	4	8	66	0.1212121
NODE_301498_length_199_cov_31.400000	126	192	6	5	66	0.0757576
NODE_301498_length_199_cov_31.400000	126	192	10	21	66	0.3181818
NODE_301498_length_199_cov_31.400000	126	192	12	2	66	0.0303030
NODE_301498_length_199_cov_31.400000	126	192	14	3	66	0.0454545
NODE_301498_length_199_cov_31.400000	126	192	16	5	66	0.0757576
NODE_301498_length_199_cov_31.400000	129	199	2	29	70	0.4142857
NODE_301498_length_199_cov_31.400000	129	199	4	8	70	0.1142857
NODE_301498_length_199_cov_31.400000	129	199	6	5	70	0.0714286
NODE_301498_length_199_cov_31.400000	129	199	10	21	70	0.3000000
NODE_301498_length_199_cov_31.400000	129	199	12	2	70	0.0285714
NODE_301498_length_199_cov_31.400000	129	199	14	3	70	0.0428571
NODE_301498_length_199_cov_31.400000	129	199	16	2	70	0.0285714
NODE_301498_length_199_cov_31.400000	131	199	2	29	68	0.4264706
NODE_301498_length_199_cov_31.400000	131	199	4	8	68	0.1176471
NODE_301498_length_199_cov_31.400000	131	199	6	5	68	0.0735294
NODE_301498_length_199_cov_31.400000	131	199	10	21	68	0.3088235
NODE_301498_length_199_cov_31.400000	131	199	12	2	68	0.0294118
NODE_301498_length_199_cov_31.400000	131	199	14	3	68	0.0441176
NODE_301500_length_199_cov_30.140000	118	198	2	80	80	1.0000000
NODE_301500_length_199_cov_30.140000	118	198	2	80	80	1.0000000
NODE_301500_length_199_cov_30.140000	118	198	2	80	80	1.0000000
NODE_301500_length_199_cov_30.140000	118	198	2	80	80	1.0000000
NODE_301500_length_199_cov_30.140000	118	198	2	80	80	1.0000000
NODE_301500_length_199_cov_30.140000	127	198	2	71	71	1.0000000
NODE_301581_length_197_cov_41.265306	0	70	0	70	70	1.0000000
NODE_301611_length_196_cov_101.855670	72	136	76	4	64	0.0625000
NODE_301611_length_196_cov_101.855670	72	136	80	4	64	0.0625000
NODE_301611_length_196_cov_101.855670	72	136	82	1	64	0.0156250
NODE_301611_length_196_cov_101.855670	72	136	86	3	64	0.0468750
NODE_301611_length_196_cov_101.855670	72	136	88	1	64	0.0156250
NODE_301611_length_196_cov_101.855670	72	136	92	3	64	0.0468750
NODE_301611_length_196_cov_101.855670	72	136	93	1	64	0.0156250
NODE_301611_length_196_cov_101.855670	72	136	94	3	64	0.0468750
NODE_301611_length_196_cov_101.855670	72	136	98	2	64	0.0312500
NODE_301611_length_196_cov_101.855670	72	136	103	1	64	0.0156250
NODE_301611_length_196_cov_101.855670	72	136	104	4	64	0.0625000
NODE_301611_length_196_cov_101.855670	72	136	106	6	64	0.0937500
NODE_301611_length_196_cov_101.855670	72	136	108	31	64	0.4843750
NODE_301611_length_196_cov_101.855670	72	136	76	4	64	0.0625000
NODE_301611_length_196_cov_101.855670	72	136	80	4	64	0.0625000
NODE_301611_length_196_cov_101.855670	72	136	82	1	64	0.0156250
NODE_301611_length_196_cov_101.855670	72	136	86	3	64	0.0468750
NODE_301611_length_196_cov_101.855670	72	136	88	1	64	0.0156250
NODE_301611_length_196_cov_101.855670	72	136	92	3	64	0.0468750
NODE_301611_length_196_cov_101.855670	72	136	93	1	64	0.0156250
NODE_301611_length_196_cov_101.855670	72	136	94	3	64	0.0468750
NODE_301611_length_196_cov_101.855670	72	136	98	2	64	0.0312500
NODE_301611_length_196_cov_101.855670	72	136	103	1	64	0.0156250
NODE_301611_length_196_cov_101.855670	72	136	104	4	64	0.0625000
NODE_301611_length_196_cov_101.855670	72	136	106	6	64	0.0937500
NODE_301611_length_196_cov_101.855670	72	136	108	31	64	0.4843750
NODE_301611_length_196_cov_101.855670	109	169	10	1	60	0.0166667
NODE_301611_length_196_cov_101.855670	109	169	12	1	60	0.0166667
NODE_301611_length_196_cov_101.855670	109	169	15	2	60	0.0333333
NODE_301611_length_196_cov_101.855670	109	169	16	6	60	0.1000000
NODE_301611_length_196_cov_101.855670	109	169	18	2	60	0.0333333
NODE_301611_length_196_cov_101.855670	109	169	26	2	60	0.0333333
NODE_301611_length_196_cov_101.855670	109	169	28	1	60	0.0166667
NODE_301611_length_196_cov_101.855670	109	169	31	1	60	0.0166667
NODE_301611_length_196_cov_101.855670	109	169	35	1	60	0.0166667
NODE_301611_length_196_cov_101.855670	109	169	39	1	60	0.0166667
NODE_301611_length_196_cov_101.855670	109	169	42	3	60	0.0500000
NODE_301611_length_196_cov_101.855670	109	169	45	1	60	0.0166667
NODE_301611_length_196_cov_101.855670	109	169	50	2	60	0.0333333
NODE_301611_length_196_cov_101.855670	109	169	63	2	60	0.0333333
NODE_301611_length_196_cov_101.855670	109	169	65	2	60	0.0333333
NODE_301611_length_196_cov_101.855670	109	169	66	1	60	0.0166667
NODE_301611_length_196_cov_101.855670	109	169	68	1	60	0.0166667
NODE_301611_length_196_cov_101.855670	109	169	70	2	60	0.0333333
NODE_301611_length_196_cov_101.855670	109	169	72	1	60	0.0166667
NODE_301611_length_196_cov_101.855670	109	169	76	4	60	0.0666667
NODE_301611_length_196_cov_101.855670	109	169	80	4	60	0.0666667
NODE_301611_length_196_cov_101.855670	109	169	82	1	60	0.0166667
NODE_301611_length_196_cov_101.855670	109	169	86	3	60	0.0500000
NODE_301611_length_196_cov_101.855670	109	169	88	1	60	0.0166667
NODE_301611_length_196_cov_101.855670	109	169	92	3	60	0.0500000
NODE_301611_length_196_cov_101.855670	109	169	93	1	60	0.0166667
NODE_301611_length_196_cov_101.855670	109	169	94	3	60	0.0500000
NODE_301611_length_196_cov_101.855670	109	169	98	2	60	0.0333333
NODE_301611_length_196_cov_101.855670	109	169	103	1	60	0.0166667
NODE_301611_length_196_cov_101.855670	109	169	104	2	60	0.0333333
NODE_301611_length_196_cov_101.855670	109	169	106	1	60	0.0166667
NODE_301611_length_196_cov_101.855670	109	169	108	1	60	0.0166667
NODE_301613_length_196_cov_100.618557	129	196	1	2	67	0.0298507
NODE_301613_length_196_cov_100.618557	129	196	3	3	67	0.0447761
NODE_301613_length_196_cov_100.618557	129	196	6	3	67	0.0447761
NODE_301613_length_196_cov_100.618557	129	196	8	4	67	0.0597015
NODE_301613_length_196_cov_100.618557	129	196	10	7	67	0.1044776
NODE_301613_length_196_cov_100.618557	129	196	12	1	67	0.0149254
NODE_301613_length_196_cov_100.618557	129	196	14	1	67	0.0149254
NODE_301613_length_196_cov_100.618557	129	196	16	1	67	0.0149254
NODE_301613_length_196_cov_100.618557	129	196	22	9	67	0.1343284
NODE_301613_length_196_cov_100.618557	129	196	24	2	67	0.0298507
NODE_301613_length_196_cov_100.618557	129	196	26	1	67	0.0149254
NODE_301613_length_196_cov_100.618557	129	196	30	1	67	0.0149254
NODE_301613_length_196_cov_100.618557	129	196	34	2	67	0.0298507
NODE_301613_length_196_cov_100.618557	129	196	36	6	67	0.0895522
NODE_301613_length_196_cov_100.618557	129	196	38	8	67	0.1194030
NODE_301613_length_196_cov_100.618557	129	196	40	1	67	0.0149254
NODE_301613_length_196_cov_100.618557	129	196	42	9	67	0.1343284
NODE_301613_length_196_cov_100.618557	129	196	44	3	67	0.0447761
NODE_301613_length_196_cov_100.618557	129	196	46	1	67	0.0149254
NODE_301613_length_196_cov_100.618557	129	196	48	1	67	0.0149254
NODE_301613_length_196_cov_100.618557	129	196	50	1	67	0.0149254
NODE_301618_length_196_cov_67.268041	8	88	0	7	80	0.0875000
NODE_301618_length_196_cov_67.268041	8	88	1	2	80	0.0250000
NODE_301618_length_196_cov_67.268041	8	88	2	9	80	0.1125000
NODE_301618_length_196_cov_67.268041	8	88	3	3	80	0.0375000
NODE_301618_length_196_cov_67.268041	8	88	5	7	80	0.0875000
NODE_301618_length_196_cov_67.268041	8	88	6	3	80	0.0375000
NODE_301618_length_196_cov_67.268041	8	88	8	6	80	0.0750000
NODE_301618_length_196_cov_67.268041	8	88	10	2	80	0.0250000
NODE_301618_length_196_cov_67.268041	8	88	12	3	80	0.0375000
NODE_301618_length_196_cov_67.268041	8	88	15	4	80	0.0500000
NODE_301618_length_196_cov_67.268041	8	88	18	17	80	0.2125000
NODE_301618_length_196_cov_67.268041	8	88	20	17	80	0.2125000
NODE_301618_length_196_cov_67.268041	61	124	18	10	63	0.1587302
NODE_301618_length_196_cov_67.268041	61	124	20	53	63	0.8412699
NODE_301629_length_196_cov_40.195876	101	184	0	5	83	0.0602410
NODE_301629_length_196_cov_40.195876	101	184	3	18	83	0.2168675
NODE_301629_length_196_cov_40.195876	101	184	5	1	83	0.0120482
NODE_301629_length_196_cov_40.195876	101	184	7	1	83	0.0120482
NODE_301629_length_196_cov_40.195876	101	184	9	22	83	0.2650602
NODE_301629_length_196_cov_40.195876	101	184	13	3	83	0.0361446
NODE_301629_length_196_cov_40.195876	101	184	15	4	83	0.0481928
NODE_301629_length_196_cov_40.195876	101	184	16	29	83	0.3493976
NODE_301704_length_194_cov_63.252632	12	78	4	5	66	0.0757576
NODE_301704_length_194_cov_63.252632	12	78	5	3	66	0.0454545
NODE_301704_length_194_cov_63.252632	12	78	11	13	66	0.1969697
NODE_301704_length_194_cov_63.252632	12	78	15	2	66	0.0303030
NODE_301704_length_194_cov_63.252632	12	78	17	1	66	0.0151515
NODE_301704_length_194_cov_63.252632	12	78	18	5	66	0.0757576
NODE_301704_length_194_cov_63.252632	12	78	20	1	66	0.0151515
NODE_301704_length_194_cov_63.252632	12	78	28	4	66	0.0606061
NODE_301704_length_194_cov_63.252632	12	78	32	4	66	0.0606061
NODE_301704_length_194_cov_63.252632	12	78	34	1	66	0.0151515
NODE_301704_length_194_cov_63.252632	12	78	36	2	66	0.0303030
NODE_301704_length_194_cov_63.252632	12	78	38	1	66	0.0151515
NODE_301704_length_194_cov_63.252632	12	78	40	5	66	0.0757576
NODE_301704_length_194_cov_63.252632	12	78	44	2	66	0.0303030
NODE_301704_length_194_cov_63.252632	12	78	46	1	66	0.0151515
NODE_301704_length_194_cov_63.252632	12	78	48	1	66	0.0151515
NODE_301704_length_194_cov_63.252632	12	78	52	1	66	0.0151515
NODE_301704_length_194_cov_63.252632	12	78	53	3	66	0.0454545
NODE_301704_length_194_cov_63.252632	12	78	55	4	66	0.0606061
NODE_301704_length_194_cov_63.252632	12	78	57	1	66	0.0151515
NODE_301704_length_194_cov_63.252632	12	78	59	2	66	0.0303030
NODE_301704_length_194_cov_63.252632	12	78	61	2	66	0.0303030
NODE_301704_length_194_cov_63.252632	12	78	62	2	66	0.0303030
NODE_301704_length_194_cov_63.252632	51	112	36	2	61	0.0327869
NODE_301704_length_194_cov_63.252632	51	112	38	1	61	0.0163934
NODE_301704_length_194_cov_63.252632	51	112	40	5	61	0.0819672
NODE_301704_length_194_cov_63.252632	51	112	44	2	61	0.0327869
NODE_301704_length_194_cov_63.252632	51	112	46	1	61	0.0163934
NODE_301704_length_194_cov_63.252632	51	112	48	1	61	0.0163934
NODE_301704_length_194_cov_63.252632	51	112	52	1	61	0.0163934
NODE_301704_length_194_cov_63.252632	51	112	53	3	61	0.0491803
NODE_301704_length_194_cov_63.252632	51	112	55	4	61	0.0655738
NODE_301704_length_194_cov_63.252632	51	112	57	1	61	0.0163934
NODE_301704_length_194_cov_63.252632	51	112	59	2	61	0.0327869
NODE_301704_length_194_cov_63.252632	51	112	61	2	61	0.0327869
NODE_301704_length_194_cov_63.252632	51	112	62	36	61	0.5901639
NODE_301704_length_194_cov_63.252632	51	99	36	2	48	0.0416667
NODE_301704_length_194_cov_63.252632	51	99	38	1	48	0.0208333
NODE_301704_length_194_cov_63.252632	51	99	40	5	48	0.1041667
NODE_301704_length_194_cov_63.252632	51	99	44	2	48	0.0416667
NODE_301704_length_194_cov_63.252632	51	99	46	1	48	0.0208333
NODE_301704_length_194_cov_63.252632	51	99	48	1	48	0.0208333
NODE_301704_length_194_cov_63.252632	51	99	52	1	48	0.0208333
NODE_301704_length_194_cov_63.252632	51	99	53	3	48	0.0625000
NODE_301704_length_194_cov_63.252632	51	99	55	4	48	0.0833333
NODE_301704_length_194_cov_63.252632	51	99	57	1	48	0.0208333
NODE_301704_length_194_cov_63.252632	51	99	59	2	48	0.0416667
NODE_301704_length_194_cov_63.252632	51	99	61	2	48	0.0416667
NODE_301704_length_194_cov_63.252632	51	99	62	23	48	0.4791667
NODE_301704_length_194_cov_63.252632	51	112	36	2	61	0.0327869
NODE_301704_length_194_cov_63.252632	51	112	38	1	61	0.0163934
NODE_301704_length_194_cov_63.252632	51	112	40	5	61	0.0819672
NODE_301704_length_194_cov_63.252632	51	112	44	2	61	0.0327869
NODE_301704_length_194_cov_63.252632	51	112	46	1	61	0.0163934
NODE_301704_length_194_cov_63.252632	51	112	48	1	61	0.0163934
NODE_301704_length_194_cov_63.252632	51	112	52	1	61	0.0163934
NODE_301704_length_194_cov_63.252632	51	112	53	3	61	0.0491803
NODE_301704_length_194_cov_63.252632	51	112	55	4	61	0.0655738
NODE_301704_length_194_cov_63.252632	51	112	57	1	61	0.0163934
NODE_301704_length_194_cov_63.252632	51	112	59	2	61	0.0327869
NODE_301704_length_194_cov_63.252632	51	112	61	2	61	0.0327869
NODE_301704_length_194_cov_63.252632	51	112	62	36	61	0.5901639
NODE_301708_length_194_cov_35.010526	95	162	0	8	67	0.1194030
NODE_301708_length_194_cov_35.010526	95	162	2	16	67	0.2388060
NODE_301708_length_194_cov_35.010526	95	162	4	14	67	0.2089552
NODE_301708_length_194_cov_35.010526	95	162	6	29	67	0.4328358
NODE_301708_length_194_cov_35.010526	95	162	0	8	67	0.1194030
NODE_301708_length_194_cov_35.010526	95	162	2	16	67	0.2388060
NODE_301708_length_194_cov_35.010526	95	162	4	14	67	0.2089552
NODE_301708_length_194_cov_35.010526	95	162	6	29	67	0.4328358
NODE_301708_length_194_cov_35.010526	135	184	0	30	49	0.6122449
NODE_301708_length_194_cov_35.010526	135	184	2	16	49	0.3265306
NODE_301708_length_194_cov_35.010526	135	184	4	3	49	0.0612245
NODE_301714_length_194_cov_9.978947	153	194	0	41	41	1.0000000
NODE_301727_length_193_cov_117.170213	21	93	4	2	72	0.0277778
NODE_301727_length_193_cov_117.170213	21	93	6	8	72	0.1111111
NODE_301727_length_193_cov_117.170213	21	93	10	8	72	0.1111111
NODE_301727_length_193_cov_117.170213	21	93	14	6	72	0.0833333
NODE_301727_length_193_cov_117.170213	21	93	16	4	72	0.0555556
NODE_301727_length_193_cov_117.170213	21	93	18	2	72	0.0277778
NODE_301727_length_193_cov_117.170213	21	93	20	1	72	0.0138889
NODE_301727_length_193_cov_117.170213	21	93	22	9	72	0.1250000
NODE_301727_length_193_cov_117.170213	21	93	25	2	72	0.0277778
NODE_301727_length_193_cov_117.170213	21	93	27	1	72	0.0138889
NODE_301727_length_193_cov_117.170213	21	93	33	11	72	0.1527778
NODE_301727_length_193_cov_117.170213	21	93	34	1	72	0.0138889
NODE_301727_length_193_cov_117.170213	21	93	36	3	72	0.0416667
NODE_301727_length_193_cov_117.170213	21	93	38	8	72	0.1111111
NODE_301727_length_193_cov_117.170213	21	93	40	1	72	0.0138889
NODE_301727_length_193_cov_117.170213	21	93	41	1	72	0.0138889
NODE_301727_length_193_cov_117.170213	21	93	42	4	72	0.0555556
NODE_301727_length_193_cov_117.170213	41	121	14	4	80	0.0500000
NODE_301727_length_193_cov_117.170213	41	121	16	4	80	0.0500000
NODE_301727_length_193_cov_117.170213	41	121	18	2	80	0.0250000
NODE_301727_length_193_cov_117.170213	41	121	20	1	80	0.0125000
NODE_301727_length_193_cov_117.170213	41	121	22	9	80	0.1125000
NODE_301727_length_193_cov_117.170213	41	121	25	2	80	0.0250000
NODE_301727_length_193_cov_117.170213	41	121	27	1	80	0.0125000
NODE_301727_length_193_cov_117.170213	41	121	33	11	80	0.1375000
NODE_301727_length_193_cov_117.170213	41	121	34	1	80	0.0125000
NODE_301727_length_193_cov_117.170213	41	121	36	3	80	0.0375000
NODE_301727_length_193_cov_117.170213	41	121	38	8	80	0.1000000
NODE_301727_length_193_cov_117.170213	41	121	40	9	80	0.1125000
NODE_301727_length_193_cov_117.170213	41	121	41	1	80	0.0125000
NODE_301727_length_193_cov_117.170213	41	121	42	24	80	0.3000000
NODE_301729_length_193_cov_54.734043	108	188	5	2	80	0.0250000
NODE_301729_length_193_cov_54.734043	108	188	13	2	80	0.0250000
NODE_301729_length_193_cov_54.734043	108	188	14	3	80	0.0375000
NODE_301729_length_193_cov_54.734043	108	188	18	4	80	0.0500000
NODE_301729_length_193_cov_54.734043	108	188	20	1	80	0.0125000
NODE_301729_length_193_cov_54.734043	108	188	22	2	80	0.0250000
NODE_301729_length_193_cov_54.734043	108	188	24	1	80	0.0125000
NODE_301729_length_193_cov_54.734043	108	188	28	35	80	0.4375000
NODE_301729_length_193_cov_54.734043	108	188	32	30	80	0.3750000
NODE_301729_length_193_cov_54.734043	161	183	14	2	22	0.0909091
NODE_301729_length_193_cov_54.734043	161	183	18	4	22	0.1818182
NODE_301729_length_193_cov_54.734043	161	183	20	1	22	0.0454545
NODE_301729_length_193_cov_54.734043	161	183	22	2	22	0.0909091
NODE_301729_length_193_cov_54.734043	161	183	24	1	22	0.0454545
NODE_301729_length_193_cov_54.734043	161	183	28	12	22	0.5454546
NODE_301735_length_193_cov_30.638298	108	188	18	4	80	0.0500000
NODE_301735_length_193_cov_30.638298	108	188	20	2	80	0.0250000
NODE_301735_length_193_cov_30.638298	108	188	26	5	80	0.0625000
NODE_301735_length_193_cov_30.638298	108	188	27	4	80	0.0500000
NODE_301735_length_193_cov_30.638298	108	188	28	11	80	0.1375000
NODE_301735_length_193_cov_30.638298	108	188	30	1	80	0.0125000
NODE_301735_length_193_cov_30.638298	108	188	33	13	80	0.1625000
NODE_301735_length_193_cov_30.638298	108	188	35	4	80	0.0500000
NODE_301735_length_193_cov_30.638298	108	188	39	7	80	0.0875000
NODE_301735_length_193_cov_30.638298	108	188	41	5	80	0.0625000
NODE_301735_length_193_cov_30.638298	108	188	42	10	80	0.1250000
NODE_301735_length_193_cov_30.638298	108	188	44	7	80	0.0875000
NODE_301735_length_193_cov_30.638298	108	188	46	4	80	0.0500000
NODE_301735_length_193_cov_30.638298	108	188	50	3	80	0.0375000
NODE_301735_length_193_cov_30.638298	161	183	20	1	22	0.0454545
NODE_301735_length_193_cov_30.638298	161	183	26	5	22	0.2272727
NODE_301735_length_193_cov_30.638298	161	183	27	4	22	0.1818182
NODE_301735_length_193_cov_30.638298	161	183	28	11	22	0.5000000
NODE_301735_length_193_cov_30.638298	161	183	30	1	22	0.0454545
NODE_301737_length_193_cov_29.968085	0	45	2	2	45	0.0444444
NODE_301737_length_193_cov_29.968085	0	45	12	6	45	0.1333333
NODE_301737_length_193_cov_29.968085	0	45	14	6	45	0.1333333
NODE_301737_length_193_cov_29.968085	0	45	16	1	45	0.0222222
NODE_301737_length_193_cov_29.968085	0	45	20	4	45	0.0888889
NODE_301737_length_193_cov_29.968085	0	45	22	3	45	0.0666667
NODE_301737_length_193_cov_29.968085	0	45	24	1	45	0.0222222
NODE_301737_length_193_cov_29.968085	0	45	26	1	45	0.0222222
NODE_301737_length_193_cov_29.968085	0	45	30	1	45	0.0222222
NODE_301737_length_193_cov_29.968085	0	45	32	1	45	0.0222222
NODE_301737_length_193_cov_29.968085	0	45	34	1	45	0.0222222
NODE_301737_length_193_cov_29.968085	0	45	36	1	45	0.0222222
NODE_301737_length_193_cov_29.968085	0	45	38	1	45	0.0222222
NODE_301737_length_193_cov_29.968085	0	45	40	1	45	0.0222222
NODE_301737_length_193_cov_29.968085	0	45	42	4	45	0.0888889
NODE_301737_length_193_cov_29.968085	0	45	46	1	45	0.0222222
NODE_301737_length_193_cov_29.968085	0	45	48	1	45	0.0222222
NODE_301737_length_193_cov_29.968085	0	45	54	1	45	0.0222222
NODE_301737_length_193_cov_29.968085	0	45	56	1	45	0.0222222
NODE_301737_length_193_cov_29.968085	0	45	58	5	45	0.1111111
NODE_301737_length_193_cov_29.968085	0	45	60	2	45	0.0444444
NODE_301737_length_193_cov_29.968085	8	57	14	6	49	0.1224490
NODE_301737_length_193_cov_29.968085	8	57	16	1	49	0.0204082
NODE_301737_length_193_cov_29.968085	8	57	20	4	49	0.0816327
NODE_301737_length_193_cov_29.968085	8	57	22	3	49	0.0612245
NODE_301737_length_193_cov_29.968085	8	57	24	1	49	0.0204082
NODE_301737_length_193_cov_29.968085	8	57	26	1	49	0.0204082
NODE_301737_length_193_cov_29.968085	8	57	30	1	49	0.0204082
NODE_301737_length_193_cov_29.968085	8	57	32	1	49	0.0204082
NODE_301737_length_193_cov_29.968085	8	57	34	1	49	0.0204082
NODE_301737_length_193_cov_29.968085	8	57	36	1	49	0.0204082
NODE_301737_length_193_cov_29.968085	8	57	38	1	49	0.0204082
NODE_301737_length_193_cov_29.968085	8	57	40	1	49	0.0204082
NODE_301737_length_193_cov_29.968085	8	57	42	4	49	0.0816327
NODE_301737_length_193_cov_29.968085	8	57	46	1	49	0.0204082
NODE_301737_length_193_cov_29.968085	8	57	48	1	49	0.0204082
NODE_301737_length_193_cov_29.968085	8	57	54	1	49	0.0204082
NODE_301737_length_193_cov_29.968085	8	57	56	1	49	0.0204082
NODE_301737_length_193_cov_29.968085	8	57	58	5	49	0.1020408
NODE_301737_length_193_cov_29.968085	8	57	60	9	49	0.1836735
NODE_301737_length_193_cov_29.968085	8	57	62	5	49	0.1020408
NODE_301737_length_193_cov_29.968085	30	98	42	4	68	0.0588235
NODE_301737_length_193_cov_29.968085	30	98	46	1	68	0.0147059
NODE_301737_length_193_cov_29.968085	30	98	48	1	68	0.0147059
NODE_301737_length_193_cov_29.968085	30	98	54	1	68	0.0147059
NODE_301737_length_193_cov_29.968085	30	98	56	1	68	0.0147059
NODE_301737_length_193_cov_29.968085	30	98	58	5	68	0.0735294
NODE_301737_length_193_cov_29.968085	30	98	60	9	68	0.1323529
NODE_301737_length_193_cov_29.968085	30	98	62	6	68	0.0882353
NODE_301737_length_193_cov_29.968085	30	98	66	14	68	0.2058824
NODE_301737_length_193_cov_29.968085	30	98	68	3	68	0.0441176
NODE_301737_length_193_cov_29.968085	30	98	70	23	68	0.3382353
NODE_301737_length_193_cov_29.968085	30	98	42	4	68	0.0588235
NODE_301737_length_193_cov_29.968085	30	98	46	1	68	0.0147059
NODE_301737_length_193_cov_29.968085	30	98	48	1	68	0.0147059
NODE_301737_length_193_cov_29.968085	30	98	54	1	68	0.0147059
NODE_301737_length_193_cov_29.968085	30	98	56	1	68	0.0147059
NODE_301737_length_193_cov_29.968085	30	98	58	5	68	0.0735294
NODE_301737_length_193_cov_29.968085	30	98	60	9	68	0.1323529
NODE_301737_length_193_cov_29.968085	30	98	62	6	68	0.0882353
NODE_301737_length_193_cov_29.968085	30	98	66	14	68	0.2058824
NODE_301737_length_193_cov_29.968085	30	98	68	3	68	0.0441176
NODE_301737_length_193_cov_29.968085	30	98	70	23	68	0.3382353
NODE_301737_length_193_cov_29.968085	30	98	42	4	68	0.0588235
NODE_301737_length_193_cov_29.968085	30	98	46	1	68	0.0147059
NODE_301737_length_193_cov_29.968085	30	98	48	1	68	0.0147059
NODE_301737_length_193_cov_29.968085	30	98	54	1	68	0.0147059
NODE_301737_length_193_cov_29.968085	30	98	56	1	68	0.0147059
NODE_301737_length_193_cov_29.968085	30	98	58	5	68	0.0735294
NODE_301737_length_193_cov_29.968085	30	98	60	9	68	0.1323529
NODE_301737_length_193_cov_29.968085	30	98	62	6	68	0.0882353
NODE_301737_length_193_cov_29.968085	30	98	66	14	68	0.2058824
NODE_301737_length_193_cov_29.968085	30	98	68	3	68	0.0441176
NODE_301737_length_193_cov_29.968085	30	98	70	23	68	0.3382353
NODE_301737_length_193_cov_29.968085	146	188	0	10	42	0.2380952
NODE_301737_length_193_cov_29.968085	146	188	2	18	42	0.4285714
NODE_301737_length_193_cov_29.968085	146	188	4	8	42	0.1904762
NODE_301737_length_193_cov_29.968085	146	188	6	6	42	0.1428571
NODE_301776_length_192_cov_160.258065	0	76	3	2	76	0.0263158
NODE_301776_length_192_cov_160.258065	0	76	5	8	76	0.1052632
NODE_301776_length_192_cov_160.258065	0	76	7	6	76	0.0789474
NODE_301776_length_192_cov_160.258065	0	76	9	6	76	0.0789474
NODE_301776_length_192_cov_160.258065	0	76	11	1	76	0.0131579
NODE_301776_length_192_cov_160.258065	0	76	13	2	76	0.0263158
NODE_301776_length_192_cov_160.258065	0	76	15	4	76	0.0526316
NODE_301776_length_192_cov_160.258065	0	76	17	2	76	0.0263158
NODE_301776_length_192_cov_160.258065	0	76	23	1	76	0.0131579
NODE_301776_length_192_cov_160.258065	0	76	24	6	76	0.0789474
NODE_301776_length_192_cov_160.258065	0	76	28	1	76	0.0131579
NODE_301776_length_192_cov_160.258065	0	76	30	1	76	0.0131579
NODE_301776_length_192_cov_160.258065	0	76	32	3	76	0.0394737
NODE_301776_length_192_cov_160.258065	0	76	34	3	76	0.0394737
NODE_301776_length_192_cov_160.258065	0	76	38	1	76	0.0131579
NODE_301776_length_192_cov_160.258065	0	76	43	1	76	0.0131579
NODE_301776_length_192_cov_160.258065	0	76	45	4	76	0.0526316
NODE_301776_length_192_cov_160.258065	0	76	47	2	76	0.0263158
NODE_301776_length_192_cov_160.258065	0	76	51	2	76	0.0263158
NODE_301776_length_192_cov_160.258065	0	76	53	2	76	0.0263158
NODE_301776_length_192_cov_160.258065	0	76	55	3	76	0.0394737
NODE_301776_length_192_cov_160.258065	0	76	57	1	76	0.0131579
NODE_301776_length_192_cov_160.258065	0	76	61	1	76	0.0131579
NODE_301776_length_192_cov_160.258065	0	76	71	1	76	0.0131579
NODE_301776_length_192_cov_160.258065	0	76	76	2	76	0.0263158
NODE_301776_length_192_cov_160.258065	0	76	80	1	76	0.0131579
NODE_301776_length_192_cov_160.258065	0	76	84	1	76	0.0131579
NODE_301776_length_192_cov_160.258065	0	76	88	1	76	0.0131579
NODE_301776_length_192_cov_160.258065	0	76	90	1	76	0.0131579
NODE_301776_length_192_cov_160.258065	0	76	92	1	76	0.0131579
NODE_301776_length_192_cov_160.258065	0	76	96	1	76	0.0131579
NODE_301776_length_192_cov_160.258065	0	76	100	1	76	0.0131579
NODE_301776_length_192_cov_160.258065	0	76	110	1	76	0.0131579
NODE_301776_length_192_cov_160.258065	0	76	112	1	76	0.0131579
NODE_301776_length_192_cov_160.258065	0	76	116	1	76	0.0131579
NODE_301825_length_191_cov_92.913043	81	144	12	8	63	0.1269841
NODE_301825_length_191_cov_92.913043	81	144	16	19	63	0.3015873
NODE_301825_length_191_cov_92.913043	81	144	18	15	63	0.2380952
NODE_301825_length_191_cov_92.913043	81	144	20	21	63	0.3333333
NODE_301855_length_190_cov_112.285714	8	91	0	32	83	0.3855422
NODE_301855_length_190_cov_112.285714	8	91	2	51	83	0.6144578
NODE_301859_length_190_cov_41.373626	92	172	6	7	80	0.0875000
NODE_301859_length_190_cov_41.373626	92	172	8	8	80	0.1000000
NODE_301859_length_190_cov_41.373626	92	172	10	11	80	0.1375000
NODE_301859_length_190_cov_41.373626	92	172	12	2	80	0.0250000
NODE_301859_length_190_cov_41.373626	92	172	16	1	80	0.0125000
NODE_301859_length_190_cov_41.373626	92	172	18	2	80	0.0250000
NODE_301859_length_190_cov_41.373626	92	172	22	8	80	0.1000000
NODE_301859_length_190_cov_41.373626	92	172	24	1	80	0.0125000
NODE_301859_length_190_cov_41.373626	92	172	25	3	80	0.0375000
NODE_301859_length_190_cov_41.373626	92	172	26	37	80	0.4625000
NODE_301859_length_190_cov_41.373626	145	190	0	9	45	0.2000000
NODE_301859_length_190_cov_41.373626	145	190	2	4	45	0.0888889
NODE_301859_length_190_cov_41.373626	145	190	3	2	45	0.0444444
NODE_301859_length_190_cov_41.373626	145	190	5	1	45	0.0222222
NODE_301859_length_190_cov_41.373626	145	190	6	9	45	0.2000000
NODE_301859_length_190_cov_41.373626	145	190	8	8	45	0.1777778
NODE_301859_length_190_cov_41.373626	145	190	10	11	45	0.2444444
NODE_301859_length_190_cov_41.373626	145	190	12	1	45	0.0222222
NODE_301880_length_189_cov_234.500000	19	88	0	69	69	1.0000000
NODE_301882_length_189_cov_192.211111	134	186	6	14	52	0.2692308
NODE_301882_length_189_cov_192.211111	134	186	8	1	52	0.0192308
NODE_301882_length_189_cov_192.211111	134	186	10	1	52	0.0192308
NODE_301882_length_189_cov_192.211111	134	186	12	7	52	0.1346154
NODE_301882_length_189_cov_192.211111	134	186	14	6	52	0.1153846
NODE_301882_length_189_cov_192.211111	134	186	16	17	52	0.3269231
NODE_301882_length_189_cov_192.211111	134	186	18	3	52	0.0576923
NODE_301882_length_189_cov_192.211111	134	186	20	3	52	0.0576923
NODE_301885_length_189_cov_70.600000	19	88	0	69	69	1.0000000
NODE_301885_length_189_cov_70.600000	72	156	0	84	84	1.0000000
NODE_301886_length_189_cov_63.455556	70	150	86	5	80	0.0625000
NODE_301886_length_189_cov_63.455556	70	150	94	2	80	0.0250000
NODE_301886_length_189_cov_63.455556	70	150	100	1	80	0.0125000
NODE_301886_length_189_cov_63.455556	70	150	102	1	80	0.0125000
NODE_301886_length_189_cov_63.455556	70	150	106	1	80	0.0125000
NODE_301886_length_189_cov_63.455556	70	150	114	1	80	0.0125000
NODE_301886_length_189_cov_63.455556	70	150	118	7	80	0.0875000
NODE_301886_length_189_cov_63.455556	70	150	120	3	80	0.0375000
NODE_301886_length_189_cov_63.455556	70	150	122	2	80	0.0250000
NODE_301886_length_189_cov_63.455556	70	150	124	8	80	0.1000000
NODE_301886_length_189_cov_63.455556	70	150	126	5	80	0.0625000
NODE_301886_length_189_cov_63.455556	70	150	128	2	80	0.0250000
NODE_301886_length_189_cov_63.455556	70	150	132	1	80	0.0125000
NODE_301886_length_189_cov_63.455556	70	150	134	3	80	0.0375000
NODE_301886_length_189_cov_63.455556	70	150	136	1	80	0.0125000
NODE_301886_length_189_cov_63.455556	70	150	138	1	80	0.0125000
NODE_301886_length_189_cov_63.455556	70	150	140	4	80	0.0500000
NODE_301886_length_189_cov_63.455556	70	150	144	1	80	0.0125000
NODE_301886_length_189_cov_63.455556	70	150	146	1	80	0.0125000
NODE_301886_length_189_cov_63.455556	70	150	148	1	80	0.0125000
NODE_301886_length_189_cov_63.455556	70	150	149	1	80	0.0125000
NODE_301886_length_189_cov_63.455556	70	150	152	2	80	0.0250000
NODE_301886_length_189_cov_63.455556	70	150	154	9	80	0.1125000
NODE_301886_length_189_cov_63.455556	70	150	156	1	80	0.0125000
NODE_301886_length_189_cov_63.455556	70	150	158	16	80	0.2000000
NODE_301886_length_189_cov_63.455556	70	141	106	1	71	0.0140845
NODE_301886_length_189_cov_63.455556	70	141	114	1	71	0.0140845
NODE_301886_length_189_cov_63.455556	70	141	118	7	71	0.0985916
NODE_301886_length_189_cov_63.455556	70	141	120	3	71	0.0422535
NODE_301886_length_189_cov_63.455556	70	141	122	2	71	0.0281690
NODE_301886_length_189_cov_63.455556	70	141	124	8	71	0.1126761
NODE_301886_length_189_cov_63.455556	70	141	126	5	71	0.0704225
NODE_301886_length_189_cov_63.455556	70	141	128	2	71	0.0281690
NODE_301886_length_189_cov_63.455556	70	141	132	1	71	0.0140845
NODE_301886_length_189_cov_63.455556	70	141	134	3	71	0.0422535
NODE_301886_length_189_cov_63.455556	70	141	136	1	71	0.0140845
NODE_301886_length_189_cov_63.455556	70	141	138	1	71	0.0140845
NODE_301886_length_189_cov_63.455556	70	141	140	4	71	0.0563380
NODE_301886_length_189_cov_63.455556	70	141	144	1	71	0.0140845
NODE_301886_length_189_cov_63.455556	70	141	146	1	71	0.0140845
NODE_301886_length_189_cov_63.455556	70	141	148	1	71	0.0140845
NODE_301886_length_189_cov_63.455556	70	141	149	1	71	0.0140845
NODE_301886_length_189_cov_63.455556	70	141	152	2	71	0.0281690
NODE_301886_length_189_cov_63.455556	70	141	154	9	71	0.1267606
NODE_301886_length_189_cov_63.455556	70	141	156	1	71	0.0140845
NODE_301886_length_189_cov_63.455556	70	141	158	16	71	0.2253521
NODE_301891_length_189_cov_43.600000	0	73	7	1	73	0.0136986
NODE_301891_length_189_cov_43.600000	0	73	8	10	73	0.1369863
NODE_301891_length_189_cov_43.600000	0	73	10	2	73	0.0273973
NODE_301891_length_189_cov_43.600000	0	73	12	2	73	0.0273973
NODE_301891_length_189_cov_43.600000	0	73	14	2	73	0.0273973
NODE_301891_length_189_cov_43.600000	0	73	20	2	73	0.0273973
NODE_301891_length_189_cov_43.600000	0	73	24	3	73	0.0410959
NODE_301891_length_189_cov_43.600000	0	73	30	2	73	0.0273973
NODE_301891_length_189_cov_43.600000	0	73	31	1	73	0.0136986
NODE_301891_length_189_cov_43.600000	0	73	35	1	73	0.0136986
NODE_301891_length_189_cov_43.600000	0	73	39	1	73	0.0136986
NODE_301891_length_189_cov_43.600000	0	73	40	2	73	0.0273973
NODE_301891_length_189_cov_43.600000	0	73	47	2	73	0.0273973
NODE_301891_length_189_cov_43.600000	0	73	50	1	73	0.0136986
NODE_301891_length_189_cov_43.600000	0	73	53	4	73	0.0547945
NODE_301891_length_189_cov_43.600000	0	73	55	1	73	0.0136986
NODE_301891_length_189_cov_43.600000	0	73	57	4	73	0.0547945
NODE_301891_length_189_cov_43.600000	0	73	59	2	73	0.0273973
NODE_301891_length_189_cov_43.600000	0	73	60	3	73	0.0410959
NODE_301891_length_189_cov_43.600000	0	73	64	1	73	0.0136986
NODE_301891_length_189_cov_43.600000	0	73	74	5	73	0.0684932
NODE_301891_length_189_cov_43.600000	0	73	76	2	73	0.0273973
NODE_301891_length_189_cov_43.600000	0	73	80	4	73	0.0547945
NODE_301891_length_189_cov_43.600000	0	73	84	3	73	0.0410959
NODE_301891_length_189_cov_43.600000	0	73	88	1	73	0.0136986
NODE_301891_length_189_cov_43.600000	0	73	90	1	73	0.0136986
NODE_301891_length_189_cov_43.600000	0	73	96	2	73	0.0273973
NODE_301891_length_189_cov_43.600000	0	73	98	2	73	0.0273973
NODE_301891_length_189_cov_43.600000	0	73	100	5	73	0.0684932
NODE_301891_length_189_cov_43.600000	0	73	102	1	73	0.0136986
NODE_301940_length_188_cov_2021.561798	108	188	2	1	80	0.0125000
NODE_301940_length_188_cov_2021.561798	108	188	4	5	80	0.0625000
NODE_301940_length_188_cov_2021.561798	108	188	6	2	80	0.0250000
NODE_301940_length_188_cov_2021.561798	108	188	10	2	80	0.0250000
NODE_301940_length_188_cov_2021.561798	108	188	18	1	80	0.0125000
NODE_301940_length_188_cov_2021.561798	108	188	28	1	80	0.0125000
NODE_301940_length_188_cov_2021.561798	108	188	35	1	80	0.0125000
NODE_301940_length_188_cov_2021.561798	108	188	43	1	80	0.0125000
NODE_301940_length_188_cov_2021.561798	108	188	49	1	80	0.0125000
NODE_301940_length_188_cov_2021.561798	108	188	51	2	80	0.0250000
NODE_301940_length_188_cov_2021.561798	108	188	53	7	80	0.0875000
NODE_301940_length_188_cov_2021.561798	108	188	61	2	80	0.0250000
NODE_301940_length_188_cov_2021.561798	108	188	65	2	80	0.0250000
NODE_301940_length_188_cov_2021.561798	108	188	66	2	80	0.0250000
NODE_301940_length_188_cov_2021.561798	108	188	69	6	80	0.0750000
NODE_301940_length_188_cov_2021.561798	108	188	74	2	80	0.0250000
NODE_301940_length_188_cov_2021.561798	108	188	76	1	80	0.0125000
NODE_301940_length_188_cov_2021.561798	108	188	84	3	80	0.0375000
NODE_301940_length_188_cov_2021.561798	108	188	92	2	80	0.0250000
NODE_301940_length_188_cov_2021.561798	108	188	95	1	80	0.0125000
NODE_301940_length_188_cov_2021.561798	108	188	101	2	80	0.0250000
NODE_301940_length_188_cov_2021.561798	108	188	104	1	80	0.0125000
NODE_301940_length_188_cov_2021.561798	108	188	105	1	80	0.0125000
NODE_301940_length_188_cov_2021.561798	108	188	114	1	80	0.0125000
NODE_301940_length_188_cov_2021.561798	108	188	119	1	80	0.0125000
NODE_301940_length_188_cov_2021.561798	108	188	121	1	80	0.0125000
NODE_301940_length_188_cov_2021.561798	108	188	126	1	80	0.0125000
NODE_301940_length_188_cov_2021.561798	108	188	129	3	80	0.0375000
NODE_301940_length_188_cov_2021.561798	108	188	133	1	80	0.0125000
NODE_301940_length_188_cov_2021.561798	108	188	135	1	80	0.0125000
NODE_301940_length_188_cov_2021.561798	108	188	137	4	80	0.0500000
NODE_301940_length_188_cov_2021.561798	108	188	138	1	80	0.0125000
NODE_301940_length_188_cov_2021.561798	108	188	140	1	80	0.0125000
NODE_301940_length_188_cov_2021.561798	108	188	142	1	80	0.0125000
NODE_301940_length_188_cov_2021.561798	108	188	146	1	80	0.0125000
NODE_301940_length_188_cov_2021.561798	108	188	147	1	80	0.0125000
NODE_301940_length_188_cov_2021.561798	108	188	150	2	80	0.0250000
NODE_301940_length_188_cov_2021.561798	108	188	152	2	80	0.0250000
NODE_301940_length_188_cov_2021.561798	108	188	154	2	80	0.0250000
NODE_301940_length_188_cov_2021.561798	108	188	159	2	80	0.0250000
NODE_301940_length_188_cov_2021.561798	108	188	160	5	80	0.0625000
NODE_301940_length_188_cov_2021.561798	161	183	4	1	22	0.0454545
NODE_301940_length_188_cov_2021.561798	161	183	6	2	22	0.0909091
NODE_301940_length_188_cov_2021.561798	161	183	10	2	22	0.0909091
NODE_301940_length_188_cov_2021.561798	161	183	18	1	22	0.0454545
NODE_301940_length_188_cov_2021.561798	161	183	28	1	22	0.0454545
NODE_301940_length_188_cov_2021.561798	161	183	35	1	22	0.0454545
NODE_301940_length_188_cov_2021.561798	161	183	43	1	22	0.0454545
NODE_301940_length_188_cov_2021.561798	161	183	49	1	22	0.0454545
NODE_301940_length_188_cov_2021.561798	161	183	51	2	22	0.0909091
NODE_301940_length_188_cov_2021.561798	161	183	53	7	22	0.3181818
NODE_301940_length_188_cov_2021.561798	161	183	61	2	22	0.0909091
NODE_301940_length_188_cov_2021.561798	161	183	65	1	22	0.0454545
NODE_301952_length_188_cov_37.988764	0	50	1	9	50	0.1800000
NODE_301952_length_188_cov_37.988764	0	50	3	6	50	0.1200000
NODE_301952_length_188_cov_37.988764	0	50	5	14	50	0.2800000
NODE_301952_length_188_cov_37.988764	0	50	9	8	50	0.1600000
NODE_301952_length_188_cov_37.988764	0	50	11	13	50	0.2600000
NODE_301980_length_187_cov_71.170455	124	155	11	3	31	0.0967742
NODE_301980_length_187_cov_71.170455	124	155	12	28	31	0.9032258
NODE_301981_length_187_cov_56.000000	72	136	65	1	64	0.0156250
NODE_301981_length_187_cov_56.000000	72	136	66	5	64	0.0781250
NODE_301981_length_187_cov_56.000000	72	136	68	4	64	0.0625000
NODE_301981_length_187_cov_56.000000	72	136	76	1	64	0.0156250
NODE_301981_length_187_cov_56.000000	72	136	78	1	64	0.0156250
NODE_301981_length_187_cov_56.000000	72	136	82	1	64	0.0156250
NODE_301981_length_187_cov_56.000000	72	136	84	4	64	0.0625000
NODE_301981_length_187_cov_56.000000	72	136	88	2	64	0.0312500
NODE_301981_length_187_cov_56.000000	72	136	90	1	64	0.0156250
NODE_301981_length_187_cov_56.000000	72	136	92	1	64	0.0156250
NODE_301981_length_187_cov_56.000000	72	136	94	7	64	0.1093750
NODE_301981_length_187_cov_56.000000	72	136	96	8	64	0.1250000
NODE_301981_length_187_cov_56.000000	72	136	98	28	64	0.4375000
NODE_301981_length_187_cov_56.000000	72	136	65	1	64	0.0156250
NODE_301981_length_187_cov_56.000000	72	136	66	5	64	0.0781250
NODE_301981_length_187_cov_56.000000	72	136	68	4	64	0.0625000
NODE_301981_length_187_cov_56.000000	72	136	76	1	64	0.0156250
NODE_301981_length_187_cov_56.000000	72	136	78	1	64	0.0156250
NODE_301981_length_187_cov_56.000000	72	136	82	1	64	0.0156250
NODE_301981_length_187_cov_56.000000	72	136	84	4	64	0.0625000
NODE_301981_length_187_cov_56.000000	72	136	88	2	64	0.0312500
NODE_301981_length_187_cov_56.000000	72	136	90	1	64	0.0156250
NODE_301981_length_187_cov_56.000000	72	136	92	1	64	0.0156250
NODE_301981_length_187_cov_56.000000	72	136	94	7	64	0.1093750
NODE_301981_length_187_cov_56.000000	72	136	96	8	64	0.1250000
NODE_301981_length_187_cov_56.000000	72	136	98	28	64	0.4375000
NODE_301981_length_187_cov_56.000000	109	175	11	2	66	0.0303030
NODE_301981_length_187_cov_56.000000	109	175	15	2	66	0.0303030
NODE_301981_length_187_cov_56.000000	109	175	17	1	66	0.0151515
NODE_301981_length_187_cov_56.000000	109	175	19	3	66	0.0454545
NODE_301981_length_187_cov_56.000000	109	175	21	4	66	0.0606061
NODE_301981_length_187_cov_56.000000	109	175	25	2	66	0.0303030
NODE_301981_length_187_cov_56.000000	109	175	27	4	66	0.0606061
NODE_301981_length_187_cov_56.000000	109	175	29	2	66	0.0303030
NODE_301981_length_187_cov_56.000000	109	175	32	4	66	0.0606061
NODE_301981_length_187_cov_56.000000	109	175	33	1	66	0.0151515
NODE_301981_length_187_cov_56.000000	109	175	37	3	66	0.0454545
NODE_301981_length_187_cov_56.000000	109	175	39	2	66	0.0303030
NODE_301981_length_187_cov_56.000000	109	175	50	1	66	0.0151515
NODE_301981_length_187_cov_56.000000	109	175	51	2	66	0.0303030
NODE_301981_length_187_cov_56.000000	109	175	54	1	66	0.0151515
NODE_301981_length_187_cov_56.000000	109	175	56	2	66	0.0303030
NODE_301981_length_187_cov_56.000000	109	175	58	1	66	0.0151515
NODE_301981_length_187_cov_56.000000	109	175	60	1	66	0.0151515
NODE_301981_length_187_cov_56.000000	109	175	64	1	66	0.0151515
NODE_301981_length_187_cov_56.000000	109	175	65	1	66	0.0151515
NODE_301981_length_187_cov_56.000000	109	175	66	5	66	0.0757576
NODE_301981_length_187_cov_56.000000	109	175	68	4	66	0.0606061
NODE_301981_length_187_cov_56.000000	109	175	76	1	66	0.0151515
NODE_301981_length_187_cov_56.000000	109	175	78	1	66	0.0151515
NODE_301981_length_187_cov_56.000000	109	175	82	1	66	0.0151515
NODE_301981_length_187_cov_56.000000	109	175	84	4	66	0.0606061
NODE_301981_length_187_cov_56.000000	109	175	88	2	66	0.0303030
NODE_301981_length_187_cov_56.000000	109	175	90	1	66	0.0151515
NODE_301981_length_187_cov_56.000000	109	175	92	1	66	0.0151515
NODE_301981_length_187_cov_56.000000	109	175	94	6	66	0.0909091
NODE_301981_length_187_cov_56.000000	109	180	5	1	71	0.0140845
NODE_301981_length_187_cov_56.000000	109	180	6	2	71	0.0281690
NODE_301981_length_187_cov_56.000000	109	180	11	4	71	0.0563380
NODE_301981_length_187_cov_56.000000	109	180	15	2	71	0.0281690
NODE_301981_length_187_cov_56.000000	109	180	17	1	71	0.0140845
NODE_301981_length_187_cov_56.000000	109	180	19	3	71	0.0422535
NODE_301981_length_187_cov_56.000000	109	180	21	4	71	0.0563380
NODE_301981_length_187_cov_56.000000	109	180	25	2	71	0.0281690
NODE_301981_length_187_cov_56.000000	109	180	27	4	71	0.0563380
NODE_301981_length_187_cov_56.000000	109	180	29	2	71	0.0281690
NODE_301981_length_187_cov_56.000000	109	180	32	4	71	0.0563380
NODE_301981_length_187_cov_56.000000	109	180	33	1	71	0.0140845
NODE_301981_length_187_cov_56.000000	109	180	37	3	71	0.0422535
NODE_301981_length_187_cov_56.000000	109	180	39	2	71	0.0281690
NODE_301981_length_187_cov_56.000000	109	180	50	1	71	0.0140845
NODE_301981_length_187_cov_56.000000	109	180	51	2	71	0.0281690
NODE_301981_length_187_cov_56.000000	109	180	54	1	71	0.0140845
NODE_301981_length_187_cov_56.000000	109	180	56	2	71	0.0281690
NODE_301981_length_187_cov_56.000000	109	180	58	1	71	0.0140845
NODE_301981_length_187_cov_56.000000	109	180	60	1	71	0.0140845
NODE_301981_length_187_cov_56.000000	109	180	64	1	71	0.0140845
NODE_301981_length_187_cov_56.000000	109	180	65	1	71	0.0140845
NODE_301981_length_187_cov_56.000000	109	180	66	5	71	0.0704225
NODE_301981_length_187_cov_56.000000	109	180	68	4	71	0.0563380
NODE_301981_length_187_cov_56.000000	109	180	76	1	71	0.0140845
NODE_301981_length_187_cov_56.000000	109	180	78	1	71	0.0140845
NODE_301981_length_187_cov_56.000000	109	180	82	1	71	0.0140845
NODE_301981_length_187_cov_56.000000	109	180	84	4	71	0.0563380
NODE_301981_length_187_cov_56.000000	109	180	88	2	71	0.0281690
NODE_301981_length_187_cov_56.000000	109	180	90	1	71	0.0140845
NODE_301981_length_187_cov_56.000000	109	180	92	1	71	0.0140845
NODE_301981_length_187_cov_56.000000	109	180	94	6	71	0.0845070
NODE_301986_length_187_cov_37.397727	4	57	3	13	53	0.2452830
NODE_301986_length_187_cov_37.397727	4	57	7	6	53	0.1132075
NODE_301986_length_187_cov_37.397727	4	57	9	2	53	0.0377358
NODE_301986_length_187_cov_37.397727	4	57	11	1	53	0.0188679
NODE_301986_length_187_cov_37.397727	4	57	13	3	53	0.0566038
NODE_301986_length_187_cov_37.397727	4	57	14	2	53	0.0377358
NODE_301986_length_187_cov_37.397727	4	57	16	4	53	0.0754717
NODE_301986_length_187_cov_37.397727	4	57	17	2	53	0.0377358
NODE_301986_length_187_cov_37.397727	4	57	19	1	53	0.0188679
NODE_301986_length_187_cov_37.397727	4	57	21	2	53	0.0377358
NODE_301986_length_187_cov_37.397727	4	57	27	1	53	0.0188679
NODE_301986_length_187_cov_37.397727	4	57	29	4	53	0.0754717
NODE_301986_length_187_cov_37.397727	4	57	30	1	53	0.0188679
NODE_301986_length_187_cov_37.397727	4	57	34	2	53	0.0377358
NODE_301986_length_187_cov_37.397727	4	57	38	1	53	0.0188679
NODE_301986_length_187_cov_37.397727	4	57	40	2	53	0.0377358
NODE_301986_length_187_cov_37.397727	4	57	44	5	53	0.0943396
NODE_301986_length_187_cov_37.397727	4	57	46	1	53	0.0188679
NODE_301986_length_187_cov_37.397727	12	78	3	5	66	0.0757576
NODE_301986_length_187_cov_37.397727	12	78	7	6	66	0.0909091
NODE_301986_length_187_cov_37.397727	12	78	9	2	66	0.0303030
NODE_301986_length_187_cov_37.397727	12	78	11	1	66	0.0151515
NODE_301986_length_187_cov_37.397727	12	78	13	3	66	0.0454545
NODE_301986_length_187_cov_37.397727	12	78	14	2	66	0.0303030
NODE_301986_length_187_cov_37.397727	12	78	16	4	66	0.0606061
NODE_301986_length_187_cov_37.397727	12	78	17	2	66	0.0303030
NODE_301986_length_187_cov_37.397727	12	78	19	1	66	0.0151515
NODE_301986_length_187_cov_37.397727	12	78	21	2	66	0.0303030
NODE_301986_length_187_cov_37.397727	12	78	27	1	66	0.0151515
NODE_301986_length_187_cov_37.397727	12	78	29	4	66	0.0606061
NODE_301986_length_187_cov_37.397727	12	78	30	1	66	0.0151515
NODE_301986_length_187_cov_37.397727	12	78	34	2	66	0.0303030
NODE_301986_length_187_cov_37.397727	12	78	38	1	66	0.0151515
NODE_301986_length_187_cov_37.397727	12	78	40	2	66	0.0303030
NODE_301986_length_187_cov_37.397727	12	78	44	5	66	0.0757576
NODE_301986_length_187_cov_37.397727	12	78	46	1	66	0.0151515
NODE_301986_length_187_cov_37.397727	12	78	56	4	66	0.0606061
NODE_301986_length_187_cov_37.397727	12	78	66	2	66	0.0303030
NODE_301986_length_187_cov_37.397727	12	78	68	4	66	0.0606061
NODE_301986_length_187_cov_37.397727	12	78	72	7	66	0.1060606
NODE_301986_length_187_cov_37.397727	12	78	74	4	66	0.0606061
NODE_301986_length_187_cov_37.397727	51	112	44	5	61	0.0819672
NODE_301986_length_187_cov_37.397727	51	112	46	1	61	0.0163934
NODE_301986_length_187_cov_37.397727	51	112	56	4	61	0.0655738
NODE_301986_length_187_cov_37.397727	51	112	66	2	61	0.0327869
NODE_301986_length_187_cov_37.397727	51	112	68	4	61	0.0655738
NODE_301986_length_187_cov_37.397727	51	112	72	7	61	0.1147541
NODE_301986_length_187_cov_37.397727	51	112	74	8	61	0.1311475
NODE_301986_length_187_cov_37.397727	51	112	76	30	61	0.4918033
NODE_301986_length_187_cov_37.397727	51	114	44	5	63	0.0793651
NODE_301986_length_187_cov_37.397727	51	114	46	1	63	0.0158730
NODE_301986_length_187_cov_37.397727	51	114	56	4	63	0.0634921
NODE_301986_length_187_cov_37.397727	51	114	66	2	63	0.0317460
NODE_301986_length_187_cov_37.397727	51	114	68	4	63	0.0634921
NODE_301986_length_187_cov_37.397727	51	114	72	7	63	0.1111111
NODE_301986_length_187_cov_37.397727	51	114	74	10	63	0.1587302
NODE_301986_length_187_cov_37.397727	51	114	76	30	63	0.4761905
NODE_302020_length_186_cov_309.620690	20	104	0	28	84	0.3333333
NODE_302020_length_186_cov_309.620690	20	104	4	56	84	0.6666667
NODE_302021_length_186_cov_295.505747	57	115	80	2	58	0.0344828
NODE_302021_length_186_cov_295.505747	57	115	83	1	58	0.0172414
NODE_302021_length_186_cov_295.505747	57	115	84	3	58	0.0517241
NODE_302021_length_186_cov_295.505747	57	115	88	7	58	0.1206897
NODE_302021_length_186_cov_295.505747	57	115	90	2	58	0.0344828
NODE_302021_length_186_cov_295.505747	57	115	92	3	58	0.0517241
NODE_302021_length_186_cov_295.505747	57	115	94	1	58	0.0172414
NODE_302021_length_186_cov_295.505747	57	115	95	4	58	0.0689655
NODE_302021_length_186_cov_295.505747	57	115	96	6	58	0.1034483
NODE_302021_length_186_cov_295.505747	57	115	97	7	58	0.1206897
NODE_302021_length_186_cov_295.505747	57	115	98	1	58	0.0172414
NODE_302021_length_186_cov_295.505747	57	115	99	1	58	0.0172414
NODE_302021_length_186_cov_295.505747	57	115	100	20	58	0.3448276
NODE_302021_length_186_cov_295.505747	101	168	23	1	67	0.0149254
NODE_302021_length_186_cov_295.505747	101	168	24	4	67	0.0597015
NODE_302021_length_186_cov_295.505747	101	168	26	2	67	0.0298507
NODE_302021_length_186_cov_295.505747	101	168	28	5	67	0.0746269
NODE_302021_length_186_cov_295.505747	101	168	34	1	67	0.0149254
NODE_302021_length_186_cov_295.505747	101	168	35	5	67	0.0746269
NODE_302021_length_186_cov_295.505747	101	168	39	3	67	0.0447761
NODE_302021_length_186_cov_295.505747	101	168	41	1	67	0.0149254
NODE_302021_length_186_cov_295.505747	101	168	43	1	67	0.0149254
NODE_302021_length_186_cov_295.505747	101	168	45	1	67	0.0149254
NODE_302021_length_186_cov_295.505747	101	168	47	2	67	0.0298507
NODE_302021_length_186_cov_295.505747	101	168	49	3	67	0.0447761
NODE_302021_length_186_cov_295.505747	101	168	55	3	67	0.0447761
NODE_302021_length_186_cov_295.505747	101	168	57	2	67	0.0298507
NODE_302021_length_186_cov_295.505747	101	168	59	1	67	0.0149254
NODE_302021_length_186_cov_295.505747	101	168	61	1	67	0.0149254
NODE_302021_length_186_cov_295.505747	101	168	63	2	67	0.0298507
NODE_302021_length_186_cov_295.505747	101	168	65	1	67	0.0149254
NODE_302021_length_186_cov_295.505747	101	168	71	1	67	0.0149254
NODE_302021_length_186_cov_295.505747	101	168	73	1	67	0.0149254
NODE_302021_length_186_cov_295.505747	101	168	77	1	67	0.0149254
NODE_302021_length_186_cov_295.505747	101	168	81	1	67	0.0149254
NODE_302021_length_186_cov_295.505747	101	168	85	1	67	0.0149254
NODE_302021_length_186_cov_295.505747	101	168	87	5	67	0.0746269
NODE_302021_length_186_cov_295.505747	101	168	88	5	67	0.0746269
NODE_302021_length_186_cov_295.505747	101	168	92	3	67	0.0447761
NODE_302021_length_186_cov_295.505747	101	168	94	1	67	0.0149254
NODE_302021_length_186_cov_295.505747	101	168	96	6	67	0.0895522
NODE_302021_length_186_cov_295.505747	101	168	99	1	67	0.0149254
NODE_302021_length_186_cov_295.505747	101	168	100	2	67	0.0298507
NODE_302025_length_186_cov_61.344828	38	118	34	7	80	0.0875000
NODE_302025_length_186_cov_61.344828	38	118	38	1	80	0.0125000
NODE_302025_length_186_cov_61.344828	38	118	40	2	80	0.0250000
NODE_302025_length_186_cov_61.344828	38	118	44	1	80	0.0125000
NODE_302025_length_186_cov_61.344828	38	118	46	2	80	0.0250000
NODE_302025_length_186_cov_61.344828	38	118	48	5	80	0.0625000
NODE_302025_length_186_cov_61.344828	38	118	54	7	80	0.0875000
NODE_302025_length_186_cov_61.344828	38	118	56	6	80	0.0750000
NODE_302025_length_186_cov_61.344828	38	118	60	1	80	0.0125000
NODE_302025_length_186_cov_61.344828	38	118	62	2	80	0.0250000
NODE_302025_length_186_cov_61.344828	38	118	66	8	80	0.1000000
NODE_302025_length_186_cov_61.344828	38	118	68	38	80	0.4750000
NODE_302025_length_186_cov_61.344828	91	171	18	4	80	0.0500000
NODE_302025_length_186_cov_61.344828	91	171	20	1	80	0.0125000
NODE_302025_length_186_cov_61.344828	91	171	24	2	80	0.0250000
NODE_302025_length_186_cov_61.344828	91	171	26	2	80	0.0250000
NODE_302025_length_186_cov_61.344828	91	171	28	2	80	0.0250000
NODE_302025_length_186_cov_61.344828	91	171	34	1	80	0.0125000
NODE_302025_length_186_cov_61.344828	91	171	36	2	80	0.0250000
NODE_302025_length_186_cov_61.344828	91	171	38	2	80	0.0250000
NODE_302025_length_186_cov_61.344828	91	171	40	1	80	0.0125000
NODE_302025_length_186_cov_61.344828	91	171	44	1	80	0.0125000
NODE_302025_length_186_cov_61.344828	91	171	46	5	80	0.0625000
NODE_302025_length_186_cov_61.344828	91	171	48	2	80	0.0250000
NODE_302025_length_186_cov_61.344828	91	171	50	3	80	0.0375000
NODE_302025_length_186_cov_61.344828	91	171	52	18	80	0.2250000
NODE_302025_length_186_cov_61.344828	91	171	60	3	80	0.0375000
NODE_302025_length_186_cov_61.344828	91	171	66	11	80	0.1375000
NODE_302025_length_186_cov_61.344828	91	171	68	20	80	0.2500000
NODE_302201_length_182_cov_127.759036	6	52	23	6	46	0.1304348
NODE_302201_length_182_cov_127.759036	6	52	27	1	46	0.0217391
NODE_302201_length_182_cov_127.759036	6	52	28	2	46	0.0434783
NODE_302201_length_182_cov_127.759036	6	52	30	3	46	0.0652174
NODE_302201_length_182_cov_127.759036	6	52	32	3	46	0.0652174
NODE_302201_length_182_cov_127.759036	6	52	34	1	46	0.0217391
NODE_302201_length_182_cov_127.759036	6	52	37	2	46	0.0434783
NODE_302201_length_182_cov_127.759036	6	52	43	1	46	0.0217391
NODE_302201_length_182_cov_127.759036	6	52	45	1	46	0.0217391
NODE_302201_length_182_cov_127.759036	6	52	47	1	46	0.0217391
NODE_302201_length_182_cov_127.759036	6	52	49	2	46	0.0434783
NODE_302201_length_182_cov_127.759036	6	52	51	2	46	0.0434783
NODE_302201_length_182_cov_127.759036	6	52	53	4	46	0.0869565
NODE_302201_length_182_cov_127.759036	6	52	57	10	46	0.2173913
NODE_302201_length_182_cov_127.759036	6	52	58	2	46	0.0434783
NODE_302201_length_182_cov_127.759036	6	52	60	3	46	0.0652174
NODE_302201_length_182_cov_127.759036	6	52	62	2	46	0.0434783
NODE_302201_length_182_cov_127.759036	59	105	79	1	46	0.0217391
NODE_302201_length_182_cov_127.759036	59	105	81	1	46	0.0217391
NODE_302201_length_182_cov_127.759036	59	105	85	1	46	0.0217391
NODE_302201_length_182_cov_127.759036	59	105	87	1	46	0.0217391
NODE_302201_length_182_cov_127.759036	59	105	91	8	46	0.1739130
NODE_302201_length_182_cov_127.759036	59	105	93	2	46	0.0434783
NODE_302201_length_182_cov_127.759036	59	105	95	4	46	0.0869565
NODE_302201_length_182_cov_127.759036	59	105	96	1	46	0.0217391
NODE_302201_length_182_cov_127.759036	59	105	97	3	46	0.0652174
NODE_302201_length_182_cov_127.759036	59	105	99	24	46	0.5217391
NODE_302214_length_182_cov_29.421687	5	35	0	30	30	1.0000000
NODE_302214_length_182_cov_29.421687	8	88	0	80	80	1.0000000
NODE_302236_length_181_cov_141.195122	1	60	0	14	59	0.2372881
NODE_302236_length_181_cov_141.195122	1	60	2	10	59	0.1694915
NODE_302236_length_181_cov_141.195122	1	60	4	35	59	0.5932204
NODE_302236_length_181_cov_141.195122	34	60	4	26	26	1.0000000
NODE_302236_length_181_cov_141.195122	114	145	2	7	31	0.2258064
NODE_302236_length_181_cov_141.195122	114	145	4	24	31	0.7741935
NODE_302285_length_180_cov_102.567901	6	75	30	2	69	0.0289855
NODE_302285_length_180_cov_102.567901	6	75	32	1	69	0.0144928
NODE_302285_length_180_cov_102.567901	6	75	39	1	69	0.0144928
NODE_302285_length_180_cov_102.567901	6	75	41	2	69	0.0289855
NODE_302285_length_180_cov_102.567901	6	75	51	1	69	0.0144928
NODE_302285_length_180_cov_102.567901	6	75	58	2	69	0.0289855
NODE_302285_length_180_cov_102.567901	6	75	64	1	69	0.0144928
NODE_302285_length_180_cov_102.567901	6	75	67	1	69	0.0144928
NODE_302285_length_180_cov_102.567901	6	75	69	2	69	0.0289855
NODE_302285_length_180_cov_102.567901	6	75	74	2	69	0.0289855
NODE_302285_length_180_cov_102.567901	6	75	78	1	69	0.0144928
NODE_302285_length_180_cov_102.567901	6	75	80	1	69	0.0144928
NODE_302285_length_180_cov_102.567901	6	75	82	1	69	0.0144928
NODE_302285_length_180_cov_102.567901	6	75	86	1	69	0.0144928
NODE_302285_length_180_cov_102.567901	6	75	88	4	69	0.0579710
NODE_302285_length_180_cov_102.567901	6	75	98	3	69	0.0434783
NODE_302285_length_180_cov_102.567901	6	75	104	3	69	0.0434783
NODE_302285_length_180_cov_102.567901	6	75	106	1	69	0.0144928
NODE_302285_length_180_cov_102.567901	6	75	112	1	69	0.0144928
NODE_302285_length_180_cov_102.567901	6	75	116	2	69	0.0289855
NODE_302285_length_180_cov_102.567901	6	75	131	1	69	0.0144928
NODE_302285_length_180_cov_102.567901	6	75	141	1	69	0.0144928
NODE_302285_length_180_cov_102.567901	6	75	157	1	69	0.0144928
NODE_302285_length_180_cov_102.567901	6	75	160	2	69	0.0289855
NODE_302285_length_180_cov_102.567901	6	75	162	1	69	0.0144928
NODE_302285_length_180_cov_102.567901	6	75	166	2	69	0.0289855
NODE_302285_length_180_cov_102.567901	6	75	172	1	69	0.0144928
NODE_302285_length_180_cov_102.567901	6	75	174	1	69	0.0144928
NODE_302285_length_180_cov_102.567901	6	75	182	1	69	0.0144928
NODE_302285_length_180_cov_102.567901	6	75	186	1	69	0.0144928
NODE_302285_length_180_cov_102.567901	6	75	188	3	69	0.0434783
NODE_302285_length_180_cov_102.567901	6	75	194	2	69	0.0289855
NODE_302285_length_180_cov_102.567901	6	75	196	1	69	0.0144928
NODE_302285_length_180_cov_102.567901	6	75	197	1	69	0.0144928
NODE_302285_length_180_cov_102.567901	6	75	201	1	69	0.0144928
NODE_302285_length_180_cov_102.567901	6	75	203	3	69	0.0434783
NODE_302285_length_180_cov_102.567901	6	75	205	1	69	0.0144928
NODE_302285_length_180_cov_102.567901	6	75	207	1	69	0.0144928
NODE_302285_length_180_cov_102.567901	6	75	210	1	69	0.0144928
NODE_302285_length_180_cov_102.567901	6	75	216	4	69	0.0579710
NODE_302285_length_180_cov_102.567901	6	75	220	2	69	0.0289855
NODE_302285_length_180_cov_102.567901	6	75	222	4	69	0.0579710
NODE_302363_length_178_cov_93.620253	81	112	15	31	31	1.0000000
NODE_302365_length_178_cov_62.696203	0	78	0	10	78	0.1282051
NODE_302365_length_178_cov_62.696203	0	78	1	3	78	0.0384615
NODE_302365_length_178_cov_62.696203	0	78	4	14	78	0.1794872
NODE_302365_length_178_cov_62.696203	0	78	6	6	78	0.0769231
NODE_302365_length_178_cov_62.696203	0	78	8	3	78	0.0384615
NODE_302365_length_178_cov_62.696203	0	78	12	11	78	0.1410256
NODE_302365_length_178_cov_62.696203	0	78	14	31	78	0.3974359
NODE_302365_length_178_cov_62.696203	51	131	8	4	80	0.0500000
NODE_302365_length_178_cov_62.696203	51	131	10	3	80	0.0375000
NODE_302365_length_178_cov_62.696203	51	131	12	9	80	0.1125000
NODE_302365_length_178_cov_62.696203	51	131	14	64	80	0.8000000
NODE_302477_length_175_cov_116.684211	42	122	0	30	80	0.3750000
NODE_302477_length_175_cov_116.684211	42	122	2	50	80	0.6250000
NODE_302477_length_175_cov_116.684211	95	175	0	6	80	0.0750000
NODE_302477_length_175_cov_116.684211	95	175	2	74	80	0.9250000
NODE_302482_length_175_cov_61.000000	81	121	176	2	40	0.0500000
NODE_302482_length_175_cov_61.000000	81	121	191	1	40	0.0250000
NODE_302482_length_175_cov_61.000000	81	121	199	1	40	0.0250000
NODE_302482_length_175_cov_61.000000	81	121	203	1	40	0.0250000
NODE_302482_length_175_cov_61.000000	81	121	207	1	40	0.0250000
NODE_302482_length_175_cov_61.000000	81	121	209	1	40	0.0250000
NODE_302482_length_175_cov_61.000000	81	121	213	2	40	0.0500000
NODE_302482_length_175_cov_61.000000	81	121	215	2	40	0.0500000
NODE_302482_length_175_cov_61.000000	81	121	219	1	40	0.0250000
NODE_302482_length_175_cov_61.000000	81	121	223	1	40	0.0250000
NODE_302482_length_175_cov_61.000000	81	121	229	1	40	0.0250000
NODE_302482_length_175_cov_61.000000	81	121	231	3	40	0.0750000
NODE_302482_length_175_cov_61.000000	81	121	239	23	40	0.5750000
NODE_302538_length_174_cov_173.893333	53	93	158	1	40	0.0250000
NODE_302538_length_174_cov_173.893333	53	93	160	1	40	0.0250000
NODE_302538_length_174_cov_173.893333	53	93	162	1	40	0.0250000
NODE_302538_length_174_cov_173.893333	53	93	164	1	40	0.0250000
NODE_302538_length_174_cov_173.893333	53	93	166	1	40	0.0250000
NODE_302538_length_174_cov_173.893333	53	93	168	1	40	0.0250000
NODE_302538_length_174_cov_173.893333	53	93	170	1	40	0.0250000
NODE_302538_length_174_cov_173.893333	53	93	172	1	40	0.0250000
NODE_302538_length_174_cov_173.893333	53	93	174	1	40	0.0250000
NODE_302538_length_174_cov_173.893333	53	93	180	1	40	0.0250000
NODE_302538_length_174_cov_173.893333	53	93	181	1	40	0.0250000
NODE_302538_length_174_cov_173.893333	53	93	183	1	40	0.0250000
NODE_302538_length_174_cov_173.893333	53	93	187	1	40	0.0250000
NODE_302538_length_174_cov_173.893333	53	93	188	2	40	0.0500000
NODE_302538_length_174_cov_173.893333	53	93	190	1	40	0.0250000
NODE_302538_length_174_cov_173.893333	53	93	192	2	40	0.0500000
NODE_302538_length_174_cov_173.893333	53	93	196	1	40	0.0250000
NODE_302538_length_174_cov_173.893333	53	93	198	21	40	0.5250000
NODE_302543_length_174_cov_50.346667	91	161	14	1	70	0.0142857
NODE_302543_length_174_cov_50.346667	91	161	16	2	70	0.0285714
NODE_302543_length_174_cov_50.346667	91	161	18	8	70	0.1142857
NODE_302543_length_174_cov_50.346667	91	161	20	2	70	0.0285714
NODE_302543_length_174_cov_50.346667	91	161	22	4	70	0.0571429
NODE_302543_length_174_cov_50.346667	91	161	23	2	70	0.0285714
NODE_302543_length_174_cov_50.346667	91	161	25	2	70	0.0285714
NODE_302543_length_174_cov_50.346667	91	161	26	1	70	0.0142857
NODE_302543_length_174_cov_50.346667	91	161	29	5	70	0.0714286
NODE_302543_length_174_cov_50.346667	91	161	31	1	70	0.0142857
NODE_302543_length_174_cov_50.346667	91	161	35	1	70	0.0142857
NODE_302543_length_174_cov_50.346667	91	161	39	2	70	0.0285714
NODE_302543_length_174_cov_50.346667	91	161	40	3	70	0.0428571
NODE_302543_length_174_cov_50.346667	91	161	42	6	70	0.0857143
NODE_302543_length_174_cov_50.346667	91	161	44	3	70	0.0428571
NODE_302543_length_174_cov_50.346667	91	161	46	1	70	0.0142857
NODE_302543_length_174_cov_50.346667	91	161	52	1	70	0.0142857
NODE_302543_length_174_cov_50.346667	91	161	54	1	70	0.0142857
NODE_302543_length_174_cov_50.346667	91	161	60	2	70	0.0285714
NODE_302543_length_174_cov_50.346667	91	161	66	1	70	0.0142857
NODE_302543_length_174_cov_50.346667	91	161	70	1	70	0.0142857
NODE_302543_length_174_cov_50.346667	91	161	72	1	70	0.0142857
NODE_302543_length_174_cov_50.346667	91	161	74	2	70	0.0285714
NODE_302543_length_174_cov_50.346667	91	161	76	17	70	0.2428571
NODE_302590_length_173_cov_184.351351	62	126	181	1	64	0.0156250
NODE_302590_length_173_cov_184.351351	62	126	183	2	64	0.0312500
NODE_302590_length_173_cov_184.351351	62	126	187	1	64	0.0156250
NODE_302590_length_173_cov_184.351351	62	126	189	1	64	0.0156250
NODE_302590_length_173_cov_184.351351	62	126	200	1	64	0.0156250
NODE_302590_length_173_cov_184.351351	62	126	208	2	64	0.0312500
NODE_302590_length_173_cov_184.351351	62	126	212	1	64	0.0156250
NODE_302590_length_173_cov_184.351351	62	126	214	1	64	0.0156250
NODE_302590_length_173_cov_184.351351	62	126	216	2	64	0.0312500
NODE_302590_length_173_cov_184.351351	62	126	222	1	64	0.0156250
NODE_302590_length_173_cov_184.351351	62	126	223	1	64	0.0156250
NODE_302590_length_173_cov_184.351351	62	126	225	2	64	0.0312500
NODE_302590_length_173_cov_184.351351	62	126	232	1	64	0.0156250
NODE_302590_length_173_cov_184.351351	62	126	236	2	64	0.0312500
NODE_302590_length_173_cov_184.351351	62	126	240	1	64	0.0156250
NODE_302590_length_173_cov_184.351351	62	126	244	6	64	0.0937500
NODE_302590_length_173_cov_184.351351	62	126	245	1	64	0.0156250
NODE_302590_length_173_cov_184.351351	62	126	246	37	64	0.5781250
NODE_302590_length_173_cov_184.351351	62	126	181	1	64	0.0156250
NODE_302590_length_173_cov_184.351351	62	126	183	2	64	0.0312500
NODE_302590_length_173_cov_184.351351	62	126	187	1	64	0.0156250
NODE_302590_length_173_cov_184.351351	62	126	189	1	64	0.0156250
NODE_302590_length_173_cov_184.351351	62	126	200	1	64	0.0156250
NODE_302590_length_173_cov_184.351351	62	126	208	2	64	0.0312500
NODE_302590_length_173_cov_184.351351	62	126	212	1	64	0.0156250
NODE_302590_length_173_cov_184.351351	62	126	214	1	64	0.0156250
NODE_302590_length_173_cov_184.351351	62	126	216	2	64	0.0312500
NODE_302590_length_173_cov_184.351351	62	126	222	1	64	0.0156250
NODE_302590_length_173_cov_184.351351	62	126	223	1	64	0.0156250
NODE_302590_length_173_cov_184.351351	62	126	225	2	64	0.0312500
NODE_302590_length_173_cov_184.351351	62	126	232	1	64	0.0156250
NODE_302590_length_173_cov_184.351351	62	126	236	2	64	0.0312500
NODE_302590_length_173_cov_184.351351	62	126	240	1	64	0.0156250
NODE_302590_length_173_cov_184.351351	62	126	244	6	64	0.0937500
NODE_302590_length_173_cov_184.351351	62	126	245	1	64	0.0156250
NODE_302590_length_173_cov_184.351351	62	126	246	37	64	0.5781250
NODE_302590_length_173_cov_184.351351	62	126	181	1	64	0.0156250
NODE_302590_length_173_cov_184.351351	62	126	183	2	64	0.0312500
NODE_302590_length_173_cov_184.351351	62	126	187	1	64	0.0156250
NODE_302590_length_173_cov_184.351351	62	126	189	1	64	0.0156250
NODE_302590_length_173_cov_184.351351	62	126	200	1	64	0.0156250
NODE_302590_length_173_cov_184.351351	62	126	208	2	64	0.0312500
NODE_302590_length_173_cov_184.351351	62	126	212	1	64	0.0156250
NODE_302590_length_173_cov_184.351351	62	126	214	1	64	0.0156250
NODE_302590_length_173_cov_184.351351	62	126	216	2	64	0.0312500
NODE_302590_length_173_cov_184.351351	62	126	222	1	64	0.0156250
NODE_302590_length_173_cov_184.351351	62	126	223	1	64	0.0156250
NODE_302590_length_173_cov_184.351351	62	126	225	2	64	0.0312500
NODE_302590_length_173_cov_184.351351	62	126	232	1	64	0.0156250
NODE_302590_length_173_cov_184.351351	62	126	236	2	64	0.0312500
NODE_302590_length_173_cov_184.351351	62	126	240	1	64	0.0156250
NODE_302590_length_173_cov_184.351351	62	126	244	6	64	0.0937500
NODE_302590_length_173_cov_184.351351	62	126	245	1	64	0.0156250
NODE_302590_length_173_cov_184.351351	62	126	246	37	64	0.5781250
NODE_302590_length_173_cov_184.351351	62	126	181	1	64	0.0156250
NODE_302590_length_173_cov_184.351351	62	126	183	2	64	0.0312500
NODE_302590_length_173_cov_184.351351	62	126	187	1	64	0.0156250
NODE_302590_length_173_cov_184.351351	62	126	189	1	64	0.0156250
NODE_302590_length_173_cov_184.351351	62	126	200	1	64	0.0156250
NODE_302590_length_173_cov_184.351351	62	126	208	2	64	0.0312500
NODE_302590_length_173_cov_184.351351	62	126	212	1	64	0.0156250
NODE_302590_length_173_cov_184.351351	62	126	214	1	64	0.0156250
NODE_302590_length_173_cov_184.351351	62	126	216	2	64	0.0312500
NODE_302590_length_173_cov_184.351351	62	126	222	1	64	0.0156250
NODE_302590_length_173_cov_184.351351	62	126	223	1	64	0.0156250
NODE_302590_length_173_cov_184.351351	62	126	225	2	64	0.0312500
NODE_302590_length_173_cov_184.351351	62	126	232	1	64	0.0156250
NODE_302590_length_173_cov_184.351351	62	126	236	2	64	0.0312500
NODE_302590_length_173_cov_184.351351	62	126	240	1	64	0.0156250
NODE_302590_length_173_cov_184.351351	62	126	244	6	64	0.0937500
NODE_302590_length_173_cov_184.351351	62	126	245	1	64	0.0156250
NODE_302590_length_173_cov_184.351351	62	126	246	37	64	0.5781250
NODE_302590_length_173_cov_184.351351	99	165	42	1	66	0.0151515
NODE_302590_length_173_cov_184.351351	99	165	48	1	66	0.0151515
NODE_302590_length_173_cov_184.351351	99	165	49	1	66	0.0151515
NODE_302590_length_173_cov_184.351351	99	165	51	1	66	0.0151515
NODE_302590_length_173_cov_184.351351	99	165	56	3	66	0.0454545
NODE_302590_length_173_cov_184.351351	99	165	62	1	66	0.0151515
NODE_302590_length_173_cov_184.351351	99	165	65	1	66	0.0151515
NODE_302590_length_173_cov_184.351351	99	165	73	2	66	0.0303030
NODE_302590_length_173_cov_184.351351	99	165	74	1	66	0.0151515
NODE_302590_length_173_cov_184.351351	99	165	75	1	66	0.0151515
NODE_302590_length_173_cov_184.351351	99	165	78	2	66	0.0303030
NODE_302590_length_173_cov_184.351351	99	165	82	1	66	0.0151515
NODE_302590_length_173_cov_184.351351	99	165	83	1	66	0.0151515
NODE_302590_length_173_cov_184.351351	99	165	88	1	66	0.0151515
NODE_302590_length_173_cov_184.351351	99	165	92	1	66	0.0151515
NODE_302590_length_173_cov_184.351351	99	165	93	1	66	0.0151515
NODE_302590_length_173_cov_184.351351	99	165	100	1	66	0.0151515
NODE_302590_length_173_cov_184.351351	99	165	101	2	66	0.0303030
NODE_302590_length_173_cov_184.351351	99	165	105	1	66	0.0151515
NODE_302590_length_173_cov_184.351351	99	165	107	1	66	0.0151515
NODE_302590_length_173_cov_184.351351	99	165	116	1	66	0.0151515
NODE_302590_length_173_cov_184.351351	99	165	118	2	66	0.0303030
NODE_302590_length_173_cov_184.351351	99	165	126	1	66	0.0151515
NODE_302590_length_173_cov_184.351351	99	165	135	1	66	0.0151515
NODE_302590_length_173_cov_184.351351	99	165	140	1	66	0.0151515
NODE_302590_length_173_cov_184.351351	99	165	142	1	66	0.0151515
NODE_302590_length_173_cov_184.351351	99	165	151	1	66	0.0151515
NODE_302590_length_173_cov_184.351351	99	165	155	1	66	0.0151515
NODE_302590_length_173_cov_184.351351	99	165	165	1	66	0.0151515
NODE_302590_length_173_cov_184.351351	99	165	169	1	66	0.0151515
NODE_302590_length_173_cov_184.351351	99	165	173	1	66	0.0151515
NODE_302590_length_173_cov_184.351351	99	165	174	1	66	0.0151515
NODE_302590_length_173_cov_184.351351	99	165	176	1	66	0.0151515
NODE_302590_length_173_cov_184.351351	99	165	181	1	66	0.0151515
NODE_302590_length_173_cov_184.351351	99	165	183	2	66	0.0303030
NODE_302590_length_173_cov_184.351351	99	165	187	1	66	0.0151515
NODE_302590_length_173_cov_184.351351	99	165	189	1	66	0.0151515
NODE_302590_length_173_cov_184.351351	99	165	200	1	66	0.0151515
NODE_302590_length_173_cov_184.351351	99	165	208	2	66	0.0303030
NODE_302590_length_173_cov_184.351351	99	165	212	1	66	0.0151515
NODE_302590_length_173_cov_184.351351	99	165	214	1	66	0.0151515
NODE_302590_length_173_cov_184.351351	99	165	216	2	66	0.0303030
NODE_302590_length_173_cov_184.351351	99	165	222	1	66	0.0151515
NODE_302590_length_173_cov_184.351351	99	165	223	1	66	0.0151515
NODE_302590_length_173_cov_184.351351	99	165	225	2	66	0.0303030
NODE_302590_length_173_cov_184.351351	99	165	232	1	66	0.0151515
NODE_302590_length_173_cov_184.351351	99	165	236	2	66	0.0303030
NODE_302590_length_173_cov_184.351351	99	165	240	1	66	0.0151515
NODE_302590_length_173_cov_184.351351	99	165	244	2	66	0.0303030
NODE_302590_length_173_cov_184.351351	99	165	246	5	66	0.0757576
NODE_302590_length_173_cov_184.351351	99	170	33	1	71	0.0140845
NODE_302590_length_173_cov_184.351351	99	170	37	1	71	0.0140845
NODE_302590_length_173_cov_184.351351	99	170	40	3	71	0.0422535
NODE_302590_length_173_cov_184.351351	99	170	42	1	71	0.0140845
NODE_302590_length_173_cov_184.351351	99	170	48	1	71	0.0140845
NODE_302590_length_173_cov_184.351351	99	170	49	1	71	0.0140845
NODE_302590_length_173_cov_184.351351	99	170	51	1	71	0.0140845
NODE_302590_length_173_cov_184.351351	99	170	56	3	71	0.0422535
NODE_302590_length_173_cov_184.351351	99	170	62	1	71	0.0140845
NODE_302590_length_173_cov_184.351351	99	170	65	1	71	0.0140845
NODE_302590_length_173_cov_184.351351	99	170	73	2	71	0.0281690
NODE_302590_length_173_cov_184.351351	99	170	74	1	71	0.0140845
NODE_302590_length_173_cov_184.351351	99	170	75	1	71	0.0140845
NODE_302590_length_173_cov_184.351351	99	170	78	2	71	0.0281690
NODE_302590_length_173_cov_184.351351	99	170	82	1	71	0.0140845
NODE_302590_length_173_cov_184.351351	99	170	83	1	71	0.0140845
NODE_302590_length_173_cov_184.351351	99	170	88	1	71	0.0140845
NODE_302590_length_173_cov_184.351351	99	170	92	1	71	0.0140845
NODE_302590_length_173_cov_184.351351	99	170	93	1	71	0.0140845
NODE_302590_length_173_cov_184.351351	99	170	100	1	71	0.0140845
NODE_302590_length_173_cov_184.351351	99	170	101	2	71	0.0281690
NODE_302590_length_173_cov_184.351351	99	170	105	1	71	0.0140845
NODE_302590_length_173_cov_184.351351	99	170	107	1	71	0.0140845
NODE_302590_length_173_cov_184.351351	99	170	116	1	71	0.0140845
NODE_302590_length_173_cov_184.351351	99	170	118	2	71	0.0281690
NODE_302590_length_173_cov_184.351351	99	170	126	1	71	0.0140845
NODE_302590_length_173_cov_184.351351	99	170	135	1	71	0.0140845
NODE_302590_length_173_cov_184.351351	99	170	140	1	71	0.0140845
NODE_302590_length_173_cov_184.351351	99	170	142	1	71	0.0140845
NODE_302590_length_173_cov_184.351351	99	170	151	1	71	0.0140845
NODE_302590_length_173_cov_184.351351	99	170	155	1	71	0.0140845
NODE_302590_length_173_cov_184.351351	99	170	165	1	71	0.0140845
NODE_302590_length_173_cov_184.351351	99	170	169	1	71	0.0140845
NODE_302590_length_173_cov_184.351351	99	170	173	1	71	0.0140845
NODE_302590_length_173_cov_184.351351	99	170	174	1	71	0.0140845
NODE_302590_length_173_cov_184.351351	99	170	176	1	71	0.0140845
NODE_302590_length_173_cov_184.351351	99	170	181	1	71	0.0140845
NODE_302590_length_173_cov_184.351351	99	170	183	2	71	0.0281690
NODE_302590_length_173_cov_184.351351	99	170	187	1	71	0.0140845
NODE_302590_length_173_cov_184.351351	99	170	189	1	71	0.0140845
NODE_302590_length_173_cov_184.351351	99	170	200	1	71	0.0140845
NODE_302590_length_173_cov_184.351351	99	170	208	2	71	0.0281690
NODE_302590_length_173_cov_184.351351	99	170	212	1	71	0.0140845
NODE_302590_length_173_cov_184.351351	99	170	214	1	71	0.0140845
NODE_302590_length_173_cov_184.351351	99	170	216	2	71	0.0281690
NODE_302590_length_173_cov_184.351351	99	170	222	1	71	0.0140845
NODE_302590_length_173_cov_184.351351	99	170	223	1	71	0.0140845
NODE_302590_length_173_cov_184.351351	99	170	225	2	71	0.0281690
NODE_302590_length_173_cov_184.351351	99	170	232	1	71	0.0140845
NODE_302590_length_173_cov_184.351351	99	170	236	2	71	0.0281690
NODE_302590_length_173_cov_184.351351	99	170	240	1	71	0.0140845
NODE_302590_length_173_cov_184.351351	99	170	244	2	71	0.0281690
NODE_302590_length_173_cov_184.351351	99	170	246	5	71	0.0704225
NODE_302590_length_173_cov_184.351351	115	173	22	1	58	0.0172414
NODE_302590_length_173_cov_184.351351	115	173	26	1	58	0.0172414
NODE_302590_length_173_cov_184.351351	115	173	29	1	58	0.0172414
NODE_302590_length_173_cov_184.351351	115	173	33	1	58	0.0172414
NODE_302590_length_173_cov_184.351351	115	173	37	1	58	0.0172414
NODE_302590_length_173_cov_184.351351	115	173	40	3	58	0.0517241
NODE_302590_length_173_cov_184.351351	115	173	42	1	58	0.0172414
NODE_302590_length_173_cov_184.351351	115	173	48	1	58	0.0172414
NODE_302590_length_173_cov_184.351351	115	173	49	1	58	0.0172414
NODE_302590_length_173_cov_184.351351	115	173	51	1	58	0.0172414
NODE_302590_length_173_cov_184.351351	115	173	56	3	58	0.0517241
NODE_302590_length_173_cov_184.351351	115	173	62	1	58	0.0172414
NODE_302590_length_173_cov_184.351351	115	173	65	1	58	0.0172414
NODE_302590_length_173_cov_184.351351	115	173	73	2	58	0.0344828
NODE_302590_length_173_cov_184.351351	115	173	74	1	58	0.0172414
NODE_302590_length_173_cov_184.351351	115	173	75	1	58	0.0172414
NODE_302590_length_173_cov_184.351351	115	173	78	2	58	0.0344828
NODE_302590_length_173_cov_184.351351	115	173	82	1	58	0.0172414
NODE_302590_length_173_cov_184.351351	115	173	83	1	58	0.0172414
NODE_302590_length_173_cov_184.351351	115	173	88	1	58	0.0172414
NODE_302590_length_173_cov_184.351351	115	173	92	1	58	0.0172414
NODE_302590_length_173_cov_184.351351	115	173	93	1	58	0.0172414
NODE_302590_length_173_cov_184.351351	115	173	100	1	58	0.0172414
NODE_302590_length_173_cov_184.351351	115	173	101	2	58	0.0344828
NODE_302590_length_173_cov_184.351351	115	173	105	1	58	0.0172414
NODE_302590_length_173_cov_184.351351	115	173	107	1	58	0.0172414
NODE_302590_length_173_cov_184.351351	115	173	116	1	58	0.0172414
NODE_302590_length_173_cov_184.351351	115	173	118	2	58	0.0344828
NODE_302590_length_173_cov_184.351351	115	173	126	1	58	0.0172414
NODE_302590_length_173_cov_184.351351	115	173	135	1	58	0.0172414
NODE_302590_length_173_cov_184.351351	115	173	140	1	58	0.0172414
NODE_302590_length_173_cov_184.351351	115	173	142	1	58	0.0172414
NODE_302590_length_173_cov_184.351351	115	173	151	1	58	0.0172414
NODE_302590_length_173_cov_184.351351	115	173	155	1	58	0.0172414
NODE_302590_length_173_cov_184.351351	115	173	165	1	58	0.0172414
NODE_302590_length_173_cov_184.351351	115	173	169	1	58	0.0172414
NODE_302590_length_173_cov_184.351351	115	173	173	1	58	0.0172414
NODE_302590_length_173_cov_184.351351	115	173	174	1	58	0.0172414
NODE_302590_length_173_cov_184.351351	115	173	176	1	58	0.0172414
NODE_302590_length_173_cov_184.351351	115	173	181	1	58	0.0172414
NODE_302590_length_173_cov_184.351351	115	173	183	2	58	0.0344828
NODE_302590_length_173_cov_184.351351	115	173	187	1	58	0.0172414
NODE_302590_length_173_cov_184.351351	115	173	189	1	58	0.0172414
NODE_302590_length_173_cov_184.351351	115	173	200	1	58	0.0172414
NODE_302590_length_173_cov_184.351351	115	173	208	2	58	0.0344828
NODE_302590_length_173_cov_184.351351	115	173	212	1	58	0.0172414
NODE_302590_length_173_cov_184.351351	115	173	214	1	58	0.0172414
NODE_302590_length_173_cov_184.351351	115	173	216	1	58	0.0172414
NODE_302596_length_173_cov_58.472973	0	78	0	17	78	0.2179487
NODE_302596_length_173_cov_58.472973	0	78	2	6	78	0.0769231
NODE_302596_length_173_cov_58.472973	0	78	5	2	78	0.0256410
NODE_302596_length_173_cov_58.472973	0	78	7	9	78	0.1153846
NODE_302596_length_173_cov_58.472973	0	78	8	10	78	0.1282051
NODE_302596_length_173_cov_58.472973	0	78	10	1	78	0.0128205
NODE_302596_length_173_cov_58.472973	0	78	12	1	78	0.0128205
NODE_302596_length_173_cov_58.472973	0	78	14	6	78	0.0769231
NODE_302596_length_173_cov_58.472973	0	78	18	1	78	0.0128205
NODE_302596_length_173_cov_58.472973	0	78	24	5	78	0.0641026
NODE_302596_length_173_cov_58.472973	0	78	26	3	78	0.0384615
NODE_302596_length_173_cov_58.472973	0	78	31	1	78	0.0128205
NODE_302596_length_173_cov_58.472973	0	78	32	1	78	0.0128205
NODE_302596_length_173_cov_58.472973	0	78	34	3	78	0.0384615
NODE_302596_length_173_cov_58.472973	0	78	36	12	78	0.1538462
NODE_302597_length_173_cov_57.148649	101	142	86	1	41	0.0243902
NODE_302597_length_173_cov_57.148649	101	142	90	1	41	0.0243902
NODE_302597_length_173_cov_57.148649	101	142	92	1	41	0.0243902
NODE_302597_length_173_cov_57.148649	101	142	93	1	41	0.0243902
NODE_302597_length_173_cov_57.148649	101	142	95	5	41	0.1219512
NODE_302597_length_173_cov_57.148649	101	142	101	1	41	0.0243902
NODE_302597_length_173_cov_57.148649	101	142	111	1	41	0.0243902
NODE_302597_length_173_cov_57.148649	101	142	119	2	41	0.0487805
NODE_302597_length_173_cov_57.148649	101	142	129	2	41	0.0487805
NODE_302597_length_173_cov_57.148649	101	142	130	1	41	0.0243902
NODE_302597_length_173_cov_57.148649	101	142	136	1	41	0.0243902
NODE_302597_length_173_cov_57.148649	101	142	144	2	41	0.0487805
NODE_302597_length_173_cov_57.148649	101	142	148	1	41	0.0243902
NODE_302597_length_173_cov_57.148649	101	142	152	1	41	0.0243902
NODE_302597_length_173_cov_57.148649	101	142	158	2	41	0.0487805
NODE_302597_length_173_cov_57.148649	101	142	160	1	41	0.0243902
NODE_302597_length_173_cov_57.148649	101	142	162	2	41	0.0487805
NODE_302597_length_173_cov_57.148649	101	142	164	2	41	0.0487805
NODE_302597_length_173_cov_57.148649	101	142	168	1	41	0.0243902
NODE_302597_length_173_cov_57.148649	101	142	172	1	41	0.0243902
NODE_302597_length_173_cov_57.148649	101	142	174	1	41	0.0243902
NODE_302597_length_173_cov_57.148649	101	142	176	3	41	0.0731707
NODE_302597_length_173_cov_57.148649	101	142	178	1	41	0.0243902
NODE_302597_length_173_cov_57.148649	101	142	184	5	41	0.1219512
NODE_302597_length_173_cov_57.148649	101	142	190	1	41	0.0243902
NODE_302597_length_173_cov_57.148649	109	173	10	1	64	0.0156250
NODE_302597_length_173_cov_57.148649	109	173	11	2	64	0.0312500
NODE_302597_length_173_cov_57.148649	109	173	15	1	64	0.0156250
NODE_302597_length_173_cov_57.148649	109	173	17	1	64	0.0156250
NODE_302597_length_173_cov_57.148649	109	173	24	2	64	0.0312500
NODE_302597_length_173_cov_57.148649	109	173	26	1	64	0.0156250
NODE_302597_length_173_cov_57.148649	109	173	28	2	64	0.0312500
NODE_302597_length_173_cov_57.148649	109	173	29	3	64	0.0468750
NODE_302597_length_173_cov_57.148649	109	173	31	1	64	0.0156250
NODE_302597_length_173_cov_57.148649	109	173	42	1	64	0.0156250
NODE_302597_length_173_cov_57.148649	109	173	46	1	64	0.0156250
NODE_302597_length_173_cov_57.148649	109	173	48	2	64	0.0312500
NODE_302597_length_173_cov_57.148649	109	173	58	3	64	0.0468750
NODE_302597_length_173_cov_57.148649	109	173	61	2	64	0.0312500
NODE_302597_length_173_cov_57.148649	109	173	65	1	64	0.0156250
NODE_302597_length_173_cov_57.148649	109	173	68	1	64	0.0156250
NODE_302597_length_173_cov_57.148649	109	173	77	1	64	0.0156250
NODE_302597_length_173_cov_57.148649	109	173	82	3	64	0.0468750
NODE_302597_length_173_cov_57.148649	109	173	83	1	64	0.0156250
NODE_302597_length_173_cov_57.148649	109	173	86	2	64	0.0312500
NODE_302597_length_173_cov_57.148649	109	173	90	1	64	0.0156250
NODE_302597_length_173_cov_57.148649	109	173	92	1	64	0.0156250
NODE_302597_length_173_cov_57.148649	109	173	93	1	64	0.0156250
NODE_302597_length_173_cov_57.148649	109	173	95	5	64	0.0781250
NODE_302597_length_173_cov_57.148649	109	173	101	1	64	0.0156250
NODE_302597_length_173_cov_57.148649	109	173	111	1	64	0.0156250
NODE_302597_length_173_cov_57.148649	109	173	119	2	64	0.0312500
NODE_302597_length_173_cov_57.148649	109	173	129	2	64	0.0312500
NODE_302597_length_173_cov_57.148649	109	173	130	1	64	0.0156250
NODE_302597_length_173_cov_57.148649	109	173	136	1	64	0.0156250
NODE_302597_length_173_cov_57.148649	109	173	144	2	64	0.0312500
NODE_302597_length_173_cov_57.148649	109	173	148	1	64	0.0156250
NODE_302597_length_173_cov_57.148649	109	173	152	1	64	0.0156250
NODE_302597_length_173_cov_57.148649	109	173	158	2	64	0.0312500
NODE_302597_length_173_cov_57.148649	109	173	160	1	64	0.0156250
NODE_302597_length_173_cov_57.148649	109	173	162	2	64	0.0312500
NODE_302597_length_173_cov_57.148649	109	173	164	2	64	0.0312500
NODE_302597_length_173_cov_57.148649	109	173	168	1	64	0.0156250
NODE_302597_length_173_cov_57.148649	109	173	172	1	64	0.0156250
NODE_302597_length_173_cov_57.148649	109	173	174	1	64	0.0156250
NODE_302597_length_173_cov_57.148649	109	173	176	2	64	0.0312500
NODE_302686_length_171_cov_218.666667	12	90	12	5	78	0.0641026
NODE_302686_length_171_cov_218.666667	12	90	16	1	78	0.0128205
NODE_302686_length_171_cov_218.666667	12	90	18	1	78	0.0128205
NODE_302686_length_171_cov_218.666667	12	90	26	21	78	0.2692308
NODE_302686_length_171_cov_218.666667	12	90	32	1	78	0.0128205
NODE_302686_length_171_cov_218.666667	12	90	34	1	78	0.0128205
NODE_302686_length_171_cov_218.666667	12	90	38	1	78	0.0128205
NODE_302686_length_171_cov_218.666667	12	90	42	1	78	0.0128205
NODE_302686_length_171_cov_218.666667	12	90	48	9	78	0.1153846
NODE_302686_length_171_cov_218.666667	12	90	50	11	78	0.1410256
NODE_302686_length_171_cov_218.666667	12	90	52	1	78	0.0128205
NODE_302686_length_171_cov_218.666667	12	90	56	25	78	0.3205128
NODE_302686_length_171_cov_218.666667	12	90	12	5	78	0.0641026
NODE_302686_length_171_cov_218.666667	12	90	16	1	78	0.0128205
NODE_302686_length_171_cov_218.666667	12	90	18	1	78	0.0128205
NODE_302686_length_171_cov_218.666667	12	90	26	21	78	0.2692308
NODE_302686_length_171_cov_218.666667	12	90	32	1	78	0.0128205
NODE_302686_length_171_cov_218.666667	12	90	34	1	78	0.0128205
NODE_302686_length_171_cov_218.666667	12	90	38	1	78	0.0128205
NODE_302686_length_171_cov_218.666667	12	90	42	1	78	0.0128205
NODE_302686_length_171_cov_218.666667	12	90	48	9	78	0.1153846
NODE_302686_length_171_cov_218.666667	12	90	50	11	78	0.1410256
NODE_302686_length_171_cov_218.666667	12	90	52	1	78	0.0128205
NODE_302686_length_171_cov_218.666667	12	90	56	25	78	0.3205128
NODE_302686_length_171_cov_218.666667	21	90	26	19	69	0.2753623
NODE_302686_length_171_cov_218.666667	21	90	32	1	69	0.0144928
NODE_302686_length_171_cov_218.666667	21	90	34	1	69	0.0144928
NODE_302686_length_171_cov_218.666667	21	90	38	1	69	0.0144928
NODE_302686_length_171_cov_218.666667	21	90	42	1	69	0.0144928
NODE_302686_length_171_cov_218.666667	21	90	48	9	69	0.1304348
NODE_302686_length_171_cov_218.666667	21	90	50	11	69	0.1594203
NODE_302686_length_171_cov_218.666667	21	90	52	1	69	0.0144928
NODE_302686_length_171_cov_218.666667	21	90	56	25	69	0.3623188
NODE_302689_length_171_cov_110.194444	81	161	0	5	80	0.0625000
NODE_302689_length_171_cov_110.194444	81	161	2	4	80	0.0500000
NODE_302689_length_171_cov_110.194444	81	161	4	71	80	0.8875000
NODE_302689_length_171_cov_110.194444	81	152	4	71	71	1.0000000
NODE_302691_length_171_cov_86.013889	106	171	0	17	65	0.2615385
NODE_302691_length_171_cov_86.013889	106	171	2	18	65	0.2769231
NODE_302691_length_171_cov_86.013889	106	171	4	30	65	0.4615385
NODE_302697_length_171_cov_46.430556	0	59	10	1	59	0.0169492
NODE_302697_length_171_cov_46.430556	0	59	14	1	59	0.0169492
NODE_302697_length_171_cov_46.430556	0	59	23	2	59	0.0338983
NODE_302697_length_171_cov_46.430556	0	59	25	1	59	0.0169492
NODE_302697_length_171_cov_46.430556	0	59	29	1	59	0.0169492
NODE_302697_length_171_cov_46.430556	0	59	32	1	59	0.0169492
NODE_302697_length_171_cov_46.430556	0	59	36	2	59	0.0338983
NODE_302697_length_171_cov_46.430556	0	59	38	1	59	0.0169492
NODE_302697_length_171_cov_46.430556	0	59	42	1	59	0.0169492
NODE_302697_length_171_cov_46.430556	0	59	46	1	59	0.0169492
NODE_302697_length_171_cov_46.430556	0	59	48	1	59	0.0169492
NODE_302697_length_171_cov_46.430556	0	59	52	1	59	0.0169492
NODE_302697_length_171_cov_46.430556	0	59	53	1	59	0.0169492
NODE_302697_length_171_cov_46.430556	0	59	57	2	59	0.0338983
NODE_302697_length_171_cov_46.430556	0	59	59	1	59	0.0169492
NODE_302697_length_171_cov_46.430556	0	59	60	2	59	0.0338983
NODE_302697_length_171_cov_46.430556	0	59	62	1	59	0.0169492
NODE_302697_length_171_cov_46.430556	0	59	64	2	59	0.0338983
NODE_302697_length_171_cov_46.430556	0	59	66	2	59	0.0338983
NODE_302697_length_171_cov_46.430556	0	59	68	1	59	0.0169492
NODE_302697_length_171_cov_46.430556	0	59	70	2	59	0.0338983
NODE_302697_length_171_cov_46.430556	0	59	72	1	59	0.0169492
NODE_302697_length_171_cov_46.430556	0	59	74	1	59	0.0169492
NODE_302697_length_171_cov_46.430556	0	59	84	3	59	0.0508475
NODE_302697_length_171_cov_46.430556	0	59	90	1	59	0.0169492
NODE_302697_length_171_cov_46.430556	0	59	96	1	59	0.0169492
NODE_302697_length_171_cov_46.430556	0	59	102	3	59	0.0508475
NODE_302697_length_171_cov_46.430556	0	59	106	1	59	0.0169492
NODE_302697_length_171_cov_46.430556	0	59	108	1	59	0.0169492
NODE_302697_length_171_cov_46.430556	0	59	112	1	59	0.0169492
NODE_302697_length_171_cov_46.430556	0	59	114	3	59	0.0508475
NODE_302697_length_171_cov_46.430556	0	59	116	1	59	0.0169492
NODE_302697_length_171_cov_46.430556	0	59	118	1	59	0.0169492
NODE_302697_length_171_cov_46.430556	0	59	120	1	59	0.0169492
NODE_302697_length_171_cov_46.430556	0	59	122	3	59	0.0508475
NODE_302697_length_171_cov_46.430556	0	59	124	4	59	0.0677966
NODE_302697_length_171_cov_46.430556	0	59	126	1	59	0.0169492
NODE_302697_length_171_cov_46.430556	0	59	128	3	59	0.0508475
NODE_302697_length_171_cov_46.430556	0	59	134	1	59	0.0169492
NODE_302697_length_171_cov_46.430556	32	98	84	1	66	0.0151515
NODE_302697_length_171_cov_46.430556	32	98	90	1	66	0.0151515
NODE_302697_length_171_cov_46.430556	32	98	96	1	66	0.0151515
NODE_302697_length_171_cov_46.430556	32	98	102	3	66	0.0454545
NODE_302697_length_171_cov_46.430556	32	98	106	1	66	0.0151515
NODE_302697_length_171_cov_46.430556	32	98	108	1	66	0.0151515
NODE_302697_length_171_cov_46.430556	32	98	112	1	66	0.0151515
NODE_302697_length_171_cov_46.430556	32	98	114	3	66	0.0454545
NODE_302697_length_171_cov_46.430556	32	98	116	1	66	0.0151515
NODE_302697_length_171_cov_46.430556	32	98	118	1	66	0.0151515
NODE_302697_length_171_cov_46.430556	32	98	120	1	66	0.0151515
NODE_302697_length_171_cov_46.430556	32	98	122	3	66	0.0454545
NODE_302697_length_171_cov_46.430556	32	98	124	4	66	0.0606061
NODE_302697_length_171_cov_46.430556	32	98	126	1	66	0.0151515
NODE_302697_length_171_cov_46.430556	32	98	128	3	66	0.0454545
NODE_302697_length_171_cov_46.430556	32	98	134	2	66	0.0303030
NODE_302697_length_171_cov_46.430556	32	98	136	1	66	0.0151515
NODE_302697_length_171_cov_46.430556	32	98	138	4	66	0.0606061
NODE_302697_length_171_cov_46.430556	32	98	141	1	66	0.0151515
NODE_302697_length_171_cov_46.430556	32	98	142	1	66	0.0151515
NODE_302697_length_171_cov_46.430556	32	98	144	31	66	0.4696970
NODE_302700_length_171_cov_40.069444	13	87	0	74	74	1.0000000
NODE_302702_length_171_cov_33.319444	84	158	0	15	74	0.2027027
NODE_302702_length_171_cov_33.319444	84	158	4	9	74	0.1216216
NODE_302702_length_171_cov_33.319444	84	158	6	6	74	0.0810811
NODE_302702_length_171_cov_33.319444	84	158	10	8	74	0.1081081
NODE_302702_length_171_cov_33.319444	84	158	12	36	74	0.4864865
NODE_302764_length_170_cov_217.422535	10	90	17	2	80	0.0250000
NODE_302764_length_170_cov_217.422535	10	90	21	2	80	0.0250000
NODE_302764_length_170_cov_217.422535	10	90	23	1	80	0.0125000
NODE_302764_length_170_cov_217.422535	10	90	24	1	80	0.0125000
NODE_302764_length_170_cov_217.422535	10	90	28	1	80	0.0125000
NODE_302764_length_170_cov_217.422535	10	90	32	1	80	0.0125000
NODE_302764_length_170_cov_217.422535	10	90	36	1	80	0.0125000
NODE_302764_length_170_cov_217.422535	10	90	44	1	80	0.0125000
NODE_302764_length_170_cov_217.422535	10	90	48	1	80	0.0125000
NODE_302764_length_170_cov_217.422535	10	90	49	1	80	0.0125000
NODE_302764_length_170_cov_217.422535	10	90	52	2	80	0.0250000
NODE_302764_length_170_cov_217.422535	10	90	54	1	80	0.0125000
NODE_302764_length_170_cov_217.422535	10	90	58	5	80	0.0625000
NODE_302764_length_170_cov_217.422535	10	90	66	2	80	0.0250000
NODE_302764_length_170_cov_217.422535	10	90	68	2	80	0.0250000
NODE_302764_length_170_cov_217.422535	10	90	74	2	80	0.0250000
NODE_302764_length_170_cov_217.422535	10	90	76	2	80	0.0250000
NODE_302764_length_170_cov_217.422535	10	90	78	3	80	0.0375000
NODE_302764_length_170_cov_217.422535	10	90	82	1	80	0.0125000
NODE_302764_length_170_cov_217.422535	10	90	86	2	80	0.0250000
NODE_302764_length_170_cov_217.422535	10	90	94	1	80	0.0125000
NODE_302764_length_170_cov_217.422535	10	90	98	2	80	0.0250000
NODE_302764_length_170_cov_217.422535	10	90	102	1	80	0.0125000
NODE_302764_length_170_cov_217.422535	10	90	105	1	80	0.0125000
NODE_302764_length_170_cov_217.422535	10	90	110	3	80	0.0375000
NODE_302764_length_170_cov_217.422535	10	90	114	2	80	0.0250000
NODE_302764_length_170_cov_217.422535	10	90	122	2	80	0.0250000
NODE_302764_length_170_cov_217.422535	10	90	123	2	80	0.0250000
NODE_302764_length_170_cov_217.422535	10	90	125	1	80	0.0125000
NODE_302764_length_170_cov_217.422535	10	90	129	1	80	0.0125000
NODE_302764_length_170_cov_217.422535	10	90	137	1	80	0.0125000
NODE_302764_length_170_cov_217.422535	10	90	141	1	80	0.0125000
NODE_302764_length_170_cov_217.422535	10	90	145	1	80	0.0125000
NODE_302764_length_170_cov_217.422535	10	90	147	2	80	0.0250000
NODE_302764_length_170_cov_217.422535	10	90	149	4	80	0.0500000
NODE_302764_length_170_cov_217.422535	10	90	150	21	80	0.2625000
NODE_302764_length_170_cov_217.422535	10	90	17	2	80	0.0250000
NODE_302764_length_170_cov_217.422535	10	90	21	2	80	0.0250000
NODE_302764_length_170_cov_217.422535	10	90	23	1	80	0.0125000
NODE_302764_length_170_cov_217.422535	10	90	24	1	80	0.0125000
NODE_302764_length_170_cov_217.422535	10	90	28	1	80	0.0125000
NODE_302764_length_170_cov_217.422535	10	90	32	1	80	0.0125000
NODE_302764_length_170_cov_217.422535	10	90	36	1	80	0.0125000
NODE_302764_length_170_cov_217.422535	10	90	44	1	80	0.0125000
NODE_302764_length_170_cov_217.422535	10	90	48	1	80	0.0125000
NODE_302764_length_170_cov_217.422535	10	90	49	1	80	0.0125000
NODE_302764_length_170_cov_217.422535	10	90	52	2	80	0.0250000
NODE_302764_length_170_cov_217.422535	10	90	54	1	80	0.0125000
NODE_302764_length_170_cov_217.422535	10	90	58	5	80	0.0625000
NODE_302764_length_170_cov_217.422535	10	90	66	2	80	0.0250000
NODE_302764_length_170_cov_217.422535	10	90	68	2	80	0.0250000
NODE_302764_length_170_cov_217.422535	10	90	74	2	80	0.0250000
NODE_302764_length_170_cov_217.422535	10	90	76	2	80	0.0250000
NODE_302764_length_170_cov_217.422535	10	90	78	3	80	0.0375000
NODE_302764_length_170_cov_217.422535	10	90	82	1	80	0.0125000
NODE_302764_length_170_cov_217.422535	10	90	86	2	80	0.0250000
NODE_302764_length_170_cov_217.422535	10	90	94	1	80	0.0125000
NODE_302764_length_170_cov_217.422535	10	90	98	2	80	0.0250000
NODE_302764_length_170_cov_217.422535	10	90	102	1	80	0.0125000
NODE_302764_length_170_cov_217.422535	10	90	105	1	80	0.0125000
NODE_302764_length_170_cov_217.422535	10	90	110	3	80	0.0375000
NODE_302764_length_170_cov_217.422535	10	90	114	2	80	0.0250000
NODE_302764_length_170_cov_217.422535	10	90	122	2	80	0.0250000
NODE_302764_length_170_cov_217.422535	10	90	123	2	80	0.0250000
NODE_302764_length_170_cov_217.422535	10	90	125	1	80	0.0125000
NODE_302764_length_170_cov_217.422535	10	90	129	1	80	0.0125000
NODE_302764_length_170_cov_217.422535	10	90	137	1	80	0.0125000
NODE_302764_length_170_cov_217.422535	10	90	141	1	80	0.0125000
NODE_302764_length_170_cov_217.422535	10	90	145	1	80	0.0125000
NODE_302764_length_170_cov_217.422535	10	90	147	2	80	0.0250000
NODE_302764_length_170_cov_217.422535	10	90	149	4	80	0.0500000
NODE_302764_length_170_cov_217.422535	10	90	150	21	80	0.2625000
NODE_302764_length_170_cov_217.422535	10	90	17	2	80	0.0250000
NODE_302764_length_170_cov_217.422535	10	90	21	2	80	0.0250000
NODE_302764_length_170_cov_217.422535	10	90	23	1	80	0.0125000
NODE_302764_length_170_cov_217.422535	10	90	24	1	80	0.0125000
NODE_302764_length_170_cov_217.422535	10	90	28	1	80	0.0125000
NODE_302764_length_170_cov_217.422535	10	90	32	1	80	0.0125000
NODE_302764_length_170_cov_217.422535	10	90	36	1	80	0.0125000
NODE_302764_length_170_cov_217.422535	10	90	44	1	80	0.0125000
NODE_302764_length_170_cov_217.422535	10	90	48	1	80	0.0125000
NODE_302764_length_170_cov_217.422535	10	90	49	1	80	0.0125000
NODE_302764_length_170_cov_217.422535	10	90	52	2	80	0.0250000
NODE_302764_length_170_cov_217.422535	10	90	54	1	80	0.0125000
NODE_302764_length_170_cov_217.422535	10	90	58	5	80	0.0625000
NODE_302764_length_170_cov_217.422535	10	90	66	2	80	0.0250000
NODE_302764_length_170_cov_217.422535	10	90	68	2	80	0.0250000
NODE_302764_length_170_cov_217.422535	10	90	74	2	80	0.0250000
NODE_302764_length_170_cov_217.422535	10	90	76	2	80	0.0250000
NODE_302764_length_170_cov_217.422535	10	90	78	3	80	0.0375000
NODE_302764_length_170_cov_217.422535	10	90	82	1	80	0.0125000
NODE_302764_length_170_cov_217.422535	10	90	86	2	80	0.0250000
NODE_302764_length_170_cov_217.422535	10	90	94	1	80	0.0125000
NODE_302764_length_170_cov_217.422535	10	90	98	2	80	0.0250000
NODE_302764_length_170_cov_217.422535	10	90	102	1	80	0.0125000
NODE_302764_length_170_cov_217.422535	10	90	105	1	80	0.0125000
NODE_302764_length_170_cov_217.422535	10	90	110	3	80	0.0375000
NODE_302764_length_170_cov_217.422535	10	90	114	2	80	0.0250000
NODE_302764_length_170_cov_217.422535	10	90	122	2	80	0.0250000
NODE_302764_length_170_cov_217.422535	10	90	123	2	80	0.0250000
NODE_302764_length_170_cov_217.422535	10	90	125	1	80	0.0125000
NODE_302764_length_170_cov_217.422535	10	90	129	1	80	0.0125000
NODE_302764_length_170_cov_217.422535	10	90	137	1	80	0.0125000
NODE_302764_length_170_cov_217.422535	10	90	141	1	80	0.0125000
NODE_302764_length_170_cov_217.422535	10	90	145	1	80	0.0125000
NODE_302764_length_170_cov_217.422535	10	90	147	2	80	0.0250000
NODE_302764_length_170_cov_217.422535	10	90	149	4	80	0.0500000
NODE_302764_length_170_cov_217.422535	10	90	150	21	80	0.2625000
NODE_302764_length_170_cov_217.422535	10	90	17	2	80	0.0250000
NODE_302764_length_170_cov_217.422535	10	90	21	2	80	0.0250000
NODE_302764_length_170_cov_217.422535	10	90	23	1	80	0.0125000
NODE_302764_length_170_cov_217.422535	10	90	24	1	80	0.0125000
NODE_302764_length_170_cov_217.422535	10	90	28	1	80	0.0125000
NODE_302764_length_170_cov_217.422535	10	90	32	1	80	0.0125000
NODE_302764_length_170_cov_217.422535	10	90	36	1	80	0.0125000
NODE_302764_length_170_cov_217.422535	10	90	44	1	80	0.0125000
NODE_302764_length_170_cov_217.422535	10	90	48	1	80	0.0125000
NODE_302764_length_170_cov_217.422535	10	90	49	1	80	0.0125000
NODE_302764_length_170_cov_217.422535	10	90	52	2	80	0.0250000
NODE_302764_length_170_cov_217.422535	10	90	54	1	80	0.0125000
NODE_302764_length_170_cov_217.422535	10	90	58	5	80	0.0625000
NODE_302764_length_170_cov_217.422535	10	90	66	2	80	0.0250000
NODE_302764_length_170_cov_217.422535	10	90	68	2	80	0.0250000
NODE_302764_length_170_cov_217.422535	10	90	74	2	80	0.0250000
NODE_302764_length_170_cov_217.422535	10	90	76	2	80	0.0250000
NODE_302764_length_170_cov_217.422535	10	90	78	3	80	0.0375000
NODE_302764_length_170_cov_217.422535	10	90	82	1	80	0.0125000
NODE_302764_length_170_cov_217.422535	10	90	86	2	80	0.0250000
NODE_302764_length_170_cov_217.422535	10	90	94	1	80	0.0125000
NODE_302764_length_170_cov_217.422535	10	90	98	2	80	0.0250000
NODE_302764_length_170_cov_217.422535	10	90	102	1	80	0.0125000
NODE_302764_length_170_cov_217.422535	10	90	105	1	80	0.0125000
NODE_302764_length_170_cov_217.422535	10	90	110	3	80	0.0375000
NODE_302764_length_170_cov_217.422535	10	90	114	2	80	0.0250000
NODE_302764_length_170_cov_217.422535	10	90	122	2	80	0.0250000
NODE_302764_length_170_cov_217.422535	10	90	123	2	80	0.0250000
NODE_302764_length_170_cov_217.422535	10	90	125	1	80	0.0125000
NODE_302764_length_170_cov_217.422535	10	90	129	1	80	0.0125000
NODE_302764_length_170_cov_217.422535	10	90	137	1	80	0.0125000
NODE_302764_length_170_cov_217.422535	10	90	141	1	80	0.0125000
NODE_302764_length_170_cov_217.422535	10	90	145	1	80	0.0125000
NODE_302764_length_170_cov_217.422535	10	90	147	2	80	0.0250000
NODE_302764_length_170_cov_217.422535	10	90	149	4	80	0.0500000
NODE_302764_length_170_cov_217.422535	10	90	150	21	80	0.2625000
NODE_302764_length_170_cov_217.422535	10	90	17	2	80	0.0250000
NODE_302764_length_170_cov_217.422535	10	90	21	2	80	0.0250000
NODE_302764_length_170_cov_217.422535	10	90	23	1	80	0.0125000
NODE_302764_length_170_cov_217.422535	10	90	24	1	80	0.0125000
NODE_302764_length_170_cov_217.422535	10	90	28	1	80	0.0125000
NODE_302764_length_170_cov_217.422535	10	90	32	1	80	0.0125000
NODE_302764_length_170_cov_217.422535	10	90	36	1	80	0.0125000
NODE_302764_length_170_cov_217.422535	10	90	44	1	80	0.0125000
NODE_302764_length_170_cov_217.422535	10	90	48	1	80	0.0125000
NODE_302764_length_170_cov_217.422535	10	90	49	1	80	0.0125000
NODE_302764_length_170_cov_217.422535	10	90	52	2	80	0.0250000
NODE_302764_length_170_cov_217.422535	10	90	54	1	80	0.0125000
NODE_302764_length_170_cov_217.422535	10	90	58	5	80	0.0625000
NODE_302764_length_170_cov_217.422535	10	90	66	2	80	0.0250000
NODE_302764_length_170_cov_217.422535	10	90	68	2	80	0.0250000
NODE_302764_length_170_cov_217.422535	10	90	74	2	80	0.0250000
NODE_302764_length_170_cov_217.422535	10	90	76	2	80	0.0250000
NODE_302764_length_170_cov_217.422535	10	90	78	3	80	0.0375000
NODE_302764_length_170_cov_217.422535	10	90	82	1	80	0.0125000
NODE_302764_length_170_cov_217.422535	10	90	86	2	80	0.0250000
NODE_302764_length_170_cov_217.422535	10	90	94	1	80	0.0125000
NODE_302764_length_170_cov_217.422535	10	90	98	2	80	0.0250000
NODE_302764_length_170_cov_217.422535	10	90	102	1	80	0.0125000
NODE_302764_length_170_cov_217.422535	10	90	105	1	80	0.0125000
NODE_302764_length_170_cov_217.422535	10	90	110	3	80	0.0375000
NODE_302764_length_170_cov_217.422535	10	90	114	2	80	0.0250000
NODE_302764_length_170_cov_217.422535	10	90	122	2	80	0.0250000
NODE_302764_length_170_cov_217.422535	10	90	123	2	80	0.0250000
NODE_302764_length_170_cov_217.422535	10	90	125	1	80	0.0125000
NODE_302764_length_170_cov_217.422535	10	90	129	1	80	0.0125000
NODE_302764_length_170_cov_217.422535	10	90	137	1	80	0.0125000
NODE_302764_length_170_cov_217.422535	10	90	141	1	80	0.0125000
NODE_302764_length_170_cov_217.422535	10	90	145	1	80	0.0125000
NODE_302764_length_170_cov_217.422535	10	90	147	2	80	0.0250000
NODE_302764_length_170_cov_217.422535	10	90	149	4	80	0.0500000
NODE_302764_length_170_cov_217.422535	10	90	150	21	80	0.2625000
NODE_302764_length_170_cov_217.422535	19	90	44	1	71	0.0140845
NODE_302764_length_170_cov_217.422535	19	90	48	1	71	0.0140845
NODE_302764_length_170_cov_217.422535	19	90	49	1	71	0.0140845
NODE_302764_length_170_cov_217.422535	19	90	52	2	71	0.0281690
NODE_302764_length_170_cov_217.422535	19	90	54	1	71	0.0140845
NODE_302764_length_170_cov_217.422535	19	90	58	5	71	0.0704225
NODE_302764_length_170_cov_217.422535	19	90	66	2	71	0.0281690
NODE_302764_length_170_cov_217.422535	19	90	68	2	71	0.0281690
NODE_302764_length_170_cov_217.422535	19	90	74	2	71	0.0281690
NODE_302764_length_170_cov_217.422535	19	90	76	2	71	0.0281690
NODE_302764_length_170_cov_217.422535	19	90	78	3	71	0.0422535
NODE_302764_length_170_cov_217.422535	19	90	82	1	71	0.0140845
NODE_302764_length_170_cov_217.422535	19	90	86	2	71	0.0281690
NODE_302764_length_170_cov_217.422535	19	90	94	1	71	0.0140845
NODE_302764_length_170_cov_217.422535	19	90	98	2	71	0.0281690
NODE_302764_length_170_cov_217.422535	19	90	102	1	71	0.0140845
NODE_302764_length_170_cov_217.422535	19	90	105	1	71	0.0140845
NODE_302764_length_170_cov_217.422535	19	90	110	3	71	0.0422535
NODE_302764_length_170_cov_217.422535	19	90	114	2	71	0.0281690
NODE_302764_length_170_cov_217.422535	19	90	122	2	71	0.0281690
NODE_302764_length_170_cov_217.422535	19	90	123	2	71	0.0281690
NODE_302764_length_170_cov_217.422535	19	90	125	1	71	0.0140845
NODE_302764_length_170_cov_217.422535	19	90	129	1	71	0.0140845
NODE_302764_length_170_cov_217.422535	19	90	137	1	71	0.0140845
NODE_302764_length_170_cov_217.422535	19	90	141	1	71	0.0140845
NODE_302764_length_170_cov_217.422535	19	90	145	1	71	0.0140845
NODE_302764_length_170_cov_217.422535	19	90	147	2	71	0.0281690
NODE_302764_length_170_cov_217.422535	19	90	149	4	71	0.0563380
NODE_302764_length_170_cov_217.422535	19	90	150	21	71	0.2957746
NODE_302764_length_170_cov_217.422535	63	126	130	1	63	0.0158730
NODE_302764_length_170_cov_217.422535	63	126	134	1	63	0.0158730
NODE_302764_length_170_cov_217.422535	63	126	136	3	63	0.0476190
NODE_302764_length_170_cov_217.422535	63	126	138	1	63	0.0158730
NODE_302764_length_170_cov_217.422535	63	126	142	9	63	0.1428571
NODE_302764_length_170_cov_217.422535	63	126	144	2	63	0.0317460
NODE_302764_length_170_cov_217.422535	63	126	146	1	63	0.0158730
NODE_302764_length_170_cov_217.422535	63	126	147	2	63	0.0317460
NODE_302764_length_170_cov_217.422535	63	126	148	2	63	0.0317460
NODE_302764_length_170_cov_217.422535	63	126	149	4	63	0.0634921
NODE_302764_length_170_cov_217.422535	63	126	150	37	63	0.5873016
NODE_302764_length_170_cov_217.422535	63	126	130	1	63	0.0158730
NODE_302764_length_170_cov_217.422535	63	126	134	1	63	0.0158730
NODE_302764_length_170_cov_217.422535	63	126	136	3	63	0.0476190
NODE_302764_length_170_cov_217.422535	63	126	138	1	63	0.0158730
NODE_302764_length_170_cov_217.422535	63	126	142	9	63	0.1428571
NODE_302764_length_170_cov_217.422535	63	126	144	2	63	0.0317460
NODE_302764_length_170_cov_217.422535	63	126	146	1	63	0.0158730
NODE_302764_length_170_cov_217.422535	63	126	147	2	63	0.0317460
NODE_302764_length_170_cov_217.422535	63	126	148	2	63	0.0317460
NODE_302764_length_170_cov_217.422535	63	126	149	4	63	0.0634921
NODE_302764_length_170_cov_217.422535	63	126	150	37	63	0.5873016
NODE_302768_length_170_cov_102.816901	23	86	20	1	63	0.0158730
NODE_302768_length_170_cov_102.816901	23	86	39	3	63	0.0476190
NODE_302768_length_170_cov_102.816901	23	86	41	6	63	0.0952381
NODE_302768_length_170_cov_102.816901	23	86	43	3	63	0.0476190
NODE_302768_length_170_cov_102.816901	23	86	45	5	63	0.0793651
NODE_302768_length_170_cov_102.816901	23	86	47	1	63	0.0158730
NODE_302768_length_170_cov_102.816901	23	86	49	1	63	0.0158730
NODE_302768_length_170_cov_102.816901	23	86	53	13	63	0.2063492
NODE_302768_length_170_cov_102.816901	23	86	59	11	63	0.1746032
NODE_302768_length_170_cov_102.816901	23	86	61	19	63	0.3015873
NODE_302806_length_169_cov_47.757143	70	150	55	2	80	0.0250000
NODE_302806_length_169_cov_47.757143	70	150	66	1	80	0.0125000
NODE_302806_length_169_cov_47.757143	70	150	67	3	80	0.0375000
NODE_302806_length_169_cov_47.757143	70	150	71	12	80	0.1500000
NODE_302806_length_169_cov_47.757143	70	150	73	4	80	0.0500000
NODE_302806_length_169_cov_47.757143	70	150	75	1	80	0.0125000
NODE_302806_length_169_cov_47.757143	70	150	81	8	80	0.1000000
NODE_302806_length_169_cov_47.757143	70	150	82	12	80	0.1500000
NODE_302806_length_169_cov_47.757143	70	150	84	37	80	0.4625000
NODE_302869_length_168_cov_10.391304	66	99	0	33	33	1.0000000
NODE_302869_length_168_cov_10.391304	135	168	0	33	33	1.0000000
NODE_302966_length_166_cov_401.149254	31	109	66	2	78	0.0256410
NODE_302966_length_166_cov_401.149254	31	109	68	2	78	0.0256410
NODE_302966_length_166_cov_401.149254	31	109	70	2	78	0.0256410
NODE_302966_length_166_cov_401.149254	31	109	76	1	78	0.0128205
NODE_302966_length_166_cov_401.149254	31	109	80	1	78	0.0128205
NODE_302966_length_166_cov_401.149254	31	109	82	2	78	0.0256410
NODE_302966_length_166_cov_401.149254	31	109	95	1	78	0.0128205
NODE_302966_length_166_cov_401.149254	31	109	97	1	78	0.0128205
NODE_302966_length_166_cov_401.149254	31	109	115	1	78	0.0128205
NODE_302966_length_166_cov_401.149254	31	109	118	2	78	0.0256410
NODE_302966_length_166_cov_401.149254	31	109	120	3	78	0.0384615
NODE_302966_length_166_cov_401.149254	31	109	124	1	78	0.0128205
NODE_302966_length_166_cov_401.149254	31	109	132	1	78	0.0128205
NODE_302966_length_166_cov_401.149254	31	109	135	1	78	0.0128205
NODE_302966_length_166_cov_401.149254	31	109	136	1	78	0.0128205
NODE_302966_length_166_cov_401.149254	31	109	138	4	78	0.0512821
NODE_302966_length_166_cov_401.149254	31	109	144	5	78	0.0641026
NODE_302966_length_166_cov_401.149254	31	109	146	1	78	0.0128205
NODE_302966_length_166_cov_401.149254	31	109	150	3	78	0.0384615
NODE_302966_length_166_cov_401.149254	31	109	152	2	78	0.0256410
NODE_302966_length_166_cov_401.149254	31	109	154	1	78	0.0128205
NODE_302966_length_166_cov_401.149254	31	109	156	40	78	0.5128205
NODE_302966_length_166_cov_401.149254	82	157	22	3	75	0.0400000
NODE_302966_length_166_cov_401.149254	82	157	24	4	75	0.0533333
NODE_302966_length_166_cov_401.149254	82	157	28	2	75	0.0266667
NODE_302966_length_166_cov_401.149254	82	157	32	1	75	0.0133333
NODE_302966_length_166_cov_401.149254	82	157	42	1	75	0.0133333
NODE_302966_length_166_cov_401.149254	82	157	44	1	75	0.0133333
NODE_302966_length_166_cov_401.149254	82	157	54	1	75	0.0133333
NODE_302966_length_166_cov_401.149254	82	157	56	1	75	0.0133333
NODE_302966_length_166_cov_401.149254	82	157	58	1	75	0.0133333
NODE_302966_length_166_cov_401.149254	82	157	60	3	75	0.0400000
NODE_302966_length_166_cov_401.149254	82	157	68	2	75	0.0266667
NODE_302966_length_166_cov_401.149254	82	157	70	1	75	0.0133333
NODE_302966_length_166_cov_401.149254	82	157	82	2	75	0.0266667
NODE_302966_length_166_cov_401.149254	82	157	84	1	75	0.0133333
NODE_302966_length_166_cov_401.149254	82	157	90	1	75	0.0133333
NODE_302966_length_166_cov_401.149254	82	157	94	2	75	0.0266667
NODE_302966_length_166_cov_401.149254	82	157	96	2	75	0.0266667
NODE_302966_length_166_cov_401.149254	82	157	98	1	75	0.0133333
NODE_302966_length_166_cov_401.149254	82	157	100	1	75	0.0133333
NODE_302966_length_166_cov_401.149254	82	157	102	1	75	0.0133333
NODE_302966_length_166_cov_401.149254	82	157	106	1	75	0.0133333
NODE_302966_length_166_cov_401.149254	82	157	108	1	75	0.0133333
NODE_302966_length_166_cov_401.149254	82	157	112	2	75	0.0266667
NODE_302966_length_166_cov_401.149254	82	157	114	1	75	0.0133333
NODE_302966_length_166_cov_401.149254	82	157	118	1	75	0.0133333
NODE_302966_length_166_cov_401.149254	82	157	120	2	75	0.0266667
NODE_302966_length_166_cov_401.149254	82	157	122	1	75	0.0133333
NODE_302966_length_166_cov_401.149254	82	157	126	1	75	0.0133333
NODE_302966_length_166_cov_401.149254	82	157	134	3	75	0.0400000
NODE_302966_length_166_cov_401.149254	82	157	136	1	75	0.0133333
NODE_302966_length_166_cov_401.149254	82	157	138	1	75	0.0133333
NODE_302966_length_166_cov_401.149254	82	157	142	1	75	0.0133333
NODE_302966_length_166_cov_401.149254	82	157	144	3	75	0.0400000
NODE_302966_length_166_cov_401.149254	82	157	150	2	75	0.0266667
NODE_302966_length_166_cov_401.149254	82	157	154	1	75	0.0133333
NODE_302966_length_166_cov_401.149254	82	157	156	21	75	0.2800000
NODE_302974_length_166_cov_123.223881	46	97	26	3	51	0.0588235
NODE_302974_length_166_cov_123.223881	46	97	30	7	51	0.1372549
NODE_302974_length_166_cov_123.223881	46	97	32	41	51	0.8039216
NODE_303071_length_164_cov_154.076923	0	75	0	75	75	1.0000000
NODE_303071_length_164_cov_154.076923	48	128	0	80	80	1.0000000
NODE_303074_length_164_cov_69.369231	0	64	0	31	64	0.4843750
NODE_303074_length_164_cov_69.369231	0	64	2	33	64	0.5156250
NODE_303079_length_164_cov_43.923077	36	100	58	5	64	0.0781250
NODE_303079_length_164_cov_43.923077	36	100	60	1	64	0.0156250
NODE_303079_length_164_cov_43.923077	36	100	62	7	64	0.1093750
NODE_303079_length_164_cov_43.923077	36	100	64	1	64	0.0156250
NODE_303079_length_164_cov_43.923077	36	100	66	50	64	0.7812500
NODE_303079_length_164_cov_43.923077	36	100	58	5	64	0.0781250
NODE_303079_length_164_cov_43.923077	36	100	60	1	64	0.0156250
NODE_303079_length_164_cov_43.923077	36	100	62	7	64	0.1093750
NODE_303079_length_164_cov_43.923077	36	100	64	1	64	0.0156250
NODE_303079_length_164_cov_43.923077	36	100	66	50	64	0.7812500
NODE_303079_length_164_cov_43.923077	73	153	21	4	80	0.0500000
NODE_303079_length_164_cov_43.923077	73	153	23	4	80	0.0500000
NODE_303079_length_164_cov_43.923077	73	153	24	1	80	0.0125000
NODE_303079_length_164_cov_43.923077	73	153	26	4	80	0.0500000
NODE_303079_length_164_cov_43.923077	73	153	28	1	80	0.0125000
NODE_303079_length_164_cov_43.923077	73	153	30	1	80	0.0125000
NODE_303079_length_164_cov_43.923077	73	153	32	2	80	0.0250000
NODE_303079_length_164_cov_43.923077	73	153	34	2	80	0.0250000
NODE_303079_length_164_cov_43.923077	73	153	36	1	80	0.0125000
NODE_303079_length_164_cov_43.923077	73	153	38	12	80	0.1500000
NODE_303079_length_164_cov_43.923077	73	153	44	11	80	0.1375000
NODE_303079_length_164_cov_43.923077	73	153	46	1	80	0.0125000
NODE_303079_length_164_cov_43.923077	73	153	60	1	80	0.0125000
NODE_303079_length_164_cov_43.923077	73	153	62	4	80	0.0500000
NODE_303079_length_164_cov_43.923077	73	153	64	1	80	0.0125000
NODE_303079_length_164_cov_43.923077	73	153	66	30	80	0.3750000
NODE_303079_length_164_cov_43.923077	73	153	21	4	80	0.0500000
NODE_303079_length_164_cov_43.923077	73	153	23	4	80	0.0500000
NODE_303079_length_164_cov_43.923077	73	153	24	1	80	0.0125000
NODE_303079_length_164_cov_43.923077	73	153	26	4	80	0.0500000
NODE_303079_length_164_cov_43.923077	73	153	28	1	80	0.0125000
NODE_303079_length_164_cov_43.923077	73	153	30	1	80	0.0125000
NODE_303079_length_164_cov_43.923077	73	153	32	2	80	0.0250000
NODE_303079_length_164_cov_43.923077	73	153	34	2	80	0.0250000
NODE_303079_length_164_cov_43.923077	73	153	36	1	80	0.0125000
NODE_303079_length_164_cov_43.923077	73	153	38	12	80	0.1500000
NODE_303079_length_164_cov_43.923077	73	153	44	11	80	0.1375000
NODE_303079_length_164_cov_43.923077	73	153	46	1	80	0.0125000
NODE_303079_length_164_cov_43.923077	73	153	60	1	80	0.0125000
NODE_303079_length_164_cov_43.923077	73	153	62	4	80	0.0500000
NODE_303079_length_164_cov_43.923077	73	153	64	1	80	0.0125000
NODE_303079_length_164_cov_43.923077	73	153	66	30	80	0.3750000
NODE_303079_length_164_cov_43.923077	73	153	21	4	80	0.0500000
NODE_303079_length_164_cov_43.923077	73	153	23	4	80	0.0500000
NODE_303079_length_164_cov_43.923077	73	153	24	1	80	0.0125000
NODE_303079_length_164_cov_43.923077	73	153	26	4	80	0.0500000
NODE_303079_length_164_cov_43.923077	73	153	28	1	80	0.0125000
NODE_303079_length_164_cov_43.923077	73	153	30	1	80	0.0125000
NODE_303079_length_164_cov_43.923077	73	153	32	2	80	0.0250000
NODE_303079_length_164_cov_43.923077	73	153	34	2	80	0.0250000
NODE_303079_length_164_cov_43.923077	73	153	36	1	80	0.0125000
NODE_303079_length_164_cov_43.923077	73	153	38	12	80	0.1500000
NODE_303079_length_164_cov_43.923077	73	153	44	11	80	0.1375000
NODE_303079_length_164_cov_43.923077	73	153	46	1	80	0.0125000
NODE_303079_length_164_cov_43.923077	73	153	60	1	80	0.0125000
NODE_303079_length_164_cov_43.923077	73	153	62	4	80	0.0500000
NODE_303079_length_164_cov_43.923077	73	153	64	1	80	0.0125000
NODE_303079_length_164_cov_43.923077	73	153	66	30	80	0.3750000
NODE_303079_length_164_cov_43.923077	73	153	21	4	80	0.0500000
NODE_303079_length_164_cov_43.923077	73	153	23	4	80	0.0500000
NODE_303079_length_164_cov_43.923077	73	153	24	1	80	0.0125000
NODE_303079_length_164_cov_43.923077	73	153	26	4	80	0.0500000
NODE_303079_length_164_cov_43.923077	73	153	28	1	80	0.0125000
NODE_303079_length_164_cov_43.923077	73	153	30	1	80	0.0125000
NODE_303079_length_164_cov_43.923077	73	153	32	2	80	0.0250000
NODE_303079_length_164_cov_43.923077	73	153	34	2	80	0.0250000
NODE_303079_length_164_cov_43.923077	73	153	36	1	80	0.0125000
NODE_303079_length_164_cov_43.923077	73	153	38	12	80	0.1500000
NODE_303079_length_164_cov_43.923077	73	153	44	11	80	0.1375000
NODE_303079_length_164_cov_43.923077	73	153	46	1	80	0.0125000
NODE_303079_length_164_cov_43.923077	73	153	60	1	80	0.0125000
NODE_303079_length_164_cov_43.923077	73	153	62	4	80	0.0500000
NODE_303079_length_164_cov_43.923077	73	153	64	1	80	0.0125000
NODE_303079_length_164_cov_43.923077	73	153	66	30	80	0.3750000
NODE_303079_length_164_cov_43.923077	73	153	21	4	80	0.0500000
NODE_303079_length_164_cov_43.923077	73	153	23	4	80	0.0500000
NODE_303079_length_164_cov_43.923077	73	153	24	1	80	0.0125000
NODE_303079_length_164_cov_43.923077	73	153	26	4	80	0.0500000
NODE_303079_length_164_cov_43.923077	73	153	28	1	80	0.0125000
NODE_303079_length_164_cov_43.923077	73	153	30	1	80	0.0125000
NODE_303079_length_164_cov_43.923077	73	153	32	2	80	0.0250000
NODE_303079_length_164_cov_43.923077	73	153	34	2	80	0.0250000
NODE_303079_length_164_cov_43.923077	73	153	36	1	80	0.0125000
NODE_303079_length_164_cov_43.923077	73	153	38	12	80	0.1500000
NODE_303079_length_164_cov_43.923077	73	153	44	11	80	0.1375000
NODE_303079_length_164_cov_43.923077	73	153	46	1	80	0.0125000
NODE_303079_length_164_cov_43.923077	73	153	60	1	80	0.0125000
NODE_303079_length_164_cov_43.923077	73	153	62	4	80	0.0500000
NODE_303079_length_164_cov_43.923077	73	153	64	1	80	0.0125000
NODE_303079_length_164_cov_43.923077	73	153	66	30	80	0.3750000
NODE_303079_length_164_cov_43.923077	73	144	26	4	71	0.0563380
NODE_303079_length_164_cov_43.923077	73	144	28	1	71	0.0140845
NODE_303079_length_164_cov_43.923077	73	144	30	1	71	0.0140845
NODE_303079_length_164_cov_43.923077	73	144	32	2	71	0.0281690
NODE_303079_length_164_cov_43.923077	73	144	34	2	71	0.0281690
NODE_303079_length_164_cov_43.923077	73	144	36	1	71	0.0140845
NODE_303079_length_164_cov_43.923077	73	144	38	12	71	0.1690141
NODE_303079_length_164_cov_43.923077	73	144	44	11	71	0.1549296
NODE_303079_length_164_cov_43.923077	73	144	46	1	71	0.0140845
NODE_303079_length_164_cov_43.923077	73	144	60	1	71	0.0140845
NODE_303079_length_164_cov_43.923077	73	144	62	4	71	0.0563380
NODE_303079_length_164_cov_43.923077	73	144	64	1	71	0.0140845
NODE_303079_length_164_cov_43.923077	73	144	66	30	71	0.4225352
NODE_303135_length_163_cov_480.593750	0	40	4	1	40	0.0250000
NODE_303135_length_163_cov_480.593750	0	40	9	1	40	0.0250000
NODE_303135_length_163_cov_480.593750	0	40	11	1	40	0.0250000
NODE_303135_length_163_cov_480.593750	0	40	13	1	40	0.0250000
NODE_303135_length_163_cov_480.593750	0	40	15	1	40	0.0250000
NODE_303135_length_163_cov_480.593750	0	40	17	2	40	0.0500000
NODE_303135_length_163_cov_480.593750	0	40	18	1	40	0.0250000
NODE_303135_length_163_cov_480.593750	0	40	20	7	40	0.1750000
NODE_303135_length_163_cov_480.593750	0	40	24	2	40	0.0500000
NODE_303135_length_163_cov_480.593750	0	40	26	6	40	0.1500000
NODE_303135_length_163_cov_480.593750	0	40	28	2	40	0.0500000
NODE_303135_length_163_cov_480.593750	0	40	30	1	40	0.0250000
NODE_303135_length_163_cov_480.593750	0	40	36	1	40	0.0250000
NODE_303135_length_163_cov_480.593750	0	40	38	3	40	0.0750000
NODE_303135_length_163_cov_480.593750	0	40	40	1	40	0.0250000
NODE_303135_length_163_cov_480.593750	0	40	44	1	40	0.0250000
NODE_303135_length_163_cov_480.593750	0	40	46	8	40	0.2000000
NODE_303136_length_163_cov_368.000000	24	96	4	13	72	0.1805556
NODE_303136_length_163_cov_368.000000	24	96	6	7	72	0.0972222
NODE_303136_length_163_cov_368.000000	24	96	8	52	72	0.7222222
NODE_303138_length_163_cov_319.843750	0	68	14	1	68	0.0147059
NODE_303138_length_163_cov_319.843750	0	68	20	1	68	0.0147059
NODE_303138_length_163_cov_319.843750	0	68	22	1	68	0.0147059
NODE_303138_length_163_cov_319.843750	0	68	28	1	68	0.0147059
NODE_303138_length_163_cov_319.843750	0	68	29	1	68	0.0147059
NODE_303138_length_163_cov_319.843750	0	68	36	5	68	0.0735294
NODE_303138_length_163_cov_319.843750	0	68	38	1	68	0.0147059
NODE_303138_length_163_cov_319.843750	0	68	43	1	68	0.0147059
NODE_303138_length_163_cov_319.843750	0	68	51	1	68	0.0147059
NODE_303138_length_163_cov_319.843750	0	68	53	1	68	0.0147059
NODE_303138_length_163_cov_319.843750	0	68	56	1	68	0.0147059
NODE_303138_length_163_cov_319.843750	0	68	57	1	68	0.0147059
NODE_303138_length_163_cov_319.843750	0	68	59	11	68	0.1617647
NODE_303138_length_163_cov_319.843750	0	68	67	1	68	0.0147059
NODE_303138_length_163_cov_319.843750	0	68	69	4	68	0.0588235
NODE_303138_length_163_cov_319.843750	0	68	71	3	68	0.0441176
NODE_303138_length_163_cov_319.843750	0	68	74	1	68	0.0147059
NODE_303138_length_163_cov_319.843750	0	68	78	2	68	0.0294118
NODE_303138_length_163_cov_319.843750	0	68	80	1	68	0.0147059
NODE_303138_length_163_cov_319.843750	0	68	82	16	68	0.2352941
NODE_303138_length_163_cov_319.843750	0	68	83	4	68	0.0588235
NODE_303138_length_163_cov_319.843750	0	68	84	9	68	0.1323529
NODE_303139_length_163_cov_198.078125	34	109	32	3	75	0.0400000
NODE_303139_length_163_cov_198.078125	34	109	34	6	75	0.0800000
NODE_303139_length_163_cov_198.078125	34	109	36	2	75	0.0266667
NODE_303139_length_163_cov_198.078125	34	109	38	4	75	0.0533333
NODE_303139_length_163_cov_198.078125	34	109	42	1	75	0.0133333
NODE_303139_length_163_cov_198.078125	34	109	50	5	75	0.0666667
NODE_303139_length_163_cov_198.078125	34	109	54	2	75	0.0266667
NODE_303139_length_163_cov_198.078125	34	109	58	1	75	0.0133333
NODE_303139_length_163_cov_198.078125	34	109	60	51	75	0.6800000
NODE_303139_length_163_cov_198.078125	34	114	32	3	80	0.0375000
NODE_303139_length_163_cov_198.078125	34	114	34	6	80	0.0750000
NODE_303139_length_163_cov_198.078125	34	114	36	2	80	0.0250000
NODE_303139_length_163_cov_198.078125	34	114	38	4	80	0.0500000
NODE_303139_length_163_cov_198.078125	34	114	42	1	80	0.0125000
NODE_303139_length_163_cov_198.078125	34	114	48	2	80	0.0250000
NODE_303139_length_163_cov_198.078125	34	114	50	5	80	0.0625000
NODE_303139_length_163_cov_198.078125	34	114	52	1	80	0.0125000
NODE_303139_length_163_cov_198.078125	34	114	54	4	80	0.0500000
NODE_303139_length_163_cov_198.078125	34	114	58	1	80	0.0125000
NODE_303139_length_163_cov_198.078125	34	114	60	51	80	0.6375000
NODE_303139_length_163_cov_198.078125	35	110	32	2	75	0.0266667
NODE_303139_length_163_cov_198.078125	35	110	34	6	75	0.0800000
NODE_303139_length_163_cov_198.078125	35	110	36	2	75	0.0266667
NODE_303139_length_163_cov_198.078125	35	110	38	4	75	0.0533333
NODE_303139_length_163_cov_198.078125	35	110	42	1	75	0.0133333
NODE_303139_length_163_cov_198.078125	35	110	50	5	75	0.0666667
NODE_303139_length_163_cov_198.078125	35	110	54	3	75	0.0400000
NODE_303139_length_163_cov_198.078125	35	110	58	1	75	0.0133333
NODE_303139_length_163_cov_198.078125	35	110	60	51	75	0.6800000
NODE_303139_length_163_cov_198.078125	87	163	0	3	76	0.0394737
NODE_303139_length_163_cov_198.078125	87	163	6	4	76	0.0526316
NODE_303139_length_163_cov_198.078125	87	163	12	1	76	0.0131579
NODE_303139_length_163_cov_198.078125	87	163	14	1	76	0.0131579
NODE_303139_length_163_cov_198.078125	87	163	22	1	76	0.0131579
NODE_303139_length_163_cov_198.078125	87	163	24	2	76	0.0263158
NODE_303139_length_163_cov_198.078125	87	163	25	1	76	0.0131579
NODE_303139_length_163_cov_198.078125	87	163	31	2	76	0.0263158
NODE_303139_length_163_cov_198.078125	87	163	32	2	76	0.0263158
NODE_303139_length_163_cov_198.078125	87	163	34	14	76	0.1842105
NODE_303139_length_163_cov_198.078125	87	163	44	10	76	0.1315790
NODE_303139_length_163_cov_198.078125	87	163	46	7	76	0.0921053
NODE_303139_length_163_cov_198.078125	87	163	48	3	76	0.0394737
NODE_303139_length_163_cov_198.078125	87	163	52	1	76	0.0131579
NODE_303139_length_163_cov_198.078125	87	163	54	3	76	0.0394737
NODE_303139_length_163_cov_198.078125	87	163	58	1	76	0.0131579
NODE_303139_length_163_cov_198.078125	87	163	60	20	76	0.2631579
NODE_303139_length_163_cov_198.078125	87	163	0	3	76	0.0394737
NODE_303139_length_163_cov_198.078125	87	163	6	4	76	0.0526316
NODE_303139_length_163_cov_198.078125	87	163	12	1	76	0.0131579
NODE_303139_length_163_cov_198.078125	87	163	14	1	76	0.0131579
NODE_303139_length_163_cov_198.078125	87	163	22	1	76	0.0131579
NODE_303139_length_163_cov_198.078125	87	163	24	2	76	0.0263158
NODE_303139_length_163_cov_198.078125	87	163	25	1	76	0.0131579
NODE_303139_length_163_cov_198.078125	87	163	31	2	76	0.0263158
NODE_303139_length_163_cov_198.078125	87	163	32	2	76	0.0263158
NODE_303139_length_163_cov_198.078125	87	163	34	14	76	0.1842105
NODE_303139_length_163_cov_198.078125	87	163	44	10	76	0.1315790
NODE_303139_length_163_cov_198.078125	87	163	46	7	76	0.0921053
NODE_303139_length_163_cov_198.078125	87	163	48	3	76	0.0394737
NODE_303139_length_163_cov_198.078125	87	163	52	1	76	0.0131579
NODE_303139_length_163_cov_198.078125	87	163	54	3	76	0.0394737
NODE_303139_length_163_cov_198.078125	87	163	58	1	76	0.0131579
NODE_303139_length_163_cov_198.078125	87	163	60	20	76	0.2631579
NODE_303139_length_163_cov_198.078125	87	163	0	3	76	0.0394737
NODE_303139_length_163_cov_198.078125	87	163	6	4	76	0.0526316
NODE_303139_length_163_cov_198.078125	87	163	12	1	76	0.0131579
NODE_303139_length_163_cov_198.078125	87	163	14	1	76	0.0131579
NODE_303139_length_163_cov_198.078125	87	163	22	1	76	0.0131579
NODE_303139_length_163_cov_198.078125	87	163	24	2	76	0.0263158
NODE_303139_length_163_cov_198.078125	87	163	25	1	76	0.0131579
NODE_303139_length_163_cov_198.078125	87	163	31	2	76	0.0263158
NODE_303139_length_163_cov_198.078125	87	163	32	2	76	0.0263158
NODE_303139_length_163_cov_198.078125	87	163	34	14	76	0.1842105
NODE_303139_length_163_cov_198.078125	87	163	44	10	76	0.1315790
NODE_303139_length_163_cov_198.078125	87	163	46	7	76	0.0921053
NODE_303139_length_163_cov_198.078125	87	163	48	3	76	0.0394737
NODE_303139_length_163_cov_198.078125	87	163	52	1	76	0.0131579
NODE_303139_length_163_cov_198.078125	87	163	54	3	76	0.0394737
NODE_303139_length_163_cov_198.078125	87	163	58	1	76	0.0131579
NODE_303139_length_163_cov_198.078125	87	163	60	20	76	0.2631579
NODE_303231_length_162_cov_421.047619	7	56	30	1	49	0.0204082
NODE_303231_length_162_cov_421.047619	7	56	42	1	49	0.0204082
NODE_303231_length_162_cov_421.047619	7	56	45	1	49	0.0204082
NODE_303231_length_162_cov_421.047619	7	56	50	2	49	0.0408163
NODE_303231_length_162_cov_421.047619	7	56	52	2	49	0.0408163
NODE_303231_length_162_cov_421.047619	7	56	58	1	49	0.0204082
NODE_303231_length_162_cov_421.047619	7	56	64	1	49	0.0204082
NODE_303231_length_162_cov_421.047619	7	56	69	1	49	0.0204082
NODE_303231_length_162_cov_421.047619	7	56	70	1	49	0.0204082
NODE_303231_length_162_cov_421.047619	7	56	71	1	49	0.0204082
NODE_303231_length_162_cov_421.047619	7	56	83	1	49	0.0204082
NODE_303231_length_162_cov_421.047619	7	56	94	1	49	0.0204082
NODE_303231_length_162_cov_421.047619	7	56	96	1	49	0.0204082
NODE_303231_length_162_cov_421.047619	7	56	98	1	49	0.0204082
NODE_303231_length_162_cov_421.047619	7	56	100	2	49	0.0408163
NODE_303231_length_162_cov_421.047619	7	56	102	1	49	0.0204082
NODE_303231_length_162_cov_421.047619	7	56	106	1	49	0.0204082
NODE_303231_length_162_cov_421.047619	7	56	108	1	49	0.0204082
NODE_303231_length_162_cov_421.047619	7	56	113	1	49	0.0204082
NODE_303231_length_162_cov_421.047619	7	56	120	2	49	0.0408163
NODE_303231_length_162_cov_421.047619	7	56	122	1	49	0.0204082
NODE_303231_length_162_cov_421.047619	7	56	123	1	49	0.0204082
NODE_303231_length_162_cov_421.047619	7	56	127	1	49	0.0204082
NODE_303231_length_162_cov_421.047619	7	56	129	1	49	0.0204082
NODE_303231_length_162_cov_421.047619	7	56	143	1	49	0.0204082
NODE_303231_length_162_cov_421.047619	7	56	145	1	49	0.0204082
NODE_303231_length_162_cov_421.047619	7	56	159	1	49	0.0204082
NODE_303231_length_162_cov_421.047619	7	56	161	1	49	0.0204082
NODE_303231_length_162_cov_421.047619	7	56	173	1	49	0.0204082
NODE_303231_length_162_cov_421.047619	7	56	175	1	49	0.0204082
NODE_303231_length_162_cov_421.047619	7	56	187	1	49	0.0204082
NODE_303231_length_162_cov_421.047619	7	56	196	1	49	0.0204082
NODE_303231_length_162_cov_421.047619	7	56	202	2	49	0.0408163
NODE_303231_length_162_cov_421.047619	7	56	206	1	49	0.0204082
NODE_303231_length_162_cov_421.047619	7	56	208	2	49	0.0408163
NODE_303231_length_162_cov_421.047619	7	56	218	1	49	0.0204082
NODE_303231_length_162_cov_421.047619	7	56	224	1	49	0.0204082
NODE_303231_length_162_cov_421.047619	7	56	232	1	49	0.0204082
NODE_303231_length_162_cov_421.047619	7	56	234	1	49	0.0204082
NODE_303231_length_162_cov_421.047619	7	56	236	3	49	0.0612245
NODE_303231_length_162_cov_421.047619	7	56	238	1	49	0.0204082
NODE_303231_length_162_cov_421.047619	29	90	120	2	61	0.0327869
NODE_303231_length_162_cov_421.047619	29	90	122	1	61	0.0163934
NODE_303231_length_162_cov_421.047619	29	90	123	1	61	0.0163934
NODE_303231_length_162_cov_421.047619	29	90	127	1	61	0.0163934
NODE_303231_length_162_cov_421.047619	29	90	129	1	61	0.0163934
NODE_303231_length_162_cov_421.047619	29	90	143	1	61	0.0163934
NODE_303231_length_162_cov_421.047619	29	90	145	1	61	0.0163934
NODE_303231_length_162_cov_421.047619	29	90	159	1	61	0.0163934
NODE_303231_length_162_cov_421.047619	29	90	161	1	61	0.0163934
NODE_303231_length_162_cov_421.047619	29	90	173	1	61	0.0163934
NODE_303231_length_162_cov_421.047619	29	90	175	1	61	0.0163934
NODE_303231_length_162_cov_421.047619	29	90	187	1	61	0.0163934
NODE_303231_length_162_cov_421.047619	29	90	196	1	61	0.0163934
NODE_303231_length_162_cov_421.047619	29	90	202	2	61	0.0327869
NODE_303231_length_162_cov_421.047619	29	90	206	1	61	0.0163934
NODE_303231_length_162_cov_421.047619	29	90	208	2	61	0.0327869
NODE_303231_length_162_cov_421.047619	29	90	218	1	61	0.0163934
NODE_303231_length_162_cov_421.047619	29	90	224	1	61	0.0163934
NODE_303231_length_162_cov_421.047619	29	90	232	1	61	0.0163934
NODE_303231_length_162_cov_421.047619	29	90	234	1	61	0.0163934
NODE_303231_length_162_cov_421.047619	29	90	236	3	61	0.0491803
NODE_303231_length_162_cov_421.047619	29	90	238	1	61	0.0163934
NODE_303231_length_162_cov_421.047619	29	90	242	1	61	0.0163934
NODE_303231_length_162_cov_421.047619	29	90	244	33	61	0.5409836
NODE_303231_length_162_cov_421.047619	29	92	120	2	63	0.0317460
NODE_303231_length_162_cov_421.047619	29	92	122	1	63	0.0158730
NODE_303231_length_162_cov_421.047619	29	92	123	1	63	0.0158730
NODE_303231_length_162_cov_421.047619	29	92	127	1	63	0.0158730
NODE_303231_length_162_cov_421.047619	29	92	129	1	63	0.0158730
NODE_303231_length_162_cov_421.047619	29	92	143	1	63	0.0158730
NODE_303231_length_162_cov_421.047619	29	92	145	1	63	0.0158730
NODE_303231_length_162_cov_421.047619	29	92	159	1	63	0.0158730
NODE_303231_length_162_cov_421.047619	29	92	161	1	63	0.0158730
NODE_303231_length_162_cov_421.047619	29	92	173	1	63	0.0158730
NODE_303231_length_162_cov_421.047619	29	92	175	1	63	0.0158730
NODE_303231_length_162_cov_421.047619	29	92	187	1	63	0.0158730
NODE_303231_length_162_cov_421.047619	29	92	196	1	63	0.0158730
NODE_303231_length_162_cov_421.047619	29	92	202	2	63	0.0317460
NODE_303231_length_162_cov_421.047619	29	92	206	1	63	0.0158730
NODE_303231_length_162_cov_421.047619	29	92	208	2	63	0.0317460
NODE_303231_length_162_cov_421.047619	29	92	218	1	63	0.0158730
NODE_303231_length_162_cov_421.047619	29	92	224	1	63	0.0158730
NODE_303231_length_162_cov_421.047619	29	92	232	1	63	0.0158730
NODE_303231_length_162_cov_421.047619	29	92	234	1	63	0.0158730
NODE_303231_length_162_cov_421.047619	29	92	236	3	63	0.0476190
NODE_303231_length_162_cov_421.047619	29	92	238	1	63	0.0158730
NODE_303231_length_162_cov_421.047619	29	92	242	1	63	0.0158730
NODE_303231_length_162_cov_421.047619	29	92	244	35	63	0.5555556
NODE_303231_length_162_cov_421.047619	29	92	120	2	63	0.0317460
NODE_303231_length_162_cov_421.047619	29	92	122	1	63	0.0158730
NODE_303231_length_162_cov_421.047619	29	92	123	1	63	0.0158730
NODE_303231_length_162_cov_421.047619	29	92	127	1	63	0.0158730
NODE_303231_length_162_cov_421.047619	29	92	129	1	63	0.0158730
NODE_303231_length_162_cov_421.047619	29	92	143	1	63	0.0158730
NODE_303231_length_162_cov_421.047619	29	92	145	1	63	0.0158730
NODE_303231_length_162_cov_421.047619	29	92	159	1	63	0.0158730
NODE_303231_length_162_cov_421.047619	29	92	161	1	63	0.0158730
NODE_303231_length_162_cov_421.047619	29	92	173	1	63	0.0158730
NODE_303231_length_162_cov_421.047619	29	92	175	1	63	0.0158730
NODE_303231_length_162_cov_421.047619	29	92	187	1	63	0.0158730
NODE_303231_length_162_cov_421.047619	29	92	196	1	63	0.0158730
NODE_303231_length_162_cov_421.047619	29	92	202	2	63	0.0317460
NODE_303231_length_162_cov_421.047619	29	92	206	1	63	0.0158730
NODE_303231_length_162_cov_421.047619	29	92	208	2	63	0.0317460
NODE_303231_length_162_cov_421.047619	29	92	218	1	63	0.0158730
NODE_303231_length_162_cov_421.047619	29	92	224	1	63	0.0158730
NODE_303231_length_162_cov_421.047619	29	92	232	1	63	0.0158730
NODE_303231_length_162_cov_421.047619	29	92	234	1	63	0.0158730
NODE_303231_length_162_cov_421.047619	29	92	236	3	63	0.0476190
NODE_303231_length_162_cov_421.047619	29	92	238	1	63	0.0158730
NODE_303231_length_162_cov_421.047619	29	92	242	1	63	0.0158730
NODE_303231_length_162_cov_421.047619	29	92	244	35	63	0.5555556
NODE_303231_length_162_cov_421.047619	29	92	120	2	63	0.0317460
NODE_303231_length_162_cov_421.047619	29	92	122	1	63	0.0158730
NODE_303231_length_162_cov_421.047619	29	92	123	1	63	0.0158730
NODE_303231_length_162_cov_421.047619	29	92	127	1	63	0.0158730
NODE_303231_length_162_cov_421.047619	29	92	129	1	63	0.0158730
NODE_303231_length_162_cov_421.047619	29	92	143	1	63	0.0158730
NODE_303231_length_162_cov_421.047619	29	92	145	1	63	0.0158730
NODE_303231_length_162_cov_421.047619	29	92	159	1	63	0.0158730
NODE_303231_length_162_cov_421.047619	29	92	161	1	63	0.0158730
NODE_303231_length_162_cov_421.047619	29	92	173	1	63	0.0158730
NODE_303231_length_162_cov_421.047619	29	92	175	1	63	0.0158730
NODE_303231_length_162_cov_421.047619	29	92	187	1	63	0.0158730
NODE_303231_length_162_cov_421.047619	29	92	196	1	63	0.0158730
NODE_303231_length_162_cov_421.047619	29	92	202	2	63	0.0317460
NODE_303231_length_162_cov_421.047619	29	92	206	1	63	0.0158730
NODE_303231_length_162_cov_421.047619	29	92	208	2	63	0.0317460
NODE_303231_length_162_cov_421.047619	29	92	218	1	63	0.0158730
NODE_303231_length_162_cov_421.047619	29	92	224	1	63	0.0158730
NODE_303231_length_162_cov_421.047619	29	92	232	1	63	0.0158730
NODE_303231_length_162_cov_421.047619	29	92	234	1	63	0.0158730
NODE_303231_length_162_cov_421.047619	29	92	236	3	63	0.0476190
NODE_303231_length_162_cov_421.047619	29	92	238	1	63	0.0158730
NODE_303231_length_162_cov_421.047619	29	92	242	1	63	0.0158730
NODE_303231_length_162_cov_421.047619	29	92	244	35	63	0.5555556
NODE_303250_length_162_cov_45.380952	63	127	14	1	64	0.0156250
NODE_303250_length_162_cov_45.380952	63	127	20	7	64	0.1093750
NODE_303250_length_162_cov_45.380952	63	127	22	1	64	0.0156250
NODE_303250_length_162_cov_45.380952	63	127	26	55	64	0.8593750
NODE_303250_length_162_cov_45.380952	63	127	14	1	64	0.0156250
NODE_303250_length_162_cov_45.380952	63	127	20	7	64	0.1093750
NODE_303250_length_162_cov_45.380952	63	127	22	1	64	0.0156250
NODE_303250_length_162_cov_45.380952	63	127	26	55	64	0.8593750
NODE_303250_length_162_cov_45.380952	100	162	0	3	62	0.0483871
NODE_303250_length_162_cov_45.380952	100	162	1	10	62	0.1612903
NODE_303250_length_162_cov_45.380952	100	162	2	1	62	0.0161290
NODE_303250_length_162_cov_45.380952	100	162	4	12	62	0.1935484
NODE_303250_length_162_cov_45.380952	100	162	8	2	62	0.0322581
NODE_303250_length_162_cov_45.380952	100	162	10	6	62	0.0967742
NODE_303250_length_162_cov_45.380952	100	162	14	2	62	0.0322581
NODE_303250_length_162_cov_45.380952	100	162	20	7	62	0.1129032
NODE_303250_length_162_cov_45.380952	100	162	22	1	62	0.0161290
NODE_303250_length_162_cov_45.380952	100	162	26	18	62	0.2903226
NODE_303301_length_161_cov_1483.177419	51	131	64	8	80	0.1000000
NODE_303301_length_161_cov_1483.177419	51	131	66	4	80	0.0500000
NODE_303301_length_161_cov_1483.177419	51	131	68	1	80	0.0125000
NODE_303301_length_161_cov_1483.177419	51	131	70	3	80	0.0375000
NODE_303301_length_161_cov_1483.177419	51	131	72	2	80	0.0250000
NODE_303301_length_161_cov_1483.177419	51	131	74	1	80	0.0125000
NODE_303301_length_161_cov_1483.177419	51	131	76	5	80	0.0625000
NODE_303301_length_161_cov_1483.177419	51	131	78	4	80	0.0500000
NODE_303301_length_161_cov_1483.177419	51	131	80	8	80	0.1000000
NODE_303301_length_161_cov_1483.177419	51	131	82	44	80	0.5500000
NODE_303301_length_161_cov_1483.177419	104	161	10	5	57	0.0877193
NODE_303301_length_161_cov_1483.177419	104	161	12	2	57	0.0350877
NODE_303301_length_161_cov_1483.177419	104	161	14	3	57	0.0526316
NODE_303301_length_161_cov_1483.177419	104	161	18	1	57	0.0175439
NODE_303301_length_161_cov_1483.177419	104	161	24	1	57	0.0175439
NODE_303301_length_161_cov_1483.177419	104	161	32	2	57	0.0350877
NODE_303301_length_161_cov_1483.177419	104	161	38	1	57	0.0175439
NODE_303301_length_161_cov_1483.177419	104	161	40	5	57	0.0877193
NODE_303301_length_161_cov_1483.177419	104	161	48	1	57	0.0175439
NODE_303301_length_161_cov_1483.177419	104	161	50	1	57	0.0175439
NODE_303301_length_161_cov_1483.177419	104	161	52	1	57	0.0175439
NODE_303301_length_161_cov_1483.177419	104	161	54	1	57	0.0175439
NODE_303301_length_161_cov_1483.177419	104	161	58	2	57	0.0350877
NODE_303301_length_161_cov_1483.177419	104	161	61	1	57	0.0175439
NODE_303301_length_161_cov_1483.177419	104	161	64	10	57	0.1754386
NODE_303301_length_161_cov_1483.177419	104	161	66	1	57	0.0175439
NODE_303301_length_161_cov_1483.177419	104	161	68	1	57	0.0175439
NODE_303301_length_161_cov_1483.177419	104	161	70	3	57	0.0526316
NODE_303301_length_161_cov_1483.177419	104	161	72	2	57	0.0350877
NODE_303301_length_161_cov_1483.177419	104	161	76	4	57	0.0701754
NODE_303301_length_161_cov_1483.177419	104	161	78	4	57	0.0701754
NODE_303301_length_161_cov_1483.177419	104	161	80	5	57	0.0877193
NODE_303312_length_161_cov_71.500000	33	110	2	3	77	0.0389610
NODE_303312_length_161_cov_71.500000	33	110	4	10	77	0.1298701
NODE_303312_length_161_cov_71.500000	33	110	6	7	77	0.0909091
NODE_303312_length_161_cov_71.500000	33	110	10	57	77	0.7402598
NODE_303312_length_161_cov_71.500000	33	110	2	3	77	0.0389610
NODE_303312_length_161_cov_71.500000	33	110	4	10	77	0.1298701
NODE_303312_length_161_cov_71.500000	33	110	6	7	77	0.0909091
NODE_303312_length_161_cov_71.500000	33	110	10	57	77	0.7402598
NODE_303312_length_161_cov_71.500000	33	110	2	3	77	0.0389610
NODE_303312_length_161_cov_71.500000	33	110	4	10	77	0.1298701
NODE_303312_length_161_cov_71.500000	33	110	6	7	77	0.0909091
NODE_303312_length_161_cov_71.500000	33	110	10	57	77	0.7402598
NODE_303312_length_161_cov_71.500000	33	110	2	3	77	0.0389610
NODE_303312_length_161_cov_71.500000	33	110	4	10	77	0.1298701
NODE_303312_length_161_cov_71.500000	33	110	6	7	77	0.0909091
NODE_303312_length_161_cov_71.500000	33	110	10	57	77	0.7402598
NODE_303312_length_161_cov_71.500000	83	149	8	25	66	0.3787879
NODE_303312_length_161_cov_71.500000	83	149	10	41	66	0.6212121
NODE_303312_length_161_cov_71.500000	83	161	4	5	78	0.0641026
NODE_303312_length_161_cov_71.500000	83	161	6	7	78	0.0897436
NODE_303312_length_161_cov_71.500000	83	161	8	25	78	0.3205128
NODE_303312_length_161_cov_71.500000	83	161	10	41	78	0.5256410
NODE_303312_length_161_cov_71.500000	86	161	4	5	75	0.0666667
NODE_303312_length_161_cov_71.500000	86	161	6	7	75	0.0933333
NODE_303312_length_161_cov_71.500000	86	161	8	25	75	0.3333333
NODE_303312_length_161_cov_71.500000	86	161	10	38	75	0.5066667
NODE_303312_length_161_cov_71.500000	86	161	4	5	75	0.0666667
NODE_303312_length_161_cov_71.500000	86	161	6	7	75	0.0933333
NODE_303312_length_161_cov_71.500000	86	161	8	25	75	0.3333333
NODE_303312_length_161_cov_71.500000	86	161	10	38	75	0.5066667
NODE_303312_length_161_cov_71.500000	88	161	4	5	73	0.0684932
NODE_303312_length_161_cov_71.500000	88	161	6	7	73	0.0958904
NODE_303312_length_161_cov_71.500000	88	161	8	25	73	0.3424658
NODE_303312_length_161_cov_71.500000	88	161	10	36	73	0.4931507
NODE_303321_length_161_cov_29.758065	0	80	0	5	80	0.0625000
NODE_303321_length_161_cov_29.758065	0	80	4	2	80	0.0250000
NODE_303321_length_161_cov_29.758065	0	80	6	2	80	0.0250000
NODE_303321_length_161_cov_29.758065	0	80	8	5	80	0.0625000
NODE_303321_length_161_cov_29.758065	0	80	10	1	80	0.0125000
NODE_303321_length_161_cov_29.758065	0	80	16	8	80	0.1000000
NODE_303321_length_161_cov_29.758065	0	80	20	10	80	0.1250000
NODE_303321_length_161_cov_29.758065	0	80	23	1	80	0.0125000
NODE_303321_length_161_cov_29.758065	0	80	24	2	80	0.0250000
NODE_303321_length_161_cov_29.758065	0	80	26	1	80	0.0125000
NODE_303321_length_161_cov_29.758065	0	80	28	43	80	0.5375000
NODE_303381_length_160_cov_143.573770	45	125	4	8	80	0.1000000
NODE_303381_length_160_cov_143.573770	45	125	6	25	80	0.3125000
NODE_303381_length_160_cov_143.573770	45	125	8	47	80	0.5875000
NODE_303381_length_160_cov_143.573770	93	160	0	33	67	0.4925373
NODE_303381_length_160_cov_143.573770	93	160	2	1	67	0.0149254
NODE_303381_length_160_cov_143.573770	93	160	4	9	67	0.1343284
NODE_303381_length_160_cov_143.573770	93	160	6	15	67	0.2238806
NODE_303381_length_160_cov_143.573770	93	160	8	9	67	0.1343284
NODE_303381_length_160_cov_143.573770	98	120	4	3	22	0.1363636
NODE_303381_length_160_cov_143.573770	98	120	6	15	22	0.6818182
NODE_303381_length_160_cov_143.573770	98	120	8	4	22	0.1818182
NODE_303388_length_160_cov_58.245902	0	45	0	35	45	0.7777778
NODE_303388_length_160_cov_58.245902	0	45	2	1	45	0.0222222
NODE_303388_length_160_cov_58.245902	0	45	4	9	45	0.2000000
NODE_303431_length_159_cov_182.016667	71	156	2	10	85	0.1176471
NODE_303431_length_159_cov_182.016667	71	156	4	3	85	0.0352941
NODE_303431_length_159_cov_182.016667	71	156	6	4	85	0.0470588
NODE_303431_length_159_cov_182.016667	71	156	14	10	85	0.1176471
NODE_303431_length_159_cov_182.016667	71	156	16	14	85	0.1647059
NODE_303431_length_159_cov_182.016667	71	156	18	1	85	0.0117647
NODE_303431_length_159_cov_182.016667	71	156	20	4	85	0.0470588
NODE_303431_length_159_cov_182.016667	71	156	22	39	85	0.4588235
NODE_303431_length_159_cov_182.016667	71	156	2	10	85	0.1176471
NODE_303431_length_159_cov_182.016667	71	156	4	3	85	0.0352941
NODE_303431_length_159_cov_182.016667	71	156	6	4	85	0.0470588
NODE_303431_length_159_cov_182.016667	71	156	14	10	85	0.1176471
NODE_303431_length_159_cov_182.016667	71	156	16	14	85	0.1647059
NODE_303431_length_159_cov_182.016667	71	156	18	1	85	0.0117647
NODE_303431_length_159_cov_182.016667	71	156	20	4	85	0.0470588
NODE_303431_length_159_cov_182.016667	71	156	22	39	85	0.4588235
NODE_303431_length_159_cov_182.016667	71	156	2	10	85	0.1176471
NODE_303431_length_159_cov_182.016667	71	156	4	3	85	0.0352941
NODE_303431_length_159_cov_182.016667	71	156	6	4	85	0.0470588
NODE_303431_length_159_cov_182.016667	71	156	14	10	85	0.1176471
NODE_303431_length_159_cov_182.016667	71	156	16	14	85	0.1647059
NODE_303431_length_159_cov_182.016667	71	156	18	1	85	0.0117647
NODE_303431_length_159_cov_182.016667	71	156	20	4	85	0.0470588
NODE_303431_length_159_cov_182.016667	71	156	22	39	85	0.4588235
NODE_303440_length_159_cov_85.750000	0	43	0	1	43	0.0232558
NODE_303440_length_159_cov_85.750000	0	43	2	2	43	0.0465116
NODE_303440_length_159_cov_85.750000	0	43	4	2	43	0.0465116
NODE_303440_length_159_cov_85.750000	0	43	6	1	43	0.0232558
NODE_303440_length_159_cov_85.750000	0	43	8	11	43	0.2558140
NODE_303440_length_159_cov_85.750000	0	43	14	5	43	0.1162791
NODE_303440_length_159_cov_85.750000	0	43	22	8	43	0.1860465
NODE_303440_length_159_cov_85.750000	0	43	24	3	43	0.0697674
NODE_303440_length_159_cov_85.750000	0	43	32	2	43	0.0465116
NODE_303440_length_159_cov_85.750000	0	43	34	8	43	0.1860465
NODE_303440_length_159_cov_85.750000	16	97	8	1	81	0.0123457
NODE_303440_length_159_cov_85.750000	16	97	14	5	81	0.0617284
NODE_303440_length_159_cov_85.750000	16	97	22	8	81	0.0987654
NODE_303440_length_159_cov_85.750000	16	97	24	3	81	0.0370370
NODE_303440_length_159_cov_85.750000	16	97	32	2	81	0.0246914
NODE_303440_length_159_cov_85.750000	16	97	34	11	81	0.1358025
NODE_303440_length_159_cov_85.750000	16	97	44	6	81	0.0740741
NODE_303440_length_159_cov_85.750000	16	97	46	45	81	0.5555556
NODE_303440_length_159_cov_85.750000	65	145	30	9	80	0.1125000
NODE_303440_length_159_cov_85.750000	65	145	32	1	80	0.0125000
NODE_303440_length_159_cov_85.750000	65	145	34	8	80	0.1000000
NODE_303440_length_159_cov_85.750000	65	145	36	6	80	0.0750000
NODE_303440_length_159_cov_85.750000	65	145	38	10	80	0.1250000
NODE_303440_length_159_cov_85.750000	65	145	40	1	80	0.0125000
NODE_303440_length_159_cov_85.750000	65	145	42	1	80	0.0125000
NODE_303440_length_159_cov_85.750000	65	145	46	44	80	0.5500000
NODE_303440_length_159_cov_85.750000	70	92	46	22	22	1.0000000
NODE_303546_length_158_cov_119.813559	34	77	6	11	43	0.2558140
NODE_303546_length_158_cov_119.813559	34	77	8	9	43	0.2093023
NODE_303546_length_158_cov_119.813559	34	77	10	23	43	0.5348837
NODE_303546_length_158_cov_119.813559	78	113	10	35	35	1.0000000
NODE_303546_length_158_cov_119.813559	123	158	0	19	35	0.5428572
NODE_303546_length_158_cov_119.813559	123	158	2	4	35	0.1142857
NODE_303546_length_158_cov_119.813559	123	158	4	1	35	0.0285714
NODE_303546_length_158_cov_119.813559	123	158	6	4	35	0.1142857
NODE_303546_length_158_cov_119.813559	123	158	8	7	35	0.2000000
NODE_303552_length_158_cov_70.135593	5	82	2	7	77	0.0909091
NODE_303552_length_158_cov_70.135593	5	82	4	10	77	0.1298701
NODE_303552_length_158_cov_70.135593	5	82	6	4	77	0.0519481
NODE_303552_length_158_cov_70.135593	5	82	8	11	77	0.1428571
NODE_303552_length_158_cov_70.135593	5	82	10	7	77	0.0909091
NODE_303552_length_158_cov_70.135593	5	82	12	38	77	0.4935065
NODE_303552_length_158_cov_70.135593	5	82	2	7	77	0.0909091
NODE_303552_length_158_cov_70.135593	5	82	4	10	77	0.1298701
NODE_303552_length_158_cov_70.135593	5	82	6	4	77	0.0519481
NODE_303552_length_158_cov_70.135593	5	82	8	11	77	0.1428571
NODE_303552_length_158_cov_70.135593	5	82	10	7	77	0.0909091
NODE_303552_length_158_cov_70.135593	5	82	12	38	77	0.4935065
NODE_303552_length_158_cov_70.135593	81	155	0	12	74	0.1621622
NODE_303552_length_158_cov_70.135593	81	155	4	2	74	0.0270270
NODE_303552_length_158_cov_70.135593	81	155	8	23	74	0.3108108
NODE_303552_length_158_cov_70.135593	81	155	10	11	74	0.1486486
NODE_303552_length_158_cov_70.135593	81	155	12	26	74	0.3513514
NODE_303555_length_158_cov_63.559322	80	151	22	5	71	0.0704225
NODE_303555_length_158_cov_63.559322	80	151	24	1	71	0.0140845
NODE_303555_length_158_cov_63.559322	80	151	26	3	71	0.0422535
NODE_303555_length_158_cov_63.559322	80	151	28	1	71	0.0140845
NODE_303555_length_158_cov_63.559322	80	151	30	1	71	0.0140845
NODE_303555_length_158_cov_63.559322	80	151	32	11	71	0.1549296
NODE_303555_length_158_cov_63.559322	80	151	36	4	71	0.0563380
NODE_303555_length_158_cov_63.559322	80	151	42	3	71	0.0422535
NODE_303555_length_158_cov_63.559322	80	151	46	1	71	0.0140845
NODE_303555_length_158_cov_63.559322	80	151	52	2	71	0.0281690
NODE_303555_length_158_cov_63.559322	80	151	54	5	71	0.0704225
NODE_303555_length_158_cov_63.559322	80	151	60	2	71	0.0281690
NODE_303555_length_158_cov_63.559322	80	151	64	2	71	0.0281690
NODE_303555_length_158_cov_63.559322	80	151	66	7	71	0.0985916
NODE_303555_length_158_cov_63.559322	80	151	72	23	71	0.3239437
NODE_303556_length_158_cov_61.203390	2	66	27	1	64	0.0156250
NODE_303556_length_158_cov_61.203390	2	66	29	1	64	0.0156250
NODE_303556_length_158_cov_61.203390	2	66	35	1	64	0.0156250
NODE_303556_length_158_cov_61.203390	2	66	43	3	64	0.0468750
NODE_303556_length_158_cov_61.203390	2	66	45	1	64	0.0156250
NODE_303556_length_158_cov_61.203390	2	66	58	4	64	0.0625000
NODE_303556_length_158_cov_61.203390	2	66	60	1	64	0.0156250
NODE_303556_length_158_cov_61.203390	2	66	72	1	64	0.0156250
NODE_303556_length_158_cov_61.203390	2	66	76	2	64	0.0312500
NODE_303556_length_158_cov_61.203390	2	66	84	1	64	0.0156250
NODE_303556_length_158_cov_61.203390	2	66	91	1	64	0.0156250
NODE_303556_length_158_cov_61.203390	2	66	100	1	64	0.0156250
NODE_303556_length_158_cov_61.203390	2	66	103	1	64	0.0156250
NODE_303556_length_158_cov_61.203390	2	66	113	1	64	0.0156250
NODE_303556_length_158_cov_61.203390	2	66	115	2	64	0.0312500
NODE_303556_length_158_cov_61.203390	2	66	121	1	64	0.0156250
NODE_303556_length_158_cov_61.203390	2	66	127	1	64	0.0156250
NODE_303556_length_158_cov_61.203390	2	66	131	2	64	0.0312500
NODE_303556_length_158_cov_61.203390	2	66	141	2	64	0.0312500
NODE_303556_length_158_cov_61.203390	2	66	145	1	64	0.0156250
NODE_303556_length_158_cov_61.203390	2	66	149	3	64	0.0468750
NODE_303556_length_158_cov_61.203390	2	66	156	6	64	0.0937500
NODE_303556_length_158_cov_61.203390	2	66	158	1	64	0.0156250
NODE_303556_length_158_cov_61.203390	2	66	164	1	64	0.0156250
NODE_303556_length_158_cov_61.203390	2	66	165	1	64	0.0156250
NODE_303556_length_158_cov_61.203390	2	66	167	1	64	0.0156250
NODE_303556_length_158_cov_61.203390	2	66	173	1	64	0.0156250
NODE_303556_length_158_cov_61.203390	2	66	179	1	64	0.0156250
NODE_303556_length_158_cov_61.203390	2	66	181	2	64	0.0312500
NODE_303556_length_158_cov_61.203390	2	66	183	2	64	0.0312500
NODE_303556_length_158_cov_61.203390	2	66	185	2	64	0.0312500
NODE_303556_length_158_cov_61.203390	2	66	187	2	64	0.0312500
NODE_303556_length_158_cov_61.203390	2	66	189	12	64	0.1875000
NODE_303556_length_158_cov_61.203390	2	66	27	1	64	0.0156250
NODE_303556_length_158_cov_61.203390	2	66	29	1	64	0.0156250
NODE_303556_length_158_cov_61.203390	2	66	35	1	64	0.0156250
NODE_303556_length_158_cov_61.203390	2	66	43	3	64	0.0468750
NODE_303556_length_158_cov_61.203390	2	66	45	1	64	0.0156250
NODE_303556_length_158_cov_61.203390	2	66	58	4	64	0.0625000
NODE_303556_length_158_cov_61.203390	2	66	60	1	64	0.0156250
NODE_303556_length_158_cov_61.203390	2	66	72	1	64	0.0156250
NODE_303556_length_158_cov_61.203390	2	66	76	2	64	0.0312500
NODE_303556_length_158_cov_61.203390	2	66	84	1	64	0.0156250
NODE_303556_length_158_cov_61.203390	2	66	91	1	64	0.0156250
NODE_303556_length_158_cov_61.203390	2	66	100	1	64	0.0156250
NODE_303556_length_158_cov_61.203390	2	66	103	1	64	0.0156250
NODE_303556_length_158_cov_61.203390	2	66	113	1	64	0.0156250
NODE_303556_length_158_cov_61.203390	2	66	115	2	64	0.0312500
NODE_303556_length_158_cov_61.203390	2	66	121	1	64	0.0156250
NODE_303556_length_158_cov_61.203390	2	66	127	1	64	0.0156250
NODE_303556_length_158_cov_61.203390	2	66	131	2	64	0.0312500
NODE_303556_length_158_cov_61.203390	2	66	141	2	64	0.0312500
NODE_303556_length_158_cov_61.203390	2	66	145	1	64	0.0156250
NODE_303556_length_158_cov_61.203390	2	66	149	3	64	0.0468750
NODE_303556_length_158_cov_61.203390	2	66	156	6	64	0.0937500
NODE_303556_length_158_cov_61.203390	2	66	158	1	64	0.0156250
NODE_303556_length_158_cov_61.203390	2	66	164	1	64	0.0156250
NODE_303556_length_158_cov_61.203390	2	66	165	1	64	0.0156250
NODE_303556_length_158_cov_61.203390	2	66	167	1	64	0.0156250
NODE_303556_length_158_cov_61.203390	2	66	173	1	64	0.0156250
NODE_303556_length_158_cov_61.203390	2	66	179	1	64	0.0156250
NODE_303556_length_158_cov_61.203390	2	66	181	2	64	0.0312500
NODE_303556_length_158_cov_61.203390	2	66	183	2	64	0.0312500
NODE_303556_length_158_cov_61.203390	2	66	185	2	64	0.0312500
NODE_303556_length_158_cov_61.203390	2	66	187	2	64	0.0312500
NODE_303556_length_158_cov_61.203390	2	66	189	12	64	0.1875000
NODE_303556_length_158_cov_61.203390	2	66	27	1	64	0.0156250
NODE_303556_length_158_cov_61.203390	2	66	29	1	64	0.0156250
NODE_303556_length_158_cov_61.203390	2	66	35	1	64	0.0156250
NODE_303556_length_158_cov_61.203390	2	66	43	3	64	0.0468750
NODE_303556_length_158_cov_61.203390	2	66	45	1	64	0.0156250
NODE_303556_length_158_cov_61.203390	2	66	58	4	64	0.0625000
NODE_303556_length_158_cov_61.203390	2	66	60	1	64	0.0156250
NODE_303556_length_158_cov_61.203390	2	66	72	1	64	0.0156250
NODE_303556_length_158_cov_61.203390	2	66	76	2	64	0.0312500
NODE_303556_length_158_cov_61.203390	2	66	84	1	64	0.0156250
NODE_303556_length_158_cov_61.203390	2	66	91	1	64	0.0156250
NODE_303556_length_158_cov_61.203390	2	66	100	1	64	0.0156250
NODE_303556_length_158_cov_61.203390	2	66	103	1	64	0.0156250
NODE_303556_length_158_cov_61.203390	2	66	113	1	64	0.0156250
NODE_303556_length_158_cov_61.203390	2	66	115	2	64	0.0312500
NODE_303556_length_158_cov_61.203390	2	66	121	1	64	0.0156250
NODE_303556_length_158_cov_61.203390	2	66	127	1	64	0.0156250
NODE_303556_length_158_cov_61.203390	2	66	131	2	64	0.0312500
NODE_303556_length_158_cov_61.203390	2	66	141	2	64	0.0312500
NODE_303556_length_158_cov_61.203390	2	66	145	1	64	0.0156250
NODE_303556_length_158_cov_61.203390	2	66	149	3	64	0.0468750
NODE_303556_length_158_cov_61.203390	2	66	156	6	64	0.0937500
NODE_303556_length_158_cov_61.203390	2	66	158	1	64	0.0156250
NODE_303556_length_158_cov_61.203390	2	66	164	1	64	0.0156250
NODE_303556_length_158_cov_61.203390	2	66	165	1	64	0.0156250
NODE_303556_length_158_cov_61.203390	2	66	167	1	64	0.0156250
NODE_303556_length_158_cov_61.203390	2	66	173	1	64	0.0156250
NODE_303556_length_158_cov_61.203390	2	66	179	1	64	0.0156250
NODE_303556_length_158_cov_61.203390	2	66	181	2	64	0.0312500
NODE_303556_length_158_cov_61.203390	2	66	183	2	64	0.0312500
NODE_303556_length_158_cov_61.203390	2	66	185	2	64	0.0312500
NODE_303556_length_158_cov_61.203390	2	66	187	2	64	0.0312500
NODE_303556_length_158_cov_61.203390	2	66	189	12	64	0.1875000
NODE_303556_length_158_cov_61.203390	39	119	149	1	80	0.0125000
NODE_303556_length_158_cov_61.203390	39	119	151	1	80	0.0125000
NODE_303556_length_158_cov_61.203390	39	119	153	1	80	0.0125000
NODE_303556_length_158_cov_61.203390	39	119	155	1	80	0.0125000
NODE_303556_length_158_cov_61.203390	39	119	156	1	80	0.0125000
NODE_303556_length_158_cov_61.203390	39	119	158	1	80	0.0125000
NODE_303556_length_158_cov_61.203390	39	119	164	1	80	0.0125000
NODE_303556_length_158_cov_61.203390	39	119	165	1	80	0.0125000
NODE_303556_length_158_cov_61.203390	39	119	167	5	80	0.0625000
NODE_303556_length_158_cov_61.203390	39	119	173	8	80	0.1000000
NODE_303556_length_158_cov_61.203390	39	119	177	3	80	0.0375000
NODE_303556_length_158_cov_61.203390	39	119	179	1	80	0.0125000
NODE_303556_length_158_cov_61.203390	39	119	181	2	80	0.0250000
NODE_303556_length_158_cov_61.203390	39	119	183	2	80	0.0250000
NODE_303556_length_158_cov_61.203390	39	119	185	2	80	0.0250000
NODE_303556_length_158_cov_61.203390	39	119	186	12	80	0.1500000
NODE_303556_length_158_cov_61.203390	39	119	187	16	80	0.2000000
NODE_303556_length_158_cov_61.203390	39	119	188	4	80	0.0500000
NODE_303556_length_158_cov_61.203390	39	119	189	17	80	0.2125000
NODE_303563_length_158_cov_40.271186	43	107	34	1	64	0.0156250
NODE_303563_length_158_cov_40.271186	43	107	42	63	64	0.9843750
NODE_303563_length_158_cov_40.271186	80	151	20	18	71	0.2535211
NODE_303563_length_158_cov_40.271186	80	151	26	11	71	0.1549296
NODE_303563_length_158_cov_40.271186	80	151	28	1	71	0.0140845
NODE_303563_length_158_cov_40.271186	80	151	30	5	71	0.0704225
NODE_303563_length_158_cov_40.271186	80	151	36	3	71	0.0422535
NODE_303563_length_158_cov_40.271186	80	151	40	1	71	0.0140845
NODE_303563_length_158_cov_40.271186	80	151	42	32	71	0.4507042
NODE_303566_length_158_cov_29.661017	0	61	0	61	61	1.0000000
NODE_303566_length_158_cov_29.661017	34	64	0	30	30	1.0000000
NODE_303605_length_157_cov_1488.586207	57	138	40	2	81	0.0246914
NODE_303605_length_157_cov_1488.586207	57	138	42	2	81	0.0246914
NODE_303605_length_157_cov_1488.586207	57	138	48	1	81	0.0123457
NODE_303605_length_157_cov_1488.586207	57	138	52	1	81	0.0123457
NODE_303605_length_157_cov_1488.586207	57	138	59	1	81	0.0123457
NODE_303605_length_157_cov_1488.586207	57	138	63	1	81	0.0123457
NODE_303605_length_157_cov_1488.586207	57	138	71	1	81	0.0123457
NODE_303605_length_157_cov_1488.586207	57	138	77	1	81	0.0123457
NODE_303605_length_157_cov_1488.586207	57	138	81	1	81	0.0123457
NODE_303605_length_157_cov_1488.586207	57	138	89	1	81	0.0123457
NODE_303605_length_157_cov_1488.586207	57	138	91	1	81	0.0123457
NODE_303605_length_157_cov_1488.586207	57	138	97	3	81	0.0370370
NODE_303605_length_157_cov_1488.586207	57	138	103	1	81	0.0123457
NODE_303605_length_157_cov_1488.586207	57	138	105	1	81	0.0123457
NODE_303605_length_157_cov_1488.586207	57	138	107	2	81	0.0246914
NODE_303605_length_157_cov_1488.586207	57	138	109	8	81	0.0987654
NODE_303605_length_157_cov_1488.586207	57	138	111	3	81	0.0370370
NODE_303605_length_157_cov_1488.586207	57	138	116	1	81	0.0123457
NODE_303605_length_157_cov_1488.586207	57	138	117	3	81	0.0370370
NODE_303605_length_157_cov_1488.586207	57	138	119	26	81	0.3209876
NODE_303605_length_157_cov_1488.586207	57	138	120	20	81	0.2469136
NODE_303605_length_157_cov_1488.586207	111	157	2	5	46	0.1086956
NODE_303605_length_157_cov_1488.586207	111	157	4	1	46	0.0217391
NODE_303605_length_157_cov_1488.586207	111	157	10	2	46	0.0434783
NODE_303605_length_157_cov_1488.586207	111	157	12	1	46	0.0217391
NODE_303605_length_157_cov_1488.586207	111	157	14	1	46	0.0217391
NODE_303605_length_157_cov_1488.586207	111	157	18	2	46	0.0434783
NODE_303605_length_157_cov_1488.586207	111	157	22	1	46	0.0217391
NODE_303605_length_157_cov_1488.586207	111	157	28	2	46	0.0434783
NODE_303605_length_157_cov_1488.586207	111	157	30	1	46	0.0217391
NODE_303605_length_157_cov_1488.586207	111	157	32	2	46	0.0434783
NODE_303605_length_157_cov_1488.586207	111	157	36	1	46	0.0217391
NODE_303605_length_157_cov_1488.586207	111	157	40	2	46	0.0434783
NODE_303605_length_157_cov_1488.586207	111	157	42	2	46	0.0434783
NODE_303605_length_157_cov_1488.586207	111	157	48	1	46	0.0217391
NODE_303605_length_157_cov_1488.586207	111	157	52	1	46	0.0217391
NODE_303605_length_157_cov_1488.586207	111	157	59	1	46	0.0217391
NODE_303605_length_157_cov_1488.586207	111	157	63	1	46	0.0217391
NODE_303605_length_157_cov_1488.586207	111	157	71	1	46	0.0217391
NODE_303605_length_157_cov_1488.586207	111	157	77	1	46	0.0217391
NODE_303605_length_157_cov_1488.586207	111	157	81	1	46	0.0217391
NODE_303605_length_157_cov_1488.586207	111	157	89	1	46	0.0217391
NODE_303605_length_157_cov_1488.586207	111	157	91	1	46	0.0217391
NODE_303605_length_157_cov_1488.586207	111	157	97	3	46	0.0652174
NODE_303605_length_157_cov_1488.586207	111	157	103	1	46	0.0217391
NODE_303605_length_157_cov_1488.586207	111	157	105	1	46	0.0217391
NODE_303605_length_157_cov_1488.586207	111	157	107	2	46	0.0434783
NODE_303605_length_157_cov_1488.586207	111	157	109	7	46	0.1521739
NODE_303606_length_157_cov_295.896552	32	78	38	2	46	0.0434783
NODE_303606_length_157_cov_295.896552	32	78	40	3	46	0.0652174
NODE_303606_length_157_cov_295.896552	32	78	44	1	46	0.0217391
NODE_303606_length_157_cov_295.896552	32	78	46	2	46	0.0434783
NODE_303606_length_157_cov_295.896552	32	78	48	1	46	0.0217391
NODE_303606_length_157_cov_295.896552	32	78	52	2	46	0.0434783
NODE_303606_length_157_cov_295.896552	32	78	54	1	46	0.0217391
NODE_303606_length_157_cov_295.896552	32	78	56	1	46	0.0217391
NODE_303606_length_157_cov_295.896552	32	78	58	1	46	0.0217391
NODE_303606_length_157_cov_295.896552	32	78	60	1	46	0.0217391
NODE_303606_length_157_cov_295.896552	32	78	66	1	46	0.0217391
NODE_303606_length_157_cov_295.896552	32	78	70	1	46	0.0217391
NODE_303606_length_157_cov_295.896552	32	78	74	3	46	0.0652174
NODE_303606_length_157_cov_295.896552	32	78	76	1	46	0.0217391
NODE_303606_length_157_cov_295.896552	32	78	78	2	46	0.0434783
NODE_303606_length_157_cov_295.896552	32	78	80	23	46	0.5000000
NODE_303608_length_157_cov_161.689655	0	59	0	11	59	0.1864407
NODE_303608_length_157_cov_161.689655	0	59	2	5	59	0.0847458
NODE_303608_length_157_cov_161.689655	0	59	4	12	59	0.2033898
NODE_303608_length_157_cov_161.689655	0	59	9	2	59	0.0338983
NODE_303608_length_157_cov_161.689655	0	59	11	11	59	0.1864407
NODE_303608_length_157_cov_161.689655	0	59	12	3	59	0.0508475
NODE_303608_length_157_cov_161.689655	0	59	14	5	59	0.0847458
NODE_303608_length_157_cov_161.689655	0	59	16	10	59	0.1694915
NODE_303608_length_157_cov_161.689655	0	59	0	11	59	0.1864407
NODE_303608_length_157_cov_161.689655	0	59	2	5	59	0.0847458
NODE_303608_length_157_cov_161.689655	0	59	4	12	59	0.2033898
NODE_303608_length_157_cov_161.689655	0	59	9	2	59	0.0338983
NODE_303608_length_157_cov_161.689655	0	59	11	11	59	0.1864407
NODE_303608_length_157_cov_161.689655	0	59	12	3	59	0.0508475
NODE_303608_length_157_cov_161.689655	0	59	14	5	59	0.0847458
NODE_303608_length_157_cov_161.689655	0	59	16	10	59	0.1694915
NODE_303608_length_157_cov_161.689655	55	135	12	4	80	0.0500000
NODE_303608_length_157_cov_161.689655	55	135	14	13	80	0.1625000
NODE_303608_length_157_cov_161.689655	55	135	16	63	80	0.7875000
NODE_303608_length_157_cov_161.689655	55	135	12	4	80	0.0500000
NODE_303608_length_157_cov_161.689655	55	135	14	13	80	0.1625000
NODE_303608_length_157_cov_161.689655	55	135	16	63	80	0.7875000
NODE_303608_length_157_cov_161.689655	108	157	2	13	49	0.2653061
NODE_303608_length_157_cov_161.689655	108	157	6	9	49	0.1836735
NODE_303608_length_157_cov_161.689655	108	157	12	4	49	0.0816327
NODE_303608_length_157_cov_161.689655	108	157	14	13	49	0.2653061
NODE_303608_length_157_cov_161.689655	108	157	16	10	49	0.2040816
NODE_303608_length_157_cov_161.689655	113	157	2	13	44	0.2954545
NODE_303608_length_157_cov_161.689655	113	157	6	9	44	0.2045455
NODE_303608_length_157_cov_161.689655	113	157	12	4	44	0.0909091
NODE_303608_length_157_cov_161.689655	113	157	14	13	44	0.2954545
NODE_303608_length_157_cov_161.689655	113	157	16	5	44	0.1136364
NODE_303677_length_156_cov_100.491228	0	41	0	8	41	0.1951219
NODE_303677_length_156_cov_100.491228	0	41	2	30	41	0.7317073
NODE_303677_length_156_cov_100.491228	0	41	4	3	41	0.0731707
NODE_303677_length_156_cov_100.491228	21	94	2	17	73	0.2328767
NODE_303677_length_156_cov_100.491228	21	94	4	9	73	0.1232877
NODE_303677_length_156_cov_100.491228	21	94	6	47	73	0.6438356
NODE_303688_length_156_cov_37.368421	24	81	0	2	57	0.0350877
NODE_303688_length_156_cov_37.368421	24	81	4	3	57	0.0526316
NODE_303688_length_156_cov_37.368421	24	81	6	3	57	0.0526316
NODE_303688_length_156_cov_37.368421	24	81	8	5	57	0.0877193
NODE_303688_length_156_cov_37.368421	24	81	10	10	57	0.1754386
NODE_303688_length_156_cov_37.368421	24	81	12	2	57	0.0350877
NODE_303688_length_156_cov_37.368421	24	81	14	32	57	0.5614035
NODE_303688_length_156_cov_37.368421	54	134	14	80	80	1.0000000
NODE_303700_length_156_cov_9.543860	2	48	0	42	46	0.9130435
NODE_303700_length_156_cov_9.543860	2	48	2	4	46	0.0869565
NODE_303700_length_156_cov_9.543860	59	105	2	46	46	1.0000000
NODE_303752_length_155_cov_56.750000	27	102	0	75	75	1.0000000
NODE_303752_length_155_cov_56.750000	80	155	0	75	75	1.0000000
NODE_304022_length_153_cov_0.944444	5	48	0	43	43	1.0000000
NODE_304022_length_153_cov_0.944444	37	86	0	49	49	1.0000000
NODE_304022_length_153_cov_0.944444	59	102	0	43	43	1.0000000
NODE_304022_length_153_cov_0.944444	91	140	0	49	49	1.0000000
NODE_304022_length_153_cov_0.944444	113	153	0	40	40	1.0000000
NODE_304027_length_152_cov_195.396226	9	89	0	17	80	0.2125000
NODE_304027_length_152_cov_195.396226	9	89	2	6	80	0.0750000
NODE_304027_length_152_cov_195.396226	9	89	4	57	80	0.7125000
NODE_304027_length_152_cov_195.396226	9	89	0	17	80	0.2125000
NODE_304027_length_152_cov_195.396226	9	89	2	6	80	0.0750000
NODE_304027_length_152_cov_195.396226	9	89	4	57	80	0.7125000
NODE_304027_length_152_cov_195.396226	85	149	0	16	64	0.2500000
NODE_304027_length_152_cov_195.396226	85	149	2	25	64	0.3906250
NODE_304027_length_152_cov_195.396226	85	149	4	23	64	0.3593750
NODE_304027_length_152_cov_195.396226	85	152	0	19	67	0.2835821
NODE_304027_length_152_cov_195.396226	85	152	2	25	67	0.3731343
NODE_304027_length_152_cov_195.396226	85	152	4	23	67	0.3432836
NODE_304027_length_152_cov_195.396226	85	152	0	19	67	0.2835821
NODE_304027_length_152_cov_195.396226	85	152	2	25	67	0.3731343
NODE_304027_length_152_cov_195.396226	85	152	4	23	67	0.3432836
NODE_304027_length_152_cov_195.396226	85	152	0	19	67	0.2835821
NODE_304027_length_152_cov_195.396226	85	152	2	25	67	0.3731343
NODE_304027_length_152_cov_195.396226	85	152	4	23	67	0.3432836
NODE_304030_length_152_cov_68.094340	99	150	0	46	51	0.9019608
NODE_304030_length_152_cov_68.094340	99	150	2	5	51	0.0980392
NODE_304112_length_151_cov_541.615385	19	88	2	4	69	0.0579710
NODE_304112_length_151_cov_541.615385	19	88	3	1	69	0.0144928
NODE_304112_length_151_cov_541.615385	19	88	4	3	69	0.0434783
NODE_304112_length_151_cov_541.615385	19	88	6	1	69	0.0144928
NODE_304112_length_151_cov_541.615385	19	88	10	7	69	0.1014493
NODE_304112_length_151_cov_541.615385	19	88	12	4	69	0.0579710
NODE_304112_length_151_cov_541.615385	19	88	14	1	69	0.0144928
NODE_304112_length_151_cov_541.615385	19	88	18	1	69	0.0144928
NODE_304112_length_151_cov_541.615385	19	88	22	4	69	0.0579710
NODE_304112_length_151_cov_541.615385	19	88	24	43	69	0.6231884
NODE_304112_length_151_cov_541.615385	72	149	6	3	77	0.0389610
NODE_304112_length_151_cov_541.615385	72	149	10	5	77	0.0649351
NODE_304112_length_151_cov_541.615385	72	149	12	2	77	0.0259740
NODE_304112_length_151_cov_541.615385	72	149	16	12	77	0.1558442
NODE_304112_length_151_cov_541.615385	72	149	18	8	77	0.1038961
NODE_304112_length_151_cov_541.615385	72	149	20	3	77	0.0389610
NODE_304112_length_151_cov_541.615385	72	149	22	12	77	0.1558442
NODE_304112_length_151_cov_541.615385	72	149	24	32	77	0.4155844
NODE_304229_length_150_cov_88.647059	51	102	12	51	51	1.0000000
NODE_304472_length_148_cov_34.183673	23	99	11	3	76	0.0394737
NODE_304472_length_148_cov_34.183673	23	99	13	6	76	0.0789474
NODE_304472_length_148_cov_34.183673	23	99	17	1	76	0.0131579
NODE_304472_length_148_cov_34.183673	23	99	19	1	76	0.0131579
NODE_304472_length_148_cov_34.183673	23	99	21	2	76	0.0263158
NODE_304472_length_148_cov_34.183673	23	99	23	4	76	0.0526316
NODE_304472_length_148_cov_34.183673	23	99	25	4	76	0.0526316
NODE_304472_length_148_cov_34.183673	23	99	29	55	76	0.7236842
NODE_304570_length_147_cov_472.354167	0	55	6	2	55	0.0363636
NODE_304570_length_147_cov_472.354167	0	55	8	1	55	0.0181818
NODE_304570_length_147_cov_472.354167	0	55	10	8	55	0.1454545
NODE_304570_length_147_cov_472.354167	0	55	12	1	55	0.0181818
NODE_304570_length_147_cov_472.354167	0	55	14	1	55	0.0181818
NODE_304570_length_147_cov_472.354167	0	55	18	1	55	0.0181818
NODE_304570_length_147_cov_472.354167	0	55	20	3	55	0.0545455
NODE_304570_length_147_cov_472.354167	0	55	22	1	55	0.0181818
NODE_304570_length_147_cov_472.354167	0	55	24	6	55	0.1090909
NODE_304570_length_147_cov_472.354167	0	55	28	5	55	0.0909091
NODE_304570_length_147_cov_472.354167	0	55	30	2	55	0.0363636
NODE_304570_length_147_cov_472.354167	0	55	32	8	55	0.1454545
NODE_304570_length_147_cov_472.354167	0	55	34	16	55	0.2909091
NODE_304570_length_147_cov_472.354167	12	89	14	1	77	0.0129870
NODE_304570_length_147_cov_472.354167	12	89	18	1	77	0.0129870
NODE_304570_length_147_cov_472.354167	12	89	20	3	77	0.0389610
NODE_304570_length_147_cov_472.354167	12	89	22	1	77	0.0129870
NODE_304570_length_147_cov_472.354167	12	89	24	6	77	0.0779221
NODE_304570_length_147_cov_472.354167	12	89	28	5	77	0.0649351
NODE_304570_length_147_cov_472.354167	12	89	30	2	77	0.0259740
NODE_304570_length_147_cov_472.354167	12	89	32	8	77	0.1038961
NODE_304570_length_147_cov_472.354167	12	89	34	50	77	0.6493506
NODE_304570_length_147_cov_472.354167	65	137	4	3	72	0.0416667
NODE_304570_length_147_cov_472.354167	65	137	10	3	72	0.0416667
NODE_304570_length_147_cov_472.354167	65	137	12	2	72	0.0277778
NODE_304570_length_147_cov_472.354167	65	137	14	3	72	0.0416667
NODE_304570_length_147_cov_472.354167	65	137	16	8	72	0.1111111
NODE_304570_length_147_cov_472.354167	65	137	20	1	72	0.0138889
NODE_304570_length_147_cov_472.354167	65	137	22	1	72	0.0138889
NODE_304570_length_147_cov_472.354167	65	137	24	3	72	0.0416667
NODE_304570_length_147_cov_472.354167	65	137	26	3	72	0.0416667
NODE_304570_length_147_cov_472.354167	65	137	28	1	72	0.0138889
NODE_304570_length_147_cov_472.354167	65	137	30	1	72	0.0138889
NODE_304570_length_147_cov_472.354167	65	137	32	3	72	0.0416667
NODE_304570_length_147_cov_472.354167	65	137	34	40	72	0.5555556
NODE_304572_length_147_cov_229.729167	7	56	0	3	49	0.0612245
NODE_304572_length_147_cov_229.729167	7	56	2	1	49	0.0204082
NODE_304572_length_147_cov_229.729167	7	56	4	1	49	0.0204082
NODE_304572_length_147_cov_229.729167	7	56	6	1	49	0.0204082
NODE_304572_length_147_cov_229.729167	7	56	8	1	49	0.0204082
NODE_304572_length_147_cov_229.729167	7	56	10	1	49	0.0204082
NODE_304572_length_147_cov_229.729167	7	56	15	3	49	0.0612245
NODE_304572_length_147_cov_229.729167	7	56	21	2	49	0.0408163
NODE_304572_length_147_cov_229.729167	7	56	25	2	49	0.0408163
NODE_304572_length_147_cov_229.729167	7	56	27	1	49	0.0204082
NODE_304572_length_147_cov_229.729167	7	56	30	1	49	0.0204082
NODE_304572_length_147_cov_229.729167	7	56	33	3	49	0.0612245
NODE_304572_length_147_cov_229.729167	7	56	35	2	49	0.0408163
NODE_304572_length_147_cov_229.729167	7	56	37	4	49	0.0816327
NODE_304572_length_147_cov_229.729167	7	56	38	3	49	0.0612245
NODE_304572_length_147_cov_229.729167	7	56	40	1	49	0.0204082
NODE_304572_length_147_cov_229.729167	7	56	48	1	49	0.0204082
NODE_304572_length_147_cov_229.729167	7	56	50	4	49	0.0816327
NODE_304572_length_147_cov_229.729167	7	56	54	1	49	0.0204082
NODE_304572_length_147_cov_229.729167	7	56	56	13	49	0.2653061
NODE_304572_length_147_cov_229.729167	29	93	37	4	64	0.0625000
NODE_304572_length_147_cov_229.729167	29	93	38	3	64	0.0468750
NODE_304572_length_147_cov_229.729167	29	93	40	1	64	0.0156250
NODE_304572_length_147_cov_229.729167	29	93	48	1	64	0.0156250
NODE_304572_length_147_cov_229.729167	29	93	50	4	64	0.0625000
NODE_304572_length_147_cov_229.729167	29	93	54	1	64	0.0156250
NODE_304572_length_147_cov_229.729167	29	93	56	50	64	0.7812500
NODE_304572_length_147_cov_229.729167	29	93	37	4	64	0.0625000
NODE_304572_length_147_cov_229.729167	29	93	38	3	64	0.0468750
NODE_304572_length_147_cov_229.729167	29	93	40	1	64	0.0156250
NODE_304572_length_147_cov_229.729167	29	93	48	1	64	0.0156250
NODE_304572_length_147_cov_229.729167	29	93	50	4	64	0.0625000
NODE_304572_length_147_cov_229.729167	29	93	54	1	64	0.0156250
NODE_304572_length_147_cov_229.729167	29	93	56	50	64	0.7812500
NODE_304572_length_147_cov_229.729167	29	93	37	4	64	0.0625000
NODE_304572_length_147_cov_229.729167	29	93	38	3	64	0.0468750
NODE_304572_length_147_cov_229.729167	29	93	40	1	64	0.0156250
NODE_304572_length_147_cov_229.729167	29	93	48	1	64	0.0156250
NODE_304572_length_147_cov_229.729167	29	93	50	4	64	0.0625000
NODE_304572_length_147_cov_229.729167	29	93	54	1	64	0.0156250
NODE_304572_length_147_cov_229.729167	29	93	56	50	64	0.7812500
NODE_304573_length_147_cov_213.770833	37	117	0	80	80	1.0000000
NODE_304573_length_147_cov_213.770833	90	146	0	56	56	1.0000000
NODE_304697_length_146_cov_182.893617	1	60	4	18	59	0.3050847
NODE_304697_length_146_cov_182.893617	1	60	6	41	59	0.6949152
NODE_304697_length_146_cov_182.893617	34	60	6	26	26	1.0000000
NODE_304697_length_146_cov_182.893617	113	144	0	17	31	0.5483871
NODE_304697_length_146_cov_182.893617	113	144	2	6	31	0.1935484
NODE_304697_length_146_cov_182.893617	113	144	4	8	31	0.2580645
NODE_304698_length_146_cov_152.808511	0	69	0	69	69	1.0000000
NODE_304698_length_146_cov_152.808511	42	122	0	80	80	1.0000000
NODE_304703_length_146_cov_89.808511	0	53	0	5	53	0.0943396
NODE_304703_length_146_cov_89.808511	0	53	2	48	53	0.9056604
NODE_304703_length_146_cov_89.808511	26	106	2	80	80	1.0000000
NODE_304703_length_146_cov_89.808511	74	146	0	7	72	0.0972222
NODE_304703_length_146_cov_89.808511	74	146	2	65	72	0.9027778
NODE_304703_length_146_cov_89.808511	79	101	2	22	22	1.0000000
NODE_304707_length_146_cov_57.446809	44	124	0	80	80	1.0000000
NODE_304708_length_146_cov_54.106383	0	69	0	69	69	1.0000000
NODE_304708_length_146_cov_54.106383	42	122	0	80	80	1.0000000
NODE_304710_length_146_cov_46.765957	3	83	0	1	80	0.0125000
NODE_304710_length_146_cov_46.765957	3	83	2	20	80	0.2500000
NODE_304710_length_146_cov_46.765957	3	83	4	3	80	0.0375000
NODE_304710_length_146_cov_46.765957	3	83	8	56	80	0.7000000
NODE_304710_length_146_cov_46.765957	3	83	0	1	80	0.0125000
NODE_304710_length_146_cov_46.765957	3	83	2	20	80	0.2500000
NODE_304710_length_146_cov_46.765957	3	83	4	3	80	0.0375000
NODE_304710_length_146_cov_46.765957	3	83	8	56	80	0.7000000
NODE_304710_length_146_cov_46.765957	3	83	0	1	80	0.0125000
NODE_304710_length_146_cov_46.765957	3	83	2	20	80	0.2500000
NODE_304710_length_146_cov_46.765957	3	83	4	3	80	0.0375000
NODE_304710_length_146_cov_46.765957	3	83	8	56	80	0.7000000
NODE_304710_length_146_cov_46.765957	3	83	0	1	80	0.0125000
NODE_304710_length_146_cov_46.765957	3	83	2	20	80	0.2500000
NODE_304710_length_146_cov_46.765957	3	83	4	3	80	0.0375000
NODE_304710_length_146_cov_46.765957	3	83	8	56	80	0.7000000
NODE_304710_length_146_cov_46.765957	3	83	0	1	80	0.0125000
NODE_304710_length_146_cov_46.765957	3	83	2	20	80	0.2500000
NODE_304710_length_146_cov_46.765957	3	83	4	3	80	0.0375000
NODE_304710_length_146_cov_46.765957	3	83	8	56	80	0.7000000
NODE_304710_length_146_cov_46.765957	12	83	2	12	71	0.1690141
NODE_304710_length_146_cov_46.765957	12	83	4	3	71	0.0422535
NODE_304710_length_146_cov_46.765957	12	83	8	56	71	0.7887324
NODE_304710_length_146_cov_46.765957	56	136	2	9	80	0.1125000
NODE_304710_length_146_cov_46.765957	56	136	6	7	80	0.0875000
NODE_304710_length_146_cov_46.765957	56	136	8	64	80	0.8000000
NODE_304710_length_146_cov_46.765957	56	136	2	9	80	0.1125000
NODE_304710_length_146_cov_46.765957	56	136	6	7	80	0.0875000
NODE_304710_length_146_cov_46.765957	56	136	8	64	80	0.8000000
NODE_304711_length_146_cov_44.021277	0	69	0	69	69	1.0000000
NODE_304711_length_146_cov_44.021277	42	122	0	80	80	1.0000000
NODE_304798_length_145_cov_1385.413043	0	69	22	1	69	0.0144928
NODE_304798_length_145_cov_1385.413043	0	69	24	1	69	0.0144928
NODE_304798_length_145_cov_1385.413043	0	69	32	1	69	0.0144928
NODE_304798_length_145_cov_1385.413043	0	69	34	1	69	0.0144928
NODE_304798_length_145_cov_1385.413043	0	69	36	1	69	0.0144928
NODE_304798_length_145_cov_1385.413043	0	69	38	1	69	0.0144928
NODE_304798_length_145_cov_1385.413043	0	69	42	1	69	0.0144928
NODE_304798_length_145_cov_1385.413043	0	69	50	1	69	0.0144928
NODE_304798_length_145_cov_1385.413043	0	69	56	2	69	0.0289855
NODE_304798_length_145_cov_1385.413043	0	69	66	1	69	0.0144928
NODE_304798_length_145_cov_1385.413043	0	69	72	1	69	0.0144928
NODE_304798_length_145_cov_1385.413043	0	69	78	1	69	0.0144928
NODE_304798_length_145_cov_1385.413043	0	69	84	1	69	0.0144928
NODE_304798_length_145_cov_1385.413043	0	69	93	1	69	0.0144928
NODE_304798_length_145_cov_1385.413043	0	69	101	2	69	0.0289855
NODE_304798_length_145_cov_1385.413043	0	69	115	1	69	0.0144928
NODE_304798_length_145_cov_1385.413043	0	69	117	1	69	0.0144928
NODE_304798_length_145_cov_1385.413043	0	69	123	1	69	0.0144928
NODE_304798_length_145_cov_1385.413043	0	69	127	1	69	0.0144928
NODE_304798_length_145_cov_1385.413043	0	69	137	1	69	0.0144928
NODE_304798_length_145_cov_1385.413043	0	69	153	1	69	0.0144928
NODE_304798_length_145_cov_1385.413043	0	69	157	1	69	0.0144928
NODE_304798_length_145_cov_1385.413043	0	69	159	1	69	0.0144928
NODE_304798_length_145_cov_1385.413043	0	69	161	2	69	0.0289855
NODE_304798_length_145_cov_1385.413043	0	69	163	2	69	0.0289855
NODE_304798_length_145_cov_1385.413043	0	69	169	1	69	0.0144928
NODE_304798_length_145_cov_1385.413043	0	69	173	1	69	0.0144928
NODE_304798_length_145_cov_1385.413043	0	69	183	1	69	0.0144928
NODE_304798_length_145_cov_1385.413043	0	69	187	1	69	0.0144928
NODE_304798_length_145_cov_1385.413043	0	69	193	1	69	0.0144928
NODE_304798_length_145_cov_1385.413043	0	69	195	1	69	0.0144928
NODE_304798_length_145_cov_1385.413043	0	69	201	3	69	0.0434783
NODE_304798_length_145_cov_1385.413043	0	69	210	1	69	0.0144928
NODE_304798_length_145_cov_1385.413043	0	69	217	1	69	0.0144928
NODE_304798_length_145_cov_1385.413043	0	69	226	1	69	0.0144928
NODE_304798_length_145_cov_1385.413043	0	69	230	1	69	0.0144928
NODE_304798_length_145_cov_1385.413043	0	69	231	1	69	0.0144928
NODE_304798_length_145_cov_1385.413043	0	69	236	3	69	0.0434783
NODE_304798_length_145_cov_1385.413043	0	69	237	12	69	0.1739130
NODE_304798_length_145_cov_1385.413043	0	69	238	11	69	0.1594203
NODE_304798_length_145_cov_1385.413043	42	122	152	1	80	0.0125000
NODE_304798_length_145_cov_1385.413043	42	122	158	1	80	0.0125000
NODE_304798_length_145_cov_1385.413043	42	122	163	1	80	0.0125000
NODE_304798_length_145_cov_1385.413043	42	122	165	1	80	0.0125000
NODE_304798_length_145_cov_1385.413043	42	122	170	1	80	0.0125000
NODE_304798_length_145_cov_1385.413043	42	122	174	1	80	0.0125000
NODE_304798_length_145_cov_1385.413043	42	122	178	1	80	0.0125000
NODE_304798_length_145_cov_1385.413043	42	122	180	1	80	0.0125000
NODE_304798_length_145_cov_1385.413043	42	122	186	1	80	0.0125000
NODE_304798_length_145_cov_1385.413043	42	122	194	1	80	0.0125000
NODE_304798_length_145_cov_1385.413043	42	122	198	1	80	0.0125000
NODE_304798_length_145_cov_1385.413043	42	122	202	1	80	0.0125000
NODE_304798_length_145_cov_1385.413043	42	122	212	1	80	0.0125000
NODE_304798_length_145_cov_1385.413043	42	122	216	1	80	0.0125000
NODE_304798_length_145_cov_1385.413043	42	122	222	2	80	0.0250000
NODE_304798_length_145_cov_1385.413043	42	122	224	1	80	0.0125000
NODE_304798_length_145_cov_1385.413043	42	122	230	2	80	0.0250000
NODE_304798_length_145_cov_1385.413043	42	122	231	1	80	0.0125000
NODE_304798_length_145_cov_1385.413043	42	122	232	1	80	0.0125000
NODE_304798_length_145_cov_1385.413043	42	122	236	6	80	0.0750000
NODE_304798_length_145_cov_1385.413043	42	122	237	12	80	0.1500000
NODE_304798_length_145_cov_1385.413043	42	122	238	41	80	0.5125000
NODE_304799_length_145_cov_880.369565	56	120	169	3	64	0.0468750
NODE_304799_length_145_cov_880.369565	56	120	171	1	64	0.0156250
NODE_304799_length_145_cov_880.369565	56	120	177	2	64	0.0312500
NODE_304799_length_145_cov_880.369565	56	120	181	1	64	0.0156250
NODE_304799_length_145_cov_880.369565	56	120	183	1	64	0.0156250
NODE_304799_length_145_cov_880.369565	56	120	193	1	64	0.0156250
NODE_304799_length_145_cov_880.369565	56	120	195	1	64	0.0156250
NODE_304799_length_145_cov_880.369565	56	120	198	1	64	0.0156250
NODE_304799_length_145_cov_880.369565	56	120	199	1	64	0.0156250
NODE_304799_length_145_cov_880.369565	56	120	209	1	64	0.0156250
NODE_304799_length_145_cov_880.369565	56	120	210	1	64	0.0156250
NODE_304799_length_145_cov_880.369565	56	120	214	2	64	0.0312500
NODE_304799_length_145_cov_880.369565	56	120	216	1	64	0.0156250
NODE_304799_length_145_cov_880.369565	56	120	220	47	64	0.7343750
NODE_304799_length_145_cov_880.369565	56	120	169	3	64	0.0468750
NODE_304799_length_145_cov_880.369565	56	120	171	1	64	0.0156250
NODE_304799_length_145_cov_880.369565	56	120	177	2	64	0.0312500
NODE_304799_length_145_cov_880.369565	56	120	181	1	64	0.0156250
NODE_304799_length_145_cov_880.369565	56	120	183	1	64	0.0156250
NODE_304799_length_145_cov_880.369565	56	120	193	1	64	0.0156250
NODE_304799_length_145_cov_880.369565	56	120	195	1	64	0.0156250
NODE_304799_length_145_cov_880.369565	56	120	198	1	64	0.0156250
NODE_304799_length_145_cov_880.369565	56	120	199	1	64	0.0156250
NODE_304799_length_145_cov_880.369565	56	120	209	1	64	0.0156250
NODE_304799_length_145_cov_880.369565	56	120	210	1	64	0.0156250
NODE_304799_length_145_cov_880.369565	56	120	214	2	64	0.0312500
NODE_304799_length_145_cov_880.369565	56	120	216	1	64	0.0156250
NODE_304799_length_145_cov_880.369565	56	120	220	47	64	0.7343750
NODE_304799_length_145_cov_880.369565	56	120	169	3	64	0.0468750
NODE_304799_length_145_cov_880.369565	56	120	171	1	64	0.0156250
NODE_304799_length_145_cov_880.369565	56	120	177	2	64	0.0312500
NODE_304799_length_145_cov_880.369565	56	120	181	1	64	0.0156250
NODE_304799_length_145_cov_880.369565	56	120	183	1	64	0.0156250
NODE_304799_length_145_cov_880.369565	56	120	193	1	64	0.0156250
NODE_304799_length_145_cov_880.369565	56	120	195	1	64	0.0156250
NODE_304799_length_145_cov_880.369565	56	120	198	1	64	0.0156250
NODE_304799_length_145_cov_880.369565	56	120	199	1	64	0.0156250
NODE_304799_length_145_cov_880.369565	56	120	209	1	64	0.0156250
NODE_304799_length_145_cov_880.369565	56	120	210	1	64	0.0156250
NODE_304799_length_145_cov_880.369565	56	120	214	2	64	0.0312500
NODE_304799_length_145_cov_880.369565	56	120	216	1	64	0.0156250
NODE_304799_length_145_cov_880.369565	56	120	220	47	64	0.7343750
NODE_304799_length_145_cov_880.369565	93	142	33	1	49	0.0204082
NODE_304799_length_145_cov_880.369565	93	142	37	1	49	0.0204082
NODE_304799_length_145_cov_880.369565	93	142	47	1	49	0.0204082
NODE_304799_length_145_cov_880.369565	93	142	49	1	49	0.0204082
NODE_304799_length_145_cov_880.369565	93	142	53	1	49	0.0204082
NODE_304799_length_145_cov_880.369565	93	142	57	1	49	0.0204082
NODE_304799_length_145_cov_880.369565	93	142	61	1	49	0.0204082
NODE_304799_length_145_cov_880.369565	93	142	63	1	49	0.0204082
NODE_304799_length_145_cov_880.369565	93	142	69	1	49	0.0204082
NODE_304799_length_145_cov_880.369565	93	142	73	1	49	0.0204082
NODE_304799_length_145_cov_880.369565	93	142	75	1	49	0.0204082
NODE_304799_length_145_cov_880.369565	93	142	91	1	49	0.0204082
NODE_304799_length_145_cov_880.369565	93	142	95	1	49	0.0204082
NODE_304799_length_145_cov_880.369565	93	142	113	2	49	0.0408163
NODE_304799_length_145_cov_880.369565	93	142	119	1	49	0.0204082
NODE_304799_length_145_cov_880.369565	93	142	121	1	49	0.0204082
NODE_304799_length_145_cov_880.369565	93	142	129	2	49	0.0408163
NODE_304799_length_145_cov_880.369565	93	142	141	1	49	0.0204082
NODE_304799_length_145_cov_880.369565	93	142	145	1	49	0.0204082
NODE_304799_length_145_cov_880.369565	93	142	159	1	49	0.0204082
NODE_304799_length_145_cov_880.369565	93	142	169	3	49	0.0612245
NODE_304799_length_145_cov_880.369565	93	142	171	1	49	0.0204082
NODE_304799_length_145_cov_880.369565	93	142	177	2	49	0.0408163
NODE_304799_length_145_cov_880.369565	93	142	181	1	49	0.0204082
NODE_304799_length_145_cov_880.369565	93	142	183	1	49	0.0204082
NODE_304799_length_145_cov_880.369565	93	142	193	1	49	0.0204082
NODE_304799_length_145_cov_880.369565	93	142	195	1	49	0.0204082
NODE_304799_length_145_cov_880.369565	93	142	198	1	49	0.0204082
NODE_304799_length_145_cov_880.369565	93	142	199	1	49	0.0204082
NODE_304799_length_145_cov_880.369565	93	142	209	1	49	0.0204082
NODE_304799_length_145_cov_880.369565	93	142	210	1	49	0.0204082
NODE_304799_length_145_cov_880.369565	93	142	214	2	49	0.0408163
NODE_304799_length_145_cov_880.369565	93	142	216	1	49	0.0204082
NODE_304799_length_145_cov_880.369565	93	142	220	10	49	0.2040816
NODE_304923_length_144_cov_46.155556	1	81	4	3	80	0.0375000
NODE_304923_length_144_cov_46.155556	1	81	6	1	80	0.0125000
NODE_304923_length_144_cov_46.155556	1	81	8	1	80	0.0125000
NODE_304923_length_144_cov_46.155556	1	81	10	2	80	0.0250000
NODE_304923_length_144_cov_46.155556	1	81	12	6	80	0.0750000
NODE_304923_length_144_cov_46.155556	1	81	14	1	80	0.0125000
NODE_304923_length_144_cov_46.155556	1	81	18	3	80	0.0375000
NODE_304923_length_144_cov_46.155556	1	81	20	1	80	0.0125000
NODE_304923_length_144_cov_46.155556	1	81	22	1	80	0.0125000
NODE_304923_length_144_cov_46.155556	1	81	24	9	80	0.1125000
NODE_304923_length_144_cov_46.155556	1	81	26	6	80	0.0750000
NODE_304923_length_144_cov_46.155556	1	81	28	4	80	0.0500000
NODE_304923_length_144_cov_46.155556	1	81	30	42	80	0.5250000
NODE_305208_length_142_cov_244.488372	0	52	2	3	52	0.0576923
NODE_305208_length_142_cov_244.488372	0	52	3	1	52	0.0192308
NODE_305208_length_142_cov_244.488372	0	52	5	1	52	0.0192308
NODE_305208_length_142_cov_244.488372	0	52	7	10	52	0.1923077
NODE_305208_length_142_cov_244.488372	0	52	9	5	52	0.0961538
NODE_305208_length_142_cov_244.488372	0	52	11	1	52	0.0192308
NODE_305208_length_142_cov_244.488372	0	52	13	1	52	0.0192308
NODE_305208_length_142_cov_244.488372	0	52	15	3	52	0.0576923
NODE_305208_length_142_cov_244.488372	0	52	18	2	52	0.0384615
NODE_305208_length_142_cov_244.488372	0	52	20	3	52	0.0576923
NODE_305208_length_142_cov_244.488372	0	52	22	1	52	0.0192308
NODE_305208_length_142_cov_244.488372	0	52	28	2	52	0.0384615
NODE_305208_length_142_cov_244.488372	0	52	30	6	52	0.1153846
NODE_305208_length_142_cov_244.488372	0	52	34	13	52	0.2500000
NODE_305229_length_142_cov_46.976744	1	65	8	8	64	0.1250000
NODE_305229_length_142_cov_46.976744	1	65	10	3	64	0.0468750
NODE_305229_length_142_cov_46.976744	1	65	14	1	64	0.0156250
NODE_305229_length_142_cov_46.976744	1	65	16	2	64	0.0312500
NODE_305229_length_142_cov_46.976744	1	65	22	2	64	0.0312500
NODE_305229_length_142_cov_46.976744	1	65	26	1	64	0.0156250
NODE_305229_length_142_cov_46.976744	1	65	28	2	64	0.0312500
NODE_305229_length_142_cov_46.976744	1	65	36	6	64	0.0937500
NODE_305229_length_142_cov_46.976744	1	65	38	2	64	0.0312500
NODE_305229_length_142_cov_46.976744	1	65	42	7	64	0.1093750
NODE_305229_length_142_cov_46.976744	1	65	44	1	64	0.0156250
NODE_305229_length_142_cov_46.976744	1	65	46	29	64	0.4531250
NODE_305229_length_142_cov_46.976744	1	65	8	8	64	0.1250000
NODE_305229_length_142_cov_46.976744	1	65	10	3	64	0.0468750
NODE_305229_length_142_cov_46.976744	1	65	14	1	64	0.0156250
NODE_305229_length_142_cov_46.976744	1	65	16	2	64	0.0312500
NODE_305229_length_142_cov_46.976744	1	65	22	2	64	0.0312500
NODE_305229_length_142_cov_46.976744	1	65	26	1	64	0.0156250
NODE_305229_length_142_cov_46.976744	1	65	28	2	64	0.0312500
NODE_305229_length_142_cov_46.976744	1	65	36	6	64	0.0937500
NODE_305229_length_142_cov_46.976744	1	65	38	2	64	0.0312500
NODE_305229_length_142_cov_46.976744	1	65	42	7	64	0.1093750
NODE_305229_length_142_cov_46.976744	1	65	44	1	64	0.0156250
NODE_305229_length_142_cov_46.976744	1	65	46	29	64	0.4531250
NODE_305229_length_142_cov_46.976744	1	65	8	8	64	0.1250000
NODE_305229_length_142_cov_46.976744	1	65	10	3	64	0.0468750
NODE_305229_length_142_cov_46.976744	1	65	14	1	64	0.0156250
NODE_305229_length_142_cov_46.976744	1	65	16	2	64	0.0312500
NODE_305229_length_142_cov_46.976744	1	65	22	2	64	0.0312500
NODE_305229_length_142_cov_46.976744	1	65	26	1	64	0.0156250
NODE_305229_length_142_cov_46.976744	1	65	28	2	64	0.0312500
NODE_305229_length_142_cov_46.976744	1	65	36	6	64	0.0937500
NODE_305229_length_142_cov_46.976744	1	65	38	2	64	0.0312500
NODE_305229_length_142_cov_46.976744	1	65	42	7	64	0.1093750
NODE_305229_length_142_cov_46.976744	1	65	44	1	64	0.0156250
NODE_305229_length_142_cov_46.976744	1	65	46	29	64	0.4531250
NODE_305230_length_142_cov_45.000000	0	69	0	69	69	1.0000000
NODE_305385_length_141_cov_178.785714	58	118	72	1	60	0.0166667
NODE_305385_length_141_cov_178.785714	58	118	76	1	60	0.0166667
NODE_305385_length_141_cov_178.785714	58	118	78	2	60	0.0333333
NODE_305385_length_141_cov_178.785714	58	118	83	1	60	0.0166667
NODE_305385_length_141_cov_178.785714	58	118	85	1	60	0.0166667
NODE_305385_length_141_cov_178.785714	58	118	90	2	60	0.0333333
NODE_305385_length_141_cov_178.785714	58	118	92	5	60	0.0833333
NODE_305385_length_141_cov_178.785714	58	118	94	47	60	0.7833334
NODE_305398_length_141_cov_62.285714	26	106	0	6	80	0.0750000
NODE_305398_length_141_cov_62.285714	26	106	2	74	80	0.9250000
NODE_305398_length_141_cov_62.285714	26	106	0	6	80	0.0750000
NODE_305398_length_141_cov_62.285714	26	106	2	74	80	0.9250000
NODE_305398_length_141_cov_62.285714	26	97	0	6	71	0.0845070
NODE_305398_length_141_cov_62.285714	26	97	2	65	71	0.9154930
NODE_305402_length_141_cov_41.142857	26	97	0	71	71	1.0000000
NODE_305600_length_140_cov_60.439024	8	88	0	3	80	0.0375000
NODE_305600_length_140_cov_60.439024	8	88	2	13	80	0.1625000
NODE_305600_length_140_cov_60.439024	8	88	8	3	80	0.0375000
NODE_305600_length_140_cov_60.439024	8	88	10	1	80	0.0125000
NODE_305600_length_140_cov_60.439024	8	88	12	2	80	0.0250000
NODE_305600_length_140_cov_60.439024	8	88	14	5	80	0.0625000
NODE_305600_length_140_cov_60.439024	8	88	16	53	80	0.6625000
NODE_305600_length_140_cov_60.439024	8	88	0	3	80	0.0375000
NODE_305600_length_140_cov_60.439024	8	88	2	13	80	0.1625000
NODE_305600_length_140_cov_60.439024	8	88	8	3	80	0.0375000
NODE_305600_length_140_cov_60.439024	8	88	10	1	80	0.0125000
NODE_305600_length_140_cov_60.439024	8	88	12	2	80	0.0250000
NODE_305600_length_140_cov_60.439024	8	88	14	5	80	0.0625000
NODE_305600_length_140_cov_60.439024	8	88	16	53	80	0.6625000
NODE_305600_length_140_cov_60.439024	8	88	0	3	80	0.0375000
NODE_305600_length_140_cov_60.439024	8	88	2	13	80	0.1625000
NODE_305600_length_140_cov_60.439024	8	88	8	3	80	0.0375000
NODE_305600_length_140_cov_60.439024	8	88	10	1	80	0.0125000
NODE_305600_length_140_cov_60.439024	8	88	12	2	80	0.0250000
NODE_305600_length_140_cov_60.439024	8	88	14	5	80	0.0625000
NODE_305600_length_140_cov_60.439024	8	88	16	53	80	0.6625000
NODE_305600_length_140_cov_60.439024	8	88	0	3	80	0.0375000
NODE_305600_length_140_cov_60.439024	8	88	2	13	80	0.1625000
NODE_305600_length_140_cov_60.439024	8	88	8	3	80	0.0375000
NODE_305600_length_140_cov_60.439024	8	88	10	1	80	0.0125000
NODE_305600_length_140_cov_60.439024	8	88	12	2	80	0.0250000
NODE_305600_length_140_cov_60.439024	8	88	14	5	80	0.0625000
NODE_305600_length_140_cov_60.439024	8	88	16	53	80	0.6625000
NODE_305600_length_140_cov_60.439024	8	88	0	3	80	0.0375000
NODE_305600_length_140_cov_60.439024	8	88	2	13	80	0.1625000
NODE_305600_length_140_cov_60.439024	8	88	8	3	80	0.0375000
NODE_305600_length_140_cov_60.439024	8	88	10	1	80	0.0125000
NODE_305600_length_140_cov_60.439024	8	88	12	2	80	0.0250000
NODE_305600_length_140_cov_60.439024	8	88	14	5	80	0.0625000
NODE_305600_length_140_cov_60.439024	8	88	16	53	80	0.6625000
NODE_305616_length_140_cov_35.146341	22	102	0	80	80	1.0000000
NODE_305616_length_140_cov_35.146341	75	105	0	30	30	1.0000000
NODE_305618_length_140_cov_34.048780	0	77	0	77	77	1.0000000
NODE_305618_length_140_cov_34.048780	0	77	0	77	77	1.0000000
NODE_305618_length_140_cov_34.048780	50	130	0	80	80	1.0000000
NODE_305618_length_140_cov_34.048780	50	130	0	80	80	1.0000000
NODE_305618_length_140_cov_34.048780	55	130	0	75	75	1.0000000
NODE_305619_length_140_cov_19.926829	44	118	0	74	74	1.0000000
NODE_305783_length_139_cov_29.700000	0	40	0	5	40	0.1250000
NODE_305783_length_139_cov_29.700000	0	40	8	5	40	0.1250000
NODE_305783_length_139_cov_29.700000	0	40	12	22	40	0.5500000
NODE_305783_length_139_cov_29.700000	0	40	14	5	40	0.1250000
NODE_305783_length_139_cov_29.700000	0	40	15	3	40	0.0750000
NODE_305783_length_139_cov_29.700000	0	40	0	5	40	0.1250000
NODE_305783_length_139_cov_29.700000	0	40	8	5	40	0.1250000
NODE_305783_length_139_cov_29.700000	0	40	12	22	40	0.5500000
NODE_305783_length_139_cov_29.700000	0	40	14	5	40	0.1250000
NODE_305783_length_139_cov_29.700000	0	40	15	3	40	0.0750000
NODE_305783_length_139_cov_29.700000	13	93	12	19	80	0.2375000
NODE_305783_length_139_cov_29.700000	13	93	14	5	80	0.0625000
NODE_305783_length_139_cov_29.700000	13	93	15	56	80	0.7000000
NODE_305783_length_139_cov_29.700000	13	93	12	19	80	0.2375000
NODE_305783_length_139_cov_29.700000	13	93	14	5	80	0.0625000
NODE_305783_length_139_cov_29.700000	13	93	15	56	80	0.7000000
NODE_305783_length_139_cov_29.700000	13	93	12	19	80	0.2375000
NODE_305783_length_139_cov_29.700000	13	93	14	5	80	0.0625000
NODE_305783_length_139_cov_29.700000	13	93	15	56	80	0.7000000
NODE_305783_length_139_cov_29.700000	13	93	12	19	80	0.2375000
NODE_305783_length_139_cov_29.700000	13	93	14	5	80	0.0625000
NODE_305783_length_139_cov_29.700000	13	93	15	56	80	0.7000000
NODE_305783_length_139_cov_29.700000	13	93	12	19	80	0.2375000
NODE_305783_length_139_cov_29.700000	13	93	14	5	80	0.0625000
NODE_305783_length_139_cov_29.700000	13	93	15	56	80	0.7000000
NODE_305783_length_139_cov_29.700000	13	84	12	19	71	0.2676056
NODE_305783_length_139_cov_29.700000	13	84	14	5	71	0.0704225
NODE_305783_length_139_cov_29.700000	13	84	15	47	71	0.6619718
NODE_305936_length_138_cov_1475.615385	30	97	57	1	67	0.0149254
NODE_305936_length_138_cov_1475.615385	30	97	63	1	67	0.0149254
NODE_305936_length_138_cov_1475.615385	30	97	67	1	67	0.0149254
NODE_305936_length_138_cov_1475.615385	30	97	71	2	67	0.0298507
NODE_305936_length_138_cov_1475.615385	30	97	73	38	67	0.5671642
NODE_305936_length_138_cov_1475.615385	30	97	74	24	67	0.3582090
NODE_305936_length_138_cov_1475.615385	70	138	36	3	68	0.0441176
NODE_305936_length_138_cov_1475.615385	70	138	40	1	68	0.0147059
NODE_305936_length_138_cov_1475.615385	70	138	42	1	68	0.0147059
NODE_305936_length_138_cov_1475.615385	70	138	52	1	68	0.0147059
NODE_305936_length_138_cov_1475.615385	70	138	54	5	68	0.0735294
NODE_305936_length_138_cov_1475.615385	70	138	60	1	68	0.0147059
NODE_305936_length_138_cov_1475.615385	70	138	62	2	68	0.0294118
NODE_305936_length_138_cov_1475.615385	70	138	64	7	68	0.1029412
NODE_305936_length_138_cov_1475.615385	70	138	68	2	68	0.0294118
NODE_305936_length_138_cov_1475.615385	70	138	70	2	68	0.0294118
NODE_305936_length_138_cov_1475.615385	70	138	72	6	68	0.0882353
NODE_305936_length_138_cov_1475.615385	70	138	73	3	68	0.0441176
NODE_305936_length_138_cov_1475.615385	70	138	74	34	68	0.5000000
NODE_305963_length_138_cov_29.564103	11	91	2	80	80	1.0000000
NODE_305963_length_138_cov_29.564103	11	91	2	80	80	1.0000000
NODE_305963_length_138_cov_29.564103	64	128	0	1	64	0.0156250
NODE_305963_length_138_cov_29.564103	64	128	2	63	64	0.9843750
NODE_305963_length_138_cov_29.564103	64	128	0	1	64	0.0156250
NODE_305963_length_138_cov_29.564103	64	128	2	63	64	0.9843750
NODE_306081_length_137_cov_185.684211	20	104	6	6	84	0.0714286
NODE_306081_length_137_cov_185.684211	20	104	8	78	84	0.9285714
NODE_306092_length_137_cov_58.289474	76	106	24	2	30	0.0666667
NODE_306092_length_137_cov_58.289474	76	106	28	28	30	0.9333333
NODE_306099_length_137_cov_36.473684	31	111	20	6	80	0.0750000
NODE_306099_length_137_cov_36.473684	31	111	22	74	80	0.9250000
NODE_306208_length_136_cov_1257.621622	27	107	80	3	80	0.0375000
NODE_306208_length_136_cov_1257.621622	27	107	82	1	80	0.0125000
NODE_306208_length_136_cov_1257.621622	27	107	83	2	80	0.0250000
NODE_306208_length_136_cov_1257.621622	27	107	85	1	80	0.0125000
NODE_306208_length_136_cov_1257.621622	27	107	86	73	80	0.9125000
NODE_306209_length_136_cov_769.594595	0	69	2	5	69	0.0724638
NODE_306209_length_136_cov_769.594595	0	69	4	5	69	0.0724638
NODE_306209_length_136_cov_769.594595	0	69	6	59	69	0.8550724
NODE_306222_length_136_cov_128.324324	39	119	2	5	80	0.0625000
NODE_306222_length_136_cov_128.324324	39	119	4	3	80	0.0375000
NODE_306222_length_136_cov_128.324324	39	119	6	3	80	0.0375000
NODE_306222_length_136_cov_128.324324	39	119	8	5	80	0.0625000
NODE_306222_length_136_cov_128.324324	39	119	10	64	80	0.8000000
NODE_306227_length_136_cov_90.783784	10	86	0	76	76	1.0000000
NODE_306227_length_136_cov_90.783784	59	136	0	77	77	1.0000000
NODE_306368_length_135_cov_2144.166667	0	73	20	1	73	0.0136986
NODE_306368_length_135_cov_2144.166667	0	73	30	1	73	0.0136986
NODE_306368_length_135_cov_2144.166667	0	73	40	1	73	0.0136986
NODE_306368_length_135_cov_2144.166667	0	73	46	1	73	0.0136986
NODE_306368_length_135_cov_2144.166667	0	73	52	1	73	0.0136986
NODE_306368_length_135_cov_2144.166667	0	73	54	1	73	0.0136986
NODE_306368_length_135_cov_2144.166667	0	73	76	1	73	0.0136986
NODE_306368_length_135_cov_2144.166667	0	73	78	1	73	0.0136986
NODE_306368_length_135_cov_2144.166667	0	73	84	1	73	0.0136986
NODE_306368_length_135_cov_2144.166667	0	73	86	1	73	0.0136986
NODE_306368_length_135_cov_2144.166667	0	73	94	1	73	0.0136986
NODE_306368_length_135_cov_2144.166667	0	73	102	2	73	0.0273973
NODE_306368_length_135_cov_2144.166667	0	73	106	1	73	0.0136986
NODE_306368_length_135_cov_2144.166667	0	73	110	1	73	0.0136986
NODE_306368_length_135_cov_2144.166667	0	73	112	1	73	0.0136986
NODE_306368_length_135_cov_2144.166667	0	73	118	1	73	0.0136986
NODE_306368_length_135_cov_2144.166667	0	73	120	1	73	0.0136986
NODE_306368_length_135_cov_2144.166667	0	73	122	1	73	0.0136986
NODE_306368_length_135_cov_2144.166667	0	73	124	1	73	0.0136986
NODE_306368_length_135_cov_2144.166667	0	73	126	2	73	0.0273973
NODE_306368_length_135_cov_2144.166667	0	73	136	2	73	0.0273973
NODE_306368_length_135_cov_2144.166667	0	73	138	1	73	0.0136986
NODE_306368_length_135_cov_2144.166667	0	73	142	1	73	0.0136986
NODE_306368_length_135_cov_2144.166667	0	73	144	1	73	0.0136986
NODE_306368_length_135_cov_2144.166667	0	73	150	1	73	0.0136986
NODE_306368_length_135_cov_2144.166667	0	73	158	2	73	0.0273973
NODE_306368_length_135_cov_2144.166667	0	73	166	2	73	0.0273973
NODE_306368_length_135_cov_2144.166667	0	73	172	1	73	0.0136986
NODE_306368_length_135_cov_2144.166667	0	73	174	40	73	0.5479452
NODE_306368_length_135_cov_2144.166667	46	126	62	1	80	0.0125000
NODE_306368_length_135_cov_2144.166667	46	126	64	2	80	0.0250000
NODE_306368_length_135_cov_2144.166667	46	126	66	1	80	0.0125000
NODE_306368_length_135_cov_2144.166667	46	126	70	2	80	0.0250000
NODE_306368_length_135_cov_2144.166667	46	126	81	1	80	0.0125000
NODE_306368_length_135_cov_2144.166667	46	126	82	1	80	0.0125000
NODE_306368_length_135_cov_2144.166667	46	126	90	1	80	0.0125000
NODE_306368_length_135_cov_2144.166667	46	126	94	1	80	0.0125000
NODE_306368_length_135_cov_2144.166667	46	126	105	1	80	0.0125000
NODE_306368_length_135_cov_2144.166667	46	126	116	2	80	0.0250000
NODE_306368_length_135_cov_2144.166667	46	126	124	1	80	0.0125000
NODE_306368_length_135_cov_2144.166667	46	126	136	1	80	0.0125000
NODE_306368_length_135_cov_2144.166667	46	126	142	1	80	0.0125000
NODE_306368_length_135_cov_2144.166667	46	126	146	1	80	0.0125000
NODE_306368_length_135_cov_2144.166667	46	126	158	1	80	0.0125000
NODE_306368_length_135_cov_2144.166667	46	126	160	1	80	0.0125000
NODE_306368_length_135_cov_2144.166667	46	126	162	1	80	0.0125000
NODE_306368_length_135_cov_2144.166667	46	126	164	1	80	0.0125000
NODE_306368_length_135_cov_2144.166667	46	126	166	2	80	0.0250000
NODE_306368_length_135_cov_2144.166667	46	126	174	57	80	0.7125000
NODE_306368_length_135_cov_2144.166667	83	135	12	2	52	0.0384615
NODE_306368_length_135_cov_2144.166667	83	135	22	3	52	0.0576923
NODE_306368_length_135_cov_2144.166667	83	135	32	1	52	0.0192308
NODE_306368_length_135_cov_2144.166667	83	135	40	1	52	0.0192308
NODE_306368_length_135_cov_2144.166667	83	135	44	1	52	0.0192308
NODE_306368_length_135_cov_2144.166667	83	135	56	1	52	0.0192308
NODE_306368_length_135_cov_2144.166667	83	135	62	1	52	0.0192308
NODE_306368_length_135_cov_2144.166667	83	135	64	2	52	0.0384615
NODE_306368_length_135_cov_2144.166667	83	135	66	1	52	0.0192308
NODE_306368_length_135_cov_2144.166667	83	135	70	2	52	0.0384615
NODE_306368_length_135_cov_2144.166667	83	135	81	1	52	0.0192308
NODE_306368_length_135_cov_2144.166667	83	135	82	1	52	0.0192308
NODE_306368_length_135_cov_2144.166667	83	135	90	1	52	0.0192308
NODE_306368_length_135_cov_2144.166667	83	135	94	1	52	0.0192308
NODE_306368_length_135_cov_2144.166667	83	135	105	1	52	0.0192308
NODE_306368_length_135_cov_2144.166667	83	135	116	2	52	0.0384615
NODE_306368_length_135_cov_2144.166667	83	135	124	1	52	0.0192308
NODE_306368_length_135_cov_2144.166667	83	135	136	1	52	0.0192308
NODE_306368_length_135_cov_2144.166667	83	135	142	1	52	0.0192308
NODE_306368_length_135_cov_2144.166667	83	135	146	1	52	0.0192308
NODE_306368_length_135_cov_2144.166667	83	135	158	1	52	0.0192308
NODE_306368_length_135_cov_2144.166667	83	135	160	1	52	0.0192308
NODE_306368_length_135_cov_2144.166667	83	135	162	1	52	0.0192308
NODE_306368_length_135_cov_2144.166667	83	135	164	1	52	0.0192308
NODE_306368_length_135_cov_2144.166667	83	135	166	2	52	0.0384615
NODE_306368_length_135_cov_2144.166667	83	135	174	20	52	0.3846154
NODE_306370_length_135_cov_630.194444	0	76	4	2	76	0.0263158
NODE_306370_length_135_cov_630.194444	0	76	9	2	76	0.0263158
NODE_306370_length_135_cov_630.194444	0	76	22	2	76	0.0263158
NODE_306370_length_135_cov_630.194444	0	76	26	2	76	0.0263158
NODE_306370_length_135_cov_630.194444	0	76	28	3	76	0.0394737
NODE_306370_length_135_cov_630.194444	0	76	32	2	76	0.0263158
NODE_306370_length_135_cov_630.194444	0	76	39	1	76	0.0131579
NODE_306370_length_135_cov_630.194444	0	76	44	3	76	0.0394737
NODE_306370_length_135_cov_630.194444	0	76	46	1	76	0.0131579
NODE_306370_length_135_cov_630.194444	0	76	48	1	76	0.0131579
NODE_306370_length_135_cov_630.194444	0	76	52	2	76	0.0263158
NODE_306370_length_135_cov_630.194444	0	76	54	1	76	0.0131579
NODE_306370_length_135_cov_630.194444	0	76	56	1	76	0.0131579
NODE_306370_length_135_cov_630.194444	0	76	62	3	76	0.0394737
NODE_306370_length_135_cov_630.194444	0	76	69	1	76	0.0131579
NODE_306370_length_135_cov_630.194444	0	76	70	49	76	0.6447368
NODE_306371_length_135_cov_540.611111	0	76	16	1	76	0.0131579
NODE_306371_length_135_cov_540.611111	0	76	18	2	76	0.0263158
NODE_306371_length_135_cov_540.611111	0	76	20	1	76	0.0131579
NODE_306371_length_135_cov_540.611111	0	76	22	5	76	0.0657895
NODE_306371_length_135_cov_540.611111	0	76	24	2	76	0.0263158
NODE_306371_length_135_cov_540.611111	0	76	28	1	76	0.0131579
NODE_306371_length_135_cov_540.611111	0	76	34	1	76	0.0131579
NODE_306371_length_135_cov_540.611111	0	76	36	2	76	0.0263158
NODE_306371_length_135_cov_540.611111	0	76	38	1	76	0.0131579
NODE_306371_length_135_cov_540.611111	0	76	40	1	76	0.0131579
NODE_306371_length_135_cov_540.611111	0	76	42	4	76	0.0526316
NODE_306371_length_135_cov_540.611111	0	76	44	8	76	0.1052632
NODE_306371_length_135_cov_540.611111	0	76	48	1	76	0.0131579
NODE_306371_length_135_cov_540.611111	0	76	50	46	76	0.6052632
NODE_306373_length_135_cov_257.416667	36	88	26	52	52	1.0000000
NODE_306374_length_135_cov_239.638889	97	135	15	2	38	0.0526316
NODE_306374_length_135_cov_239.638889	97	135	23	7	38	0.1842105
NODE_306374_length_135_cov_239.638889	97	135	25	4	38	0.1052632
NODE_306374_length_135_cov_239.638889	97	135	27	1	38	0.0263158
NODE_306374_length_135_cov_239.638889	97	135	29	1	38	0.0263158
NODE_306374_length_135_cov_239.638889	97	135	33	1	38	0.0263158
NODE_306374_length_135_cov_239.638889	97	135	38	2	38	0.0526316
NODE_306374_length_135_cov_239.638889	97	135	44	1	38	0.0263158
NODE_306374_length_135_cov_239.638889	97	135	46	5	38	0.1315790
NODE_306374_length_135_cov_239.638889	97	135	50	2	38	0.0526316
NODE_306374_length_135_cov_239.638889	97	135	52	2	38	0.0526316
NODE_306374_length_135_cov_239.638889	97	135	54	2	38	0.0526316
NODE_306374_length_135_cov_239.638889	97	135	58	1	38	0.0263158
NODE_306374_length_135_cov_239.638889	97	135	60	7	38	0.1842105
NODE_306400_length_135_cov_35.055556	8	88	0	8	80	0.1000000
NODE_306400_length_135_cov_35.055556	8	88	8	72	80	0.9000000
NODE_306400_length_135_cov_35.055556	61	125	2	6	64	0.0937500
NODE_306400_length_135_cov_35.055556	61	125	8	58	64	0.9062500
NODE_306400_length_135_cov_35.055556	61	125	2	6	64	0.0937500
NODE_306400_length_135_cov_35.055556	61	125	8	58	64	0.9062500
NODE_306402_length_135_cov_31.805556	0	76	0	76	76	1.0000000
NODE_306658_length_133_cov_140.411765	8	43	12	4	35	0.1142857
NODE_306658_length_133_cov_140.411765	8	43	18	1	35	0.0285714
NODE_306658_length_133_cov_140.411765	8	43	20	5	35	0.1428571
NODE_306658_length_133_cov_140.411765	8	43	22	2	35	0.0571429
NODE_306658_length_133_cov_140.411765	8	43	24	1	35	0.0285714
NODE_306658_length_133_cov_140.411765	8	43	26	1	35	0.0285714
NODE_306658_length_133_cov_140.411765	8	43	28	2	35	0.0571429
NODE_306658_length_133_cov_140.411765	8	43	30	5	35	0.1428571
NODE_306658_length_133_cov_140.411765	8	43	32	14	35	0.4000000
NODE_306658_length_133_cov_140.411765	53	88	32	35	35	1.0000000
NODE_306658_length_133_cov_140.411765	98	133	6	1	35	0.0285714
NODE_306658_length_133_cov_140.411765	98	133	8	1	35	0.0285714
NODE_306658_length_133_cov_140.411765	98	133	10	1	35	0.0285714
NODE_306658_length_133_cov_140.411765	98	133	12	7	35	0.2000000
NODE_306658_length_133_cov_140.411765	98	133	14	1	35	0.0285714
NODE_306658_length_133_cov_140.411765	98	133	16	2	35	0.0571429
NODE_306658_length_133_cov_140.411765	98	133	20	8	35	0.2285714
NODE_306658_length_133_cov_140.411765	98	133	22	2	35	0.0571429
NODE_306658_length_133_cov_140.411765	98	133	24	2	35	0.0571429
NODE_306658_length_133_cov_140.411765	98	133	28	1	35	0.0285714
NODE_306658_length_133_cov_140.411765	98	133	30	4	35	0.1142857
NODE_306658_length_133_cov_140.411765	98	133	32	5	35	0.1428571
NODE_306661_length_133_cov_109.441176	63	129	6	6	66	0.0909091
NODE_306661_length_133_cov_109.441176	63	129	8	5	66	0.0757576
NODE_306661_length_133_cov_109.441176	63	129	10	6	66	0.0909091
NODE_306661_length_133_cov_109.441176	63	129	12	49	66	0.7424242
NODE_306812_length_132_cov_114.151515	2	44	1	11	42	0.2619048
NODE_306812_length_132_cov_114.151515	2	44	3	4	42	0.0952381
NODE_306812_length_132_cov_114.151515	2	44	5	6	42	0.1428571
NODE_306812_length_132_cov_114.151515	2	44	7	1	42	0.0238095
NODE_306812_length_132_cov_114.151515	2	44	9	3	42	0.0714286
NODE_306812_length_132_cov_114.151515	2	44	10	17	42	0.4047619
NODE_306812_length_132_cov_114.151515	4	44	1	9	40	0.2250000
NODE_306812_length_132_cov_114.151515	4	44	3	4	40	0.1000000
NODE_306812_length_132_cov_114.151515	4	44	5	6	40	0.1500000
NODE_306812_length_132_cov_114.151515	4	44	7	1	40	0.0250000
NODE_306812_length_132_cov_114.151515	4	44	9	3	40	0.0750000
NODE_306812_length_132_cov_114.151515	4	44	10	17	40	0.4250000
NODE_306812_length_132_cov_114.151515	17	83	5	6	66	0.0909091
NODE_306812_length_132_cov_114.151515	17	83	7	1	66	0.0151515
NODE_306812_length_132_cov_114.151515	17	83	9	3	66	0.0454545
NODE_306812_length_132_cov_114.151515	17	83	10	56	66	0.8484849
NODE_306812_length_132_cov_114.151515	17	88	5	6	71	0.0845070
NODE_306812_length_132_cov_114.151515	17	88	7	1	71	0.0140845
NODE_306812_length_132_cov_114.151515	17	88	9	3	71	0.0422535
NODE_306812_length_132_cov_114.151515	17	88	10	61	71	0.8591549
NODE_306824_length_132_cov_61.636364	3	76	2	1	73	0.0136986
NODE_306824_length_132_cov_61.636364	3	76	6	13	73	0.1780822
NODE_306824_length_132_cov_61.636364	3	76	8	1	73	0.0136986
NODE_306824_length_132_cov_61.636364	3	76	10	3	73	0.0410959
NODE_306824_length_132_cov_61.636364	3	76	12	1	73	0.0136986
NODE_306824_length_132_cov_61.636364	3	76	14	2	73	0.0273973
NODE_306824_length_132_cov_61.636364	3	76	18	3	73	0.0410959
NODE_306824_length_132_cov_61.636364	3	76	22	1	73	0.0136986
NODE_306824_length_132_cov_61.636364	3	76	24	48	73	0.6575342
NODE_306824_length_132_cov_61.636364	49	130	6	1	81	0.0123457
NODE_306824_length_132_cov_61.636364	49	130	12	5	81	0.0617284
NODE_306824_length_132_cov_61.636364	49	130	16	1	81	0.0123457
NODE_306824_length_132_cov_61.636364	49	130	18	1	81	0.0123457
NODE_306824_length_132_cov_61.636364	49	130	20	2	81	0.0246914
NODE_306824_length_132_cov_61.636364	49	130	22	14	81	0.1728395
NODE_306824_length_132_cov_61.636364	49	130	24	57	81	0.7037037
NODE_306824_length_132_cov_61.636364	103	125	12	1	22	0.0454545
NODE_306824_length_132_cov_61.636364	103	125	16	1	22	0.0454545
NODE_306824_length_132_cov_61.636364	103	125	18	1	22	0.0454545
NODE_306824_length_132_cov_61.636364	103	125	20	2	22	0.0909091
NODE_306824_length_132_cov_61.636364	103	125	22	14	22	0.6363636
NODE_306824_length_132_cov_61.636364	103	125	24	3	22	0.1363636
NODE_306834_length_132_cov_33.393939	2	83	0	81	81	1.0000000
NODE_306834_length_132_cov_33.393939	7	29	0	22	22	1.0000000
NODE_306834_length_132_cov_33.393939	56	129	0	73	73	1.0000000
NODE_306965_length_131_cov_810.000000	0	60	6	1	60	0.0166667
NODE_306965_length_131_cov_810.000000	0	60	14	1	60	0.0166667
NODE_306965_length_131_cov_810.000000	0	60	24	2	60	0.0333333
NODE_306965_length_131_cov_810.000000	0	60	44	1	60	0.0166667
NODE_306965_length_131_cov_810.000000	0	60	46	1	60	0.0166667
NODE_306965_length_131_cov_810.000000	0	60	48	2	60	0.0333333
NODE_306965_length_131_cov_810.000000	0	60	58	1	60	0.0166667
NODE_306965_length_131_cov_810.000000	0	60	62	1	60	0.0166667
NODE_306965_length_131_cov_810.000000	0	60	64	1	60	0.0166667
NODE_306965_length_131_cov_810.000000	0	60	70	1	60	0.0166667
NODE_306965_length_131_cov_810.000000	0	60	76	1	60	0.0166667
NODE_306965_length_131_cov_810.000000	0	60	80	1	60	0.0166667
NODE_306965_length_131_cov_810.000000	0	60	81	1	60	0.0166667
NODE_306965_length_131_cov_810.000000	0	60	86	1	60	0.0166667
NODE_306965_length_131_cov_810.000000	0	60	88	1	60	0.0166667
NODE_306965_length_131_cov_810.000000	0	60	96	1	60	0.0166667
NODE_306965_length_131_cov_810.000000	0	60	99	1	60	0.0166667
NODE_306965_length_131_cov_810.000000	0	60	106	3	60	0.0500000
NODE_306965_length_131_cov_810.000000	0	60	117	1	60	0.0166667
NODE_306965_length_131_cov_810.000000	0	60	131	1	60	0.0166667
NODE_306965_length_131_cov_810.000000	0	60	136	1	60	0.0166667
NODE_306965_length_131_cov_810.000000	0	60	140	1	60	0.0166667
NODE_306965_length_131_cov_810.000000	0	60	144	1	60	0.0166667
NODE_306965_length_131_cov_810.000000	0	60	148	1	60	0.0166667
NODE_306965_length_131_cov_810.000000	0	60	160	1	60	0.0166667
NODE_306965_length_131_cov_810.000000	0	60	162	31	60	0.5166667
NODE_306965_length_131_cov_810.000000	33	97	162	64	64	1.0000000
NODE_306965_length_131_cov_810.000000	33	97	162	64	64	1.0000000
NODE_306965_length_131_cov_810.000000	33	97	162	64	64	1.0000000
NODE_306985_length_131_cov_149.187500	25	105	84	2	80	0.0250000
NODE_306985_length_131_cov_149.187500	25	105	86	1	80	0.0125000
NODE_306985_length_131_cov_149.187500	25	105	88	23	80	0.2875000
NODE_306985_length_131_cov_149.187500	25	105	91	10	80	0.1250000
NODE_306985_length_131_cov_149.187500	25	105	92	44	80	0.5500000
NODE_306985_length_131_cov_149.187500	78	131	8	1	53	0.0188679
NODE_306985_length_131_cov_149.187500	78	131	10	1	53	0.0188679
NODE_306985_length_131_cov_149.187500	78	131	14	1	53	0.0188679
NODE_306985_length_131_cov_149.187500	78	131	15	1	53	0.0188679
NODE_306985_length_131_cov_149.187500	78	131	27	1	53	0.0188679
NODE_306985_length_131_cov_149.187500	78	131	28	2	53	0.0377358
NODE_306985_length_131_cov_149.187500	78	131	36	1	53	0.0188679
NODE_306985_length_131_cov_149.187500	78	131	40	1	53	0.0188679
NODE_306985_length_131_cov_149.187500	78	131	42	1	53	0.0188679
NODE_306985_length_131_cov_149.187500	78	131	48	1	53	0.0188679
NODE_306985_length_131_cov_149.187500	78	131	54	1	53	0.0188679
NODE_306985_length_131_cov_149.187500	78	131	56	1	53	0.0188679
NODE_306985_length_131_cov_149.187500	78	131	62	3	53	0.0566038
NODE_306985_length_131_cov_149.187500	78	131	66	3	53	0.0566038
NODE_306985_length_131_cov_149.187500	78	131	76	1	53	0.0188679
NODE_306985_length_131_cov_149.187500	78	131	80	4	53	0.0754717
NODE_306985_length_131_cov_149.187500	78	131	84	4	53	0.0754717
NODE_306985_length_131_cov_149.187500	78	131	88	22	53	0.4150943
NODE_306985_length_131_cov_149.187500	78	131	91	3	53	0.0566038
NODE_307121_length_130_cov_319.806452	54	126	4	3	72	0.0416667
NODE_307121_length_130_cov_319.806452	54	126	6	6	72	0.0833333
NODE_307121_length_130_cov_319.806452	54	126	10	1	72	0.0138889
NODE_307121_length_130_cov_319.806452	54	126	12	1	72	0.0138889
NODE_307121_length_130_cov_319.806452	54	126	16	1	72	0.0138889
NODE_307121_length_130_cov_319.806452	54	126	18	3	72	0.0416667
NODE_307121_length_130_cov_319.806452	54	126	20	1	72	0.0138889
NODE_307121_length_130_cov_319.806452	54	126	22	6	72	0.0833333
NODE_307121_length_130_cov_319.806452	54	126	24	1	72	0.0138889
NODE_307121_length_130_cov_319.806452	54	126	26	49	72	0.6805556
NODE_307132_length_130_cov_153.516129	82	113	4	31	31	1.0000000
NODE_307140_length_130_cov_79.064516	0	53	2	5	53	0.0943396
NODE_307140_length_130_cov_79.064516	0	53	4	2	53	0.0377358
NODE_307140_length_130_cov_79.064516	0	53	6	6	53	0.1132075
NODE_307140_length_130_cov_79.064516	0	53	8	3	53	0.0566038
NODE_307140_length_130_cov_79.064516	0	53	12	37	53	0.6981132
NODE_307140_length_130_cov_79.064516	26	56	12	30	30	1.0000000
NODE_307270_length_129_cov_1851.133333	0	45	0	4	45	0.0888889
NODE_307270_length_129_cov_1851.133333	0	45	6	3	45	0.0666667
NODE_307270_length_129_cov_1851.133333	0	45	8	2	45	0.0444444
NODE_307270_length_129_cov_1851.133333	0	45	10	1	45	0.0222222
NODE_307270_length_129_cov_1851.133333	0	45	12	3	45	0.0666667
NODE_307270_length_129_cov_1851.133333	0	45	13	3	45	0.0666667
NODE_307270_length_129_cov_1851.133333	0	45	14	6	45	0.1333333
NODE_307270_length_129_cov_1851.133333	0	45	16	3	45	0.0666667
NODE_307270_length_129_cov_1851.133333	0	45	18	20	45	0.4444444
NODE_307270_length_129_cov_1851.133333	18	98	14	4	80	0.0500000
NODE_307270_length_129_cov_1851.133333	18	98	16	3	80	0.0375000
NODE_307270_length_129_cov_1851.133333	18	98	18	73	80	0.9125000
NODE_307285_length_129_cov_186.500000	0	78	0	2	78	0.0256410
NODE_307285_length_129_cov_186.500000	0	78	4	8	78	0.1025641
NODE_307285_length_129_cov_186.500000	0	78	10	9	78	0.1153846
NODE_307285_length_129_cov_186.500000	0	78	12	6	78	0.0769231
NODE_307285_length_129_cov_186.500000	0	78	14	53	78	0.6794872
NODE_307285_length_129_cov_186.500000	53	129	2	1	76	0.0131579
NODE_307285_length_129_cov_186.500000	53	129	4	6	76	0.0789474
NODE_307285_length_129_cov_186.500000	53	129	8	5	76	0.0657895
NODE_307285_length_129_cov_186.500000	53	129	12	5	76	0.0657895
NODE_307285_length_129_cov_186.500000	53	129	14	59	76	0.7763158
NODE_307287_length_129_cov_165.466667	36	111	13	2	75	0.0266667
NODE_307287_length_129_cov_165.466667	36	111	19	1	75	0.0133333
NODE_307287_length_129_cov_165.466667	36	111	22	2	75	0.0266667
NODE_307287_length_129_cov_165.466667	36	111	28	2	75	0.0266667
NODE_307287_length_129_cov_165.466667	36	111	30	68	75	0.9066667
NODE_307287_length_129_cov_165.466667	84	113	13	4	29	0.1379310
NODE_307287_length_129_cov_165.466667	84	113	19	1	29	0.0344828
NODE_307287_length_129_cov_165.466667	84	113	22	2	29	0.0689655
NODE_307287_length_129_cov_165.466667	84	113	28	2	29	0.0689655
NODE_307287_length_129_cov_165.466667	84	113	30	20	29	0.6896552
NODE_307292_length_129_cov_90.366667	0	48	8	2	48	0.0416667
NODE_307292_length_129_cov_90.366667	0	48	12	3	48	0.0625000
NODE_307292_length_129_cov_90.366667	0	48	14	4	48	0.0833333
NODE_307292_length_129_cov_90.366667	0	48	16	14	48	0.2916667
NODE_307292_length_129_cov_90.366667	0	48	20	2	48	0.0416667
NODE_307292_length_129_cov_90.366667	0	48	22	23	48	0.4791667
NODE_307292_length_129_cov_90.366667	0	48	8	2	48	0.0416667
NODE_307292_length_129_cov_90.366667	0	48	12	3	48	0.0625000
NODE_307292_length_129_cov_90.366667	0	48	14	4	48	0.0833333
NODE_307292_length_129_cov_90.366667	0	48	16	14	48	0.2916667
NODE_307292_length_129_cov_90.366667	0	48	20	2	48	0.0416667
NODE_307292_length_129_cov_90.366667	0	48	22	23	48	0.4791667
NODE_307292_length_129_cov_90.366667	0	48	8	2	48	0.0416667
NODE_307292_length_129_cov_90.366667	0	48	12	3	48	0.0625000
NODE_307292_length_129_cov_90.366667	0	48	14	4	48	0.0833333
NODE_307292_length_129_cov_90.366667	0	48	16	14	48	0.2916667
NODE_307292_length_129_cov_90.366667	0	48	20	2	48	0.0416667
NODE_307292_length_129_cov_90.366667	0	48	22	23	48	0.4791667
NODE_307292_length_129_cov_90.366667	21	101	16	2	80	0.0250000
NODE_307292_length_129_cov_90.366667	21	101	20	2	80	0.0250000
NODE_307292_length_129_cov_90.366667	21	101	22	76	80	0.9500000
NODE_307442_length_128_cov_2621.517241	3	83	16	1	80	0.0125000
NODE_307442_length_128_cov_2621.517241	3	83	20	1	80	0.0125000
NODE_307442_length_128_cov_2621.517241	3	83	22	2	80	0.0250000
NODE_307442_length_128_cov_2621.517241	3	83	26	1	80	0.0125000
NODE_307442_length_128_cov_2621.517241	3	83	30	1	80	0.0125000
NODE_307442_length_128_cov_2621.517241	3	83	35	1	80	0.0125000
NODE_307442_length_128_cov_2621.517241	3	83	39	1	80	0.0125000
NODE_307442_length_128_cov_2621.517241	3	83	41	1	80	0.0125000
NODE_307442_length_128_cov_2621.517241	3	83	45	3	80	0.0375000
NODE_307442_length_128_cov_2621.517241	3	83	47	1	80	0.0125000
NODE_307442_length_128_cov_2621.517241	3	83	49	4	80	0.0500000
NODE_307442_length_128_cov_2621.517241	3	83	51	1	80	0.0125000
NODE_307442_length_128_cov_2621.517241	3	83	53	1	80	0.0125000
NODE_307442_length_128_cov_2621.517241	3	83	55	1	80	0.0125000
NODE_307442_length_128_cov_2621.517241	3	83	57	1	80	0.0125000
NODE_307442_length_128_cov_2621.517241	3	83	61	4	80	0.0500000
NODE_307442_length_128_cov_2621.517241	3	83	62	55	80	0.6875000
NODE_307442_length_128_cov_2621.517241	8	30	30	1	22	0.0454545
NODE_307442_length_128_cov_2621.517241	8	30	35	1	22	0.0454545
NODE_307442_length_128_cov_2621.517241	8	30	39	1	22	0.0454545
NODE_307442_length_128_cov_2621.517241	8	30	41	1	22	0.0454545
NODE_307442_length_128_cov_2621.517241	8	30	45	3	22	0.1363636
NODE_307442_length_128_cov_2621.517241	8	30	47	1	22	0.0454545
NODE_307442_length_128_cov_2621.517241	8	30	49	4	22	0.1818182
NODE_307442_length_128_cov_2621.517241	8	30	51	1	22	0.0454545
NODE_307442_length_128_cov_2621.517241	8	30	53	1	22	0.0454545
NODE_307442_length_128_cov_2621.517241	8	30	55	1	22	0.0454545
NODE_307442_length_128_cov_2621.517241	8	30	57	1	22	0.0454545
NODE_307442_length_128_cov_2621.517241	8	30	61	4	22	0.1818182
NODE_307442_length_128_cov_2621.517241	8	30	62	2	22	0.0909091
NODE_307442_length_128_cov_2621.517241	56	128	2	1	72	0.0138889
NODE_307442_length_128_cov_2621.517241	56	128	4	2	72	0.0277778
NODE_307442_length_128_cov_2621.517241	56	128	6	1	72	0.0138889
NODE_307442_length_128_cov_2621.517241	56	128	10	6	72	0.0833333
NODE_307442_length_128_cov_2621.517241	56	128	12	1	72	0.0138889
NODE_307442_length_128_cov_2621.517241	56	128	16	1	72	0.0138889
NODE_307442_length_128_cov_2621.517241	56	128	18	1	72	0.0138889
NODE_307442_length_128_cov_2621.517241	56	128	24	1	72	0.0138889
NODE_307442_length_128_cov_2621.517241	56	128	26	1	72	0.0138889
NODE_307442_length_128_cov_2621.517241	56	128	30	1	72	0.0138889
NODE_307442_length_128_cov_2621.517241	56	128	34	1	72	0.0138889
NODE_307442_length_128_cov_2621.517241	56	128	38	1	72	0.0138889
NODE_307442_length_128_cov_2621.517241	56	128	42	1	72	0.0138889
NODE_307442_length_128_cov_2621.517241	56	128	44	1	72	0.0138889
NODE_307442_length_128_cov_2621.517241	56	128	46	1	72	0.0138889
NODE_307442_length_128_cov_2621.517241	56	128	50	1	72	0.0138889
NODE_307442_length_128_cov_2621.517241	56	128	52	1	72	0.0138889
NODE_307442_length_128_cov_2621.517241	56	128	54	2	72	0.0277778
NODE_307442_length_128_cov_2621.517241	56	128	62	47	72	0.6527778
NODE_307443_length_128_cov_1604.275862	58	127	0	6	69	0.0869565
NODE_307443_length_128_cov_1604.275862	58	127	2	5	69	0.0724638
NODE_307443_length_128_cov_1604.275862	58	127	6	10	69	0.1449275
NODE_307443_length_128_cov_1604.275862	58	127	8	48	69	0.6956522
NODE_307458_length_128_cov_79.034483	43	123	0	4	80	0.0500000
NODE_307458_length_128_cov_79.034483	43	123	2	2	80	0.0250000
NODE_307458_length_128_cov_79.034483	43	123	10	2	80	0.0250000
NODE_307458_length_128_cov_79.034483	43	123	14	4	80	0.0500000
NODE_307458_length_128_cov_79.034483	43	123	16	68	80	0.8500000
NODE_307464_length_128_cov_61.793103	5	85	0	80	80	1.0000000
NODE_307549_length_127_cov_1879.785714	21	101	110	1	80	0.0125000
NODE_307549_length_127_cov_1879.785714	21	101	114	1	80	0.0125000
NODE_307549_length_127_cov_1879.785714	21	101	124	1	80	0.0125000
NODE_307549_length_127_cov_1879.785714	21	101	130	77	80	0.9625000
NODE_307549_length_127_cov_1879.785714	74	127	4	1	53	0.0188679
NODE_307549_length_127_cov_1879.785714	74	127	8	1	53	0.0188679
NODE_307549_length_127_cov_1879.785714	74	127	10	1	53	0.0188679
NODE_307549_length_127_cov_1879.785714	74	127	14	1	53	0.0188679
NODE_307549_length_127_cov_1879.785714	74	127	20	1	53	0.0188679
NODE_307549_length_127_cov_1879.785714	74	127	22	3	53	0.0566038
NODE_307549_length_127_cov_1879.785714	74	127	26	1	53	0.0188679
NODE_307549_length_127_cov_1879.785714	74	127	32	1	53	0.0188679
NODE_307549_length_127_cov_1879.785714	74	127	46	1	53	0.0188679
NODE_307549_length_127_cov_1879.785714	74	127	65	2	53	0.0377358
NODE_307549_length_127_cov_1879.785714	74	127	91	1	53	0.0188679
NODE_307549_length_127_cov_1879.785714	74	127	95	1	53	0.0188679
NODE_307549_length_127_cov_1879.785714	74	127	98	1	53	0.0188679
NODE_307549_length_127_cov_1879.785714	74	127	104	2	53	0.0377358
NODE_307549_length_127_cov_1879.785714	74	127	106	1	53	0.0188679
NODE_307549_length_127_cov_1879.785714	74	127	118	1	53	0.0188679
NODE_307549_length_127_cov_1879.785714	74	127	120	1	53	0.0188679
NODE_307549_length_127_cov_1879.785714	74	127	122	1	53	0.0188679
NODE_307549_length_127_cov_1879.785714	74	127	123	1	53	0.0188679
NODE_307549_length_127_cov_1879.785714	74	127	125	1	53	0.0188679
NODE_307549_length_127_cov_1879.785714	74	127	129	1	53	0.0188679
NODE_307549_length_127_cov_1879.785714	74	127	130	28	53	0.5283019
NODE_307583_length_127_cov_66.142857	38	118	0	80	80	1.0000000
NODE_307583_length_127_cov_66.142857	47	118	0	71	71	1.0000000
NODE_307590_length_127_cov_38.285714	12	86	0	74	74	1.0000000
NODE_307596_length_127_cov_30.607143	21	93	0	72	72	1.0000000
NODE_307662_length_126_cov_936.777778	24	96	6	72	72	1.0000000
NODE_307675_length_126_cov_147.185185	2	66	0	5	64	0.0781250
NODE_307675_length_126_cov_147.185185	2	66	2	1	64	0.0156250
NODE_307675_length_126_cov_147.185185	2	66	4	7	64	0.1093750
NODE_307675_length_126_cov_147.185185	2	66	6	5	64	0.0781250
NODE_307675_length_126_cov_147.185185	2	66	8	46	64	0.7187500
NODE_307675_length_126_cov_147.185185	2	66	0	5	64	0.0781250
NODE_307675_length_126_cov_147.185185	2	66	2	1	64	0.0156250
NODE_307675_length_126_cov_147.185185	2	66	4	7	64	0.1093750
NODE_307675_length_126_cov_147.185185	2	66	6	5	64	0.0781250
NODE_307675_length_126_cov_147.185185	2	66	8	46	64	0.7187500
NODE_307675_length_126_cov_147.185185	2	66	0	5	64	0.0781250
NODE_307675_length_126_cov_147.185185	2	66	2	1	64	0.0156250
NODE_307675_length_126_cov_147.185185	2	66	4	7	64	0.1093750
NODE_307675_length_126_cov_147.185185	2	66	6	5	64	0.0781250
NODE_307675_length_126_cov_147.185185	2	66	8	46	64	0.7187500
NODE_307675_length_126_cov_147.185185	39	99	8	60	60	1.0000000
NODE_307675_length_126_cov_147.185185	55	99	8	44	44	1.0000000
NODE_307684_length_126_cov_82.518519	44	75	0	31	31	1.0000000
NODE_307793_length_125_cov_656.807692	19	99	42	3	80	0.0375000
NODE_307793_length_125_cov_656.807692	19	99	46	1	80	0.0125000
NODE_307793_length_125_cov_656.807692	19	99	48	76	80	0.9500000
NODE_307806_length_125_cov_143.615385	52	125	4	3	73	0.0410959
NODE_307806_length_125_cov_143.615385	52	125	6	4	73	0.0547945
NODE_307806_length_125_cov_143.615385	52	125	8	2	73	0.0273973
NODE_307806_length_125_cov_143.615385	52	125	10	64	73	0.8767123
NODE_307810_length_125_cov_131.923077	3	52	6	3	49	0.0612245
NODE_307810_length_125_cov_131.923077	3	52	10	2	49	0.0408163
NODE_307810_length_125_cov_131.923077	3	52	11	1	49	0.0204082
NODE_307810_length_125_cov_131.923077	3	52	12	5	49	0.1020408
NODE_307810_length_125_cov_131.923077	3	52	18	4	49	0.0816327
NODE_307810_length_125_cov_131.923077	3	52	22	2	49	0.0408163
NODE_307810_length_125_cov_131.923077	3	52	26	2	49	0.0408163
NODE_307810_length_125_cov_131.923077	3	52	32	30	49	0.6122449
NODE_307810_length_125_cov_131.923077	25	89	32	64	64	1.0000000
NODE_307810_length_125_cov_131.923077	25	89	32	64	64	1.0000000
NODE_307816_length_125_cov_102.500000	0	56	6	20	56	0.3571429
NODE_307816_length_125_cov_102.500000	0	56	12	36	56	0.6428571
NODE_307816_length_125_cov_102.500000	7	56	6	13	49	0.2653061
NODE_307816_length_125_cov_102.500000	7	56	12	36	49	0.7346939
NODE_307816_length_125_cov_102.500000	29	114	4	8	85	0.0941176
NODE_307816_length_125_cov_102.500000	29	114	10	3	85	0.0352941
NODE_307816_length_125_cov_102.500000	29	114	12	74	85	0.8705882
NODE_307816_length_125_cov_102.500000	29	114	4	8	85	0.0941176
NODE_307816_length_125_cov_102.500000	29	114	10	3	85	0.0352941
NODE_307816_length_125_cov_102.500000	29	114	12	74	85	0.8705882
NODE_307816_length_125_cov_102.500000	29	114	4	8	85	0.0941176
NODE_307816_length_125_cov_102.500000	29	114	10	3	85	0.0352941
NODE_307816_length_125_cov_102.500000	29	114	12	74	85	0.8705882
NODE_307839_length_125_cov_28.115385	17	90	26	1	73	0.0136986
NODE_307839_length_125_cov_28.115385	17	90	28	1	73	0.0136986
NODE_307839_length_125_cov_28.115385	17	90	30	1	73	0.0136986
NODE_307839_length_125_cov_28.115385	17	90	32	3	73	0.0410959
NODE_307839_length_125_cov_28.115385	17	90	34	67	73	0.9178082
NODE_307839_length_125_cov_28.115385	57	98	34	41	41	1.0000000
NODE_307906_length_124_cov_945.680000	0	73	2	5	73	0.0684932
NODE_307906_length_124_cov_945.680000	0	73	4	1	73	0.0136986
NODE_307906_length_124_cov_945.680000	0	73	6	4	73	0.0547945
NODE_307906_length_124_cov_945.680000	0	73	12	2	73	0.0273973
NODE_307906_length_124_cov_945.680000	0	73	18	61	73	0.8356164
NODE_307906_length_124_cov_945.680000	53	124	0	1	71	0.0140845
NODE_307906_length_124_cov_945.680000	53	124	2	1	71	0.0140845
NODE_307906_length_124_cov_945.680000	53	124	4	4	71	0.0563380
NODE_307906_length_124_cov_945.680000	53	124	7	1	71	0.0140845
NODE_307906_length_124_cov_945.680000	53	124	14	6	71	0.0845070
NODE_307906_length_124_cov_945.680000	53	124	16	8	71	0.1126761
NODE_307906_length_124_cov_945.680000	53	124	18	50	71	0.7042254
NODE_308023_length_123_cov_1186.083333	0	76	6	2	76	0.0263158
NODE_308023_length_123_cov_1186.083333	0	76	10	3	76	0.0394737
NODE_308023_length_123_cov_1186.083333	0	76	12	5	76	0.0657895
NODE_308023_length_123_cov_1186.083333	0	76	22	3	76	0.0394737
NODE_308023_length_123_cov_1186.083333	0	76	28	63	76	0.8289474
NODE_308023_length_123_cov_1186.083333	0	76	6	2	76	0.0263158
NODE_308023_length_123_cov_1186.083333	0	76	10	3	76	0.0394737
NODE_308023_length_123_cov_1186.083333	0	76	12	5	76	0.0657895
NODE_308023_length_123_cov_1186.083333	0	76	22	3	76	0.0394737
NODE_308023_length_123_cov_1186.083333	0	76	28	63	76	0.8289474
NODE_308023_length_123_cov_1186.083333	0	76	6	2	76	0.0263158
NODE_308023_length_123_cov_1186.083333	0	76	10	3	76	0.0394737
NODE_308023_length_123_cov_1186.083333	0	76	12	5	76	0.0657895
NODE_308023_length_123_cov_1186.083333	0	76	22	3	76	0.0394737
NODE_308023_length_123_cov_1186.083333	0	76	28	63	76	0.8289474
NODE_308023_length_123_cov_1186.083333	0	76	6	2	76	0.0263158
NODE_308023_length_123_cov_1186.083333	0	76	10	3	76	0.0394737
NODE_308023_length_123_cov_1186.083333	0	76	12	5	76	0.0657895
NODE_308023_length_123_cov_1186.083333	0	76	22	3	76	0.0394737
NODE_308023_length_123_cov_1186.083333	0	76	28	63	76	0.8289474
NODE_308023_length_123_cov_1186.083333	49	123	0	3	74	0.0405405
NODE_308023_length_123_cov_1186.083333	49	123	2	1	74	0.0135135
NODE_308023_length_123_cov_1186.083333	49	123	8	6	74	0.0810811
NODE_308023_length_123_cov_1186.083333	49	123	12	1	74	0.0135135
NODE_308023_length_123_cov_1186.083333	49	123	16	1	74	0.0135135
NODE_308023_length_123_cov_1186.083333	49	123	18	7	74	0.0945946
NODE_308023_length_123_cov_1186.083333	49	123	24	1	74	0.0135135
NODE_308023_length_123_cov_1186.083333	49	123	28	54	74	0.7297297
NODE_308023_length_123_cov_1186.083333	49	123	0	3	74	0.0405405
NODE_308023_length_123_cov_1186.083333	49	123	2	1	74	0.0135135
NODE_308023_length_123_cov_1186.083333	49	123	8	6	74	0.0810811
NODE_308023_length_123_cov_1186.083333	49	123	12	1	74	0.0135135
NODE_308023_length_123_cov_1186.083333	49	123	16	1	74	0.0135135
NODE_308023_length_123_cov_1186.083333	49	123	18	7	74	0.0945946
NODE_308023_length_123_cov_1186.083333	49	123	24	1	74	0.0135135
NODE_308023_length_123_cov_1186.083333	49	123	28	54	74	0.7297297
NODE_308023_length_123_cov_1186.083333	49	123	0	3	74	0.0405405
NODE_308023_length_123_cov_1186.083333	49	123	2	1	74	0.0135135
NODE_308023_length_123_cov_1186.083333	49	123	8	6	74	0.0810811
NODE_308023_length_123_cov_1186.083333	49	123	12	1	74	0.0135135
NODE_308023_length_123_cov_1186.083333	49	123	16	1	74	0.0135135
NODE_308023_length_123_cov_1186.083333	49	123	18	7	74	0.0945946
NODE_308023_length_123_cov_1186.083333	49	123	24	1	74	0.0135135
NODE_308023_length_123_cov_1186.083333	49	123	28	54	74	0.7297297
NODE_308024_length_123_cov_963.500000	19	88	0	69	69	1.0000000
NODE_308037_length_123_cov_181.291667	0	47	0	47	47	1.0000000
NODE_308037_length_123_cov_181.291667	24	100	0	76	76	1.0000000
NODE_308057_length_123_cov_55.375000	52	123	2	1	71	0.0140845
NODE_308057_length_123_cov_55.375000	52	123	6	2	71	0.0281690
NODE_308057_length_123_cov_55.375000	52	123	8	1	71	0.0140845
NODE_308057_length_123_cov_55.375000	52	123	10	4	71	0.0563380
NODE_308057_length_123_cov_55.375000	52	123	17	4	71	0.0563380
NODE_308057_length_123_cov_55.375000	52	123	19	1	71	0.0140845
NODE_308057_length_123_cov_55.375000	52	123	21	1	71	0.0140845
NODE_308057_length_123_cov_55.375000	52	123	23	5	71	0.0704225
NODE_308057_length_123_cov_55.375000	52	123	27	1	71	0.0140845
NODE_308057_length_123_cov_55.375000	52	123	28	51	71	0.7183099
NODE_308057_length_123_cov_55.375000	52	123	2	1	71	0.0140845
NODE_308057_length_123_cov_55.375000	52	123	6	2	71	0.0281690
NODE_308057_length_123_cov_55.375000	52	123	8	1	71	0.0140845
NODE_308057_length_123_cov_55.375000	52	123	10	4	71	0.0563380
NODE_308057_length_123_cov_55.375000	52	123	17	4	71	0.0563380
NODE_308057_length_123_cov_55.375000	52	123	19	1	71	0.0140845
NODE_308057_length_123_cov_55.375000	52	123	21	1	71	0.0140845
NODE_308057_length_123_cov_55.375000	52	123	23	5	71	0.0704225
NODE_308057_length_123_cov_55.375000	52	123	27	1	71	0.0140845
NODE_308057_length_123_cov_55.375000	52	123	28	51	71	0.7183099
NODE_308057_length_123_cov_55.375000	61	123	2	1	62	0.0161290
NODE_308057_length_123_cov_55.375000	61	123	6	2	62	0.0322581
NODE_308057_length_123_cov_55.375000	61	123	8	1	62	0.0161290
NODE_308057_length_123_cov_55.375000	61	123	10	4	62	0.0645161
NODE_308057_length_123_cov_55.375000	61	123	17	4	62	0.0645161
NODE_308057_length_123_cov_55.375000	61	123	19	1	62	0.0161290
NODE_308057_length_123_cov_55.375000	61	123	21	1	62	0.0161290
NODE_308057_length_123_cov_55.375000	61	123	23	5	62	0.0806452
NODE_308057_length_123_cov_55.375000	61	123	27	1	62	0.0161290
NODE_308057_length_123_cov_55.375000	61	123	28	42	62	0.6774194
NODE_308068_length_123_cov_40.958333	9	89	8	3	80	0.0375000
NODE_308068_length_123_cov_40.958333	9	89	20	2	80	0.0250000
NODE_308068_length_123_cov_40.958333	9	89	22	75	80	0.9375000
NODE_308068_length_123_cov_40.958333	9	89	8	3	80	0.0375000
NODE_308068_length_123_cov_40.958333	9	89	20	2	80	0.0250000
NODE_308068_length_123_cov_40.958333	9	89	22	75	80	0.9375000
NODE_308068_length_123_cov_40.958333	9	89	8	3	80	0.0375000
NODE_308068_length_123_cov_40.958333	9	89	20	2	80	0.0250000
NODE_308068_length_123_cov_40.958333	9	89	22	75	80	0.9375000
NODE_308068_length_123_cov_40.958333	9	89	8	3	80	0.0375000
NODE_308068_length_123_cov_40.958333	9	89	20	2	80	0.0250000
NODE_308068_length_123_cov_40.958333	9	89	22	75	80	0.9375000
NODE_308068_length_123_cov_40.958333	9	89	8	3	80	0.0375000
NODE_308068_length_123_cov_40.958333	9	89	20	2	80	0.0250000
NODE_308068_length_123_cov_40.958333	9	89	22	75	80	0.9375000
NODE_308068_length_123_cov_40.958333	9	80	8	3	71	0.0422535
NODE_308068_length_123_cov_40.958333	9	80	20	2	71	0.0281690
NODE_308068_length_123_cov_40.958333	9	80	22	66	71	0.9295775
NODE_308180_length_122_cov_111.043478	8	88	2	80	80	1.0000000
NODE_308180_length_122_cov_111.043478	8	88	2	80	80	1.0000000
NODE_308184_length_122_cov_67.565217	0	50	0	2	50	0.0400000
NODE_308184_length_122_cov_67.565217	0	50	4	9	50	0.1800000
NODE_308184_length_122_cov_67.565217	0	50	6	2	50	0.0400000
NODE_308184_length_122_cov_67.565217	0	50	8	37	50	0.7400000
NODE_308184_length_122_cov_67.565217	0	50	0	2	50	0.0400000
NODE_308184_length_122_cov_67.565217	0	50	4	9	50	0.1800000
NODE_308184_length_122_cov_67.565217	0	50	6	2	50	0.0400000
NODE_308184_length_122_cov_67.565217	0	50	8	37	50	0.7400000
NODE_308184_length_122_cov_67.565217	23	103	8	80	80	1.0000000
NODE_308184_length_122_cov_67.565217	23	103	8	80	80	1.0000000
NODE_308184_length_122_cov_67.565217	23	103	8	80	80	1.0000000
NODE_308184_length_122_cov_67.565217	23	103	8	80	80	1.0000000
NODE_308184_length_122_cov_67.565217	23	103	8	80	80	1.0000000
NODE_308184_length_122_cov_67.565217	23	94	8	71	71	1.0000000
NODE_308188_length_122_cov_58.826087	28	99	0	71	71	1.0000000
NODE_308188_length_122_cov_58.826087	33	99	0	66	66	1.0000000
NODE_308188_length_122_cov_58.826087	72	122	0	50	50	1.0000000
NODE_308188_length_122_cov_58.826087	72	122	0	50	50	1.0000000
NODE_308198_length_122_cov_38.173913	12	93	0	81	81	1.0000000
NODE_308257_length_121_cov_159.318182	24	55	0	31	31	1.0000000
NODE_308260_length_121_cov_120.181818	20	100	4	80	80	1.0000000
NODE_308260_length_121_cov_120.181818	20	95	4	75	75	1.0000000
NODE_308260_length_121_cov_120.181818	20	100	4	80	80	1.0000000
NODE_308260_length_121_cov_120.181818	29	100	4	71	71	1.0000000
NODE_308273_length_121_cov_54.181818	7	70	6	63	63	1.0000000
NODE_308273_length_121_cov_54.181818	7	70	6	63	63	1.0000000
NODE_308273_length_121_cov_54.181818	7	70	6	63	63	1.0000000
NODE_308273_length_121_cov_54.181818	9	70	6	61	61	1.0000000
NODE_308273_length_121_cov_54.181818	43	109	6	66	66	1.0000000
NODE_308273_length_121_cov_54.181818	43	121	0	9	78	0.1153846
NODE_308273_length_121_cov_54.181818	43	121	6	69	78	0.8846154
NODE_308273_length_121_cov_54.181818	64	117	0	5	53	0.0943396
NODE_308273_length_121_cov_54.181818	64	117	6	48	53	0.9056604
NODE_308317_length_120_cov_1404.619048	0	64	0	1	64	0.0156250
NODE_308317_length_120_cov_1404.619048	0	64	2	1	64	0.0156250
NODE_308317_length_120_cov_1404.619048	0	64	6	1	64	0.0156250
NODE_308317_length_120_cov_1404.619048	0	64	10	3	64	0.0468750
NODE_308317_length_120_cov_1404.619048	0	64	16	4	64	0.0625000
NODE_308317_length_120_cov_1404.619048	0	64	18	1	64	0.0156250
NODE_308317_length_120_cov_1404.619048	0	64	20	3	64	0.0468750
NODE_308317_length_120_cov_1404.619048	0	64	22	1	64	0.0156250
NODE_308317_length_120_cov_1404.619048	0	64	24	1	64	0.0156250
NODE_308317_length_120_cov_1404.619048	0	64	26	1	64	0.0156250
NODE_308317_length_120_cov_1404.619048	0	64	34	1	64	0.0156250
NODE_308317_length_120_cov_1404.619048	0	64	36	46	64	0.7187500
NODE_308317_length_120_cov_1404.619048	45	117	4	2	72	0.0277778
NODE_308317_length_120_cov_1404.619048	45	117	8	2	72	0.0277778
NODE_308317_length_120_cov_1404.619048	45	117	10	1	72	0.0138889
NODE_308317_length_120_cov_1404.619048	45	117	12	3	72	0.0416667
NODE_308317_length_120_cov_1404.619048	45	117	18	1	72	0.0138889
NODE_308317_length_120_cov_1404.619048	45	117	28	3	72	0.0416667
NODE_308317_length_120_cov_1404.619048	45	117	34	1	72	0.0138889
NODE_308317_length_120_cov_1404.619048	45	117	36	59	72	0.8194444
NODE_308318_length_120_cov_1138.428571	19	99	12	80	80	1.0000000
NODE_308318_length_120_cov_1138.428571	72	120	2	5	48	0.1041667
NODE_308318_length_120_cov_1138.428571	72	120	6	1	48	0.0208333
NODE_308318_length_120_cov_1138.428571	72	120	8	8	48	0.1666667
NODE_308318_length_120_cov_1138.428571	72	120	10	1	48	0.0208333
NODE_308318_length_120_cov_1138.428571	72	120	12	33	48	0.6875000
NODE_308357_length_120_cov_54.666667	0	69	0	69	69	1.0000000
NODE_308357_length_120_cov_54.666667	0	69	0	69	69	1.0000000
NODE_308357_length_120_cov_54.666667	0	69	0	69	69	1.0000000
NODE_308357_length_120_cov_54.666667	42	108	0	66	66	1.0000000
NODE_308357_length_120_cov_54.666667	53	120	0	67	67	1.0000000
NODE_308357_length_120_cov_54.666667	53	120	0	67	67	1.0000000
NODE_308487_length_118_cov_1211.578947	49	116	0	6	67	0.0895522
NODE_308487_length_118_cov_1211.578947	49	116	2	61	67	0.9104478
NODE_308488_length_118_cov_1157.157895	4	70	0	11	66	0.1666667
NODE_308488_length_118_cov_1157.157895	4	70	2	55	66	0.8333333
NODE_308500_length_118_cov_218.210526	0	63	0	1	63	0.0158730
NODE_308500_length_118_cov_218.210526	0	63	2	3	63	0.0476190
NODE_308500_length_118_cov_218.210526	0	63	4	1	63	0.0158730
NODE_308500_length_118_cov_218.210526	0	63	10	5	63	0.0793651
NODE_308500_length_118_cov_218.210526	0	63	14	3	63	0.0476190
NODE_308500_length_118_cov_218.210526	0	63	16	50	63	0.7936508
NODE_308500_length_118_cov_218.210526	35	115	4	1	80	0.0125000
NODE_308500_length_118_cov_218.210526	35	115	6	1	80	0.0125000
NODE_308500_length_118_cov_218.210526	35	115	8	4	80	0.0500000
NODE_308500_length_118_cov_218.210526	35	115	10	2	80	0.0250000
NODE_308500_length_118_cov_218.210526	35	115	12	3	80	0.0375000
NODE_308500_length_118_cov_218.210526	35	115	16	69	80	0.8625000
NODE_308504_length_118_cov_161.052632	4	70	0	2	66	0.0303030
NODE_308504_length_118_cov_161.052632	4	70	4	7	66	0.1060606
NODE_308504_length_118_cov_161.052632	4	70	6	57	66	0.8636364
NODE_308572_length_117_cov_338.555556	7	70	10	1	63	0.0158730
NODE_308572_length_117_cov_338.555556	7	70	12	62	63	0.9841270
NODE_308572_length_117_cov_338.555556	7	70	10	1	63	0.0158730
NODE_308572_length_117_cov_338.555556	7	70	12	62	63	0.9841270
NODE_308572_length_117_cov_338.555556	7	70	10	1	63	0.0158730
NODE_308572_length_117_cov_338.555556	7	70	12	62	63	0.9841270
NODE_308572_length_117_cov_338.555556	9	70	12	61	61	1.0000000
NODE_308572_length_117_cov_338.555556	43	109	6	1	66	0.0151515
NODE_308572_length_117_cov_338.555556	43	109	8	2	66	0.0303030
NODE_308572_length_117_cov_338.555556	43	109	10	2	66	0.0303030
NODE_308572_length_117_cov_338.555556	43	109	12	61	66	0.9242424
NODE_308572_length_117_cov_338.555556	43	114	4	2	71	0.0281690
NODE_308572_length_117_cov_338.555556	43	114	6	4	71	0.0563380
NODE_308572_length_117_cov_338.555556	43	114	8	2	71	0.0281690
NODE_308572_length_117_cov_338.555556	43	114	10	2	71	0.0281690
NODE_308572_length_117_cov_338.555556	43	114	12	61	71	0.8591549
NODE_308572_length_117_cov_338.555556	64	117	0	1	53	0.0188679
NODE_308572_length_117_cov_338.555556	64	117	2	1	53	0.0188679
NODE_308572_length_117_cov_338.555556	64	117	4	3	53	0.0566038
NODE_308572_length_117_cov_338.555556	64	117	6	4	53	0.0754717
NODE_308572_length_117_cov_338.555556	64	117	8	2	53	0.0377358
NODE_308572_length_117_cov_338.555556	64	117	10	2	53	0.0377358
NODE_308572_length_117_cov_338.555556	64	117	12	40	53	0.7547170
NODE_308654_length_116_cov_1897.470588	0	77	0	1	77	0.0129870
NODE_308654_length_116_cov_1897.470588	0	77	4	1	77	0.0129870
NODE_308654_length_116_cov_1897.470588	0	77	6	3	77	0.0389610
NODE_308654_length_116_cov_1897.470588	0	77	10	1	77	0.0129870
NODE_308654_length_116_cov_1897.470588	0	77	12	4	77	0.0519481
NODE_308654_length_116_cov_1897.470588	0	77	14	2	77	0.0259740
NODE_308654_length_116_cov_1897.470588	0	77	16	65	77	0.8441558
NODE_308654_length_116_cov_1897.470588	34	111	10	3	77	0.0389610
NODE_308654_length_116_cov_1897.470588	34	111	14	3	77	0.0389610
NODE_308654_length_116_cov_1897.470588	34	111	16	71	77	0.9220779
NODE_308668_length_116_cov_438.529412	15	95	8	80	80	1.0000000
NODE_308668_length_116_cov_438.529412	68	116	0	2	48	0.0416667
NODE_308668_length_116_cov_438.529412	68	116	4	4	48	0.0833333
NODE_308668_length_116_cov_438.529412	68	116	6	6	48	0.1250000
NODE_308668_length_116_cov_438.529412	68	116	8	36	48	0.7500000
NODE_308701_length_116_cov_93.235294	52	116	0	11	64	0.1718750
NODE_308701_length_116_cov_93.235294	52	116	2	1	64	0.0156250
NODE_308701_length_116_cov_93.235294	52	116	4	52	64	0.8125000
NODE_308722_length_116_cov_46.882353	6	66	7	2	60	0.0333333
NODE_308722_length_116_cov_46.882353	6	66	10	1	60	0.0166667
NODE_308722_length_116_cov_46.882353	6	66	14	2	60	0.0333333
NODE_308722_length_116_cov_46.882353	6	66	16	1	60	0.0166667
NODE_308722_length_116_cov_46.882353	6	66	18	54	60	0.9000000
NODE_308727_length_116_cov_38.352941	20	100	2	80	80	1.0000000
NODE_308746_length_115_cov_1012.625000	31	114	2	3	83	0.0361446
NODE_308746_length_115_cov_1012.625000	31	114	4	80	83	0.9638554
NODE_308750_length_115_cov_776.625000	9	92	10	83	83	1.0000000
NODE_308752_length_115_cov_623.937500	0	74	2	4	74	0.0540541
NODE_308752_length_115_cov_623.937500	0	74	6	70	74	0.9459459
NODE_308782_length_115_cov_144.812500	4	73	0	69	69	1.0000000
NODE_308806_length_115_cov_65.187500	16	76	6	60	60	1.0000000
NODE_308846_length_114_cov_819.466667	40	114	0	2	74	0.0270270
NODE_308846_length_114_cov_819.466667	40	114	12	1	74	0.0135135
NODE_308846_length_114_cov_819.466667	40	114	18	1	74	0.0135135
NODE_308846_length_114_cov_819.466667	40	114	20	3	74	0.0405405
NODE_308846_length_114_cov_819.466667	40	114	22	7	74	0.0945946
NODE_308846_length_114_cov_819.466667	40	114	24	60	74	0.8108108
NODE_308846_length_114_cov_819.466667	40	114	0	2	74	0.0270270
NODE_308846_length_114_cov_819.466667	40	114	12	1	74	0.0135135
NODE_308846_length_114_cov_819.466667	40	114	18	1	74	0.0135135
NODE_308846_length_114_cov_819.466667	40	114	20	3	74	0.0405405
NODE_308846_length_114_cov_819.466667	40	114	22	7	74	0.0945946
NODE_308846_length_114_cov_819.466667	40	114	24	60	74	0.8108108
NODE_308846_length_114_cov_819.466667	49	114	0	2	65	0.0307692
NODE_308846_length_114_cov_819.466667	49	114	12	1	65	0.0153846
NODE_308846_length_114_cov_819.466667	49	114	18	1	65	0.0153846
NODE_308846_length_114_cov_819.466667	49	114	20	3	65	0.0461538
NODE_308846_length_114_cov_819.466667	49	114	22	7	65	0.1076923
NODE_308846_length_114_cov_819.466667	49	114	24	51	65	0.7846154
NODE_308866_length_114_cov_285.666667	0	78	0	7	78	0.0897436
NODE_308866_length_114_cov_285.666667	0	78	4	71	78	0.9102564
NODE_308866_length_114_cov_285.666667	51	114	0	2	63	0.0317460
NODE_308866_length_114_cov_285.666667	51	114	4	61	63	0.9682540
NODE_308886_length_114_cov_83.600000	51	82	0	31	31	1.0000000
NODE_308891_length_114_cov_67.666667	40	90	0	50	50	1.0000000
NODE_308939_length_113_cov_446.214286	5	82	2	77	77	1.0000000
NODE_308939_length_113_cov_446.214286	5	82	2	77	77	1.0000000
NODE_308967_length_113_cov_160.071429	0	64	14	64	64	1.0000000
NODE_308967_length_113_cov_160.071429	0	64	14	64	64	1.0000000
NODE_308967_length_113_cov_160.071429	37	103	14	66	66	1.0000000
NODE_308967_length_113_cov_160.071429	37	108	14	71	71	1.0000000
NODE_309037_length_112_cov_963.384615	43	112	0	12	69	0.1739130
NODE_309037_length_112_cov_963.384615	43	112	2	57	69	0.8260869
NODE_309044_length_112_cov_653.615385	7	78	4	1	71	0.0140845
NODE_309044_length_112_cov_653.615385	7	78	6	70	71	0.9859155
NODE_309044_length_112_cov_653.615385	12	78	6	66	66	1.0000000
NODE_309044_length_112_cov_653.615385	51	112	0	4	61	0.0655738
NODE_309044_length_112_cov_653.615385	51	112	4	4	61	0.0655738
NODE_309044_length_112_cov_653.615385	51	112	6	53	61	0.8688524
NODE_309044_length_112_cov_653.615385	51	112	0	4	61	0.0655738
NODE_309044_length_112_cov_653.615385	51	112	4	4	61	0.0655738
NODE_309044_length_112_cov_653.615385	51	112	6	53	61	0.8688524
NODE_309067_length_112_cov_219.538462	0	62	0	62	62	1.0000000
NODE_309067_length_112_cov_219.538462	0	57	0	57	57	1.0000000
NODE_309067_length_112_cov_219.538462	0	62	0	62	62	1.0000000
NODE_309067_length_112_cov_219.538462	0	59	0	59	59	1.0000000
NODE_309067_length_112_cov_219.538462	35	112	0	77	77	1.0000000
NODE_309067_length_112_cov_219.538462	35	112	0	77	77	1.0000000
NODE_309067_length_112_cov_219.538462	35	112	0	77	77	1.0000000
NODE_309078_length_112_cov_160.307692	0	69	0	69	69	1.0000000
NODE_309079_length_112_cov_134.846154	11	91	7	59	80	0.7375000
NODE_309079_length_112_cov_134.846154	11	91	8	21	80	0.2625000
NODE_309079_length_112_cov_134.846154	11	91	7	59	80	0.7375000
NODE_309079_length_112_cov_134.846154	11	91	8	21	80	0.2625000
NODE_309079_length_112_cov_134.846154	64	112	0	1	48	0.0208333
NODE_309079_length_112_cov_134.846154	64	112	2	8	48	0.1666667
NODE_309079_length_112_cov_134.846154	64	112	7	6	48	0.1250000
NODE_309079_length_112_cov_134.846154	64	112	8	33	48	0.6875000
NODE_309079_length_112_cov_134.846154	64	112	0	1	48	0.0208333
NODE_309079_length_112_cov_134.846154	64	112	2	8	48	0.1666667
NODE_309079_length_112_cov_134.846154	64	112	7	6	48	0.1250000
NODE_309079_length_112_cov_134.846154	64	112	8	33	48	0.6875000
NODE_309079_length_112_cov_134.846154	64	112	0	1	48	0.0208333
NODE_309079_length_112_cov_134.846154	64	112	2	8	48	0.1666667
NODE_309079_length_112_cov_134.846154	64	112	7	6	48	0.1250000
NODE_309079_length_112_cov_134.846154	64	112	8	33	48	0.6875000
NODE_309092_length_112_cov_84.384615	10	90	0	80	80	1.0000000
NODE_309097_length_112_cov_72.769231	36	100	2	64	64	1.0000000
NODE_309106_length_112_cov_35.307692	13	76	2	63	63	1.0000000
NODE_309123_length_111_cov_1107.833333	0	52	0	2	52	0.0384615
NODE_309123_length_111_cov_1107.833333	0	52	2	1	52	0.0192308
NODE_309123_length_111_cov_1107.833333	0	52	4	1	52	0.0192308
NODE_309123_length_111_cov_1107.833333	0	52	7	2	52	0.0384615
NODE_309123_length_111_cov_1107.833333	0	52	14	46	52	0.8846154
NODE_309123_length_111_cov_1107.833333	0	52	0	2	52	0.0384615
NODE_309123_length_111_cov_1107.833333	0	52	2	1	52	0.0192308
NODE_309123_length_111_cov_1107.833333	0	52	4	1	52	0.0192308
NODE_309123_length_111_cov_1107.833333	0	52	7	2	52	0.0384615
NODE_309123_length_111_cov_1107.833333	0	52	14	46	52	0.8846154
NODE_309123_length_111_cov_1107.833333	0	52	0	2	52	0.0384615
NODE_309123_length_111_cov_1107.833333	0	52	2	1	52	0.0192308
NODE_309123_length_111_cov_1107.833333	0	52	4	1	52	0.0192308
NODE_309123_length_111_cov_1107.833333	0	52	7	2	52	0.0384615
NODE_309123_length_111_cov_1107.833333	0	52	14	46	52	0.8846154
NODE_309123_length_111_cov_1107.833333	0	52	0	2	52	0.0384615
NODE_309123_length_111_cov_1107.833333	0	52	2	1	52	0.0192308
NODE_309123_length_111_cov_1107.833333	0	52	4	1	52	0.0192308
NODE_309123_length_111_cov_1107.833333	0	52	7	2	52	0.0384615
NODE_309123_length_111_cov_1107.833333	0	52	14	46	52	0.8846154
NODE_309123_length_111_cov_1107.833333	25	105	12	2	80	0.0250000
NODE_309123_length_111_cov_1107.833333	25	105	14	78	80	0.9750000
NODE_309123_length_111_cov_1107.833333	25	105	12	2	80	0.0250000
NODE_309123_length_111_cov_1107.833333	25	105	14	78	80	0.9750000
NODE_309123_length_111_cov_1107.833333	25	105	12	2	80	0.0250000
NODE_309123_length_111_cov_1107.833333	25	105	14	78	80	0.9750000
NODE_309123_length_111_cov_1107.833333	25	105	12	2	80	0.0250000
NODE_309123_length_111_cov_1107.833333	25	105	14	78	80	0.9750000
NODE_309123_length_111_cov_1107.833333	25	105	12	2	80	0.0250000
NODE_309123_length_111_cov_1107.833333	25	105	14	78	80	0.9750000
NODE_309123_length_111_cov_1107.833333	25	105	12	2	80	0.0250000
NODE_309123_length_111_cov_1107.833333	25	105	14	78	80	0.9750000
NODE_309126_length_111_cov_827.500000	3	74	10	4	71	0.0563380
NODE_309126_length_111_cov_827.500000	3	74	12	67	71	0.9436620
NODE_309126_length_111_cov_827.500000	8	74	12	66	66	1.0000000
NODE_309126_length_111_cov_827.500000	47	111	4	2	64	0.0312500
NODE_309126_length_111_cov_827.500000	47	111	6	1	64	0.0156250
NODE_309126_length_111_cov_827.500000	47	111	7	1	64	0.0156250
NODE_309126_length_111_cov_827.500000	47	111	10	1	64	0.0156250
NODE_309126_length_111_cov_827.500000	47	111	12	59	64	0.9218750
NODE_309126_length_111_cov_827.500000	47	111	4	2	64	0.0312500
NODE_309126_length_111_cov_827.500000	47	111	6	1	64	0.0156250
NODE_309126_length_111_cov_827.500000	47	111	7	1	64	0.0156250
NODE_309126_length_111_cov_827.500000	47	111	10	1	64	0.0156250
NODE_309126_length_111_cov_827.500000	47	111	12	59	64	0.9218750
NODE_309126_length_111_cov_827.500000	47	111	4	2	64	0.0312500
NODE_309126_length_111_cov_827.500000	47	111	6	1	64	0.0156250
NODE_309126_length_111_cov_827.500000	47	111	7	1	64	0.0156250
NODE_309126_length_111_cov_827.500000	47	111	10	1	64	0.0156250
NODE_309126_length_111_cov_827.500000	47	111	12	59	64	0.9218750
NODE_309129_length_111_cov_726.833333	12	89	0	77	77	1.0000000
NODE_309129_length_111_cov_726.833333	12	89	0	77	77	1.0000000
NODE_309129_length_111_cov_726.833333	62	111	0	49	49	1.0000000
NODE_309129_length_111_cov_726.833333	67	111	0	44	44	1.0000000
NODE_309131_length_111_cov_692.416667	31	111	0	1	80	0.0125000
NODE_309131_length_111_cov_692.416667	31	111	2	1	80	0.0125000
NODE_309131_length_111_cov_692.416667	31	111	4	4	80	0.0500000
NODE_309131_length_111_cov_692.416667	31	111	10	74	80	0.9250000
NODE_309149_length_111_cov_241.750000	30	97	0	67	67	1.0000000
NODE_309160_length_111_cov_169.416667	21	102	0	81	81	1.0000000
NODE_309200_length_110_cov_554.909091	1	28	12	27	27	1.0000000
NODE_309200_length_110_cov_554.909091	1	81	12	80	80	1.0000000
NODE_309202_length_110_cov_537.545455	0	75	0	75	75	1.0000000
NODE_309202_length_110_cov_537.545455	53	107	0	54	54	1.0000000
NODE_309235_length_110_cov_91.636364	19	54	0	35	35	1.0000000
NODE_309235_length_110_cov_91.636364	64	107	0	43	43	1.0000000
NODE_309239_length_110_cov_80.272727	19	54	0	35	35	1.0000000
NODE_309239_length_110_cov_80.272727	64	99	0	35	35	1.0000000
NODE_309241_length_110_cov_78.363636	19	54	0	35	35	1.0000000
NODE_309241_length_110_cov_78.363636	64	107	0	43	43	1.0000000
NODE_309245_length_110_cov_68.727273	11	46	0	35	35	1.0000000
NODE_309245_length_110_cov_68.727273	56	91	0	35	35	1.0000000
NODE_309252_length_110_cov_44.545455	5	57	0	52	52	1.0000000
NODE_309263_length_109_cov_1364.100000	29	98	0	69	69	1.0000000
NODE_309275_length_109_cov_689.800000	12	86	0	74	74	1.0000000
NODE_309309_length_109_cov_250.800000	4	66	0	62	62	1.0000000
NODE_309311_length_109_cov_242.000000	29	98	0	69	69	1.0000000
NODE_309326_length_109_cov_139.000000	26	106	2	80	80	1.0000000
NODE_309345_length_109_cov_84.500000	33	93	6	60	60	1.0000000
NODE_309349_length_109_cov_75.300000	0	65	4	2	65	0.0307692
NODE_309349_length_109_cov_75.300000	0	65	6	2	65	0.0307692
NODE_309349_length_109_cov_75.300000	0	65	8	2	65	0.0307692
NODE_309349_length_109_cov_75.300000	0	65	12	59	65	0.9076923
NODE_309384_length_108_cov_1542.666667	28	108	0	80	80	1.0000000
NODE_309391_length_108_cov_987.666667	5	85	0	80	80	1.0000000
NODE_309391_length_108_cov_987.666667	5	85	0	80	80	1.0000000
NODE_309391_length_108_cov_987.666667	5	85	0	80	80	1.0000000
NODE_309391_length_108_cov_987.666667	5	85	0	80	80	1.0000000
NODE_309391_length_108_cov_987.666667	5	85	0	80	80	1.0000000
NODE_309391_length_108_cov_987.666667	58	108	0	50	50	1.0000000
NODE_309391_length_108_cov_987.666667	58	108	0	50	50	1.0000000
NODE_309395_length_108_cov_841.666667	1	65	2	64	64	1.0000000
NODE_309395_length_108_cov_841.666667	1	65	2	64	64	1.0000000
NODE_309395_length_108_cov_841.666667	1	65	2	64	64	1.0000000
NODE_309433_length_108_cov_213.333333	22	81	2	59	59	1.0000000
NODE_309433_length_108_cov_213.333333	55	81	2	26	26	1.0000000
NODE_309464_length_108_cov_107.888889	11	82	4	71	71	1.0000000
NODE_309464_length_108_cov_107.888889	16	82	4	66	66	1.0000000
NODE_309464_length_108_cov_107.888889	55	108	0	4	53	0.0754717
NODE_309464_length_108_cov_107.888889	55	108	4	49	53	0.9245283
NODE_309464_length_108_cov_107.888889	55	108	0	4	53	0.0754717
NODE_309464_length_108_cov_107.888889	55	108	4	49	53	0.9245283
NODE_309464_length_108_cov_107.888889	55	108	0	4	53	0.0754717
NODE_309464_length_108_cov_107.888889	55	108	4	49	53	0.9245283
NODE_309472_length_108_cov_76.444444	13	76	6	63	63	1.0000000
NODE_309479_length_108_cov_51.000000	0	53	0	53	53	1.0000000
NODE_309479_length_108_cov_51.000000	0	53	0	53	53	1.0000000
NODE_309479_length_108_cov_51.000000	0	53	0	53	53	1.0000000
NODE_309479_length_108_cov_51.000000	26	106	0	80	80	1.0000000
NODE_309479_length_108_cov_51.000000	26	106	0	80	80	1.0000000
NODE_309479_length_108_cov_51.000000	26	106	0	80	80	1.0000000
NODE_309479_length_108_cov_51.000000	26	106	0	80	80	1.0000000
NODE_309479_length_108_cov_51.000000	26	106	0	80	80	1.0000000
NODE_309479_length_108_cov_51.000000	26	97	0	71	71	1.0000000
NODE_309490_length_108_cov_31.111111	11	82	0	71	71	1.0000000
NODE_309490_length_108_cov_31.111111	16	82	0	66	66	1.0000000
NODE_309490_length_108_cov_31.111111	55	108	0	53	53	1.0000000
NODE_309490_length_108_cov_31.111111	55	108	0	53	53	1.0000000
NODE_309490_length_108_cov_31.111111	55	108	0	53	53	1.0000000
NODE_309530_length_107_cov_608.250000	0	64	0	64	64	1.0000000
NODE_309530_length_107_cov_608.250000	53	103	0	50	50	1.0000000
NODE_309551_length_107_cov_303.250000	0	56	0	56	56	1.0000000
NODE_309551_length_107_cov_303.250000	29	99	0	70	70	1.0000000
NODE_309657_length_106_cov_522.571429	10	90	0	80	80	1.0000000
NODE_309657_length_106_cov_522.571429	10	90	0	80	80	1.0000000
NODE_309657_length_106_cov_522.571429	10	90	0	80	80	1.0000000
NODE_309657_length_106_cov_522.571429	10	90	0	80	80	1.0000000
NODE_309657_length_106_cov_522.571429	10	90	0	80	80	1.0000000
NODE_309657_length_106_cov_522.571429	19	90	0	71	71	1.0000000
NODE_309696_length_106_cov_161.857143	7	78	0	71	71	1.0000000
NODE_309696_length_106_cov_161.857143	51	106	0	55	55	1.0000000
NODE_309707_length_106_cov_130.714286	0	76	0	76	76	1.0000000
NODE_309714_length_106_cov_108.000000	0	76	0	76	76	1.0000000
NODE_309717_length_106_cov_102.142857	0	62	0	62	62	1.0000000
NODE_309717_length_106_cov_102.142857	35	106	0	71	71	1.0000000
NODE_309717_length_106_cov_102.142857	35	106	0	71	71	1.0000000
NODE_309747_length_106_cov_39.428571	0	76	0	76	76	1.0000000
NODE_309761_length_106_cov_30.857143	0	70	0	70	70	1.0000000
NODE_309761_length_106_cov_30.857143	0	70	0	70	70	1.0000000
NODE_309761_length_106_cov_30.857143	0	70	0	70	70	1.0000000
NODE_309761_length_106_cov_30.857143	43	92	0	49	49	1.0000000
NODE_309761_length_106_cov_30.857143	53	106	0	53	53	1.0000000
NODE_309761_length_106_cov_30.857143	53	106	0	53	53	1.0000000
NODE_309775_length_105_cov_2054.666667	31	105	0	74	74	1.0000000
NODE_309775_length_105_cov_2054.666667	31	105	0	74	74	1.0000000
NODE_309775_length_105_cov_2054.666667	31	105	0	74	74	1.0000000
NODE_309775_length_105_cov_2054.666667	31	105	0	74	74	1.0000000
NODE_309788_length_105_cov_830.833333	30	105	0	75	75	1.0000000
NODE_309789_length_105_cov_825.500000	0	77	0	77	77	1.0000000
NODE_309789_length_105_cov_825.500000	0	77	0	77	77	1.0000000
NODE_309789_length_105_cov_825.500000	50	99	0	49	49	1.0000000
NODE_309789_length_105_cov_825.500000	55	105	0	50	50	1.0000000
NODE_309815_length_105_cov_231.333333	0	54	0	54	54	1.0000000
NODE_309815_length_105_cov_231.333333	27	99	0	72	72	1.0000000
NODE_309842_length_105_cov_85.333333	14	94	12	80	80	1.0000000
NODE_309842_length_105_cov_85.333333	67	89	12	22	22	1.0000000
NODE_309855_length_105_cov_61.833333	23	103	0	80	80	1.0000000
NODE_309867_length_105_cov_40.666667	6	66	0	60	60	1.0000000
NODE_309925_length_104_cov_1016.000000	0	78	0	78	78	1.0000000
NODE_309925_length_104_cov_1016.000000	53	99	0	46	46	1.0000000
NODE_309935_length_104_cov_791.200000	0	67	0	67	67	1.0000000
NODE_309935_length_104_cov_791.200000	0	67	0	67	67	1.0000000
NODE_309935_length_104_cov_791.200000	40	104	0	64	64	1.0000000
NODE_309938_length_104_cov_574.200000	21	101	0	80	80	1.0000000
NODE_309938_length_104_cov_574.200000	21	101	0	80	80	1.0000000
NODE_309938_length_104_cov_574.200000	21	101	0	80	80	1.0000000
NODE_309938_length_104_cov_574.200000	21	101	0	80	80	1.0000000
NODE_309938_length_104_cov_574.200000	21	101	0	80	80	1.0000000
NODE_309938_length_104_cov_574.200000	21	92	0	71	71	1.0000000
NODE_309940_length_104_cov_547.400000	10	87	0	77	77	1.0000000
NODE_309940_length_104_cov_547.400000	10	87	0	77	77	1.0000000
NODE_310020_length_104_cov_46.800000	42	104	0	62	62	1.0000000
NODE_310054_length_103_cov_2267.000000	0	54	0	54	54	1.0000000
NODE_310054_length_103_cov_2267.000000	27	100	0	73	73	1.0000000
NODE_310082_length_103_cov_890.000000	6	70	0	64	64	1.0000000
NODE_310082_length_103_cov_890.000000	6	70	0	64	64	1.0000000
NODE_310082_length_103_cov_890.000000	6	70	0	64	64	1.0000000
NODE_310082_length_103_cov_890.000000	43	103	0	60	60	1.0000000
NODE_310082_length_103_cov_890.000000	59	103	0	44	44	1.0000000
NODE_310090_length_103_cov_768.500000	7	78	0	71	71	1.0000000
NODE_310090_length_103_cov_768.500000	12	78	0	66	66	1.0000000
NODE_310090_length_103_cov_768.500000	51	99	0	48	48	1.0000000
NODE_310090_length_103_cov_768.500000	51	99	0	48	48	1.0000000
NODE_310090_length_103_cov_768.500000	51	99	0	48	48	1.0000000
NODE_310091_length_103_cov_751.000000	0	71	0	71	71	1.0000000
NODE_310091_length_103_cov_751.000000	0	71	0	71	71	1.0000000
NODE_310091_length_103_cov_751.000000	44	93	0	49	49	1.0000000
NODE_310094_length_103_cov_678.000000	10	74	0	64	64	1.0000000
NODE_310094_length_103_cov_678.000000	10	74	0	64	64	1.0000000
NODE_310094_length_103_cov_678.000000	10	74	0	64	64	1.0000000
NODE_310094_length_103_cov_678.000000	47	96	0	49	49	1.0000000
NODE_310103_length_103_cov_462.750000	19	99	0	80	80	1.0000000
NODE_310116_length_103_cov_300.250000	0	63	0	63	63	1.0000000
NODE_310147_length_103_cov_103.250000	4	47	0	43	43	1.0000000
NODE_310152_length_103_cov_80.250000	36	99	0	63	63	1.0000000
NODE_310153_length_103_cov_76.500000	4	63	0	59	59	1.0000000
NODE_310160_length_103_cov_42.000000	0	78	0	78	78	1.0000000
NODE_310160_length_103_cov_42.000000	7	78	0	71	71	1.0000000
NODE_310160_length_103_cov_42.000000	12	78	0	66	66	1.0000000
NODE_310160_length_103_cov_42.000000	51	99	0	48	48	1.0000000
NODE_310160_length_103_cov_42.000000	51	99	0	48	48	1.0000000
NODE_310160_length_103_cov_42.000000	51	99	0	48	48	1.0000000
NODE_310211_length_102_cov_2033.666667	0	48	0	48	48	1.0000000
NODE_310211_length_102_cov_2033.666667	21	101	0	80	80	1.0000000
NODE_310227_length_102_cov_1028.333333	52	102	0	50	50	1.0000000
NODE_310230_length_102_cov_987.666667	15	98	0	83	83	1.0000000
NODE_310231_length_102_cov_934.000000	12	95	0	83	83	1.0000000
NODE_310246_length_102_cov_685.666667	0	73	0	73	73	1.0000000
NODE_310247_length_102_cov_646.666667	15	89	0	74	74	1.0000000
NODE_310269_length_102_cov_250.000000	12	72	0	60	60	1.0000000
NODE_310273_length_102_cov_216.333333	4	70	0	66	66	1.0000000
NODE_310273_length_102_cov_216.333333	4	70	0	66	66	1.0000000
NODE_310273_length_102_cov_216.333333	4	70	0	66	66	1.0000000
NODE_310273_length_102_cov_216.333333	43	92	0	49	49	1.0000000
NODE_310273_length_102_cov_216.333333	57	102	0	45	45	1.0000000
NODE_310287_length_102_cov_152.333333	0	63	0	63	63	1.0000000
NODE_310295_length_102_cov_124.333333	0	70	0	70	70	1.0000000
NODE_310302_length_102_cov_106.333333	0	78	0	78	78	1.0000000
NODE_310302_length_102_cov_106.333333	7	78	0	71	71	1.0000000
NODE_310302_length_102_cov_106.333333	12	78	0	66	66	1.0000000
NODE_310302_length_102_cov_106.333333	51	102	0	51	51	1.0000000
NODE_310302_length_102_cov_106.333333	51	102	0	51	51	1.0000000
NODE_310302_length_102_cov_106.333333	51	102	0	51	51	1.0000000
NODE_310316_length_102_cov_74.333333	31	99	0	68	68	1.0000000
NODE_310321_length_102_cov_71.000000	11	91	0	80	80	1.0000000
NODE_310336_length_102_cov_32.666667	0	65	0	65	65	1.0000000
NODE_310336_length_102_cov_32.666667	38	99	0	61	61	1.0000000
NODE_310405_length_101_cov_2217.000000	0	43	0	43	43	1.0000000
NODE_310405_length_101_cov_2217.000000	23	96	0	73	73	1.0000000
NODE_310464_length_101_cov_740.500000	2	66	0	64	64	1.0000000
NODE_310464_length_101_cov_740.500000	2	66	0	64	64	1.0000000
NODE_310464_length_101_cov_740.500000	2	66	0	64	64	1.0000000
NODE_310464_length_101_cov_740.500000	39	101	0	62	62	1.0000000
NODE_310464_length_101_cov_740.500000	55	101	0	46	46	1.0000000
NODE_310469_length_101_cov_701.000000	0	62	0	62	62	1.0000000
NODE_310469_length_101_cov_701.000000	35	99	0	64	64	1.0000000
NODE_310469_length_101_cov_701.000000	35	99	0	64	64	1.0000000
NODE_310469_length_101_cov_701.000000	35	99	0	64	64	1.0000000
NODE_310471_length_101_cov_679.000000	2	76	0	74	74	1.0000000
NODE_310500_length_101_cov_374.500000	2	50	0	48	48	1.0000000
NODE_310500_length_101_cov_374.500000	2	50	0	48	48	1.0000000
NODE_310500_length_101_cov_374.500000	2	50	0	48	48	1.0000000
NODE_310500_length_101_cov_374.500000	23	89	0	66	66	1.0000000
NODE_310500_length_101_cov_374.500000	23	94	0	71	71	1.0000000
NODE_310516_length_101_cov_294.000000	4	52	0	48	48	1.0000000
NODE_310516_length_101_cov_294.000000	4	52	0	48	48	1.0000000
NODE_310516_length_101_cov_294.000000	4	52	0	48	48	1.0000000
NODE_310516_length_101_cov_294.000000	25	91	0	66	66	1.0000000
NODE_310516_length_101_cov_294.000000	25	96	0	71	71	1.0000000
NODE_310529_length_101_cov_230.500000	2	76	0	74	74	1.0000000
NODE_310529_length_101_cov_230.500000	2	76	0	74	74	1.0000000
NODE_310529_length_101_cov_230.500000	2	76	0	74	74	1.0000000
NODE_310529_length_101_cov_230.500000	49	101	0	52	52	1.0000000
NODE_310529_length_101_cov_230.500000	55	101	0	46	46	1.0000000
NODE_310550_length_101_cov_157.000000	13	72	0	59	59	1.0000000
NODE_310550_length_101_cov_157.000000	46	72	0	26	26	1.0000000
NODE_310565_length_101_cov_134.500000	2	37	0	35	35	1.0000000
NODE_310685_length_100_cov_1883.000000	32	100	0	68	68	1.0000000
NODE_310685_length_100_cov_1883.000000	32	100	0	68	68	1.0000000
NODE_310685_length_100_cov_1883.000000	32	99	0	67	67	1.0000000
NODE_310685_length_100_cov_1883.000000	32	100	0	68	68	1.0000000
NODE_310704_length_100_cov_1310.000000	0	42	0	42	42	1.0000000
NODE_310704_length_100_cov_1310.000000	1	42	0	41	41	1.0000000
NODE_310704_length_100_cov_1310.000000	38	100	0	62	62	1.0000000
NODE_310704_length_100_cov_1310.000000	38	95	0	57	57	1.0000000
NODE_310704_length_100_cov_1310.000000	38	100	0	62	62	1.0000000
NODE_310704_length_100_cov_1310.000000	38	100	0	62	62	1.0000000
NODE_310708_length_100_cov_1239.000000	1	48	0	47	47	1.0000000
NODE_310740_length_100_cov_694.000000	0	62	0	62	62	1.0000000
NODE_310740_length_100_cov_694.000000	0	62	0	62	62	1.0000000
NODE_310740_length_100_cov_694.000000	35	100	0	65	65	1.0000000
NODE_310748_length_100_cov_602.000000	0	57	0	57	57	1.0000000
NODE_310750_length_100_cov_590.000000	0	58	0	58	58	1.0000000
NODE_310798_length_100_cov_274.000000	1	67	0	66	66	1.0000000
NODE_310798_length_100_cov_274.000000	1	67	0	66	66	1.0000000
NODE_310798_length_100_cov_274.000000	1	67	0	66	66	1.0000000
NODE_310798_length_100_cov_274.000000	40	100	0	60	60	1.0000000
NODE_310798_length_100_cov_274.000000	54	100	0	46	46	1.0000000
NODE_310808_length_100_cov_217.000000	4	75	0	71	71	1.0000000
NODE_310808_length_100_cov_217.000000	9	75	0	66	66	1.0000000
NODE_310808_length_100_cov_217.000000	48	99	0	51	51	1.0000000
NODE_310808_length_100_cov_217.000000	48	99	0	51	51	1.0000000
NODE_310808_length_100_cov_217.000000	48	99	0	51	51	1.0000000
NODE_310810_length_100_cov_209.000000	1	44	0	43	43	1.0000000
NODE_310810_length_100_cov_209.000000	40	100	0	60	60	1.0000000
NODE_310810_length_100_cov_209.000000	40	100	0	60	60	1.0000000
NODE_310819_length_100_cov_185.000000	0	46	0	46	46	1.0000000
NODE_310819_length_100_cov_185.000000	9	58	0	49	49	1.0000000
NODE_310819_length_100_cov_185.000000	31	99	0	68	68	1.0000000
NODE_310819_length_100_cov_185.000000	31	99	0	68	68	1.0000000
NODE_310819_length_100_cov_185.000000	31	99	0	68	68	1.0000000
NODE_310828_length_100_cov_164.000000	9	92	0	83	83	1.0000000
NODE_310837_length_100_cov_152.000000	11	91	0	80	80	1.0000000
NODE_310837_length_100_cov_152.000000	11	91	0	80	80	1.0000000
NODE_310837_length_100_cov_152.000000	11	91	0	80	80	1.0000000
NODE_310837_length_100_cov_152.000000	11	91	0	80	80	1.0000000
NODE_310837_length_100_cov_152.000000	11	91	0	80	80	1.0000000
NODE_310839_length_100_cov_150.000000	0	54	0	54	54	1.0000000
NODE_310839_length_100_cov_150.000000	0	54	0	54	54	1.0000000
NODE_310839_length_100_cov_150.000000	27	100	0	73	73	1.0000000
NODE_310839_length_100_cov_150.000000	27	100	0	73	73	1.0000000
NODE_310840_length_100_cov_148.000000	2	82	0	80	80	1.0000000
NODE_310841_length_100_cov_148.000000	0	71	0	71	71	1.0000000
NODE_310841_length_100_cov_148.000000	0	71	0	71	71	1.0000000
NODE_310841_length_100_cov_148.000000	0	62	0	62	62	1.0000000
NODE_310876_length_100_cov_71.000000	0	75	0	75	75	1.0000000
NODE_310876_length_100_cov_71.000000	4	75	0	71	71	1.0000000
NODE_310876_length_100_cov_71.000000	9	75	0	66	66	1.0000000
NODE_310876_length_100_cov_71.000000	48	100	0	52	52	1.0000000
NODE_310876_length_100_cov_71.000000	48	100	0	52	52	1.0000000
NODE_310876_length_100_cov_71.000000	48	100	0	52	52	1.0000000
NODE_310896_length_100_cov_41.000000	0	75	0	75	75	1.0000000
NODE_310896_length_100_cov_41.000000	4	75	0	71	71	1.0000000
NODE_310896_length_100_cov_41.000000	9	75	0	66	66	1.0000000
NODE_310896_length_100_cov_41.000000	48	99	0	51	51	1.0000000
NODE_310896_length_100_cov_41.000000	48	99	0	51	51	1.0000000
NODE_310896_length_100_cov_41.000000	48	99	0	51	51	1.0000000
NODE_310904_length_100_cov_30.000000	1	42	0	41	41	1.0000000
