NODE_1_length_25698_cov_36.651041	315	395	0	78	80	0.9750000
NODE_1_length_25698_cov_36.651041	315	395	2	2	80	0.0250000
NODE_1_length_25698_cov_36.651041	368	403	0	25	35	0.7142857
NODE_1_length_25698_cov_36.651041	368	403	2	8	35	0.2285714
NODE_1_length_25698_cov_36.651041	368	403	4	1	35	0.0285714
NODE_1_length_25698_cov_36.651041	368	403	9	1	35	0.0285714
NODE_1_length_25698_cov_36.651041	24448	24494	0	46	46	1.0000000
NODE_2_length_24307_cov_15.119712	2613	2689	0	76	76	1.0000000
NODE_2_length_24307_cov_15.119712	2662	2716	0	54	54	1.0000000
NODE_2_length_24307_cov_15.119712	11257	11320	0	63	63	1.0000000
NODE_2_length_24307_cov_15.119712	20621	20701	8	43	80	0.5375000
NODE_2_length_24307_cov_15.119712	20621	20701	10	37	80	0.4625000
NODE_2_length_24307_cov_15.119712	20674	20754	1	10	80	0.1250000
NODE_2_length_24307_cov_15.119712	20674	20754	2	5	80	0.0625000
NODE_2_length_24307_cov_15.119712	20674	20754	3	3	80	0.0375000
NODE_2_length_24307_cov_15.119712	20674	20754	4	30	80	0.3750000
NODE_2_length_24307_cov_15.119712	20674	20754	10	32	80	0.4000000
NODE_7_length_12349_cov_28.144571	12251	12310	13	2	59	0.0338983
NODE_7_length_12349_cov_28.144571	12251	12310	14	3	59	0.0508475
NODE_7_length_12349_cov_28.144571	12251	12310	16	5	59	0.0847458
NODE_7_length_12349_cov_28.144571	12251	12310	18	2	59	0.0338983
NODE_7_length_12349_cov_28.144571	12251	12310	20	6	59	0.1016949
NODE_7_length_12349_cov_28.144571	12251	12310	22	1	59	0.0169492
NODE_7_length_12349_cov_28.144571	12251	12310	24	5	59	0.0847458
NODE_7_length_12349_cov_28.144571	12251	12310	26	4	59	0.0677966
NODE_7_length_12349_cov_28.144571	12251	12310	28	9	59	0.1525424
NODE_7_length_12349_cov_28.144571	12251	12310	32	4	59	0.0677966
NODE_7_length_12349_cov_28.144571	12251	12310	34	8	59	0.1355932
NODE_7_length_12349_cov_28.144571	12251	12310	36	2	59	0.0338983
NODE_7_length_12349_cov_28.144571	12251	12310	37	3	59	0.0508475
NODE_7_length_12349_cov_28.144571	12251	12310	39	5	59	0.0847458
NODE_7_length_12349_cov_28.144571	12284	12310	13	2	26	0.0769231
NODE_7_length_12349_cov_28.144571	12284	12310	14	3	26	0.1153846
NODE_7_length_12349_cov_28.144571	12284	12310	16	5	26	0.1923077
NODE_7_length_12349_cov_28.144571	12284	12310	18	2	26	0.0769231
NODE_7_length_12349_cov_28.144571	12284	12310	20	6	26	0.2307692
NODE_7_length_12349_cov_28.144571	12284	12310	22	1	26	0.0384615
NODE_7_length_12349_cov_28.144571	12284	12310	24	5	26	0.1923077
NODE_7_length_12349_cov_28.144571	12284	12310	26	2	26	0.0769231
NODE_10_length_11096_cov_14.154679	6455	6535	0	80	80	1.0000000
NODE_10_length_11096_cov_14.154679	6508	6588	0	80	80	1.0000000
NODE_10_length_11096_cov_14.154679	6584	6664	0	51	80	0.6375000
NODE_10_length_11096_cov_14.154679	6584	6664	2	29	80	0.3625000
NODE_10_length_11096_cov_14.154679	6637	6717	0	14	80	0.1750000
NODE_10_length_11096_cov_14.154679	6637	6717	2	66	80	0.8250000
NODE_10_length_11096_cov_14.154679	7182	7229	297	1	47	0.0212766
NODE_10_length_11096_cov_14.154679	7182	7229	315	1	47	0.0212766
NODE_10_length_11096_cov_14.154679	7182	7229	318	1	47	0.0212766
NODE_10_length_11096_cov_14.154679	7182	7229	321	1	47	0.0212766
NODE_10_length_11096_cov_14.154679	7182	7229	329	3	47	0.0638298
NODE_10_length_11096_cov_14.154679	7182	7229	335	2	47	0.0425532
NODE_10_length_11096_cov_14.154679	7182	7229	336	1	47	0.0212766
NODE_10_length_11096_cov_14.154679	7182	7229	344	1	47	0.0212766
NODE_10_length_11096_cov_14.154679	7182	7229	351	1	47	0.0212766
NODE_10_length_11096_cov_14.154679	7182	7229	359	1	47	0.0212766
NODE_10_length_11096_cov_14.154679	7182	7229	365	2	47	0.0425532
NODE_10_length_11096_cov_14.154679	7182	7229	366	1	47	0.0212766
NODE_10_length_11096_cov_14.154679	7182	7229	368	1	47	0.0212766
NODE_10_length_11096_cov_14.154679	7182	7229	369	1	47	0.0212766
NODE_10_length_11096_cov_14.154679	7182	7229	380	1	47	0.0212766
NODE_10_length_11096_cov_14.154679	7182	7229	385	2	47	0.0425532
NODE_10_length_11096_cov_14.154679	7182	7229	388	1	47	0.0212766
NODE_10_length_11096_cov_14.154679	7182	7229	391	1	47	0.0212766
NODE_10_length_11096_cov_14.154679	7182	7229	409	2	47	0.0425532
NODE_10_length_11096_cov_14.154679	7182	7229	410	1	47	0.0212766
NODE_10_length_11096_cov_14.154679	7182	7229	411	1	47	0.0212766
NODE_10_length_11096_cov_14.154679	7182	7229	415	1	47	0.0212766
NODE_10_length_11096_cov_14.154679	7182	7229	420	3	47	0.0638298
NODE_10_length_11096_cov_14.154679	7182	7229	424	2	47	0.0425532
NODE_10_length_11096_cov_14.154679	7182	7229	431	1	47	0.0212766
NODE_10_length_11096_cov_14.154679	7182	7229	440	1	47	0.0212766
NODE_10_length_11096_cov_14.154679	7182	7229	441	1	47	0.0212766
NODE_10_length_11096_cov_14.154679	7182	7229	442	2	47	0.0425532
NODE_10_length_11096_cov_14.154679	7182	7229	446	1	47	0.0212766
NODE_10_length_11096_cov_14.154679	7182	7229	448	1	47	0.0212766
NODE_10_length_11096_cov_14.154679	7182	7229	451	2	47	0.0425532
NODE_10_length_11096_cov_14.154679	7182	7229	452	1	47	0.0212766
NODE_10_length_11096_cov_14.154679	7182	7229	454	2	47	0.0425532
NODE_10_length_11096_cov_14.154679	7182	7229	459	1	47	0.0212766
NODE_10_length_11096_cov_14.154679	7182	7229	461	1	47	0.0212766
NODE_10_length_11096_cov_14.154679	7218	7282	186	1	64	0.0156250
NODE_10_length_11096_cov_14.154679	7218	7282	187	2	64	0.0312500
NODE_10_length_11096_cov_14.154679	7218	7282	188	2	64	0.0312500
NODE_10_length_11096_cov_14.154679	7218	7282	189	3	64	0.0468750
NODE_10_length_11096_cov_14.154679	7218	7282	191	2	64	0.0312500
NODE_10_length_11096_cov_14.154679	7218	7282	192	1	64	0.0156250
NODE_10_length_11096_cov_14.154679	7218	7282	193	1	64	0.0156250
NODE_10_length_11096_cov_14.154679	7218	7282	194	2	64	0.0312500
NODE_10_length_11096_cov_14.154679	7218	7282	195	1	64	0.0156250
NODE_10_length_11096_cov_14.154679	7218	7282	196	3	64	0.0468750
NODE_10_length_11096_cov_14.154679	7218	7282	200	1	64	0.0156250
NODE_10_length_11096_cov_14.154679	7218	7282	204	1	64	0.0156250
NODE_10_length_11096_cov_14.154679	7218	7282	205	1	64	0.0156250
NODE_10_length_11096_cov_14.154679	7218	7282	212	1	64	0.0156250
NODE_10_length_11096_cov_14.154679	7218	7282	213	1	64	0.0156250
NODE_10_length_11096_cov_14.154679	7218	7282	214	2	64	0.0312500
NODE_10_length_11096_cov_14.154679	7218	7282	224	2	64	0.0312500
NODE_10_length_11096_cov_14.154679	7218	7282	226	1	64	0.0156250
NODE_10_length_11096_cov_14.154679	7218	7282	227	1	64	0.0156250
NODE_10_length_11096_cov_14.154679	7218	7282	229	1	64	0.0156250
NODE_10_length_11096_cov_14.154679	7218	7282	232	1	64	0.0156250
NODE_10_length_11096_cov_14.154679	7218	7282	242	1	64	0.0156250
NODE_10_length_11096_cov_14.154679	7218	7282	252	1	64	0.0156250
NODE_10_length_11096_cov_14.154679	7218	7282	254	1	64	0.0156250
NODE_10_length_11096_cov_14.154679	7218	7282	255	2	64	0.0312500
NODE_10_length_11096_cov_14.154679	7218	7282	256	3	64	0.0468750
NODE_10_length_11096_cov_14.154679	7218	7282	257	4	64	0.0625000
NODE_10_length_11096_cov_14.154679	7218	7282	259	3	64	0.0468750
NODE_10_length_11096_cov_14.154679	7218	7282	260	1	64	0.0156250
NODE_10_length_11096_cov_14.154679	7218	7282	261	2	64	0.0312500
NODE_10_length_11096_cov_14.154679	7218	7282	262	1	64	0.0156250
NODE_10_length_11096_cov_14.154679	7218	7282	266	1	64	0.0156250
NODE_10_length_11096_cov_14.154679	7218	7282	270	1	64	0.0156250
NODE_10_length_11096_cov_14.154679	7218	7282	288	1	64	0.0156250
NODE_10_length_11096_cov_14.154679	7218	7282	297	1	64	0.0156250
NODE_10_length_11096_cov_14.154679	7218	7282	315	1	64	0.0156250
NODE_10_length_11096_cov_14.154679	7218	7282	318	1	64	0.0156250
NODE_10_length_11096_cov_14.154679	7218	7282	321	1	64	0.0156250
NODE_10_length_11096_cov_14.154679	7218	7282	329	3	64	0.0468750
NODE_10_length_11096_cov_14.154679	7218	7282	335	2	64	0.0312500
NODE_10_length_11096_cov_14.154679	7218	7282	336	1	64	0.0156250
NODE_10_length_11096_cov_14.154679	7218	7282	344	1	64	0.0156250
NODE_13_length_10749_cov_34.330235	3589	3669	3	4	80	0.0500000
NODE_13_length_10749_cov_34.330235	3589	3669	4	47	80	0.5875000
NODE_13_length_10749_cov_34.330235	3589	3669	6	1	80	0.0125000
NODE_13_length_10749_cov_34.330235	3589	3669	7	28	80	0.3500000
NODE_13_length_10749_cov_34.330235	3642	3722	3	32	80	0.4000000
NODE_13_length_10749_cov_34.330235	3642	3722	6	25	80	0.3125000
NODE_13_length_10749_cov_34.330235	3642	3722	7	23	80	0.2875000
NODE_13_length_10749_cov_34.330235	3718	3798	3	12	80	0.1500000
NODE_13_length_10749_cov_34.330235	3718	3798	6	68	80	0.8500000
NODE_13_length_10749_cov_34.330235	3771	3851	3	60	80	0.7500000
NODE_13_length_10749_cov_34.330235	3771	3851	4	4	80	0.0500000
NODE_13_length_10749_cov_34.330235	3771	3851	6	16	80	0.2000000
NODE_14_length_10557_cov_50.055938	423	503	0	63	80	0.7875000
NODE_14_length_10557_cov_50.055938	423	503	2	17	80	0.2125000
NODE_14_length_10557_cov_50.055938	476	556	0	19	80	0.2375000
NODE_14_length_10557_cov_50.055938	476	556	2	61	80	0.7625000
NODE_14_length_10557_cov_50.055938	1625	1696	14	1	71	0.0140845
NODE_14_length_10557_cov_50.055938	1625	1696	15	1	71	0.0140845
NODE_14_length_10557_cov_50.055938	1625	1696	16	11	71	0.1549296
NODE_14_length_10557_cov_50.055938	1625	1696	18	3	71	0.0422535
NODE_14_length_10557_cov_50.055938	1625	1696	20	21	71	0.2957746
NODE_14_length_10557_cov_50.055938	1625	1696	22	23	71	0.3239437
NODE_14_length_10557_cov_50.055938	1625	1696	24	11	71	0.1549296
NODE_14_length_10557_cov_50.055938	1678	1733	8	3	55	0.0545455
NODE_14_length_10557_cov_50.055938	1678	1733	10	20	55	0.3636364
NODE_14_length_10557_cov_50.055938	1678	1733	12	10	55	0.1818182
NODE_14_length_10557_cov_50.055938	1678	1733	14	4	55	0.0727273
NODE_14_length_10557_cov_50.055938	1678	1733	15	1	55	0.0181818
NODE_14_length_10557_cov_50.055938	1678	1733	20	6	55	0.1090909
NODE_14_length_10557_cov_50.055938	1678	1733	22	4	55	0.0727273
NODE_14_length_10557_cov_50.055938	1678	1733	24	7	55	0.1272727
NODE_14_length_10557_cov_50.055938	2428	2488	37	4	60	0.0666667
NODE_14_length_10557_cov_50.055938	2428	2488	38	6	60	0.1000000
NODE_14_length_10557_cov_50.055938	2428	2488	39	5	60	0.0833333
NODE_14_length_10557_cov_50.055938	2428	2488	43	5	60	0.0833333
NODE_14_length_10557_cov_50.055938	2428	2488	45	11	60	0.1833333
NODE_14_length_10557_cov_50.055938	2428	2488	46	4	60	0.0666667
NODE_14_length_10557_cov_50.055938	2428	2488	47	12	60	0.2000000
NODE_14_length_10557_cov_50.055938	2428	2488	48	3	60	0.0500000
NODE_14_length_10557_cov_50.055938	2428	2488	49	4	60	0.0666667
NODE_14_length_10557_cov_50.055938	2428	2488	50	1	60	0.0166667
NODE_14_length_10557_cov_50.055938	2428	2488	51	2	60	0.0333333
NODE_14_length_10557_cov_50.055938	2428	2488	52	3	60	0.0500000
NODE_17_length_10101_cov_12.236253	923	966	6	43	43	1.0000000
NODE_17_length_10101_cov_12.236253	943	1007	0	37	64	0.5781250
NODE_17_length_10101_cov_12.236253	943	1007	6	27	64	0.4218750
NODE_17_length_10101_cov_12.236253	1715	1795	0	80	80	1.0000000
NODE_17_length_10101_cov_12.236253	1768	1820	0	50	52	0.9615384
NODE_17_length_10101_cov_12.236253	1768	1820	2	1	52	0.0192308
NODE_17_length_10101_cov_12.236253	1768	1820	7	1	52	0.0192308
NODE_20_length_9442_cov_109.961147	2108	2188	4	23	80	0.2875000
NODE_20_length_9442_cov_109.961147	2108	2188	6	11	80	0.1375000
NODE_20_length_9442_cov_109.961147	2108	2188	8	23	80	0.2875000
NODE_20_length_9442_cov_109.961147	2108	2188	10	19	80	0.2375000
NODE_20_length_9442_cov_109.961147	2108	2188	12	4	80	0.0500000
NODE_20_length_9442_cov_109.961147	2161	2241	8	23	80	0.2875000
NODE_20_length_9442_cov_109.961147	2161	2241	10	54	80	0.6750000
NODE_20_length_9442_cov_109.961147	2161	2241	12	3	80	0.0375000
NODE_21_length_9414_cov_34.165217	2363	2443	20	1	80	0.0125000
NODE_21_length_9414_cov_34.165217	2363	2443	26	1	80	0.0125000
NODE_21_length_9414_cov_34.165217	2363	2443	28	45	80	0.5625000
NODE_21_length_9414_cov_34.165217	2363	2443	30	6	80	0.0750000
NODE_21_length_9414_cov_34.165217	2363	2443	32	27	80	0.3375000
NODE_21_length_9414_cov_34.165217	2416	2484	5	1	68	0.0147059
NODE_21_length_9414_cov_34.165217	2416	2484	6	1	68	0.0147059
NODE_21_length_9414_cov_34.165217	2416	2484	8	18	68	0.2647059
NODE_21_length_9414_cov_34.165217	2416	2484	11	18	68	0.2647059
NODE_21_length_9414_cov_34.165217	2416	2484	13	2	68	0.0294118
NODE_21_length_9414_cov_34.165217	2416	2484	15	1	68	0.0147059
NODE_21_length_9414_cov_34.165217	2416	2484	20	1	68	0.0147059
NODE_21_length_9414_cov_34.165217	2416	2484	26	1	68	0.0147059
NODE_21_length_9414_cov_34.165217	2416	2484	28	25	68	0.3676471
NODE_21_length_9414_cov_34.165217	5899	5975	117	2	76	0.0263158
NODE_21_length_9414_cov_34.165217	5899	5975	118	2	76	0.0263158
NODE_21_length_9414_cov_34.165217	5899	5975	120	5	76	0.0657895
NODE_21_length_9414_cov_34.165217	5899	5975	121	4	76	0.0526316
NODE_21_length_9414_cov_34.165217	5899	5975	122	2	76	0.0263158
NODE_21_length_9414_cov_34.165217	5899	5975	123	3	76	0.0394737
NODE_21_length_9414_cov_34.165217	5899	5975	124	2	76	0.0263158
NODE_21_length_9414_cov_34.165217	5899	5975	126	1	76	0.0131579
NODE_21_length_9414_cov_34.165217	5899	5975	127	4	76	0.0526316
NODE_21_length_9414_cov_34.165217	5899	5975	128	6	76	0.0789474
NODE_21_length_9414_cov_34.165217	5899	5975	129	5	76	0.0657895
NODE_21_length_9414_cov_34.165217	5899	5975	130	6	76	0.0789474
NODE_21_length_9414_cov_34.165217	5899	5975	131	5	76	0.0657895
NODE_21_length_9414_cov_34.165217	5899	5975	132	8	76	0.1052632
NODE_21_length_9414_cov_34.165217	5899	5975	133	5	76	0.0657895
NODE_21_length_9414_cov_34.165217	5899	5975	134	4	76	0.0526316
NODE_21_length_9414_cov_34.165217	5899	5975	135	5	76	0.0657895
NODE_21_length_9414_cov_34.165217	5899	5975	136	4	76	0.0526316
NODE_21_length_9414_cov_34.165217	5899	5975	137	1	76	0.0131579
NODE_21_length_9414_cov_34.165217	5899	5975	139	2	76	0.0263158
NODE_24_length_9168_cov_47.407542	470	550	24	1	80	0.0125000
NODE_24_length_9168_cov_47.407542	470	550	26	4	80	0.0500000
NODE_24_length_9168_cov_47.407542	470	550	30	2	80	0.0250000
NODE_24_length_9168_cov_47.407542	470	550	33	1	80	0.0125000
NODE_24_length_9168_cov_47.407542	470	550	34	1	80	0.0125000
NODE_24_length_9168_cov_47.407542	470	550	39	1	80	0.0125000
NODE_24_length_9168_cov_47.407542	470	550	40	1	80	0.0125000
NODE_24_length_9168_cov_47.407542	470	550	42	7	80	0.0875000
NODE_24_length_9168_cov_47.407542	470	550	44	10	80	0.1250000
NODE_24_length_9168_cov_47.407542	470	550	50	1	80	0.0125000
NODE_24_length_9168_cov_47.407542	470	550	52	6	80	0.0750000
NODE_24_length_9168_cov_47.407542	470	550	53	2	80	0.0250000
NODE_24_length_9168_cov_47.407542	470	550	54	4	80	0.0500000
NODE_24_length_9168_cov_47.407542	470	550	56	3	80	0.0375000
NODE_24_length_9168_cov_47.407542	470	550	57	5	80	0.0625000
NODE_24_length_9168_cov_47.407542	470	550	63	1	80	0.0125000
NODE_24_length_9168_cov_47.407542	470	550	64	10	80	0.1250000
NODE_24_length_9168_cov_47.407542	470	550	65	12	80	0.1500000
NODE_24_length_9168_cov_47.407542	470	550	67	6	80	0.0750000
NODE_24_length_9168_cov_47.407542	470	550	70	2	80	0.0250000
NODE_24_length_9168_cov_47.407542	523	603	44	3	80	0.0375000
NODE_24_length_9168_cov_47.407542	523	603	46	9	80	0.1125000
NODE_24_length_9168_cov_47.407542	523	603	48	4	80	0.0500000
NODE_24_length_9168_cov_47.407542	523	603	52	8	80	0.1000000
NODE_24_length_9168_cov_47.407542	523	603	53	18	80	0.2250000
NODE_24_length_9168_cov_47.407542	523	603	55	3	80	0.0375000
NODE_24_length_9168_cov_47.407542	523	603	58	2	80	0.0250000
NODE_24_length_9168_cov_47.407542	523	603	60	2	80	0.0250000
NODE_24_length_9168_cov_47.407542	523	603	64	14	80	0.1750000
NODE_24_length_9168_cov_47.407542	523	603	65	9	80	0.1125000
NODE_24_length_9168_cov_47.407542	523	603	67	6	80	0.0750000
NODE_24_length_9168_cov_47.407542	523	603	70	2	80	0.0250000
NODE_27_length_9108_cov_47.430347	4786	4866	177	1	80	0.0125000
NODE_27_length_9108_cov_47.430347	4786	4866	184	1	80	0.0125000
NODE_27_length_9108_cov_47.430347	4786	4866	186	2	80	0.0250000
NODE_27_length_9108_cov_47.430347	4786	4866	187	3	80	0.0375000
NODE_27_length_9108_cov_47.430347	4786	4866	189	4	80	0.0500000
NODE_27_length_9108_cov_47.430347	4786	4866	190	1	80	0.0125000
NODE_27_length_9108_cov_47.430347	4786	4866	191	1	80	0.0125000
NODE_27_length_9108_cov_47.430347	4786	4866	192	2	80	0.0250000
NODE_27_length_9108_cov_47.430347	4786	4866	193	1	80	0.0125000
NODE_27_length_9108_cov_47.430347	4786	4866	194	1	80	0.0125000
NODE_27_length_9108_cov_47.430347	4786	4866	195	2	80	0.0250000
NODE_27_length_9108_cov_47.430347	4786	4866	196	1	80	0.0125000
NODE_27_length_9108_cov_47.430347	4786	4866	197	5	80	0.0625000
NODE_27_length_9108_cov_47.430347	4786	4866	198	1	80	0.0125000
NODE_27_length_9108_cov_47.430347	4786	4866	199	1	80	0.0125000
NODE_27_length_9108_cov_47.430347	4786	4866	200	1	80	0.0125000
NODE_27_length_9108_cov_47.430347	4786	4866	201	1	80	0.0125000
NODE_27_length_9108_cov_47.430347	4786	4866	202	1	80	0.0125000
NODE_27_length_9108_cov_47.430347	4786	4866	203	1	80	0.0125000
NODE_27_length_9108_cov_47.430347	4786	4866	204	1	80	0.0125000
NODE_27_length_9108_cov_47.430347	4786	4866	208	1	80	0.0125000
NODE_27_length_9108_cov_47.430347	4786	4866	209	1	80	0.0125000
NODE_27_length_9108_cov_47.430347	4786	4866	210	4	80	0.0500000
NODE_27_length_9108_cov_47.430347	4786	4866	211	3	80	0.0375000
NODE_27_length_9108_cov_47.430347	4786	4866	212	6	80	0.0750000
NODE_27_length_9108_cov_47.430347	4786	4866	213	3	80	0.0375000
NODE_27_length_9108_cov_47.430347	4786	4866	214	1	80	0.0125000
NODE_27_length_9108_cov_47.430347	4786	4866	215	1	80	0.0125000
NODE_27_length_9108_cov_47.430347	4786	4866	221	1	80	0.0125000
NODE_27_length_9108_cov_47.430347	4786	4866	222	3	80	0.0375000
NODE_27_length_9108_cov_47.430347	4786	4866	223	1	80	0.0125000
NODE_27_length_9108_cov_47.430347	4786	4866	224	1	80	0.0125000
NODE_27_length_9108_cov_47.430347	4786	4866	225	1	80	0.0125000
NODE_27_length_9108_cov_47.430347	4786	4866	226	1	80	0.0125000
NODE_27_length_9108_cov_47.430347	4786	4866	227	1	80	0.0125000
NODE_27_length_9108_cov_47.430347	4786	4866	228	2	80	0.0250000
NODE_27_length_9108_cov_47.430347	4786	4866	229	1	80	0.0125000
NODE_27_length_9108_cov_47.430347	4786	4866	230	4	80	0.0500000
NODE_27_length_9108_cov_47.430347	4786	4866	231	1	80	0.0125000
NODE_27_length_9108_cov_47.430347	4786	4866	232	1	80	0.0125000
NODE_27_length_9108_cov_47.430347	4786	4866	233	3	80	0.0375000
NODE_27_length_9108_cov_47.430347	4786	4866	234	2	80	0.0250000
NODE_27_length_9108_cov_47.430347	4786	4866	235	4	80	0.0500000
NODE_27_length_9108_cov_47.430347	4786	4866	237	1	80	0.0125000
NODE_27_length_9108_cov_47.430347	4839	4902	222	3	63	0.0476190
NODE_27_length_9108_cov_47.430347	4839	4902	223	1	63	0.0158730
NODE_27_length_9108_cov_47.430347	4839	4902	224	1	63	0.0158730
NODE_27_length_9108_cov_47.430347	4839	4902	225	1	63	0.0158730
NODE_27_length_9108_cov_47.430347	4839	4902	226	1	63	0.0158730
NODE_27_length_9108_cov_47.430347	4839	4902	227	1	63	0.0158730
NODE_27_length_9108_cov_47.430347	4839	4902	228	2	63	0.0317460
NODE_27_length_9108_cov_47.430347	4839	4902	229	3	63	0.0476190
NODE_27_length_9108_cov_47.430347	4839	4902	230	4	63	0.0634921
NODE_27_length_9108_cov_47.430347	4839	4902	231	7	63	0.1111111
NODE_27_length_9108_cov_47.430347	4839	4902	232	1	63	0.0158730
NODE_27_length_9108_cov_47.430347	4839	4902	233	4	63	0.0634921
NODE_27_length_9108_cov_47.430347	4839	4902	234	2	63	0.0317460
NODE_27_length_9108_cov_47.430347	4839	4902	235	5	63	0.0793651
NODE_27_length_9108_cov_47.430347	4839	4902	237	2	63	0.0317460
NODE_27_length_9108_cov_47.430347	4839	4902	238	1	63	0.0158730
NODE_27_length_9108_cov_47.430347	4839	4902	239	4	63	0.0634921
NODE_27_length_9108_cov_47.430347	4839	4902	240	1	63	0.0158730
NODE_27_length_9108_cov_47.430347	4839	4902	241	4	63	0.0634921
NODE_27_length_9108_cov_47.430347	4839	4902	242	1	63	0.0158730
NODE_27_length_9108_cov_47.430347	4839	4902	243	3	63	0.0476190
NODE_27_length_9108_cov_47.430347	4839	4902	244	2	63	0.0317460
NODE_27_length_9108_cov_47.430347	4839	4902	245	4	63	0.0634921
NODE_27_length_9108_cov_47.430347	4839	4902	246	4	63	0.0634921
NODE_27_length_9108_cov_47.430347	4839	4902	247	1	63	0.0158730
NODE_27_length_9108_cov_47.430347	4895	4963	153	1	68	0.0147059
NODE_27_length_9108_cov_47.430347	4895	4963	156	1	68	0.0147059
NODE_27_length_9108_cov_47.430347	4895	4963	157	2	68	0.0294118
NODE_27_length_9108_cov_47.430347	4895	4963	160	1	68	0.0147059
NODE_27_length_9108_cov_47.430347	4895	4963	163	2	68	0.0294118
NODE_27_length_9108_cov_47.430347	4895	4963	164	1	68	0.0147059
NODE_27_length_9108_cov_47.430347	4895	4963	171	1	68	0.0147059
NODE_27_length_9108_cov_47.430347	4895	4963	172	2	68	0.0294118
NODE_27_length_9108_cov_47.430347	4895	4963	176	1	68	0.0147059
NODE_27_length_9108_cov_47.430347	4895	4963	177	1	68	0.0147059
NODE_27_length_9108_cov_47.430347	4895	4963	180	1	68	0.0147059
NODE_27_length_9108_cov_47.430347	4895	4963	183	3	68	0.0441176
NODE_27_length_9108_cov_47.430347	4895	4963	186	1	68	0.0147059
NODE_27_length_9108_cov_47.430347	4895	4963	188	1	68	0.0147059
NODE_27_length_9108_cov_47.430347	4895	4963	189	5	68	0.0735294
NODE_27_length_9108_cov_47.430347	4895	4963	193	2	68	0.0294118
NODE_27_length_9108_cov_47.430347	4895	4963	196	1	68	0.0147059
NODE_27_length_9108_cov_47.430347	4895	4963	204	6	68	0.0882353
NODE_27_length_9108_cov_47.430347	4895	4963	206	4	68	0.0588235
NODE_27_length_9108_cov_47.430347	4895	4963	208	1	68	0.0147059
NODE_27_length_9108_cov_47.430347	4895	4963	212	1	68	0.0147059
NODE_27_length_9108_cov_47.430347	4895	4963	216	1	68	0.0147059
NODE_27_length_9108_cov_47.430347	4895	4963	218	1	68	0.0147059
NODE_27_length_9108_cov_47.430347	4895	4963	226	1	68	0.0147059
NODE_27_length_9108_cov_47.430347	4895	4963	228	1	68	0.0147059
NODE_27_length_9108_cov_47.430347	4895	4963	229	1	68	0.0147059
NODE_27_length_9108_cov_47.430347	4895	4963	230	4	68	0.0588235
NODE_27_length_9108_cov_47.430347	4895	4963	231	2	68	0.0294118
NODE_27_length_9108_cov_47.430347	4895	4963	232	3	68	0.0441176
NODE_27_length_9108_cov_47.430347	4895	4963	233	3	68	0.0441176
NODE_27_length_9108_cov_47.430347	4895	4963	235	1	68	0.0147059
NODE_27_length_9108_cov_47.430347	4895	4963	236	1	68	0.0147059
NODE_27_length_9108_cov_47.430347	4895	4963	237	2	68	0.0294118
NODE_27_length_9108_cov_47.430347	4895	4963	238	1	68	0.0147059
NODE_27_length_9108_cov_47.430347	4895	4963	239	4	68	0.0588235
NODE_27_length_9108_cov_47.430347	4895	4963	240	1	68	0.0147059
NODE_27_length_9108_cov_47.430347	4895	4963	241	2	68	0.0294118
NODE_27_length_9108_cov_47.430347	4936	5016	38	1	80	0.0125000
NODE_27_length_9108_cov_47.430347	4936	5016	44	1	80	0.0125000
NODE_27_length_9108_cov_47.430347	4936	5016	47	1	80	0.0125000
NODE_27_length_9108_cov_47.430347	4936	5016	48	3	80	0.0375000
NODE_27_length_9108_cov_47.430347	4936	5016	53	1	80	0.0125000
NODE_27_length_9108_cov_47.430347	4936	5016	61	4	80	0.0500000
NODE_27_length_9108_cov_47.430347	4936	5016	69	1	80	0.0125000
NODE_27_length_9108_cov_47.430347	4936	5016	76	1	80	0.0125000
NODE_27_length_9108_cov_47.430347	4936	5016	79	3	80	0.0375000
NODE_27_length_9108_cov_47.430347	4936	5016	85	1	80	0.0125000
NODE_27_length_9108_cov_47.430347	4936	5016	87	1	80	0.0125000
NODE_27_length_9108_cov_47.430347	4936	5016	97	3	80	0.0375000
NODE_27_length_9108_cov_47.430347	4936	5016	101	2	80	0.0250000
NODE_27_length_9108_cov_47.430347	4936	5016	107	2	80	0.0250000
NODE_27_length_9108_cov_47.430347	4936	5016	109	1	80	0.0125000
NODE_27_length_9108_cov_47.430347	4936	5016	115	1	80	0.0125000
NODE_27_length_9108_cov_47.430347	4936	5016	117	1	80	0.0125000
NODE_27_length_9108_cov_47.430347	4936	5016	125	1	80	0.0125000
NODE_27_length_9108_cov_47.430347	4936	5016	126	2	80	0.0250000
NODE_27_length_9108_cov_47.430347	4936	5016	129	1	80	0.0125000
NODE_27_length_9108_cov_47.430347	4936	5016	130	4	80	0.0500000
NODE_27_length_9108_cov_47.430347	4936	5016	136	1	80	0.0125000
NODE_27_length_9108_cov_47.430347	4936	5016	138	1	80	0.0125000
NODE_27_length_9108_cov_47.430347	4936	5016	139	1	80	0.0125000
NODE_27_length_9108_cov_47.430347	4936	5016	142	5	80	0.0625000
NODE_27_length_9108_cov_47.430347	4936	5016	144	2	80	0.0250000
NODE_27_length_9108_cov_47.430347	4936	5016	147	1	80	0.0125000
NODE_27_length_9108_cov_47.430347	4936	5016	149	4	80	0.0500000
NODE_27_length_9108_cov_47.430347	4936	5016	151	1	80	0.0125000
NODE_27_length_9108_cov_47.430347	4936	5016	153	2	80	0.0250000
NODE_27_length_9108_cov_47.430347	4936	5016	156	1	80	0.0125000
NODE_27_length_9108_cov_47.430347	4936	5016	157	2	80	0.0250000
NODE_27_length_9108_cov_47.430347	4936	5016	160	1	80	0.0125000
NODE_27_length_9108_cov_47.430347	4936	5016	163	2	80	0.0250000
NODE_27_length_9108_cov_47.430347	4936	5016	164	1	80	0.0125000
NODE_27_length_9108_cov_47.430347	4936	5016	171	1	80	0.0125000
NODE_27_length_9108_cov_47.430347	4936	5016	172	2	80	0.0250000
NODE_27_length_9108_cov_47.430347	4936	5016	176	1	80	0.0125000
NODE_27_length_9108_cov_47.430347	4936	5016	177	1	80	0.0125000
NODE_27_length_9108_cov_47.430347	4936	5016	180	1	80	0.0125000
NODE_27_length_9108_cov_47.430347	4936	5016	183	3	80	0.0375000
NODE_27_length_9108_cov_47.430347	4936	5016	186	1	80	0.0125000
NODE_27_length_9108_cov_47.430347	4936	5016	188	1	80	0.0125000
NODE_27_length_9108_cov_47.430347	4936	5016	189	5	80	0.0625000
NODE_27_length_9108_cov_47.430347	4936	5016	193	2	80	0.0250000
NODE_27_length_9108_cov_47.430347	4936	5016	196	1	80	0.0125000
NODE_28_length_9108_cov_26.469974	44	120	0	76	76	1.0000000
NODE_28_length_9108_cov_26.469974	7711	7791	8	1	80	0.0125000
NODE_28_length_9108_cov_26.469974	7711	7791	52	1	80	0.0125000
NODE_28_length_9108_cov_26.469974	7711	7791	53	1	80	0.0125000
NODE_28_length_9108_cov_26.469974	7711	7791	57	1	80	0.0125000
NODE_28_length_9108_cov_26.469974	7711	7791	62	4	80	0.0500000
NODE_28_length_9108_cov_26.469974	7711	7791	63	1	80	0.0125000
NODE_28_length_9108_cov_26.469974	7711	7791	73	1	80	0.0125000
NODE_28_length_9108_cov_26.469974	7711	7791	77	6	80	0.0750000
NODE_28_length_9108_cov_26.469974	7711	7791	81	1	80	0.0125000
NODE_28_length_9108_cov_26.469974	7711	7791	90	1	80	0.0125000
NODE_28_length_9108_cov_26.469974	7711	7791	94	4	80	0.0500000
NODE_28_length_9108_cov_26.469974	7711	7791	96	1	80	0.0125000
NODE_28_length_9108_cov_26.469974	7711	7791	100	1	80	0.0125000
NODE_28_length_9108_cov_26.469974	7711	7791	102	2	80	0.0250000
NODE_28_length_9108_cov_26.469974	7711	7791	106	5	80	0.0625000
NODE_28_length_9108_cov_26.469974	7711	7791	108	1	80	0.0125000
NODE_28_length_9108_cov_26.469974	7711	7791	110	2	80	0.0250000
NODE_28_length_9108_cov_26.469974	7711	7791	111	2	80	0.0250000
NODE_28_length_9108_cov_26.469974	7711	7791	112	2	80	0.0250000
NODE_28_length_9108_cov_26.469974	7711	7791	113	1	80	0.0125000
NODE_28_length_9108_cov_26.469974	7711	7791	115	1	80	0.0125000
NODE_28_length_9108_cov_26.469974	7711	7791	116	1	80	0.0125000
NODE_28_length_9108_cov_26.469974	7711	7791	124	2	80	0.0250000
NODE_28_length_9108_cov_26.469974	7711	7791	136	1	80	0.0125000
NODE_28_length_9108_cov_26.469974	7711	7791	137	1	80	0.0125000
NODE_28_length_9108_cov_26.469974	7711	7791	139	2	80	0.0250000
NODE_28_length_9108_cov_26.469974	7711	7791	141	1	80	0.0125000
NODE_28_length_9108_cov_26.469974	7711	7791	145	1	80	0.0125000
NODE_28_length_9108_cov_26.469974	7711	7791	147	1	80	0.0125000
NODE_28_length_9108_cov_26.469974	7711	7791	149	3	80	0.0375000
NODE_28_length_9108_cov_26.469974	7711	7791	150	2	80	0.0250000
NODE_28_length_9108_cov_26.469974	7711	7791	152	2	80	0.0250000
NODE_28_length_9108_cov_26.469974	7711	7791	157	1	80	0.0125000
NODE_28_length_9108_cov_26.469974	7711	7791	161	1	80	0.0125000
NODE_28_length_9108_cov_26.469974	7711	7791	170	1	80	0.0125000
NODE_28_length_9108_cov_26.469974	7711	7791	171	1	80	0.0125000
NODE_28_length_9108_cov_26.469974	7711	7791	174	1	80	0.0125000
NODE_28_length_9108_cov_26.469974	7711	7791	180	1	80	0.0125000
NODE_28_length_9108_cov_26.469974	7711	7791	191	2	80	0.0250000
NODE_28_length_9108_cov_26.469974	7711	7791	195	1	80	0.0125000
NODE_28_length_9108_cov_26.469974	7711	7791	198	1	80	0.0125000
NODE_28_length_9108_cov_26.469974	7711	7791	204	1	80	0.0125000
NODE_28_length_9108_cov_26.469974	7711	7791	209	2	80	0.0250000
NODE_28_length_9108_cov_26.469974	7711	7791	211	2	80	0.0250000
NODE_28_length_9108_cov_26.469974	7711	7791	219	1	80	0.0125000
NODE_28_length_9108_cov_26.469974	7711	7791	225	1	80	0.0125000
NODE_28_length_9108_cov_26.469974	7711	7791	228	3	80	0.0375000
NODE_28_length_9108_cov_26.469974	7711	7791	231	1	80	0.0125000
NODE_28_length_9108_cov_26.469974	7711	7791	236	1	80	0.0125000
NODE_28_length_9108_cov_26.469974	7711	7791	238	1	80	0.0125000
NODE_28_length_9108_cov_26.469974	8144	8224	9	1	80	0.0125000
NODE_28_length_9108_cov_26.469974	8144	8224	52	1	80	0.0125000
NODE_28_length_9108_cov_26.469974	8144	8224	53	1	80	0.0125000
NODE_28_length_9108_cov_26.469974	8144	8224	54	2	80	0.0250000
NODE_28_length_9108_cov_26.469974	8144	8224	58	1	80	0.0125000
NODE_28_length_9108_cov_26.469974	8144	8224	60	2	80	0.0250000
NODE_28_length_9108_cov_26.469974	8144	8224	62	2	80	0.0250000
NODE_28_length_9108_cov_26.469974	8144	8224	64	2	80	0.0250000
NODE_28_length_9108_cov_26.469974	8144	8224	70	1	80	0.0125000
NODE_28_length_9108_cov_26.469974	8144	8224	71	2	80	0.0250000
NODE_28_length_9108_cov_26.469974	8144	8224	73	1	80	0.0125000
NODE_28_length_9108_cov_26.469974	8144	8224	75	1	80	0.0125000
NODE_28_length_9108_cov_26.469974	8144	8224	77	1	80	0.0125000
NODE_28_length_9108_cov_26.469974	8144	8224	85	2	80	0.0250000
NODE_28_length_9108_cov_26.469974	8144	8224	86	2	80	0.0250000
NODE_28_length_9108_cov_26.469974	8144	8224	88	1	80	0.0125000
NODE_28_length_9108_cov_26.469974	8144	8224	92	1	80	0.0125000
NODE_28_length_9108_cov_26.469974	8144	8224	94	2	80	0.0250000
NODE_28_length_9108_cov_26.469974	8144	8224	98	1	80	0.0125000
NODE_28_length_9108_cov_26.469974	8144	8224	100	1	80	0.0125000
NODE_28_length_9108_cov_26.469974	8144	8224	102	2	80	0.0250000
NODE_28_length_9108_cov_26.469974	8144	8224	105	2	80	0.0250000
NODE_28_length_9108_cov_26.469974	8144	8224	106	6	80	0.0750000
NODE_28_length_9108_cov_26.469974	8144	8224	107	3	80	0.0375000
NODE_28_length_9108_cov_26.469974	8144	8224	109	2	80	0.0250000
NODE_28_length_9108_cov_26.469974	8144	8224	110	1	80	0.0125000
NODE_28_length_9108_cov_26.469974	8144	8224	114	1	80	0.0125000
NODE_28_length_9108_cov_26.469974	8144	8224	118	1	80	0.0125000
NODE_28_length_9108_cov_26.469974	8144	8224	121	1	80	0.0125000
NODE_28_length_9108_cov_26.469974	8144	8224	122	7	80	0.0875000
NODE_28_length_9108_cov_26.469974	8144	8224	127	1	80	0.0125000
NODE_28_length_9108_cov_26.469974	8144	8224	128	1	80	0.0125000
NODE_28_length_9108_cov_26.469974	8144	8224	129	1	80	0.0125000
NODE_28_length_9108_cov_26.469974	8144	8224	130	2	80	0.0250000
NODE_28_length_9108_cov_26.469974	8144	8224	133	1	80	0.0125000
NODE_28_length_9108_cov_26.469974	8144	8224	135	2	80	0.0250000
NODE_28_length_9108_cov_26.469974	8144	8224	137	1	80	0.0125000
NODE_28_length_9108_cov_26.469974	8144	8224	139	3	80	0.0375000
NODE_28_length_9108_cov_26.469974	8144	8224	140	1	80	0.0125000
NODE_28_length_9108_cov_26.469974	8144	8224	142	9	80	0.1125000
NODE_28_length_9108_cov_26.469974	8144	8224	143	2	80	0.0250000
NODE_28_length_9108_cov_26.469974	8144	8224	148	1	80	0.0125000
NODE_28_length_9108_cov_26.469974	8144	8224	152	1	80	0.0125000
NODE_28_length_9108_cov_26.469974	8568	8648	0	66	80	0.8250000
NODE_28_length_9108_cov_26.469974	8568	8648	2	14	80	0.1750000
NODE_28_length_9108_cov_26.469974	8621	8701	0	80	80	1.0000000
NODE_30_length_8743_cov_14.172721	7849	7929	39	3	80	0.0375000
NODE_30_length_8743_cov_14.172721	7849	7929	41	4	80	0.0500000
NODE_30_length_8743_cov_14.172721	7849	7929	46	4	80	0.0500000
NODE_30_length_8743_cov_14.172721	7849	7929	50	3	80	0.0375000
NODE_30_length_8743_cov_14.172721	7849	7929	52	1	80	0.0125000
NODE_30_length_8743_cov_14.172721	7849	7929	53	2	80	0.0250000
NODE_30_length_8743_cov_14.172721	7849	7929	57	1	80	0.0125000
NODE_30_length_8743_cov_14.172721	7849	7929	58	3	80	0.0375000
NODE_30_length_8743_cov_14.172721	7849	7929	59	2	80	0.0250000
NODE_30_length_8743_cov_14.172721	7849	7929	60	1	80	0.0125000
NODE_30_length_8743_cov_14.172721	7849	7929	61	8	80	0.1000000
NODE_30_length_8743_cov_14.172721	7849	7929	65	3	80	0.0375000
NODE_30_length_8743_cov_14.172721	7849	7929	68	6	80	0.0750000
NODE_30_length_8743_cov_14.172721	7849	7929	70	3	80	0.0375000
NODE_30_length_8743_cov_14.172721	7849	7929	72	10	80	0.1250000
NODE_30_length_8743_cov_14.172721	7849	7929	73	2	80	0.0250000
NODE_30_length_8743_cov_14.172721	7849	7929	74	24	80	0.3000000
NODE_30_length_8743_cov_14.172721	7902	7964	2	3	62	0.0483871
NODE_30_length_8743_cov_14.172721	7902	7964	3	3	62	0.0483871
NODE_30_length_8743_cov_14.172721	7902	7964	8	1	62	0.0161290
NODE_30_length_8743_cov_14.172721	7902	7964	11	2	62	0.0322581
NODE_30_length_8743_cov_14.172721	7902	7964	12	1	62	0.0161290
NODE_30_length_8743_cov_14.172721	7902	7964	14	1	62	0.0161290
NODE_30_length_8743_cov_14.172721	7902	7964	16	1	62	0.0161290
NODE_30_length_8743_cov_14.172721	7902	7964	20	2	62	0.0322581
NODE_30_length_8743_cov_14.172721	7902	7964	22	6	62	0.0967742
NODE_30_length_8743_cov_14.172721	7902	7964	24	1	62	0.0161290
NODE_30_length_8743_cov_14.172721	7902	7964	25	4	62	0.0645161
NODE_30_length_8743_cov_14.172721	7902	7964	26	1	62	0.0161290
NODE_30_length_8743_cov_14.172721	7902	7964	29	4	62	0.0645161
NODE_30_length_8743_cov_14.172721	7902	7964	30	1	62	0.0161290
NODE_30_length_8743_cov_14.172721	7902	7964	32	1	62	0.0161290
NODE_30_length_8743_cov_14.172721	7902	7964	35	2	62	0.0322581
NODE_30_length_8743_cov_14.172721	7902	7964	37	1	62	0.0161290
NODE_30_length_8743_cov_14.172721	7902	7964	39	3	62	0.0483871
NODE_30_length_8743_cov_14.172721	7902	7964	41	4	62	0.0645161
NODE_30_length_8743_cov_14.172721	7902	7964	46	4	62	0.0645161
NODE_30_length_8743_cov_14.172721	7902	7964	50	3	62	0.0483871
NODE_30_length_8743_cov_14.172721	7902	7964	52	1	62	0.0161290
NODE_30_length_8743_cov_14.172721	7902	7964	53	2	62	0.0322581
NODE_30_length_8743_cov_14.172721	7902	7964	57	1	62	0.0161290
NODE_30_length_8743_cov_14.172721	7902	7964	58	3	62	0.0483871
NODE_30_length_8743_cov_14.172721	7902	7964	59	2	62	0.0322581
NODE_30_length_8743_cov_14.172721	7902	7964	60	1	62	0.0161290
NODE_30_length_8743_cov_14.172721	7902	7964	61	3	62	0.0483871
NODE_32_length_8707_cov_6.353044	8541	8621	8	6	80	0.0750000
NODE_32_length_8707_cov_6.353044	8541	8621	9	3	80	0.0375000
NODE_32_length_8707_cov_6.353044	8541	8621	15	1	80	0.0125000
NODE_32_length_8707_cov_6.353044	8541	8621	16	6	80	0.0750000
NODE_32_length_8707_cov_6.353044	8541	8621	27	1	80	0.0125000
NODE_32_length_8707_cov_6.353044	8541	8621	28	1	80	0.0125000
NODE_32_length_8707_cov_6.353044	8541	8621	31	2	80	0.0250000
NODE_32_length_8707_cov_6.353044	8541	8621	36	1	80	0.0125000
NODE_32_length_8707_cov_6.353044	8541	8621	37	5	80	0.0625000
NODE_32_length_8707_cov_6.353044	8541	8621	39	2	80	0.0250000
NODE_32_length_8707_cov_6.353044	8541	8621	43	7	80	0.0875000
NODE_32_length_8707_cov_6.353044	8541	8621	51	5	80	0.0625000
NODE_32_length_8707_cov_6.353044	8541	8621	60	1	80	0.0125000
NODE_32_length_8707_cov_6.353044	8541	8621	62	15	80	0.1875000
NODE_32_length_8707_cov_6.353044	8541	8621	63	24	80	0.3000000
NODE_32_length_8707_cov_6.353044	8541	8621	8	6	80	0.0750000
NODE_32_length_8707_cov_6.353044	8541	8621	9	3	80	0.0375000
NODE_32_length_8707_cov_6.353044	8541	8621	15	1	80	0.0125000
NODE_32_length_8707_cov_6.353044	8541	8621	16	6	80	0.0750000
NODE_32_length_8707_cov_6.353044	8541	8621	27	1	80	0.0125000
NODE_32_length_8707_cov_6.353044	8541	8621	28	1	80	0.0125000
NODE_32_length_8707_cov_6.353044	8541	8621	31	2	80	0.0250000
NODE_32_length_8707_cov_6.353044	8541	8621	36	1	80	0.0125000
NODE_32_length_8707_cov_6.353044	8541	8621	37	5	80	0.0625000
NODE_32_length_8707_cov_6.353044	8541	8621	39	2	80	0.0250000
NODE_32_length_8707_cov_6.353044	8541	8621	43	7	80	0.0875000
NODE_32_length_8707_cov_6.353044	8541	8621	51	5	80	0.0625000
NODE_32_length_8707_cov_6.353044	8541	8621	60	1	80	0.0125000
NODE_32_length_8707_cov_6.353044	8541	8621	62	15	80	0.1875000
NODE_32_length_8707_cov_6.353044	8541	8621	63	24	80	0.3000000
NODE_32_length_8707_cov_6.353044	8541	8621	8	6	80	0.0750000
NODE_32_length_8707_cov_6.353044	8541	8621	9	3	80	0.0375000
NODE_32_length_8707_cov_6.353044	8541	8621	15	1	80	0.0125000
NODE_32_length_8707_cov_6.353044	8541	8621	16	6	80	0.0750000
NODE_32_length_8707_cov_6.353044	8541	8621	27	1	80	0.0125000
NODE_32_length_8707_cov_6.353044	8541	8621	28	1	80	0.0125000
NODE_32_length_8707_cov_6.353044	8541	8621	31	2	80	0.0250000
NODE_32_length_8707_cov_6.353044	8541	8621	36	1	80	0.0125000
NODE_32_length_8707_cov_6.353044	8541	8621	37	5	80	0.0625000
NODE_32_length_8707_cov_6.353044	8541	8621	39	2	80	0.0250000
NODE_32_length_8707_cov_6.353044	8541	8621	43	7	80	0.0875000
NODE_32_length_8707_cov_6.353044	8541	8621	51	5	80	0.0625000
NODE_32_length_8707_cov_6.353044	8541	8621	60	1	80	0.0125000
NODE_32_length_8707_cov_6.353044	8541	8621	62	15	80	0.1875000
NODE_32_length_8707_cov_6.353044	8541	8621	63	24	80	0.3000000
NODE_32_length_8707_cov_6.353044	8594	8674	42	8	80	0.1000000
NODE_32_length_8707_cov_6.353044	8594	8674	48	16	80	0.2000000
NODE_32_length_8707_cov_6.353044	8594	8674	50	3	80	0.0375000
NODE_32_length_8707_cov_6.353044	8594	8674	54	11	80	0.1375000
NODE_32_length_8707_cov_6.353044	8594	8674	60	4	80	0.0500000
NODE_32_length_8707_cov_6.353044	8594	8674	62	26	80	0.3250000
NODE_32_length_8707_cov_6.353044	8594	8674	63	12	80	0.1500000
NODE_32_length_8707_cov_6.353044	8594	8674	42	8	80	0.1000000
NODE_32_length_8707_cov_6.353044	8594	8674	48	16	80	0.2000000
NODE_32_length_8707_cov_6.353044	8594	8674	50	3	80	0.0375000
NODE_32_length_8707_cov_6.353044	8594	8674	54	11	80	0.1375000
NODE_32_length_8707_cov_6.353044	8594	8674	60	4	80	0.0500000
NODE_32_length_8707_cov_6.353044	8594	8674	62	26	80	0.3250000
NODE_32_length_8707_cov_6.353044	8594	8674	63	12	80	0.1500000
NODE_32_length_8707_cov_6.353044	8594	8673	42	7	79	0.0886076
NODE_32_length_8707_cov_6.353044	8594	8673	48	16	79	0.2025317
NODE_32_length_8707_cov_6.353044	8594	8673	50	3	79	0.0379747
NODE_32_length_8707_cov_6.353044	8594	8673	54	11	79	0.1392405
NODE_32_length_8707_cov_6.353044	8594	8673	60	4	79	0.0506329
NODE_32_length_8707_cov_6.353044	8594	8673	62	26	79	0.3291139
NODE_32_length_8707_cov_6.353044	8594	8673	63	12	79	0.1518987
NODE_32_length_8707_cov_6.353044	8599	8674	42	8	75	0.1066667
NODE_32_length_8707_cov_6.353044	8599	8674	48	16	75	0.2133333
NODE_32_length_8707_cov_6.353044	8599	8674	50	3	75	0.0400000
NODE_32_length_8707_cov_6.353044	8599	8674	54	11	75	0.1466667
NODE_32_length_8707_cov_6.353044	8599	8674	60	4	75	0.0533333
NODE_32_length_8707_cov_6.353044	8599	8674	62	26	75	0.3466667
NODE_32_length_8707_cov_6.353044	8599	8674	63	7	75	0.0933333
NODE_38_length_8281_cov_13.025177	7108	7188	0	80	80	1.0000000
NODE_38_length_8281_cov_13.025177	7161	7199	0	38	38	1.0000000
NODE_38_length_8281_cov_13.025177	7175	7255	0	80	80	1.0000000
NODE_38_length_8281_cov_13.025177	7228	7308	0	80	80	1.0000000
NODE_38_length_8281_cov_13.025177	7749	7829	0	77	80	0.9625000
NODE_38_length_8281_cov_13.025177	7749	7829	2	3	80	0.0375000
NODE_38_length_8281_cov_13.025177	7802	7882	0	24	80	0.3000000
NODE_38_length_8281_cov_13.025177	7802	7882	2	24	80	0.3000000
NODE_38_length_8281_cov_13.025177	7802	7882	4	32	80	0.4000000
NODE_38_length_8281_cov_13.025177	7878	7958	4	6	80	0.0750000
NODE_38_length_8281_cov_13.025177	7878	7958	6	50	80	0.6250000
NODE_38_length_8281_cov_13.025177	7878	7958	8	24	80	0.3000000
NODE_38_length_8281_cov_13.025177	7931	8011	2	16	80	0.2000000
NODE_38_length_8281_cov_13.025177	7931	8011	4	34	80	0.4250000
NODE_38_length_8281_cov_13.025177	7931	8011	6	27	80	0.3375000
NODE_38_length_8281_cov_13.025177	7931	8011	8	3	80	0.0375000
NODE_39_length_8259_cov_60.011152	1424	1504	4	2	80	0.0250000
NODE_39_length_8259_cov_60.011152	1424	1504	6	1	80	0.0125000
NODE_39_length_8259_cov_60.011152	1424	1504	9	7	80	0.0875000
NODE_39_length_8259_cov_60.011152	1424	1504	10	31	80	0.3875000
NODE_39_length_8259_cov_60.011152	1424	1504	11	31	80	0.3875000
NODE_39_length_8259_cov_60.011152	1424	1504	13	8	80	0.1000000
NODE_39_length_8259_cov_60.011152	1477	1549	11	41	72	0.5694444
NODE_39_length_8259_cov_60.011152	1477	1549	13	11	72	0.1527778
NODE_39_length_8259_cov_60.011152	1477	1549	14	20	72	0.2777778
NODE_40_length_8228_cov_17.079592	314	394	0	10	80	0.1250000
NODE_40_length_8228_cov_17.079592	314	394	2	70	80	0.8750000
NODE_40_length_8228_cov_17.079592	367	447	0	63	80	0.7875000
NODE_40_length_8228_cov_17.079592	367	447	2	17	80	0.2125000
NODE_40_length_8228_cov_17.079592	443	523	0	50	80	0.6250000
NODE_40_length_8228_cov_17.079592	443	523	2	2	80	0.0250000
NODE_40_length_8228_cov_17.079592	443	523	4	10	80	0.1250000
NODE_40_length_8228_cov_17.079592	443	523	6	3	80	0.0375000
NODE_40_length_8228_cov_17.079592	443	523	12	2	80	0.0250000
NODE_40_length_8228_cov_17.079592	443	523	14	13	80	0.1625000
NODE_40_length_8228_cov_17.079592	496	576	4	9	80	0.1125000
NODE_40_length_8228_cov_17.079592	496	576	6	3	80	0.0375000
NODE_40_length_8228_cov_17.079592	496	576	12	2	80	0.0250000
NODE_40_length_8228_cov_17.079592	496	576	14	66	80	0.8250000
NODE_40_length_8228_cov_17.079592	3154	3217	20	1	63	0.0158730
NODE_40_length_8228_cov_17.079592	3154	3217	81	1	63	0.0158730
NODE_40_length_8228_cov_17.079592	3154	3217	91	1	63	0.0158730
NODE_40_length_8228_cov_17.079592	3154	3217	96	1	63	0.0158730
NODE_40_length_8228_cov_17.079592	3154	3217	101	1	63	0.0158730
NODE_40_length_8228_cov_17.079592	3154	3217	103	2	63	0.0317460
NODE_40_length_8228_cov_17.079592	3154	3217	113	1	63	0.0158730
NODE_40_length_8228_cov_17.079592	3154	3217	115	1	63	0.0158730
NODE_40_length_8228_cov_17.079592	3154	3217	119	1	63	0.0158730
NODE_40_length_8228_cov_17.079592	3154	3217	121	1	63	0.0158730
NODE_40_length_8228_cov_17.079592	3154	3217	127	1	63	0.0158730
NODE_40_length_8228_cov_17.079592	3154	3217	134	1	63	0.0158730
NODE_40_length_8228_cov_17.079592	3154	3217	137	2	63	0.0317460
NODE_40_length_8228_cov_17.079592	3154	3217	145	1	63	0.0158730
NODE_40_length_8228_cov_17.079592	3154	3217	149	1	63	0.0158730
NODE_40_length_8228_cov_17.079592	3154	3217	153	1	63	0.0158730
NODE_40_length_8228_cov_17.079592	3154	3217	155	1	63	0.0158730
NODE_40_length_8228_cov_17.079592	3154	3217	156	1	63	0.0158730
NODE_40_length_8228_cov_17.079592	3154	3217	158	2	63	0.0317460
NODE_40_length_8228_cov_17.079592	3154	3217	160	1	63	0.0158730
NODE_40_length_8228_cov_17.079592	3154	3217	162	1	63	0.0158730
NODE_40_length_8228_cov_17.079592	3154	3217	166	1	63	0.0158730
NODE_40_length_8228_cov_17.079592	3154	3217	170	2	63	0.0317460
NODE_40_length_8228_cov_17.079592	3154	3217	172	1	63	0.0158730
NODE_40_length_8228_cov_17.079592	3154	3217	174	1	63	0.0158730
NODE_40_length_8228_cov_17.079592	3154	3217	180	1	63	0.0158730
NODE_40_length_8228_cov_17.079592	3154	3217	188	1	63	0.0158730
NODE_40_length_8228_cov_17.079592	3154	3217	192	2	63	0.0317460
NODE_40_length_8228_cov_17.079592	3154	3217	198	1	63	0.0158730
NODE_40_length_8228_cov_17.079592	3154	3217	206	1	63	0.0158730
NODE_40_length_8228_cov_17.079592	3154	3217	208	2	63	0.0317460
NODE_40_length_8228_cov_17.079592	3154	3217	210	1	63	0.0158730
NODE_40_length_8228_cov_17.079592	3154	3217	214	2	63	0.0317460
NODE_40_length_8228_cov_17.079592	3154	3217	218	5	63	0.0793651
NODE_40_length_8228_cov_17.079592	3154	3217	220	11	63	0.1746032
NODE_40_length_8228_cov_17.079592	3154	3217	222	7	63	0.1111111
NODE_43_length_8100_cov_32.115236	501	581	2	16	80	0.2000000
NODE_43_length_8100_cov_32.115236	501	581	4	20	80	0.2500000
NODE_43_length_8100_cov_32.115236	501	581	6	20	80	0.2500000
NODE_43_length_8100_cov_32.115236	501	581	7	15	80	0.1875000
NODE_43_length_8100_cov_32.115236	501	581	8	7	80	0.0875000
NODE_43_length_8100_cov_32.115236	501	581	9	2	80	0.0250000
NODE_43_length_8100_cov_32.115236	554	634	0	39	80	0.4875000
NODE_43_length_8100_cov_32.115236	554	634	1	1	80	0.0125000
NODE_43_length_8100_cov_32.115236	554	634	2	29	80	0.3625000
NODE_43_length_8100_cov_32.115236	554	634	4	11	80	0.1375000
NODE_43_length_8100_cov_32.115236	1383	1463	0	80	80	1.0000000
NODE_43_length_8100_cov_32.115236	1436	1516	0	80	80	1.0000000
NODE_43_length_8100_cov_32.115236	3391	3462	407	1	71	0.0140845
NODE_43_length_8100_cov_32.115236	3391	3462	415	1	71	0.0140845
NODE_43_length_8100_cov_32.115236	3391	3462	421	1	71	0.0140845
NODE_43_length_8100_cov_32.115236	3391	3462	431	1	71	0.0140845
NODE_43_length_8100_cov_32.115236	3391	3462	437	1	71	0.0140845
NODE_43_length_8100_cov_32.115236	3391	3462	444	1	71	0.0140845
NODE_43_length_8100_cov_32.115236	3391	3462	467	1	71	0.0140845
NODE_43_length_8100_cov_32.115236	3391	3462	470	1	71	0.0140845
NODE_43_length_8100_cov_32.115236	3391	3462	475	1	71	0.0140845
NODE_43_length_8100_cov_32.115236	3391	3462	495	1	71	0.0140845
NODE_43_length_8100_cov_32.115236	3391	3462	496	1	71	0.0140845
NODE_43_length_8100_cov_32.115236	3391	3462	514	1	71	0.0140845
NODE_43_length_8100_cov_32.115236	3391	3462	518	1	71	0.0140845
NODE_43_length_8100_cov_32.115236	3391	3462	523	2	71	0.0281690
NODE_43_length_8100_cov_32.115236	3391	3462	532	1	71	0.0140845
NODE_43_length_8100_cov_32.115236	3391	3462	540	1	71	0.0140845
NODE_43_length_8100_cov_32.115236	3391	3462	561	1	71	0.0140845
NODE_43_length_8100_cov_32.115236	3391	3462	573	1	71	0.0140845
NODE_43_length_8100_cov_32.115236	3391	3462	574	1	71	0.0140845
NODE_43_length_8100_cov_32.115236	3391	3462	586	1	71	0.0140845
NODE_43_length_8100_cov_32.115236	3391	3462	595	1	71	0.0140845
NODE_43_length_8100_cov_32.115236	3391	3462	599	1	71	0.0140845
NODE_43_length_8100_cov_32.115236	3391	3462	605	1	71	0.0140845
NODE_43_length_8100_cov_32.115236	3391	3462	612	1	71	0.0140845
NODE_43_length_8100_cov_32.115236	3391	3462	615	1	71	0.0140845
NODE_43_length_8100_cov_32.115236	3391	3462	617	1	71	0.0140845
NODE_43_length_8100_cov_32.115236	3391	3462	619	2	71	0.0281690
NODE_43_length_8100_cov_32.115236	3391	3462	626	1	71	0.0140845
NODE_43_length_8100_cov_32.115236	3391	3462	627	2	71	0.0281690
NODE_43_length_8100_cov_32.115236	3391	3462	628	1	71	0.0140845
NODE_43_length_8100_cov_32.115236	3391	3462	629	1	71	0.0140845
NODE_43_length_8100_cov_32.115236	3391	3462	636	1	71	0.0140845
NODE_43_length_8100_cov_32.115236	3391	3462	638	1	71	0.0140845
NODE_43_length_8100_cov_32.115236	3391	3462	639	2	71	0.0281690
NODE_43_length_8100_cov_32.115236	3391	3462	640	2	71	0.0281690
NODE_43_length_8100_cov_32.115236	3391	3462	649	1	71	0.0140845
NODE_43_length_8100_cov_32.115236	3391	3462	650	1	71	0.0140845
NODE_43_length_8100_cov_32.115236	3391	3462	661	2	71	0.0281690
NODE_43_length_8100_cov_32.115236	3391	3462	664	1	71	0.0140845
NODE_43_length_8100_cov_32.115236	3391	3462	668	1	71	0.0140845
NODE_43_length_8100_cov_32.115236	3391	3462	672	1	71	0.0140845
NODE_43_length_8100_cov_32.115236	3391	3462	677	1	71	0.0140845
NODE_43_length_8100_cov_32.115236	3391	3462	689	1	71	0.0140845
NODE_43_length_8100_cov_32.115236	3391	3462	690	1	71	0.0140845
NODE_43_length_8100_cov_32.115236	3391	3462	691	1	71	0.0140845
NODE_43_length_8100_cov_32.115236	3391	3462	692	2	71	0.0281690
NODE_43_length_8100_cov_32.115236	3391	3462	693	3	71	0.0422535
NODE_43_length_8100_cov_32.115236	3391	3462	695	3	71	0.0422535
NODE_43_length_8100_cov_32.115236	3391	3462	696	1	71	0.0140845
NODE_43_length_8100_cov_32.115236	3391	3462	697	4	71	0.0563380
NODE_43_length_8100_cov_32.115236	3391	3462	698	4	71	0.0563380
NODE_43_length_8100_cov_32.115236	3391	3462	699	3	71	0.0422535
NODE_43_length_8100_cov_32.115236	3435	3483	253	2	48	0.0416667
NODE_43_length_8100_cov_32.115236	3435	3483	256	1	48	0.0208333
NODE_43_length_8100_cov_32.115236	3435	3483	263	2	48	0.0416667
NODE_43_length_8100_cov_32.115236	3435	3483	268	1	48	0.0208333
NODE_43_length_8100_cov_32.115236	3435	3483	278	1	48	0.0208333
NODE_43_length_8100_cov_32.115236	3435	3483	293	1	48	0.0208333
NODE_43_length_8100_cov_32.115236	3435	3483	294	1	48	0.0208333
NODE_43_length_8100_cov_32.115236	3435	3483	303	1	48	0.0208333
NODE_43_length_8100_cov_32.115236	3435	3483	307	1	48	0.0208333
NODE_43_length_8100_cov_32.115236	3435	3483	311	1	48	0.0208333
NODE_43_length_8100_cov_32.115236	3435	3483	322	1	48	0.0208333
NODE_43_length_8100_cov_32.115236	3435	3483	333	1	48	0.0208333
NODE_43_length_8100_cov_32.115236	3435	3483	342	1	48	0.0208333
NODE_43_length_8100_cov_32.115236	3435	3483	343	1	48	0.0208333
NODE_43_length_8100_cov_32.115236	3435	3483	356	1	48	0.0208333
NODE_43_length_8100_cov_32.115236	3435	3483	361	1	48	0.0208333
NODE_43_length_8100_cov_32.115236	3435	3483	362	1	48	0.0208333
NODE_43_length_8100_cov_32.115236	3435	3483	388	1	48	0.0208333
NODE_43_length_8100_cov_32.115236	3435	3483	404	1	48	0.0208333
NODE_43_length_8100_cov_32.115236	3435	3483	407	1	48	0.0208333
NODE_43_length_8100_cov_32.115236	3435	3483	415	1	48	0.0208333
NODE_43_length_8100_cov_32.115236	3435	3483	421	1	48	0.0208333
NODE_43_length_8100_cov_32.115236	3435	3483	431	1	48	0.0208333
NODE_43_length_8100_cov_32.115236	3435	3483	437	1	48	0.0208333
NODE_43_length_8100_cov_32.115236	3435	3483	444	1	48	0.0208333
NODE_43_length_8100_cov_32.115236	3435	3483	467	1	48	0.0208333
NODE_43_length_8100_cov_32.115236	3435	3483	470	1	48	0.0208333
NODE_43_length_8100_cov_32.115236	3435	3483	475	1	48	0.0208333
NODE_43_length_8100_cov_32.115236	3435	3483	495	1	48	0.0208333
NODE_43_length_8100_cov_32.115236	3435	3483	496	1	48	0.0208333
NODE_43_length_8100_cov_32.115236	3435	3483	514	1	48	0.0208333
NODE_43_length_8100_cov_32.115236	3435	3483	518	1	48	0.0208333
NODE_43_length_8100_cov_32.115236	3435	3483	523	2	48	0.0416667
NODE_43_length_8100_cov_32.115236	3435	3483	532	1	48	0.0208333
NODE_43_length_8100_cov_32.115236	3435	3483	540	1	48	0.0208333
NODE_43_length_8100_cov_32.115236	3435	3483	561	1	48	0.0208333
NODE_43_length_8100_cov_32.115236	3435	3483	573	1	48	0.0208333
NODE_43_length_8100_cov_32.115236	3435	3483	574	1	48	0.0208333
NODE_43_length_8100_cov_32.115236	3435	3483	586	1	48	0.0208333
NODE_43_length_8100_cov_32.115236	3435	3483	595	1	48	0.0208333
NODE_43_length_8100_cov_32.115236	3435	3483	599	1	48	0.0208333
NODE_43_length_8100_cov_32.115236	3435	3483	605	1	48	0.0208333
NODE_43_length_8100_cov_32.115236	3435	3483	612	1	48	0.0208333
NODE_43_length_8100_cov_32.115236	3435	3483	615	1	48	0.0208333
NODE_43_length_8100_cov_32.115236	3435	3483	619	1	48	0.0208333
NODE_46_length_7962_cov_31.622790	6281	6363	118	1	82	0.0121951
NODE_46_length_7962_cov_31.622790	6281	6363	120	2	82	0.0243902
NODE_46_length_7962_cov_31.622790	6281	6363	122	2	82	0.0243902
NODE_46_length_7962_cov_31.622790	6281	6363	123	2	82	0.0243902
NODE_46_length_7962_cov_31.622790	6281	6363	125	4	82	0.0487805
NODE_46_length_7962_cov_31.622790	6281	6363	126	4	82	0.0487805
NODE_46_length_7962_cov_31.622790	6281	6363	127	2	82	0.0243902
NODE_46_length_7962_cov_31.622790	6281	6363	132	1	82	0.0121951
NODE_46_length_7962_cov_31.622790	6281	6363	133	1	82	0.0121951
NODE_46_length_7962_cov_31.622790	6281	6363	134	2	82	0.0243902
NODE_46_length_7962_cov_31.622790	6281	6363	135	2	82	0.0243902
NODE_46_length_7962_cov_31.622790	6281	6363	136	4	82	0.0487805
NODE_46_length_7962_cov_31.622790	6281	6363	137	7	82	0.0853659
NODE_46_length_7962_cov_31.622790	6281	6363	139	4	82	0.0487805
NODE_46_length_7962_cov_31.622790	6281	6363	140	4	82	0.0487805
NODE_46_length_7962_cov_31.622790	6281	6363	141	12	82	0.1463415
NODE_46_length_7962_cov_31.622790	6281	6363	142	1	82	0.0121951
NODE_46_length_7962_cov_31.622790	6281	6363	143	5	82	0.0609756
NODE_46_length_7962_cov_31.622790	6281	6363	144	3	82	0.0365854
NODE_46_length_7962_cov_31.622790	6281	6363	145	1	82	0.0121951
NODE_46_length_7962_cov_31.622790	6281	6363	147	6	82	0.0731707
NODE_46_length_7962_cov_31.622790	6281	6363	148	6	82	0.0731707
NODE_46_length_7962_cov_31.622790	6281	6363	149	1	82	0.0121951
NODE_46_length_7962_cov_31.622790	6281	6363	150	2	82	0.0243902
NODE_46_length_7962_cov_31.622790	6281	6363	152	3	82	0.0365854
NODE_47_length_7944_cov_12.238496	348	419	13	2	71	0.0281690
NODE_47_length_7944_cov_12.238496	348	419	21	8	71	0.1126761
NODE_47_length_7944_cov_12.238496	348	419	22	19	71	0.2676056
NODE_47_length_7944_cov_12.238496	348	419	26	1	71	0.0140845
NODE_47_length_7944_cov_12.238496	348	419	27	5	71	0.0704225
NODE_47_length_7944_cov_12.238496	348	419	38	5	71	0.0704225
NODE_47_length_7944_cov_12.238496	348	419	39	4	71	0.0563380
NODE_47_length_7944_cov_12.238496	348	419	44	8	71	0.1126761
NODE_47_length_7944_cov_12.238496	348	419	45	7	71	0.0985916
NODE_47_length_7944_cov_12.238496	348	419	46	7	71	0.0985916
NODE_47_length_7944_cov_12.238496	348	419	48	5	71	0.0704225
NODE_48_length_7919_cov_14.554859	2380	2460	6	3	80	0.0375000
NODE_48_length_7919_cov_14.554859	2380	2460	8	3	80	0.0375000
NODE_48_length_7919_cov_14.554859	2380	2460	10	23	80	0.2875000
NODE_48_length_7919_cov_14.554859	2380	2460	12	42	80	0.5250000
NODE_48_length_7919_cov_14.554859	2380	2460	14	9	80	0.1125000
NODE_50_length_7830_cov_4.211098	0	52	0	52	52	1.0000000
NODE_50_length_7830_cov_4.211098	30	105	0	75	75	1.0000000
NODE_52_length_7779_cov_20.230859	7691	7771	0	1	80	0.0125000
NODE_52_length_7779_cov_20.230859	7691	7771	2	21	80	0.2625000
NODE_52_length_7779_cov_20.230859	7691	7771	3	58	80	0.7250000
NODE_52_length_7779_cov_20.230859	7691	7771	0	1	80	0.0125000
NODE_52_length_7779_cov_20.230859	7691	7771	2	21	80	0.2625000
NODE_52_length_7779_cov_20.230859	7691	7771	3	58	80	0.7250000
NODE_52_length_7779_cov_20.230859	7691	7761	2	12	70	0.1714286
NODE_52_length_7779_cov_20.230859	7691	7761	3	58	70	0.8285714
NODE_52_length_7779_cov_20.230859	7744	7779	0	9	35	0.2571429
NODE_52_length_7779_cov_20.230859	7744	7779	2	21	35	0.6000000
NODE_52_length_7779_cov_20.230859	7744	7779	3	5	35	0.1428571
NODE_53_length_7765_cov_18.871119	254	322	19	1	68	0.0147059
NODE_53_length_7765_cov_18.871119	254	322	21	1	68	0.0147059
NODE_53_length_7765_cov_18.871119	254	322	22	2	68	0.0294118
NODE_53_length_7765_cov_18.871119	254	322	23	6	68	0.0882353
NODE_53_length_7765_cov_18.871119	254	322	24	3	68	0.0441176
NODE_53_length_7765_cov_18.871119	254	322	25	3	68	0.0441176
NODE_53_length_7765_cov_18.871119	254	322	26	9	68	0.1323529
NODE_53_length_7765_cov_18.871119	254	322	27	2	68	0.0294118
NODE_53_length_7765_cov_18.871119	254	322	28	1	68	0.0147059
NODE_53_length_7765_cov_18.871119	254	322	29	1	68	0.0147059
NODE_53_length_7765_cov_18.871119	254	322	30	8	68	0.1176471
NODE_53_length_7765_cov_18.871119	254	322	34	2	68	0.0294118
NODE_53_length_7765_cov_18.871119	254	322	36	1	68	0.0147059
NODE_53_length_7765_cov_18.871119	254	322	38	1	68	0.0147059
NODE_53_length_7765_cov_18.871119	254	322	39	8	68	0.1176471
NODE_53_length_7765_cov_18.871119	254	322	41	4	68	0.0588235
NODE_53_length_7765_cov_18.871119	254	322	44	1	68	0.0147059
NODE_53_length_7765_cov_18.871119	254	322	48	1	68	0.0147059
NODE_53_length_7765_cov_18.871119	254	322	49	1	68	0.0147059
NODE_53_length_7765_cov_18.871119	254	322	51	1	68	0.0147059
NODE_53_length_7765_cov_18.871119	254	322	52	1	68	0.0147059
NODE_53_length_7765_cov_18.871119	254	322	60	1	68	0.0147059
NODE_53_length_7765_cov_18.871119	254	322	61	1	68	0.0147059
NODE_53_length_7765_cov_18.871119	254	322	63	1	68	0.0147059
NODE_53_length_7765_cov_18.871119	254	322	65	1	68	0.0147059
NODE_53_length_7765_cov_18.871119	254	322	68	1	68	0.0147059
NODE_53_length_7765_cov_18.871119	254	322	73	2	68	0.0294118
NODE_53_length_7765_cov_18.871119	254	322	82	1	68	0.0147059
NODE_53_length_7765_cov_18.871119	254	322	83	1	68	0.0147059
NODE_53_length_7765_cov_18.871119	254	322	87	1	68	0.0147059
NODE_53_length_7765_cov_18.871119	353	433	35	2	80	0.0250000
NODE_53_length_7765_cov_18.871119	353	433	37	1	80	0.0125000
NODE_53_length_7765_cov_18.871119	353	433	39	12	80	0.1500000
NODE_53_length_7765_cov_18.871119	353	433	41	2	80	0.0250000
NODE_53_length_7765_cov_18.871119	353	433	43	1	80	0.0125000
NODE_53_length_7765_cov_18.871119	353	433	44	2	80	0.0250000
NODE_53_length_7765_cov_18.871119	353	433	45	8	80	0.1000000
NODE_53_length_7765_cov_18.871119	353	433	46	4	80	0.0500000
NODE_53_length_7765_cov_18.871119	353	433	47	5	80	0.0625000
NODE_53_length_7765_cov_18.871119	353	433	48	9	80	0.1125000
NODE_53_length_7765_cov_18.871119	353	433	49	18	80	0.2250000
NODE_53_length_7765_cov_18.871119	353	433	50	3	80	0.0375000
NODE_53_length_7765_cov_18.871119	353	433	51	7	80	0.0875000
NODE_53_length_7765_cov_18.871119	353	433	52	4	80	0.0500000
NODE_53_length_7765_cov_18.871119	353	433	54	2	80	0.0250000
NODE_61_length_7411_cov_74.967314	2283	2347	0	64	64	1.0000000
NODE_61_length_7411_cov_74.967314	4725	4789	0	64	64	1.0000000
NODE_64_length_7305_cov_3.696087	971	1019	0	21	48	0.4375000
NODE_64_length_7305_cov_3.696087	971	1019	2	7	48	0.1458333
NODE_64_length_7305_cov_3.696087	971	1019	3	6	48	0.1250000
NODE_64_length_7305_cov_3.696087	971	1019	4	14	48	0.2916667
NODE_64_length_7305_cov_3.696087	7142	7190	2	8	48	0.1666667
NODE_64_length_7305_cov_3.696087	7142	7190	3	7	48	0.1458333
NODE_64_length_7305_cov_3.696087	7142	7190	6	33	48	0.6875000
NODE_66_length_7261_cov_12.433398	2313	2395	283	2	82	0.0243902
NODE_66_length_7261_cov_12.433398	2313	2395	284	1	82	0.0121951
NODE_66_length_7261_cov_12.433398	2313	2395	288	2	82	0.0243902
NODE_66_length_7261_cov_12.433398	2313	2395	289	2	82	0.0243902
NODE_66_length_7261_cov_12.433398	2313	2395	290	4	82	0.0487805
NODE_66_length_7261_cov_12.433398	2313	2395	292	1	82	0.0121951
NODE_66_length_7261_cov_12.433398	2313	2395	293	1	82	0.0121951
NODE_66_length_7261_cov_12.433398	2313	2395	294	4	82	0.0487805
NODE_66_length_7261_cov_12.433398	2313	2395	295	2	82	0.0243902
NODE_66_length_7261_cov_12.433398	2313	2395	296	2	82	0.0243902
NODE_66_length_7261_cov_12.433398	2313	2395	297	1	82	0.0121951
NODE_66_length_7261_cov_12.433398	2313	2395	300	3	82	0.0365854
NODE_66_length_7261_cov_12.433398	2313	2395	302	2	82	0.0243902
NODE_66_length_7261_cov_12.433398	2313	2395	305	2	82	0.0243902
NODE_66_length_7261_cov_12.433398	2313	2395	308	1	82	0.0121951
NODE_66_length_7261_cov_12.433398	2313	2395	309	2	82	0.0243902
NODE_66_length_7261_cov_12.433398	2313	2395	312	2	82	0.0243902
NODE_66_length_7261_cov_12.433398	2313	2395	314	1	82	0.0121951
NODE_66_length_7261_cov_12.433398	2313	2395	315	2	82	0.0243902
NODE_66_length_7261_cov_12.433398	2313	2395	318	1	82	0.0121951
NODE_66_length_7261_cov_12.433398	2313	2395	321	1	82	0.0121951
NODE_66_length_7261_cov_12.433398	2313	2395	335	1	82	0.0121951
NODE_66_length_7261_cov_12.433398	2313	2395	336	2	82	0.0243902
NODE_66_length_7261_cov_12.433398	2313	2395	353	1	82	0.0121951
NODE_66_length_7261_cov_12.433398	2313	2395	355	1	82	0.0121951
NODE_66_length_7261_cov_12.433398	2313	2395	357	2	82	0.0243902
NODE_66_length_7261_cov_12.433398	2313	2395	359	1	82	0.0121951
NODE_66_length_7261_cov_12.433398	2313	2395	362	1	82	0.0121951
NODE_66_length_7261_cov_12.433398	2313	2395	373	1	82	0.0121951
NODE_66_length_7261_cov_12.433398	2313	2395	375	1	82	0.0121951
NODE_66_length_7261_cov_12.433398	2313	2395	394	1	82	0.0121951
NODE_66_length_7261_cov_12.433398	2313	2395	400	1	82	0.0121951
NODE_66_length_7261_cov_12.433398	2313	2395	404	1	82	0.0121951
NODE_66_length_7261_cov_12.433398	2313	2395	425	1	82	0.0121951
NODE_66_length_7261_cov_12.433398	2313	2395	434	1	82	0.0121951
NODE_66_length_7261_cov_12.433398	2313	2395	449	1	82	0.0121951
NODE_66_length_7261_cov_12.433398	2313	2395	450	1	82	0.0121951
NODE_66_length_7261_cov_12.433398	2313	2395	451	1	82	0.0121951
NODE_66_length_7261_cov_12.433398	2313	2395	453	1	82	0.0121951
NODE_66_length_7261_cov_12.433398	2313	2395	459	1	82	0.0121951
NODE_66_length_7261_cov_12.433398	2313	2395	469	3	82	0.0365854
NODE_66_length_7261_cov_12.433398	2313	2395	477	1	82	0.0121951
NODE_66_length_7261_cov_12.433398	2313	2395	481	1	82	0.0121951
NODE_66_length_7261_cov_12.433398	2313	2395	483	1	82	0.0121951
NODE_66_length_7261_cov_12.433398	2313	2395	484	1	82	0.0121951
NODE_66_length_7261_cov_12.433398	2313	2395	487	1	82	0.0121951
NODE_66_length_7261_cov_12.433398	2313	2395	491	1	82	0.0121951
NODE_66_length_7261_cov_12.433398	2313	2395	492	1	82	0.0121951
NODE_66_length_7261_cov_12.433398	2313	2395	494	2	82	0.0243902
NODE_66_length_7261_cov_12.433398	2313	2395	501	2	82	0.0243902
NODE_66_length_7261_cov_12.433398	2313	2395	507	1	82	0.0121951
NODE_66_length_7261_cov_12.433398	2313	2395	511	1	82	0.0121951
NODE_66_length_7261_cov_12.433398	2313	2395	512	1	82	0.0121951
NODE_66_length_7261_cov_12.433398	2313	2395	514	3	82	0.0365854
NODE_66_length_7261_cov_12.433398	2313	2395	516	1	82	0.0121951
NODE_66_length_7261_cov_12.433398	2313	2395	523	1	82	0.0121951
NODE_73_length_7036_cov_65.961943	4375	4455	6	28	80	0.3500000
NODE_73_length_7036_cov_65.961943	4375	4455	7	1	80	0.0125000
NODE_73_length_7036_cov_65.961943	4375	4455	8	10	80	0.1250000
NODE_73_length_7036_cov_65.961943	4375	4455	9	17	80	0.2125000
NODE_73_length_7036_cov_65.961943	4375	4455	12	20	80	0.2500000
NODE_73_length_7036_cov_65.961943	4375	4455	13	4	80	0.0500000
NODE_73_length_7036_cov_65.961943	5538	5618	732	1	80	0.0125000
NODE_73_length_7036_cov_65.961943	5538	5618	734	1	80	0.0125000
NODE_73_length_7036_cov_65.961943	5538	5618	772	1	80	0.0125000
NODE_73_length_7036_cov_65.961943	5538	5618	778	1	80	0.0125000
NODE_73_length_7036_cov_65.961943	5538	5618	794	1	80	0.0125000
NODE_73_length_7036_cov_65.961943	5538	5618	805	1	80	0.0125000
NODE_73_length_7036_cov_65.961943	5538	5618	807	1	80	0.0125000
NODE_73_length_7036_cov_65.961943	5538	5618	841	1	80	0.0125000
NODE_73_length_7036_cov_65.961943	5538	5618	846	1	80	0.0125000
NODE_73_length_7036_cov_65.961943	5538	5618	864	1	80	0.0125000
NODE_73_length_7036_cov_65.961943	5538	5618	869	1	80	0.0125000
NODE_73_length_7036_cov_65.961943	5538	5618	894	1	80	0.0125000
NODE_73_length_7036_cov_65.961943	5538	5618	923	1	80	0.0125000
NODE_73_length_7036_cov_65.961943	5538	5618	931	1	80	0.0125000
NODE_73_length_7036_cov_65.961943	5538	5618	945	1	80	0.0125000
NODE_73_length_7036_cov_65.961943	5538	5618	962	1	80	0.0125000
NODE_73_length_7036_cov_65.961943	5538	5618	987	1	80	0.0125000
NODE_73_length_7036_cov_65.961943	5538	5618	1000	1	80	0.0125000
NODE_73_length_7036_cov_65.961943	5538	5618	1011	1	80	0.0125000
NODE_73_length_7036_cov_65.961943	5538	5618	1046	1	80	0.0125000
NODE_73_length_7036_cov_65.961943	5538	5618	1049	1	80	0.0125000
NODE_73_length_7036_cov_65.961943	5538	5618	1067	1	80	0.0125000
NODE_73_length_7036_cov_65.961943	5538	5618	1070	1	80	0.0125000
NODE_73_length_7036_cov_65.961943	5538	5618	1084	1	80	0.0125000
NODE_73_length_7036_cov_65.961943	5538	5618	1094	1	80	0.0125000
NODE_73_length_7036_cov_65.961943	5538	5618	1120	1	80	0.0125000
NODE_73_length_7036_cov_65.961943	5538	5618	1126	1	80	0.0125000
NODE_73_length_7036_cov_65.961943	5538	5618	1135	1	80	0.0125000
NODE_73_length_7036_cov_65.961943	5538	5618	1160	1	80	0.0125000
NODE_73_length_7036_cov_65.961943	5538	5618	1164	1	80	0.0125000
NODE_73_length_7036_cov_65.961943	5538	5618	1177	1	80	0.0125000
NODE_73_length_7036_cov_65.961943	5538	5618	1184	1	80	0.0125000
NODE_73_length_7036_cov_65.961943	5538	5618	1204	1	80	0.0125000
NODE_73_length_7036_cov_65.961943	5538	5618	1218	1	80	0.0125000
NODE_73_length_7036_cov_65.961943	5538	5618	1269	1	80	0.0125000
NODE_73_length_7036_cov_65.961943	5538	5618	1293	1	80	0.0125000
NODE_73_length_7036_cov_65.961943	5538	5618	1301	1	80	0.0125000
NODE_73_length_7036_cov_65.961943	5538	5618	1304	1	80	0.0125000
NODE_73_length_7036_cov_65.961943	5538	5618	1306	1	80	0.0125000
NODE_73_length_7036_cov_65.961943	5538	5618	1325	1	80	0.0125000
NODE_73_length_7036_cov_65.961943	5538	5618	1350	1	80	0.0125000
NODE_73_length_7036_cov_65.961943	5538	5618	1366	1	80	0.0125000
NODE_73_length_7036_cov_65.961943	5538	5618	1367	1	80	0.0125000
NODE_73_length_7036_cov_65.961943	5538	5618	1370	1	80	0.0125000
NODE_73_length_7036_cov_65.961943	5538	5618	1382	1	80	0.0125000
NODE_73_length_7036_cov_65.961943	5538	5618	1395	1	80	0.0125000
NODE_73_length_7036_cov_65.961943	5538	5618	1406	1	80	0.0125000
NODE_73_length_7036_cov_65.961943	5538	5618	1428	1	80	0.0125000
NODE_73_length_7036_cov_65.961943	5538	5618	1432	2	80	0.0250000
NODE_73_length_7036_cov_65.961943	5538	5618	1434	2	80	0.0250000
NODE_73_length_7036_cov_65.961943	5538	5618	1435	1	80	0.0125000
NODE_73_length_7036_cov_65.961943	5538	5618	1437	1	80	0.0125000
NODE_73_length_7036_cov_65.961943	5538	5618	1439	1	80	0.0125000
NODE_73_length_7036_cov_65.961943	5538	5618	1469	1	80	0.0125000
NODE_73_length_7036_cov_65.961943	5538	5618	1484	1	80	0.0125000
NODE_73_length_7036_cov_65.961943	5538	5618	1494	1	80	0.0125000
NODE_73_length_7036_cov_65.961943	5538	5618	1506	1	80	0.0125000
NODE_73_length_7036_cov_65.961943	5538	5618	1507	1	80	0.0125000
NODE_73_length_7036_cov_65.961943	5538	5618	1520	1	80	0.0125000
NODE_73_length_7036_cov_65.961943	5538	5618	1532	1	80	0.0125000
NODE_73_length_7036_cov_65.961943	5538	5618	1551	1	80	0.0125000
NODE_73_length_7036_cov_65.961943	5538	5618	1567	1	80	0.0125000
NODE_73_length_7036_cov_65.961943	5538	5618	1585	1	80	0.0125000
NODE_73_length_7036_cov_65.961943	5538	5618	1586	1	80	0.0125000
NODE_73_length_7036_cov_65.961943	5538	5618	1604	1	80	0.0125000
NODE_73_length_7036_cov_65.961943	5538	5618	1610	1	80	0.0125000
NODE_73_length_7036_cov_65.961943	5538	5618	1611	1	80	0.0125000
NODE_73_length_7036_cov_65.961943	5538	5618	1612	5	80	0.0625000
NODE_73_length_7036_cov_65.961943	5538	5618	1615	2	80	0.0250000
NODE_73_length_7036_cov_65.961943	5538	5618	1619	1	80	0.0125000
NODE_73_length_7036_cov_65.961943	5538	5618	1622	2	80	0.0250000
NODE_73_length_7036_cov_65.961943	5538	5618	1637	1	80	0.0125000
NODE_73_length_7036_cov_65.961943	5591	5666	1432	1	75	0.0133333
NODE_73_length_7036_cov_65.961943	5591	5666	1437	1	75	0.0133333
NODE_73_length_7036_cov_65.961943	5591	5666	1469	1	75	0.0133333
NODE_73_length_7036_cov_65.961943	5591	5666	1484	1	75	0.0133333
NODE_73_length_7036_cov_65.961943	5591	5666	1494	1	75	0.0133333
NODE_73_length_7036_cov_65.961943	5591	5666	1506	1	75	0.0133333
NODE_73_length_7036_cov_65.961943	5591	5666	1507	1	75	0.0133333
NODE_73_length_7036_cov_65.961943	5591	5666	1520	1	75	0.0133333
NODE_73_length_7036_cov_65.961943	5591	5666	1532	1	75	0.0133333
NODE_73_length_7036_cov_65.961943	5591	5666	1551	1	75	0.0133333
NODE_73_length_7036_cov_65.961943	5591	5666	1567	1	75	0.0133333
NODE_73_length_7036_cov_65.961943	5591	5666	1585	1	75	0.0133333
NODE_73_length_7036_cov_65.961943	5591	5666	1586	1	75	0.0133333
NODE_73_length_7036_cov_65.961943	5591	5666	1604	1	75	0.0133333
NODE_73_length_7036_cov_65.961943	5591	5666	1610	1	75	0.0133333
NODE_73_length_7036_cov_65.961943	5591	5666	1611	1	75	0.0133333
NODE_73_length_7036_cov_65.961943	5591	5666	1612	5	75	0.0666667
NODE_73_length_7036_cov_65.961943	5591	5666	1615	2	75	0.0266667
NODE_73_length_7036_cov_65.961943	5591	5666	1616	1	75	0.0133333
NODE_73_length_7036_cov_65.961943	5591	5666	1619	1	75	0.0133333
NODE_73_length_7036_cov_65.961943	5591	5666	1622	2	75	0.0266667
NODE_73_length_7036_cov_65.961943	5591	5666	1632	1	75	0.0133333
NODE_73_length_7036_cov_65.961943	5591	5666	1637	1	75	0.0133333
NODE_73_length_7036_cov_65.961943	5591	5666	1671	1	75	0.0133333
NODE_73_length_7036_cov_65.961943	5591	5666	1683	1	75	0.0133333
NODE_73_length_7036_cov_65.961943	5591	5666	1690	1	75	0.0133333
NODE_73_length_7036_cov_65.961943	5591	5666	1691	1	75	0.0133333
NODE_73_length_7036_cov_65.961943	5591	5666	1695	1	75	0.0133333
NODE_73_length_7036_cov_65.961943	5591	5666	1697	1	75	0.0133333
NODE_73_length_7036_cov_65.961943	5591	5666	1701	1	75	0.0133333
NODE_73_length_7036_cov_65.961943	5591	5666	1702	2	75	0.0266667
NODE_73_length_7036_cov_65.961943	5591	5666	1708	1	75	0.0133333
NODE_73_length_7036_cov_65.961943	5591	5666	1715	1	75	0.0133333
NODE_73_length_7036_cov_65.961943	5591	5666	1743	1	75	0.0133333
NODE_73_length_7036_cov_65.961943	5591	5666	1744	1	75	0.0133333
NODE_73_length_7036_cov_65.961943	5591	5666	1747	1	75	0.0133333
NODE_73_length_7036_cov_65.961943	5591	5666	1750	1	75	0.0133333
NODE_73_length_7036_cov_65.961943	5591	5666	1753	1	75	0.0133333
NODE_73_length_7036_cov_65.961943	5591	5666	1758	1	75	0.0133333
NODE_73_length_7036_cov_65.961943	5591	5666	1760	1	75	0.0133333
NODE_73_length_7036_cov_65.961943	5591	5666	1766	2	75	0.0266667
NODE_73_length_7036_cov_65.961943	5591	5666	1773	1	75	0.0133333
NODE_73_length_7036_cov_65.961943	5591	5666	1775	3	75	0.0400000
NODE_73_length_7036_cov_65.961943	5591	5666	1776	1	75	0.0133333
NODE_73_length_7036_cov_65.961943	5591	5666	1779	1	75	0.0133333
NODE_73_length_7036_cov_65.961943	5591	5666	1784	1	75	0.0133333
NODE_73_length_7036_cov_65.961943	5591	5666	1795	1	75	0.0133333
NODE_73_length_7036_cov_65.961943	5591	5666	1828	1	75	0.0133333
NODE_73_length_7036_cov_65.961943	5591	5666	1842	1	75	0.0133333
NODE_73_length_7036_cov_65.961943	5591	5666	1889	1	75	0.0133333
NODE_73_length_7036_cov_65.961943	5591	5666	1913	1	75	0.0133333
NODE_73_length_7036_cov_65.961943	5591	5666	1959	1	75	0.0133333
NODE_73_length_7036_cov_65.961943	5591	5666	1964	1	75	0.0133333
NODE_73_length_7036_cov_65.961943	5591	5666	1984	1	75	0.0133333
NODE_73_length_7036_cov_65.961943	5591	5666	1985	1	75	0.0133333
NODE_73_length_7036_cov_65.961943	5591	5666	1994	1	75	0.0133333
NODE_73_length_7036_cov_65.961943	5591	5666	2001	1	75	0.0133333
NODE_73_length_7036_cov_65.961943	5591	5666	2029	1	75	0.0133333
NODE_73_length_7036_cov_65.961943	5591	5666	2046	1	75	0.0133333
NODE_73_length_7036_cov_65.961943	5591	5666	2057	1	75	0.0133333
NODE_73_length_7036_cov_65.961943	5591	5666	2065	1	75	0.0133333
NODE_73_length_7036_cov_65.961943	5591	5666	2073	1	75	0.0133333
NODE_73_length_7036_cov_65.961943	5591	5666	2075	1	75	0.0133333
NODE_73_length_7036_cov_65.961943	5591	5666	2086	1	75	0.0133333
NODE_73_length_7036_cov_65.961943	5591	5666	2090	1	75	0.0133333
NODE_73_length_7036_cov_65.961943	5690	5746	2328	1	56	0.0178571
NODE_73_length_7036_cov_65.961943	5690	5746	2341	1	56	0.0178571
NODE_73_length_7036_cov_65.961943	5690	5746	2343	1	56	0.0178571
NODE_73_length_7036_cov_65.961943	5690	5746	2346	1	56	0.0178571
NODE_73_length_7036_cov_65.961943	5690	5746	2348	2	56	0.0357143
NODE_73_length_7036_cov_65.961943	5690	5746	2349	2	56	0.0357143
NODE_73_length_7036_cov_65.961943	5690	5746	2351	2	56	0.0357143
NODE_73_length_7036_cov_65.961943	5690	5746	2352	1	56	0.0178571
NODE_73_length_7036_cov_65.961943	5690	5746	2368	1	56	0.0178571
NODE_73_length_7036_cov_65.961943	5690	5746	2381	1	56	0.0178571
NODE_73_length_7036_cov_65.961943	5690	5746	2392	1	56	0.0178571
NODE_73_length_7036_cov_65.961943	5690	5746	2397	1	56	0.0178571
NODE_73_length_7036_cov_65.961943	5690	5746	2422	1	56	0.0178571
NODE_73_length_7036_cov_65.961943	5690	5746	2427	1	56	0.0178571
NODE_73_length_7036_cov_65.961943	5690	5746	2430	1	56	0.0178571
NODE_73_length_7036_cov_65.961943	5690	5746	2433	1	56	0.0178571
NODE_73_length_7036_cov_65.961943	5690	5746	2434	1	56	0.0178571
NODE_73_length_7036_cov_65.961943	5690	5746	2439	1	56	0.0178571
NODE_73_length_7036_cov_65.961943	5690	5746	2442	1	56	0.0178571
NODE_73_length_7036_cov_65.961943	5690	5746	2443	1	56	0.0178571
NODE_73_length_7036_cov_65.961943	5690	5746	2445	2	56	0.0357143
NODE_73_length_7036_cov_65.961943	5690	5746	2448	2	56	0.0357143
NODE_73_length_7036_cov_65.961943	5690	5746	2450	1	56	0.0178571
NODE_73_length_7036_cov_65.961943	5690	5746	2451	1	56	0.0178571
NODE_73_length_7036_cov_65.961943	5690	5746	2453	1	56	0.0178571
NODE_73_length_7036_cov_65.961943	5690	5746	2455	1	56	0.0178571
NODE_73_length_7036_cov_65.961943	5690	5746	2457	1	56	0.0178571
NODE_73_length_7036_cov_65.961943	5690	5746	2461	1	56	0.0178571
NODE_73_length_7036_cov_65.961943	5690	5746	2462	1	56	0.0178571
NODE_73_length_7036_cov_65.961943	5690	5746	2464	2	56	0.0357143
NODE_73_length_7036_cov_65.961943	5690	5746	2470	2	56	0.0357143
NODE_73_length_7036_cov_65.961943	5690	5746	2472	1	56	0.0178571
NODE_73_length_7036_cov_65.961943	5690	5746	2474	1	56	0.0178571
NODE_73_length_7036_cov_65.961943	5690	5746	2477	2	56	0.0357143
NODE_73_length_7036_cov_65.961943	5690	5746	2479	1	56	0.0178571
NODE_73_length_7036_cov_65.961943	5690	5746	2480	1	56	0.0178571
NODE_73_length_7036_cov_65.961943	5690	5746	2483	1	56	0.0178571
NODE_73_length_7036_cov_65.961943	5690	5746	2484	1	56	0.0178571
NODE_73_length_7036_cov_65.961943	5690	5746	2485	1	56	0.0178571
NODE_73_length_7036_cov_65.961943	5690	5746	2488	2	56	0.0357143
NODE_73_length_7036_cov_65.961943	5690	5746	2490	1	56	0.0178571
NODE_73_length_7036_cov_65.961943	5690	5746	2495	1	56	0.0178571
NODE_73_length_7036_cov_65.961943	5690	5746	2500	1	56	0.0178571
NODE_73_length_7036_cov_65.961943	5690	5746	2507	1	56	0.0178571
NODE_73_length_7036_cov_65.961943	5690	5746	2511	1	56	0.0178571
NODE_73_length_7036_cov_65.961943	5690	5746	2512	1	56	0.0178571
NODE_73_length_7036_cov_65.961943	5690	5746	2527	1	56	0.0178571
NODE_73_length_7036_cov_65.961943	6373	6453	0	18	80	0.2250000
NODE_73_length_7036_cov_65.961943	6373	6453	2	62	80	0.7750000
NODE_73_length_7036_cov_65.961943	6426	6506	0	71	80	0.8875000
NODE_73_length_7036_cov_65.961943	6426	6506	2	9	80	0.1125000
NODE_74_length_6974_cov_16.058327	976	1056	0	14	80	0.1750000
NODE_74_length_6974_cov_16.058327	976	1056	2	66	80	0.8250000
NODE_74_length_6974_cov_16.058327	1029	1109	0	62	80	0.7750000
NODE_74_length_6974_cov_16.058327	1029	1109	2	18	80	0.2250000
NODE_80_length_6826_cov_10.483574	4462	4542	0	10	80	0.1250000
NODE_80_length_6826_cov_10.483574	4462	4542	10	13	80	0.1625000
NODE_80_length_6826_cov_10.483574	4462	4542	12	2	80	0.0250000
NODE_80_length_6826_cov_10.483574	4462	4542	19	6	80	0.0750000
NODE_80_length_6826_cov_10.483574	4462	4542	23	2	80	0.0250000
NODE_80_length_6826_cov_10.483574	4462	4542	29	7	80	0.0875000
NODE_80_length_6826_cov_10.483574	4462	4542	30	28	80	0.3500000
NODE_80_length_6826_cov_10.483574	4462	4542	32	1	80	0.0125000
NODE_80_length_6826_cov_10.483574	4462	4542	34	6	80	0.0750000
NODE_80_length_6826_cov_10.483574	4462	4542	37	5	80	0.0625000
NODE_80_length_6826_cov_10.483574	4515	4595	30	15	80	0.1875000
NODE_80_length_6826_cov_10.483574	4515	4595	32	1	80	0.0125000
NODE_80_length_6826_cov_10.483574	4515	4595	34	6	80	0.0750000
NODE_80_length_6826_cov_10.483574	4515	4595	37	7	80	0.0875000
NODE_80_length_6826_cov_10.483574	4515	4595	39	25	80	0.3125000
NODE_80_length_6826_cov_10.483574	4515	4595	40	6	80	0.0750000
NODE_80_length_6826_cov_10.483574	4515	4595	41	5	80	0.0625000
NODE_80_length_6826_cov_10.483574	4515	4595	43	6	80	0.0750000
NODE_80_length_6826_cov_10.483574	4515	4595	44	9	80	0.1125000
NODE_81_length_6816_cov_2.820753	6726	6801	0	75	75	1.0000000
NODE_81_length_6816_cov_2.820753	6774	6816	0	42	42	1.0000000
NODE_84_length_6744_cov_6.222272	5	85	0	15	80	0.1875000
NODE_84_length_6744_cov_6.222272	5	85	1	1	80	0.0125000
NODE_84_length_6744_cov_6.222272	5	85	2	64	80	0.8000000
NODE_84_length_6744_cov_6.222272	58	138	0	11	80	0.1375000
NODE_84_length_6744_cov_6.222272	58	138	2	69	80	0.8625000
NODE_84_length_6744_cov_6.222272	6650	6730	2	8	80	0.1000000
NODE_84_length_6744_cov_6.222272	6650	6730	4	72	80	0.9000000
NODE_84_length_6744_cov_6.222272	6703	6744	0	1	41	0.0243902
NODE_84_length_6744_cov_6.222272	6703	6744	2	21	41	0.5121951
NODE_84_length_6744_cov_6.222272	6703	6744	4	19	41	0.4634146
NODE_86_length_6733_cov_88.965029	3141	3221	4	22	80	0.2750000
NODE_86_length_6733_cov_88.965029	3141	3221	15	1	80	0.0125000
NODE_86_length_6733_cov_88.965029	3141	3221	16	42	80	0.5250000
NODE_86_length_6733_cov_88.965029	3141	3221	18	15	80	0.1875000
NODE_86_length_6733_cov_88.965029	3194	3274	16	12	80	0.1500000
NODE_86_length_6733_cov_88.965029	3194	3274	18	45	80	0.5625000
NODE_86_length_6733_cov_88.965029	3194	3274	30	19	80	0.2375000
NODE_86_length_6733_cov_88.965029	3194	3274	32	1	80	0.0125000
NODE_86_length_6733_cov_88.965029	3194	3274	34	3	80	0.0375000
NODE_86_length_6733_cov_88.965029	3270	3350	23	27	80	0.3375000
NODE_86_length_6733_cov_88.965029	3270	3350	24	29	80	0.3625000
NODE_86_length_6733_cov_88.965029	3270	3350	26	19	80	0.2375000
NODE_86_length_6733_cov_88.965029	3270	3350	30	5	80	0.0625000
NODE_86_length_6733_cov_88.965029	3323	3403	8	41	80	0.5125000
NODE_86_length_6733_cov_88.965029	3323	3403	10	1	80	0.0125000
NODE_86_length_6733_cov_88.965029	3323	3403	23	38	80	0.4750000
NODE_90_length_6627_cov_9.440564	350	430	0	38	80	0.4750000
NODE_90_length_6627_cov_9.440564	350	430	4	42	80	0.5250000
NODE_90_length_6627_cov_9.440564	403	483	4	80	80	1.0000000
NODE_95_length_6507_cov_95.786049	171	247	2	73	76	0.9605263
NODE_95_length_6507_cov_95.786049	171	247	6	1	76	0.0131579
NODE_95_length_6507_cov_95.786049	171	247	8	1	76	0.0131579
NODE_95_length_6507_cov_95.786049	171	247	50	1	76	0.0131579
NODE_96_length_6497_cov_2.677399	366	436	20	14	70	0.2000000
NODE_96_length_6497_cov_2.677399	366	436	22	7	70	0.1000000
NODE_96_length_6497_cov_2.677399	366	436	24	10	70	0.1428571
NODE_96_length_6497_cov_2.677399	366	436	26	39	70	0.5571429
NODE_96_length_6497_cov_2.677399	409	444	20	7	35	0.2000000
NODE_96_length_6497_cov_2.677399	409	444	22	8	35	0.2285714
NODE_96_length_6497_cov_2.677399	409	444	24	8	35	0.2285714
NODE_96_length_6497_cov_2.677399	409	444	26	12	35	0.3428572
NODE_97_length_6450_cov_26.108172	5024	5104	16	16	80	0.2000000
NODE_97_length_6450_cov_26.108172	5024	5104	17	1	80	0.0125000
NODE_97_length_6450_cov_26.108172	5024	5104	18	2	80	0.0250000
NODE_97_length_6450_cov_26.108172	5024	5104	20	15	80	0.1875000
NODE_97_length_6450_cov_26.108172	5024	5104	22	30	80	0.3750000
NODE_97_length_6450_cov_26.108172	5024	5104	24	16	80	0.2000000
NODE_109_length_6171_cov_36.061100	3743	3813	31	1	70	0.0142857
NODE_109_length_6171_cov_36.061100	3743	3813	32	2	70	0.0285714
NODE_109_length_6171_cov_36.061100	3743	3813	38	1	70	0.0142857
NODE_109_length_6171_cov_36.061100	3743	3813	50	1	70	0.0142857
NODE_109_length_6171_cov_36.061100	3743	3813	52	1	70	0.0142857
NODE_109_length_6171_cov_36.061100	3743	3813	55	1	70	0.0142857
NODE_109_length_6171_cov_36.061100	3743	3813	58	3	70	0.0428571
NODE_109_length_6171_cov_36.061100	3743	3813	60	1	70	0.0142857
NODE_109_length_6171_cov_36.061100	3743	3813	62	1	70	0.0142857
NODE_109_length_6171_cov_36.061100	3743	3813	64	9	70	0.1285714
NODE_109_length_6171_cov_36.061100	3743	3813	65	4	70	0.0571429
NODE_109_length_6171_cov_36.061100	3743	3813	66	1	70	0.0142857
NODE_109_length_6171_cov_36.061100	3743	3813	68	1	70	0.0142857
NODE_109_length_6171_cov_36.061100	3743	3813	69	1	70	0.0142857
NODE_109_length_6171_cov_36.061100	3743	3813	71	1	70	0.0142857
NODE_109_length_6171_cov_36.061100	3743	3813	75	2	70	0.0285714
NODE_109_length_6171_cov_36.061100	3743	3813	77	3	70	0.0428571
NODE_109_length_6171_cov_36.061100	3743	3813	78	10	70	0.1428571
NODE_109_length_6171_cov_36.061100	3743	3813	86	1	70	0.0142857
NODE_109_length_6171_cov_36.061100	3743	3813	89	1	70	0.0142857
NODE_109_length_6171_cov_36.061100	3743	3813	91	12	70	0.1714286
NODE_109_length_6171_cov_36.061100	3743	3813	95	1	70	0.0142857
NODE_109_length_6171_cov_36.061100	3743	3813	100	3	70	0.0428571
NODE_109_length_6171_cov_36.061100	3743	3813	102	8	70	0.1142857
NODE_109_length_6171_cov_36.061100	3798	3851	63	1	53	0.0188679
NODE_109_length_6171_cov_36.061100	3798	3851	65	1	53	0.0188679
NODE_109_length_6171_cov_36.061100	3798	3851	71	2	53	0.0377358
NODE_109_length_6171_cov_36.061100	3798	3851	72	1	53	0.0188679
NODE_109_length_6171_cov_36.061100	3798	3851	73	2	53	0.0377358
NODE_109_length_6171_cov_36.061100	3798	3851	74	1	53	0.0188679
NODE_109_length_6171_cov_36.061100	3798	3851	75	2	53	0.0377358
NODE_109_length_6171_cov_36.061100	3798	3851	77	1	53	0.0188679
NODE_109_length_6171_cov_36.061100	3798	3851	86	2	53	0.0377358
NODE_109_length_6171_cov_36.061100	3798	3851	87	1	53	0.0188679
NODE_109_length_6171_cov_36.061100	3798	3851	91	3	53	0.0566038
NODE_109_length_6171_cov_36.061100	3798	3851	92	2	53	0.0377358
NODE_109_length_6171_cov_36.061100	3798	3851	94	1	53	0.0188679
NODE_109_length_6171_cov_36.061100	3798	3851	95	1	53	0.0188679
NODE_109_length_6171_cov_36.061100	3798	3851	96	4	53	0.0754717
NODE_109_length_6171_cov_36.061100	3798	3851	98	1	53	0.0188679
NODE_109_length_6171_cov_36.061100	3798	3851	100	5	53	0.0943396
NODE_109_length_6171_cov_36.061100	3798	3851	102	9	53	0.1698113
NODE_109_length_6171_cov_36.061100	3798	3851	104	4	53	0.0754717
NODE_109_length_6171_cov_36.061100	3798	3851	108	2	53	0.0377358
NODE_109_length_6171_cov_36.061100	3798	3851	110	2	53	0.0377358
NODE_109_length_6171_cov_36.061100	3798	3851	111	1	53	0.0188679
NODE_109_length_6171_cov_36.061100	3798	3851	113	3	53	0.0566038
NODE_109_length_6171_cov_36.061100	3798	3851	114	1	53	0.0188679
NODE_109_length_6171_cov_36.061100	4552	4596	643	1	44	0.0227273
NODE_109_length_6171_cov_36.061100	4552	4596	644	1	44	0.0227273
NODE_109_length_6171_cov_36.061100	4552	4596	645	1	44	0.0227273
NODE_109_length_6171_cov_36.061100	4552	4596	648	2	44	0.0454545
NODE_109_length_6171_cov_36.061100	4552	4596	649	1	44	0.0227273
NODE_109_length_6171_cov_36.061100	4552	4596	650	1	44	0.0227273
NODE_109_length_6171_cov_36.061100	4552	4596	651	2	44	0.0454545
NODE_109_length_6171_cov_36.061100	4552	4596	652	1	44	0.0227273
NODE_109_length_6171_cov_36.061100	4552	4596	655	1	44	0.0227273
NODE_109_length_6171_cov_36.061100	4552	4596	671	1	44	0.0227273
NODE_109_length_6171_cov_36.061100	4552	4596	674	4	44	0.0909091
NODE_109_length_6171_cov_36.061100	4552	4596	675	1	44	0.0227273
NODE_109_length_6171_cov_36.061100	4552	4596	678	1	44	0.0227273
NODE_109_length_6171_cov_36.061100	4552	4596	679	1	44	0.0227273
NODE_109_length_6171_cov_36.061100	4552	4596	680	1	44	0.0227273
NODE_109_length_6171_cov_36.061100	4552	4596	681	1	44	0.0227273
NODE_109_length_6171_cov_36.061100	4552	4596	682	2	44	0.0454545
NODE_109_length_6171_cov_36.061100	4552	4596	683	1	44	0.0227273
NODE_109_length_6171_cov_36.061100	4552	4596	685	1	44	0.0227273
NODE_109_length_6171_cov_36.061100	4552	4596	686	3	44	0.0681818
NODE_109_length_6171_cov_36.061100	4552	4596	688	2	44	0.0454545
NODE_109_length_6171_cov_36.061100	4552	4596	690	2	44	0.0454545
NODE_109_length_6171_cov_36.061100	4552	4596	691	2	44	0.0454545
NODE_109_length_6171_cov_36.061100	4552	4596	692	1	44	0.0227273
NODE_109_length_6171_cov_36.061100	4552	4596	694	1	44	0.0227273
NODE_109_length_6171_cov_36.061100	4552	4596	695	3	44	0.0681818
NODE_109_length_6171_cov_36.061100	4552	4596	697	1	44	0.0227273
NODE_109_length_6171_cov_36.061100	4552	4596	700	1	44	0.0227273
NODE_109_length_6171_cov_36.061100	4552	4596	705	1	44	0.0227273
NODE_109_length_6171_cov_36.061100	4552	4596	706	2	44	0.0454545
NODE_109_length_6171_cov_36.061100	4569	4649	658	1	80	0.0125000
NODE_109_length_6171_cov_36.061100	4569	4649	661	1	80	0.0125000
NODE_109_length_6171_cov_36.061100	4569	4649	663	1	80	0.0125000
NODE_109_length_6171_cov_36.061100	4569	4649	664	1	80	0.0125000
NODE_109_length_6171_cov_36.061100	4569	4649	669	1	80	0.0125000
NODE_109_length_6171_cov_36.061100	4569	4649	670	2	80	0.0250000
NODE_109_length_6171_cov_36.061100	4569	4649	671	1	80	0.0125000
NODE_109_length_6171_cov_36.061100	4569	4649	672	1	80	0.0125000
NODE_109_length_6171_cov_36.061100	4569	4649	673	2	80	0.0250000
NODE_109_length_6171_cov_36.061100	4569	4649	674	2	80	0.0250000
NODE_109_length_6171_cov_36.061100	4569	4649	676	1	80	0.0125000
NODE_109_length_6171_cov_36.061100	4569	4649	677	1	80	0.0125000
NODE_109_length_6171_cov_36.061100	4569	4649	678	1	80	0.0125000
NODE_109_length_6171_cov_36.061100	4569	4649	679	4	80	0.0500000
NODE_109_length_6171_cov_36.061100	4569	4649	680	1	80	0.0125000
NODE_109_length_6171_cov_36.061100	4569	4649	681	3	80	0.0375000
NODE_109_length_6171_cov_36.061100	4569	4649	682	5	80	0.0625000
NODE_109_length_6171_cov_36.061100	4569	4649	683	2	80	0.0250000
NODE_109_length_6171_cov_36.061100	4569	4649	685	3	80	0.0375000
NODE_109_length_6171_cov_36.061100	4569	4649	686	3	80	0.0375000
NODE_109_length_6171_cov_36.061100	4569	4649	688	2	80	0.0250000
NODE_109_length_6171_cov_36.061100	4569	4649	690	4	80	0.0500000
NODE_109_length_6171_cov_36.061100	4569	4649	691	2	80	0.0250000
NODE_109_length_6171_cov_36.061100	4569	4649	692	4	80	0.0500000
NODE_109_length_6171_cov_36.061100	4569	4649	693	2	80	0.0250000
NODE_109_length_6171_cov_36.061100	4569	4649	694	2	80	0.0250000
NODE_109_length_6171_cov_36.061100	4569	4649	695	4	80	0.0500000
NODE_109_length_6171_cov_36.061100	4569	4649	697	3	80	0.0375000
NODE_109_length_6171_cov_36.061100	4569	4649	698	2	80	0.0250000
NODE_109_length_6171_cov_36.061100	4569	4649	700	2	80	0.0250000
NODE_109_length_6171_cov_36.061100	4569	4649	701	1	80	0.0125000
NODE_109_length_6171_cov_36.061100	4569	4649	702	2	80	0.0250000
NODE_109_length_6171_cov_36.061100	4569	4649	703	1	80	0.0125000
NODE_109_length_6171_cov_36.061100	4569	4649	705	2	80	0.0250000
NODE_109_length_6171_cov_36.061100	4569	4649	706	2	80	0.0250000
NODE_109_length_6171_cov_36.061100	4569	4649	707	1	80	0.0125000
NODE_109_length_6171_cov_36.061100	4569	4649	708	1	80	0.0125000
NODE_109_length_6171_cov_36.061100	4569	4649	709	3	80	0.0375000
NODE_109_length_6171_cov_36.061100	4569	4649	710	2	80	0.0250000
NODE_109_length_6171_cov_36.061100	4569	4649	711	1	80	0.0125000
NODE_109_length_6171_cov_36.061100	5742	5788	0	46	46	1.0000000
NODE_109_length_6171_cov_36.061100	5761	5841	0	80	80	1.0000000
NODE_110_length_6148_cov_58.915358	5602	5682	0	80	80	1.0000000
NODE_110_length_6148_cov_58.915358	5655	5735	0	80	80	1.0000000
NODE_112_length_6026_cov_17.775772	4124	4204	4	6	80	0.0750000
NODE_112_length_6026_cov_17.775772	4124	4204	6	27	80	0.3375000
NODE_112_length_6026_cov_17.775772	4124	4204	7	47	80	0.5875000
NODE_112_length_6026_cov_17.775772	4177	4257	0	25	80	0.3125000
NODE_112_length_6026_cov_17.775772	4177	4257	2	24	80	0.3000000
NODE_112_length_6026_cov_17.775772	4177	4257	4	10	80	0.1250000
NODE_112_length_6026_cov_17.775772	4177	4257	6	21	80	0.2625000
NODE_112_length_6026_cov_17.775772	4253	4333	0	17	80	0.2125000
NODE_112_length_6026_cov_17.775772	4253	4333	2	6	80	0.0750000
NODE_112_length_6026_cov_17.775772	4253	4333	4	4	80	0.0500000
NODE_112_length_6026_cov_17.775772	4253	4333	8	53	80	0.6625000
NODE_112_length_6026_cov_17.775772	4306	4386	4	8	80	0.1000000
NODE_112_length_6026_cov_17.775772	4306	4386	6	15	80	0.1875000
NODE_112_length_6026_cov_17.775772	4306	4386	8	34	80	0.4250000
NODE_112_length_6026_cov_17.775772	4306	4386	9	1	80	0.0125000
NODE_112_length_6026_cov_17.775772	4306	4386	10	22	80	0.2750000
NODE_124_length_5810_cov_24.750657	2064	2144	14	19	80	0.2375000
NODE_124_length_5810_cov_24.750657	2064	2144	15	3	80	0.0375000
NODE_124_length_5810_cov_24.750657	2064	2144	16	9	80	0.1125000
NODE_124_length_5810_cov_24.750657	2064	2144	18	21	80	0.2625000
NODE_124_length_5810_cov_24.750657	2064	2144	19	1	80	0.0125000
NODE_124_length_5810_cov_24.750657	2064	2144	23	1	80	0.0125000
NODE_124_length_5810_cov_24.750657	2064	2144	29	3	80	0.0375000
NODE_124_length_5810_cov_24.750657	2064	2144	31	2	80	0.0250000
NODE_124_length_5810_cov_24.750657	2064	2144	33	2	80	0.0250000
NODE_124_length_5810_cov_24.750657	2064	2144	39	2	80	0.0250000
NODE_124_length_5810_cov_24.750657	2064	2144	42	3	80	0.0375000
NODE_124_length_5810_cov_24.750657	2064	2144	43	2	80	0.0250000
NODE_124_length_5810_cov_24.750657	2064	2144	44	4	80	0.0500000
NODE_124_length_5810_cov_24.750657	2064	2144	45	2	80	0.0250000
NODE_124_length_5810_cov_24.750657	2064	2144	46	6	80	0.0750000
NODE_124_length_5810_cov_24.750657	2117	2194	12	35	77	0.4545455
NODE_124_length_5810_cov_24.750657	2117	2194	14	12	77	0.1558442
NODE_124_length_5810_cov_24.750657	2117	2194	15	1	77	0.0129870
NODE_124_length_5810_cov_24.750657	2117	2194	16	9	77	0.1168831
NODE_124_length_5810_cov_24.750657	2117	2194	18	20	77	0.2597403
NODE_127_length_5771_cov_10.854549	2814	2883	0	4	69	0.0579710
NODE_127_length_5771_cov_10.854549	2814	2883	2	27	69	0.3913043
NODE_127_length_5771_cov_10.854549	2814	2883	4	38	69	0.5507246
NODE_128_length_5769_cov_6.878483	5701	5731	2	30	30	1.0000000
NODE_133_length_5728_cov_16.351039	63	134	2	71	71	1.0000000
NODE_133_length_5728_cov_16.351039	2960	3040	0	66	80	0.8250000
NODE_133_length_5728_cov_16.351039	2960	3040	2	14	80	0.1750000
NODE_133_length_5728_cov_16.351039	5106	5172	60	1	66	0.0151515
NODE_133_length_5728_cov_16.351039	5106	5172	65	6	66	0.0909091
NODE_133_length_5728_cov_16.351039	5106	5172	66	1	66	0.0151515
NODE_133_length_5728_cov_16.351039	5106	5172	70	4	66	0.0606061
NODE_133_length_5728_cov_16.351039	5106	5172	72	2	66	0.0303030
NODE_133_length_5728_cov_16.351039	5106	5172	74	6	66	0.0909091
NODE_133_length_5728_cov_16.351039	5106	5172	75	7	66	0.1060606
NODE_133_length_5728_cov_16.351039	5106	5172	76	2	66	0.0303030
NODE_133_length_5728_cov_16.351039	5106	5172	82	1	66	0.0151515
NODE_133_length_5728_cov_16.351039	5106	5172	83	2	66	0.0303030
NODE_133_length_5728_cov_16.351039	5106	5172	84	1	66	0.0151515
NODE_133_length_5728_cov_16.351039	5106	5172	85	1	66	0.0151515
NODE_133_length_5728_cov_16.351039	5106	5172	86	11	66	0.1666667
NODE_133_length_5728_cov_16.351039	5106	5172	87	6	66	0.0909091
NODE_133_length_5728_cov_16.351039	5106	5172	89	4	66	0.0606061
NODE_133_length_5728_cov_16.351039	5106	5172	91	2	66	0.0303030
NODE_133_length_5728_cov_16.351039	5106	5172	93	1	66	0.0151515
NODE_133_length_5728_cov_16.351039	5106	5172	95	5	66	0.0757576
NODE_133_length_5728_cov_16.351039	5106	5172	97	3	66	0.0454545
NODE_133_length_5728_cov_16.351039	5145	5225	82	1	80	0.0125000
NODE_133_length_5728_cov_16.351039	5145	5225	83	1	80	0.0125000
NODE_133_length_5728_cov_16.351039	5145	5225	86	4	80	0.0500000
NODE_133_length_5728_cov_16.351039	5145	5225	87	6	80	0.0750000
NODE_133_length_5728_cov_16.351039	5145	5225	89	4	80	0.0500000
NODE_133_length_5728_cov_16.351039	5145	5225	91	2	80	0.0250000
NODE_133_length_5728_cov_16.351039	5145	5225	93	1	80	0.0125000
NODE_133_length_5728_cov_16.351039	5145	5225	95	5	80	0.0625000
NODE_133_length_5728_cov_16.351039	5145	5225	97	6	80	0.0750000
NODE_133_length_5728_cov_16.351039	5145	5225	98	5	80	0.0625000
NODE_133_length_5728_cov_16.351039	5145	5225	99	1	80	0.0125000
NODE_133_length_5728_cov_16.351039	5145	5225	100	1	80	0.0125000
NODE_133_length_5728_cov_16.351039	5145	5225	101	3	80	0.0375000
NODE_133_length_5728_cov_16.351039	5145	5225	102	8	80	0.1000000
NODE_133_length_5728_cov_16.351039	5145	5225	103	10	80	0.1250000
NODE_133_length_5728_cov_16.351039	5145	5225	104	7	80	0.0875000
NODE_133_length_5728_cov_16.351039	5145	5225	105	7	80	0.0875000
NODE_133_length_5728_cov_16.351039	5145	5225	106	6	80	0.0750000
NODE_133_length_5728_cov_16.351039	5145	5225	107	1	80	0.0125000
NODE_133_length_5728_cov_16.351039	5145	5225	108	1	80	0.0125000
NODE_137_length_5696_cov_20.656244	179	258	0	79	79	1.0000000
NODE_137_length_5696_cov_20.656244	231	311	0	80	80	1.0000000
NODE_137_length_5696_cov_20.656244	307	387	0	80	80	1.0000000
NODE_137_length_5696_cov_20.656244	360	440	0	63	80	0.7875000
NODE_137_length_5696_cov_20.656244	360	440	2	17	80	0.2125000
NODE_137_length_5696_cov_20.656244	5100	5180	0	54	80	0.6750000
NODE_137_length_5696_cov_20.656244	5100	5180	2	26	80	0.3250000
NODE_137_length_5696_cov_20.656244	5153	5233	0	21	80	0.2625000
NODE_137_length_5696_cov_20.656244	5153	5233	2	59	80	0.7375000
NODE_137_length_5696_cov_20.656244	5280	5360	0	1	80	0.0125000
NODE_137_length_5696_cov_20.656244	5280	5360	2	72	80	0.9000000
NODE_137_length_5696_cov_20.656244	5280	5360	5	3	80	0.0375000
NODE_137_length_5696_cov_20.656244	5280	5360	6	4	80	0.0500000
NODE_137_length_5696_cov_20.656244	5333	5413	0	1	80	0.0125000
NODE_137_length_5696_cov_20.656244	5333	5413	2	19	80	0.2375000
NODE_137_length_5696_cov_20.656244	5333	5413	5	3	80	0.0375000
NODE_137_length_5696_cov_20.656244	5333	5413	6	57	80	0.7125000
NODE_139_length_5681_cov_68.065030	253	333	4	2	80	0.0250000
NODE_139_length_5681_cov_68.065030	253	333	6	5	80	0.0625000
NODE_139_length_5681_cov_68.065030	253	333	9	1	80	0.0125000
NODE_139_length_5681_cov_68.065030	253	333	10	22	80	0.2750000
NODE_139_length_5681_cov_68.065030	253	333	14	31	80	0.3875000
NODE_139_length_5681_cov_68.065030	253	333	16	7	80	0.0875000
NODE_139_length_5681_cov_68.065030	253	333	22	12	80	0.1500000
NODE_139_length_5681_cov_68.065030	306	386	14	8	80	0.1000000
NODE_139_length_5681_cov_68.065030	306	386	15	5	80	0.0625000
NODE_139_length_5681_cov_68.065030	306	386	16	7	80	0.0875000
NODE_139_length_5681_cov_68.065030	306	386	20	10	80	0.1250000
NODE_139_length_5681_cov_68.065030	306	386	21	19	80	0.2375000
NODE_139_length_5681_cov_68.065030	306	386	22	31	80	0.3875000
NODE_139_length_5681_cov_68.065030	4762	4842	339	1	80	0.0125000
NODE_139_length_5681_cov_68.065030	4762	4842	347	1	80	0.0125000
NODE_139_length_5681_cov_68.065030	4762	4842	351	6	80	0.0750000
NODE_139_length_5681_cov_68.065030	4762	4842	352	1	80	0.0125000
NODE_139_length_5681_cov_68.065030	4762	4842	357	1	80	0.0125000
NODE_139_length_5681_cov_68.065030	4762	4842	358	1	80	0.0125000
NODE_139_length_5681_cov_68.065030	4762	4842	369	6	80	0.0750000
NODE_139_length_5681_cov_68.065030	4762	4842	371	5	80	0.0625000
NODE_139_length_5681_cov_68.065030	4762	4842	372	1	80	0.0125000
NODE_139_length_5681_cov_68.065030	4762	4842	373	5	80	0.0625000
NODE_139_length_5681_cov_68.065030	4762	4842	374	2	80	0.0250000
NODE_139_length_5681_cov_68.065030	4762	4842	375	1	80	0.0125000
NODE_139_length_5681_cov_68.065030	4762	4842	379	2	80	0.0250000
NODE_139_length_5681_cov_68.065030	4762	4842	381	1	80	0.0125000
NODE_139_length_5681_cov_68.065030	4762	4842	382	1	80	0.0125000
NODE_139_length_5681_cov_68.065030	4762	4842	389	2	80	0.0250000
NODE_139_length_5681_cov_68.065030	4762	4842	390	1	80	0.0125000
NODE_139_length_5681_cov_68.065030	4762	4842	391	4	80	0.0500000
NODE_139_length_5681_cov_68.065030	4762	4842	392	4	80	0.0500000
NODE_139_length_5681_cov_68.065030	4762	4842	393	1	80	0.0125000
NODE_139_length_5681_cov_68.065030	4762	4842	396	2	80	0.0250000
NODE_139_length_5681_cov_68.065030	4762	4842	397	1	80	0.0125000
NODE_139_length_5681_cov_68.065030	4762	4842	401	2	80	0.0250000
NODE_139_length_5681_cov_68.065030	4762	4842	402	3	80	0.0375000
NODE_139_length_5681_cov_68.065030	4762	4842	403	3	80	0.0375000
NODE_139_length_5681_cov_68.065030	4762	4842	404	3	80	0.0375000
NODE_139_length_5681_cov_68.065030	4762	4842	405	4	80	0.0500000
NODE_139_length_5681_cov_68.065030	4762	4842	410	1	80	0.0125000
NODE_139_length_5681_cov_68.065030	4762	4842	411	1	80	0.0125000
NODE_139_length_5681_cov_68.065030	4762	4842	412	6	80	0.0750000
NODE_139_length_5681_cov_68.065030	4762	4842	413	2	80	0.0250000
NODE_139_length_5681_cov_68.065030	4762	4842	415	1	80	0.0125000
NODE_139_length_5681_cov_68.065030	4762	4842	416	4	80	0.0500000
NODE_139_length_5681_cov_68.065030	4762	4842	339	1	80	0.0125000
NODE_139_length_5681_cov_68.065030	4762	4842	347	1	80	0.0125000
NODE_139_length_5681_cov_68.065030	4762	4842	351	6	80	0.0750000
NODE_139_length_5681_cov_68.065030	4762	4842	352	1	80	0.0125000
NODE_139_length_5681_cov_68.065030	4762	4842	357	1	80	0.0125000
NODE_139_length_5681_cov_68.065030	4762	4842	358	1	80	0.0125000
NODE_139_length_5681_cov_68.065030	4762	4842	369	6	80	0.0750000
NODE_139_length_5681_cov_68.065030	4762	4842	371	5	80	0.0625000
NODE_139_length_5681_cov_68.065030	4762	4842	372	1	80	0.0125000
NODE_139_length_5681_cov_68.065030	4762	4842	373	5	80	0.0625000
NODE_139_length_5681_cov_68.065030	4762	4842	374	2	80	0.0250000
NODE_139_length_5681_cov_68.065030	4762	4842	375	1	80	0.0125000
NODE_139_length_5681_cov_68.065030	4762	4842	379	2	80	0.0250000
NODE_139_length_5681_cov_68.065030	4762	4842	381	1	80	0.0125000
NODE_139_length_5681_cov_68.065030	4762	4842	382	1	80	0.0125000
NODE_139_length_5681_cov_68.065030	4762	4842	389	2	80	0.0250000
NODE_139_length_5681_cov_68.065030	4762	4842	390	1	80	0.0125000
NODE_139_length_5681_cov_68.065030	4762	4842	391	4	80	0.0500000
NODE_139_length_5681_cov_68.065030	4762	4842	392	4	80	0.0500000
NODE_139_length_5681_cov_68.065030	4762	4842	393	1	80	0.0125000
NODE_139_length_5681_cov_68.065030	4762	4842	396	2	80	0.0250000
NODE_139_length_5681_cov_68.065030	4762	4842	397	1	80	0.0125000
NODE_139_length_5681_cov_68.065030	4762	4842	401	2	80	0.0250000
NODE_139_length_5681_cov_68.065030	4762	4842	402	3	80	0.0375000
NODE_139_length_5681_cov_68.065030	4762	4842	403	3	80	0.0375000
NODE_139_length_5681_cov_68.065030	4762	4842	404	3	80	0.0375000
NODE_139_length_5681_cov_68.065030	4762	4842	405	4	80	0.0500000
NODE_139_length_5681_cov_68.065030	4762	4842	410	1	80	0.0125000
NODE_139_length_5681_cov_68.065030	4762	4842	411	1	80	0.0125000
NODE_139_length_5681_cov_68.065030	4762	4842	412	6	80	0.0750000
NODE_139_length_5681_cov_68.065030	4762	4842	413	2	80	0.0250000
NODE_139_length_5681_cov_68.065030	4762	4842	415	1	80	0.0125000
NODE_139_length_5681_cov_68.065030	4762	4842	416	4	80	0.0500000
NODE_139_length_5681_cov_68.065030	4762	4842	339	1	80	0.0125000
NODE_139_length_5681_cov_68.065030	4762	4842	347	1	80	0.0125000
NODE_139_length_5681_cov_68.065030	4762	4842	351	6	80	0.0750000
NODE_139_length_5681_cov_68.065030	4762	4842	352	1	80	0.0125000
NODE_139_length_5681_cov_68.065030	4762	4842	357	1	80	0.0125000
NODE_139_length_5681_cov_68.065030	4762	4842	358	1	80	0.0125000
NODE_139_length_5681_cov_68.065030	4762	4842	369	6	80	0.0750000
NODE_139_length_5681_cov_68.065030	4762	4842	371	5	80	0.0625000
NODE_139_length_5681_cov_68.065030	4762	4842	372	1	80	0.0125000
NODE_139_length_5681_cov_68.065030	4762	4842	373	5	80	0.0625000
NODE_139_length_5681_cov_68.065030	4762	4842	374	2	80	0.0250000
NODE_139_length_5681_cov_68.065030	4762	4842	375	1	80	0.0125000
NODE_139_length_5681_cov_68.065030	4762	4842	379	2	80	0.0250000
NODE_139_length_5681_cov_68.065030	4762	4842	381	1	80	0.0125000
NODE_139_length_5681_cov_68.065030	4762	4842	382	1	80	0.0125000
NODE_139_length_5681_cov_68.065030	4762	4842	389	2	80	0.0250000
NODE_139_length_5681_cov_68.065030	4762	4842	390	1	80	0.0125000
NODE_139_length_5681_cov_68.065030	4762	4842	391	4	80	0.0500000
NODE_139_length_5681_cov_68.065030	4762	4842	392	4	80	0.0500000
NODE_139_length_5681_cov_68.065030	4762	4842	393	1	80	0.0125000
NODE_139_length_5681_cov_68.065030	4762	4842	396	2	80	0.0250000
NODE_139_length_5681_cov_68.065030	4762	4842	397	1	80	0.0125000
NODE_139_length_5681_cov_68.065030	4762	4842	401	2	80	0.0250000
NODE_139_length_5681_cov_68.065030	4762	4842	402	3	80	0.0375000
NODE_139_length_5681_cov_68.065030	4762	4842	403	3	80	0.0375000
NODE_139_length_5681_cov_68.065030	4762	4842	404	3	80	0.0375000
NODE_139_length_5681_cov_68.065030	4762	4842	405	4	80	0.0500000
NODE_139_length_5681_cov_68.065030	4762	4842	410	1	80	0.0125000
NODE_139_length_5681_cov_68.065030	4762	4842	411	1	80	0.0125000
NODE_139_length_5681_cov_68.065030	4762	4842	412	6	80	0.0750000
NODE_139_length_5681_cov_68.065030	4762	4842	413	2	80	0.0250000
NODE_139_length_5681_cov_68.065030	4762	4842	415	1	80	0.0125000
NODE_139_length_5681_cov_68.065030	4762	4842	416	4	80	0.0500000
NODE_139_length_5681_cov_68.065030	4762	4842	339	1	80	0.0125000
NODE_139_length_5681_cov_68.065030	4762	4842	347	1	80	0.0125000
NODE_139_length_5681_cov_68.065030	4762	4842	351	6	80	0.0750000
NODE_139_length_5681_cov_68.065030	4762	4842	352	1	80	0.0125000
NODE_139_length_5681_cov_68.065030	4762	4842	357	1	80	0.0125000
NODE_139_length_5681_cov_68.065030	4762	4842	358	1	80	0.0125000
NODE_139_length_5681_cov_68.065030	4762	4842	369	6	80	0.0750000
NODE_139_length_5681_cov_68.065030	4762	4842	371	5	80	0.0625000
NODE_139_length_5681_cov_68.065030	4762	4842	372	1	80	0.0125000
NODE_139_length_5681_cov_68.065030	4762	4842	373	5	80	0.0625000
NODE_139_length_5681_cov_68.065030	4762	4842	374	2	80	0.0250000
NODE_139_length_5681_cov_68.065030	4762	4842	375	1	80	0.0125000
NODE_139_length_5681_cov_68.065030	4762	4842	379	2	80	0.0250000
NODE_139_length_5681_cov_68.065030	4762	4842	381	1	80	0.0125000
NODE_139_length_5681_cov_68.065030	4762	4842	382	1	80	0.0125000
NODE_139_length_5681_cov_68.065030	4762	4842	389	2	80	0.0250000
NODE_139_length_5681_cov_68.065030	4762	4842	390	1	80	0.0125000
NODE_139_length_5681_cov_68.065030	4762	4842	391	4	80	0.0500000
NODE_139_length_5681_cov_68.065030	4762	4842	392	4	80	0.0500000
NODE_139_length_5681_cov_68.065030	4762	4842	393	1	80	0.0125000
NODE_139_length_5681_cov_68.065030	4762	4842	396	2	80	0.0250000
NODE_139_length_5681_cov_68.065030	4762	4842	397	1	80	0.0125000
NODE_139_length_5681_cov_68.065030	4762	4842	401	2	80	0.0250000
NODE_139_length_5681_cov_68.065030	4762	4842	402	3	80	0.0375000
NODE_139_length_5681_cov_68.065030	4762	4842	403	3	80	0.0375000
NODE_139_length_5681_cov_68.065030	4762	4842	404	3	80	0.0375000
NODE_139_length_5681_cov_68.065030	4762	4842	405	4	80	0.0500000
NODE_139_length_5681_cov_68.065030	4762	4842	410	1	80	0.0125000
NODE_139_length_5681_cov_68.065030	4762	4842	411	1	80	0.0125000
NODE_139_length_5681_cov_68.065030	4762	4842	412	6	80	0.0750000
NODE_139_length_5681_cov_68.065030	4762	4842	413	2	80	0.0250000
NODE_139_length_5681_cov_68.065030	4762	4842	415	1	80	0.0125000
NODE_139_length_5681_cov_68.065030	4762	4842	416	4	80	0.0500000
NODE_139_length_5681_cov_68.065030	4762	4842	339	1	80	0.0125000
NODE_139_length_5681_cov_68.065030	4762	4842	347	1	80	0.0125000
NODE_139_length_5681_cov_68.065030	4762	4842	351	6	80	0.0750000
NODE_139_length_5681_cov_68.065030	4762	4842	352	1	80	0.0125000
NODE_139_length_5681_cov_68.065030	4762	4842	357	1	80	0.0125000
NODE_139_length_5681_cov_68.065030	4762	4842	358	1	80	0.0125000
NODE_139_length_5681_cov_68.065030	4762	4842	369	6	80	0.0750000
NODE_139_length_5681_cov_68.065030	4762	4842	371	5	80	0.0625000
NODE_139_length_5681_cov_68.065030	4762	4842	372	1	80	0.0125000
NODE_139_length_5681_cov_68.065030	4762	4842	373	5	80	0.0625000
NODE_139_length_5681_cov_68.065030	4762	4842	374	2	80	0.0250000
NODE_139_length_5681_cov_68.065030	4762	4842	375	1	80	0.0125000
NODE_139_length_5681_cov_68.065030	4762	4842	379	2	80	0.0250000
NODE_139_length_5681_cov_68.065030	4762	4842	381	1	80	0.0125000
NODE_139_length_5681_cov_68.065030	4762	4842	382	1	80	0.0125000
NODE_139_length_5681_cov_68.065030	4762	4842	389	2	80	0.0250000
NODE_139_length_5681_cov_68.065030	4762	4842	390	1	80	0.0125000
NODE_139_length_5681_cov_68.065030	4762	4842	391	4	80	0.0500000
NODE_139_length_5681_cov_68.065030	4762	4842	392	4	80	0.0500000
NODE_139_length_5681_cov_68.065030	4762	4842	393	1	80	0.0125000
NODE_139_length_5681_cov_68.065030	4762	4842	396	2	80	0.0250000
NODE_139_length_5681_cov_68.065030	4762	4842	397	1	80	0.0125000
NODE_139_length_5681_cov_68.065030	4762	4842	401	2	80	0.0250000
NODE_139_length_5681_cov_68.065030	4762	4842	402	3	80	0.0375000
NODE_139_length_5681_cov_68.065030	4762	4842	403	3	80	0.0375000
NODE_139_length_5681_cov_68.065030	4762	4842	404	3	80	0.0375000
NODE_139_length_5681_cov_68.065030	4762	4842	405	4	80	0.0500000
NODE_139_length_5681_cov_68.065030	4762	4842	410	1	80	0.0125000
NODE_139_length_5681_cov_68.065030	4762	4842	411	1	80	0.0125000
NODE_139_length_5681_cov_68.065030	4762	4842	412	6	80	0.0750000
NODE_139_length_5681_cov_68.065030	4762	4842	413	2	80	0.0250000
NODE_139_length_5681_cov_68.065030	4762	4842	415	1	80	0.0125000
NODE_139_length_5681_cov_68.065030	4762	4842	416	4	80	0.0500000
NODE_139_length_5681_cov_68.065030	4762	4842	339	1	80	0.0125000
NODE_139_length_5681_cov_68.065030	4762	4842	347	1	80	0.0125000
NODE_139_length_5681_cov_68.065030	4762	4842	351	6	80	0.0750000
NODE_139_length_5681_cov_68.065030	4762	4842	352	1	80	0.0125000
NODE_139_length_5681_cov_68.065030	4762	4842	357	1	80	0.0125000
NODE_139_length_5681_cov_68.065030	4762	4842	358	1	80	0.0125000
NODE_139_length_5681_cov_68.065030	4762	4842	369	6	80	0.0750000
NODE_139_length_5681_cov_68.065030	4762	4842	371	5	80	0.0625000
NODE_139_length_5681_cov_68.065030	4762	4842	372	1	80	0.0125000
NODE_139_length_5681_cov_68.065030	4762	4842	373	5	80	0.0625000
NODE_139_length_5681_cov_68.065030	4762	4842	374	2	80	0.0250000
NODE_139_length_5681_cov_68.065030	4762	4842	375	1	80	0.0125000
NODE_139_length_5681_cov_68.065030	4762	4842	379	2	80	0.0250000
NODE_139_length_5681_cov_68.065030	4762	4842	381	1	80	0.0125000
NODE_139_length_5681_cov_68.065030	4762	4842	382	1	80	0.0125000
NODE_139_length_5681_cov_68.065030	4762	4842	389	2	80	0.0250000
NODE_139_length_5681_cov_68.065030	4762	4842	390	1	80	0.0125000
NODE_139_length_5681_cov_68.065030	4762	4842	391	4	80	0.0500000
NODE_139_length_5681_cov_68.065030	4762	4842	392	4	80	0.0500000
NODE_139_length_5681_cov_68.065030	4762	4842	393	1	80	0.0125000
NODE_139_length_5681_cov_68.065030	4762	4842	396	2	80	0.0250000
NODE_139_length_5681_cov_68.065030	4762	4842	397	1	80	0.0125000
NODE_139_length_5681_cov_68.065030	4762	4842	401	2	80	0.0250000
NODE_139_length_5681_cov_68.065030	4762	4842	402	3	80	0.0375000
NODE_139_length_5681_cov_68.065030	4762	4842	403	3	80	0.0375000
NODE_139_length_5681_cov_68.065030	4762	4842	404	3	80	0.0375000
NODE_139_length_5681_cov_68.065030	4762	4842	405	4	80	0.0500000
NODE_139_length_5681_cov_68.065030	4762	4842	410	1	80	0.0125000
NODE_139_length_5681_cov_68.065030	4762	4842	411	1	80	0.0125000
NODE_139_length_5681_cov_68.065030	4762	4842	412	6	80	0.0750000
NODE_139_length_5681_cov_68.065030	4762	4842	413	2	80	0.0250000
NODE_139_length_5681_cov_68.065030	4762	4842	415	1	80	0.0125000
NODE_139_length_5681_cov_68.065030	4762	4842	416	4	80	0.0500000
NODE_139_length_5681_cov_68.065030	4769	4839	358	1	70	0.0142857
NODE_139_length_5681_cov_68.065030	4769	4839	369	6	70	0.0857143
NODE_139_length_5681_cov_68.065030	4769	4839	371	5	70	0.0714286
NODE_139_length_5681_cov_68.065030	4769	4839	372	1	70	0.0142857
NODE_139_length_5681_cov_68.065030	4769	4839	373	5	70	0.0714286
NODE_139_length_5681_cov_68.065030	4769	4839	374	2	70	0.0285714
NODE_139_length_5681_cov_68.065030	4769	4839	375	1	70	0.0142857
NODE_139_length_5681_cov_68.065030	4769	4839	379	2	70	0.0285714
NODE_139_length_5681_cov_68.065030	4769	4839	381	1	70	0.0142857
NODE_139_length_5681_cov_68.065030	4769	4839	382	1	70	0.0142857
NODE_139_length_5681_cov_68.065030	4769	4839	389	2	70	0.0285714
NODE_139_length_5681_cov_68.065030	4769	4839	390	1	70	0.0142857
NODE_139_length_5681_cov_68.065030	4769	4839	391	4	70	0.0571429
NODE_139_length_5681_cov_68.065030	4769	4839	392	4	70	0.0571429
NODE_139_length_5681_cov_68.065030	4769	4839	393	1	70	0.0142857
NODE_139_length_5681_cov_68.065030	4769	4839	396	2	70	0.0285714
NODE_139_length_5681_cov_68.065030	4769	4839	397	1	70	0.0142857
NODE_139_length_5681_cov_68.065030	4769	4839	401	2	70	0.0285714
NODE_139_length_5681_cov_68.065030	4769	4839	402	3	70	0.0428571
NODE_139_length_5681_cov_68.065030	4769	4839	403	3	70	0.0428571
NODE_139_length_5681_cov_68.065030	4769	4839	404	3	70	0.0428571
NODE_139_length_5681_cov_68.065030	4769	4839	405	4	70	0.0571429
NODE_139_length_5681_cov_68.065030	4769	4839	410	1	70	0.0142857
NODE_139_length_5681_cov_68.065030	4769	4839	411	1	70	0.0142857
NODE_139_length_5681_cov_68.065030	4769	4839	412	6	70	0.0857143
NODE_139_length_5681_cov_68.065030	4769	4839	413	2	70	0.0285714
NODE_139_length_5681_cov_68.065030	4769	4839	415	1	70	0.0142857
NODE_139_length_5681_cov_68.065030	4769	4839	416	4	70	0.0571429
NODE_139_length_5681_cov_68.065030	4771	4842	339	1	71	0.0140845
NODE_139_length_5681_cov_68.065030	4771	4842	347	1	71	0.0140845
NODE_139_length_5681_cov_68.065030	4771	4842	357	1	71	0.0140845
NODE_139_length_5681_cov_68.065030	4771	4842	358	1	71	0.0140845
NODE_139_length_5681_cov_68.065030	4771	4842	369	6	71	0.0845070
NODE_139_length_5681_cov_68.065030	4771	4842	371	5	71	0.0704225
NODE_139_length_5681_cov_68.065030	4771	4842	372	1	71	0.0140845
NODE_139_length_5681_cov_68.065030	4771	4842	373	5	71	0.0704225
NODE_139_length_5681_cov_68.065030	4771	4842	374	1	71	0.0140845
NODE_139_length_5681_cov_68.065030	4771	4842	375	1	71	0.0140845
NODE_139_length_5681_cov_68.065030	4771	4842	379	2	71	0.0281690
NODE_139_length_5681_cov_68.065030	4771	4842	381	1	71	0.0140845
NODE_139_length_5681_cov_68.065030	4771	4842	382	1	71	0.0140845
NODE_139_length_5681_cov_68.065030	4771	4842	389	2	71	0.0281690
NODE_139_length_5681_cov_68.065030	4771	4842	391	4	71	0.0563380
NODE_139_length_5681_cov_68.065030	4771	4842	392	4	71	0.0563380
NODE_139_length_5681_cov_68.065030	4771	4842	393	1	71	0.0140845
NODE_139_length_5681_cov_68.065030	4771	4842	396	2	71	0.0281690
NODE_139_length_5681_cov_68.065030	4771	4842	397	1	71	0.0140845
NODE_139_length_5681_cov_68.065030	4771	4842	401	2	71	0.0281690
NODE_139_length_5681_cov_68.065030	4771	4842	402	3	71	0.0422535
NODE_139_length_5681_cov_68.065030	4771	4842	403	3	71	0.0422535
NODE_139_length_5681_cov_68.065030	4771	4842	404	3	71	0.0422535
NODE_139_length_5681_cov_68.065030	4771	4842	405	4	71	0.0563380
NODE_139_length_5681_cov_68.065030	4771	4842	410	1	71	0.0140845
NODE_139_length_5681_cov_68.065030	4771	4842	411	1	71	0.0140845
NODE_139_length_5681_cov_68.065030	4771	4842	412	6	71	0.0845070
NODE_139_length_5681_cov_68.065030	4771	4842	413	2	71	0.0281690
NODE_139_length_5681_cov_68.065030	4771	4842	415	1	71	0.0140845
NODE_139_length_5681_cov_68.065030	4771	4842	416	4	71	0.0563380
NODE_139_length_5681_cov_68.065030	4815	4895	169	14	80	0.1750000
NODE_139_length_5681_cov_68.065030	4815	4895	190	2	80	0.0250000
NODE_139_length_5681_cov_68.065030	4815	4895	212	1	80	0.0125000
NODE_139_length_5681_cov_68.065030	4815	4895	258	4	80	0.0500000
NODE_139_length_5681_cov_68.065030	4815	4895	260	5	80	0.0625000
NODE_139_length_5681_cov_68.065030	4815	4895	265	1	80	0.0125000
NODE_139_length_5681_cov_68.065030	4815	4895	266	3	80	0.0375000
NODE_139_length_5681_cov_68.065030	4815	4895	273	2	80	0.0250000
NODE_139_length_5681_cov_68.065030	4815	4895	275	1	80	0.0125000
NODE_139_length_5681_cov_68.065030	4815	4895	291	1	80	0.0125000
NODE_139_length_5681_cov_68.065030	4815	4895	292	2	80	0.0250000
NODE_139_length_5681_cov_68.065030	4815	4895	294	1	80	0.0125000
NODE_139_length_5681_cov_68.065030	4815	4895	301	2	80	0.0250000
NODE_139_length_5681_cov_68.065030	4815	4895	303	1	80	0.0125000
NODE_139_length_5681_cov_68.065030	4815	4895	307	1	80	0.0125000
NODE_139_length_5681_cov_68.065030	4815	4895	310	4	80	0.0500000
NODE_139_length_5681_cov_68.065030	4815	4895	314	1	80	0.0125000
NODE_139_length_5681_cov_68.065030	4815	4895	329	2	80	0.0250000
NODE_139_length_5681_cov_68.065030	4815	4895	334	1	80	0.0125000
NODE_139_length_5681_cov_68.065030	4815	4895	339	5	80	0.0625000
NODE_139_length_5681_cov_68.065030	4815	4895	347	1	80	0.0125000
NODE_139_length_5681_cov_68.065030	4815	4895	357	1	80	0.0125000
NODE_139_length_5681_cov_68.065030	4815	4895	358	1	80	0.0125000
NODE_139_length_5681_cov_68.065030	4815	4895	369	6	80	0.0750000
NODE_139_length_5681_cov_68.065030	4815	4895	371	5	80	0.0625000
NODE_139_length_5681_cov_68.065030	4815	4895	372	1	80	0.0125000
NODE_139_length_5681_cov_68.065030	4815	4895	373	5	80	0.0625000
NODE_139_length_5681_cov_68.065030	4815	4895	374	1	80	0.0125000
NODE_139_length_5681_cov_68.065030	4815	4895	375	1	80	0.0125000
NODE_139_length_5681_cov_68.065030	4815	4895	379	2	80	0.0250000
NODE_139_length_5681_cov_68.065030	4815	4895	381	1	80	0.0125000
NODE_139_length_5681_cov_68.065030	4815	4895	382	1	80	0.0125000
NODE_139_length_5681_cov_68.065030	4815	4895	169	14	80	0.1750000
NODE_139_length_5681_cov_68.065030	4815	4895	190	2	80	0.0250000
NODE_139_length_5681_cov_68.065030	4815	4895	212	1	80	0.0125000
NODE_139_length_5681_cov_68.065030	4815	4895	258	4	80	0.0500000
NODE_139_length_5681_cov_68.065030	4815	4895	260	5	80	0.0625000
NODE_139_length_5681_cov_68.065030	4815	4895	265	1	80	0.0125000
NODE_139_length_5681_cov_68.065030	4815	4895	266	3	80	0.0375000
NODE_139_length_5681_cov_68.065030	4815	4895	273	2	80	0.0250000
NODE_139_length_5681_cov_68.065030	4815	4895	275	1	80	0.0125000
NODE_139_length_5681_cov_68.065030	4815	4895	291	1	80	0.0125000
NODE_139_length_5681_cov_68.065030	4815	4895	292	2	80	0.0250000
NODE_139_length_5681_cov_68.065030	4815	4895	294	1	80	0.0125000
NODE_139_length_5681_cov_68.065030	4815	4895	301	2	80	0.0250000
NODE_139_length_5681_cov_68.065030	4815	4895	303	1	80	0.0125000
NODE_139_length_5681_cov_68.065030	4815	4895	307	1	80	0.0125000
NODE_139_length_5681_cov_68.065030	4815	4895	310	4	80	0.0500000
NODE_139_length_5681_cov_68.065030	4815	4895	314	1	80	0.0125000
NODE_139_length_5681_cov_68.065030	4815	4895	329	2	80	0.0250000
NODE_139_length_5681_cov_68.065030	4815	4895	334	1	80	0.0125000
NODE_139_length_5681_cov_68.065030	4815	4895	339	5	80	0.0625000
NODE_139_length_5681_cov_68.065030	4815	4895	347	1	80	0.0125000
NODE_139_length_5681_cov_68.065030	4815	4895	357	1	80	0.0125000
NODE_139_length_5681_cov_68.065030	4815	4895	358	1	80	0.0125000
NODE_139_length_5681_cov_68.065030	4815	4895	369	6	80	0.0750000
NODE_139_length_5681_cov_68.065030	4815	4895	371	5	80	0.0625000
NODE_139_length_5681_cov_68.065030	4815	4895	372	1	80	0.0125000
NODE_139_length_5681_cov_68.065030	4815	4895	373	5	80	0.0625000
NODE_139_length_5681_cov_68.065030	4815	4895	374	1	80	0.0125000
NODE_139_length_5681_cov_68.065030	4815	4895	375	1	80	0.0125000
NODE_139_length_5681_cov_68.065030	4815	4895	379	2	80	0.0250000
NODE_139_length_5681_cov_68.065030	4815	4895	381	1	80	0.0125000
NODE_139_length_5681_cov_68.065030	4815	4895	382	1	80	0.0125000
NODE_139_length_5681_cov_68.065030	4815	4895	169	14	80	0.1750000
NODE_139_length_5681_cov_68.065030	4815	4895	190	2	80	0.0250000
NODE_139_length_5681_cov_68.065030	4815	4895	212	1	80	0.0125000
NODE_139_length_5681_cov_68.065030	4815	4895	258	4	80	0.0500000
NODE_139_length_5681_cov_68.065030	4815	4895	260	5	80	0.0625000
NODE_139_length_5681_cov_68.065030	4815	4895	265	1	80	0.0125000
NODE_139_length_5681_cov_68.065030	4815	4895	266	3	80	0.0375000
NODE_139_length_5681_cov_68.065030	4815	4895	273	2	80	0.0250000
NODE_139_length_5681_cov_68.065030	4815	4895	275	1	80	0.0125000
NODE_139_length_5681_cov_68.065030	4815	4895	291	1	80	0.0125000
NODE_139_length_5681_cov_68.065030	4815	4895	292	2	80	0.0250000
NODE_139_length_5681_cov_68.065030	4815	4895	294	1	80	0.0125000
NODE_139_length_5681_cov_68.065030	4815	4895	301	2	80	0.0250000
NODE_139_length_5681_cov_68.065030	4815	4895	303	1	80	0.0125000
NODE_139_length_5681_cov_68.065030	4815	4895	307	1	80	0.0125000
NODE_139_length_5681_cov_68.065030	4815	4895	310	4	80	0.0500000
NODE_139_length_5681_cov_68.065030	4815	4895	314	1	80	0.0125000
NODE_139_length_5681_cov_68.065030	4815	4895	329	2	80	0.0250000
NODE_139_length_5681_cov_68.065030	4815	4895	334	1	80	0.0125000
NODE_139_length_5681_cov_68.065030	4815	4895	339	5	80	0.0625000
NODE_139_length_5681_cov_68.065030	4815	4895	347	1	80	0.0125000
NODE_139_length_5681_cov_68.065030	4815	4895	357	1	80	0.0125000
NODE_139_length_5681_cov_68.065030	4815	4895	358	1	80	0.0125000
NODE_139_length_5681_cov_68.065030	4815	4895	369	6	80	0.0750000
NODE_139_length_5681_cov_68.065030	4815	4895	371	5	80	0.0625000
NODE_139_length_5681_cov_68.065030	4815	4895	372	1	80	0.0125000
NODE_139_length_5681_cov_68.065030	4815	4895	373	5	80	0.0625000
NODE_139_length_5681_cov_68.065030	4815	4895	374	1	80	0.0125000
NODE_139_length_5681_cov_68.065030	4815	4895	375	1	80	0.0125000
NODE_139_length_5681_cov_68.065030	4815	4895	379	2	80	0.0250000
NODE_139_length_5681_cov_68.065030	4815	4895	381	1	80	0.0125000
NODE_139_length_5681_cov_68.065030	4815	4895	382	1	80	0.0125000
NODE_139_length_5681_cov_68.065030	4815	4895	169	14	80	0.1750000
NODE_139_length_5681_cov_68.065030	4815	4895	190	2	80	0.0250000
NODE_139_length_5681_cov_68.065030	4815	4895	212	1	80	0.0125000
NODE_139_length_5681_cov_68.065030	4815	4895	258	4	80	0.0500000
NODE_139_length_5681_cov_68.065030	4815	4895	260	5	80	0.0625000
NODE_139_length_5681_cov_68.065030	4815	4895	265	1	80	0.0125000
NODE_139_length_5681_cov_68.065030	4815	4895	266	3	80	0.0375000
NODE_139_length_5681_cov_68.065030	4815	4895	273	2	80	0.0250000
NODE_139_length_5681_cov_68.065030	4815	4895	275	1	80	0.0125000
NODE_139_length_5681_cov_68.065030	4815	4895	291	1	80	0.0125000
NODE_139_length_5681_cov_68.065030	4815	4895	292	2	80	0.0250000
NODE_139_length_5681_cov_68.065030	4815	4895	294	1	80	0.0125000
NODE_139_length_5681_cov_68.065030	4815	4895	301	2	80	0.0250000
NODE_139_length_5681_cov_68.065030	4815	4895	303	1	80	0.0125000
NODE_139_length_5681_cov_68.065030	4815	4895	307	1	80	0.0125000
NODE_139_length_5681_cov_68.065030	4815	4895	310	4	80	0.0500000
NODE_139_length_5681_cov_68.065030	4815	4895	314	1	80	0.0125000
NODE_139_length_5681_cov_68.065030	4815	4895	329	2	80	0.0250000
NODE_139_length_5681_cov_68.065030	4815	4895	334	1	80	0.0125000
NODE_139_length_5681_cov_68.065030	4815	4895	339	5	80	0.0625000
NODE_139_length_5681_cov_68.065030	4815	4895	347	1	80	0.0125000
NODE_139_length_5681_cov_68.065030	4815	4895	357	1	80	0.0125000
NODE_139_length_5681_cov_68.065030	4815	4895	358	1	80	0.0125000
NODE_139_length_5681_cov_68.065030	4815	4895	369	6	80	0.0750000
NODE_139_length_5681_cov_68.065030	4815	4895	371	5	80	0.0625000
NODE_139_length_5681_cov_68.065030	4815	4895	372	1	80	0.0125000
NODE_139_length_5681_cov_68.065030	4815	4895	373	5	80	0.0625000
NODE_139_length_5681_cov_68.065030	4815	4895	374	1	80	0.0125000
NODE_139_length_5681_cov_68.065030	4815	4895	375	1	80	0.0125000
NODE_139_length_5681_cov_68.065030	4815	4895	379	2	80	0.0250000
NODE_139_length_5681_cov_68.065030	4815	4895	381	1	80	0.0125000
NODE_139_length_5681_cov_68.065030	4815	4895	382	1	80	0.0125000
NODE_139_length_5681_cov_68.065030	4815	4895	169	14	80	0.1750000
NODE_139_length_5681_cov_68.065030	4815	4895	190	2	80	0.0250000
NODE_139_length_5681_cov_68.065030	4815	4895	212	1	80	0.0125000
NODE_139_length_5681_cov_68.065030	4815	4895	258	4	80	0.0500000
NODE_139_length_5681_cov_68.065030	4815	4895	260	5	80	0.0625000
NODE_139_length_5681_cov_68.065030	4815	4895	265	1	80	0.0125000
NODE_139_length_5681_cov_68.065030	4815	4895	266	3	80	0.0375000
NODE_139_length_5681_cov_68.065030	4815	4895	273	2	80	0.0250000
NODE_139_length_5681_cov_68.065030	4815	4895	275	1	80	0.0125000
NODE_139_length_5681_cov_68.065030	4815	4895	291	1	80	0.0125000
NODE_139_length_5681_cov_68.065030	4815	4895	292	2	80	0.0250000
NODE_139_length_5681_cov_68.065030	4815	4895	294	1	80	0.0125000
NODE_139_length_5681_cov_68.065030	4815	4895	301	2	80	0.0250000
NODE_139_length_5681_cov_68.065030	4815	4895	303	1	80	0.0125000
NODE_139_length_5681_cov_68.065030	4815	4895	307	1	80	0.0125000
NODE_139_length_5681_cov_68.065030	4815	4895	310	4	80	0.0500000
NODE_139_length_5681_cov_68.065030	4815	4895	314	1	80	0.0125000
NODE_139_length_5681_cov_68.065030	4815	4895	329	2	80	0.0250000
NODE_139_length_5681_cov_68.065030	4815	4895	334	1	80	0.0125000
NODE_139_length_5681_cov_68.065030	4815	4895	339	5	80	0.0625000
NODE_139_length_5681_cov_68.065030	4815	4895	347	1	80	0.0125000
NODE_139_length_5681_cov_68.065030	4815	4895	357	1	80	0.0125000
NODE_139_length_5681_cov_68.065030	4815	4895	358	1	80	0.0125000
NODE_139_length_5681_cov_68.065030	4815	4895	369	6	80	0.0750000
NODE_139_length_5681_cov_68.065030	4815	4895	371	5	80	0.0625000
NODE_139_length_5681_cov_68.065030	4815	4895	372	1	80	0.0125000
NODE_139_length_5681_cov_68.065030	4815	4895	373	5	80	0.0625000
NODE_139_length_5681_cov_68.065030	4815	4895	374	1	80	0.0125000
NODE_139_length_5681_cov_68.065030	4815	4895	375	1	80	0.0125000
NODE_139_length_5681_cov_68.065030	4815	4895	379	2	80	0.0250000
NODE_139_length_5681_cov_68.065030	4815	4895	381	1	80	0.0125000
NODE_139_length_5681_cov_68.065030	4815	4895	382	1	80	0.0125000
NODE_139_length_5681_cov_68.065030	4815	4895	169	14	80	0.1750000
NODE_139_length_5681_cov_68.065030	4815	4895	190	2	80	0.0250000
NODE_139_length_5681_cov_68.065030	4815	4895	212	1	80	0.0125000
NODE_139_length_5681_cov_68.065030	4815	4895	258	4	80	0.0500000
NODE_139_length_5681_cov_68.065030	4815	4895	260	5	80	0.0625000
NODE_139_length_5681_cov_68.065030	4815	4895	265	1	80	0.0125000
NODE_139_length_5681_cov_68.065030	4815	4895	266	3	80	0.0375000
NODE_139_length_5681_cov_68.065030	4815	4895	273	2	80	0.0250000
NODE_139_length_5681_cov_68.065030	4815	4895	275	1	80	0.0125000
NODE_139_length_5681_cov_68.065030	4815	4895	291	1	80	0.0125000
NODE_139_length_5681_cov_68.065030	4815	4895	292	2	80	0.0250000
NODE_139_length_5681_cov_68.065030	4815	4895	294	1	80	0.0125000
NODE_139_length_5681_cov_68.065030	4815	4895	301	2	80	0.0250000
NODE_139_length_5681_cov_68.065030	4815	4895	303	1	80	0.0125000
NODE_139_length_5681_cov_68.065030	4815	4895	307	1	80	0.0125000
NODE_139_length_5681_cov_68.065030	4815	4895	310	4	80	0.0500000
NODE_139_length_5681_cov_68.065030	4815	4895	314	1	80	0.0125000
NODE_139_length_5681_cov_68.065030	4815	4895	329	2	80	0.0250000
NODE_139_length_5681_cov_68.065030	4815	4895	334	1	80	0.0125000
NODE_139_length_5681_cov_68.065030	4815	4895	339	5	80	0.0625000
NODE_139_length_5681_cov_68.065030	4815	4895	347	1	80	0.0125000
NODE_139_length_5681_cov_68.065030	4815	4895	357	1	80	0.0125000
NODE_139_length_5681_cov_68.065030	4815	4895	358	1	80	0.0125000
NODE_139_length_5681_cov_68.065030	4815	4895	369	6	80	0.0750000
NODE_139_length_5681_cov_68.065030	4815	4895	371	5	80	0.0625000
NODE_139_length_5681_cov_68.065030	4815	4895	372	1	80	0.0125000
NODE_139_length_5681_cov_68.065030	4815	4895	373	5	80	0.0625000
NODE_139_length_5681_cov_68.065030	4815	4895	374	1	80	0.0125000
NODE_139_length_5681_cov_68.065030	4815	4895	375	1	80	0.0125000
NODE_139_length_5681_cov_68.065030	4815	4895	379	2	80	0.0250000
NODE_139_length_5681_cov_68.065030	4815	4895	381	1	80	0.0125000
NODE_139_length_5681_cov_68.065030	4815	4895	382	1	80	0.0125000
NODE_139_length_5681_cov_68.065030	4891	4971	12	7	80	0.0875000
NODE_139_length_5681_cov_68.065030	4891	4971	13	7	80	0.0875000
NODE_139_length_5681_cov_68.065030	4891	4971	22	11	80	0.1375000
NODE_139_length_5681_cov_68.065030	4891	4971	23	2	80	0.0250000
NODE_139_length_5681_cov_68.065030	4891	4971	24	25	80	0.3125000
NODE_139_length_5681_cov_68.065030	4891	4971	47	1	80	0.0125000
NODE_139_length_5681_cov_68.065030	4891	4971	49	4	80	0.0500000
NODE_139_length_5681_cov_68.065030	4891	4971	59	1	80	0.0125000
NODE_139_length_5681_cov_68.065030	4891	4971	60	1	80	0.0125000
NODE_139_length_5681_cov_68.065030	4891	4971	84	2	80	0.0250000
NODE_139_length_5681_cov_68.065030	4891	4971	89	2	80	0.0250000
NODE_139_length_5681_cov_68.065030	4891	4971	93	3	80	0.0375000
NODE_139_length_5681_cov_68.065030	4891	4971	95	3	80	0.0375000
NODE_139_length_5681_cov_68.065030	4891	4971	107	1	80	0.0125000
NODE_139_length_5681_cov_68.065030	4891	4971	149	1	80	0.0125000
NODE_139_length_5681_cov_68.065030	4891	4971	151	1	80	0.0125000
NODE_139_length_5681_cov_68.065030	4891	4971	152	1	80	0.0125000
NODE_139_length_5681_cov_68.065030	4891	4971	167	1	80	0.0125000
NODE_139_length_5681_cov_68.065030	4891	4971	169	6	80	0.0750000
NODE_139_length_5681_cov_68.065030	4944	5007	7	5	63	0.0793651
NODE_139_length_5681_cov_68.065030	4944	5007	9	16	63	0.2539683
NODE_139_length_5681_cov_68.065030	4944	5007	11	7	63	0.1111111
NODE_139_length_5681_cov_68.065030	4944	5007	12	7	63	0.1111111
NODE_139_length_5681_cov_68.065030	4944	5007	13	15	63	0.2380952
NODE_139_length_5681_cov_68.065030	4944	5007	24	13	63	0.2063492
NODE_139_length_5681_cov_68.065030	4944	5024	2	2	80	0.0250000
NODE_139_length_5681_cov_68.065030	4944	5024	4	6	80	0.0750000
NODE_139_length_5681_cov_68.065030	4944	5024	6	9	80	0.1125000
NODE_139_length_5681_cov_68.065030	4944	5024	7	5	80	0.0625000
NODE_139_length_5681_cov_68.065030	4944	5024	9	16	80	0.2000000
NODE_139_length_5681_cov_68.065030	4944	5024	11	7	80	0.0875000
NODE_139_length_5681_cov_68.065030	4944	5024	12	7	80	0.0875000
NODE_139_length_5681_cov_68.065030	4944	5024	13	15	80	0.1875000
NODE_139_length_5681_cov_68.065030	4944	5024	24	13	80	0.1625000
NODE_140_length_5677_cov_21.613482	1792	1863	86	1	71	0.0140845
NODE_140_length_5677_cov_21.613482	1792	1863	87	2	71	0.0281690
NODE_140_length_5677_cov_21.613482	1792	1863	88	4	71	0.0563380
NODE_140_length_5677_cov_21.613482	1792	1863	89	5	71	0.0704225
NODE_140_length_5677_cov_21.613482	1792	1863	90	4	71	0.0563380
NODE_140_length_5677_cov_21.613482	1792	1863	91	1	71	0.0140845
NODE_140_length_5677_cov_21.613482	1792	1863	92	7	71	0.0985916
NODE_140_length_5677_cov_21.613482	1792	1863	93	1	71	0.0140845
NODE_140_length_5677_cov_21.613482	1792	1863	94	4	71	0.0563380
NODE_140_length_5677_cov_21.613482	1792	1863	95	4	71	0.0563380
NODE_140_length_5677_cov_21.613482	1792	1863	96	2	71	0.0281690
NODE_140_length_5677_cov_21.613482	1792	1863	97	8	71	0.1126761
NODE_140_length_5677_cov_21.613482	1792	1863	98	11	71	0.1549296
NODE_140_length_5677_cov_21.613482	1792	1863	99	5	71	0.0704225
NODE_140_length_5677_cov_21.613482	1792	1863	100	7	71	0.0985916
NODE_140_length_5677_cov_21.613482	1792	1863	101	3	71	0.0422535
NODE_140_length_5677_cov_21.613482	1792	1863	102	2	71	0.0281690
NODE_140_length_5677_cov_21.613482	1845	1916	79	1	71	0.0140845
NODE_140_length_5677_cov_21.613482	1845	1916	81	1	71	0.0140845
NODE_140_length_5677_cov_21.613482	1845	1916	87	1	71	0.0140845
NODE_140_length_5677_cov_21.613482	1845	1916	89	5	71	0.0704225
NODE_140_length_5677_cov_21.613482	1845	1916	94	3	71	0.0422535
NODE_140_length_5677_cov_21.613482	1845	1916	95	5	71	0.0704225
NODE_140_length_5677_cov_21.613482	1845	1916	96	4	71	0.0563380
NODE_140_length_5677_cov_21.613482	1845	1916	97	16	71	0.2253521
NODE_140_length_5677_cov_21.613482	1845	1916	98	13	71	0.1830986
NODE_140_length_5677_cov_21.613482	1845	1916	99	7	71	0.0985916
NODE_140_length_5677_cov_21.613482	1845	1916	100	4	71	0.0563380
NODE_140_length_5677_cov_21.613482	1845	1916	101	7	71	0.0985916
NODE_140_length_5677_cov_21.613482	1845	1916	102	2	71	0.0281690
NODE_140_length_5677_cov_21.613482	1845	1916	103	2	71	0.0281690
NODE_142_length_5631_cov_25.927332	96	176	20	1	80	0.0125000
NODE_142_length_5631_cov_25.927332	96	176	30	29	80	0.3625000
NODE_142_length_5631_cov_25.927332	96	176	32	2	80	0.0250000
NODE_142_length_5631_cov_25.927332	96	176	34	10	80	0.1250000
NODE_142_length_5631_cov_25.927332	96	176	36	35	80	0.4375000
NODE_142_length_5631_cov_25.927332	96	176	38	3	80	0.0375000
NODE_142_length_5631_cov_25.927332	149	229	10	2	80	0.0250000
NODE_142_length_5631_cov_25.927332	149	229	12	9	80	0.1125000
NODE_142_length_5631_cov_25.927332	149	229	21	1	80	0.0125000
NODE_142_length_5631_cov_25.927332	149	229	22	18	80	0.2250000
NODE_142_length_5631_cov_25.927332	149	229	26	6	80	0.0750000
NODE_142_length_5631_cov_25.927332	149	229	30	6	80	0.0750000
NODE_142_length_5631_cov_25.927332	149	229	32	8	80	0.1000000
NODE_142_length_5631_cov_25.927332	149	229	34	7	80	0.0875000
NODE_142_length_5631_cov_25.927332	149	229	36	20	80	0.2500000
NODE_142_length_5631_cov_25.927332	149	229	38	3	80	0.0375000
NODE_146_length_5588_cov_40.961377	2793	2873	2	3	80	0.0375000
NODE_146_length_5588_cov_40.961377	2793	2873	4	13	80	0.1625000
NODE_146_length_5588_cov_40.961377	2793	2873	6	4	80	0.0500000
NODE_146_length_5588_cov_40.961377	2793	2873	8	22	80	0.2750000
NODE_146_length_5588_cov_40.961377	2793	2873	9	5	80	0.0625000
NODE_146_length_5588_cov_40.961377	2793	2873	10	33	80	0.4125000
NODE_146_length_5588_cov_40.961377	2846	2926	0	52	80	0.6500000
NODE_146_length_5588_cov_40.961377	2846	2926	2	4	80	0.0500000
NODE_146_length_5588_cov_40.961377	2846	2926	8	14	80	0.1750000
NODE_146_length_5588_cov_40.961377	2846	2926	10	10	80	0.1250000
NODE_146_length_5588_cov_40.961377	2922	3002	0	62	80	0.7750000
NODE_146_length_5588_cov_40.961377	2922	3002	4	11	80	0.1375000
NODE_146_length_5588_cov_40.961377	2922	3002	5	1	80	0.0125000
NODE_146_length_5588_cov_40.961377	2922	3002	6	6	80	0.0750000
NODE_146_length_5588_cov_40.961377	2975	3055	0	9	80	0.1125000
NODE_146_length_5588_cov_40.961377	2975	3055	4	11	80	0.1375000
NODE_146_length_5588_cov_40.961377	2975	3055	5	1	80	0.0125000
NODE_146_length_5588_cov_40.961377	2975	3055	6	28	80	0.3500000
NODE_146_length_5588_cov_40.961377	2975	3055	7	31	80	0.3875000
NODE_149_length_5578_cov_5.173389	331	411	0	2	80	0.0250000
NODE_149_length_5578_cov_5.173389	331	411	2	39	80	0.4875000
NODE_149_length_5578_cov_5.173389	331	411	6	37	80	0.4625000
NODE_149_length_5578_cov_5.173389	331	411	7	2	80	0.0250000
NODE_149_length_5578_cov_5.173389	388	464	6	21	76	0.2763158
NODE_149_length_5578_cov_5.173389	388	464	7	29	76	0.3815790
NODE_149_length_5578_cov_5.173389	388	464	9	26	76	0.3421053
NODE_150_length_5572_cov_79.124246	1555	1627	46	1	72	0.0138889
NODE_150_length_5572_cov_79.124246	1555	1627	47	5	72	0.0694444
NODE_150_length_5572_cov_79.124246	1555	1627	48	3	72	0.0416667
NODE_150_length_5572_cov_79.124246	1555	1627	50	2	72	0.0277778
NODE_150_length_5572_cov_79.124246	1555	1627	55	1	72	0.0138889
NODE_150_length_5572_cov_79.124246	1555	1627	64	4	72	0.0555556
NODE_150_length_5572_cov_79.124246	1555	1627	65	1	72	0.0138889
NODE_150_length_5572_cov_79.124246	1555	1627	71	1	72	0.0138889
NODE_150_length_5572_cov_79.124246	1555	1627	73	2	72	0.0277778
NODE_150_length_5572_cov_79.124246	1555	1627	75	1	72	0.0138889
NODE_150_length_5572_cov_79.124246	1555	1627	77	1	72	0.0138889
NODE_150_length_5572_cov_79.124246	1555	1627	83	1	72	0.0138889
NODE_150_length_5572_cov_79.124246	1555	1627	84	2	72	0.0277778
NODE_150_length_5572_cov_79.124246	1555	1627	89	1	72	0.0138889
NODE_150_length_5572_cov_79.124246	1555	1627	90	1	72	0.0138889
NODE_150_length_5572_cov_79.124246	1555	1627	91	2	72	0.0277778
NODE_150_length_5572_cov_79.124246	1555	1627	95	4	72	0.0555556
NODE_150_length_5572_cov_79.124246	1555	1627	97	1	72	0.0138889
NODE_150_length_5572_cov_79.124246	1555	1627	101	1	72	0.0138889
NODE_150_length_5572_cov_79.124246	1555	1627	103	1	72	0.0138889
NODE_150_length_5572_cov_79.124246	1555	1627	110	1	72	0.0138889
NODE_150_length_5572_cov_79.124246	1555	1627	112	1	72	0.0138889
NODE_150_length_5572_cov_79.124246	1555	1627	125	1	72	0.0138889
NODE_150_length_5572_cov_79.124246	1555	1627	143	1	72	0.0138889
NODE_150_length_5572_cov_79.124246	1555	1627	149	1	72	0.0138889
NODE_150_length_5572_cov_79.124246	1555	1627	151	1	72	0.0138889
NODE_150_length_5572_cov_79.124246	1555	1627	156	1	72	0.0138889
NODE_150_length_5572_cov_79.124246	1555	1627	158	1	72	0.0138889
NODE_150_length_5572_cov_79.124246	1555	1627	170	1	72	0.0138889
NODE_150_length_5572_cov_79.124246	1555	1627	173	1	72	0.0138889
NODE_150_length_5572_cov_79.124246	1555	1627	179	1	72	0.0138889
NODE_150_length_5572_cov_79.124246	1555	1627	187	1	72	0.0138889
NODE_150_length_5572_cov_79.124246	1555	1627	193	1	72	0.0138889
NODE_150_length_5572_cov_79.124246	1555	1627	194	1	72	0.0138889
NODE_150_length_5572_cov_79.124246	1555	1627	199	1	72	0.0138889
NODE_150_length_5572_cov_79.124246	1555	1627	204	1	72	0.0138889
NODE_150_length_5572_cov_79.124246	1555	1627	212	1	72	0.0138889
NODE_150_length_5572_cov_79.124246	1555	1627	220	1	72	0.0138889
NODE_150_length_5572_cov_79.124246	1555	1627	229	1	72	0.0138889
NODE_150_length_5572_cov_79.124246	1555	1627	232	1	72	0.0138889
NODE_150_length_5572_cov_79.124246	1555	1627	233	1	72	0.0138889
NODE_150_length_5572_cov_79.124246	1555	1627	242	2	72	0.0277778
NODE_150_length_5572_cov_79.124246	1555	1627	252	1	72	0.0138889
NODE_150_length_5572_cov_79.124246	1555	1627	280	1	72	0.0138889
NODE_150_length_5572_cov_79.124246	1555	1627	286	1	72	0.0138889
NODE_150_length_5572_cov_79.124246	1555	1627	295	1	72	0.0138889
NODE_150_length_5572_cov_79.124246	1555	1627	314	2	72	0.0277778
NODE_150_length_5572_cov_79.124246	1555	1627	319	1	72	0.0138889
NODE_150_length_5572_cov_79.124246	1555	1627	331	1	72	0.0138889
NODE_150_length_5572_cov_79.124246	1555	1627	341	1	72	0.0138889
NODE_150_length_5572_cov_79.124246	1555	1627	349	1	72	0.0138889
NODE_150_length_5572_cov_79.124246	1555	1627	357	2	72	0.0277778
NODE_150_length_5572_cov_79.124246	1555	1627	361	1	72	0.0138889
NODE_150_length_5572_cov_79.124246	1603	1680	193	1	77	0.0129870
NODE_150_length_5572_cov_79.124246	1603	1680	194	1	77	0.0129870
NODE_150_length_5572_cov_79.124246	1603	1680	199	1	77	0.0129870
NODE_150_length_5572_cov_79.124246	1603	1680	204	1	77	0.0129870
NODE_150_length_5572_cov_79.124246	1603	1680	212	1	77	0.0129870
NODE_150_length_5572_cov_79.124246	1603	1680	220	1	77	0.0129870
NODE_150_length_5572_cov_79.124246	1603	1680	229	1	77	0.0129870
NODE_150_length_5572_cov_79.124246	1603	1680	232	1	77	0.0129870
NODE_150_length_5572_cov_79.124246	1603	1680	233	1	77	0.0129870
NODE_150_length_5572_cov_79.124246	1603	1680	242	2	77	0.0259740
NODE_150_length_5572_cov_79.124246	1603	1680	252	1	77	0.0129870
NODE_150_length_5572_cov_79.124246	1603	1680	280	1	77	0.0129870
NODE_150_length_5572_cov_79.124246	1603	1680	286	1	77	0.0129870
NODE_150_length_5572_cov_79.124246	1603	1680	295	1	77	0.0129870
NODE_150_length_5572_cov_79.124246	1603	1680	314	2	77	0.0259740
NODE_150_length_5572_cov_79.124246	1603	1680	319	1	77	0.0129870
NODE_150_length_5572_cov_79.124246	1603	1680	331	1	77	0.0129870
NODE_150_length_5572_cov_79.124246	1603	1680	341	1	77	0.0129870
NODE_150_length_5572_cov_79.124246	1603	1680	349	1	77	0.0129870
NODE_150_length_5572_cov_79.124246	1603	1680	357	2	77	0.0259740
NODE_150_length_5572_cov_79.124246	1603	1680	361	2	77	0.0259740
NODE_150_length_5572_cov_79.124246	1603	1680	362	1	77	0.0129870
NODE_150_length_5572_cov_79.124246	1603	1680	369	1	77	0.0129870
NODE_150_length_5572_cov_79.124246	1603	1680	389	1	77	0.0129870
NODE_150_length_5572_cov_79.124246	1603	1680	392	1	77	0.0129870
NODE_150_length_5572_cov_79.124246	1603	1680	399	1	77	0.0129870
NODE_150_length_5572_cov_79.124246	1603	1680	411	1	77	0.0129870
NODE_150_length_5572_cov_79.124246	1603	1680	417	1	77	0.0129870
NODE_150_length_5572_cov_79.124246	1603	1680	424	1	77	0.0129870
NODE_150_length_5572_cov_79.124246	1603	1680	437	1	77	0.0129870
NODE_150_length_5572_cov_79.124246	1603	1680	440	1	77	0.0129870
NODE_150_length_5572_cov_79.124246	1603	1680	441	1	77	0.0129870
NODE_150_length_5572_cov_79.124246	1603	1680	447	1	77	0.0129870
NODE_150_length_5572_cov_79.124246	1603	1680	452	1	77	0.0129870
NODE_150_length_5572_cov_79.124246	1603	1680	465	1	77	0.0129870
NODE_150_length_5572_cov_79.124246	1603	1680	481	1	77	0.0129870
NODE_150_length_5572_cov_79.124246	1603	1680	493	1	77	0.0129870
NODE_150_length_5572_cov_79.124246	1603	1680	504	1	77	0.0129870
NODE_150_length_5572_cov_79.124246	1603	1680	539	1	77	0.0129870
NODE_150_length_5572_cov_79.124246	1603	1680	562	1	77	0.0129870
NODE_150_length_5572_cov_79.124246	1603	1680	606	1	77	0.0129870
NODE_150_length_5572_cov_79.124246	1603	1680	640	1	77	0.0129870
NODE_150_length_5572_cov_79.124246	1603	1680	659	1	77	0.0129870
NODE_150_length_5572_cov_79.124246	1603	1680	679	1	77	0.0129870
NODE_150_length_5572_cov_79.124246	1603	1680	697	1	77	0.0129870
NODE_150_length_5572_cov_79.124246	1603	1680	721	1	77	0.0129870
NODE_150_length_5572_cov_79.124246	1603	1680	722	1	77	0.0129870
NODE_150_length_5572_cov_79.124246	1603	1680	764	1	77	0.0129870
NODE_150_length_5572_cov_79.124246	1603	1680	780	1	77	0.0129870
NODE_150_length_5572_cov_79.124246	1603	1680	794	2	77	0.0259740
NODE_150_length_5572_cov_79.124246	1603	1680	795	1	77	0.0129870
NODE_150_length_5572_cov_79.124246	1603	1680	799	1	77	0.0129870
NODE_150_length_5572_cov_79.124246	1603	1680	823	1	77	0.0129870
NODE_150_length_5572_cov_79.124246	1603	1680	843	1	77	0.0129870
NODE_150_length_5572_cov_79.124246	1603	1680	865	1	77	0.0129870
NODE_150_length_5572_cov_79.124246	1603	1680	870	1	77	0.0129870
NODE_150_length_5572_cov_79.124246	1603	1680	874	1	77	0.0129870
NODE_150_length_5572_cov_79.124246	1603	1680	875	1	77	0.0129870
NODE_150_length_5572_cov_79.124246	1603	1680	877	1	77	0.0129870
NODE_150_length_5572_cov_79.124246	1603	1680	888	1	77	0.0129870
NODE_150_length_5572_cov_79.124246	1603	1680	907	1	77	0.0129870
NODE_150_length_5572_cov_79.124246	1603	1680	912	1	77	0.0129870
NODE_150_length_5572_cov_79.124246	1603	1680	923	1	77	0.0129870
NODE_150_length_5572_cov_79.124246	1603	1680	941	1	77	0.0129870
NODE_150_length_5572_cov_79.124246	1603	1680	952	1	77	0.0129870
NODE_150_length_5572_cov_79.124246	1603	1680	961	1	77	0.0129870
NODE_150_length_5572_cov_79.124246	1603	1680	1007	1	77	0.0129870
NODE_150_length_5572_cov_79.124246	1603	1680	1041	1	77	0.0129870
NODE_150_length_5572_cov_79.124246	1603	1680	1070	1	77	0.0129870
NODE_150_length_5572_cov_79.124246	1603	1680	1093	1	77	0.0129870
NODE_150_length_5572_cov_79.124246	1603	1680	1123	1	77	0.0129870
NODE_150_length_5572_cov_79.124246	1603	1680	1142	1	77	0.0129870
NODE_150_length_5572_cov_79.124246	1637	1717	440	1	80	0.0125000
NODE_150_length_5572_cov_79.124246	1637	1717	441	1	80	0.0125000
NODE_150_length_5572_cov_79.124246	1637	1717	447	1	80	0.0125000
NODE_150_length_5572_cov_79.124246	1637	1717	452	1	80	0.0125000
NODE_150_length_5572_cov_79.124246	1637	1717	465	1	80	0.0125000
NODE_150_length_5572_cov_79.124246	1637	1717	481	1	80	0.0125000
NODE_150_length_5572_cov_79.124246	1637	1717	493	1	80	0.0125000
NODE_150_length_5572_cov_79.124246	1637	1717	504	1	80	0.0125000
NODE_150_length_5572_cov_79.124246	1637	1717	539	1	80	0.0125000
NODE_150_length_5572_cov_79.124246	1637	1717	562	1	80	0.0125000
NODE_150_length_5572_cov_79.124246	1637	1717	606	1	80	0.0125000
NODE_150_length_5572_cov_79.124246	1637	1717	640	1	80	0.0125000
NODE_150_length_5572_cov_79.124246	1637	1717	659	1	80	0.0125000
NODE_150_length_5572_cov_79.124246	1637	1717	679	1	80	0.0125000
NODE_150_length_5572_cov_79.124246	1637	1717	697	1	80	0.0125000
NODE_150_length_5572_cov_79.124246	1637	1717	721	1	80	0.0125000
NODE_150_length_5572_cov_79.124246	1637	1717	722	1	80	0.0125000
NODE_150_length_5572_cov_79.124246	1637	1717	764	1	80	0.0125000
NODE_150_length_5572_cov_79.124246	1637	1717	780	1	80	0.0125000
NODE_150_length_5572_cov_79.124246	1637	1717	794	2	80	0.0250000
NODE_150_length_5572_cov_79.124246	1637	1717	795	1	80	0.0125000
NODE_150_length_5572_cov_79.124246	1637	1717	799	1	80	0.0125000
NODE_150_length_5572_cov_79.124246	1637	1717	823	1	80	0.0125000
NODE_150_length_5572_cov_79.124246	1637	1717	843	1	80	0.0125000
NODE_150_length_5572_cov_79.124246	1637	1717	865	1	80	0.0125000
NODE_150_length_5572_cov_79.124246	1637	1717	870	1	80	0.0125000
NODE_150_length_5572_cov_79.124246	1637	1717	874	1	80	0.0125000
NODE_150_length_5572_cov_79.124246	1637	1717	875	1	80	0.0125000
NODE_150_length_5572_cov_79.124246	1637	1717	877	1	80	0.0125000
NODE_150_length_5572_cov_79.124246	1637	1717	888	1	80	0.0125000
NODE_150_length_5572_cov_79.124246	1637	1717	907	1	80	0.0125000
NODE_150_length_5572_cov_79.124246	1637	1717	912	1	80	0.0125000
NODE_150_length_5572_cov_79.124246	1637	1717	923	1	80	0.0125000
NODE_150_length_5572_cov_79.124246	1637	1717	941	1	80	0.0125000
NODE_150_length_5572_cov_79.124246	1637	1717	952	1	80	0.0125000
NODE_150_length_5572_cov_79.124246	1637	1717	961	1	80	0.0125000
NODE_150_length_5572_cov_79.124246	1637	1717	1007	1	80	0.0125000
NODE_150_length_5572_cov_79.124246	1637	1717	1041	1	80	0.0125000
NODE_150_length_5572_cov_79.124246	1637	1717	1070	1	80	0.0125000
NODE_150_length_5572_cov_79.124246	1637	1717	1093	1	80	0.0125000
NODE_150_length_5572_cov_79.124246	1637	1717	1123	1	80	0.0125000
NODE_150_length_5572_cov_79.124246	1637	1717	1142	1	80	0.0125000
NODE_150_length_5572_cov_79.124246	1637	1717	1147	1	80	0.0125000
NODE_150_length_5572_cov_79.124246	1637	1717	1151	1	80	0.0125000
NODE_150_length_5572_cov_79.124246	1637	1717	1159	1	80	0.0125000
NODE_150_length_5572_cov_79.124246	1637	1717	1200	1	80	0.0125000
NODE_150_length_5572_cov_79.124246	1637	1717	1204	1	80	0.0125000
NODE_150_length_5572_cov_79.124246	1637	1717	1206	2	80	0.0250000
NODE_150_length_5572_cov_79.124246	1637	1717	1217	1	80	0.0125000
NODE_150_length_5572_cov_79.124246	1637	1717	1247	1	80	0.0125000
NODE_150_length_5572_cov_79.124246	1637	1717	1258	1	80	0.0125000
NODE_150_length_5572_cov_79.124246	1637	1717	1263	1	80	0.0125000
NODE_150_length_5572_cov_79.124246	1637	1717	1264	1	80	0.0125000
NODE_150_length_5572_cov_79.124246	1637	1717	1279	1	80	0.0125000
NODE_150_length_5572_cov_79.124246	1637	1717	1287	1	80	0.0125000
NODE_150_length_5572_cov_79.124246	1637	1717	1293	1	80	0.0125000
NODE_150_length_5572_cov_79.124246	1637	1717	1318	1	80	0.0125000
NODE_150_length_5572_cov_79.124246	1637	1717	1324	1	80	0.0125000
NODE_150_length_5572_cov_79.124246	1637	1717	1332	1	80	0.0125000
NODE_150_length_5572_cov_79.124246	1637	1717	1338	1	80	0.0125000
NODE_150_length_5572_cov_79.124246	1637	1717	1344	1	80	0.0125000
NODE_150_length_5572_cov_79.124246	1637	1717	1348	2	80	0.0250000
NODE_150_length_5572_cov_79.124246	1637	1717	1350	1	80	0.0125000
NODE_150_length_5572_cov_79.124246	1637	1717	1352	1	80	0.0125000
NODE_150_length_5572_cov_79.124246	1637	1717	1357	1	80	0.0125000
NODE_150_length_5572_cov_79.124246	1637	1717	1358	1	80	0.0125000
NODE_150_length_5572_cov_79.124246	1637	1717	1359	1	80	0.0125000
NODE_150_length_5572_cov_79.124246	1637	1717	1360	2	80	0.0250000
NODE_150_length_5572_cov_79.124246	1637	1717	1361	2	80	0.0250000
NODE_150_length_5572_cov_79.124246	1637	1717	1364	1	80	0.0125000
NODE_150_length_5572_cov_79.124246	1637	1717	1370	1	80	0.0125000
NODE_150_length_5572_cov_79.124246	1637	1717	1371	1	80	0.0125000
NODE_150_length_5572_cov_79.124246	1637	1717	1372	2	80	0.0250000
NODE_150_length_5572_cov_79.124246	1637	1717	1374	1	80	0.0125000
NODE_150_length_5572_cov_79.124246	1690	1770	802	1	80	0.0125000
NODE_150_length_5572_cov_79.124246	1690	1770	816	1	80	0.0125000
NODE_150_length_5572_cov_79.124246	1690	1770	859	1	80	0.0125000
NODE_150_length_5572_cov_79.124246	1690	1770	874	1	80	0.0125000
NODE_150_length_5572_cov_79.124246	1690	1770	909	1	80	0.0125000
NODE_150_length_5572_cov_79.124246	1690	1770	934	1	80	0.0125000
NODE_150_length_5572_cov_79.124246	1690	1770	954	1	80	0.0125000
NODE_150_length_5572_cov_79.124246	1690	1770	970	1	80	0.0125000
NODE_150_length_5572_cov_79.124246	1690	1770	976	1	80	0.0125000
NODE_150_length_5572_cov_79.124246	1690	1770	978	1	80	0.0125000
NODE_150_length_5572_cov_79.124246	1690	1770	1007	1	80	0.0125000
NODE_150_length_5572_cov_79.124246	1690	1770	1022	1	80	0.0125000
NODE_150_length_5572_cov_79.124246	1690	1770	1032	1	80	0.0125000
NODE_150_length_5572_cov_79.124246	1690	1770	1057	1	80	0.0125000
NODE_150_length_5572_cov_79.124246	1690	1770	1064	1	80	0.0125000
NODE_150_length_5572_cov_79.124246	1690	1770	1073	1	80	0.0125000
NODE_150_length_5572_cov_79.124246	1690	1770	1084	1	80	0.0125000
NODE_150_length_5572_cov_79.124246	1690	1770	1097	1	80	0.0125000
NODE_150_length_5572_cov_79.124246	1690	1770	1141	1	80	0.0125000
NODE_150_length_5572_cov_79.124246	1690	1770	1146	1	80	0.0125000
NODE_150_length_5572_cov_79.124246	1690	1770	1163	1	80	0.0125000
NODE_150_length_5572_cov_79.124246	1690	1770	1184	1	80	0.0125000
NODE_150_length_5572_cov_79.124246	1690	1770	1200	1	80	0.0125000
NODE_150_length_5572_cov_79.124246	1690	1770	1209	1	80	0.0125000
NODE_150_length_5572_cov_79.124246	1690	1770	1216	1	80	0.0125000
NODE_150_length_5572_cov_79.124246	1690	1770	1228	1	80	0.0125000
NODE_150_length_5572_cov_79.124246	1690	1770	1248	1	80	0.0125000
NODE_150_length_5572_cov_79.124246	1690	1770	1258	1	80	0.0125000
NODE_150_length_5572_cov_79.124246	1690	1770	1263	1	80	0.0125000
NODE_150_length_5572_cov_79.124246	1690	1770	1264	1	80	0.0125000
NODE_150_length_5572_cov_79.124246	1690	1770	1265	1	80	0.0125000
NODE_150_length_5572_cov_79.124246	1690	1770	1275	1	80	0.0125000
NODE_150_length_5572_cov_79.124246	1690	1770	1276	1	80	0.0125000
NODE_150_length_5572_cov_79.124246	1690	1770	1279	1	80	0.0125000
NODE_150_length_5572_cov_79.124246	1690	1770	1281	1	80	0.0125000
NODE_150_length_5572_cov_79.124246	1690	1770	1287	1	80	0.0125000
NODE_150_length_5572_cov_79.124246	1690	1770	1293	1	80	0.0125000
NODE_150_length_5572_cov_79.124246	1690	1770	1294	1	80	0.0125000
NODE_150_length_5572_cov_79.124246	1690	1770	1298	2	80	0.0250000
NODE_150_length_5572_cov_79.124246	1690	1770	1309	1	80	0.0125000
NODE_150_length_5572_cov_79.124246	1690	1770	1317	1	80	0.0125000
NODE_150_length_5572_cov_79.124246	1690	1770	1318	1	80	0.0125000
NODE_150_length_5572_cov_79.124246	1690	1770	1324	1	80	0.0125000
NODE_150_length_5572_cov_79.124246	1690	1770	1332	1	80	0.0125000
NODE_150_length_5572_cov_79.124246	1690	1770	1335	1	80	0.0125000
NODE_150_length_5572_cov_79.124246	1690	1770	1338	1	80	0.0125000
NODE_150_length_5572_cov_79.124246	1690	1770	1339	1	80	0.0125000
NODE_150_length_5572_cov_79.124246	1690	1770	1344	2	80	0.0250000
NODE_150_length_5572_cov_79.124246	1690	1770	1348	2	80	0.0250000
NODE_150_length_5572_cov_79.124246	1690	1770	1350	1	80	0.0125000
NODE_150_length_5572_cov_79.124246	1690	1770	1351	1	80	0.0125000
NODE_150_length_5572_cov_79.124246	1690	1770	1352	1	80	0.0125000
NODE_150_length_5572_cov_79.124246	1690	1770	1355	1	80	0.0125000
NODE_150_length_5572_cov_79.124246	1690	1770	1357	1	80	0.0125000
NODE_150_length_5572_cov_79.124246	1690	1770	1358	2	80	0.0250000
NODE_150_length_5572_cov_79.124246	1690	1770	1359	1	80	0.0125000
NODE_150_length_5572_cov_79.124246	1690	1770	1360	2	80	0.0250000
NODE_150_length_5572_cov_79.124246	1690	1770	1361	2	80	0.0250000
NODE_150_length_5572_cov_79.124246	1690	1770	1364	1	80	0.0125000
NODE_150_length_5572_cov_79.124246	1690	1770	1365	1	80	0.0125000
NODE_150_length_5572_cov_79.124246	1690	1770	1368	1	80	0.0125000
NODE_150_length_5572_cov_79.124246	1690	1770	1369	1	80	0.0125000
NODE_150_length_5572_cov_79.124246	1690	1770	1370	4	80	0.0500000
NODE_150_length_5572_cov_79.124246	1690	1770	1371	3	80	0.0375000
NODE_150_length_5572_cov_79.124246	1690	1770	1372	2	80	0.0250000
NODE_150_length_5572_cov_79.124246	1690	1770	1373	1	80	0.0125000
NODE_150_length_5572_cov_79.124246	1690	1770	1374	1	80	0.0125000
NODE_150_length_5572_cov_79.124246	1690	1770	1375	1	80	0.0125000
NODE_150_length_5572_cov_79.124246	5130	5210	0	69	80	0.8625000
NODE_150_length_5572_cov_79.124246	5130	5210	2	11	80	0.1375000
NODE_150_length_5572_cov_79.124246	5183	5263	0	16	80	0.2000000
NODE_150_length_5572_cov_79.124246	5183	5263	2	64	80	0.8000000
NODE_151_length_5557_cov_26.198241	341	414	2	26	73	0.3561644
NODE_151_length_5557_cov_26.198241	341	414	4	4	73	0.0547945
NODE_151_length_5557_cov_26.198241	341	414	6	43	73	0.5890411
NODE_151_length_5557_cov_26.198241	394	460	0	13	66	0.1969697
NODE_151_length_5557_cov_26.198241	394	460	4	37	66	0.5606061
NODE_151_length_5557_cov_26.198241	394	460	6	16	66	0.2424242
NODE_156_length_5500_cov_35.832438	81	161	0	22	80	0.2750000
NODE_156_length_5500_cov_35.832438	81	161	2	58	80	0.7250000
NODE_156_length_5500_cov_35.832438	134	214	0	64	80	0.8000000
NODE_156_length_5500_cov_35.832438	134	214	2	16	80	0.2000000
NODE_159_length_5470_cov_5.987526	5180	5249	0	69	69	1.0000000
NODE_160_length_5434_cov_14.997751	541	621	0	67	80	0.8375000
NODE_160_length_5434_cov_14.997751	541	621	2	13	80	0.1625000
NODE_160_length_5434_cov_14.997751	594	674	0	80	80	1.0000000
NODE_160_length_5434_cov_14.997751	2664	2744	0	80	80	1.0000000
NODE_160_length_5434_cov_14.997751	2717	2797	0	80	80	1.0000000
NODE_160_length_5434_cov_14.997751	3041	3093	6	52	52	1.0000000
NODE_160_length_5434_cov_14.997751	3419	3467	4	16	48	0.3333333
NODE_160_length_5434_cov_14.997751	3419	3467	8	32	48	0.6666667
NODE_161_length_5425_cov_15.812242	141	218	24	7	77	0.0909091
NODE_161_length_5425_cov_15.812242	141	218	30	2	77	0.0259740
NODE_161_length_5425_cov_15.812242	141	218	32	1	77	0.0129870
NODE_161_length_5425_cov_15.812242	141	218	33	2	77	0.0259740
NODE_161_length_5425_cov_15.812242	141	218	35	3	77	0.0389610
NODE_161_length_5425_cov_15.812242	141	218	37	1	77	0.0129870
NODE_161_length_5425_cov_15.812242	141	218	39	1	77	0.0129870
NODE_161_length_5425_cov_15.812242	141	218	43	1	77	0.0129870
NODE_161_length_5425_cov_15.812242	141	218	47	1	77	0.0129870
NODE_161_length_5425_cov_15.812242	141	218	49	1	77	0.0129870
NODE_161_length_5425_cov_15.812242	141	218	53	1	77	0.0129870
NODE_161_length_5425_cov_15.812242	141	218	55	1	77	0.0129870
NODE_161_length_5425_cov_15.812242	141	218	57	6	77	0.0779221
NODE_161_length_5425_cov_15.812242	141	218	68	2	77	0.0259740
NODE_161_length_5425_cov_15.812242	141	218	69	2	77	0.0259740
NODE_161_length_5425_cov_15.812242	141	218	71	1	77	0.0129870
NODE_161_length_5425_cov_15.812242	141	218	73	8	77	0.1038961
NODE_161_length_5425_cov_15.812242	141	218	76	1	77	0.0129870
NODE_161_length_5425_cov_15.812242	141	218	79	1	77	0.0129870
NODE_161_length_5425_cov_15.812242	141	218	80	1	77	0.0129870
NODE_161_length_5425_cov_15.812242	141	218	81	2	77	0.0259740
NODE_161_length_5425_cov_15.812242	141	218	83	1	77	0.0129870
NODE_161_length_5425_cov_15.812242	141	218	85	1	77	0.0129870
NODE_161_length_5425_cov_15.812242	141	218	86	1	77	0.0129870
NODE_161_length_5425_cov_15.812242	141	218	91	1	77	0.0129870
NODE_161_length_5425_cov_15.812242	141	218	93	1	77	0.0129870
NODE_161_length_5425_cov_15.812242	141	218	95	1	77	0.0129870
NODE_161_length_5425_cov_15.812242	141	218	102	1	77	0.0129870
NODE_161_length_5425_cov_15.812242	141	218	105	1	77	0.0129870
NODE_161_length_5425_cov_15.812242	141	218	110	1	77	0.0129870
NODE_161_length_5425_cov_15.812242	141	218	112	1	77	0.0129870
NODE_161_length_5425_cov_15.812242	141	218	113	1	77	0.0129870
NODE_161_length_5425_cov_15.812242	141	218	116	1	77	0.0129870
NODE_161_length_5425_cov_15.812242	141	218	122	1	77	0.0129870
NODE_161_length_5425_cov_15.812242	141	218	132	1	77	0.0129870
NODE_161_length_5425_cov_15.812242	141	218	134	1	77	0.0129870
NODE_161_length_5425_cov_15.812242	141	218	142	1	77	0.0129870
NODE_161_length_5425_cov_15.812242	141	218	143	1	77	0.0129870
NODE_161_length_5425_cov_15.812242	141	218	145	1	77	0.0129870
NODE_161_length_5425_cov_15.812242	141	218	147	1	77	0.0129870
NODE_161_length_5425_cov_15.812242	141	218	159	1	77	0.0129870
NODE_161_length_5425_cov_15.812242	141	218	161	2	77	0.0259740
NODE_161_length_5425_cov_15.812242	141	218	164	3	77	0.0389610
NODE_161_length_5425_cov_15.812242	141	218	165	1	77	0.0129870
NODE_161_length_5425_cov_15.812242	141	218	169	3	77	0.0389610
NODE_161_length_5425_cov_15.812242	141	218	172	1	77	0.0129870
NODE_161_length_5425_cov_15.812242	141	218	174	1	77	0.0129870
NODE_161_length_5425_cov_15.812242	841	921	2	14	80	0.1750000
NODE_161_length_5425_cov_15.812242	841	921	4	17	80	0.2125000
NODE_161_length_5425_cov_15.812242	841	921	6	1	80	0.0125000
NODE_161_length_5425_cov_15.812242	841	921	8	46	80	0.5750000
NODE_161_length_5425_cov_15.812242	841	921	10	2	80	0.0250000
NODE_161_length_5425_cov_15.812242	894	974	0	50	80	0.6250000
NODE_161_length_5425_cov_15.812242	894	974	2	17	80	0.2125000
NODE_161_length_5425_cov_15.812242	894	974	4	13	80	0.1625000
NODE_163_length_5402_cov_5.397322	191	263	0	11	72	0.1527778
NODE_163_length_5402_cov_5.397322	191	263	2	61	72	0.8472222
NODE_163_length_5402_cov_5.397322	2305	2385	50	2	80	0.0250000
NODE_163_length_5402_cov_5.397322	2305	2385	53	1	80	0.0125000
NODE_163_length_5402_cov_5.397322	2305	2385	57	2	80	0.0250000
NODE_163_length_5402_cov_5.397322	2305	2385	61	1	80	0.0125000
NODE_163_length_5402_cov_5.397322	2305	2385	65	2	80	0.0250000
NODE_163_length_5402_cov_5.397322	2305	2385	68	5	80	0.0625000
NODE_163_length_5402_cov_5.397322	2305	2385	71	4	80	0.0500000
NODE_163_length_5402_cov_5.397322	2305	2385	73	6	80	0.0750000
NODE_163_length_5402_cov_5.397322	2305	2385	76	3	80	0.0375000
NODE_163_length_5402_cov_5.397322	2305	2385	78	1	80	0.0125000
NODE_163_length_5402_cov_5.397322	2305	2385	80	2	80	0.0250000
NODE_163_length_5402_cov_5.397322	2305	2385	83	2	80	0.0250000
NODE_163_length_5402_cov_5.397322	2305	2385	84	4	80	0.0500000
NODE_163_length_5402_cov_5.397322	2305	2385	89	1	80	0.0125000
NODE_163_length_5402_cov_5.397322	2305	2385	90	3	80	0.0375000
NODE_163_length_5402_cov_5.397322	2305	2385	91	2	80	0.0250000
NODE_163_length_5402_cov_5.397322	2305	2385	92	1	80	0.0125000
NODE_163_length_5402_cov_5.397322	2305	2385	93	5	80	0.0625000
NODE_163_length_5402_cov_5.397322	2305	2385	94	14	80	0.1750000
NODE_163_length_5402_cov_5.397322	2305	2385	95	1	80	0.0125000
NODE_163_length_5402_cov_5.397322	2305	2385	97	4	80	0.0500000
NODE_163_length_5402_cov_5.397322	2305	2385	99	5	80	0.0625000
NODE_163_length_5402_cov_5.397322	2305	2385	101	3	80	0.0375000
NODE_163_length_5402_cov_5.397322	2305	2385	103	5	80	0.0625000
NODE_163_length_5402_cov_5.397322	2305	2385	105	1	80	0.0125000
NODE_163_length_5402_cov_5.397322	2358	2438	51	3	80	0.0375000
NODE_163_length_5402_cov_5.397322	2358	2438	56	1	80	0.0125000
NODE_163_length_5402_cov_5.397322	2358	2438	57	1	80	0.0125000
NODE_163_length_5402_cov_5.397322	2358	2438	58	1	80	0.0125000
NODE_163_length_5402_cov_5.397322	2358	2438	60	1	80	0.0125000
NODE_163_length_5402_cov_5.397322	2358	2438	69	2	80	0.0250000
NODE_163_length_5402_cov_5.397322	2358	2438	71	1	80	0.0125000
NODE_163_length_5402_cov_5.397322	2358	2438	77	2	80	0.0250000
NODE_163_length_5402_cov_5.397322	2358	2438	87	2	80	0.0250000
NODE_163_length_5402_cov_5.397322	2358	2438	93	3	80	0.0375000
NODE_163_length_5402_cov_5.397322	2358	2438	94	7	80	0.0875000
NODE_163_length_5402_cov_5.397322	2358	2438	95	8	80	0.1000000
NODE_163_length_5402_cov_5.397322	2358	2438	97	8	80	0.1000000
NODE_163_length_5402_cov_5.397322	2358	2438	99	8	80	0.1000000
NODE_163_length_5402_cov_5.397322	2358	2438	100	2	80	0.0250000
NODE_163_length_5402_cov_5.397322	2358	2438	101	3	80	0.0375000
NODE_163_length_5402_cov_5.397322	2358	2438	103	6	80	0.0750000
NODE_163_length_5402_cov_5.397322	2358	2438	105	3	80	0.0375000
NODE_163_length_5402_cov_5.397322	2358	2438	106	1	80	0.0125000
NODE_163_length_5402_cov_5.397322	2358	2438	107	9	80	0.1125000
NODE_163_length_5402_cov_5.397322	2358	2438	109	3	80	0.0375000
NODE_163_length_5402_cov_5.397322	2358	2438	111	3	80	0.0375000
NODE_163_length_5402_cov_5.397322	2358	2438	113	2	80	0.0250000
NODE_164_length_5383_cov_15.680545	205	285	0	80	80	1.0000000
NODE_164_length_5383_cov_15.680545	258	317	0	59	59	1.0000000
NODE_164_length_5383_cov_15.680545	2042	2122	14	3	80	0.0375000
NODE_164_length_5383_cov_15.680545	2042	2122	16	74	80	0.9250000
NODE_164_length_5383_cov_15.680545	2042	2122	18	3	80	0.0375000
NODE_164_length_5383_cov_15.680545	2095	2175	4	5	80	0.0625000
NODE_164_length_5383_cov_15.680545	2095	2175	6	6	80	0.0750000
NODE_164_length_5383_cov_15.680545	2095	2175	8	7	80	0.0875000
NODE_164_length_5383_cov_15.680545	2095	2175	10	17	80	0.2125000
NODE_164_length_5383_cov_15.680545	2095	2175	12	11	80	0.1375000
NODE_164_length_5383_cov_15.680545	2095	2175	16	34	80	0.4250000
NODE_165_length_5382_cov_16.894378	1301	1347	0	33	46	0.7173913
NODE_165_length_5382_cov_16.894378	1301	1347	2	13	46	0.2826087
NODE_165_length_5382_cov_16.894378	5056	5082	67	2	26	0.0769231
NODE_165_length_5382_cov_16.894378	5056	5082	69	2	26	0.0769231
NODE_165_length_5382_cov_16.894378	5056	5082	75	1	26	0.0384615
NODE_165_length_5382_cov_16.894378	5056	5082	78	2	26	0.0769231
NODE_165_length_5382_cov_16.894378	5056	5082	80	3	26	0.1153846
NODE_165_length_5382_cov_16.894378	5056	5082	82	1	26	0.0384615
NODE_165_length_5382_cov_16.894378	5056	5082	85	1	26	0.0384615
NODE_165_length_5382_cov_16.894378	5056	5082	87	2	26	0.0769231
NODE_165_length_5382_cov_16.894378	5056	5082	91	4	26	0.1538462
NODE_165_length_5382_cov_16.894378	5056	5082	95	1	26	0.0384615
NODE_165_length_5382_cov_16.894378	5056	5082	96	4	26	0.1538462
NODE_165_length_5382_cov_16.894378	5056	5082	100	2	26	0.0769231
NODE_165_length_5382_cov_16.894378	5056	5082	112	1	26	0.0384615
NODE_165_length_5382_cov_16.894378	5056	5115	67	2	59	0.0338983
NODE_165_length_5382_cov_16.894378	5056	5115	69	2	59	0.0338983
NODE_165_length_5382_cov_16.894378	5056	5115	75	1	59	0.0169492
NODE_165_length_5382_cov_16.894378	5056	5115	78	2	59	0.0338983
NODE_165_length_5382_cov_16.894378	5056	5115	80	3	59	0.0508475
NODE_165_length_5382_cov_16.894378	5056	5115	82	1	59	0.0169492
NODE_165_length_5382_cov_16.894378	5056	5115	85	1	59	0.0169492
NODE_165_length_5382_cov_16.894378	5056	5115	87	2	59	0.0338983
NODE_165_length_5382_cov_16.894378	5056	5115	91	4	59	0.0677966
NODE_165_length_5382_cov_16.894378	5056	5115	95	1	59	0.0169492
NODE_165_length_5382_cov_16.894378	5056	5115	96	4	59	0.0677966
NODE_165_length_5382_cov_16.894378	5056	5115	100	2	59	0.0338983
NODE_165_length_5382_cov_16.894378	5056	5115	112	2	59	0.0338983
NODE_165_length_5382_cov_16.894378	5056	5115	114	2	59	0.0338983
NODE_165_length_5382_cov_16.894378	5056	5115	120	1	59	0.0169492
NODE_165_length_5382_cov_16.894378	5056	5115	122	2	59	0.0338983
NODE_165_length_5382_cov_16.894378	5056	5115	123	1	59	0.0169492
NODE_165_length_5382_cov_16.894378	5056	5115	125	1	59	0.0169492
NODE_165_length_5382_cov_16.894378	5056	5115	126	1	59	0.0169492
NODE_165_length_5382_cov_16.894378	5056	5115	127	2	59	0.0338983
NODE_165_length_5382_cov_16.894378	5056	5115	134	1	59	0.0169492
NODE_165_length_5382_cov_16.894378	5056	5115	135	1	59	0.0169492
NODE_165_length_5382_cov_16.894378	5056	5115	137	1	59	0.0169492
NODE_165_length_5382_cov_16.894378	5056	5115	139	3	59	0.0508475
NODE_165_length_5382_cov_16.894378	5056	5115	140	1	59	0.0169492
NODE_165_length_5382_cov_16.894378	5056	5115	144	1	59	0.0169492
NODE_165_length_5382_cov_16.894378	5056	5115	145	1	59	0.0169492
NODE_165_length_5382_cov_16.894378	5056	5115	146	2	59	0.0338983
NODE_165_length_5382_cov_16.894378	5056	5115	147	1	59	0.0169492
NODE_165_length_5382_cov_16.894378	5056	5115	148	1	59	0.0169492
NODE_165_length_5382_cov_16.894378	5056	5115	150	1	59	0.0169492
NODE_165_length_5382_cov_16.894378	5056	5115	164	2	59	0.0338983
NODE_165_length_5382_cov_16.894378	5056	5115	167	1	59	0.0169492
NODE_165_length_5382_cov_16.894378	5056	5115	169	1	59	0.0169492
NODE_165_length_5382_cov_16.894378	5056	5115	171	1	59	0.0169492
NODE_165_length_5382_cov_16.894378	5056	5115	174	1	59	0.0169492
NODE_165_length_5382_cov_16.894378	5056	5115	176	1	59	0.0169492
NODE_165_length_5382_cov_16.894378	5056	5115	182	1	59	0.0169492
NODE_167_length_5339_cov_28.708969	3375	3455	0	4	80	0.0500000
NODE_167_length_5339_cov_28.708969	3375	3455	2	22	80	0.2750000
NODE_167_length_5339_cov_28.708969	3375	3455	4	30	80	0.3750000
NODE_167_length_5339_cov_28.708969	3375	3455	6	4	80	0.0500000
NODE_167_length_5339_cov_28.708969	3375	3455	8	13	80	0.1625000
NODE_167_length_5339_cov_28.708969	3375	3455	12	7	80	0.0875000
NODE_167_length_5339_cov_28.708969	3428	3508	4	3	80	0.0375000
NODE_167_length_5339_cov_28.708969	3428	3508	6	4	80	0.0500000
NODE_167_length_5339_cov_28.708969	3428	3508	8	13	80	0.1625000
NODE_167_length_5339_cov_28.708969	3428	3508	12	17	80	0.2125000
NODE_167_length_5339_cov_28.708969	3428	3508	14	43	80	0.5375000
NODE_168_length_5336_cov_33.036471	3109	3189	38	20	80	0.2500000
NODE_168_length_5336_cov_33.036471	3109	3189	48	4	80	0.0500000
NODE_168_length_5336_cov_33.036471	3109	3189	50	1	80	0.0125000
NODE_168_length_5336_cov_33.036471	3109	3189	53	5	80	0.0625000
NODE_168_length_5336_cov_33.036471	3109	3189	56	8	80	0.1000000
NODE_168_length_5336_cov_33.036471	3109	3189	58	3	80	0.0375000
NODE_168_length_5336_cov_33.036471	3109	3189	63	5	80	0.0625000
NODE_168_length_5336_cov_33.036471	3109	3189	64	4	80	0.0500000
NODE_168_length_5336_cov_33.036471	3109	3189	65	22	80	0.2750000
NODE_168_length_5336_cov_33.036471	3109	3189	67	8	80	0.1000000
NODE_168_length_5336_cov_33.036471	3162	3242	10	4	80	0.0500000
NODE_168_length_5336_cov_33.036471	3162	3242	19	1	80	0.0125000
NODE_168_length_5336_cov_33.036471	3162	3242	20	17	80	0.2125000
NODE_168_length_5336_cov_33.036471	3162	3242	24	4	80	0.0500000
NODE_168_length_5336_cov_33.036471	3162	3242	32	5	80	0.0625000
NODE_168_length_5336_cov_33.036471	3162	3242	46	1	80	0.0125000
NODE_168_length_5336_cov_33.036471	3162	3242	49	1	80	0.0125000
NODE_168_length_5336_cov_33.036471	3162	3242	50	7	80	0.0875000
NODE_168_length_5336_cov_33.036471	3162	3242	51	4	80	0.0500000
NODE_168_length_5336_cov_33.036471	3162	3242	53	6	80	0.0750000
NODE_168_length_5336_cov_33.036471	3162	3242	54	8	80	0.1000000
NODE_168_length_5336_cov_33.036471	3162	3242	56	8	80	0.1000000
NODE_168_length_5336_cov_33.036471	3162	3242	64	4	80	0.0500000
NODE_168_length_5336_cov_33.036471	3162	3242	65	2	80	0.0250000
NODE_168_length_5336_cov_33.036471	3162	3242	67	8	80	0.1000000
NODE_179_length_5269_cov_23.392650	1905	1985	2	50	80	0.6250000
NODE_179_length_5269_cov_23.392650	1905	1985	4	30	80	0.3750000
NODE_179_length_5269_cov_23.392650	1958	2038	2	15	80	0.1875000
NODE_179_length_5269_cov_23.392650	1958	2038	4	65	80	0.8125000
NODE_181_length_5207_cov_31.352780	4588	4668	0	80	80	1.0000000
NODE_181_length_5207_cov_31.352780	4641	4721	0	80	80	1.0000000
NODE_183_length_5193_cov_14.930506	4659	4739	6	6	80	0.0750000
NODE_183_length_5193_cov_14.930506	4659	4739	9	1	80	0.0125000
NODE_183_length_5193_cov_14.930506	4659	4739	11	55	80	0.6875000
NODE_183_length_5193_cov_14.930506	4659	4739	12	18	80	0.2250000
NODE_183_length_5193_cov_14.930506	4712	4792	6	20	80	0.2500000
NODE_183_length_5193_cov_14.930506	4712	4792	11	10	80	0.1250000
NODE_183_length_5193_cov_14.930506	4712	4792	12	50	80	0.6250000
NODE_183_length_5193_cov_14.930506	4788	4868	0	13	80	0.1625000
NODE_183_length_5193_cov_14.930506	4788	4868	2	40	80	0.5000000
NODE_183_length_5193_cov_14.930506	4788	4868	6	27	80	0.3375000
NODE_183_length_5193_cov_14.930506	4841	4921	0	20	80	0.2500000
NODE_183_length_5193_cov_14.930506	4841	4921	2	60	80	0.7500000
NODE_186_length_5159_cov_261.593676	158	227	173	1	69	0.0144928
NODE_186_length_5159_cov_261.593676	158	227	174	3	69	0.0434783
NODE_186_length_5159_cov_261.593676	158	227	176	1	69	0.0144928
NODE_186_length_5159_cov_261.593676	158	227	178	2	69	0.0289855
NODE_186_length_5159_cov_261.593676	158	227	179	1	69	0.0144928
NODE_186_length_5159_cov_261.593676	158	227	180	1	69	0.0144928
NODE_186_length_5159_cov_261.593676	158	227	181	2	69	0.0289855
NODE_186_length_5159_cov_261.593676	158	227	182	2	69	0.0289855
NODE_186_length_5159_cov_261.593676	158	227	185	1	69	0.0144928
NODE_186_length_5159_cov_261.593676	158	227	186	2	69	0.0289855
NODE_186_length_5159_cov_261.593676	158	227	187	5	69	0.0724638
NODE_186_length_5159_cov_261.593676	158	227	188	4	69	0.0579710
NODE_186_length_5159_cov_261.593676	158	227	189	1	69	0.0144928
NODE_186_length_5159_cov_261.593676	158	227	191	2	69	0.0289855
NODE_186_length_5159_cov_261.593676	158	227	192	1	69	0.0144928
NODE_186_length_5159_cov_261.593676	158	227	193	6	69	0.0869565
NODE_186_length_5159_cov_261.593676	158	227	194	2	69	0.0289855
NODE_186_length_5159_cov_261.593676	158	227	195	1	69	0.0144928
NODE_186_length_5159_cov_261.593676	158	227	196	5	69	0.0724638
NODE_186_length_5159_cov_261.593676	158	227	197	1	69	0.0144928
NODE_186_length_5159_cov_261.593676	158	227	198	1	69	0.0144928
NODE_186_length_5159_cov_261.593676	158	227	199	2	69	0.0289855
NODE_186_length_5159_cov_261.593676	158	227	200	2	69	0.0289855
NODE_186_length_5159_cov_261.593676	158	227	201	1	69	0.0144928
NODE_186_length_5159_cov_261.593676	158	227	204	2	69	0.0289855
NODE_186_length_5159_cov_261.593676	158	227	205	2	69	0.0289855
NODE_186_length_5159_cov_261.593676	158	227	206	2	69	0.0289855
NODE_186_length_5159_cov_261.593676	158	227	207	3	69	0.0434783
NODE_186_length_5159_cov_261.593676	158	227	208	3	69	0.0434783
NODE_186_length_5159_cov_261.593676	158	227	210	3	69	0.0434783
NODE_186_length_5159_cov_261.593676	158	227	212	2	69	0.0289855
NODE_186_length_5159_cov_261.593676	158	227	214	2	69	0.0289855
NODE_189_length_5138_cov_31.467355	3004	3075	4	1	71	0.0140845
NODE_189_length_5138_cov_31.467355	3004	3075	8	1	71	0.0140845
NODE_189_length_5138_cov_31.467355	3004	3075	9	1	71	0.0140845
NODE_189_length_5138_cov_31.467355	3004	3075	10	2	71	0.0281690
NODE_189_length_5138_cov_31.467355	3004	3075	14	5	71	0.0704225
NODE_189_length_5138_cov_31.467355	3004	3075	16	1	71	0.0140845
NODE_189_length_5138_cov_31.467355	3004	3075	17	1	71	0.0140845
NODE_189_length_5138_cov_31.467355	3004	3075	19	1	71	0.0140845
NODE_189_length_5138_cov_31.467355	3004	3075	20	1	71	0.0140845
NODE_189_length_5138_cov_31.467355	3004	3075	23	4	71	0.0563380
NODE_189_length_5138_cov_31.467355	3004	3075	24	1	71	0.0140845
NODE_189_length_5138_cov_31.467355	3004	3075	28	1	71	0.0140845
NODE_189_length_5138_cov_31.467355	3004	3075	29	3	71	0.0422535
NODE_189_length_5138_cov_31.467355	3004	3075	30	2	71	0.0281690
NODE_189_length_5138_cov_31.467355	3004	3075	33	1	71	0.0140845
NODE_189_length_5138_cov_31.467355	3004	3075	34	1	71	0.0140845
NODE_189_length_5138_cov_31.467355	3004	3075	37	1	71	0.0140845
NODE_189_length_5138_cov_31.467355	3004	3075	40	2	71	0.0281690
NODE_189_length_5138_cov_31.467355	3004	3075	45	2	71	0.0281690
NODE_189_length_5138_cov_31.467355	3004	3075	46	1	71	0.0140845
NODE_189_length_5138_cov_31.467355	3004	3075	47	4	71	0.0563380
NODE_189_length_5138_cov_31.467355	3004	3075	51	1	71	0.0140845
NODE_189_length_5138_cov_31.467355	3004	3075	53	1	71	0.0140845
NODE_189_length_5138_cov_31.467355	3004	3075	54	3	71	0.0422535
NODE_189_length_5138_cov_31.467355	3004	3075	55	1	71	0.0140845
NODE_189_length_5138_cov_31.467355	3004	3075	57	1	71	0.0140845
NODE_189_length_5138_cov_31.467355	3004	3075	58	1	71	0.0140845
NODE_189_length_5138_cov_31.467355	3004	3075	60	3	71	0.0422535
NODE_189_length_5138_cov_31.467355	3004	3075	62	3	71	0.0422535
NODE_189_length_5138_cov_31.467355	3004	3075	63	7	71	0.0985916
NODE_189_length_5138_cov_31.467355	3004	3075	65	1	71	0.0140845
NODE_189_length_5138_cov_31.467355	3004	3075	67	1	71	0.0140845
NODE_189_length_5138_cov_31.467355	3004	3075	69	3	71	0.0422535
NODE_189_length_5138_cov_31.467355	3004	3075	70	4	71	0.0563380
NODE_189_length_5138_cov_31.467355	3004	3075	72	2	71	0.0281690
NODE_189_length_5138_cov_31.467355	3004	3075	73	2	71	0.0281690
NODE_191_length_5126_cov_5.900935	731	811	12	52	80	0.6500000
NODE_191_length_5126_cov_5.900935	731	811	14	16	80	0.2000000
NODE_191_length_5126_cov_5.900935	731	811	16	12	80	0.1500000
NODE_191_length_5126_cov_5.900935	784	864	2	19	80	0.2375000
NODE_191_length_5126_cov_5.900935	784	864	4	4	80	0.0500000
NODE_191_length_5126_cov_5.900935	784	864	8	23	80	0.2875000
NODE_191_length_5126_cov_5.900935	784	864	10	1	80	0.0125000
NODE_191_length_5126_cov_5.900935	784	864	14	15	80	0.1875000
NODE_191_length_5126_cov_5.900935	784	864	16	18	80	0.2250000
NODE_194_length_5102_cov_12.729962	367	447	21	14	80	0.1750000
NODE_194_length_5102_cov_12.729962	367	447	22	66	80	0.8250000
NODE_194_length_5102_cov_12.729962	420	500	0	28	80	0.3500000
NODE_194_length_5102_cov_12.729962	420	500	21	13	80	0.1625000
NODE_194_length_5102_cov_12.729962	420	500	22	39	80	0.4875000
NODE_194_length_5102_cov_12.729962	496	576	0	80	80	1.0000000
NODE_194_length_5102_cov_12.729962	549	629	0	80	80	1.0000000
NODE_196_length_5079_cov_5.580522	875	940	48	7	65	0.1076923
NODE_196_length_5079_cov_5.580522	875	940	49	3	65	0.0461538
NODE_196_length_5079_cov_5.580522	875	940	50	11	65	0.1692308
NODE_196_length_5079_cov_5.580522	875	940	51	6	65	0.0923077
NODE_196_length_5079_cov_5.580522	875	940	52	9	65	0.1384615
NODE_196_length_5079_cov_5.580522	875	940	53	2	65	0.0307692
NODE_196_length_5079_cov_5.580522	875	940	54	1	65	0.0153846
NODE_196_length_5079_cov_5.580522	875	940	55	4	65	0.0615385
NODE_196_length_5079_cov_5.580522	875	940	56	1	65	0.0153846
NODE_196_length_5079_cov_5.580522	875	940	57	1	65	0.0153846
NODE_196_length_5079_cov_5.580522	875	940	58	2	65	0.0307692
NODE_196_length_5079_cov_5.580522	875	940	59	3	65	0.0461538
NODE_196_length_5079_cov_5.580522	875	940	60	2	65	0.0307692
NODE_196_length_5079_cov_5.580522	875	940	61	1	65	0.0153846
NODE_196_length_5079_cov_5.580522	875	940	62	5	65	0.0769231
NODE_196_length_5079_cov_5.580522	875	940	64	2	65	0.0307692
NODE_196_length_5079_cov_5.580522	875	940	65	5	65	0.0769231
NODE_197_length_5057_cov_16.348729	2929	3000	265	1	71	0.0140845
NODE_197_length_5057_cov_16.348729	2929	3000	270	1	71	0.0140845
NODE_197_length_5057_cov_16.348729	2929	3000	289	1	71	0.0140845
NODE_197_length_5057_cov_16.348729	2929	3000	294	1	71	0.0140845
NODE_197_length_5057_cov_16.348729	2929	3000	303	1	71	0.0140845
NODE_197_length_5057_cov_16.348729	2929	3000	306	1	71	0.0140845
NODE_197_length_5057_cov_16.348729	2929	3000	313	1	71	0.0140845
NODE_197_length_5057_cov_16.348729	2929	3000	322	1	71	0.0140845
NODE_197_length_5057_cov_16.348729	2929	3000	337	1	71	0.0140845
NODE_197_length_5057_cov_16.348729	2929	3000	348	1	71	0.0140845
NODE_197_length_5057_cov_16.348729	2929	3000	353	1	71	0.0140845
NODE_197_length_5057_cov_16.348729	2929	3000	354	1	71	0.0140845
NODE_197_length_5057_cov_16.348729	2929	3000	361	1	71	0.0140845
NODE_197_length_5057_cov_16.348729	2929	3000	375	1	71	0.0140845
NODE_197_length_5057_cov_16.348729	2929	3000	383	1	71	0.0140845
NODE_197_length_5057_cov_16.348729	2929	3000	392	1	71	0.0140845
NODE_197_length_5057_cov_16.348729	2929	3000	400	1	71	0.0140845
NODE_197_length_5057_cov_16.348729	2929	3000	412	1	71	0.0140845
NODE_197_length_5057_cov_16.348729	2929	3000	418	1	71	0.0140845
NODE_197_length_5057_cov_16.348729	2929	3000	426	1	71	0.0140845
NODE_197_length_5057_cov_16.348729	2929	3000	435	1	71	0.0140845
NODE_197_length_5057_cov_16.348729	2929	3000	448	1	71	0.0140845
NODE_197_length_5057_cov_16.348729	2929	3000	452	1	71	0.0140845
NODE_197_length_5057_cov_16.348729	2929	3000	455	1	71	0.0140845
NODE_197_length_5057_cov_16.348729	2929	3000	459	2	71	0.0281690
NODE_197_length_5057_cov_16.348729	2929	3000	465	1	71	0.0140845
NODE_197_length_5057_cov_16.348729	2929	3000	470	1	71	0.0140845
NODE_197_length_5057_cov_16.348729	2929	3000	478	1	71	0.0140845
NODE_197_length_5057_cov_16.348729	2929	3000	480	1	71	0.0140845
NODE_197_length_5057_cov_16.348729	2929	3000	485	1	71	0.0140845
NODE_197_length_5057_cov_16.348729	2929	3000	491	1	71	0.0140845
NODE_197_length_5057_cov_16.348729	2929	3000	495	1	71	0.0140845
NODE_197_length_5057_cov_16.348729	2929	3000	499	1	71	0.0140845
NODE_197_length_5057_cov_16.348729	2929	3000	502	1	71	0.0140845
NODE_197_length_5057_cov_16.348729	2929	3000	510	1	71	0.0140845
NODE_197_length_5057_cov_16.348729	2929	3000	514	3	71	0.0422535
NODE_197_length_5057_cov_16.348729	2929	3000	516	1	71	0.0140845
NODE_197_length_5057_cov_16.348729	2929	3000	523	1	71	0.0140845
NODE_197_length_5057_cov_16.348729	2929	3000	527	1	71	0.0140845
NODE_197_length_5057_cov_16.348729	2929	3000	530	1	71	0.0140845
NODE_197_length_5057_cov_16.348729	2929	3000	536	1	71	0.0140845
NODE_197_length_5057_cov_16.348729	2929	3000	542	1	71	0.0140845
NODE_197_length_5057_cov_16.348729	2929	3000	544	1	71	0.0140845
NODE_197_length_5057_cov_16.348729	2929	3000	548	1	71	0.0140845
NODE_197_length_5057_cov_16.348729	2929	3000	550	1	71	0.0140845
NODE_197_length_5057_cov_16.348729	2929	3000	552	4	71	0.0563380
NODE_197_length_5057_cov_16.348729	2929	3000	554	1	71	0.0140845
NODE_197_length_5057_cov_16.348729	2929	3000	555	3	71	0.0422535
NODE_197_length_5057_cov_16.348729	2929	3000	558	1	71	0.0140845
NODE_197_length_5057_cov_16.348729	2929	3000	562	1	71	0.0140845
NODE_197_length_5057_cov_16.348729	2929	3000	566	2	71	0.0281690
NODE_197_length_5057_cov_16.348729	2929	3000	568	1	71	0.0140845
NODE_197_length_5057_cov_16.348729	2929	3000	576	1	71	0.0140845
NODE_197_length_5057_cov_16.348729	2929	3000	584	1	71	0.0140845
NODE_197_length_5057_cov_16.348729	2929	3000	588	1	71	0.0140845
NODE_197_length_5057_cov_16.348729	2929	3000	589	4	71	0.0563380
NODE_197_length_5057_cov_16.348729	2929	3000	591	2	71	0.0281690
NODE_197_length_5057_cov_16.348729	2929	3000	592	1	71	0.0140845
NODE_197_length_5057_cov_16.348729	2973	3012	542	1	39	0.0256410
NODE_197_length_5057_cov_16.348729	2973	3012	544	1	39	0.0256410
NODE_197_length_5057_cov_16.348729	2973	3012	548	1	39	0.0256410
NODE_197_length_5057_cov_16.348729	2973	3012	550	1	39	0.0256410
NODE_197_length_5057_cov_16.348729	2973	3012	552	4	39	0.1025641
NODE_197_length_5057_cov_16.348729	2973	3012	554	1	39	0.0256410
NODE_197_length_5057_cov_16.348729	2973	3012	555	3	39	0.0769231
NODE_197_length_5057_cov_16.348729	2973	3012	558	1	39	0.0256410
NODE_197_length_5057_cov_16.348729	2973	3012	562	1	39	0.0256410
NODE_197_length_5057_cov_16.348729	2973	3012	566	2	39	0.0512821
NODE_197_length_5057_cov_16.348729	2973	3012	568	1	39	0.0256410
NODE_197_length_5057_cov_16.348729	2973	3012	575	1	39	0.0256410
NODE_197_length_5057_cov_16.348729	2973	3012	576	1	39	0.0256410
NODE_197_length_5057_cov_16.348729	2973	3012	579	1	39	0.0256410
NODE_197_length_5057_cov_16.348729	2973	3012	584	1	39	0.0256410
NODE_197_length_5057_cov_16.348729	2973	3012	588	1	39	0.0256410
NODE_197_length_5057_cov_16.348729	2973	3012	589	4	39	0.1025641
NODE_197_length_5057_cov_16.348729	2973	3012	590	2	39	0.0512821
NODE_197_length_5057_cov_16.348729	2973	3012	591	3	39	0.0769231
NODE_197_length_5057_cov_16.348729	2973	3012	592	3	39	0.0769231
NODE_197_length_5057_cov_16.348729	2973	3012	593	1	39	0.0256410
NODE_197_length_5057_cov_16.348729	2973	3012	595	3	39	0.0769231
NODE_197_length_5057_cov_16.348729	2973	3012	598	1	39	0.0256410
NODE_198_length_5053_cov_11.281994	791	834	2	43	43	1.0000000
NODE_198_length_5053_cov_11.281994	807	887	0	40	80	0.5000000
NODE_198_length_5053_cov_11.281994	807	887	2	40	80	0.5000000
NODE_198_length_5053_cov_11.281994	883	963	0	80	80	1.0000000
NODE_198_length_5053_cov_11.281994	936	999	0	63	63	1.0000000
NODE_204_length_4906_cov_37.988350	3170	3251	28	1	81	0.0123457
NODE_204_length_4906_cov_37.988350	3170	3251	32	1	81	0.0123457
NODE_204_length_4906_cov_37.988350	3170	3251	36	2	81	0.0246914
NODE_204_length_4906_cov_37.988350	3170	3251	38	1	81	0.0123457
NODE_204_length_4906_cov_37.988350	3170	3251	46	3	81	0.0370370
NODE_204_length_4906_cov_37.988350	3170	3251	47	1	81	0.0123457
NODE_204_length_4906_cov_37.988350	3170	3251	52	1	81	0.0123457
NODE_204_length_4906_cov_37.988350	3170	3251	55	1	81	0.0123457
NODE_204_length_4906_cov_37.988350	3170	3251	57	1	81	0.0123457
NODE_204_length_4906_cov_37.988350	3170	3251	58	1	81	0.0123457
NODE_204_length_4906_cov_37.988350	3170	3251	59	1	81	0.0123457
NODE_204_length_4906_cov_37.988350	3170	3251	61	2	81	0.0246914
NODE_204_length_4906_cov_37.988350	3170	3251	63	1	81	0.0123457
NODE_204_length_4906_cov_37.988350	3170	3251	69	1	81	0.0123457
NODE_204_length_4906_cov_37.988350	3170	3251	72	1	81	0.0123457
NODE_204_length_4906_cov_37.988350	3170	3251	73	1	81	0.0123457
NODE_204_length_4906_cov_37.988350	3170	3251	75	2	81	0.0246914
NODE_204_length_4906_cov_37.988350	3170	3251	76	1	81	0.0123457
NODE_204_length_4906_cov_37.988350	3170	3251	80	1	81	0.0123457
NODE_204_length_4906_cov_37.988350	3170	3251	84	1	81	0.0123457
NODE_204_length_4906_cov_37.988350	3170	3251	99	1	81	0.0123457
NODE_204_length_4906_cov_37.988350	3170	3251	100	2	81	0.0246914
NODE_204_length_4906_cov_37.988350	3170	3251	101	1	81	0.0123457
NODE_204_length_4906_cov_37.988350	3170	3251	103	1	81	0.0123457
NODE_204_length_4906_cov_37.988350	3170	3251	107	2	81	0.0246914
NODE_204_length_4906_cov_37.988350	3170	3251	108	3	81	0.0370370
NODE_204_length_4906_cov_37.988350	3170	3251	112	1	81	0.0123457
NODE_204_length_4906_cov_37.988350	3170	3251	116	1	81	0.0123457
NODE_204_length_4906_cov_37.988350	3170	3251	120	1	81	0.0123457
NODE_204_length_4906_cov_37.988350	3170	3251	127	2	81	0.0246914
NODE_204_length_4906_cov_37.988350	3170	3251	135	1	81	0.0123457
NODE_204_length_4906_cov_37.988350	3170	3251	138	1	81	0.0123457
NODE_204_length_4906_cov_37.988350	3170	3251	139	1	81	0.0123457
NODE_204_length_4906_cov_37.988350	3170	3251	141	1	81	0.0123457
NODE_204_length_4906_cov_37.988350	3170	3251	149	1	81	0.0123457
NODE_204_length_4906_cov_37.988350	3170	3251	156	1	81	0.0123457
NODE_204_length_4906_cov_37.988350	3170	3251	160	1	81	0.0123457
NODE_204_length_4906_cov_37.988350	3170	3251	163	1	81	0.0123457
NODE_204_length_4906_cov_37.988350	3170	3251	165	1	81	0.0123457
NODE_204_length_4906_cov_37.988350	3170	3251	169	1	81	0.0123457
NODE_204_length_4906_cov_37.988350	3170	3251	178	1	81	0.0123457
NODE_204_length_4906_cov_37.988350	3170	3251	184	1	81	0.0123457
NODE_204_length_4906_cov_37.988350	3170	3251	185	1	81	0.0123457
NODE_204_length_4906_cov_37.988350	3170	3251	189	1	81	0.0123457
NODE_204_length_4906_cov_37.988350	3170	3251	191	1	81	0.0123457
NODE_204_length_4906_cov_37.988350	3170	3251	192	1	81	0.0123457
NODE_204_length_4906_cov_37.988350	3170	3251	195	1	81	0.0123457
NODE_204_length_4906_cov_37.988350	3170	3251	207	3	81	0.0370370
NODE_204_length_4906_cov_37.988350	3170	3251	208	1	81	0.0123457
NODE_204_length_4906_cov_37.988350	3170	3251	214	1	81	0.0123457
NODE_204_length_4906_cov_37.988350	3170	3251	218	1	81	0.0123457
NODE_204_length_4906_cov_37.988350	3170	3251	224	1	81	0.0123457
NODE_204_length_4906_cov_37.988350	3170	3251	227	2	81	0.0246914
NODE_204_length_4906_cov_37.988350	3170	3251	231	1	81	0.0123457
NODE_204_length_4906_cov_37.988350	3170	3251	240	1	81	0.0123457
NODE_204_length_4906_cov_37.988350	3170	3251	245	1	81	0.0123457
NODE_204_length_4906_cov_37.988350	3170	3251	251	3	81	0.0370370
NODE_204_length_4906_cov_37.988350	3170	3251	252	1	81	0.0123457
NODE_204_length_4906_cov_37.988350	3170	3251	260	1	81	0.0123457
NODE_204_length_4906_cov_37.988350	3170	3251	262	1	81	0.0123457
NODE_204_length_4906_cov_37.988350	3170	3251	269	1	81	0.0123457
NODE_204_length_4906_cov_37.988350	3170	3251	271	1	81	0.0123457
NODE_204_length_4906_cov_37.988350	3170	3251	273	1	81	0.0123457
NODE_204_length_4906_cov_37.988350	3170	3251	274	1	81	0.0123457
NODE_204_length_4906_cov_37.988350	3170	3251	279	2	81	0.0246914
NODE_205_length_4888_cov_60.162247	4029	4068	2	11	39	0.2820513
NODE_205_length_4888_cov_60.162247	4029	4068	4	25	39	0.6410257
NODE_205_length_4888_cov_60.162247	4029	4068	6	3	39	0.0769231
NODE_205_length_4888_cov_60.162247	4041	4121	2	16	80	0.2000000
NODE_205_length_4888_cov_60.162247	4041	4121	4	64	80	0.8000000
NODE_207_length_4875_cov_63.035176	2905	2985	0	32	80	0.4000000
NODE_207_length_4875_cov_63.035176	2905	2985	1	2	80	0.0250000
NODE_207_length_4875_cov_63.035176	2905	2985	2	30	80	0.3750000
NODE_207_length_4875_cov_63.035176	2905	2985	4	16	80	0.2000000
NODE_207_length_4875_cov_63.035176	2958	3038	2	11	80	0.1375000
NODE_207_length_4875_cov_63.035176	2958	3038	4	33	80	0.4125000
NODE_207_length_4875_cov_63.035176	2958	3038	5	35	80	0.4375000
NODE_207_length_4875_cov_63.035176	2958	3038	7	1	80	0.0125000
NODE_208_length_4875_cov_8.996859	4683	4760	0	77	77	1.0000000
NODE_208_length_4875_cov_8.996859	4736	4813	0	77	77	1.0000000
NODE_211_length_4827_cov_15.364636	1803	1865	65	1	62	0.0161290
NODE_211_length_4827_cov_15.364636	1803	1865	67	3	62	0.0483871
NODE_211_length_4827_cov_15.364636	1803	1865	68	2	62	0.0322581
NODE_211_length_4827_cov_15.364636	1803	1865	69	5	62	0.0806452
NODE_211_length_4827_cov_15.364636	1803	1865	70	1	62	0.0161290
NODE_211_length_4827_cov_15.364636	1803	1865	71	1	62	0.0161290
NODE_211_length_4827_cov_15.364636	1803	1865	72	1	62	0.0161290
NODE_211_length_4827_cov_15.364636	1803	1865	74	1	62	0.0161290
NODE_211_length_4827_cov_15.364636	1803	1865	75	3	62	0.0483871
NODE_211_length_4827_cov_15.364636	1803	1865	76	4	62	0.0645161
NODE_211_length_4827_cov_15.364636	1803	1865	77	3	62	0.0483871
NODE_211_length_4827_cov_15.364636	1803	1865	78	2	62	0.0322581
NODE_211_length_4827_cov_15.364636	1803	1865	80	2	62	0.0322581
NODE_211_length_4827_cov_15.364636	1803	1865	82	3	62	0.0483871
NODE_211_length_4827_cov_15.364636	1803	1865	88	1	62	0.0161290
NODE_211_length_4827_cov_15.364636	1803	1865	89	2	62	0.0322581
NODE_211_length_4827_cov_15.364636	1803	1865	91	2	62	0.0322581
NODE_211_length_4827_cov_15.364636	1803	1865	93	1	62	0.0161290
NODE_211_length_4827_cov_15.364636	1803	1865	94	1	62	0.0161290
NODE_211_length_4827_cov_15.364636	1803	1865	95	2	62	0.0322581
NODE_211_length_4827_cov_15.364636	1803	1865	96	1	62	0.0161290
NODE_211_length_4827_cov_15.364636	1803	1865	98	1	62	0.0161290
NODE_211_length_4827_cov_15.364636	1803	1865	110	2	62	0.0322581
NODE_211_length_4827_cov_15.364636	1803	1865	111	2	62	0.0322581
NODE_211_length_4827_cov_15.364636	1803	1865	113	1	62	0.0161290
NODE_211_length_4827_cov_15.364636	1803	1865	117	1	62	0.0161290
NODE_211_length_4827_cov_15.364636	1803	1865	124	1	62	0.0161290
NODE_211_length_4827_cov_15.364636	1803	1865	130	4	62	0.0645161
NODE_211_length_4827_cov_15.364636	1803	1865	134	1	62	0.0161290
NODE_211_length_4827_cov_15.364636	1803	1865	138	1	62	0.0161290
NODE_211_length_4827_cov_15.364636	1803	1865	145	1	62	0.0161290
NODE_211_length_4827_cov_15.364636	1803	1865	148	2	62	0.0322581
NODE_211_length_4827_cov_15.364636	1803	1865	150	1	62	0.0161290
NODE_211_length_4827_cov_15.364636	1803	1865	156	2	62	0.0322581
NODE_211_length_4827_cov_15.364636	1899	1979	56	3	80	0.0375000
NODE_211_length_4827_cov_15.364636	1899	1979	60	8	80	0.1000000
NODE_211_length_4827_cov_15.364636	1899	1979	61	5	80	0.0625000
NODE_211_length_4827_cov_15.364636	1899	1979	62	2	80	0.0250000
NODE_211_length_4827_cov_15.364636	1899	1979	64	1	80	0.0125000
NODE_211_length_4827_cov_15.364636	1899	1979	66	3	80	0.0375000
NODE_211_length_4827_cov_15.364636	1899	1979	71	1	80	0.0125000
NODE_211_length_4827_cov_15.364636	1899	1979	75	5	80	0.0625000
NODE_211_length_4827_cov_15.364636	1899	1979	77	6	80	0.0750000
NODE_211_length_4827_cov_15.364636	1899	1979	79	4	80	0.0500000
NODE_211_length_4827_cov_15.364636	1899	1979	81	3	80	0.0375000
NODE_211_length_4827_cov_15.364636	1899	1979	83	4	80	0.0500000
NODE_211_length_4827_cov_15.364636	1899	1979	84	1	80	0.0125000
NODE_211_length_4827_cov_15.364636	1899	1979	85	12	80	0.1500000
NODE_211_length_4827_cov_15.364636	1899	1979	86	5	80	0.0625000
NODE_211_length_4827_cov_15.364636	1899	1979	87	10	80	0.1250000
NODE_211_length_4827_cov_15.364636	1899	1979	88	3	80	0.0375000
NODE_211_length_4827_cov_15.364636	1899	1979	89	1	80	0.0125000
NODE_211_length_4827_cov_15.364636	1899	1979	90	1	80	0.0125000
NODE_211_length_4827_cov_15.364636	1899	1979	91	1	80	0.0125000
NODE_211_length_4827_cov_15.364636	1899	1979	92	1	80	0.0125000
NODE_211_length_4827_cov_15.364636	1952	1996	47	4	44	0.0909091
NODE_211_length_4827_cov_15.364636	1952	1996	49	1	44	0.0227273
NODE_211_length_4827_cov_15.364636	1952	1996	51	1	44	0.0227273
NODE_211_length_4827_cov_15.364636	1952	1996	53	7	44	0.1590909
NODE_211_length_4827_cov_15.364636	1952	1996	54	3	44	0.0681818
NODE_211_length_4827_cov_15.364636	1952	1996	55	1	44	0.0227273
NODE_211_length_4827_cov_15.364636	1952	1996	56	3	44	0.0681818
NODE_211_length_4827_cov_15.364636	1952	1996	60	8	44	0.1818182
NODE_211_length_4827_cov_15.364636	1952	1996	61	5	44	0.1136364
NODE_211_length_4827_cov_15.364636	1952	1996	62	2	44	0.0454545
NODE_211_length_4827_cov_15.364636	1952	1996	64	1	44	0.0227273
NODE_211_length_4827_cov_15.364636	1952	1996	66	3	44	0.0681818
NODE_211_length_4827_cov_15.364636	1952	1996	71	1	44	0.0227273
NODE_211_length_4827_cov_15.364636	1952	1996	75	2	44	0.0454545
NODE_211_length_4827_cov_15.364636	1952	1996	77	2	44	0.0454545
NODE_212_length_4821_cov_10.856840	999	1061	12	46	62	0.7419355
NODE_212_length_4821_cov_10.856840	999	1061	14	16	62	0.2580645
NODE_213_length_4819_cov_16.363347	2392	2461	15	2	69	0.0289855
NODE_213_length_4819_cov_16.363347	2392	2461	16	9	69	0.1304348
NODE_213_length_4819_cov_16.363347	2392	2461	17	1	69	0.0144928
NODE_213_length_4819_cov_16.363347	2392	2461	21	1	69	0.0144928
NODE_213_length_4819_cov_16.363347	2392	2461	26	1	69	0.0144928
NODE_213_length_4819_cov_16.363347	2392	2461	33	1	69	0.0144928
NODE_213_length_4819_cov_16.363347	2392	2461	34	11	69	0.1594203
NODE_213_length_4819_cov_16.363347	2392	2461	36	18	69	0.2608696
NODE_213_length_4819_cov_16.363347	2392	2461	38	25	69	0.3623188
NODE_217_length_4794_cov_14.912886	657	737	104	1	80	0.0125000
NODE_217_length_4794_cov_14.912886	657	737	106	2	80	0.0250000
NODE_217_length_4794_cov_14.912886	657	737	108	1	80	0.0125000
NODE_217_length_4794_cov_14.912886	657	737	111	1	80	0.0125000
NODE_217_length_4794_cov_14.912886	657	737	117	1	80	0.0125000
NODE_217_length_4794_cov_14.912886	657	737	120	2	80	0.0250000
NODE_217_length_4794_cov_14.912886	657	737	122	5	80	0.0625000
NODE_217_length_4794_cov_14.912886	657	737	124	1	80	0.0125000
NODE_217_length_4794_cov_14.912886	657	737	126	2	80	0.0250000
NODE_217_length_4794_cov_14.912886	657	737	128	1	80	0.0125000
NODE_217_length_4794_cov_14.912886	657	737	130	3	80	0.0375000
NODE_217_length_4794_cov_14.912886	657	737	133	2	80	0.0250000
NODE_217_length_4794_cov_14.912886	657	737	135	1	80	0.0125000
NODE_217_length_4794_cov_14.912886	657	737	136	1	80	0.0125000
NODE_217_length_4794_cov_14.912886	657	737	137	1	80	0.0125000
NODE_217_length_4794_cov_14.912886	657	737	139	3	80	0.0375000
NODE_217_length_4794_cov_14.912886	657	737	142	1	80	0.0125000
NODE_217_length_4794_cov_14.912886	657	737	144	3	80	0.0375000
NODE_217_length_4794_cov_14.912886	657	737	148	6	80	0.0750000
NODE_217_length_4794_cov_14.912886	657	737	154	3	80	0.0375000
NODE_217_length_4794_cov_14.912886	657	737	157	2	80	0.0250000
NODE_217_length_4794_cov_14.912886	657	737	160	1	80	0.0125000
NODE_217_length_4794_cov_14.912886	657	737	162	4	80	0.0500000
NODE_217_length_4794_cov_14.912886	657	737	164	4	80	0.0500000
NODE_217_length_4794_cov_14.912886	657	737	167	1	80	0.0125000
NODE_217_length_4794_cov_14.912886	657	737	171	2	80	0.0250000
NODE_217_length_4794_cov_14.912886	657	737	177	2	80	0.0250000
NODE_217_length_4794_cov_14.912886	657	737	181	1	80	0.0125000
NODE_217_length_4794_cov_14.912886	657	737	183	1	80	0.0125000
NODE_217_length_4794_cov_14.912886	657	737	185	1	80	0.0125000
NODE_217_length_4794_cov_14.912886	657	737	189	1	80	0.0125000
NODE_217_length_4794_cov_14.912886	657	737	192	3	80	0.0375000
NODE_217_length_4794_cov_14.912886	657	737	194	9	80	0.1125000
NODE_217_length_4794_cov_14.912886	657	737	196	1	80	0.0125000
NODE_217_length_4794_cov_14.912886	657	737	197	1	80	0.0125000
NODE_217_length_4794_cov_14.912886	657	737	199	1	80	0.0125000
NODE_217_length_4794_cov_14.912886	657	737	203	1	80	0.0125000
NODE_217_length_4794_cov_14.912886	657	737	207	2	80	0.0250000
NODE_217_length_4794_cov_14.912886	657	737	210	1	80	0.0125000
NODE_217_length_4794_cov_14.912886	4240	4312	4	21	72	0.2916667
NODE_217_length_4794_cov_14.912886	4240	4312	6	49	72	0.6805556
NODE_217_length_4794_cov_14.912886	4240	4312	8	2	72	0.0277778
NODE_217_length_4794_cov_14.912886	4293	4312	4	19	19	1.0000000
NODE_217_length_4794_cov_14.912886	4345	4408	4	11	63	0.1746032
NODE_217_length_4794_cov_14.912886	4345	4408	6	6	63	0.0952381
NODE_217_length_4794_cov_14.912886	4345	4408	8	35	63	0.5555556
NODE_217_length_4794_cov_14.912886	4345	4408	12	11	63	0.1746032
NODE_218_length_4791_cov_16.126172	2438	2518	0	80	80	1.0000000
NODE_218_length_4791_cov_16.126172	2491	2571	0	80	80	1.0000000
NODE_218_length_4791_cov_16.126172	2567	2647	0	80	80	1.0000000
NODE_218_length_4791_cov_16.126172	2620	2700	0	80	80	1.0000000
NODE_218_length_4791_cov_16.126172	4607	4687	0	32	80	0.4000000
NODE_218_length_4791_cov_16.126172	4607	4687	1	4	80	0.0500000
NODE_218_length_4791_cov_16.126172	4607	4687	2	44	80	0.5500000
NODE_219_length_4790_cov_9.713494	2159	2239	35	6	80	0.0750000
NODE_219_length_4790_cov_9.713494	2159	2239	38	2	80	0.0250000
NODE_219_length_4790_cov_9.713494	2159	2239	40	1	80	0.0125000
NODE_219_length_4790_cov_9.713494	2159	2239	44	2	80	0.0250000
NODE_219_length_4790_cov_9.713494	2159	2239	46	18	80	0.2250000
NODE_219_length_4790_cov_9.713494	2159	2239	47	9	80	0.1125000
NODE_219_length_4790_cov_9.713494	2159	2239	49	5	80	0.0625000
NODE_219_length_4790_cov_9.713494	2159	2239	51	13	80	0.1625000
NODE_219_length_4790_cov_9.713494	2159	2239	53	4	80	0.0500000
NODE_219_length_4790_cov_9.713494	2159	2239	55	6	80	0.0750000
NODE_219_length_4790_cov_9.713494	2159	2239	56	2	80	0.0250000
NODE_219_length_4790_cov_9.713494	2159	2239	57	1	80	0.0125000
NODE_219_length_4790_cov_9.713494	2159	2239	58	4	80	0.0500000
NODE_219_length_4790_cov_9.713494	2159	2239	61	5	80	0.0625000
NODE_219_length_4790_cov_9.713494	2159	2239	63	2	80	0.0250000
NODE_219_length_4790_cov_9.713494	4273	4353	2	5	80	0.0625000
NODE_219_length_4790_cov_9.713494	4273	4353	8	3	80	0.0375000
NODE_219_length_4790_cov_9.713494	4273	4353	12	7	80	0.0875000
NODE_219_length_4790_cov_9.713494	4273	4353	14	9	80	0.1125000
NODE_219_length_4790_cov_9.713494	4273	4353	16	1	80	0.0125000
NODE_219_length_4790_cov_9.713494	4273	4353	18	55	80	0.6875000
NODE_219_length_4790_cov_9.713494	4273	4335	2	5	62	0.0806452
NODE_219_length_4790_cov_9.713494	4273	4335	8	3	62	0.0483871
NODE_219_length_4790_cov_9.713494	4273	4335	12	7	62	0.1129032
NODE_219_length_4790_cov_9.713494	4273	4335	14	9	62	0.1451613
NODE_219_length_4790_cov_9.713494	4273	4335	16	1	62	0.0161290
NODE_219_length_4790_cov_9.713494	4273	4335	18	37	62	0.5967742
NODE_219_length_4790_cov_9.713494	4326	4406	2	14	80	0.1750000
NODE_219_length_4790_cov_9.713494	4326	4406	4	3	80	0.0375000
NODE_219_length_4790_cov_9.713494	4326	4406	8	10	80	0.1250000
NODE_219_length_4790_cov_9.713494	4326	4406	10	4	80	0.0500000
NODE_219_length_4790_cov_9.713494	4326	4406	12	9	80	0.1125000
NODE_219_length_4790_cov_9.713494	4326	4406	18	40	80	0.5000000
NODE_221_length_4772_cov_10.560454	4281	4367	0	86	86	1.0000000
NODE_222_length_4770_cov_106.953543	2778	2858	53	2	80	0.0250000
NODE_222_length_4770_cov_106.953543	2778	2858	55	1	80	0.0125000
NODE_222_length_4770_cov_106.953543	2778	2858	56	2	80	0.0250000
NODE_222_length_4770_cov_106.953543	2778	2858	62	1	80	0.0125000
NODE_222_length_4770_cov_106.953543	2778	2858	63	6	80	0.0750000
NODE_222_length_4770_cov_106.953543	2778	2858	64	2	80	0.0250000
NODE_222_length_4770_cov_106.953543	2778	2858	65	4	80	0.0500000
NODE_222_length_4770_cov_106.953543	2778	2858	66	8	80	0.1000000
NODE_222_length_4770_cov_106.953543	2778	2858	67	1	80	0.0125000
NODE_222_length_4770_cov_106.953543	2778	2858	68	1	80	0.0125000
NODE_222_length_4770_cov_106.953543	2778	2858	69	1	80	0.0125000
NODE_222_length_4770_cov_106.953543	2778	2858	70	7	80	0.0875000
NODE_222_length_4770_cov_106.953543	2778	2858	71	4	80	0.0500000
NODE_222_length_4770_cov_106.953543	2778	2858	72	11	80	0.1375000
NODE_222_length_4770_cov_106.953543	2778	2858	73	7	80	0.0875000
NODE_222_length_4770_cov_106.953543	2778	2858	74	3	80	0.0375000
NODE_222_length_4770_cov_106.953543	2778	2858	75	13	80	0.1625000
NODE_222_length_4770_cov_106.953543	2778	2858	76	1	80	0.0125000
NODE_222_length_4770_cov_106.953543	2778	2858	77	4	80	0.0500000
NODE_222_length_4770_cov_106.953543	2778	2858	79	1	80	0.0125000
NODE_222_length_4770_cov_106.953543	2831	2911	61	3	80	0.0375000
NODE_222_length_4770_cov_106.953543	2831	2911	63	6	80	0.0750000
NODE_222_length_4770_cov_106.953543	2831	2911	65	4	80	0.0500000
NODE_222_length_4770_cov_106.953543	2831	2911	66	2	80	0.0250000
NODE_222_length_4770_cov_106.953543	2831	2911	67	8	80	0.1000000
NODE_222_length_4770_cov_106.953543	2831	2911	68	1	80	0.0125000
NODE_222_length_4770_cov_106.953543	2831	2911	69	3	80	0.0375000
NODE_222_length_4770_cov_106.953543	2831	2911	70	3	80	0.0375000
NODE_222_length_4770_cov_106.953543	2831	2911	71	3	80	0.0375000
NODE_222_length_4770_cov_106.953543	2831	2911	72	3	80	0.0375000
NODE_222_length_4770_cov_106.953543	2831	2911	73	6	80	0.0750000
NODE_222_length_4770_cov_106.953543	2831	2911	74	2	80	0.0250000
NODE_222_length_4770_cov_106.953543	2831	2911	75	7	80	0.0875000
NODE_222_length_4770_cov_106.953543	2831	2911	76	1	80	0.0125000
NODE_222_length_4770_cov_106.953543	2831	2911	79	1	80	0.0125000
NODE_222_length_4770_cov_106.953543	2831	2911	80	2	80	0.0250000
NODE_222_length_4770_cov_106.953543	2831	2911	82	3	80	0.0375000
NODE_222_length_4770_cov_106.953543	2831	2911	84	4	80	0.0500000
NODE_222_length_4770_cov_106.953543	2831	2911	86	2	80	0.0250000
NODE_222_length_4770_cov_106.953543	2831	2911	93	1	80	0.0125000
NODE_222_length_4770_cov_106.953543	2831	2911	94	2	80	0.0250000
NODE_222_length_4770_cov_106.953543	2831	2911	95	1	80	0.0125000
NODE_222_length_4770_cov_106.953543	2831	2911	96	6	80	0.0750000
NODE_222_length_4770_cov_106.953543	2831	2911	99	1	80	0.0125000
NODE_222_length_4770_cov_106.953543	2831	2911	100	5	80	0.0625000
NODE_222_length_4770_cov_106.953543	2907	2987	94	2	80	0.0250000
NODE_222_length_4770_cov_106.953543	2907	2987	96	2	80	0.0250000
NODE_222_length_4770_cov_106.953543	2907	2987	105	1	80	0.0125000
NODE_222_length_4770_cov_106.953543	2907	2987	111	1	80	0.0125000
NODE_222_length_4770_cov_106.953543	2907	2987	115	6	80	0.0750000
NODE_222_length_4770_cov_106.953543	2907	2987	117	1	80	0.0125000
NODE_222_length_4770_cov_106.953543	2907	2987	118	1	80	0.0125000
NODE_222_length_4770_cov_106.953543	2907	2987	119	2	80	0.0250000
NODE_222_length_4770_cov_106.953543	2907	2987	121	2	80	0.0250000
NODE_222_length_4770_cov_106.953543	2907	2987	128	2	80	0.0250000
NODE_222_length_4770_cov_106.953543	2907	2987	134	1	80	0.0125000
NODE_222_length_4770_cov_106.953543	2907	2987	142	2	80	0.0250000
NODE_222_length_4770_cov_106.953543	2907	2987	154	1	80	0.0125000
NODE_222_length_4770_cov_106.953543	2907	2987	156	1	80	0.0125000
NODE_222_length_4770_cov_106.953543	2907	2987	164	1	80	0.0125000
NODE_222_length_4770_cov_106.953543	2907	2987	165	1	80	0.0125000
NODE_222_length_4770_cov_106.953543	2907	2987	181	2	80	0.0250000
NODE_222_length_4770_cov_106.953543	2907	2987	185	1	80	0.0125000
NODE_222_length_4770_cov_106.953543	2907	2987	187	1	80	0.0125000
NODE_222_length_4770_cov_106.953543	2907	2987	193	1	80	0.0125000
NODE_222_length_4770_cov_106.953543	2907	2987	200	1	80	0.0125000
NODE_222_length_4770_cov_106.953543	2907	2987	202	3	80	0.0375000
NODE_222_length_4770_cov_106.953543	2907	2987	204	5	80	0.0625000
NODE_222_length_4770_cov_106.953543	2907	2987	205	1	80	0.0125000
NODE_222_length_4770_cov_106.953543	2907	2987	206	1	80	0.0125000
NODE_222_length_4770_cov_106.953543	2907	2987	207	2	80	0.0250000
NODE_222_length_4770_cov_106.953543	2907	2987	208	1	80	0.0125000
NODE_222_length_4770_cov_106.953543	2907	2987	209	1	80	0.0125000
NODE_222_length_4770_cov_106.953543	2907	2987	210	4	80	0.0500000
NODE_222_length_4770_cov_106.953543	2907	2987	211	1	80	0.0125000
NODE_222_length_4770_cov_106.953543	2907	2987	212	8	80	0.1000000
NODE_222_length_4770_cov_106.953543	2907	2987	213	1	80	0.0125000
NODE_222_length_4770_cov_106.953543	2907	2987	214	2	80	0.0250000
NODE_222_length_4770_cov_106.953543	2907	2987	216	1	80	0.0125000
NODE_222_length_4770_cov_106.953543	2907	2987	222	2	80	0.0250000
NODE_222_length_4770_cov_106.953543	2907	2987	224	1	80	0.0125000
NODE_222_length_4770_cov_106.953543	2907	2987	225	1	80	0.0125000
NODE_222_length_4770_cov_106.953543	2907	2987	226	3	80	0.0375000
NODE_222_length_4770_cov_106.953543	2907	2987	227	2	80	0.0250000
NODE_222_length_4770_cov_106.953543	2907	2987	228	4	80	0.0500000
NODE_222_length_4770_cov_106.953543	2907	2987	229	1	80	0.0125000
NODE_222_length_4770_cov_106.953543	2907	2987	230	1	80	0.0125000
NODE_222_length_4770_cov_106.953543	2907	2987	231	1	80	0.0125000
NODE_222_length_4770_cov_106.953543	2960	3040	166	1	80	0.0125000
NODE_222_length_4770_cov_106.953543	2960	3040	168	1	80	0.0125000
NODE_222_length_4770_cov_106.953543	2960	3040	169	2	80	0.0250000
NODE_222_length_4770_cov_106.953543	2960	3040	170	2	80	0.0250000
NODE_222_length_4770_cov_106.953543	2960	3040	171	3	80	0.0375000
NODE_222_length_4770_cov_106.953543	2960	3040	173	1	80	0.0125000
NODE_222_length_4770_cov_106.953543	2960	3040	177	1	80	0.0125000
NODE_222_length_4770_cov_106.953543	2960	3040	187	1	80	0.0125000
NODE_222_length_4770_cov_106.953543	2960	3040	190	3	80	0.0375000
NODE_222_length_4770_cov_106.953543	2960	3040	192	4	80	0.0500000
NODE_222_length_4770_cov_106.953543	2960	3040	198	3	80	0.0375000
NODE_222_length_4770_cov_106.953543	2960	3040	202	2	80	0.0250000
NODE_222_length_4770_cov_106.953543	2960	3040	208	2	80	0.0250000
NODE_222_length_4770_cov_106.953543	2960	3040	210	2	80	0.0250000
NODE_222_length_4770_cov_106.953543	2960	3040	211	2	80	0.0250000
NODE_222_length_4770_cov_106.953543	2960	3040	212	4	80	0.0500000
NODE_222_length_4770_cov_106.953543	2960	3040	213	1	80	0.0125000
NODE_222_length_4770_cov_106.953543	2960	3040	214	5	80	0.0625000
NODE_222_length_4770_cov_106.953543	2960	3040	215	1	80	0.0125000
NODE_222_length_4770_cov_106.953543	2960	3040	216	1	80	0.0125000
NODE_222_length_4770_cov_106.953543	2960	3040	217	2	80	0.0250000
NODE_222_length_4770_cov_106.953543	2960	3040	218	1	80	0.0125000
NODE_222_length_4770_cov_106.953543	2960	3040	219	1	80	0.0125000
NODE_222_length_4770_cov_106.953543	2960	3040	220	4	80	0.0500000
NODE_222_length_4770_cov_106.953543	2960	3040	221	2	80	0.0250000
NODE_222_length_4770_cov_106.953543	2960	3040	222	3	80	0.0375000
NODE_222_length_4770_cov_106.953543	2960	3040	223	1	80	0.0125000
NODE_222_length_4770_cov_106.953543	2960	3040	224	1	80	0.0125000
NODE_222_length_4770_cov_106.953543	2960	3040	225	2	80	0.0250000
NODE_222_length_4770_cov_106.953543	2960	3040	226	3	80	0.0375000
NODE_222_length_4770_cov_106.953543	2960	3040	227	2	80	0.0250000
NODE_222_length_4770_cov_106.953543	2960	3040	228	7	80	0.0875000
NODE_222_length_4770_cov_106.953543	2960	3040	229	2	80	0.0250000
NODE_222_length_4770_cov_106.953543	2960	3040	230	2	80	0.0250000
NODE_222_length_4770_cov_106.953543	2960	3040	231	3	80	0.0375000
NODE_222_length_4770_cov_106.953543	2960	3040	232	2	80	0.0250000
NODE_223_length_4768_cov_15.447205	1237	1317	16	2	80	0.0250000
NODE_223_length_4768_cov_15.447205	1237	1317	17	6	80	0.0750000
NODE_223_length_4768_cov_15.447205	1237	1317	19	2	80	0.0250000
NODE_223_length_4768_cov_15.447205	1237	1317	21	1	80	0.0125000
NODE_223_length_4768_cov_15.447205	1237	1317	24	1	80	0.0125000
NODE_223_length_4768_cov_15.447205	1237	1317	25	4	80	0.0500000
NODE_223_length_4768_cov_15.447205	1237	1317	27	6	80	0.0750000
NODE_223_length_4768_cov_15.447205	1237	1317	29	3	80	0.0375000
NODE_223_length_4768_cov_15.447205	1237	1317	30	3	80	0.0375000
NODE_223_length_4768_cov_15.447205	1237	1317	32	44	80	0.5500000
NODE_223_length_4768_cov_15.447205	1237	1317	34	7	80	0.0875000
NODE_223_length_4768_cov_15.447205	1237	1317	36	1	80	0.0125000
NODE_228_length_4730_cov_30.142734	256	336	2	16	80	0.2000000
NODE_228_length_4730_cov_30.142734	256	336	8	9	80	0.1125000
NODE_228_length_4730_cov_30.142734	256	336	12	1	80	0.0125000
NODE_228_length_4730_cov_30.142734	256	336	13	54	80	0.6750000
NODE_228_length_4730_cov_30.142734	309	389	12	24	80	0.3000000
NODE_228_length_4730_cov_30.142734	309	389	13	55	80	0.6875000
NODE_228_length_4730_cov_30.142734	309	389	14	1	80	0.0125000
NODE_228_length_4730_cov_30.142734	4052	4132	0	80	80	1.0000000
NODE_228_length_4730_cov_30.142734	4105	4185	0	80	80	1.0000000
NODE_231_length_4706_cov_25.522683	2181	2261	21	4	80	0.0500000
NODE_231_length_4706_cov_25.522683	2181	2261	23	9	80	0.1125000
NODE_231_length_4706_cov_25.522683	2181	2261	25	4	80	0.0500000
NODE_231_length_4706_cov_25.522683	2181	2261	26	1	80	0.0125000
NODE_231_length_4706_cov_25.522683	2181	2261	28	2	80	0.0250000
NODE_231_length_4706_cov_25.522683	2181	2261	29	7	80	0.0875000
NODE_231_length_4706_cov_25.522683	2181	2261	30	4	80	0.0500000
NODE_231_length_4706_cov_25.522683	2181	2261	35	1	80	0.0125000
NODE_231_length_4706_cov_25.522683	2181	2261	37	2	80	0.0250000
NODE_231_length_4706_cov_25.522683	2181	2261	38	2	80	0.0250000
NODE_231_length_4706_cov_25.522683	2181	2261	42	1	80	0.0125000
NODE_231_length_4706_cov_25.522683	2181	2261	43	1	80	0.0125000
NODE_231_length_4706_cov_25.522683	2181	2261	45	1	80	0.0125000
NODE_231_length_4706_cov_25.522683	2181	2261	47	1	80	0.0125000
NODE_231_length_4706_cov_25.522683	2181	2261	52	1	80	0.0125000
NODE_231_length_4706_cov_25.522683	2181	2261	53	3	80	0.0375000
NODE_231_length_4706_cov_25.522683	2181	2261	55	1	80	0.0125000
NODE_231_length_4706_cov_25.522683	2181	2261	61	1	80	0.0125000
NODE_231_length_4706_cov_25.522683	2181	2261	64	1	80	0.0125000
NODE_231_length_4706_cov_25.522683	2181	2261	65	1	80	0.0125000
NODE_231_length_4706_cov_25.522683	2181	2261	67	1	80	0.0125000
NODE_231_length_4706_cov_25.522683	2181	2261	71	1	80	0.0125000
NODE_231_length_4706_cov_25.522683	2181	2261	72	1	80	0.0125000
NODE_231_length_4706_cov_25.522683	2181	2261	75	1	80	0.0125000
NODE_231_length_4706_cov_25.522683	2181	2261	76	2	80	0.0250000
NODE_231_length_4706_cov_25.522683	2181	2261	78	2	80	0.0250000
NODE_231_length_4706_cov_25.522683	2181	2261	81	1	80	0.0125000
NODE_231_length_4706_cov_25.522683	2181	2261	86	1	80	0.0125000
NODE_231_length_4706_cov_25.522683	2181	2261	90	2	80	0.0250000
NODE_231_length_4706_cov_25.522683	2181	2261	92	2	80	0.0250000
NODE_231_length_4706_cov_25.522683	2181	2261	96	2	80	0.0250000
NODE_231_length_4706_cov_25.522683	2181	2261	97	4	80	0.0500000
NODE_231_length_4706_cov_25.522683	2181	2261	99	1	80	0.0125000
NODE_231_length_4706_cov_25.522683	2181	2261	102	2	80	0.0250000
NODE_231_length_4706_cov_25.522683	2181	2261	108	1	80	0.0125000
NODE_231_length_4706_cov_25.522683	2181	2261	109	2	80	0.0250000
NODE_231_length_4706_cov_25.522683	2181	2261	113	1	80	0.0125000
NODE_231_length_4706_cov_25.522683	2181	2261	117	1	80	0.0125000
NODE_231_length_4706_cov_25.522683	2181	2261	119	1	80	0.0125000
NODE_231_length_4706_cov_25.522683	2181	2261	125	1	80	0.0125000
NODE_231_length_4706_cov_25.522683	2181	2261	126	2	80	0.0250000
NODE_231_length_4706_cov_25.522683	2234	2288	2	2	54	0.0370370
NODE_231_length_4706_cov_25.522683	2234	2288	8	6	54	0.1111111
NODE_231_length_4706_cov_25.522683	2234	2288	10	1	54	0.0185185
NODE_231_length_4706_cov_25.522683	2234	2288	11	8	54	0.1481481
NODE_231_length_4706_cov_25.522683	2234	2288	14	5	54	0.0925926
NODE_231_length_4706_cov_25.522683	2234	2288	17	2	54	0.0370370
NODE_231_length_4706_cov_25.522683	2234	2288	21	7	54	0.1296296
NODE_231_length_4706_cov_25.522683	2234	2288	23	9	54	0.1666667
NODE_231_length_4706_cov_25.522683	2234	2288	25	4	54	0.0740741
NODE_231_length_4706_cov_25.522683	2234	2288	26	1	54	0.0185185
NODE_231_length_4706_cov_25.522683	2234	2288	28	2	54	0.0370370
NODE_231_length_4706_cov_25.522683	2234	2288	29	7	54	0.1296296
NODE_231_length_4706_cov_25.522683	3943	4026	10	2	83	0.0240964
NODE_231_length_4706_cov_25.522683	3943	4026	12	2	83	0.0240964
NODE_231_length_4706_cov_25.522683	3943	4026	14	24	83	0.2891566
NODE_231_length_4706_cov_25.522683	3943	4026	16	3	83	0.0361446
NODE_231_length_4706_cov_25.522683	3943	4026	20	28	83	0.3373494
NODE_231_length_4706_cov_25.522683	3943	4026	22	20	83	0.2409639
NODE_231_length_4706_cov_25.522683	3943	4026	24	4	83	0.0481928
NODE_235_length_4693_cov_16.973008	374	454	4	1	80	0.0125000
NODE_235_length_4693_cov_16.973008	374	454	6	43	80	0.5375000
NODE_235_length_4693_cov_16.973008	374	454	8	5	80	0.0625000
NODE_235_length_4693_cov_16.973008	374	454	9	13	80	0.1625000
NODE_235_length_4693_cov_16.973008	374	454	11	18	80	0.2250000
NODE_235_length_4693_cov_16.973008	427	507	8	4	80	0.0500000
NODE_235_length_4693_cov_16.973008	427	507	9	9	80	0.1125000
NODE_235_length_4693_cov_16.973008	427	507	11	21	80	0.2625000
NODE_235_length_4693_cov_16.973008	427	507	12	13	80	0.1625000
NODE_235_length_4693_cov_16.973008	427	507	13	2	80	0.0250000
NODE_235_length_4693_cov_16.973008	427	507	14	31	80	0.3875000
NODE_240_length_4672_cov_39.029084	1391	1470	138	1	79	0.0126582
NODE_240_length_4672_cov_39.029084	1391	1470	161	1	79	0.0126582
NODE_240_length_4672_cov_39.029084	1391	1470	168	1	79	0.0126582
NODE_240_length_4672_cov_39.029084	1391	1470	176	1	79	0.0126582
NODE_240_length_4672_cov_39.029084	1391	1470	180	1	79	0.0126582
NODE_240_length_4672_cov_39.029084	1391	1470	181	1	79	0.0126582
NODE_240_length_4672_cov_39.029084	1391	1470	183	1	79	0.0126582
NODE_240_length_4672_cov_39.029084	1391	1470	187	3	79	0.0379747
NODE_240_length_4672_cov_39.029084	1391	1470	196	1	79	0.0126582
NODE_240_length_4672_cov_39.029084	1391	1470	205	1	79	0.0126582
NODE_240_length_4672_cov_39.029084	1391	1470	213	2	79	0.0253165
NODE_240_length_4672_cov_39.029084	1391	1470	226	1	79	0.0126582
NODE_240_length_4672_cov_39.029084	1391	1470	230	1	79	0.0126582
NODE_240_length_4672_cov_39.029084	1391	1470	236	2	79	0.0253165
NODE_240_length_4672_cov_39.029084	1391	1470	240	1	79	0.0126582
NODE_240_length_4672_cov_39.029084	1391	1470	242	1	79	0.0126582
NODE_240_length_4672_cov_39.029084	1391	1470	250	1	79	0.0126582
NODE_240_length_4672_cov_39.029084	1391	1470	254	1	79	0.0126582
NODE_240_length_4672_cov_39.029084	1391	1470	265	1	79	0.0126582
NODE_240_length_4672_cov_39.029084	1391	1470	274	1	79	0.0126582
NODE_240_length_4672_cov_39.029084	1391	1470	292	1	79	0.0126582
NODE_240_length_4672_cov_39.029084	1391	1470	296	1	79	0.0126582
NODE_240_length_4672_cov_39.029084	1391	1470	300	1	79	0.0126582
NODE_240_length_4672_cov_39.029084	1391	1470	304	1	79	0.0126582
NODE_240_length_4672_cov_39.029084	1391	1470	314	1	79	0.0126582
NODE_240_length_4672_cov_39.029084	1391	1470	320	1	79	0.0126582
NODE_240_length_4672_cov_39.029084	1391	1470	324	1	79	0.0126582
NODE_240_length_4672_cov_39.029084	1391	1470	343	1	79	0.0126582
NODE_240_length_4672_cov_39.029084	1391	1470	352	1	79	0.0126582
NODE_240_length_4672_cov_39.029084	1391	1470	366	1	79	0.0126582
NODE_240_length_4672_cov_39.029084	1391	1470	382	1	79	0.0126582
NODE_240_length_4672_cov_39.029084	1391	1470	387	1	79	0.0126582
NODE_240_length_4672_cov_39.029084	1391	1470	395	1	79	0.0126582
NODE_240_length_4672_cov_39.029084	1391	1470	397	1	79	0.0126582
NODE_240_length_4672_cov_39.029084	1391	1470	401	1	79	0.0126582
NODE_240_length_4672_cov_39.029084	1391	1470	407	1	79	0.0126582
NODE_240_length_4672_cov_39.029084	1391	1470	415	1	79	0.0126582
NODE_240_length_4672_cov_39.029084	1391	1470	419	2	79	0.0253165
NODE_240_length_4672_cov_39.029084	1391	1470	424	1	79	0.0126582
NODE_240_length_4672_cov_39.029084	1391	1470	426	1	79	0.0126582
NODE_240_length_4672_cov_39.029084	1391	1470	428	2	79	0.0253165
NODE_240_length_4672_cov_39.029084	1391	1470	430	1	79	0.0126582
NODE_240_length_4672_cov_39.029084	1391	1470	444	1	79	0.0126582
NODE_240_length_4672_cov_39.029084	1391	1470	446	3	79	0.0379747
NODE_240_length_4672_cov_39.029084	1391	1470	452	1	79	0.0126582
NODE_240_length_4672_cov_39.029084	1391	1470	454	1	79	0.0126582
NODE_240_length_4672_cov_39.029084	1391	1470	458	1	79	0.0126582
NODE_240_length_4672_cov_39.029084	1391	1470	462	1	79	0.0126582
NODE_240_length_4672_cov_39.029084	1391	1470	466	1	79	0.0126582
NODE_240_length_4672_cov_39.029084	1391	1470	467	2	79	0.0253165
NODE_240_length_4672_cov_39.029084	1391	1470	483	1	79	0.0126582
NODE_240_length_4672_cov_39.029084	1391	1470	487	1	79	0.0126582
NODE_240_length_4672_cov_39.029084	1391	1470	491	1	79	0.0126582
NODE_240_length_4672_cov_39.029084	1391	1470	495	1	79	0.0126582
NODE_240_length_4672_cov_39.029084	1391	1470	497	1	79	0.0126582
NODE_240_length_4672_cov_39.029084	1391	1470	498	1	79	0.0126582
NODE_240_length_4672_cov_39.029084	1391	1470	499	3	79	0.0379747
NODE_240_length_4672_cov_39.029084	1391	1470	500	1	79	0.0126582
NODE_240_length_4672_cov_39.029084	1391	1470	501	3	79	0.0379747
NODE_240_length_4672_cov_39.029084	1391	1470	503	6	79	0.0759494
NODE_240_length_4672_cov_39.029084	1391	1470	505	1	79	0.0126582
NODE_240_length_4672_cov_39.029084	1444	1523	218	1	79	0.0126582
NODE_240_length_4672_cov_39.029084	1444	1523	226	1	79	0.0126582
NODE_240_length_4672_cov_39.029084	1444	1523	246	1	79	0.0126582
NODE_240_length_4672_cov_39.029084	1444	1523	252	1	79	0.0126582
NODE_240_length_4672_cov_39.029084	1444	1523	260	1	79	0.0126582
NODE_240_length_4672_cov_39.029084	1444	1523	267	1	79	0.0126582
NODE_240_length_4672_cov_39.029084	1444	1523	286	1	79	0.0126582
NODE_240_length_4672_cov_39.029084	1444	1523	293	1	79	0.0126582
NODE_240_length_4672_cov_39.029084	1444	1523	308	1	79	0.0126582
NODE_240_length_4672_cov_39.029084	1444	1523	312	1	79	0.0126582
NODE_240_length_4672_cov_39.029084	1444	1523	318	2	79	0.0253165
NODE_240_length_4672_cov_39.029084	1444	1523	324	1	79	0.0126582
NODE_240_length_4672_cov_39.029084	1444	1523	336	1	79	0.0126582
NODE_240_length_4672_cov_39.029084	1444	1523	354	1	79	0.0126582
NODE_240_length_4672_cov_39.029084	1444	1523	364	1	79	0.0126582
NODE_240_length_4672_cov_39.029084	1444	1523	372	1	79	0.0126582
NODE_240_length_4672_cov_39.029084	1444	1523	375	1	79	0.0126582
NODE_240_length_4672_cov_39.029084	1444	1523	394	1	79	0.0126582
NODE_240_length_4672_cov_39.029084	1444	1523	395	3	79	0.0379747
NODE_240_length_4672_cov_39.029084	1444	1523	399	1	79	0.0126582
NODE_240_length_4672_cov_39.029084	1444	1523	404	1	79	0.0126582
NODE_240_length_4672_cov_39.029084	1444	1523	408	1	79	0.0126582
NODE_240_length_4672_cov_39.029084	1444	1523	416	1	79	0.0126582
NODE_240_length_4672_cov_39.029084	1444	1523	417	1	79	0.0126582
NODE_240_length_4672_cov_39.029084	1444	1523	428	1	79	0.0126582
NODE_240_length_4672_cov_39.029084	1444	1523	432	1	79	0.0126582
NODE_240_length_4672_cov_39.029084	1444	1523	437	1	79	0.0126582
NODE_240_length_4672_cov_39.029084	1444	1523	441	1	79	0.0126582
NODE_240_length_4672_cov_39.029084	1444	1523	454	1	79	0.0126582
NODE_240_length_4672_cov_39.029084	1444	1523	455	2	79	0.0253165
NODE_240_length_4672_cov_39.029084	1444	1523	458	1	79	0.0126582
NODE_240_length_4672_cov_39.029084	1444	1523	462	1	79	0.0126582
NODE_240_length_4672_cov_39.029084	1444	1523	466	1	79	0.0126582
NODE_240_length_4672_cov_39.029084	1444	1523	467	2	79	0.0253165
NODE_240_length_4672_cov_39.029084	1444	1523	471	2	79	0.0253165
NODE_240_length_4672_cov_39.029084	1444	1523	475	2	79	0.0253165
NODE_240_length_4672_cov_39.029084	1444	1523	477	1	79	0.0126582
NODE_240_length_4672_cov_39.029084	1444	1523	483	1	79	0.0126582
NODE_240_length_4672_cov_39.029084	1444	1523	484	1	79	0.0126582
NODE_240_length_4672_cov_39.029084	1444	1523	485	3	79	0.0379747
NODE_240_length_4672_cov_39.029084	1444	1523	487	3	79	0.0379747
NODE_240_length_4672_cov_39.029084	1444	1523	491	1	79	0.0126582
NODE_240_length_4672_cov_39.029084	1444	1523	495	1	79	0.0126582
NODE_240_length_4672_cov_39.029084	1444	1523	496	2	79	0.0253165
NODE_240_length_4672_cov_39.029084	1444	1523	497	1	79	0.0126582
NODE_240_length_4672_cov_39.029084	1444	1523	498	6	79	0.0759494
NODE_240_length_4672_cov_39.029084	1444	1523	499	3	79	0.0379747
NODE_240_length_4672_cov_39.029084	1444	1523	500	2	79	0.0253165
NODE_240_length_4672_cov_39.029084	1444	1523	501	3	79	0.0379747
NODE_240_length_4672_cov_39.029084	1444	1523	502	1	79	0.0126582
NODE_240_length_4672_cov_39.029084	1444	1523	503	6	79	0.0759494
NODE_240_length_4672_cov_39.029084	1444	1523	505	1	79	0.0126582
NODE_246_length_4602_cov_17.281368	3106	3186	0	46	80	0.5750000
NODE_246_length_4602_cov_17.281368	3106	3186	4	2	80	0.0250000
NODE_246_length_4602_cov_17.281368	3106	3186	8	30	80	0.3750000
NODE_246_length_4602_cov_17.281368	3106	3186	10	2	80	0.0250000
NODE_246_length_4602_cov_17.281368	3159	3239	6	14	80	0.1750000
NODE_246_length_4602_cov_17.281368	3159	3239	8	25	80	0.3125000
NODE_246_length_4602_cov_17.281368	3159	3239	10	41	80	0.5125000
NODE_248_length_4587_cov_14.431150	1294	1370	131	2	76	0.0263158
NODE_248_length_4587_cov_14.431150	1294	1370	135	2	76	0.0263158
NODE_248_length_4587_cov_14.431150	1294	1370	136	1	76	0.0131579
NODE_248_length_4587_cov_14.431150	1294	1370	137	1	76	0.0131579
NODE_248_length_4587_cov_14.431150	1294	1370	138	3	76	0.0394737
NODE_248_length_4587_cov_14.431150	1294	1370	139	4	76	0.0526316
NODE_248_length_4587_cov_14.431150	1294	1370	141	3	76	0.0394737
NODE_248_length_4587_cov_14.431150	1294	1370	142	1	76	0.0131579
NODE_248_length_4587_cov_14.431150	1294	1370	145	2	76	0.0263158
NODE_248_length_4587_cov_14.431150	1294	1370	147	2	76	0.0263158
NODE_248_length_4587_cov_14.431150	1294	1370	150	1	76	0.0131579
NODE_248_length_4587_cov_14.431150	1294	1370	155	1	76	0.0131579
NODE_248_length_4587_cov_14.431150	1294	1370	157	6	76	0.0789474
NODE_248_length_4587_cov_14.431150	1294	1370	158	4	76	0.0526316
NODE_248_length_4587_cov_14.431150	1294	1370	159	5	76	0.0657895
NODE_248_length_4587_cov_14.431150	1294	1370	160	5	76	0.0657895
NODE_248_length_4587_cov_14.431150	1294	1370	161	6	76	0.0789474
NODE_248_length_4587_cov_14.431150	1294	1370	162	8	76	0.1052632
NODE_248_length_4587_cov_14.431150	1294	1370	163	8	76	0.1052632
NODE_248_length_4587_cov_14.431150	1294	1370	164	5	76	0.0657895
NODE_248_length_4587_cov_14.431150	1294	1370	165	3	76	0.0394737
NODE_248_length_4587_cov_14.431150	1294	1370	166	2	76	0.0263158
NODE_248_length_4587_cov_14.431150	1294	1370	168	1	76	0.0131579
NODE_248_length_4587_cov_14.431150	1347	1427	157	2	80	0.0250000
NODE_248_length_4587_cov_14.431150	1347	1427	158	1	80	0.0125000
NODE_248_length_4587_cov_14.431150	1347	1427	159	4	80	0.0500000
NODE_248_length_4587_cov_14.431150	1347	1427	160	1	80	0.0125000
NODE_248_length_4587_cov_14.431150	1347	1427	161	6	80	0.0750000
NODE_248_length_4587_cov_14.431150	1347	1427	162	5	80	0.0625000
NODE_248_length_4587_cov_14.431150	1347	1427	163	5	80	0.0625000
NODE_248_length_4587_cov_14.431150	1347	1427	164	2	80	0.0250000
NODE_248_length_4587_cov_14.431150	1347	1427	165	1	80	0.0125000
NODE_248_length_4587_cov_14.431150	1347	1427	166	4	80	0.0500000
NODE_248_length_4587_cov_14.431150	1347	1427	168	3	80	0.0375000
NODE_248_length_4587_cov_14.431150	1347	1427	170	3	80	0.0375000
NODE_248_length_4587_cov_14.431150	1347	1427	172	5	80	0.0625000
NODE_248_length_4587_cov_14.431150	1347	1427	173	3	80	0.0375000
NODE_248_length_4587_cov_14.431150	1347	1427	175	1	80	0.0125000
NODE_248_length_4587_cov_14.431150	1347	1427	176	1	80	0.0125000
NODE_248_length_4587_cov_14.431150	1347	1427	177	4	80	0.0500000
NODE_248_length_4587_cov_14.431150	1347	1427	178	1	80	0.0125000
NODE_248_length_4587_cov_14.431150	1347	1427	179	1	80	0.0125000
NODE_248_length_4587_cov_14.431150	1347	1427	182	5	80	0.0625000
NODE_248_length_4587_cov_14.431150	1347	1427	183	1	80	0.0125000
NODE_248_length_4587_cov_14.431150	1347	1427	184	1	80	0.0125000
NODE_248_length_4587_cov_14.431150	1347	1427	185	2	80	0.0250000
NODE_248_length_4587_cov_14.431150	1347	1427	186	2	80	0.0250000
NODE_248_length_4587_cov_14.431150	1347	1427	187	1	80	0.0125000
NODE_248_length_4587_cov_14.431150	1347	1427	189	1	80	0.0125000
NODE_248_length_4587_cov_14.431150	1347	1427	191	4	80	0.0500000
NODE_248_length_4587_cov_14.431150	1347	1427	193	1	80	0.0125000
NODE_248_length_4587_cov_14.431150	1347	1427	194	3	80	0.0375000
NODE_248_length_4587_cov_14.431150	1347	1427	196	1	80	0.0125000
NODE_248_length_4587_cov_14.431150	1347	1427	197	1	80	0.0125000
NODE_248_length_4587_cov_14.431150	1347	1427	199	1	80	0.0125000
NODE_248_length_4587_cov_14.431150	1347	1427	200	1	80	0.0125000
NODE_248_length_4587_cov_14.431150	1347	1427	201	1	80	0.0125000
NODE_248_length_4587_cov_14.431150	1347	1427	202	1	80	0.0125000
NODE_248_length_4587_cov_14.431150	1466	1533	135	4	67	0.0597015
NODE_248_length_4587_cov_14.431150	1466	1533	141	2	67	0.0298507
NODE_248_length_4587_cov_14.431150	1466	1533	142	3	67	0.0447761
NODE_248_length_4587_cov_14.431150	1466	1533	143	4	67	0.0597015
NODE_248_length_4587_cov_14.431150	1466	1533	144	2	67	0.0298507
NODE_248_length_4587_cov_14.431150	1466	1533	146	1	67	0.0149254
NODE_248_length_4587_cov_14.431150	1466	1533	148	2	67	0.0298507
NODE_248_length_4587_cov_14.431150	1466	1533	149	1	67	0.0149254
NODE_248_length_4587_cov_14.431150	1466	1533	151	6	67	0.0895522
NODE_248_length_4587_cov_14.431150	1466	1533	152	2	67	0.0298507
NODE_248_length_4587_cov_14.431150	1466	1533	153	5	67	0.0746269
NODE_248_length_4587_cov_14.431150	1466	1533	154	1	67	0.0149254
NODE_248_length_4587_cov_14.431150	1466	1533	155	3	67	0.0447761
NODE_248_length_4587_cov_14.431150	1466	1533	156	8	67	0.1194030
NODE_248_length_4587_cov_14.431150	1466	1533	158	9	67	0.1343284
NODE_248_length_4587_cov_14.431150	1466	1533	159	2	67	0.0298507
NODE_248_length_4587_cov_14.431150	1466	1533	160	5	67	0.0746269
NODE_248_length_4587_cov_14.431150	1466	1533	161	1	67	0.0149254
NODE_248_length_4587_cov_14.431150	1466	1533	163	3	67	0.0447761
NODE_248_length_4587_cov_14.431150	1466	1533	164	1	67	0.0149254
NODE_248_length_4587_cov_14.431150	1466	1533	165	1	67	0.0149254
NODE_248_length_4587_cov_14.431150	1466	1533	169	1	67	0.0149254
NODE_248_length_4587_cov_14.431150	4316	4382	417	1	66	0.0151515
NODE_248_length_4587_cov_14.431150	4316	4382	423	1	66	0.0151515
NODE_248_length_4587_cov_14.431150	4316	4382	435	1	66	0.0151515
NODE_248_length_4587_cov_14.431150	4316	4382	459	1	66	0.0151515
NODE_248_length_4587_cov_14.431150	4316	4382	468	1	66	0.0151515
NODE_248_length_4587_cov_14.431150	4316	4382	472	1	66	0.0151515
NODE_248_length_4587_cov_14.431150	4316	4382	479	1	66	0.0151515
NODE_248_length_4587_cov_14.431150	4316	4382	497	1	66	0.0151515
NODE_248_length_4587_cov_14.431150	4316	4382	508	2	66	0.0303030
NODE_248_length_4587_cov_14.431150	4316	4382	514	1	66	0.0151515
NODE_248_length_4587_cov_14.431150	4316	4382	555	1	66	0.0151515
NODE_248_length_4587_cov_14.431150	4316	4382	576	1	66	0.0151515
NODE_248_length_4587_cov_14.431150	4316	4382	605	1	66	0.0151515
NODE_248_length_4587_cov_14.431150	4316	4382	611	1	66	0.0151515
NODE_248_length_4587_cov_14.431150	4316	4382	619	1	66	0.0151515
NODE_248_length_4587_cov_14.431150	4316	4382	620	1	66	0.0151515
NODE_248_length_4587_cov_14.431150	4316	4382	621	1	66	0.0151515
NODE_248_length_4587_cov_14.431150	4316	4382	636	2	66	0.0303030
NODE_248_length_4587_cov_14.431150	4316	4382	650	1	66	0.0151515
NODE_248_length_4587_cov_14.431150	4316	4382	660	1	66	0.0151515
NODE_248_length_4587_cov_14.431150	4316	4382	662	1	66	0.0151515
NODE_248_length_4587_cov_14.431150	4316	4382	666	1	66	0.0151515
NODE_248_length_4587_cov_14.431150	4316	4382	667	1	66	0.0151515
NODE_248_length_4587_cov_14.431150	4316	4382	669	2	66	0.0303030
NODE_248_length_4587_cov_14.431150	4316	4382	683	1	66	0.0151515
NODE_248_length_4587_cov_14.431150	4316	4382	686	1	66	0.0151515
NODE_248_length_4587_cov_14.431150	4316	4382	702	1	66	0.0151515
NODE_248_length_4587_cov_14.431150	4316	4382	720	1	66	0.0151515
NODE_248_length_4587_cov_14.431150	4316	4382	732	1	66	0.0151515
NODE_248_length_4587_cov_14.431150	4316	4382	734	1	66	0.0151515
NODE_248_length_4587_cov_14.431150	4316	4382	736	1	66	0.0151515
NODE_248_length_4587_cov_14.431150	4316	4382	742	1	66	0.0151515
NODE_248_length_4587_cov_14.431150	4316	4382	745	1	66	0.0151515
NODE_248_length_4587_cov_14.431150	4316	4382	749	1	66	0.0151515
NODE_248_length_4587_cov_14.431150	4316	4382	758	1	66	0.0151515
NODE_248_length_4587_cov_14.431150	4316	4382	770	1	66	0.0151515
NODE_248_length_4587_cov_14.431150	4316	4382	776	1	66	0.0151515
NODE_248_length_4587_cov_14.431150	4316	4382	794	2	66	0.0303030
NODE_248_length_4587_cov_14.431150	4316	4382	799	2	66	0.0303030
NODE_248_length_4587_cov_14.431150	4316	4382	801	1	66	0.0151515
NODE_248_length_4587_cov_14.431150	4316	4382	802	1	66	0.0151515
NODE_248_length_4587_cov_14.431150	4316	4382	810	1	66	0.0151515
NODE_248_length_4587_cov_14.431150	4316	4382	811	3	66	0.0454545
NODE_248_length_4587_cov_14.431150	4316	4382	812	1	66	0.0151515
NODE_248_length_4587_cov_14.431150	4316	4382	819	1	66	0.0151515
NODE_248_length_4587_cov_14.431150	4316	4382	821	4	66	0.0606061
NODE_248_length_4587_cov_14.431150	4316	4382	822	1	66	0.0151515
NODE_248_length_4587_cov_14.431150	4316	4382	823	2	66	0.0303030
NODE_248_length_4587_cov_14.431150	4316	4382	824	1	66	0.0151515
NODE_248_length_4587_cov_14.431150	4316	4382	825	1	66	0.0151515
NODE_248_length_4587_cov_14.431150	4316	4382	826	1	66	0.0151515
NODE_248_length_4587_cov_14.431150	4316	4382	828	1	66	0.0151515
NODE_248_length_4587_cov_14.431150	4316	4382	830	1	66	0.0151515
NODE_248_length_4587_cov_14.431150	4316	4382	831	2	66	0.0303030
NODE_248_length_4587_cov_14.431150	4355	4435	680	1	80	0.0125000
NODE_248_length_4587_cov_14.431150	4355	4435	693	1	80	0.0125000
NODE_248_length_4587_cov_14.431150	4355	4435	701	1	80	0.0125000
NODE_248_length_4587_cov_14.431150	4355	4435	716	1	80	0.0125000
NODE_248_length_4587_cov_14.431150	4355	4435	727	1	80	0.0125000
NODE_248_length_4587_cov_14.431150	4355	4435	733	1	80	0.0125000
NODE_248_length_4587_cov_14.431150	4355	4435	746	1	80	0.0125000
NODE_248_length_4587_cov_14.431150	4355	4435	749	1	80	0.0125000
NODE_248_length_4587_cov_14.431150	4355	4435	762	3	80	0.0375000
NODE_248_length_4587_cov_14.431150	4355	4435	766	1	80	0.0125000
NODE_248_length_4587_cov_14.431150	4355	4435	768	1	80	0.0125000
NODE_248_length_4587_cov_14.431150	4355	4435	771	1	80	0.0125000
NODE_248_length_4587_cov_14.431150	4355	4435	775	1	80	0.0125000
NODE_248_length_4587_cov_14.431150	4355	4435	776	1	80	0.0125000
NODE_248_length_4587_cov_14.431150	4355	4435	782	2	80	0.0250000
NODE_248_length_4587_cov_14.431150	4355	4435	794	2	80	0.0250000
NODE_248_length_4587_cov_14.431150	4355	4435	795	1	80	0.0125000
NODE_248_length_4587_cov_14.431150	4355	4435	799	2	80	0.0250000
NODE_248_length_4587_cov_14.431150	4355	4435	801	1	80	0.0125000
NODE_248_length_4587_cov_14.431150	4355	4435	802	1	80	0.0125000
NODE_248_length_4587_cov_14.431150	4355	4435	807	1	80	0.0125000
NODE_248_length_4587_cov_14.431150	4355	4435	810	1	80	0.0125000
NODE_248_length_4587_cov_14.431150	4355	4435	811	3	80	0.0375000
NODE_248_length_4587_cov_14.431150	4355	4435	812	1	80	0.0125000
NODE_248_length_4587_cov_14.431150	4355	4435	813	2	80	0.0250000
NODE_248_length_4587_cov_14.431150	4355	4435	816	1	80	0.0125000
NODE_248_length_4587_cov_14.431150	4355	4435	817	1	80	0.0125000
NODE_248_length_4587_cov_14.431150	4355	4435	819	1	80	0.0125000
NODE_248_length_4587_cov_14.431150	4355	4435	821	4	80	0.0500000
NODE_248_length_4587_cov_14.431150	4355	4435	822	3	80	0.0375000
NODE_248_length_4587_cov_14.431150	4355	4435	823	2	80	0.0250000
NODE_248_length_4587_cov_14.431150	4355	4435	824	3	80	0.0375000
NODE_248_length_4587_cov_14.431150	4355	4435	825	5	80	0.0625000
NODE_248_length_4587_cov_14.431150	4355	4435	826	4	80	0.0500000
NODE_248_length_4587_cov_14.431150	4355	4435	827	2	80	0.0250000
NODE_248_length_4587_cov_14.431150	4355	4435	828	3	80	0.0375000
NODE_248_length_4587_cov_14.431150	4355	4435	829	1	80	0.0125000
NODE_248_length_4587_cov_14.431150	4355	4435	830	1	80	0.0125000
NODE_248_length_4587_cov_14.431150	4355	4435	831	4	80	0.0500000
NODE_248_length_4587_cov_14.431150	4355	4435	832	1	80	0.0125000
NODE_248_length_4587_cov_14.431150	4355	4435	833	2	80	0.0250000
NODE_248_length_4587_cov_14.431150	4355	4435	834	1	80	0.0125000
NODE_248_length_4587_cov_14.431150	4355	4435	835	1	80	0.0125000
NODE_248_length_4587_cov_14.431150	4355	4435	836	3	80	0.0375000
NODE_248_length_4587_cov_14.431150	4355	4435	837	1	80	0.0125000
NODE_248_length_4587_cov_14.431150	4355	4435	839	1	80	0.0125000
NODE_248_length_4587_cov_14.431150	4355	4435	840	1	80	0.0125000
NODE_248_length_4587_cov_14.431150	4355	4435	841	1	80	0.0125000
NODE_249_length_4572_cov_50.244579	2406	2483	10	8	77	0.1038961
NODE_249_length_4572_cov_50.244579	2406	2483	14	1	77	0.0129870
NODE_249_length_4572_cov_50.244579	2406	2483	15	3	77	0.0389610
NODE_249_length_4572_cov_50.244579	2406	2483	18	26	77	0.3376623
NODE_249_length_4572_cov_50.244579	2406	2483	19	16	77	0.2077922
NODE_249_length_4572_cov_50.244579	2406	2483	20	23	77	0.2987013
NODE_249_length_4572_cov_50.244579	2406	2483	10	8	77	0.1038961
NODE_249_length_4572_cov_50.244579	2406	2483	14	1	77	0.0129870
NODE_249_length_4572_cov_50.244579	2406	2483	15	3	77	0.0389610
NODE_249_length_4572_cov_50.244579	2406	2483	18	26	77	0.3376623
NODE_249_length_4572_cov_50.244579	2406	2483	19	16	77	0.2077922
NODE_249_length_4572_cov_50.244579	2406	2483	20	23	77	0.2987013
NODE_251_length_4556_cov_14.556652	4229	4288	92	1	59	0.0169492
NODE_251_length_4556_cov_14.556652	4229	4288	93	1	59	0.0169492
NODE_251_length_4556_cov_14.556652	4229	4288	94	6	59	0.1016949
NODE_251_length_4556_cov_14.556652	4229	4288	95	2	59	0.0338983
NODE_251_length_4556_cov_14.556652	4229	4288	96	1	59	0.0169492
NODE_251_length_4556_cov_14.556652	4229	4288	97	5	59	0.0847458
NODE_251_length_4556_cov_14.556652	4229	4288	98	4	59	0.0677966
NODE_251_length_4556_cov_14.556652	4229	4288	99	12	59	0.2033898
NODE_251_length_4556_cov_14.556652	4229	4288	101	2	59	0.0338983
NODE_251_length_4556_cov_14.556652	4229	4288	102	4	59	0.0677966
NODE_251_length_4556_cov_14.556652	4229	4288	106	5	59	0.0847458
NODE_251_length_4556_cov_14.556652	4229	4288	107	1	59	0.0169492
NODE_251_length_4556_cov_14.556652	4229	4288	108	9	59	0.1525424
NODE_251_length_4556_cov_14.556652	4229	4288	109	3	59	0.0508475
NODE_251_length_4556_cov_14.556652	4229	4288	110	1	59	0.0169492
NODE_251_length_4556_cov_14.556652	4229	4288	112	2	59	0.0338983
NODE_252_length_4550_cov_5.664120	3548	3628	0	80	80	1.0000000
NODE_252_length_4550_cov_5.664120	3601	3681	0	80	80	1.0000000
NODE_253_length_4544_cov_10.690439	353	433	0	80	80	1.0000000
NODE_253_length_4544_cov_10.690439	406	486	0	80	80	1.0000000
NODE_253_length_4544_cov_10.690439	4487	4544	0	55	57	0.9649123
NODE_253_length_4544_cov_10.690439	4487	4544	18	2	57	0.0350877
NODE_255_length_4535_cov_24.849188	675	755	0	22	80	0.2750000
NODE_255_length_4535_cov_24.849188	675	755	1	37	80	0.4625000
NODE_255_length_4535_cov_24.849188	675	755	2	21	80	0.2625000
NODE_255_length_4535_cov_24.849188	728	809	1	6	81	0.0740741
NODE_255_length_4535_cov_24.849188	728	809	2	75	81	0.9259259
NODE_255_length_4535_cov_24.849188	1319	1399	0	14	80	0.1750000
NODE_255_length_4535_cov_24.849188	1319	1399	4	66	80	0.8250000
NODE_255_length_4535_cov_24.849188	1372	1452	4	30	80	0.3750000
NODE_255_length_4535_cov_24.849188	1372	1452	5	2	80	0.0250000
NODE_255_length_4535_cov_24.849188	1372	1452	6	1	80	0.0125000
NODE_255_length_4535_cov_24.849188	1372	1452	13	12	80	0.1500000
NODE_255_length_4535_cov_24.849188	1372	1452	17	2	80	0.0250000
NODE_255_length_4535_cov_24.849188	1372	1452	19	1	80	0.0125000
NODE_255_length_4535_cov_24.849188	1372	1452	23	1	80	0.0125000
NODE_255_length_4535_cov_24.849188	1372	1452	24	2	80	0.0250000
NODE_255_length_4535_cov_24.849188	1372	1452	27	2	80	0.0250000
NODE_255_length_4535_cov_24.849188	1372	1452	32	1	80	0.0125000
NODE_255_length_4535_cov_24.849188	1372	1452	45	2	80	0.0250000
NODE_255_length_4535_cov_24.849188	1372	1452	48	1	80	0.0125000
NODE_255_length_4535_cov_24.849188	1372	1452	49	2	80	0.0250000
NODE_255_length_4535_cov_24.849188	1372	1452	53	1	80	0.0125000
NODE_255_length_4535_cov_24.849188	1372	1452	56	3	80	0.0375000
NODE_255_length_4535_cov_24.849188	1372	1452	66	1	80	0.0125000
NODE_255_length_4535_cov_24.849188	1372	1452	78	3	80	0.0375000
NODE_255_length_4535_cov_24.849188	1372	1452	83	2	80	0.0250000
NODE_255_length_4535_cov_24.849188	1372	1452	88	1	80	0.0125000
NODE_255_length_4535_cov_24.849188	1372	1452	94	2	80	0.0250000
NODE_255_length_4535_cov_24.849188	1372	1452	97	1	80	0.0125000
NODE_255_length_4535_cov_24.849188	1372	1452	100	2	80	0.0250000
NODE_255_length_4535_cov_24.849188	1372	1452	102	2	80	0.0250000
NODE_255_length_4535_cov_24.849188	1372	1452	104	1	80	0.0125000
NODE_255_length_4535_cov_24.849188	1372	1452	115	1	80	0.0125000
NODE_255_length_4535_cov_24.849188	1372	1452	121	1	80	0.0125000
NODE_258_length_4528_cov_19.736509	4295	4366	0	68	71	0.9577465
NODE_258_length_4528_cov_19.736509	4295	4366	2	1	71	0.0140845
NODE_258_length_4528_cov_19.736509	4295	4366	11	1	71	0.0140845
NODE_258_length_4528_cov_19.736509	4295	4366	42	1	71	0.0140845
NODE_259_length_4505_cov_10.409215	3166	3202	36	11	36	0.3055556
NODE_259_length_4505_cov_10.409215	3166	3202	37	5	36	0.1388889
NODE_259_length_4505_cov_10.409215	3166	3202	38	17	36	0.4722222
NODE_259_length_4505_cov_10.409215	3166	3202	40	3	36	0.0833333
NODE_259_length_4505_cov_10.409215	3175	3255	30	8	80	0.1000000
NODE_259_length_4505_cov_10.409215	3175	3255	32	10	80	0.1250000
NODE_259_length_4505_cov_10.409215	3175	3255	34	6	80	0.0750000
NODE_259_length_4505_cov_10.409215	3175	3255	36	14	80	0.1750000
NODE_259_length_4505_cov_10.409215	3175	3255	37	5	80	0.0625000
NODE_259_length_4505_cov_10.409215	3175	3255	38	10	80	0.1250000
NODE_259_length_4505_cov_10.409215	3175	3255	39	11	80	0.1375000
NODE_259_length_4505_cov_10.409215	3175	3255	40	3	80	0.0375000
NODE_259_length_4505_cov_10.409215	3175	3255	41	2	80	0.0250000
NODE_259_length_4505_cov_10.409215	3175	3255	42	11	80	0.1375000
NODE_260_length_4498_cov_8.216185	3161	3219	0	58	58	1.0000000
NODE_260_length_4498_cov_8.216185	4257	4314	4	16	57	0.2807018
NODE_260_length_4498_cov_8.216185	4257	4314	6	41	57	0.7192982
NODE_263_length_4476_cov_29.825451	141	215	0	2	74	0.0270270
NODE_263_length_4476_cov_29.825451	141	215	2	65	74	0.8783784
NODE_263_length_4476_cov_29.825451	141	215	4	7	74	0.0945946
NODE_263_length_4476_cov_29.825451	1890	1970	50	3	80	0.0375000
NODE_263_length_4476_cov_29.825451	1890	1970	52	4	80	0.0500000
NODE_263_length_4476_cov_29.825451	1890	1970	58	4	80	0.0500000
NODE_263_length_4476_cov_29.825451	1890	1970	66	7	80	0.0875000
NODE_263_length_4476_cov_29.825451	1890	1970	68	20	80	0.2500000
NODE_263_length_4476_cov_29.825451	1890	1970	69	1	80	0.0125000
NODE_263_length_4476_cov_29.825451	1890	1970	70	7	80	0.0875000
NODE_263_length_4476_cov_29.825451	1890	1970	71	2	80	0.0250000
NODE_263_length_4476_cov_29.825451	1890	1970	72	15	80	0.1875000
NODE_263_length_4476_cov_29.825451	1890	1970	73	2	80	0.0250000
NODE_263_length_4476_cov_29.825451	1890	1970	74	12	80	0.1500000
NODE_263_length_4476_cov_29.825451	1890	1970	75	1	80	0.0125000
NODE_263_length_4476_cov_29.825451	1890	1970	76	2	80	0.0250000
NODE_263_length_4476_cov_29.825451	1943	2023	36	1	80	0.0125000
NODE_263_length_4476_cov_29.825451	1943	2023	38	2	80	0.0250000
NODE_263_length_4476_cov_29.825451	1943	2023	40	1	80	0.0125000
NODE_263_length_4476_cov_29.825451	1943	2023	41	2	80	0.0250000
NODE_263_length_4476_cov_29.825451	1943	2023	47	1	80	0.0125000
NODE_263_length_4476_cov_29.825451	1943	2023	51	6	80	0.0750000
NODE_263_length_4476_cov_29.825451	1943	2023	52	1	80	0.0125000
NODE_263_length_4476_cov_29.825451	1943	2023	55	1	80	0.0125000
NODE_263_length_4476_cov_29.825451	1943	2023	56	3	80	0.0375000
NODE_263_length_4476_cov_29.825451	1943	2023	57	4	80	0.0500000
NODE_263_length_4476_cov_29.825451	1943	2023	58	5	80	0.0625000
NODE_263_length_4476_cov_29.825451	1943	2023	60	8	80	0.1000000
NODE_263_length_4476_cov_29.825451	1943	2023	62	4	80	0.0500000
NODE_263_length_4476_cov_29.825451	1943	2023	64	8	80	0.1000000
NODE_263_length_4476_cov_29.825451	1943	2023	66	3	80	0.0375000
NODE_263_length_4476_cov_29.825451	1943	2023	68	1	80	0.0125000
NODE_263_length_4476_cov_29.825451	1943	2023	69	1	80	0.0125000
NODE_263_length_4476_cov_29.825451	1943	2023	71	2	80	0.0250000
NODE_263_length_4476_cov_29.825451	1943	2023	72	18	80	0.2250000
NODE_263_length_4476_cov_29.825451	1943	2023	73	2	80	0.0250000
NODE_263_length_4476_cov_29.825451	1943	2023	74	5	80	0.0625000
NODE_263_length_4476_cov_29.825451	1943	2023	75	1	80	0.0125000
NODE_264_length_4474_cov_17.051886	23	99	11	1	76	0.0131579
NODE_264_length_4474_cov_17.051886	23	99	13	6	76	0.0789474
NODE_264_length_4474_cov_17.051886	23	99	14	69	76	0.9078947
NODE_264_length_4474_cov_17.051886	23	98	11	1	75	0.0133333
NODE_264_length_4474_cov_17.051886	23	98	13	6	75	0.0800000
NODE_264_length_4474_cov_17.051886	23	98	14	68	75	0.9066667
NODE_264_length_4474_cov_17.051886	23	99	11	1	76	0.0131579
NODE_264_length_4474_cov_17.051886	23	99	13	6	76	0.0789474
NODE_264_length_4474_cov_17.051886	23	99	14	69	76	0.9078947
NODE_264_length_4474_cov_17.051886	32	99	14	67	67	1.0000000
NODE_264_length_4474_cov_17.051886	76	140	12	18	64	0.2812500
NODE_264_length_4474_cov_17.051886	76	140	14	46	64	0.7187500
NODE_264_length_4474_cov_17.051886	1528	1569	113	1	41	0.0243902
NODE_264_length_4474_cov_17.051886	1528	1569	125	2	41	0.0487805
NODE_264_length_4474_cov_17.051886	1528	1569	127	2	41	0.0487805
NODE_264_length_4474_cov_17.051886	1528	1569	131	3	41	0.0731707
NODE_264_length_4474_cov_17.051886	1528	1569	134	1	41	0.0243902
NODE_264_length_4474_cov_17.051886	1528	1569	135	2	41	0.0487805
NODE_264_length_4474_cov_17.051886	1528	1569	138	1	41	0.0243902
NODE_264_length_4474_cov_17.051886	1528	1569	140	1	41	0.0243902
NODE_264_length_4474_cov_17.051886	1528	1569	145	1	41	0.0243902
NODE_264_length_4474_cov_17.051886	1528	1569	147	1	41	0.0243902
NODE_264_length_4474_cov_17.051886	1528	1569	152	2	41	0.0487805
NODE_264_length_4474_cov_17.051886	1528	1569	156	1	41	0.0243902
NODE_264_length_4474_cov_17.051886	1528	1569	159	1	41	0.0243902
NODE_264_length_4474_cov_17.051886	1528	1569	162	1	41	0.0243902
NODE_264_length_4474_cov_17.051886	1528	1569	164	1	41	0.0243902
NODE_264_length_4474_cov_17.051886	1528	1569	165	1	41	0.0243902
NODE_264_length_4474_cov_17.051886	1528	1569	167	1	41	0.0243902
NODE_264_length_4474_cov_17.051886	1528	1569	174	1	41	0.0243902
NODE_264_length_4474_cov_17.051886	1528	1569	177	1	41	0.0243902
NODE_264_length_4474_cov_17.051886	1528	1569	181	1	41	0.0243902
NODE_264_length_4474_cov_17.051886	1528	1569	186	1	41	0.0243902
NODE_264_length_4474_cov_17.051886	1528	1569	188	1	41	0.0243902
NODE_264_length_4474_cov_17.051886	1528	1569	192	2	41	0.0487805
NODE_264_length_4474_cov_17.051886	1528	1569	199	1	41	0.0243902
NODE_264_length_4474_cov_17.051886	1528	1569	204	1	41	0.0243902
NODE_264_length_4474_cov_17.051886	1528	1569	206	1	41	0.0243902
NODE_264_length_4474_cov_17.051886	1528	1569	211	1	41	0.0243902
NODE_264_length_4474_cov_17.051886	1528	1569	220	2	41	0.0487805
NODE_264_length_4474_cov_17.051886	1528	1569	226	1	41	0.0243902
NODE_264_length_4474_cov_17.051886	1528	1569	228	2	41	0.0487805
NODE_264_length_4474_cov_17.051886	1528	1569	230	1	41	0.0243902
NODE_264_length_4474_cov_17.051886	1528	1569	233	1	41	0.0243902
NODE_264_length_4474_cov_17.051886	1536	1609	46	1	73	0.0136986
NODE_264_length_4474_cov_17.051886	1536	1609	48	7	73	0.0958904
NODE_264_length_4474_cov_17.051886	1536	1609	54	1	73	0.0136986
NODE_264_length_4474_cov_17.051886	1536	1609	58	1	73	0.0136986
NODE_264_length_4474_cov_17.051886	1536	1609	60	1	73	0.0136986
NODE_264_length_4474_cov_17.051886	1536	1609	62	3	73	0.0410959
NODE_264_length_4474_cov_17.051886	1536	1609	64	3	73	0.0410959
NODE_264_length_4474_cov_17.051886	1536	1609	66	1	73	0.0136986
NODE_264_length_4474_cov_17.051886	1536	1609	68	3	73	0.0410959
NODE_264_length_4474_cov_17.051886	1536	1609	73	1	73	0.0136986
NODE_264_length_4474_cov_17.051886	1536	1609	75	1	73	0.0136986
NODE_264_length_4474_cov_17.051886	1536	1609	81	3	73	0.0410959
NODE_264_length_4474_cov_17.051886	1536	1609	83	1	73	0.0136986
NODE_264_length_4474_cov_17.051886	1536	1609	90	4	73	0.0547945
NODE_264_length_4474_cov_17.051886	1536	1609	92	1	73	0.0136986
NODE_264_length_4474_cov_17.051886	1536	1609	93	1	73	0.0136986
NODE_264_length_4474_cov_17.051886	1536	1609	94	1	73	0.0136986
NODE_264_length_4474_cov_17.051886	1536	1609	98	1	73	0.0136986
NODE_264_length_4474_cov_17.051886	1536	1609	102	1	73	0.0136986
NODE_264_length_4474_cov_17.051886	1536	1609	106	2	73	0.0273973
NODE_264_length_4474_cov_17.051886	1536	1609	108	1	73	0.0136986
NODE_264_length_4474_cov_17.051886	1536	1609	110	1	73	0.0136986
NODE_264_length_4474_cov_17.051886	1536	1609	113	1	73	0.0136986
NODE_264_length_4474_cov_17.051886	1536	1609	125	2	73	0.0273973
NODE_264_length_4474_cov_17.051886	1536	1609	127	2	73	0.0273973
NODE_264_length_4474_cov_17.051886	1536	1609	131	3	73	0.0410959
NODE_264_length_4474_cov_17.051886	1536	1609	134	1	73	0.0136986
NODE_264_length_4474_cov_17.051886	1536	1609	135	2	73	0.0273973
NODE_264_length_4474_cov_17.051886	1536	1609	138	1	73	0.0136986
NODE_264_length_4474_cov_17.051886	1536	1609	140	1	73	0.0136986
NODE_264_length_4474_cov_17.051886	1536	1609	145	1	73	0.0136986
NODE_264_length_4474_cov_17.051886	1536	1609	147	1	73	0.0136986
NODE_264_length_4474_cov_17.051886	1536	1609	152	2	73	0.0273973
NODE_264_length_4474_cov_17.051886	1536	1609	156	1	73	0.0136986
NODE_264_length_4474_cov_17.051886	1536	1609	159	1	73	0.0136986
NODE_264_length_4474_cov_17.051886	1536	1609	162	1	73	0.0136986
NODE_264_length_4474_cov_17.051886	1536	1609	164	1	73	0.0136986
NODE_264_length_4474_cov_17.051886	1536	1609	165	1	73	0.0136986
NODE_264_length_4474_cov_17.051886	1536	1609	167	1	73	0.0136986
NODE_264_length_4474_cov_17.051886	1536	1609	174	1	73	0.0136986
NODE_264_length_4474_cov_17.051886	1536	1609	177	1	73	0.0136986
NODE_264_length_4474_cov_17.051886	1536	1609	181	1	73	0.0136986
NODE_264_length_4474_cov_17.051886	1536	1609	186	1	73	0.0136986
NODE_264_length_4474_cov_17.051886	1536	1609	188	1	73	0.0136986
NODE_264_length_4474_cov_17.051886	1536	1609	192	2	73	0.0273973
NODE_264_length_4474_cov_17.051886	1536	1609	199	1	73	0.0136986
NODE_264_length_4474_cov_17.051886	1536	1609	204	1	73	0.0136986
NODE_264_length_4474_cov_17.051886	1536	1609	206	1	73	0.0136986
NODE_264_length_4474_cov_17.051886	1618	1643	0	18	25	0.7200000
NODE_264_length_4474_cov_17.051886	1618	1643	4	1	25	0.0400000
NODE_264_length_4474_cov_17.051886	1618	1643	9	1	25	0.0400000
NODE_264_length_4474_cov_17.051886	1618	1643	13	1	25	0.0400000
NODE_264_length_4474_cov_17.051886	1618	1643	27	1	25	0.0400000
NODE_264_length_4474_cov_17.051886	1618	1643	28	1	25	0.0400000
NODE_264_length_4474_cov_17.051886	1618	1643	30	2	25	0.0800000
NODE_264_length_4474_cov_17.051886	1618	1696	0	71	78	0.9102564
NODE_264_length_4474_cov_17.051886	1618	1696	4	1	78	0.0128205
NODE_264_length_4474_cov_17.051886	1618	1696	9	1	78	0.0128205
NODE_264_length_4474_cov_17.051886	1618	1696	13	1	78	0.0128205
NODE_264_length_4474_cov_17.051886	1618	1696	27	1	78	0.0128205
NODE_264_length_4474_cov_17.051886	1618	1696	28	1	78	0.0128205
NODE_264_length_4474_cov_17.051886	1618	1696	30	2	78	0.0256410
NODE_265_length_4474_cov_14.441829	282	362	6	80	80	1.0000000
NODE_265_length_4474_cov_14.441829	335	415	0	29	80	0.3625000
NODE_265_length_4474_cov_14.441829	335	415	2	8	80	0.1000000
NODE_265_length_4474_cov_14.441829	335	415	6	40	80	0.5000000
NODE_265_length_4474_cov_14.441829	335	415	12	1	80	0.0125000
NODE_265_length_4474_cov_14.441829	335	415	52	1	80	0.0125000
NODE_265_length_4474_cov_14.441829	335	415	70	1	80	0.0125000
NODE_265_length_4474_cov_14.441829	1522	1575	0	2	53	0.0377358
NODE_265_length_4474_cov_14.441829	1522	1575	2	3	53	0.0566038
NODE_265_length_4474_cov_14.441829	1522	1575	4	44	53	0.8301887
NODE_265_length_4474_cov_14.441829	1522	1575	26	2	53	0.0377358
NODE_265_length_4474_cov_14.441829	1522	1575	28	2	53	0.0377358
NODE_265_length_4474_cov_14.441829	1548	1623	0	10	75	0.1333333
NODE_265_length_4474_cov_14.441829	1548	1623	1	2	75	0.0266667
NODE_265_length_4474_cov_14.441829	1548	1623	2	3	75	0.0400000
NODE_265_length_4474_cov_14.441829	1548	1623	4	22	75	0.2933333
NODE_265_length_4474_cov_14.441829	1548	1623	5	6	75	0.0800000
NODE_265_length_4474_cov_14.441829	1548	1623	9	9	75	0.1200000
NODE_265_length_4474_cov_14.441829	1548	1623	11	3	75	0.0400000
NODE_265_length_4474_cov_14.441829	1548	1623	13	4	75	0.0533333
NODE_265_length_4474_cov_14.441829	1548	1623	14	6	75	0.0800000
NODE_265_length_4474_cov_14.441829	1548	1623	16	10	75	0.1333333
NODE_265_length_4474_cov_14.441829	3068	3121	5	30	53	0.5660377
NODE_265_length_4474_cov_14.441829	3068	3121	7	13	53	0.2452830
NODE_265_length_4474_cov_14.441829	3068	3121	9	4	53	0.0754717
NODE_265_length_4474_cov_14.441829	3068	3121	11	4	53	0.0754717
NODE_265_length_4474_cov_14.441829	3068	3121	31	1	53	0.0188679
NODE_265_length_4474_cov_14.441829	3068	3121	33	1	53	0.0188679
NODE_268_length_4463_cov_7.023144	119	168	0	40	49	0.8163266
NODE_268_length_4463_cov_7.023144	119	168	2	1	49	0.0204082
NODE_268_length_4463_cov_7.023144	119	168	4	3	49	0.0612245
NODE_268_length_4463_cov_7.023144	119	168	13	4	49	0.0816327
NODE_268_length_4463_cov_7.023144	119	168	14	1	49	0.0204082
NODE_270_length_4453_cov_16.820395	3383	3463	127	1	80	0.0125000
NODE_270_length_4453_cov_16.820395	3383	3463	138	1	80	0.0125000
NODE_270_length_4453_cov_16.820395	3383	3463	142	1	80	0.0125000
NODE_270_length_4453_cov_16.820395	3383	3463	145	1	80	0.0125000
NODE_270_length_4453_cov_16.820395	3383	3463	147	1	80	0.0125000
NODE_270_length_4453_cov_16.820395	3383	3463	150	1	80	0.0125000
NODE_270_length_4453_cov_16.820395	3383	3463	157	1	80	0.0125000
NODE_270_length_4453_cov_16.820395	3383	3463	159	1	80	0.0125000
NODE_270_length_4453_cov_16.820395	3383	3463	161	1	80	0.0125000
NODE_270_length_4453_cov_16.820395	3383	3463	165	1	80	0.0125000
NODE_270_length_4453_cov_16.820395	3383	3463	172	1	80	0.0125000
NODE_270_length_4453_cov_16.820395	3383	3463	177	1	80	0.0125000
NODE_270_length_4453_cov_16.820395	3383	3463	180	1	80	0.0125000
NODE_270_length_4453_cov_16.820395	3383	3463	182	1	80	0.0125000
NODE_270_length_4453_cov_16.820395	3383	3463	188	2	80	0.0250000
NODE_270_length_4453_cov_16.820395	3383	3463	190	2	80	0.0250000
NODE_270_length_4453_cov_16.820395	3383	3463	191	1	80	0.0125000
NODE_270_length_4453_cov_16.820395	3383	3463	197	1	80	0.0125000
NODE_270_length_4453_cov_16.820395	3383	3463	198	2	80	0.0250000
NODE_270_length_4453_cov_16.820395	3383	3463	200	1	80	0.0125000
NODE_270_length_4453_cov_16.820395	3383	3463	202	12	80	0.1500000
NODE_270_length_4453_cov_16.820395	3383	3463	204	4	80	0.0500000
NODE_270_length_4453_cov_16.820395	3383	3463	206	1	80	0.0125000
NODE_270_length_4453_cov_16.820395	3383	3463	208	1	80	0.0125000
NODE_270_length_4453_cov_16.820395	3383	3463	210	2	80	0.0250000
NODE_270_length_4453_cov_16.820395	3383	3463	211	3	80	0.0375000
NODE_270_length_4453_cov_16.820395	3383	3463	213	1	80	0.0125000
NODE_270_length_4453_cov_16.820395	3383	3463	216	2	80	0.0250000
NODE_270_length_4453_cov_16.820395	3383	3463	218	1	80	0.0125000
NODE_270_length_4453_cov_16.820395	3383	3463	221	2	80	0.0250000
NODE_270_length_4453_cov_16.820395	3383	3463	222	2	80	0.0250000
NODE_270_length_4453_cov_16.820395	3383	3463	224	5	80	0.0625000
NODE_270_length_4453_cov_16.820395	3383	3463	226	1	80	0.0125000
NODE_270_length_4453_cov_16.820395	3383	3463	228	1	80	0.0125000
NODE_270_length_4453_cov_16.820395	3383	3463	229	2	80	0.0250000
NODE_270_length_4453_cov_16.820395	3383	3463	230	1	80	0.0125000
NODE_270_length_4453_cov_16.820395	3383	3463	231	6	80	0.0750000
NODE_270_length_4453_cov_16.820395	3383	3463	232	2	80	0.0250000
NODE_270_length_4453_cov_16.820395	3383	3463	233	1	80	0.0125000
NODE_270_length_4453_cov_16.820395	3383	3463	234	1	80	0.0125000
NODE_270_length_4453_cov_16.820395	3383	3463	235	3	80	0.0375000
NODE_270_length_4453_cov_16.820395	3383	3463	236	3	80	0.0375000
NODE_270_length_4453_cov_16.820395	3436	3496	56	1	60	0.0166667
NODE_270_length_4453_cov_16.820395	3436	3496	60	1	60	0.0166667
NODE_270_length_4453_cov_16.820395	3436	3496	63	2	60	0.0333333
NODE_270_length_4453_cov_16.820395	3436	3496	67	1	60	0.0166667
NODE_270_length_4453_cov_16.820395	3436	3496	73	3	60	0.0500000
NODE_270_length_4453_cov_16.820395	3436	3496	75	1	60	0.0166667
NODE_270_length_4453_cov_16.820395	3436	3496	77	2	60	0.0333333
NODE_270_length_4453_cov_16.820395	3436	3496	80	1	60	0.0166667
NODE_270_length_4453_cov_16.820395	3436	3496	88	1	60	0.0166667
NODE_270_length_4453_cov_16.820395	3436	3496	89	2	60	0.0333333
NODE_270_length_4453_cov_16.820395	3436	3496	90	2	60	0.0333333
NODE_270_length_4453_cov_16.820395	3436	3496	94	1	60	0.0166667
NODE_270_length_4453_cov_16.820395	3436	3496	96	2	60	0.0333333
NODE_270_length_4453_cov_16.820395	3436	3496	100	1	60	0.0166667
NODE_270_length_4453_cov_16.820395	3436	3496	102	1	60	0.0166667
NODE_270_length_4453_cov_16.820395	3436	3496	105	2	60	0.0333333
NODE_270_length_4453_cov_16.820395	3436	3496	107	1	60	0.0166667
NODE_270_length_4453_cov_16.820395	3436	3496	109	2	60	0.0333333
NODE_270_length_4453_cov_16.820395	3436	3496	111	1	60	0.0166667
NODE_270_length_4453_cov_16.820395	3436	3496	114	1	60	0.0166667
NODE_270_length_4453_cov_16.820395	3436	3496	116	2	60	0.0333333
NODE_270_length_4453_cov_16.820395	3436	3496	120	2	60	0.0333333
NODE_270_length_4453_cov_16.820395	3436	3496	127	1	60	0.0166667
NODE_270_length_4453_cov_16.820395	3436	3496	138	1	60	0.0166667
NODE_270_length_4453_cov_16.820395	3436	3496	142	1	60	0.0166667
NODE_270_length_4453_cov_16.820395	3436	3496	145	1	60	0.0166667
NODE_270_length_4453_cov_16.820395	3436	3496	147	1	60	0.0166667
NODE_270_length_4453_cov_16.820395	3436	3496	150	1	60	0.0166667
NODE_270_length_4453_cov_16.820395	3436	3496	157	1	60	0.0166667
NODE_270_length_4453_cov_16.820395	3436	3496	159	1	60	0.0166667
NODE_270_length_4453_cov_16.820395	3436	3496	161	1	60	0.0166667
NODE_270_length_4453_cov_16.820395	3436	3496	165	1	60	0.0166667
NODE_270_length_4453_cov_16.820395	3436	3496	172	1	60	0.0166667
NODE_270_length_4453_cov_16.820395	3436	3496	177	1	60	0.0166667
NODE_270_length_4453_cov_16.820395	3436	3496	180	1	60	0.0166667
NODE_270_length_4453_cov_16.820395	3436	3496	182	1	60	0.0166667
NODE_270_length_4453_cov_16.820395	3436	3496	188	2	60	0.0333333
NODE_270_length_4453_cov_16.820395	3436	3496	190	2	60	0.0333333
NODE_270_length_4453_cov_16.820395	3436	3496	191	1	60	0.0166667
NODE_270_length_4453_cov_16.820395	3436	3496	197	1	60	0.0166667
NODE_270_length_4453_cov_16.820395	3436	3496	198	2	60	0.0333333
NODE_270_length_4453_cov_16.820395	3436	3496	200	1	60	0.0166667
NODE_270_length_4453_cov_16.820395	3436	3496	202	4	60	0.0666667
NODE_272_length_4436_cov_31.114595	2807	2871	20	3	64	0.0468750
NODE_272_length_4436_cov_31.114595	2807	2871	22	8	64	0.1250000
NODE_272_length_4436_cov_31.114595	2807	2871	24	2	64	0.0312500
NODE_272_length_4436_cov_31.114595	2807	2871	26	8	64	0.1250000
NODE_272_length_4436_cov_31.114595	2807	2871	28	3	64	0.0468750
NODE_272_length_4436_cov_31.114595	2807	2871	30	40	64	0.6250000
NODE_272_length_4436_cov_31.114595	2846	2906	1	3	60	0.0500000
NODE_272_length_4436_cov_31.114595	2846	2906	5	2	60	0.0333333
NODE_272_length_4436_cov_31.114595	2846	2906	8	4	60	0.0666667
NODE_272_length_4436_cov_31.114595	2846	2906	9	6	60	0.1000000
NODE_272_length_4436_cov_31.114595	2846	2906	11	2	60	0.0333333
NODE_272_length_4436_cov_31.114595	2846	2906	13	6	60	0.1000000
NODE_272_length_4436_cov_31.114595	2846	2906	14	2	60	0.0333333
NODE_272_length_4436_cov_31.114595	2846	2906	15	4	60	0.0666667
NODE_272_length_4436_cov_31.114595	2846	2906	16	4	60	0.0666667
NODE_272_length_4436_cov_31.114595	2846	2906	20	5	60	0.0833333
NODE_272_length_4436_cov_31.114595	2846	2906	22	8	60	0.1333333
NODE_272_length_4436_cov_31.114595	2846	2906	24	2	60	0.0333333
NODE_272_length_4436_cov_31.114595	2846	2906	26	8	60	0.1333333
NODE_272_length_4436_cov_31.114595	2846	2906	28	3	60	0.0500000
NODE_272_length_4436_cov_31.114595	2846	2906	30	1	60	0.0166667
NODE_272_length_4436_cov_31.114595	2846	2898	8	1	52	0.0192308
NODE_272_length_4436_cov_31.114595	2846	2898	9	6	52	0.1153846
NODE_272_length_4436_cov_31.114595	2846	2898	11	2	52	0.0384615
NODE_272_length_4436_cov_31.114595	2846	2898	13	6	52	0.1153846
NODE_272_length_4436_cov_31.114595	2846	2898	14	2	52	0.0384615
NODE_272_length_4436_cov_31.114595	2846	2898	15	4	52	0.0769231
NODE_272_length_4436_cov_31.114595	2846	2898	16	4	52	0.0769231
NODE_272_length_4436_cov_31.114595	2846	2898	20	5	52	0.0961538
NODE_272_length_4436_cov_31.114595	2846	2898	22	8	52	0.1538462
NODE_272_length_4436_cov_31.114595	2846	2898	24	2	52	0.0384615
NODE_272_length_4436_cov_31.114595	2846	2898	26	8	52	0.1538462
NODE_272_length_4436_cov_31.114595	2846	2898	28	3	52	0.0576923
NODE_272_length_4436_cov_31.114595	2846	2898	30	1	52	0.0192308
NODE_278_length_4391_cov_7.711323	66	141	0	75	75	1.0000000
NODE_278_length_4391_cov_7.711323	119	155	0	36	36	1.0000000
NODE_279_length_4385_cov_6.067662	1556	1606	0	1	50	0.0200000
NODE_279_length_4385_cov_6.067662	1556	1606	4	2	50	0.0400000
NODE_279_length_4385_cov_6.067662	1556	1606	6	1	50	0.0200000
NODE_279_length_4385_cov_6.067662	1556	1606	12	2	50	0.0400000
NODE_279_length_4385_cov_6.067662	1556	1606	16	5	50	0.1000000
NODE_279_length_4385_cov_6.067662	1556	1606	20	9	50	0.1800000
NODE_279_length_4385_cov_6.067662	1556	1606	22	8	50	0.1600000
NODE_279_length_4385_cov_6.067662	1556	1606	26	4	50	0.0800000
NODE_279_length_4385_cov_6.067662	1556	1606	28	1	50	0.0200000
NODE_279_length_4385_cov_6.067662	1556	1606	30	3	50	0.0600000
NODE_279_length_4385_cov_6.067662	1556	1606	32	9	50	0.1800000
NODE_279_length_4385_cov_6.067662	1556	1606	34	1	50	0.0200000
NODE_279_length_4385_cov_6.067662	1556	1606	36	4	50	0.0800000
NODE_286_length_4331_cov_37.938800	1898	1978	8	1	80	0.0125000
NODE_286_length_4331_cov_37.938800	1898	1978	12	18	80	0.2250000
NODE_286_length_4331_cov_37.938800	1898	1978	15	15	80	0.1875000
NODE_286_length_4331_cov_37.938800	1898	1978	16	1	80	0.0125000
NODE_286_length_4331_cov_37.938800	1898	1978	17	3	80	0.0375000
NODE_286_length_4331_cov_37.938800	1898	1978	20	2	80	0.0250000
NODE_286_length_4331_cov_37.938800	1898	1978	24	1	80	0.0125000
NODE_286_length_4331_cov_37.938800	1898	1978	26	9	80	0.1125000
NODE_286_length_4331_cov_37.938800	1898	1978	27	1	80	0.0125000
NODE_286_length_4331_cov_37.938800	1898	1978	28	2	80	0.0250000
NODE_286_length_4331_cov_37.938800	1898	1978	32	5	80	0.0625000
NODE_286_length_4331_cov_37.938800	1898	1978	36	5	80	0.0625000
NODE_286_length_4331_cov_37.938800	1898	1978	40	5	80	0.0625000
NODE_286_length_4331_cov_37.938800	1898	1978	42	7	80	0.0875000
NODE_286_length_4331_cov_37.938800	1898	1978	44	3	80	0.0375000
NODE_286_length_4331_cov_37.938800	1898	1978	46	2	80	0.0250000
NODE_286_length_4331_cov_37.938800	1951	2031	32	5	80	0.0625000
NODE_286_length_4331_cov_37.938800	1951	2031	36	5	80	0.0625000
NODE_286_length_4331_cov_37.938800	1951	2031	40	5	80	0.0625000
NODE_286_length_4331_cov_37.938800	1951	2031	42	7	80	0.0875000
NODE_286_length_4331_cov_37.938800	1951	2031	44	3	80	0.0375000
NODE_286_length_4331_cov_37.938800	1951	2031	46	9	80	0.1125000
NODE_286_length_4331_cov_37.938800	1951	2031	56	17	80	0.2125000
NODE_286_length_4331_cov_37.938800	1951	2031	58	1	80	0.0125000
NODE_286_length_4331_cov_37.938800	1951	2031	59	1	80	0.0125000
NODE_286_length_4331_cov_37.938800	1951	2031	60	7	80	0.0875000
NODE_286_length_4331_cov_37.938800	1951	2031	62	4	80	0.0500000
NODE_286_length_4331_cov_37.938800	1951	2031	64	6	80	0.0750000
NODE_286_length_4331_cov_37.938800	1951	2031	66	4	80	0.0500000
NODE_286_length_4331_cov_37.938800	1951	2031	74	1	80	0.0125000
NODE_286_length_4331_cov_37.938800	1951	2031	77	2	80	0.0250000
NODE_286_length_4331_cov_37.938800	1951	2031	79	3	80	0.0375000
NODE_286_length_4331_cov_37.938800	2027	2107	77	3	80	0.0375000
NODE_286_length_4331_cov_37.938800	2027	2107	79	2	80	0.0250000
NODE_286_length_4331_cov_37.938800	2027	2107	83	11	80	0.1375000
NODE_286_length_4331_cov_37.938800	2027	2107	86	2	80	0.0250000
NODE_286_length_4331_cov_37.938800	2027	2107	90	3	80	0.0375000
NODE_286_length_4331_cov_37.938800	2027	2107	92	1	80	0.0125000
NODE_286_length_4331_cov_37.938800	2027	2107	99	1	80	0.0125000
NODE_286_length_4331_cov_37.938800	2027	2107	106	4	80	0.0500000
NODE_286_length_4331_cov_37.938800	2027	2107	107	11	80	0.1375000
NODE_286_length_4331_cov_37.938800	2027	2107	112	7	80	0.0875000
NODE_286_length_4331_cov_37.938800	2027	2107	115	1	80	0.0125000
NODE_286_length_4331_cov_37.938800	2027	2107	116	6	80	0.0750000
NODE_286_length_4331_cov_37.938800	2027	2107	117	7	80	0.0875000
NODE_286_length_4331_cov_37.938800	2027	2107	118	4	80	0.0500000
NODE_286_length_4331_cov_37.938800	2027	2107	120	6	80	0.0750000
NODE_286_length_4331_cov_37.938800	2027	2107	122	11	80	0.1375000
NODE_286_length_4331_cov_37.938800	2080	2160	62	1	80	0.0125000
NODE_286_length_4331_cov_37.938800	2080	2160	66	2	80	0.0250000
NODE_286_length_4331_cov_37.938800	2080	2160	67	1	80	0.0125000
NODE_286_length_4331_cov_37.938800	2080	2160	70	3	80	0.0375000
NODE_286_length_4331_cov_37.938800	2080	2160	71	3	80	0.0375000
NODE_286_length_4331_cov_37.938800	2080	2160	72	2	80	0.0250000
NODE_286_length_4331_cov_37.938800	2080	2160	76	1	80	0.0125000
NODE_286_length_4331_cov_37.938800	2080	2160	78	3	80	0.0375000
NODE_286_length_4331_cov_37.938800	2080	2160	80	4	80	0.0500000
NODE_286_length_4331_cov_37.938800	2080	2160	82	5	80	0.0625000
NODE_286_length_4331_cov_37.938800	2080	2160	98	5	80	0.0625000
NODE_286_length_4331_cov_37.938800	2080	2160	104	2	80	0.0250000
NODE_286_length_4331_cov_37.938800	2080	2160	106	1	80	0.0125000
NODE_286_length_4331_cov_37.938800	2080	2160	107	16	80	0.2000000
NODE_286_length_4331_cov_37.938800	2080	2160	112	7	80	0.0875000
NODE_286_length_4331_cov_37.938800	2080	2160	115	6	80	0.0750000
NODE_286_length_4331_cov_37.938800	2080	2160	116	5	80	0.0625000
NODE_286_length_4331_cov_37.938800	2080	2160	117	2	80	0.0250000
NODE_286_length_4331_cov_37.938800	2080	2160	118	7	80	0.0875000
NODE_286_length_4331_cov_37.938800	2080	2160	119	4	80	0.0500000
NODE_289_length_4320_cov_7.680881	442	522	0	80	80	1.0000000
NODE_289_length_4320_cov_7.680881	495	575	0	80	80	1.0000000
NODE_289_length_4320_cov_7.680881	571	651	0	80	80	1.0000000
NODE_289_length_4320_cov_7.680881	624	704	0	80	80	1.0000000
NODE_290_length_4314_cov_5.311507	1436	1516	0	2	80	0.0250000
NODE_290_length_4314_cov_5.311507	1436	1516	2	1	80	0.0125000
NODE_290_length_4314_cov_5.311507	1436	1516	4	35	80	0.4375000
NODE_290_length_4314_cov_5.311507	1436	1516	6	42	80	0.5250000
NODE_290_length_4314_cov_5.311507	1489	1569	0	55	80	0.6875000
NODE_290_length_4314_cov_5.311507	1489	1569	2	1	80	0.0125000
NODE_290_length_4314_cov_5.311507	1489	1569	4	24	80	0.3000000
NODE_290_length_4314_cov_5.311507	3331	3400	2	2	69	0.0289855
NODE_290_length_4314_cov_5.311507	3331	3400	4	5	69	0.0724638
NODE_290_length_4314_cov_5.311507	3331	3400	6	62	69	0.8985507
NODE_290_length_4314_cov_5.311507	3420	3482	2	38	62	0.6129032
NODE_290_length_4314_cov_5.311507	3420	3482	4	24	62	0.3870968
NODE_292_length_4311_cov_8.733381	92	171	37	4	79	0.0506329
NODE_292_length_4311_cov_8.733381	92	171	39	4	79	0.0506329
NODE_292_length_4311_cov_8.733381	92	171	41	1	79	0.0126582
NODE_292_length_4311_cov_8.733381	92	171	43	4	79	0.0506329
NODE_292_length_4311_cov_8.733381	92	171	45	2	79	0.0253165
NODE_292_length_4311_cov_8.733381	92	171	46	13	79	0.1645570
NODE_292_length_4311_cov_8.733381	92	171	49	9	79	0.1139240
NODE_292_length_4311_cov_8.733381	92	171	53	16	79	0.2025317
NODE_292_length_4311_cov_8.733381	92	171	55	1	79	0.0126582
NODE_292_length_4311_cov_8.733381	92	171	57	9	79	0.1139240
NODE_292_length_4311_cov_8.733381	92	171	59	16	79	0.2025317
NODE_292_length_4311_cov_8.733381	1925	2005	0	17	80	0.2125000
NODE_292_length_4311_cov_8.733381	1925	2005	2	63	80	0.7875000
NODE_292_length_4311_cov_8.733381	1978	2058	0	38	80	0.4750000
NODE_292_length_4311_cov_8.733381	1978	2058	2	42	80	0.5250000
NODE_294_length_4293_cov_3.809251	244	326	2	82	82	1.0000000
NODE_294_length_4293_cov_3.809251	301	394	0	60	93	0.6451613
NODE_294_length_4293_cov_3.809251	301	394	2	33	93	0.3548387
NODE_295_length_4284_cov_15.940263	3726	3806	0	17	80	0.2125000
NODE_295_length_4284_cov_15.940263	3726	3806	2	63	80	0.7875000
NODE_295_length_4284_cov_15.940263	3779	3858	2	79	79	1.0000000
NODE_299_length_4277_cov_5.451173	3818	3898	0	12	80	0.1500000
NODE_299_length_4277_cov_5.451173	3818	3898	4	15	80	0.1875000
NODE_299_length_4277_cov_5.451173	3818	3898	6	53	80	0.6625000
NODE_299_length_4277_cov_5.451173	3927	3995	6	56	68	0.8235294
NODE_299_length_4277_cov_5.451173	3927	3995	10	12	68	0.1764706
NODE_299_length_4277_cov_5.451173	3968	4048	0	41	80	0.5125000
NODE_299_length_4277_cov_5.451173	3968	4048	4	2	80	0.0250000
NODE_299_length_4277_cov_5.451173	3968	4048	6	37	80	0.4625000
NODE_300_length_4274_cov_18.943234	591	671	0	64	80	0.8000000
NODE_300_length_4274_cov_18.943234	591	671	4	12	80	0.1500000
NODE_300_length_4274_cov_18.943234	591	671	6	4	80	0.0500000
NODE_300_length_4274_cov_18.943234	644	724	0	11	80	0.1375000
NODE_300_length_4274_cov_18.943234	644	724	2	1	80	0.0125000
NODE_300_length_4274_cov_18.943234	644	724	4	23	80	0.2875000
NODE_300_length_4274_cov_18.943234	644	724	6	45	80	0.5625000
NODE_301_length_4274_cov_16.160958	416	496	0	41	80	0.5125000
NODE_301_length_4274_cov_16.160958	416	496	2	32	80	0.4000000
NODE_301_length_4274_cov_16.160958	416	496	6	1	80	0.0125000
NODE_301_length_4274_cov_16.160958	416	496	8	5	80	0.0625000
NODE_301_length_4274_cov_16.160958	416	496	10	1	80	0.0125000
NODE_301_length_4274_cov_16.160958	1034	1114	0	80	80	1.0000000
NODE_301_length_4274_cov_16.160958	1087	1167	0	80	80	1.0000000
NODE_301_length_4274_cov_16.160958	1163	1243	0	80	80	1.0000000
NODE_301_length_4274_cov_16.160958	1216	1296	0	80	80	1.0000000
NODE_301_length_4274_cov_16.160958	3411	3491	0	2	80	0.0250000
NODE_301_length_4274_cov_16.160958	3411	3491	5	1	80	0.0125000
NODE_301_length_4274_cov_16.160958	3411	3491	6	4	80	0.0500000
NODE_301_length_4274_cov_16.160958	3411	3491	8	3	80	0.0375000
NODE_301_length_4274_cov_16.160958	3411	3491	15	1	80	0.0125000
NODE_301_length_4274_cov_16.160958	3411	3491	16	1	80	0.0125000
NODE_301_length_4274_cov_16.160958	3411	3491	18	3	80	0.0375000
NODE_301_length_4274_cov_16.160958	3411	3491	20	12	80	0.1500000
NODE_301_length_4274_cov_16.160958	3411	3491	29	33	80	0.4125000
NODE_301_length_4274_cov_16.160958	3411	3491	33	10	80	0.1250000
NODE_301_length_4274_cov_16.160958	3411	3491	35	6	80	0.0750000
NODE_301_length_4274_cov_16.160958	3411	3491	37	4	80	0.0500000
NODE_302_length_4270_cov_14.045792	3835	3915	189	2	80	0.0250000
NODE_302_length_4270_cov_14.045792	3835	3915	190	1	80	0.0125000
NODE_302_length_4270_cov_14.045792	3835	3915	192	1	80	0.0125000
NODE_302_length_4270_cov_14.045792	3835	3915	194	1	80	0.0125000
NODE_302_length_4270_cov_14.045792	3835	3915	195	1	80	0.0125000
NODE_302_length_4270_cov_14.045792	3835	3915	200	1	80	0.0125000
NODE_302_length_4270_cov_14.045792	3835	3915	202	2	80	0.0250000
NODE_302_length_4270_cov_14.045792	3835	3915	208	1	80	0.0125000
NODE_302_length_4270_cov_14.045792	3835	3915	209	6	80	0.0750000
NODE_302_length_4270_cov_14.045792	3835	3915	210	4	80	0.0500000
NODE_302_length_4270_cov_14.045792	3835	3915	213	3	80	0.0375000
NODE_302_length_4270_cov_14.045792	3835	3915	214	2	80	0.0250000
NODE_302_length_4270_cov_14.045792	3835	3915	215	1	80	0.0125000
NODE_302_length_4270_cov_14.045792	3835	3915	216	1	80	0.0125000
NODE_302_length_4270_cov_14.045792	3835	3915	217	7	80	0.0875000
NODE_302_length_4270_cov_14.045792	3835	3915	218	3	80	0.0375000
NODE_302_length_4270_cov_14.045792	3835	3915	219	4	80	0.0500000
NODE_302_length_4270_cov_14.045792	3835	3915	220	1	80	0.0125000
NODE_302_length_4270_cov_14.045792	3835	3915	221	3	80	0.0375000
NODE_302_length_4270_cov_14.045792	3835	3915	223	2	80	0.0250000
NODE_302_length_4270_cov_14.045792	3835	3915	224	1	80	0.0125000
NODE_302_length_4270_cov_14.045792	3835	3915	225	1	80	0.0125000
NODE_302_length_4270_cov_14.045792	3835	3915	227	2	80	0.0250000
NODE_302_length_4270_cov_14.045792	3835	3915	228	4	80	0.0500000
NODE_302_length_4270_cov_14.045792	3835	3915	229	6	80	0.0750000
NODE_302_length_4270_cov_14.045792	3835	3915	230	3	80	0.0375000
NODE_302_length_4270_cov_14.045792	3835	3915	231	4	80	0.0500000
NODE_302_length_4270_cov_14.045792	3835	3915	232	1	80	0.0125000
NODE_302_length_4270_cov_14.045792	3835	3915	233	7	80	0.0875000
NODE_302_length_4270_cov_14.045792	3835	3915	234	3	80	0.0375000
NODE_302_length_4270_cov_14.045792	3835	3915	235	1	80	0.0125000
NODE_302_length_4270_cov_14.045792	3888	3968	133	2	80	0.0250000
NODE_302_length_4270_cov_14.045792	3888	3968	135	1	80	0.0125000
NODE_302_length_4270_cov_14.045792	3888	3968	136	2	80	0.0250000
NODE_302_length_4270_cov_14.045792	3888	3968	138	1	80	0.0125000
NODE_302_length_4270_cov_14.045792	3888	3968	141	1	80	0.0125000
NODE_302_length_4270_cov_14.045792	3888	3968	142	2	80	0.0250000
NODE_302_length_4270_cov_14.045792	3888	3968	143	1	80	0.0125000
NODE_302_length_4270_cov_14.045792	3888	3968	144	4	80	0.0500000
NODE_302_length_4270_cov_14.045792	3888	3968	145	3	80	0.0375000
NODE_302_length_4270_cov_14.045792	3888	3968	146	6	80	0.0750000
NODE_302_length_4270_cov_14.045792	3888	3968	149	1	80	0.0125000
NODE_302_length_4270_cov_14.045792	3888	3968	151	1	80	0.0125000
NODE_302_length_4270_cov_14.045792	3888	3968	153	1	80	0.0125000
NODE_302_length_4270_cov_14.045792	3888	3968	155	3	80	0.0375000
NODE_302_length_4270_cov_14.045792	3888	3968	158	1	80	0.0125000
NODE_302_length_4270_cov_14.045792	3888	3968	160	2	80	0.0250000
NODE_302_length_4270_cov_14.045792	3888	3968	162	1	80	0.0125000
NODE_302_length_4270_cov_14.045792	3888	3968	164	1	80	0.0125000
NODE_302_length_4270_cov_14.045792	3888	3968	168	1	80	0.0125000
NODE_302_length_4270_cov_14.045792	3888	3968	170	2	80	0.0250000
NODE_302_length_4270_cov_14.045792	3888	3968	171	2	80	0.0250000
NODE_302_length_4270_cov_14.045792	3888	3968	172	1	80	0.0125000
NODE_302_length_4270_cov_14.045792	3888	3968	173	1	80	0.0125000
NODE_302_length_4270_cov_14.045792	3888	3968	179	1	80	0.0125000
NODE_302_length_4270_cov_14.045792	3888	3968	182	1	80	0.0125000
NODE_302_length_4270_cov_14.045792	3888	3968	185	1	80	0.0125000
NODE_302_length_4270_cov_14.045792	3888	3968	193	1	80	0.0125000
NODE_302_length_4270_cov_14.045792	3888	3968	195	2	80	0.0250000
NODE_302_length_4270_cov_14.045792	3888	3968	196	1	80	0.0125000
NODE_302_length_4270_cov_14.045792	3888	3968	197	1	80	0.0125000
NODE_302_length_4270_cov_14.045792	3888	3968	199	1	80	0.0125000
NODE_302_length_4270_cov_14.045792	3888	3968	201	1	80	0.0125000
NODE_302_length_4270_cov_14.045792	3888	3968	202	3	80	0.0375000
NODE_302_length_4270_cov_14.045792	3888	3968	208	1	80	0.0125000
NODE_302_length_4270_cov_14.045792	3888	3968	209	6	80	0.0750000
NODE_302_length_4270_cov_14.045792	3888	3968	210	3	80	0.0375000
NODE_302_length_4270_cov_14.045792	3888	3968	213	2	80	0.0250000
NODE_302_length_4270_cov_14.045792	3888	3968	214	2	80	0.0250000
NODE_302_length_4270_cov_14.045792	3888	3968	215	1	80	0.0125000
NODE_302_length_4270_cov_14.045792	3888	3968	216	1	80	0.0125000
NODE_302_length_4270_cov_14.045792	3888	3968	217	6	80	0.0750000
NODE_302_length_4270_cov_14.045792	3888	3968	218	3	80	0.0375000
NODE_302_length_4270_cov_14.045792	3888	3968	223	1	80	0.0125000
NODE_303_length_4260_cov_24.780822	244	311	14	6	67	0.0895522
NODE_303_length_4260_cov_24.780822	244	311	16	11	67	0.1641791
NODE_303_length_4260_cov_24.780822	244	311	22	1	67	0.0149254
NODE_303_length_4260_cov_24.780822	244	311	24	8	67	0.1194030
NODE_303_length_4260_cov_24.780822	244	311	28	41	67	0.6119403
NODE_303_length_4260_cov_24.780822	244	311	14	6	67	0.0895522
NODE_303_length_4260_cov_24.780822	244	311	16	11	67	0.1641791
NODE_303_length_4260_cov_24.780822	244	311	22	1	67	0.0149254
NODE_303_length_4260_cov_24.780822	244	311	24	8	67	0.1194030
NODE_303_length_4260_cov_24.780822	244	311	28	41	67	0.6119403
NODE_303_length_4260_cov_24.780822	263	311	22	1	48	0.0208333
NODE_303_length_4260_cov_24.780822	263	311	24	8	48	0.1666667
NODE_303_length_4260_cov_24.780822	263	311	28	39	48	0.8125000
NODE_303_length_4260_cov_24.780822	1605	1633	8	2	28	0.0714286
NODE_303_length_4260_cov_24.780822	1605	1633	10	8	28	0.2857143
NODE_303_length_4260_cov_24.780822	1605	1633	12	5	28	0.1785714
NODE_303_length_4260_cov_24.780822	1605	1633	14	1	28	0.0357143
NODE_303_length_4260_cov_24.780822	1605	1633	15	1	28	0.0357143
NODE_303_length_4260_cov_24.780822	1605	1633	19	1	28	0.0357143
NODE_303_length_4260_cov_24.780822	1605	1633	20	1	28	0.0357143
NODE_303_length_4260_cov_24.780822	1605	1633	23	1	28	0.0357143
NODE_303_length_4260_cov_24.780822	1605	1633	24	3	28	0.1071429
NODE_303_length_4260_cov_24.780822	1605	1633	27	4	28	0.1428571
NODE_303_length_4260_cov_24.780822	1605	1633	46	1	28	0.0357143
NODE_303_length_4260_cov_24.780822	1660	1699	42	2	39	0.0512821
NODE_303_length_4260_cov_24.780822	1660	1699	44	3	39	0.0769231
NODE_303_length_4260_cov_24.780822	1660	1699	45	2	39	0.0512821
NODE_303_length_4260_cov_24.780822	1660	1699	46	8	39	0.2051282
NODE_303_length_4260_cov_24.780822	1660	1699	47	2	39	0.0512821
NODE_303_length_4260_cov_24.780822	1660	1699	49	3	39	0.0769231
NODE_303_length_4260_cov_24.780822	1660	1699	53	1	39	0.0256410
NODE_303_length_4260_cov_24.780822	1660	1699	56	1	39	0.0256410
NODE_303_length_4260_cov_24.780822	1660	1699	58	1	39	0.0256410
NODE_303_length_4260_cov_24.780822	1660	1699	60	1	39	0.0256410
NODE_303_length_4260_cov_24.780822	1660	1699	62	10	39	0.2564103
NODE_303_length_4260_cov_24.780822	1660	1699	68	4	39	0.1025641
NODE_303_length_4260_cov_24.780822	1660	1699	69	1	39	0.0256410
NODE_310_length_4207_cov_6.923564	3664	3722	26	1	58	0.0172414
NODE_310_length_4207_cov_6.923564	3664	3722	28	3	58	0.0517241
NODE_310_length_4207_cov_6.923564	3664	3722	30	9	58	0.1551724
NODE_310_length_4207_cov_6.923564	3664	3722	32	30	58	0.5172414
NODE_310_length_4207_cov_6.923564	3664	3722	34	4	58	0.0689655
NODE_310_length_4207_cov_6.923564	3664	3722	36	2	58	0.0344828
NODE_310_length_4207_cov_6.923564	3664	3722	38	1	58	0.0172414
NODE_310_length_4207_cov_6.923564	3664	3722	40	2	58	0.0344828
NODE_310_length_4207_cov_6.923564	3664	3722	41	1	58	0.0172414
NODE_310_length_4207_cov_6.923564	3664	3722	47	5	58	0.0862069
NODE_310_length_4207_cov_6.923564	3695	3775	2	5	80	0.0625000
NODE_310_length_4207_cov_6.923564	3695	3775	8	7	80	0.0875000
NODE_310_length_4207_cov_6.923564	3695	3775	12	2	80	0.0250000
NODE_310_length_4207_cov_6.923564	3695	3775	14	15	80	0.1875000
NODE_310_length_4207_cov_6.923564	3695	3775	16	12	80	0.1500000
NODE_310_length_4207_cov_6.923564	3695	3775	18	9	80	0.1125000
NODE_310_length_4207_cov_6.923564	3695	3775	25	1	80	0.0125000
NODE_310_length_4207_cov_6.923564	3695	3775	26	3	80	0.0375000
NODE_310_length_4207_cov_6.923564	3695	3775	28	3	80	0.0375000
NODE_310_length_4207_cov_6.923564	3695	3775	30	9	80	0.1125000
NODE_310_length_4207_cov_6.923564	3695	3775	32	14	80	0.1750000
NODE_311_length_4205_cov_6.121042	592	632	2	40	40	1.0000000
NODE_311_length_4205_cov_6.121042	605	685	0	42	80	0.5250000
NODE_311_length_4205_cov_6.121042	605	685	2	38	80	0.4750000
NODE_311_length_4205_cov_6.121042	681	745	0	64	64	1.0000000
NODE_312_length_4196_cov_4.170857	340	420	0	80	80	1.0000000
NODE_312_length_4196_cov_4.170857	393	473	0	80	80	1.0000000
NODE_316_length_4179_cov_6.655882	1	65	16	5	64	0.0781250
NODE_316_length_4179_cov_6.655882	1	65	18	2	64	0.0312500
NODE_316_length_4179_cov_6.655882	1	65	20	1	64	0.0156250
NODE_316_length_4179_cov_6.655882	1	65	22	2	64	0.0312500
NODE_316_length_4179_cov_6.655882	1	65	24	10	64	0.1562500
NODE_316_length_4179_cov_6.655882	1	65	26	13	64	0.2031250
NODE_316_length_4179_cov_6.655882	1	65	28	1	64	0.0156250
NODE_316_length_4179_cov_6.655882	1	65	30	1	64	0.0156250
NODE_316_length_4179_cov_6.655882	1	65	32	29	64	0.4531250
NODE_316_length_4179_cov_6.655882	1087	1140	2	28	53	0.5283019
NODE_316_length_4179_cov_6.655882	1087	1140	4	25	53	0.4716981
NODE_316_length_4179_cov_6.655882	1818	1898	0	15	80	0.1875000
NODE_316_length_4179_cov_6.655882	1818	1898	2	25	80	0.3125000
NODE_316_length_4179_cov_6.655882	1818	1898	5	8	80	0.1000000
NODE_316_length_4179_cov_6.655882	1818	1898	6	32	80	0.4000000
NODE_319_length_4150_cov_10.600099	2827	2849	120	5	22	0.2272727
NODE_319_length_4150_cov_10.600099	2827	2849	124	1	22	0.0454545
NODE_319_length_4150_cov_10.600099	2827	2849	128	1	22	0.0454545
NODE_319_length_4150_cov_10.600099	2827	2849	136	4	22	0.1818182
NODE_319_length_4150_cov_10.600099	2827	2849	144	3	22	0.1363636
NODE_319_length_4150_cov_10.600099	2827	2849	145	8	22	0.3636364
NODE_319_length_4150_cov_10.600099	2973	3053	10	2	80	0.0250000
NODE_319_length_4150_cov_10.600099	2973	3053	11	1	80	0.0125000
NODE_319_length_4150_cov_10.600099	2973	3053	13	1	80	0.0125000
NODE_319_length_4150_cov_10.600099	2973	3053	15	1	80	0.0125000
NODE_319_length_4150_cov_10.600099	2973	3053	16	2	80	0.0250000
NODE_319_length_4150_cov_10.600099	2973	3053	17	2	80	0.0250000
NODE_319_length_4150_cov_10.600099	2973	3053	19	3	80	0.0375000
NODE_319_length_4150_cov_10.600099	2973	3053	21	2	80	0.0250000
NODE_319_length_4150_cov_10.600099	2973	3053	22	2	80	0.0250000
NODE_319_length_4150_cov_10.600099	2973	3053	23	8	80	0.1000000
NODE_319_length_4150_cov_10.600099	2973	3053	25	1	80	0.0125000
NODE_319_length_4150_cov_10.600099	2973	3053	26	3	80	0.0375000
NODE_319_length_4150_cov_10.600099	2973	3053	28	7	80	0.0875000
NODE_319_length_4150_cov_10.600099	2973	3053	29	5	80	0.0625000
NODE_319_length_4150_cov_10.600099	2973	3053	35	7	80	0.0875000
NODE_319_length_4150_cov_10.600099	2973	3053	36	2	80	0.0250000
NODE_319_length_4150_cov_10.600099	2973	3053	37	1	80	0.0125000
NODE_319_length_4150_cov_10.600099	2973	3053	38	3	80	0.0375000
NODE_319_length_4150_cov_10.600099	2973	3053	44	8	80	0.1000000
NODE_319_length_4150_cov_10.600099	2973	3053	46	10	80	0.1250000
NODE_319_length_4150_cov_10.600099	2973	3053	48	9	80	0.1125000
NODE_319_length_4150_cov_10.600099	3026	3106	42	14	80	0.1750000
NODE_319_length_4150_cov_10.600099	3026	3106	44	33	80	0.4125000
NODE_319_length_4150_cov_10.600099	3026	3106	46	21	80	0.2625000
NODE_319_length_4150_cov_10.600099	3026	3106	48	12	80	0.1500000
NODE_324_length_4119_cov_27.984328	2818	2898	140	1	80	0.0125000
NODE_324_length_4119_cov_27.984328	2818	2898	143	1	80	0.0125000
NODE_324_length_4119_cov_27.984328	2818	2898	144	1	80	0.0125000
NODE_324_length_4119_cov_27.984328	2818	2898	147	1	80	0.0125000
NODE_324_length_4119_cov_27.984328	2818	2898	153	3	80	0.0375000
NODE_324_length_4119_cov_27.984328	2818	2898	157	1	80	0.0125000
NODE_324_length_4119_cov_27.984328	2818	2898	159	1	80	0.0125000
NODE_324_length_4119_cov_27.984328	2818	2898	162	3	80	0.0375000
NODE_324_length_4119_cov_27.984328	2818	2898	163	1	80	0.0125000
NODE_324_length_4119_cov_27.984328	2818	2898	164	5	80	0.0625000
NODE_324_length_4119_cov_27.984328	2818	2898	165	2	80	0.0250000
NODE_324_length_4119_cov_27.984328	2818	2898	166	3	80	0.0375000
NODE_324_length_4119_cov_27.984328	2818	2898	168	2	80	0.0250000
NODE_324_length_4119_cov_27.984328	2818	2898	169	2	80	0.0250000
NODE_324_length_4119_cov_27.984328	2818	2898	170	2	80	0.0250000
NODE_324_length_4119_cov_27.984328	2818	2898	171	1	80	0.0125000
NODE_324_length_4119_cov_27.984328	2818	2898	176	2	80	0.0250000
NODE_324_length_4119_cov_27.984328	2818	2898	178	4	80	0.0500000
NODE_324_length_4119_cov_27.984328	2818	2898	180	2	80	0.0250000
NODE_324_length_4119_cov_27.984328	2818	2898	182	3	80	0.0375000
NODE_324_length_4119_cov_27.984328	2818	2898	184	3	80	0.0375000
NODE_324_length_4119_cov_27.984328	2818	2898	186	1	80	0.0125000
NODE_324_length_4119_cov_27.984328	2818	2898	187	4	80	0.0500000
NODE_324_length_4119_cov_27.984328	2818	2898	188	3	80	0.0375000
NODE_324_length_4119_cov_27.984328	2818	2898	189	1	80	0.0125000
NODE_324_length_4119_cov_27.984328	2818	2898	190	5	80	0.0625000
NODE_324_length_4119_cov_27.984328	2818	2898	191	3	80	0.0375000
NODE_324_length_4119_cov_27.984328	2818	2898	192	2	80	0.0250000
NODE_324_length_4119_cov_27.984328	2818	2898	193	3	80	0.0375000
NODE_324_length_4119_cov_27.984328	2818	2898	194	2	80	0.0250000
NODE_324_length_4119_cov_27.984328	2818	2898	195	3	80	0.0375000
NODE_324_length_4119_cov_27.984328	2818	2898	196	2	80	0.0250000
NODE_324_length_4119_cov_27.984328	2818	2898	197	3	80	0.0375000
NODE_324_length_4119_cov_27.984328	2818	2898	198	3	80	0.0375000
NODE_324_length_4119_cov_27.984328	2818	2898	201	1	80	0.0125000
NODE_325_length_4108_cov_14.755550	378	422	0	3	44	0.0681818
NODE_325_length_4108_cov_14.755550	378	422	2	40	44	0.9090909
NODE_325_length_4108_cov_14.755550	378	422	6	1	44	0.0227273
NODE_325_length_4108_cov_14.755550	3537	3617	4	5	80	0.0625000
NODE_325_length_4108_cov_14.755550	3537	3617	8	33	80	0.4125000
NODE_325_length_4108_cov_14.755550	3537	3617	10	11	80	0.1375000
NODE_325_length_4108_cov_14.755550	3537	3617	12	1	80	0.0125000
NODE_325_length_4108_cov_14.755550	3537	3617	22	6	80	0.0750000
NODE_325_length_4108_cov_14.755550	3537	3617	24	9	80	0.1125000
NODE_325_length_4108_cov_14.755550	3537	3617	27	2	80	0.0250000
NODE_325_length_4108_cov_14.755550	3537	3617	28	13	80	0.1625000
NODE_325_length_4108_cov_14.755550	3590	3670	19	3	80	0.0375000
NODE_325_length_4108_cov_14.755550	3590	3670	21	5	80	0.0625000
NODE_325_length_4108_cov_14.755550	3590	3670	22	3	80	0.0375000
NODE_325_length_4108_cov_14.755550	3590	3670	23	15	80	0.1875000
NODE_325_length_4108_cov_14.755550	3590	3670	24	9	80	0.1125000
NODE_325_length_4108_cov_14.755550	3590	3670	25	17	80	0.2125000
NODE_325_length_4108_cov_14.755550	3590	3670	26	7	80	0.0875000
NODE_325_length_4108_cov_14.755550	3590	3670	27	8	80	0.1000000
NODE_325_length_4108_cov_14.755550	3590	3670	28	13	80	0.1625000
NODE_326_length_4107_cov_1.855539	207	287	0	6	80	0.0750000
NODE_326_length_4107_cov_1.855539	207	287	2	74	80	0.9250000
NODE_328_length_4096_cov_31.197648	379	459	0	80	80	1.0000000
NODE_328_length_4096_cov_31.197648	432	512	0	80	80	1.0000000
NODE_328_length_4096_cov_31.197648	3305	3385	1	6	80	0.0750000
NODE_328_length_4096_cov_31.197648	3305	3385	2	74	80	0.9250000
NODE_328_length_4096_cov_31.197648	3358	3438	1	16	80	0.2000000
NODE_328_length_4096_cov_31.197648	3358	3438	2	64	80	0.8000000
NODE_329_length_4081_cov_20.248870	3673	3753	4	75	80	0.9375000
NODE_329_length_4081_cov_20.248870	3673	3753	6	5	80	0.0625000
NODE_329_length_4081_cov_20.248870	3726	3806	0	42	80	0.5250000
NODE_329_length_4081_cov_20.248870	3726	3806	4	38	80	0.4750000
NODE_330_length_4076_cov_15.138044	1062	1142	0	22	80	0.2750000
NODE_330_length_4076_cov_15.138044	1062	1142	8	1	80	0.0125000
NODE_330_length_4076_cov_15.138044	1062	1142	9	12	80	0.1500000
NODE_330_length_4076_cov_15.138044	1062	1142	15	1	80	0.0125000
NODE_330_length_4076_cov_15.138044	1062	1142	16	8	80	0.1000000
NODE_330_length_4076_cov_15.138044	1062	1142	17	36	80	0.4500000
NODE_330_length_4076_cov_15.138044	1115	1195	17	80	80	1.0000000
NODE_331_length_4069_cov_14.261209	3871	3936	4	25	65	0.3846154
NODE_331_length_4069_cov_14.261209	3871	3936	6	40	65	0.6153846
NODE_333_length_4050_cov_31.044039	1703	1783	14	8	80	0.1000000
NODE_333_length_4050_cov_31.044039	1703	1783	16	10	80	0.1250000
NODE_333_length_4050_cov_31.044039	1703	1783	17	13	80	0.1625000
NODE_333_length_4050_cov_31.044039	1703	1783	18	12	80	0.1500000
NODE_333_length_4050_cov_31.044039	1703	1783	20	8	80	0.1000000
NODE_333_length_4050_cov_31.044039	1703	1783	21	7	80	0.0875000
NODE_333_length_4050_cov_31.044039	1703	1783	22	1	80	0.0125000
NODE_333_length_4050_cov_31.044039	1703	1783	24	19	80	0.2375000
NODE_333_length_4050_cov_31.044039	1703	1783	25	2	80	0.0250000
NODE_335_length_4021_cov_34.619072	379	459	2	21	80	0.2625000
NODE_335_length_4021_cov_34.619072	379	459	4	19	80	0.2375000
NODE_335_length_4021_cov_34.619072	379	459	6	40	80	0.5000000
NODE_335_length_4021_cov_34.619072	432	512	0	30	80	0.3750000
NODE_335_length_4021_cov_34.619072	432	512	2	44	80	0.5500000
NODE_335_length_4021_cov_34.619072	432	512	6	6	80	0.0750000
NODE_336_length_4020_cov_5.130834	3455	3535	0	31	80	0.3875000
NODE_336_length_4020_cov_5.130834	3455	3535	2	28	80	0.3500000
NODE_336_length_4020_cov_5.130834	3455	3535	4	5	80	0.0625000
NODE_336_length_4020_cov_5.130834	3455	3535	6	16	80	0.2000000
NODE_336_length_4020_cov_5.130834	3508	3588	2	15	80	0.1875000
NODE_336_length_4020_cov_5.130834	3508	3588	4	18	80	0.2250000
NODE_336_length_4020_cov_5.130834	3508	3588	6	47	80	0.5875000
NODE_339_length_4004_cov_9.718054	387	467	2	80	80	1.0000000
NODE_339_length_4004_cov_9.718054	440	520	0	8	80	0.1000000
NODE_339_length_4004_cov_9.718054	440	520	2	72	80	0.9000000
NODE_339_length_4004_cov_9.718054	516	596	0	80	80	1.0000000
NODE_339_length_4004_cov_9.718054	569	649	0	80	80	1.0000000
NODE_341_length_3991_cov_18.617934	867	947	0	48	80	0.6000000
NODE_341_length_3991_cov_18.617934	867	947	4	32	80	0.4000000
NODE_341_length_3991_cov_18.617934	920	1000	0	80	80	1.0000000
NODE_341_length_3991_cov_18.617934	996	1076	0	80	80	1.0000000
NODE_341_length_3991_cov_18.617934	1049	1124	0	75	75	1.0000000
NODE_348_length_3973_cov_6.906298	17	65	0	48	48	1.0000000
NODE_348_length_3973_cov_6.906298	1945	1995	16	4	50	0.0800000
NODE_348_length_3973_cov_6.906298	1945	1995	18	2	50	0.0400000
NODE_348_length_3973_cov_6.906298	1945	1995	20	26	50	0.5200000
NODE_348_length_3973_cov_6.906298	1945	1995	22	6	50	0.1200000
NODE_348_length_3973_cov_6.906298	1945	1995	24	9	50	0.1800000
NODE_348_length_3973_cov_6.906298	1945	1995	26	3	50	0.0600000
NODE_350_length_3960_cov_6.246827	2673	2761	0	88	88	1.0000000
NODE_350_length_3960_cov_6.246827	3520	3600	0	17	80	0.2125000
NODE_350_length_3960_cov_6.246827	3520	3600	3	63	80	0.7875000
NODE_350_length_3960_cov_6.246827	3573	3653	0	7	80	0.0875000
NODE_350_length_3960_cov_6.246827	3573	3653	3	73	80	0.9125000
NODE_353_length_3952_cov_8.805346	826	906	0	15	80	0.1875000
NODE_353_length_3952_cov_8.805346	826	906	2	65	80	0.8125000
NODE_353_length_3952_cov_8.805346	879	959	0	68	80	0.8500000
NODE_353_length_3952_cov_8.805346	879	959	2	12	80	0.1500000
NODE_354_length_3928_cov_5.936798	2440	2521	0	18	81	0.2222222
NODE_354_length_3928_cov_5.936798	2440	2521	2	63	81	0.7777778
NODE_354_length_3928_cov_5.936798	2493	2574	2	81	81	1.0000000
NODE_356_length_3923_cov_14.807793	3759	3800	2	1	41	0.0243902
NODE_356_length_3923_cov_14.807793	3759	3800	6	40	41	0.9756098
NODE_358_length_3922_cov_7.609731	1493	1573	67	3	80	0.0375000
NODE_358_length_3922_cov_7.609731	1493	1573	68	6	80	0.0750000
NODE_358_length_3922_cov_7.609731	1493	1573	69	1	80	0.0125000
NODE_358_length_3922_cov_7.609731	1493	1573	72	3	80	0.0375000
NODE_358_length_3922_cov_7.609731	1493	1573	73	5	80	0.0625000
NODE_358_length_3922_cov_7.609731	1493	1573	75	2	80	0.0250000
NODE_358_length_3922_cov_7.609731	1493	1573	79	1	80	0.0125000
NODE_358_length_3922_cov_7.609731	1493	1573	80	6	80	0.0750000
NODE_358_length_3922_cov_7.609731	1493	1573	82	5	80	0.0625000
NODE_358_length_3922_cov_7.609731	1493	1573	83	2	80	0.0250000
NODE_358_length_3922_cov_7.609731	1493	1573	84	6	80	0.0750000
NODE_358_length_3922_cov_7.609731	1493	1573	85	6	80	0.0750000
NODE_358_length_3922_cov_7.609731	1493	1573	86	4	80	0.0500000
NODE_358_length_3922_cov_7.609731	1493	1573	87	3	80	0.0375000
NODE_358_length_3922_cov_7.609731	1493	1573	88	8	80	0.1000000
NODE_358_length_3922_cov_7.609731	1493	1573	89	9	80	0.1125000
NODE_358_length_3922_cov_7.609731	1493	1573	90	2	80	0.0250000
NODE_358_length_3922_cov_7.609731	1493	1573	91	1	80	0.0125000
NODE_358_length_3922_cov_7.609731	1493	1573	92	6	80	0.0750000
NODE_358_length_3922_cov_7.609731	1493	1573	93	1	80	0.0125000
NODE_358_length_3922_cov_7.609731	1546	1600	76	1	54	0.0185185
NODE_358_length_3922_cov_7.609731	1546	1600	81	4	54	0.0740741
NODE_358_length_3922_cov_7.609731	1546	1600	83	2	54	0.0370370
NODE_358_length_3922_cov_7.609731	1546	1600	84	17	54	0.3148148
NODE_358_length_3922_cov_7.609731	1546	1600	86	3	54	0.0555556
NODE_358_length_3922_cov_7.609731	1546	1600	88	6	54	0.1111111
NODE_358_length_3922_cov_7.609731	1546	1600	89	10	54	0.1851852
NODE_358_length_3922_cov_7.609731	1546	1600	90	2	54	0.0370370
NODE_358_length_3922_cov_7.609731	1546	1600	91	2	54	0.0370370
NODE_358_length_3922_cov_7.609731	1546	1600	92	6	54	0.1111111
NODE_358_length_3922_cov_7.609731	1546	1600	93	1	54	0.0185185
NODE_359_length_3921_cov_9.943223	2936	3016	372	1	80	0.0125000
NODE_359_length_3921_cov_9.943223	2936	3016	380	1	80	0.0125000
NODE_359_length_3921_cov_9.943223	2936	3016	381	1	80	0.0125000
NODE_359_length_3921_cov_9.943223	2936	3016	387	1	80	0.0125000
NODE_359_length_3921_cov_9.943223	2936	3016	388	2	80	0.0250000
NODE_359_length_3921_cov_9.943223	2936	3016	389	1	80	0.0125000
NODE_359_length_3921_cov_9.943223	2936	3016	390	1	80	0.0125000
NODE_359_length_3921_cov_9.943223	2936	3016	391	3	80	0.0375000
NODE_359_length_3921_cov_9.943223	2936	3016	392	1	80	0.0125000
NODE_359_length_3921_cov_9.943223	2936	3016	393	1	80	0.0125000
NODE_359_length_3921_cov_9.943223	2936	3016	396	1	80	0.0125000
NODE_359_length_3921_cov_9.943223	2936	3016	397	1	80	0.0125000
NODE_359_length_3921_cov_9.943223	2936	3016	399	1	80	0.0125000
NODE_359_length_3921_cov_9.943223	2936	3016	400	2	80	0.0250000
NODE_359_length_3921_cov_9.943223	2936	3016	402	1	80	0.0125000
NODE_359_length_3921_cov_9.943223	2936	3016	403	3	80	0.0375000
NODE_359_length_3921_cov_9.943223	2936	3016	405	1	80	0.0125000
NODE_359_length_3921_cov_9.943223	2936	3016	407	1	80	0.0125000
NODE_359_length_3921_cov_9.943223	2936	3016	413	2	80	0.0250000
NODE_359_length_3921_cov_9.943223	2936	3016	416	2	80	0.0250000
NODE_359_length_3921_cov_9.943223	2936	3016	417	1	80	0.0125000
NODE_359_length_3921_cov_9.943223	2936	3016	418	1	80	0.0125000
NODE_359_length_3921_cov_9.943223	2936	3016	419	1	80	0.0125000
NODE_359_length_3921_cov_9.943223	2936	3016	421	2	80	0.0250000
NODE_359_length_3921_cov_9.943223	2936	3016	423	5	80	0.0625000
NODE_359_length_3921_cov_9.943223	2936	3016	424	1	80	0.0125000
NODE_359_length_3921_cov_9.943223	2936	3016	430	1	80	0.0125000
NODE_359_length_3921_cov_9.943223	2936	3016	432	1	80	0.0125000
NODE_359_length_3921_cov_9.943223	2936	3016	433	1	80	0.0125000
NODE_359_length_3921_cov_9.943223	2936	3016	434	1	80	0.0125000
NODE_359_length_3921_cov_9.943223	2936	3016	435	1	80	0.0125000
NODE_359_length_3921_cov_9.943223	2936	3016	437	1	80	0.0125000
NODE_359_length_3921_cov_9.943223	2936	3016	439	1	80	0.0125000
NODE_359_length_3921_cov_9.943223	2936	3016	441	1	80	0.0125000
NODE_359_length_3921_cov_9.943223	2936	3016	442	1	80	0.0125000
NODE_359_length_3921_cov_9.943223	2936	3016	444	1	80	0.0125000
NODE_359_length_3921_cov_9.943223	2936	3016	450	1	80	0.0125000
NODE_359_length_3921_cov_9.943223	2936	3016	451	2	80	0.0250000
NODE_359_length_3921_cov_9.943223	2936	3016	452	2	80	0.0250000
NODE_359_length_3921_cov_9.943223	2936	3016	453	1	80	0.0125000
NODE_359_length_3921_cov_9.943223	2936	3016	454	3	80	0.0375000
NODE_359_length_3921_cov_9.943223	2936	3016	456	1	80	0.0125000
NODE_359_length_3921_cov_9.943223	2936	3016	458	1	80	0.0125000
NODE_359_length_3921_cov_9.943223	2936	3016	459	1	80	0.0125000
NODE_359_length_3921_cov_9.943223	2936	3016	461	1	80	0.0125000
NODE_359_length_3921_cov_9.943223	2936	3016	462	1	80	0.0125000
NODE_359_length_3921_cov_9.943223	2936	3016	463	3	80	0.0375000
NODE_359_length_3921_cov_9.943223	2936	3016	464	3	80	0.0375000
NODE_359_length_3921_cov_9.943223	2936	3016	466	4	80	0.0500000
NODE_359_length_3921_cov_9.943223	2936	3016	467	2	80	0.0250000
NODE_359_length_3921_cov_9.943223	2936	3016	468	1	80	0.0125000
NODE_359_length_3921_cov_9.943223	2936	3016	469	2	80	0.0250000
NODE_359_length_3921_cov_9.943223	2936	3016	471	1	80	0.0125000
NODE_359_length_3921_cov_9.943223	2936	3016	472	1	80	0.0125000
NODE_359_length_3921_cov_9.943223	2989	3057	341	1	68	0.0147059
NODE_359_length_3921_cov_9.943223	2989	3057	347	1	68	0.0147059
NODE_359_length_3921_cov_9.943223	2989	3057	348	1	68	0.0147059
NODE_359_length_3921_cov_9.943223	2989	3057	349	1	68	0.0147059
NODE_359_length_3921_cov_9.943223	2989	3057	350	1	68	0.0147059
NODE_359_length_3921_cov_9.943223	2989	3057	353	1	68	0.0147059
NODE_359_length_3921_cov_9.943223	2989	3057	355	2	68	0.0294118
NODE_359_length_3921_cov_9.943223	2989	3057	356	1	68	0.0147059
NODE_359_length_3921_cov_9.943223	2989	3057	358	2	68	0.0294118
NODE_359_length_3921_cov_9.943223	2989	3057	361	1	68	0.0147059
NODE_359_length_3921_cov_9.943223	2989	3057	366	1	68	0.0147059
NODE_359_length_3921_cov_9.943223	2989	3057	369	1	68	0.0147059
NODE_359_length_3921_cov_9.943223	2989	3057	390	1	68	0.0147059
NODE_359_length_3921_cov_9.943223	2989	3057	403	2	68	0.0294118
NODE_359_length_3921_cov_9.943223	2989	3057	404	2	68	0.0294118
NODE_359_length_3921_cov_9.943223	2989	3057	405	1	68	0.0147059
NODE_359_length_3921_cov_9.943223	2989	3057	406	3	68	0.0441176
NODE_359_length_3921_cov_9.943223	2989	3057	407	2	68	0.0294118
NODE_359_length_3921_cov_9.943223	2989	3057	409	1	68	0.0147059
NODE_359_length_3921_cov_9.943223	2989	3057	412	1	68	0.0147059
NODE_359_length_3921_cov_9.943223	2989	3057	418	1	68	0.0147059
NODE_359_length_3921_cov_9.943223	2989	3057	425	1	68	0.0147059
NODE_359_length_3921_cov_9.943223	2989	3057	427	2	68	0.0294118
NODE_359_length_3921_cov_9.943223	2989	3057	428	2	68	0.0294118
NODE_359_length_3921_cov_9.943223	2989	3057	429	1	68	0.0147059
NODE_359_length_3921_cov_9.943223	2989	3057	430	1	68	0.0147059
NODE_359_length_3921_cov_9.943223	2989	3057	431	1	68	0.0147059
NODE_359_length_3921_cov_9.943223	2989	3057	432	1	68	0.0147059
NODE_359_length_3921_cov_9.943223	2989	3057	433	2	68	0.0294118
NODE_359_length_3921_cov_9.943223	2989	3057	434	1	68	0.0147059
NODE_359_length_3921_cov_9.943223	2989	3057	435	1	68	0.0147059
NODE_359_length_3921_cov_9.943223	2989	3057	437	1	68	0.0147059
NODE_359_length_3921_cov_9.943223	2989	3057	439	1	68	0.0147059
NODE_359_length_3921_cov_9.943223	2989	3057	441	1	68	0.0147059
NODE_359_length_3921_cov_9.943223	2989	3057	450	1	68	0.0147059
NODE_359_length_3921_cov_9.943223	2989	3057	453	1	68	0.0147059
NODE_359_length_3921_cov_9.943223	2989	3057	454	2	68	0.0294118
NODE_359_length_3921_cov_9.943223	2989	3057	459	1	68	0.0147059
NODE_359_length_3921_cov_9.943223	2989	3057	461	1	68	0.0147059
NODE_359_length_3921_cov_9.943223	2989	3057	462	1	68	0.0147059
NODE_359_length_3921_cov_9.943223	2989	3057	463	3	68	0.0441176
NODE_359_length_3921_cov_9.943223	2989	3057	464	3	68	0.0441176
NODE_359_length_3921_cov_9.943223	2989	3057	466	4	68	0.0588235
NODE_359_length_3921_cov_9.943223	2989	3057	467	2	68	0.0294118
NODE_359_length_3921_cov_9.943223	2989	3057	468	1	68	0.0147059
NODE_359_length_3921_cov_9.943223	2989	3057	469	2	68	0.0294118
NODE_359_length_3921_cov_9.943223	2989	3057	471	1	68	0.0147059
NODE_359_length_3921_cov_9.943223	2989	3057	472	1	68	0.0147059
NODE_359_length_3921_cov_9.943223	3047	3066	284	1	19	0.0526316
NODE_359_length_3921_cov_9.943223	3047	3066	294	1	19	0.0526316
NODE_359_length_3921_cov_9.943223	3047	3066	296	1	19	0.0526316
NODE_359_length_3921_cov_9.943223	3047	3066	299	1	19	0.0526316
NODE_359_length_3921_cov_9.943223	3047	3066	313	1	19	0.0526316
NODE_359_length_3921_cov_9.943223	3047	3066	317	1	19	0.0526316
NODE_359_length_3921_cov_9.943223	3047	3066	326	1	19	0.0526316
NODE_359_length_3921_cov_9.943223	3047	3066	341	2	19	0.1052632
NODE_359_length_3921_cov_9.943223	3047	3066	342	1	19	0.0526316
NODE_359_length_3921_cov_9.943223	3047	3066	347	1	19	0.0526316
NODE_359_length_3921_cov_9.943223	3047	3066	348	1	19	0.0526316
NODE_359_length_3921_cov_9.943223	3047	3066	349	1	19	0.0526316
NODE_359_length_3921_cov_9.943223	3047	3066	350	1	19	0.0526316
NODE_359_length_3921_cov_9.943223	3047	3066	353	1	19	0.0526316
NODE_359_length_3921_cov_9.943223	3047	3066	355	2	19	0.1052632
NODE_359_length_3921_cov_9.943223	3047	3066	356	1	19	0.0526316
NODE_359_length_3921_cov_9.943223	3047	3066	358	1	19	0.0526316
NODE_363_length_3898_cov_40.033167	3296	3370	55	3	74	0.0405405
NODE_363_length_3898_cov_40.033167	3296	3370	57	1	74	0.0135135
NODE_363_length_3898_cov_40.033167	3296	3370	58	2	74	0.0270270
NODE_363_length_3898_cov_40.033167	3296	3370	60	1	74	0.0135135
NODE_363_length_3898_cov_40.033167	3296	3370	61	5	74	0.0675676
NODE_363_length_3898_cov_40.033167	3296	3370	63	1	74	0.0135135
NODE_363_length_3898_cov_40.033167	3296	3370	64	2	74	0.0270270
NODE_363_length_3898_cov_40.033167	3296	3370	67	5	74	0.0675676
NODE_363_length_3898_cov_40.033167	3296	3370	68	12	74	0.1621622
NODE_363_length_3898_cov_40.033167	3296	3370	70	21	74	0.2837838
NODE_363_length_3898_cov_40.033167	3296	3370	72	5	74	0.0675676
NODE_363_length_3898_cov_40.033167	3296	3370	74	16	74	0.2162162
NODE_363_length_3898_cov_40.033167	3539	3619	17	3	80	0.0375000
NODE_363_length_3898_cov_40.033167	3539	3619	18	1	80	0.0125000
NODE_363_length_3898_cov_40.033167	3539	3619	19	6	80	0.0750000
NODE_363_length_3898_cov_40.033167	3539	3619	21	9	80	0.1125000
NODE_363_length_3898_cov_40.033167	3539	3619	22	4	80	0.0500000
NODE_363_length_3898_cov_40.033167	3539	3619	23	34	80	0.4250000
NODE_363_length_3898_cov_40.033167	3539	3619	24	1	80	0.0125000
NODE_363_length_3898_cov_40.033167	3539	3619	25	22	80	0.2750000
NODE_364_length_3898_cov_7.550145	668	748	0	80	80	1.0000000
NODE_364_length_3898_cov_7.550145	721	801	0	75	80	0.9375000
NODE_364_length_3898_cov_7.550145	721	801	5	1	80	0.0125000
NODE_364_length_3898_cov_7.550145	721	801	7	1	80	0.0125000
NODE_364_length_3898_cov_7.550145	721	801	12	1	80	0.0125000
NODE_364_length_3898_cov_7.550145	721	801	14	1	80	0.0125000
NODE_364_length_3898_cov_7.550145	721	801	18	1	80	0.0125000
NODE_367_length_3882_cov_4.166006	3244	3324	8	45	80	0.5625000
NODE_367_length_3882_cov_4.166006	3244	3324	10	35	80	0.4375000
NODE_367_length_3882_cov_4.166006	3282	3324	8	7	42	0.1666667
NODE_367_length_3882_cov_4.166006	3282	3324	10	35	42	0.8333333
NODE_367_length_3882_cov_4.166006	3297	3377	2	3	80	0.0375000
NODE_367_length_3882_cov_4.166006	3297	3377	4	28	80	0.3500000
NODE_367_length_3882_cov_4.166006	3297	3377	6	20	80	0.2500000
NODE_367_length_3882_cov_4.166006	3297	3377	10	29	80	0.3625000
NODE_367_length_3882_cov_4.166006	3297	3377	2	3	80	0.0375000
NODE_367_length_3882_cov_4.166006	3297	3377	4	28	80	0.3500000
NODE_367_length_3882_cov_4.166006	3297	3377	6	20	80	0.2500000
NODE_367_length_3882_cov_4.166006	3297	3377	10	29	80	0.3625000
NODE_367_length_3882_cov_4.166006	3373	3450	2	45	77	0.5844156
NODE_367_length_3882_cov_4.166006	3373	3450	4	32	77	0.4155844
NODE_374_length_3853_cov_18.816196	524	579	6	52	55	0.9454545
NODE_374_length_3853_cov_18.816196	524	579	8	3	55	0.0545455
NODE_374_length_3853_cov_18.816196	559	639	0	46	80	0.5750000
NODE_374_length_3853_cov_18.816196	559	639	6	34	80	0.4250000
NODE_379_length_3829_cov_12.697319	515	595	0	33	80	0.4125000
NODE_379_length_3829_cov_12.697319	515	595	2	47	80	0.5875000
NODE_379_length_3829_cov_12.697319	568	648	0	80	80	1.0000000
NODE_379_length_3829_cov_12.697319	644	724	0	80	80	1.0000000
NODE_379_length_3829_cov_12.697319	697	777	0	80	80	1.0000000
NODE_381_length_3815_cov_17.218784	399	479	2	7	80	0.0875000
NODE_381_length_3815_cov_17.218784	399	479	4	1	80	0.0125000
NODE_381_length_3815_cov_17.218784	399	479	6	72	80	0.9000000
NODE_381_length_3815_cov_17.218784	452	532	0	23	80	0.2875000
NODE_381_length_3815_cov_17.218784	452	532	2	37	80	0.4625000
NODE_381_length_3815_cov_17.218784	452	532	4	1	80	0.0125000
NODE_381_length_3815_cov_17.218784	452	532	6	19	80	0.2375000
NODE_383_length_3812_cov_65.007272	840	903	9	1	63	0.0158730
NODE_383_length_3812_cov_65.007272	840	903	14	1	63	0.0158730
NODE_383_length_3812_cov_65.007272	840	903	17	1	63	0.0158730
NODE_383_length_3812_cov_65.007272	840	903	20	1	63	0.0158730
NODE_383_length_3812_cov_65.007272	840	903	22	1	63	0.0158730
NODE_383_length_3812_cov_65.007272	840	903	48	2	63	0.0317460
NODE_383_length_3812_cov_65.007272	840	903	54	2	63	0.0317460
NODE_383_length_3812_cov_65.007272	840	903	58	1	63	0.0158730
NODE_383_length_3812_cov_65.007272	840	903	59	1	63	0.0158730
NODE_383_length_3812_cov_65.007272	840	903	60	2	63	0.0317460
NODE_383_length_3812_cov_65.007272	840	903	62	1	63	0.0158730
NODE_383_length_3812_cov_65.007272	840	903	68	1	63	0.0158730
NODE_383_length_3812_cov_65.007272	840	903	77	1	63	0.0158730
NODE_383_length_3812_cov_65.007272	840	903	79	1	63	0.0158730
NODE_383_length_3812_cov_65.007272	840	903	81	3	63	0.0476190
NODE_383_length_3812_cov_65.007272	840	903	85	1	63	0.0158730
NODE_383_length_3812_cov_65.007272	840	903	93	1	63	0.0158730
NODE_383_length_3812_cov_65.007272	840	903	95	1	63	0.0158730
NODE_383_length_3812_cov_65.007272	840	903	102	1	63	0.0158730
NODE_383_length_3812_cov_65.007272	840	903	104	1	63	0.0158730
NODE_383_length_3812_cov_65.007272	840	903	115	1	63	0.0158730
NODE_383_length_3812_cov_65.007272	840	903	118	1	63	0.0158730
NODE_383_length_3812_cov_65.007272	840	903	125	1	63	0.0158730
NODE_383_length_3812_cov_65.007272	840	903	128	1	63	0.0158730
NODE_383_length_3812_cov_65.007272	840	903	132	1	63	0.0158730
NODE_383_length_3812_cov_65.007272	840	903	135	1	63	0.0158730
NODE_383_length_3812_cov_65.007272	840	903	138	1	63	0.0158730
NODE_383_length_3812_cov_65.007272	840	903	144	1	63	0.0158730
NODE_383_length_3812_cov_65.007272	840	903	147	1	63	0.0158730
NODE_383_length_3812_cov_65.007272	840	903	150	1	63	0.0158730
NODE_383_length_3812_cov_65.007272	840	903	157	1	63	0.0158730
NODE_383_length_3812_cov_65.007272	840	903	164	1	63	0.0158730
NODE_383_length_3812_cov_65.007272	840	903	168	1	63	0.0158730
NODE_383_length_3812_cov_65.007272	840	903	170	1	63	0.0158730
NODE_383_length_3812_cov_65.007272	840	903	176	1	63	0.0158730
NODE_383_length_3812_cov_65.007272	840	903	182	1	63	0.0158730
NODE_383_length_3812_cov_65.007272	840	903	191	1	63	0.0158730
NODE_383_length_3812_cov_65.007272	840	903	192	1	63	0.0158730
NODE_383_length_3812_cov_65.007272	840	903	195	3	63	0.0476190
NODE_383_length_3812_cov_65.007272	840	903	202	2	63	0.0317460
NODE_383_length_3812_cov_65.007272	840	903	205	1	63	0.0158730
NODE_383_length_3812_cov_65.007272	840	903	211	1	63	0.0158730
NODE_383_length_3812_cov_65.007272	840	903	212	1	63	0.0158730
NODE_383_length_3812_cov_65.007272	840	903	216	1	63	0.0158730
NODE_383_length_3812_cov_65.007272	840	903	217	1	63	0.0158730
NODE_383_length_3812_cov_65.007272	840	903	228	1	63	0.0158730
NODE_383_length_3812_cov_65.007272	840	903	230	1	63	0.0158730
NODE_383_length_3812_cov_65.007272	840	903	237	1	63	0.0158730
NODE_383_length_3812_cov_65.007272	840	903	238	1	63	0.0158730
NODE_383_length_3812_cov_65.007272	840	903	241	1	63	0.0158730
NODE_383_length_3812_cov_65.007272	840	903	242	1	63	0.0158730
NODE_383_length_3812_cov_65.007272	840	903	243	1	63	0.0158730
NODE_383_length_3812_cov_65.007272	840	903	246	1	63	0.0158730
NODE_383_length_3812_cov_65.007272	840	903	250	1	63	0.0158730
NODE_383_length_3812_cov_65.007272	840	903	255	1	63	0.0158730
NODE_384_length_3805_cov_9.533189	145	236	0	91	91	1.0000000
NODE_384_length_3805_cov_9.533189	209	279	0	70	70	1.0000000
NODE_386_length_3799_cov_10.046486	2944	3024	0	10	80	0.1250000
NODE_386_length_3799_cov_10.046486	2944	3024	2	27	80	0.3375000
NODE_386_length_3799_cov_10.046486	2944	3024	4	6	80	0.0750000
NODE_386_length_3799_cov_10.046486	2944	3024	5	23	80	0.2875000
NODE_386_length_3799_cov_10.046486	2944	3024	6	2	80	0.0250000
NODE_386_length_3799_cov_10.046486	2944	3024	8	8	80	0.1000000
NODE_386_length_3799_cov_10.046486	2944	3024	12	1	80	0.0125000
NODE_386_length_3799_cov_10.046486	2944	3024	14	3	80	0.0375000
NODE_386_length_3799_cov_10.046486	2997	3077	0	4	80	0.0500000
NODE_386_length_3799_cov_10.046486	2997	3077	2	76	80	0.9500000
NODE_388_length_3795_cov_13.724297	3350	3430	0	80	80	1.0000000
NODE_388_length_3795_cov_13.724297	3403	3483	0	45	80	0.5625000
NODE_388_length_3795_cov_13.724297	3403	3483	2	35	80	0.4375000
NODE_388_length_3795_cov_13.724297	3479	3562	2	24	83	0.2891566
NODE_388_length_3795_cov_13.724297	3479	3562	4	42	83	0.5060241
NODE_388_length_3795_cov_13.724297	3479	3562	8	4	83	0.0481928
NODE_388_length_3795_cov_13.724297	3479	3562	11	13	83	0.1566265
NODE_388_length_3795_cov_13.724297	3479	3562	2	24	83	0.2891566
NODE_388_length_3795_cov_13.724297	3479	3562	4	42	83	0.5060241
NODE_388_length_3795_cov_13.724297	3479	3562	8	4	83	0.0481928
NODE_388_length_3795_cov_13.724297	3479	3562	11	13	83	0.1566265
NODE_388_length_3795_cov_13.724297	3479	3552	2	24	73	0.3287671
NODE_388_length_3795_cov_13.724297	3479	3552	4	42	73	0.5753425
NODE_388_length_3795_cov_13.724297	3479	3552	8	4	73	0.0547945
NODE_388_length_3795_cov_13.724297	3479	3552	11	3	73	0.0410959
NODE_388_length_3795_cov_13.724297	3535	3586	2	5	51	0.0980392
NODE_388_length_3795_cov_13.724297	3535	3586	4	5	51	0.0980392
NODE_388_length_3795_cov_13.724297	3535	3586	8	4	51	0.0784314
NODE_388_length_3795_cov_13.724297	3535	3586	11	20	51	0.3921569
NODE_388_length_3795_cov_13.724297	3535	3586	13	13	51	0.2549020
NODE_388_length_3795_cov_13.724297	3535	3586	15	4	51	0.0784314
NODE_388_length_3795_cov_13.724297	3535	3584	2	5	49	0.1020408
NODE_388_length_3795_cov_13.724297	3535	3584	4	5	49	0.1020408
NODE_388_length_3795_cov_13.724297	3535	3584	8	4	49	0.0816327
NODE_388_length_3795_cov_13.724297	3535	3584	11	20	49	0.4081633
NODE_388_length_3795_cov_13.724297	3535	3584	13	11	49	0.2244898
NODE_388_length_3795_cov_13.724297	3535	3584	15	4	49	0.0816327
NODE_388_length_3795_cov_13.724297	3698	3721	135	8	23	0.3478261
NODE_388_length_3795_cov_13.724297	3698	3721	137	15	23	0.6521739
NODE_394_length_3774_cov_7.720544	538	595	0	1	57	0.0175439
NODE_394_length_3774_cov_7.720544	538	595	2	29	57	0.5087720
NODE_394_length_3774_cov_7.720544	538	595	4	25	57	0.4385965
NODE_394_length_3774_cov_7.720544	538	595	6	2	57	0.0350877
NODE_404_length_3747_cov_3.328947	2230	2292	6	32	62	0.5161290
NODE_404_length_3747_cov_3.328947	2230	2292	8	30	62	0.4838710
NODE_406_length_3743_cov_38.767014	1354	1434	10	11	80	0.1375000
NODE_406_length_3743_cov_38.767014	1354	1434	14	3	80	0.0375000
NODE_406_length_3743_cov_38.767014	1354	1434	16	7	80	0.0875000
NODE_406_length_3743_cov_38.767014	1354	1434	19	2	80	0.0250000
NODE_406_length_3743_cov_38.767014	1354	1434	22	4	80	0.0500000
NODE_406_length_3743_cov_38.767014	1354	1434	23	9	80	0.1125000
NODE_406_length_3743_cov_38.767014	1354	1434	24	3	80	0.0375000
NODE_406_length_3743_cov_38.767014	1354	1434	25	1	80	0.0125000
NODE_406_length_3743_cov_38.767014	1354	1434	27	12	80	0.1500000
NODE_406_length_3743_cov_38.767014	1354	1434	28	6	80	0.0750000
NODE_406_length_3743_cov_38.767014	1354	1434	30	8	80	0.1000000
NODE_406_length_3743_cov_38.767014	1354	1434	32	14	80	0.1750000
NODE_406_length_3743_cov_38.767014	1407	1487	19	24	80	0.3000000
NODE_406_length_3743_cov_38.767014	1407	1487	23	1	80	0.0125000
NODE_406_length_3743_cov_38.767014	1407	1487	24	1	80	0.0125000
NODE_406_length_3743_cov_38.767014	1407	1487	26	10	80	0.1250000
NODE_406_length_3743_cov_38.767014	1407	1487	28	7	80	0.0875000
NODE_406_length_3743_cov_38.767014	1407	1487	30	8	80	0.1000000
NODE_406_length_3743_cov_38.767014	1407	1487	31	1	80	0.0125000
NODE_406_length_3743_cov_38.767014	1407	1487	32	28	80	0.3500000
NODE_408_length_3733_cov_16.204458	186	249	0	52	63	0.8253968
NODE_408_length_3733_cov_16.204458	186	249	2	4	63	0.0634921
NODE_408_length_3733_cov_16.204458	186	249	3	1	63	0.0158730
NODE_408_length_3733_cov_16.204458	186	249	4	1	63	0.0158730
NODE_408_length_3733_cov_16.204458	186	249	30	4	63	0.0634921
NODE_408_length_3733_cov_16.204458	186	249	32	1	63	0.0158730
NODE_413_length_3707_cov_56.575665	2387	2467	0	80	80	1.0000000
NODE_413_length_3707_cov_56.575665	2440	2520	0	80	80	1.0000000
NODE_413_length_3707_cov_56.575665	2516	2596	0	9	80	0.1125000
NODE_413_length_3707_cov_56.575665	2516	2596	2	29	80	0.3625000
NODE_413_length_3707_cov_56.575665	2516	2596	8	12	80	0.1500000
NODE_413_length_3707_cov_56.575665	2516	2596	19	17	80	0.2125000
NODE_413_length_3707_cov_56.575665	2516	2596	26	1	80	0.0125000
NODE_413_length_3707_cov_56.575665	2516	2596	28	12	80	0.1500000
NODE_413_length_3707_cov_56.575665	2569	2649	19	14	80	0.1750000
NODE_413_length_3707_cov_56.575665	2569	2649	21	1	80	0.0125000
NODE_413_length_3707_cov_56.575665	2569	2649	22	4	80	0.0500000
NODE_413_length_3707_cov_56.575665	2569	2649	26	8	80	0.1000000
NODE_413_length_3707_cov_56.575665	2569	2649	27	41	80	0.5125000
NODE_413_length_3707_cov_56.575665	2569	2649	28	12	80	0.1500000
NODE_416_length_3690_cov_7.476190	723	792	6	69	69	1.0000000
NODE_416_length_3690_cov_7.476190	776	855	0	18	79	0.2278481
NODE_416_length_3690_cov_7.476190	776	855	2	11	79	0.1392405
NODE_416_length_3690_cov_7.476190	776	855	6	50	79	0.6329114
NODE_419_length_3685_cov_7.011154	1966	2046	148	2	80	0.0250000
NODE_419_length_3685_cov_7.011154	1966	2046	149	1	80	0.0125000
NODE_419_length_3685_cov_7.011154	1966	2046	150	1	80	0.0125000
NODE_419_length_3685_cov_7.011154	1966	2046	151	1	80	0.0125000
NODE_419_length_3685_cov_7.011154	1966	2046	155	3	80	0.0375000
NODE_419_length_3685_cov_7.011154	1966	2046	162	1	80	0.0125000
NODE_419_length_3685_cov_7.011154	1966	2046	172	1	80	0.0125000
NODE_419_length_3685_cov_7.011154	1966	2046	178	1	80	0.0125000
NODE_419_length_3685_cov_7.011154	1966	2046	182	1	80	0.0125000
NODE_419_length_3685_cov_7.011154	1966	2046	188	2	80	0.0250000
NODE_419_length_3685_cov_7.011154	1966	2046	192	1	80	0.0125000
NODE_419_length_3685_cov_7.011154	1966	2046	198	2	80	0.0250000
NODE_419_length_3685_cov_7.011154	1966	2046	199	1	80	0.0125000
NODE_419_length_3685_cov_7.011154	1966	2046	200	2	80	0.0250000
NODE_419_length_3685_cov_7.011154	1966	2046	201	6	80	0.0750000
NODE_419_length_3685_cov_7.011154	1966	2046	203	3	80	0.0375000
NODE_419_length_3685_cov_7.011154	1966	2046	205	2	80	0.0250000
NODE_419_length_3685_cov_7.011154	1966	2046	208	1	80	0.0125000
NODE_419_length_3685_cov_7.011154	1966	2046	210	1	80	0.0125000
NODE_419_length_3685_cov_7.011154	1966	2046	212	1	80	0.0125000
NODE_419_length_3685_cov_7.011154	1966	2046	214	3	80	0.0375000
NODE_419_length_3685_cov_7.011154	1966	2046	215	1	80	0.0125000
NODE_419_length_3685_cov_7.011154	1966	2046	218	7	80	0.0875000
NODE_419_length_3685_cov_7.011154	1966	2046	219	2	80	0.0250000
NODE_419_length_3685_cov_7.011154	1966	2046	220	1	80	0.0125000
NODE_419_length_3685_cov_7.011154	1966	2046	221	2	80	0.0250000
NODE_419_length_3685_cov_7.011154	1966	2046	225	3	80	0.0375000
NODE_419_length_3685_cov_7.011154	1966	2046	226	2	80	0.0250000
NODE_419_length_3685_cov_7.011154	1966	2046	227	2	80	0.0250000
NODE_419_length_3685_cov_7.011154	1966	2046	228	3	80	0.0375000
NODE_419_length_3685_cov_7.011154	1966	2046	229	3	80	0.0375000
NODE_419_length_3685_cov_7.011154	1966	2046	230	5	80	0.0625000
NODE_419_length_3685_cov_7.011154	1966	2046	231	3	80	0.0375000
NODE_419_length_3685_cov_7.011154	1966	2046	232	2	80	0.0250000
NODE_419_length_3685_cov_7.011154	1966	2046	233	2	80	0.0250000
NODE_419_length_3685_cov_7.011154	1966	2046	234	5	80	0.0625000
NODE_419_length_3685_cov_7.011154	2019	2086	145	1	67	0.0149254
NODE_419_length_3685_cov_7.011154	2019	2086	148	1	67	0.0149254
NODE_419_length_3685_cov_7.011154	2019	2086	149	4	67	0.0597015
NODE_419_length_3685_cov_7.011154	2019	2086	153	2	67	0.0298507
NODE_419_length_3685_cov_7.011154	2019	2086	159	1	67	0.0149254
NODE_419_length_3685_cov_7.011154	2019	2086	167	1	67	0.0149254
NODE_419_length_3685_cov_7.011154	2019	2086	170	1	67	0.0149254
NODE_419_length_3685_cov_7.011154	2019	2086	174	1	67	0.0149254
NODE_419_length_3685_cov_7.011154	2019	2086	183	1	67	0.0149254
NODE_419_length_3685_cov_7.011154	2019	2086	184	1	67	0.0149254
NODE_419_length_3685_cov_7.011154	2019	2086	185	1	67	0.0149254
NODE_419_length_3685_cov_7.011154	2019	2086	188	2	67	0.0298507
NODE_419_length_3685_cov_7.011154	2019	2086	190	1	67	0.0149254
NODE_419_length_3685_cov_7.011154	2019	2086	194	1	67	0.0149254
NODE_419_length_3685_cov_7.011154	2019	2086	196	2	67	0.0298507
NODE_419_length_3685_cov_7.011154	2019	2086	200	1	67	0.0149254
NODE_419_length_3685_cov_7.011154	2019	2086	202	2	67	0.0298507
NODE_419_length_3685_cov_7.011154	2019	2086	206	4	67	0.0597015
NODE_419_length_3685_cov_7.011154	2019	2086	208	4	67	0.0597015
NODE_419_length_3685_cov_7.011154	2019	2086	209	2	67	0.0298507
NODE_419_length_3685_cov_7.011154	2019	2086	212	1	67	0.0149254
NODE_419_length_3685_cov_7.011154	2019	2086	214	2	67	0.0298507
NODE_419_length_3685_cov_7.011154	2019	2086	216	3	67	0.0447761
NODE_419_length_3685_cov_7.011154	2019	2086	218	2	67	0.0298507
NODE_419_length_3685_cov_7.011154	2019	2086	219	1	67	0.0149254
NODE_419_length_3685_cov_7.011154	2019	2086	226	2	67	0.0298507
NODE_419_length_3685_cov_7.011154	2019	2086	228	3	67	0.0447761
NODE_419_length_3685_cov_7.011154	2019	2086	229	2	67	0.0298507
NODE_419_length_3685_cov_7.011154	2019	2086	230	5	67	0.0746269
NODE_419_length_3685_cov_7.011154	2019	2086	231	3	67	0.0447761
NODE_419_length_3685_cov_7.011154	2019	2086	232	2	67	0.0298507
NODE_419_length_3685_cov_7.011154	2019	2086	233	2	67	0.0298507
NODE_419_length_3685_cov_7.011154	2019	2086	234	5	67	0.0746269
NODE_426_length_3667_cov_1089.047365	1634	1705	10	2	71	0.0281690
NODE_426_length_3667_cov_1089.047365	1634	1705	14	23	71	0.3239437
NODE_426_length_3667_cov_1089.047365	1634	1705	16	3	71	0.0422535
NODE_426_length_3667_cov_1089.047365	1634	1705	18	13	71	0.1830986
NODE_426_length_3667_cov_1089.047365	1634	1705	21	1	71	0.0140845
NODE_426_length_3667_cov_1089.047365	1634	1705	22	11	71	0.1549296
NODE_426_length_3667_cov_1089.047365	1634	1705	24	1	71	0.0140845
NODE_426_length_3667_cov_1089.047365	1634	1705	26	17	71	0.2394366
NODE_426_length_3667_cov_1089.047365	1678	1758	10	7	80	0.0875000
NODE_426_length_3667_cov_1089.047365	1678	1758	11	3	80	0.0375000
NODE_426_length_3667_cov_1089.047365	1678	1758	13	1	80	0.0125000
NODE_426_length_3667_cov_1089.047365	1678	1758	15	2	80	0.0250000
NODE_426_length_3667_cov_1089.047365	1678	1758	17	1	80	0.0125000
NODE_426_length_3667_cov_1089.047365	1678	1758	18	15	80	0.1875000
NODE_426_length_3667_cov_1089.047365	1678	1758	20	2	80	0.0250000
NODE_426_length_3667_cov_1089.047365	1678	1758	22	13	80	0.1625000
NODE_426_length_3667_cov_1089.047365	1678	1758	24	7	80	0.0875000
NODE_426_length_3667_cov_1089.047365	1678	1758	26	29	80	0.3625000
NODE_428_length_3660_cov_79.447627	1806	1870	153	2	64	0.0312500
NODE_428_length_3660_cov_79.447627	1806	1870	155	1	64	0.0156250
NODE_428_length_3660_cov_79.447627	1806	1870	160	1	64	0.0156250
NODE_428_length_3660_cov_79.447627	1806	1870	164	1	64	0.0156250
NODE_428_length_3660_cov_79.447627	1806	1870	170	5	64	0.0781250
NODE_428_length_3660_cov_79.447627	1806	1870	181	1	64	0.0156250
NODE_428_length_3660_cov_79.447627	1806	1870	182	1	64	0.0156250
NODE_428_length_3660_cov_79.447627	1806	1870	190	3	64	0.0468750
NODE_428_length_3660_cov_79.447627	1806	1870	192	1	64	0.0156250
NODE_428_length_3660_cov_79.447627	1806	1870	194	1	64	0.0156250
NODE_428_length_3660_cov_79.447627	1806	1870	196	1	64	0.0156250
NODE_428_length_3660_cov_79.447627	1806	1870	208	3	64	0.0468750
NODE_428_length_3660_cov_79.447627	1806	1870	213	2	64	0.0312500
NODE_428_length_3660_cov_79.447627	1806	1870	219	1	64	0.0156250
NODE_428_length_3660_cov_79.447627	1806	1870	229	2	64	0.0312500
NODE_428_length_3660_cov_79.447627	1806	1870	230	2	64	0.0312500
NODE_428_length_3660_cov_79.447627	1806	1870	235	1	64	0.0156250
NODE_428_length_3660_cov_79.447627	1806	1870	240	1	64	0.0156250
NODE_428_length_3660_cov_79.447627	1806	1870	244	1	64	0.0156250
NODE_428_length_3660_cov_79.447627	1806	1870	247	1	64	0.0156250
NODE_428_length_3660_cov_79.447627	1806	1870	250	1	64	0.0156250
NODE_428_length_3660_cov_79.447627	1806	1870	256	2	64	0.0312500
NODE_428_length_3660_cov_79.447627	1806	1870	260	4	64	0.0625000
NODE_428_length_3660_cov_79.447627	1806	1870	261	1	64	0.0156250
NODE_428_length_3660_cov_79.447627	1806	1870	265	4	64	0.0625000
NODE_428_length_3660_cov_79.447627	1806	1870	266	1	64	0.0156250
NODE_428_length_3660_cov_79.447627	1806	1870	267	2	64	0.0312500
NODE_428_length_3660_cov_79.447627	1806	1870	269	2	64	0.0312500
NODE_428_length_3660_cov_79.447627	1806	1870	271	4	64	0.0625000
NODE_428_length_3660_cov_79.447627	1806	1870	280	3	64	0.0468750
NODE_428_length_3660_cov_79.447627	1806	1870	288	1	64	0.0156250
NODE_428_length_3660_cov_79.447627	1806	1870	290	1	64	0.0156250
NODE_428_length_3660_cov_79.447627	1806	1870	292	1	64	0.0156250
NODE_428_length_3660_cov_79.447627	1806	1870	294	1	64	0.0156250
NODE_428_length_3660_cov_79.447627	1806	1870	295	2	64	0.0312500
NODE_428_length_3660_cov_79.447627	1806	1870	296	1	64	0.0156250
NODE_428_length_3660_cov_79.447627	1806	1870	297	1	64	0.0156250
NODE_428_length_3660_cov_79.447627	1859	1906	280	3	47	0.0638298
NODE_428_length_3660_cov_79.447627	1859	1906	288	1	47	0.0212766
NODE_428_length_3660_cov_79.447627	1859	1906	290	1	47	0.0212766
NODE_428_length_3660_cov_79.447627	1859	1906	292	1	47	0.0212766
NODE_428_length_3660_cov_79.447627	1859	1906	294	1	47	0.0212766
NODE_428_length_3660_cov_79.447627	1859	1906	295	2	47	0.0425532
NODE_428_length_3660_cov_79.447627	1859	1906	296	1	47	0.0212766
NODE_428_length_3660_cov_79.447627	1859	1906	297	1	47	0.0212766
NODE_428_length_3660_cov_79.447627	1859	1906	301	1	47	0.0212766
NODE_428_length_3660_cov_79.447627	1859	1906	302	1	47	0.0212766
NODE_428_length_3660_cov_79.447627	1859	1906	309	1	47	0.0212766
NODE_428_length_3660_cov_79.447627	1859	1906	311	1	47	0.0212766
NODE_428_length_3660_cov_79.447627	1859	1906	317	1	47	0.0212766
NODE_428_length_3660_cov_79.447627	1859	1906	318	1	47	0.0212766
NODE_428_length_3660_cov_79.447627	1859	1906	319	1	47	0.0212766
NODE_428_length_3660_cov_79.447627	1859	1906	320	3	47	0.0638298
NODE_428_length_3660_cov_79.447627	1859	1906	323	1	47	0.0212766
NODE_428_length_3660_cov_79.447627	1859	1906	326	1	47	0.0212766
NODE_428_length_3660_cov_79.447627	1859	1906	332	2	47	0.0425532
NODE_428_length_3660_cov_79.447627	1859	1906	337	1	47	0.0212766
NODE_428_length_3660_cov_79.447627	1859	1906	338	1	47	0.0212766
NODE_428_length_3660_cov_79.447627	1859	1906	339	1	47	0.0212766
NODE_428_length_3660_cov_79.447627	1859	1906	343	1	47	0.0212766
NODE_428_length_3660_cov_79.447627	1859	1906	344	1	47	0.0212766
NODE_428_length_3660_cov_79.447627	1859	1906	350	1	47	0.0212766
NODE_428_length_3660_cov_79.447627	1859	1906	351	1	47	0.0212766
NODE_428_length_3660_cov_79.447627	1859	1906	353	1	47	0.0212766
NODE_428_length_3660_cov_79.447627	1859	1906	354	1	47	0.0212766
NODE_428_length_3660_cov_79.447627	1859	1906	355	5	47	0.1063830
NODE_428_length_3660_cov_79.447627	1859	1906	356	3	47	0.0638298
NODE_428_length_3660_cov_79.447627	1859	1906	357	5	47	0.1063830
NODE_428_length_3660_cov_79.447627	2358	2438	0	80	80	1.0000000
NODE_428_length_3660_cov_79.447627	2411	2491	0	80	80	1.0000000
NODE_428_length_3660_cov_79.447627	2487	2567	0	80	80	1.0000000
NODE_428_length_3660_cov_79.447627	2540	2620	0	80	80	1.0000000
NODE_430_length_3634_cov_34.913154	1499	1544	216	1	45	0.0222222
NODE_430_length_3634_cov_34.913154	1499	1544	225	1	45	0.0222222
NODE_430_length_3634_cov_34.913154	1499	1544	242	1	45	0.0222222
NODE_430_length_3634_cov_34.913154	1499	1544	283	1	45	0.0222222
NODE_430_length_3634_cov_34.913154	1499	1544	287	1	45	0.0222222
NODE_430_length_3634_cov_34.913154	1499	1544	297	1	45	0.0222222
NODE_430_length_3634_cov_34.913154	1499	1544	308	1	45	0.0222222
NODE_430_length_3634_cov_34.913154	1499	1544	315	1	45	0.0222222
NODE_430_length_3634_cov_34.913154	1499	1544	327	1	45	0.0222222
NODE_430_length_3634_cov_34.913154	1499	1544	329	1	45	0.0222222
NODE_430_length_3634_cov_34.913154	1499	1544	340	1	45	0.0222222
NODE_430_length_3634_cov_34.913154	1499	1544	343	1	45	0.0222222
NODE_430_length_3634_cov_34.913154	1499	1544	357	1	45	0.0222222
NODE_430_length_3634_cov_34.913154	1499	1544	370	1	45	0.0222222
NODE_430_length_3634_cov_34.913154	1499	1544	384	1	45	0.0222222
NODE_430_length_3634_cov_34.913154	1499	1544	391	1	45	0.0222222
NODE_430_length_3634_cov_34.913154	1499	1544	404	1	45	0.0222222
NODE_430_length_3634_cov_34.913154	1499	1544	407	1	45	0.0222222
NODE_430_length_3634_cov_34.913154	1499	1544	413	1	45	0.0222222
NODE_430_length_3634_cov_34.913154	1499	1544	440	1	45	0.0222222
NODE_430_length_3634_cov_34.913154	1499	1544	450	1	45	0.0222222
NODE_430_length_3634_cov_34.913154	1499	1544	458	1	45	0.0222222
NODE_430_length_3634_cov_34.913154	1499	1544	474	1	45	0.0222222
NODE_430_length_3634_cov_34.913154	1499	1544	484	1	45	0.0222222
NODE_430_length_3634_cov_34.913154	1499	1544	487	1	45	0.0222222
NODE_430_length_3634_cov_34.913154	1499	1544	514	1	45	0.0222222
NODE_430_length_3634_cov_34.913154	1499	1544	530	1	45	0.0222222
NODE_430_length_3634_cov_34.913154	1499	1544	567	1	45	0.0222222
NODE_430_length_3634_cov_34.913154	1499	1544	572	1	45	0.0222222
NODE_430_length_3634_cov_34.913154	1499	1544	577	1	45	0.0222222
NODE_430_length_3634_cov_34.913154	1499	1544	580	1	45	0.0222222
NODE_430_length_3634_cov_34.913154	1499	1544	600	1	45	0.0222222
NODE_430_length_3634_cov_34.913154	1499	1544	605	1	45	0.0222222
NODE_430_length_3634_cov_34.913154	1499	1544	609	1	45	0.0222222
NODE_430_length_3634_cov_34.913154	1499	1544	615	1	45	0.0222222
NODE_430_length_3634_cov_34.913154	1499	1544	628	1	45	0.0222222
NODE_430_length_3634_cov_34.913154	1499	1544	645	1	45	0.0222222
NODE_430_length_3634_cov_34.913154	1499	1544	675	1	45	0.0222222
NODE_430_length_3634_cov_34.913154	1499	1544	679	1	45	0.0222222
NODE_430_length_3634_cov_34.913154	1499	1544	682	1	45	0.0222222
NODE_430_length_3634_cov_34.913154	1499	1544	688	1	45	0.0222222
NODE_430_length_3634_cov_34.913154	1499	1544	704	1	45	0.0222222
NODE_430_length_3634_cov_34.913154	1499	1544	717	1	45	0.0222222
NODE_430_length_3634_cov_34.913154	1499	1544	720	1	45	0.0222222
NODE_430_length_3634_cov_34.913154	1499	1544	733	1	45	0.0222222
NODE_430_length_3634_cov_34.913154	1517	1597	413	1	80	0.0125000
NODE_430_length_3634_cov_34.913154	1517	1597	440	1	80	0.0125000
NODE_430_length_3634_cov_34.913154	1517	1597	450	1	80	0.0125000
NODE_430_length_3634_cov_34.913154	1517	1597	458	1	80	0.0125000
NODE_430_length_3634_cov_34.913154	1517	1597	474	1	80	0.0125000
NODE_430_length_3634_cov_34.913154	1517	1597	484	1	80	0.0125000
NODE_430_length_3634_cov_34.913154	1517	1597	487	1	80	0.0125000
NODE_430_length_3634_cov_34.913154	1517	1597	514	1	80	0.0125000
NODE_430_length_3634_cov_34.913154	1517	1597	530	1	80	0.0125000
NODE_430_length_3634_cov_34.913154	1517	1597	567	1	80	0.0125000
NODE_430_length_3634_cov_34.913154	1517	1597	572	1	80	0.0125000
NODE_430_length_3634_cov_34.913154	1517	1597	577	1	80	0.0125000
NODE_430_length_3634_cov_34.913154	1517	1597	580	1	80	0.0125000
NODE_430_length_3634_cov_34.913154	1517	1597	600	1	80	0.0125000
NODE_430_length_3634_cov_34.913154	1517	1597	605	1	80	0.0125000
NODE_430_length_3634_cov_34.913154	1517	1597	609	1	80	0.0125000
NODE_430_length_3634_cov_34.913154	1517	1597	615	1	80	0.0125000
NODE_430_length_3634_cov_34.913154	1517	1597	628	1	80	0.0125000
NODE_430_length_3634_cov_34.913154	1517	1597	645	1	80	0.0125000
NODE_430_length_3634_cov_34.913154	1517	1597	675	1	80	0.0125000
NODE_430_length_3634_cov_34.913154	1517	1597	679	1	80	0.0125000
NODE_430_length_3634_cov_34.913154	1517	1597	682	1	80	0.0125000
NODE_430_length_3634_cov_34.913154	1517	1597	688	1	80	0.0125000
NODE_430_length_3634_cov_34.913154	1517	1597	704	1	80	0.0125000
NODE_430_length_3634_cov_34.913154	1517	1597	717	1	80	0.0125000
NODE_430_length_3634_cov_34.913154	1517	1597	720	1	80	0.0125000
NODE_430_length_3634_cov_34.913154	1517	1597	733	1	80	0.0125000
NODE_430_length_3634_cov_34.913154	1517	1597	736	1	80	0.0125000
NODE_430_length_3634_cov_34.913154	1517	1597	743	1	80	0.0125000
NODE_430_length_3634_cov_34.913154	1517	1597	745	1	80	0.0125000
NODE_430_length_3634_cov_34.913154	1517	1597	755	1	80	0.0125000
NODE_430_length_3634_cov_34.913154	1517	1597	765	1	80	0.0125000
NODE_430_length_3634_cov_34.913154	1517	1597	775	1	80	0.0125000
NODE_430_length_3634_cov_34.913154	1517	1597	780	1	80	0.0125000
NODE_430_length_3634_cov_34.913154	1517	1597	796	1	80	0.0125000
NODE_430_length_3634_cov_34.913154	1517	1597	813	1	80	0.0125000
NODE_430_length_3634_cov_34.913154	1517	1597	827	1	80	0.0125000
NODE_430_length_3634_cov_34.913154	1517	1597	841	1	80	0.0125000
NODE_430_length_3634_cov_34.913154	1517	1597	849	1	80	0.0125000
NODE_430_length_3634_cov_34.913154	1517	1597	857	1	80	0.0125000
NODE_430_length_3634_cov_34.913154	1517	1597	874	1	80	0.0125000
NODE_430_length_3634_cov_34.913154	1517	1597	881	1	80	0.0125000
NODE_430_length_3634_cov_34.913154	1517	1597	886	2	80	0.0250000
NODE_430_length_3634_cov_34.913154	1517	1597	891	1	80	0.0125000
NODE_430_length_3634_cov_34.913154	1517	1597	892	1	80	0.0125000
NODE_430_length_3634_cov_34.913154	1517	1597	895	1	80	0.0125000
NODE_430_length_3634_cov_34.913154	1517	1597	898	1	80	0.0125000
NODE_430_length_3634_cov_34.913154	1517	1597	902	1	80	0.0125000
NODE_430_length_3634_cov_34.913154	1517	1597	921	1	80	0.0125000
NODE_430_length_3634_cov_34.913154	1517	1597	930	1	80	0.0125000
NODE_430_length_3634_cov_34.913154	1517	1597	937	1	80	0.0125000
NODE_430_length_3634_cov_34.913154	1517	1597	946	1	80	0.0125000
NODE_430_length_3634_cov_34.913154	1517	1597	965	1	80	0.0125000
NODE_430_length_3634_cov_34.913154	1517	1597	967	1	80	0.0125000
NODE_430_length_3634_cov_34.913154	1517	1597	986	1	80	0.0125000
NODE_430_length_3634_cov_34.913154	1517	1597	995	1	80	0.0125000
NODE_430_length_3634_cov_34.913154	1517	1597	1003	1	80	0.0125000
NODE_430_length_3634_cov_34.913154	1517	1597	1021	1	80	0.0125000
NODE_430_length_3634_cov_34.913154	1517	1597	1028	1	80	0.0125000
NODE_430_length_3634_cov_34.913154	1517	1597	1045	1	80	0.0125000
NODE_430_length_3634_cov_34.913154	1517	1597	1057	1	80	0.0125000
NODE_430_length_3634_cov_34.913154	1517	1597	1069	1	80	0.0125000
NODE_430_length_3634_cov_34.913154	1517	1597	1078	1	80	0.0125000
NODE_430_length_3634_cov_34.913154	1517	1597	1095	1	80	0.0125000
NODE_430_length_3634_cov_34.913154	1517	1597	1103	1	80	0.0125000
NODE_430_length_3634_cov_34.913154	1517	1597	1108	1	80	0.0125000
NODE_430_length_3634_cov_34.913154	1517	1597	1110	1	80	0.0125000
NODE_430_length_3634_cov_34.913154	1517	1597	1116	2	80	0.0250000
NODE_430_length_3634_cov_34.913154	1517	1597	1117	2	80	0.0250000
NODE_430_length_3634_cov_34.913154	1517	1597	1118	1	80	0.0125000
NODE_430_length_3634_cov_34.913154	1517	1597	1120	1	80	0.0125000
NODE_430_length_3634_cov_34.913154	1517	1597	1121	1	80	0.0125000
NODE_430_length_3634_cov_34.913154	1517	1597	1122	1	80	0.0125000
NODE_430_length_3634_cov_34.913154	1517	1597	1123	1	80	0.0125000
NODE_430_length_3634_cov_34.913154	1517	1597	1127	1	80	0.0125000
NODE_430_length_3634_cov_34.913154	1517	1597	1129	1	80	0.0125000
NODE_430_length_3634_cov_34.913154	1517	1597	1132	1	80	0.0125000
NODE_430_length_3634_cov_34.913154	1978	2058	305	1	80	0.0125000
NODE_430_length_3634_cov_34.913154	1978	2058	312	1	80	0.0125000
NODE_430_length_3634_cov_34.913154	1978	2058	323	1	80	0.0125000
NODE_430_length_3634_cov_34.913154	1978	2058	328	1	80	0.0125000
NODE_430_length_3634_cov_34.913154	1978	2058	340	1	80	0.0125000
NODE_430_length_3634_cov_34.913154	1978	2058	347	1	80	0.0125000
NODE_430_length_3634_cov_34.913154	1978	2058	355	1	80	0.0125000
NODE_430_length_3634_cov_34.913154	1978	2058	365	1	80	0.0125000
NODE_430_length_3634_cov_34.913154	1978	2058	366	1	80	0.0125000
NODE_430_length_3634_cov_34.913154	1978	2058	369	1	80	0.0125000
NODE_430_length_3634_cov_34.913154	1978	2058	380	1	80	0.0125000
NODE_430_length_3634_cov_34.913154	1978	2058	397	1	80	0.0125000
NODE_430_length_3634_cov_34.913154	1978	2058	407	1	80	0.0125000
NODE_430_length_3634_cov_34.913154	1978	2058	432	1	80	0.0125000
NODE_430_length_3634_cov_34.913154	1978	2058	438	1	80	0.0125000
NODE_430_length_3634_cov_34.913154	1978	2058	452	1	80	0.0125000
NODE_430_length_3634_cov_34.913154	1978	2058	456	1	80	0.0125000
NODE_430_length_3634_cov_34.913154	1978	2058	464	1	80	0.0125000
NODE_430_length_3634_cov_34.913154	1978	2058	471	1	80	0.0125000
NODE_430_length_3634_cov_34.913154	1978	2058	476	1	80	0.0125000
NODE_430_length_3634_cov_34.913154	1978	2058	492	1	80	0.0125000
NODE_430_length_3634_cov_34.913154	1978	2058	500	1	80	0.0125000
NODE_430_length_3634_cov_34.913154	1978	2058	504	1	80	0.0125000
NODE_430_length_3634_cov_34.913154	1978	2058	508	1	80	0.0125000
NODE_430_length_3634_cov_34.913154	1978	2058	511	1	80	0.0125000
NODE_430_length_3634_cov_34.913154	1978	2058	513	1	80	0.0125000
NODE_430_length_3634_cov_34.913154	1978	2058	517	1	80	0.0125000
NODE_430_length_3634_cov_34.913154	1978	2058	519	1	80	0.0125000
NODE_430_length_3634_cov_34.913154	1978	2058	522	1	80	0.0125000
NODE_430_length_3634_cov_34.913154	1978	2058	530	1	80	0.0125000
NODE_430_length_3634_cov_34.913154	1978	2058	532	1	80	0.0125000
NODE_430_length_3634_cov_34.913154	1978	2058	539	1	80	0.0125000
NODE_430_length_3634_cov_34.913154	1978	2058	547	1	80	0.0125000
NODE_430_length_3634_cov_34.913154	1978	2058	559	1	80	0.0125000
NODE_430_length_3634_cov_34.913154	1978	2058	563	1	80	0.0125000
NODE_430_length_3634_cov_34.913154	1978	2058	569	1	80	0.0125000
NODE_430_length_3634_cov_34.913154	1978	2058	572	1	80	0.0125000
NODE_430_length_3634_cov_34.913154	1978	2058	576	1	80	0.0125000
NODE_430_length_3634_cov_34.913154	1978	2058	600	1	80	0.0125000
NODE_430_length_3634_cov_34.913154	1978	2058	611	1	80	0.0125000
NODE_430_length_3634_cov_34.913154	1978	2058	613	1	80	0.0125000
NODE_430_length_3634_cov_34.913154	1978	2058	616	1	80	0.0125000
NODE_430_length_3634_cov_34.913154	1978	2058	624	1	80	0.0125000
NODE_430_length_3634_cov_34.913154	1978	2058	636	1	80	0.0125000
NODE_430_length_3634_cov_34.913154	1978	2058	645	1	80	0.0125000
NODE_430_length_3634_cov_34.913154	1978	2058	653	1	80	0.0125000
NODE_430_length_3634_cov_34.913154	1978	2058	657	1	80	0.0125000
NODE_430_length_3634_cov_34.913154	1978	2058	660	1	80	0.0125000
NODE_430_length_3634_cov_34.913154	1978	2058	662	1	80	0.0125000
NODE_430_length_3634_cov_34.913154	1978	2058	663	1	80	0.0125000
NODE_430_length_3634_cov_34.913154	1978	2058	671	1	80	0.0125000
NODE_430_length_3634_cov_34.913154	1978	2058	674	1	80	0.0125000
NODE_430_length_3634_cov_34.913154	1978	2058	682	1	80	0.0125000
NODE_430_length_3634_cov_34.913154	1978	2058	694	1	80	0.0125000
NODE_430_length_3634_cov_34.913154	1978	2058	697	1	80	0.0125000
NODE_430_length_3634_cov_34.913154	1978	2058	703	1	80	0.0125000
NODE_430_length_3634_cov_34.913154	1978	2058	712	1	80	0.0125000
NODE_430_length_3634_cov_34.913154	1978	2058	717	1	80	0.0125000
NODE_430_length_3634_cov_34.913154	1978	2058	723	1	80	0.0125000
NODE_430_length_3634_cov_34.913154	1978	2058	729	1	80	0.0125000
NODE_430_length_3634_cov_34.913154	1978	2058	739	1	80	0.0125000
NODE_430_length_3634_cov_34.913154	1978	2058	745	1	80	0.0125000
NODE_430_length_3634_cov_34.913154	1978	2058	751	1	80	0.0125000
NODE_430_length_3634_cov_34.913154	1978	2058	776	1	80	0.0125000
NODE_430_length_3634_cov_34.913154	1978	2058	784	1	80	0.0125000
NODE_430_length_3634_cov_34.913154	1978	2058	808	1	80	0.0125000
NODE_430_length_3634_cov_34.913154	1978	2058	819	1	80	0.0125000
NODE_430_length_3634_cov_34.913154	1978	2058	828	1	80	0.0125000
NODE_430_length_3634_cov_34.913154	1978	2058	829	1	80	0.0125000
NODE_430_length_3634_cov_34.913154	1978	2058	834	1	80	0.0125000
NODE_430_length_3634_cov_34.913154	1978	2058	846	1	80	0.0125000
NODE_430_length_3634_cov_34.913154	1978	2058	870	1	80	0.0125000
NODE_430_length_3634_cov_34.913154	1978	2058	878	1	80	0.0125000
NODE_430_length_3634_cov_34.913154	1978	2058	905	1	80	0.0125000
NODE_430_length_3634_cov_34.913154	1978	2058	914	1	80	0.0125000
NODE_430_length_3634_cov_34.913154	1978	2058	922	1	80	0.0125000
NODE_430_length_3634_cov_34.913154	1978	2058	942	1	80	0.0125000
NODE_430_length_3634_cov_34.913154	1978	2058	951	1	80	0.0125000
NODE_430_length_3634_cov_34.913154	1978	2058	961	1	80	0.0125000
NODE_430_length_3634_cov_34.913154	1978	2058	968	1	80	0.0125000
NODE_430_length_3634_cov_34.913154	2031	2077	97	1	46	0.0217391
NODE_430_length_3634_cov_34.913154	2031	2077	128	1	46	0.0217391
NODE_430_length_3634_cov_34.913154	2031	2077	136	1	46	0.0217391
NODE_430_length_3634_cov_34.913154	2031	2077	145	1	46	0.0217391
NODE_430_length_3634_cov_34.913154	2031	2077	148	1	46	0.0217391
NODE_430_length_3634_cov_34.913154	2031	2077	154	1	46	0.0217391
NODE_430_length_3634_cov_34.913154	2031	2077	163	1	46	0.0217391
NODE_430_length_3634_cov_34.913154	2031	2077	183	1	46	0.0217391
NODE_430_length_3634_cov_34.913154	2031	2077	203	1	46	0.0217391
NODE_430_length_3634_cov_34.913154	2031	2077	212	1	46	0.0217391
NODE_430_length_3634_cov_34.913154	2031	2077	221	1	46	0.0217391
NODE_430_length_3634_cov_34.913154	2031	2077	237	1	46	0.0217391
NODE_430_length_3634_cov_34.913154	2031	2077	249	1	46	0.0217391
NODE_430_length_3634_cov_34.913154	2031	2077	257	1	46	0.0217391
NODE_430_length_3634_cov_34.913154	2031	2077	269	1	46	0.0217391
NODE_430_length_3634_cov_34.913154	2031	2077	270	1	46	0.0217391
NODE_430_length_3634_cov_34.913154	2031	2077	271	1	46	0.0217391
NODE_430_length_3634_cov_34.913154	2031	2077	277	1	46	0.0217391
NODE_430_length_3634_cov_34.913154	2031	2077	288	1	46	0.0217391
NODE_430_length_3634_cov_34.913154	2031	2077	305	1	46	0.0217391
NODE_430_length_3634_cov_34.913154	2031	2077	312	1	46	0.0217391
NODE_430_length_3634_cov_34.913154	2031	2077	323	1	46	0.0217391
NODE_430_length_3634_cov_34.913154	2031	2077	328	1	46	0.0217391
NODE_430_length_3634_cov_34.913154	2031	2077	340	1	46	0.0217391
NODE_430_length_3634_cov_34.913154	2031	2077	347	1	46	0.0217391
NODE_430_length_3634_cov_34.913154	2031	2077	355	1	46	0.0217391
NODE_430_length_3634_cov_34.913154	2031	2077	365	1	46	0.0217391
NODE_430_length_3634_cov_34.913154	2031	2077	366	1	46	0.0217391
NODE_430_length_3634_cov_34.913154	2031	2077	369	1	46	0.0217391
NODE_430_length_3634_cov_34.913154	2031	2077	380	1	46	0.0217391
NODE_430_length_3634_cov_34.913154	2031	2077	397	1	46	0.0217391
NODE_430_length_3634_cov_34.913154	2031	2077	407	1	46	0.0217391
NODE_430_length_3634_cov_34.913154	2031	2077	432	1	46	0.0217391
NODE_430_length_3634_cov_34.913154	2031	2077	438	1	46	0.0217391
NODE_430_length_3634_cov_34.913154	2031	2077	452	1	46	0.0217391
NODE_430_length_3634_cov_34.913154	2031	2077	456	1	46	0.0217391
NODE_430_length_3634_cov_34.913154	2031	2077	464	1	46	0.0217391
NODE_430_length_3634_cov_34.913154	2031	2077	471	1	46	0.0217391
NODE_430_length_3634_cov_34.913154	2031	2077	476	1	46	0.0217391
NODE_430_length_3634_cov_34.913154	2031	2077	492	1	46	0.0217391
NODE_430_length_3634_cov_34.913154	2031	2077	500	1	46	0.0217391
NODE_430_length_3634_cov_34.913154	2031	2077	504	1	46	0.0217391
NODE_430_length_3634_cov_34.913154	2031	2077	508	1	46	0.0217391
NODE_430_length_3634_cov_34.913154	2031	2077	511	1	46	0.0217391
NODE_430_length_3634_cov_34.913154	2031	2077	513	1	46	0.0217391
NODE_430_length_3634_cov_34.913154	2031	2077	519	1	46	0.0217391
NODE_435_length_3622_cov_29.112120	201	281	4	29	80	0.3625000
NODE_435_length_3622_cov_29.112120	201	281	6	26	80	0.3250000
NODE_435_length_3622_cov_29.112120	201	281	8	25	80	0.3125000
NODE_435_length_3622_cov_29.112120	254	334	0	18	80	0.2250000
NODE_435_length_3622_cov_29.112120	254	334	4	62	80	0.7750000
NODE_435_length_3622_cov_29.112120	2310	2390	242	2	80	0.0250000
NODE_435_length_3622_cov_29.112120	2310	2390	246	1	80	0.0125000
NODE_435_length_3622_cov_29.112120	2310	2390	248	6	80	0.0750000
NODE_435_length_3622_cov_29.112120	2310	2390	250	1	80	0.0125000
NODE_435_length_3622_cov_29.112120	2310	2390	258	2	80	0.0250000
NODE_435_length_3622_cov_29.112120	2310	2390	260	2	80	0.0250000
NODE_435_length_3622_cov_29.112120	2310	2390	272	1	80	0.0125000
NODE_435_length_3622_cov_29.112120	2310	2390	273	1	80	0.0125000
NODE_435_length_3622_cov_29.112120	2310	2390	275	1	80	0.0125000
NODE_435_length_3622_cov_29.112120	2310	2390	281	1	80	0.0125000
NODE_435_length_3622_cov_29.112120	2310	2390	288	1	80	0.0125000
NODE_435_length_3622_cov_29.112120	2310	2390	290	3	80	0.0375000
NODE_435_length_3622_cov_29.112120	2310	2390	294	2	80	0.0250000
NODE_435_length_3622_cov_29.112120	2310	2390	297	1	80	0.0125000
NODE_435_length_3622_cov_29.112120	2310	2390	301	2	80	0.0250000
NODE_435_length_3622_cov_29.112120	2310	2390	307	1	80	0.0125000
NODE_435_length_3622_cov_29.112120	2310	2390	313	1	80	0.0125000
NODE_435_length_3622_cov_29.112120	2310	2390	315	1	80	0.0125000
NODE_435_length_3622_cov_29.112120	2310	2390	322	2	80	0.0250000
NODE_435_length_3622_cov_29.112120	2310	2390	327	1	80	0.0125000
NODE_435_length_3622_cov_29.112120	2310	2390	330	1	80	0.0125000
NODE_435_length_3622_cov_29.112120	2310	2390	341	1	80	0.0125000
NODE_435_length_3622_cov_29.112120	2310	2390	346	2	80	0.0250000
NODE_435_length_3622_cov_29.112120	2310	2390	351	1	80	0.0125000
NODE_435_length_3622_cov_29.112120	2310	2390	353	1	80	0.0125000
NODE_435_length_3622_cov_29.112120	2310	2390	354	1	80	0.0125000
NODE_435_length_3622_cov_29.112120	2310	2390	362	1	80	0.0125000
NODE_435_length_3622_cov_29.112120	2310	2390	365	1	80	0.0125000
NODE_435_length_3622_cov_29.112120	2310	2390	367	1	80	0.0125000
NODE_435_length_3622_cov_29.112120	2310	2390	375	1	80	0.0125000
NODE_435_length_3622_cov_29.112120	2310	2390	379	1	80	0.0125000
NODE_435_length_3622_cov_29.112120	2310	2390	381	2	80	0.0250000
NODE_435_length_3622_cov_29.112120	2310	2390	384	1	80	0.0125000
NODE_435_length_3622_cov_29.112120	2310	2390	388	2	80	0.0250000
NODE_435_length_3622_cov_29.112120	2310	2390	389	1	80	0.0125000
NODE_435_length_3622_cov_29.112120	2310	2390	390	1	80	0.0125000
NODE_435_length_3622_cov_29.112120	2310	2390	391	2	80	0.0250000
NODE_435_length_3622_cov_29.112120	2310	2390	392	1	80	0.0125000
NODE_435_length_3622_cov_29.112120	2310	2390	393	2	80	0.0250000
NODE_435_length_3622_cov_29.112120	2310	2390	394	4	80	0.0500000
NODE_435_length_3622_cov_29.112120	2310	2390	395	2	80	0.0250000
NODE_435_length_3622_cov_29.112120	2310	2390	396	2	80	0.0250000
NODE_435_length_3622_cov_29.112120	2310	2390	397	1	80	0.0125000
NODE_435_length_3622_cov_29.112120	2310	2390	398	1	80	0.0125000
NODE_435_length_3622_cov_29.112120	2310	2390	399	1	80	0.0125000
NODE_435_length_3622_cov_29.112120	2310	2390	400	1	80	0.0125000
NODE_435_length_3622_cov_29.112120	2310	2390	401	1	80	0.0125000
NODE_435_length_3622_cov_29.112120	2310	2390	402	3	80	0.0375000
NODE_435_length_3622_cov_29.112120	2310	2390	404	1	80	0.0125000
NODE_435_length_3622_cov_29.112120	2310	2390	405	1	80	0.0125000
NODE_435_length_3622_cov_29.112120	2310	2390	406	1	80	0.0125000
NODE_435_length_3622_cov_29.112120	2310	2390	407	4	80	0.0500000
NODE_435_length_3622_cov_29.112120	2363	2441	32	2	78	0.0256410
NODE_435_length_3622_cov_29.112120	2363	2441	36	1	78	0.0128205
NODE_435_length_3622_cov_29.112120	2363	2441	41	1	78	0.0128205
NODE_435_length_3622_cov_29.112120	2363	2441	49	1	78	0.0128205
NODE_435_length_3622_cov_29.112120	2363	2441	61	2	78	0.0256410
NODE_435_length_3622_cov_29.112120	2363	2441	67	1	78	0.0128205
NODE_435_length_3622_cov_29.112120	2363	2441	69	1	78	0.0128205
NODE_435_length_3622_cov_29.112120	2363	2441	70	2	78	0.0256410
NODE_435_length_3622_cov_29.112120	2363	2441	74	1	78	0.0128205
NODE_435_length_3622_cov_29.112120	2363	2441	78	3	78	0.0384615
NODE_435_length_3622_cov_29.112120	2363	2441	84	1	78	0.0128205
NODE_435_length_3622_cov_29.112120	2363	2441	88	1	78	0.0128205
NODE_435_length_3622_cov_29.112120	2363	2441	90	1	78	0.0128205
NODE_435_length_3622_cov_29.112120	2363	2441	91	1	78	0.0128205
NODE_435_length_3622_cov_29.112120	2363	2441	92	3	78	0.0384615
NODE_435_length_3622_cov_29.112120	2363	2441	93	1	78	0.0128205
NODE_435_length_3622_cov_29.112120	2363	2441	95	1	78	0.0128205
NODE_435_length_3622_cov_29.112120	2363	2441	102	2	78	0.0256410
NODE_435_length_3622_cov_29.112120	2363	2441	104	1	78	0.0128205
NODE_435_length_3622_cov_29.112120	2363	2441	106	1	78	0.0128205
NODE_435_length_3622_cov_29.112120	2363	2441	115	1	78	0.0128205
NODE_435_length_3622_cov_29.112120	2363	2441	119	1	78	0.0128205
NODE_435_length_3622_cov_29.112120	2363	2441	129	1	78	0.0128205
NODE_435_length_3622_cov_29.112120	2363	2441	133	1	78	0.0128205
NODE_435_length_3622_cov_29.112120	2363	2441	139	1	78	0.0128205
NODE_435_length_3622_cov_29.112120	2363	2441	143	1	78	0.0128205
NODE_435_length_3622_cov_29.112120	2363	2441	144	1	78	0.0128205
NODE_435_length_3622_cov_29.112120	2363	2441	156	2	78	0.0256410
NODE_435_length_3622_cov_29.112120	2363	2441	160	1	78	0.0128205
NODE_435_length_3622_cov_29.112120	2363	2441	170	1	78	0.0128205
NODE_435_length_3622_cov_29.112120	2363	2441	176	1	78	0.0128205
NODE_435_length_3622_cov_29.112120	2363	2441	180	1	78	0.0128205
NODE_435_length_3622_cov_29.112120	2363	2441	192	1	78	0.0128205
NODE_435_length_3622_cov_29.112120	2363	2441	199	1	78	0.0128205
NODE_435_length_3622_cov_29.112120	2363	2441	207	1	78	0.0128205
NODE_435_length_3622_cov_29.112120	2363	2441	213	1	78	0.0128205
NODE_435_length_3622_cov_29.112120	2363	2441	219	1	78	0.0128205
NODE_435_length_3622_cov_29.112120	2363	2441	223	1	78	0.0128205
NODE_435_length_3622_cov_29.112120	2363	2441	224	1	78	0.0128205
NODE_435_length_3622_cov_29.112120	2363	2441	230	1	78	0.0128205
NODE_435_length_3622_cov_29.112120	2363	2441	231	1	78	0.0128205
NODE_435_length_3622_cov_29.112120	2363	2441	240	1	78	0.0128205
NODE_435_length_3622_cov_29.112120	2363	2441	242	2	78	0.0256410
NODE_435_length_3622_cov_29.112120	2363	2441	246	1	78	0.0128205
NODE_435_length_3622_cov_29.112120	2363	2441	248	6	78	0.0769231
NODE_435_length_3622_cov_29.112120	2363	2441	250	1	78	0.0128205
NODE_435_length_3622_cov_29.112120	2363	2441	258	2	78	0.0256410
NODE_435_length_3622_cov_29.112120	2363	2441	260	2	78	0.0256410
NODE_435_length_3622_cov_29.112120	2363	2441	272	1	78	0.0128205
NODE_435_length_3622_cov_29.112120	2363	2441	273	1	78	0.0128205
NODE_435_length_3622_cov_29.112120	2363	2441	275	1	78	0.0128205
NODE_435_length_3622_cov_29.112120	2363	2441	281	1	78	0.0128205
NODE_435_length_3622_cov_29.112120	2363	2441	288	1	78	0.0128205
NODE_435_length_3622_cov_29.112120	2363	2441	290	3	78	0.0384615
NODE_435_length_3622_cov_29.112120	2363	2441	294	2	78	0.0256410
NODE_435_length_3622_cov_29.112120	2363	2441	297	1	78	0.0128205
NODE_435_length_3622_cov_29.112120	2363	2441	301	2	78	0.0256410
NODE_437_length_3610_cov_8.785816	294	340	16	8	46	0.1739130
NODE_437_length_3610_cov_8.785816	294	340	20	2	46	0.0434783
NODE_437_length_3610_cov_8.785816	294	340	22	29	46	0.6304348
NODE_437_length_3610_cov_8.785816	294	340	26	7	46	0.1521739
NODE_437_length_3610_cov_8.785816	313	393	10	3	80	0.0375000
NODE_437_length_3610_cov_8.785816	313	393	15	2	80	0.0250000
NODE_437_length_3610_cov_8.785816	313	393	16	1	80	0.0125000
NODE_437_length_3610_cov_8.785816	313	393	20	20	80	0.2500000
NODE_437_length_3610_cov_8.785816	313	393	22	20	80	0.2500000
NODE_437_length_3610_cov_8.785816	313	393	24	19	80	0.2375000
NODE_437_length_3610_cov_8.785816	313	393	26	15	80	0.1875000
NODE_444_length_3588_cov_16.296360	2421	2501	0	68	80	0.8500000
NODE_444_length_3588_cov_16.296360	2421	2501	2	12	80	0.1500000
NODE_444_length_3588_cov_16.296360	2474	2539	0	15	65	0.2307692
NODE_444_length_3588_cov_16.296360	2474	2539	2	50	65	0.7692308
NODE_447_length_3585_cov_2.283419	605	668	0	6	63	0.0952381
NODE_447_length_3585_cov_2.283419	605	668	2	57	63	0.9047619
NODE_451_length_3567_cov_16.283160	410	429	0	19	19	1.0000000
NODE_451_length_3567_cov_16.283160	2259	2339	267	1	80	0.0125000
NODE_451_length_3567_cov_16.283160	2259	2339	268	1	80	0.0125000
NODE_451_length_3567_cov_16.283160	2259	2339	271	1	80	0.0125000
NODE_451_length_3567_cov_16.283160	2259	2339	272	1	80	0.0125000
NODE_451_length_3567_cov_16.283160	2259	2339	277	4	80	0.0500000
NODE_451_length_3567_cov_16.283160	2259	2339	278	2	80	0.0250000
NODE_451_length_3567_cov_16.283160	2259	2339	281	1	80	0.0125000
NODE_451_length_3567_cov_16.283160	2259	2339	282	2	80	0.0250000
NODE_451_length_3567_cov_16.283160	2259	2339	284	2	80	0.0250000
NODE_451_length_3567_cov_16.283160	2259	2339	286	2	80	0.0250000
NODE_451_length_3567_cov_16.283160	2259	2339	288	1	80	0.0125000
NODE_451_length_3567_cov_16.283160	2259	2339	289	1	80	0.0125000
NODE_451_length_3567_cov_16.283160	2259	2339	290	3	80	0.0375000
NODE_451_length_3567_cov_16.283160	2259	2339	291	2	80	0.0250000
NODE_451_length_3567_cov_16.283160	2259	2339	293	1	80	0.0125000
NODE_451_length_3567_cov_16.283160	2259	2339	295	7	80	0.0875000
NODE_451_length_3567_cov_16.283160	2259	2339	296	1	80	0.0125000
NODE_451_length_3567_cov_16.283160	2259	2339	297	2	80	0.0250000
NODE_451_length_3567_cov_16.283160	2259	2339	298	9	80	0.1125000
NODE_451_length_3567_cov_16.283160	2259	2339	299	3	80	0.0375000
NODE_451_length_3567_cov_16.283160	2259	2339	300	3	80	0.0375000
NODE_451_length_3567_cov_16.283160	2259	2339	302	2	80	0.0250000
NODE_451_length_3567_cov_16.283160	2259	2339	303	5	80	0.0625000
NODE_451_length_3567_cov_16.283160	2259	2339	304	5	80	0.0625000
NODE_451_length_3567_cov_16.283160	2259	2339	306	8	80	0.1000000
NODE_451_length_3567_cov_16.283160	2259	2339	309	1	80	0.0125000
NODE_451_length_3567_cov_16.283160	2259	2339	310	5	80	0.0625000
NODE_451_length_3567_cov_16.283160	2259	2339	311	4	80	0.0500000
NODE_451_length_3567_cov_16.283160	2312	2379	11	1	67	0.0149254
NODE_451_length_3567_cov_16.283160	2312	2379	25	3	67	0.0447761
NODE_451_length_3567_cov_16.283160	2312	2379	26	1	67	0.0149254
NODE_451_length_3567_cov_16.283160	2312	2379	43	1	67	0.0149254
NODE_451_length_3567_cov_16.283160	2312	2379	46	1	67	0.0149254
NODE_451_length_3567_cov_16.283160	2312	2379	52	1	67	0.0149254
NODE_451_length_3567_cov_16.283160	2312	2379	59	1	67	0.0149254
NODE_451_length_3567_cov_16.283160	2312	2379	66	1	67	0.0149254
NODE_451_length_3567_cov_16.283160	2312	2379	84	1	67	0.0149254
NODE_451_length_3567_cov_16.283160	2312	2379	93	1	67	0.0149254
NODE_451_length_3567_cov_16.283160	2312	2379	98	1	67	0.0149254
NODE_451_length_3567_cov_16.283160	2312	2379	114	2	67	0.0298507
NODE_451_length_3567_cov_16.283160	2312	2379	121	1	67	0.0149254
NODE_451_length_3567_cov_16.283160	2312	2379	128	1	67	0.0149254
NODE_451_length_3567_cov_16.283160	2312	2379	138	2	67	0.0298507
NODE_451_length_3567_cov_16.283160	2312	2379	153	1	67	0.0149254
NODE_451_length_3567_cov_16.283160	2312	2379	158	1	67	0.0149254
NODE_451_length_3567_cov_16.283160	2312	2379	162	1	67	0.0149254
NODE_451_length_3567_cov_16.283160	2312	2379	170	1	67	0.0149254
NODE_451_length_3567_cov_16.283160	2312	2379	186	1	67	0.0149254
NODE_451_length_3567_cov_16.283160	2312	2379	193	1	67	0.0149254
NODE_451_length_3567_cov_16.283160	2312	2379	211	1	67	0.0149254
NODE_451_length_3567_cov_16.283160	2312	2379	214	1	67	0.0149254
NODE_451_length_3567_cov_16.283160	2312	2379	215	1	67	0.0149254
NODE_451_length_3567_cov_16.283160	2312	2379	219	1	67	0.0149254
NODE_451_length_3567_cov_16.283160	2312	2379	221	1	67	0.0149254
NODE_451_length_3567_cov_16.283160	2312	2379	227	1	67	0.0149254
NODE_451_length_3567_cov_16.283160	2312	2379	232	1	67	0.0149254
NODE_451_length_3567_cov_16.283160	2312	2379	237	2	67	0.0298507
NODE_451_length_3567_cov_16.283160	2312	2379	243	1	67	0.0149254
NODE_451_length_3567_cov_16.283160	2312	2379	252	1	67	0.0149254
NODE_451_length_3567_cov_16.283160	2312	2379	256	1	67	0.0149254
NODE_451_length_3567_cov_16.283160	2312	2379	265	2	67	0.0298507
NODE_451_length_3567_cov_16.283160	2312	2379	266	1	67	0.0149254
NODE_451_length_3567_cov_16.283160	2312	2379	267	1	67	0.0149254
NODE_451_length_3567_cov_16.283160	2312	2379	268	1	67	0.0149254
NODE_451_length_3567_cov_16.283160	2312	2379	271	1	67	0.0149254
NODE_451_length_3567_cov_16.283160	2312	2379	272	1	67	0.0149254
NODE_451_length_3567_cov_16.283160	2312	2379	277	4	67	0.0597015
NODE_451_length_3567_cov_16.283160	2312	2379	278	2	67	0.0298507
NODE_451_length_3567_cov_16.283160	2312	2379	281	1	67	0.0149254
NODE_451_length_3567_cov_16.283160	2312	2379	282	1	67	0.0149254
NODE_451_length_3567_cov_16.283160	2312	2379	286	1	67	0.0149254
NODE_451_length_3567_cov_16.283160	2312	2379	290	2	67	0.0298507
NODE_451_length_3567_cov_16.283160	2312	2379	291	2	67	0.0298507
NODE_451_length_3567_cov_16.283160	2312	2379	295	7	67	0.1044776
NODE_451_length_3567_cov_16.283160	2312	2379	297	1	67	0.0149254
NODE_451_length_3567_cov_16.283160	2312	2379	298	2	67	0.0298507
NODE_454_length_3557_cov_12.423077	640	718	0	50	78	0.6410257
NODE_454_length_3557_cov_12.423077	640	718	6	28	78	0.3589744
NODE_454_length_3557_cov_12.423077	640	688	0	48	48	1.0000000
NODE_454_length_3557_cov_12.423077	640	688	0	48	48	1.0000000
NODE_454_length_3557_cov_12.423077	640	688	0	48	48	1.0000000
NODE_454_length_3557_cov_12.423077	640	688	0	48	48	1.0000000
NODE_454_length_3557_cov_12.423077	693	771	6	31	78	0.3974359
NODE_454_length_3557_cov_12.423077	693	771	7	47	78	0.6025641
NODE_455_length_3548_cov_7.216295	554	634	0	8	80	0.1000000
NODE_455_length_3548_cov_7.216295	554	634	2	15	80	0.1875000
NODE_455_length_3548_cov_7.216295	554	634	4	54	80	0.6750000
NODE_455_length_3548_cov_7.216295	554	634	6	3	80	0.0375000
NODE_455_length_3548_cov_7.216295	607	687	2	49	80	0.6125000
NODE_455_length_3548_cov_7.216295	607	687	4	28	80	0.3500000
NODE_455_length_3548_cov_7.216295	607	687	6	3	80	0.0375000
NODE_461_length_3518_cov_40.508336	1320	1400	0	3	80	0.0375000
NODE_461_length_3518_cov_40.508336	1320	1400	8	2	80	0.0250000
NODE_461_length_3518_cov_40.508336	1320	1400	15	46	80	0.5750000
NODE_461_length_3518_cov_40.508336	1320	1400	21	29	80	0.3625000
NODE_461_length_3518_cov_40.508336	1373	1453	21	68	80	0.8500000
NODE_461_length_3518_cov_40.508336	1373	1453	22	12	80	0.1500000
NODE_465_length_3497_cov_65.791348	3062	3142	833	1	80	0.0125000
NODE_465_length_3497_cov_65.791348	3062	3142	836	1	80	0.0125000
NODE_465_length_3497_cov_65.791348	3062	3142	840	1	80	0.0125000
NODE_465_length_3497_cov_65.791348	3062	3142	844	1	80	0.0125000
NODE_465_length_3497_cov_65.791348	3062	3142	854	1	80	0.0125000
NODE_465_length_3497_cov_65.791348	3062	3142	866	1	80	0.0125000
NODE_465_length_3497_cov_65.791348	3062	3142	873	1	80	0.0125000
NODE_465_length_3497_cov_65.791348	3062	3142	891	1	80	0.0125000
NODE_465_length_3497_cov_65.791348	3062	3142	897	2	80	0.0250000
NODE_465_length_3497_cov_65.791348	3062	3142	903	1	80	0.0125000
NODE_465_length_3497_cov_65.791348	3062	3142	906	1	80	0.0125000
NODE_465_length_3497_cov_65.791348	3062	3142	908	1	80	0.0125000
NODE_465_length_3497_cov_65.791348	3062	3142	909	2	80	0.0250000
NODE_465_length_3497_cov_65.791348	3062	3142	912	1	80	0.0125000
NODE_465_length_3497_cov_65.791348	3062	3142	916	1	80	0.0125000
NODE_465_length_3497_cov_65.791348	3062	3142	920	1	80	0.0125000
NODE_465_length_3497_cov_65.791348	3062	3142	921	2	80	0.0250000
NODE_465_length_3497_cov_65.791348	3062	3142	933	1	80	0.0125000
NODE_465_length_3497_cov_65.791348	3062	3142	938	1	80	0.0125000
NODE_465_length_3497_cov_65.791348	3062	3142	944	1	80	0.0125000
NODE_465_length_3497_cov_65.791348	3062	3142	946	3	80	0.0375000
NODE_465_length_3497_cov_65.791348	3062	3142	948	1	80	0.0125000
NODE_465_length_3497_cov_65.791348	3062	3142	953	1	80	0.0125000
NODE_465_length_3497_cov_65.791348	3062	3142	954	3	80	0.0375000
NODE_465_length_3497_cov_65.791348	3062	3142	955	2	80	0.0250000
NODE_465_length_3497_cov_65.791348	3062	3142	956	3	80	0.0375000
NODE_465_length_3497_cov_65.791348	3062	3142	957	1	80	0.0125000
NODE_465_length_3497_cov_65.791348	3062	3142	959	1	80	0.0125000
NODE_465_length_3497_cov_65.791348	3062	3142	961	2	80	0.0250000
NODE_465_length_3497_cov_65.791348	3062	3142	962	1	80	0.0125000
NODE_465_length_3497_cov_65.791348	3062	3142	963	2	80	0.0250000
NODE_465_length_3497_cov_65.791348	3062	3142	964	4	80	0.0500000
NODE_465_length_3497_cov_65.791348	3062	3142	965	2	80	0.0250000
NODE_465_length_3497_cov_65.791348	3062	3142	966	3	80	0.0375000
NODE_465_length_3497_cov_65.791348	3062	3142	967	3	80	0.0375000
NODE_465_length_3497_cov_65.791348	3062	3142	968	1	80	0.0125000
NODE_465_length_3497_cov_65.791348	3062	3142	969	4	80	0.0500000
NODE_465_length_3497_cov_65.791348	3062	3142	970	1	80	0.0125000
NODE_465_length_3497_cov_65.791348	3062	3142	971	5	80	0.0625000
NODE_465_length_3497_cov_65.791348	3062	3142	973	2	80	0.0250000
NODE_465_length_3497_cov_65.791348	3062	3142	974	1	80	0.0125000
NODE_465_length_3497_cov_65.791348	3062	3142	975	1	80	0.0125000
NODE_465_length_3497_cov_65.791348	3062	3142	977	1	80	0.0125000
NODE_465_length_3497_cov_65.791348	3062	3142	978	1	80	0.0125000
NODE_465_length_3497_cov_65.791348	3062	3142	981	1	80	0.0125000
NODE_465_length_3497_cov_65.791348	3062	3142	982	1	80	0.0125000
NODE_465_length_3497_cov_65.791348	3062	3142	984	1	80	0.0125000
NODE_465_length_3497_cov_65.791348	3062	3142	985	1	80	0.0125000
NODE_465_length_3497_cov_65.791348	3062	3142	986	1	80	0.0125000
NODE_465_length_3497_cov_65.791348	3062	3142	989	1	80	0.0125000
NODE_465_length_3497_cov_65.791348	3062	3142	991	1	80	0.0125000
NODE_465_length_3497_cov_65.791348	3062	3142	992	1	80	0.0125000
NODE_466_length_3488_cov_2.243730	506	529	0	23	23	1.0000000
NODE_470_length_3483_cov_14.759456	360	440	2	12	80	0.1500000
NODE_470_length_3483_cov_14.759456	360	440	8	65	80	0.8125000
NODE_470_length_3483_cov_14.759456	360	440	12	3	80	0.0375000
NODE_470_length_3483_cov_14.759456	413	493	8	24	80	0.3000000
NODE_470_length_3483_cov_14.759456	413	493	12	34	80	0.4250000
NODE_470_length_3483_cov_14.759456	413	493	14	22	80	0.2750000
NODE_474_length_3471_cov_37.887604	2795	2875	0	80	80	1.0000000
NODE_474_length_3471_cov_37.887604	2848	2928	0	80	80	1.0000000
NODE_474_length_3471_cov_37.887604	2924	2943	0	19	19	1.0000000
NODE_474_length_3471_cov_37.887604	2924	3004	0	80	80	1.0000000
NODE_474_length_3471_cov_37.887604	2977	3057	0	80	80	1.0000000
NODE_479_length_3451_cov_29.833234	2973	3053	0	21	80	0.2625000
NODE_479_length_3451_cov_29.833234	2973	3053	2	59	80	0.7375000
NODE_479_length_3451_cov_29.833234	3026	3106	0	36	80	0.4500000
NODE_479_length_3451_cov_29.833234	3026	3106	2	19	80	0.2375000
NODE_479_length_3451_cov_29.833234	3026	3106	4	25	80	0.3125000
NODE_481_length_3446_cov_32.421273	3181	3261	36	18	80	0.2250000
NODE_481_length_3446_cov_32.421273	3181	3261	37	3	80	0.0375000
NODE_481_length_3446_cov_32.421273	3181	3261	38	20	80	0.2500000
NODE_481_length_3446_cov_32.421273	3181	3261	40	13	80	0.1625000
NODE_481_length_3446_cov_32.421273	3181	3261	42	26	80	0.3250000
NODE_482_length_3444_cov_29.954858	792	872	17	2	80	0.0250000
NODE_482_length_3444_cov_29.954858	792	872	23	1	80	0.0125000
NODE_482_length_3444_cov_29.954858	792	872	24	2	80	0.0250000
NODE_482_length_3444_cov_29.954858	792	872	26	1	80	0.0125000
NODE_482_length_3444_cov_29.954858	792	872	28	9	80	0.1125000
NODE_482_length_3444_cov_29.954858	792	872	30	8	80	0.1000000
NODE_482_length_3444_cov_29.954858	792	872	31	19	80	0.2375000
NODE_482_length_3444_cov_29.954858	792	872	32	4	80	0.0500000
NODE_482_length_3444_cov_29.954858	792	872	33	2	80	0.0250000
NODE_482_length_3444_cov_29.954858	792	872	34	29	80	0.3625000
NODE_482_length_3444_cov_29.954858	792	872	36	2	80	0.0250000
NODE_482_length_3444_cov_29.954858	792	872	39	1	80	0.0125000
NODE_482_length_3444_cov_29.954858	845	925	10	12	80	0.1500000
NODE_482_length_3444_cov_29.954858	845	925	12	6	80	0.0750000
NODE_482_length_3444_cov_29.954858	845	925	14	24	80	0.3000000
NODE_482_length_3444_cov_29.954858	845	925	22	2	80	0.0250000
NODE_482_length_3444_cov_29.954858	845	925	28	1	80	0.0125000
NODE_482_length_3444_cov_29.954858	845	925	30	12	80	0.1500000
NODE_482_length_3444_cov_29.954858	845	925	32	1	80	0.0125000
NODE_482_length_3444_cov_29.954858	845	925	34	20	80	0.2500000
NODE_482_length_3444_cov_29.954858	845	925	36	2	80	0.0250000
NODE_483_length_3442_cov_17.799880	3155	3220	14	1	65	0.0153846
NODE_483_length_3442_cov_17.799880	3155	3220	48	2	65	0.0307692
NODE_483_length_3442_cov_17.799880	3155	3220	50	1	65	0.0153846
NODE_483_length_3442_cov_17.799880	3155	3220	54	4	65	0.0615385
NODE_483_length_3442_cov_17.799880	3155	3220	57	1	65	0.0153846
NODE_483_length_3442_cov_17.799880	3155	3220	61	2	65	0.0307692
NODE_483_length_3442_cov_17.799880	3155	3220	63	3	65	0.0461538
NODE_483_length_3442_cov_17.799880	3155	3220	72	1	65	0.0153846
NODE_483_length_3442_cov_17.799880	3155	3220	74	3	65	0.0461538
NODE_483_length_3442_cov_17.799880	3155	3220	86	2	65	0.0307692
NODE_483_length_3442_cov_17.799880	3155	3220	91	3	65	0.0461538
NODE_483_length_3442_cov_17.799880	3155	3220	93	1	65	0.0153846
NODE_483_length_3442_cov_17.799880	3155	3220	97	1	65	0.0153846
NODE_483_length_3442_cov_17.799880	3155	3220	102	2	65	0.0307692
NODE_483_length_3442_cov_17.799880	3155	3220	103	1	65	0.0153846
NODE_483_length_3442_cov_17.799880	3155	3220	105	1	65	0.0153846
NODE_483_length_3442_cov_17.799880	3155	3220	107	1	65	0.0153846
NODE_483_length_3442_cov_17.799880	3155	3220	118	2	65	0.0307692
NODE_483_length_3442_cov_17.799880	3155	3220	120	1	65	0.0153846
NODE_483_length_3442_cov_17.799880	3155	3220	122	2	65	0.0307692
NODE_483_length_3442_cov_17.799880	3155	3220	125	1	65	0.0153846
NODE_483_length_3442_cov_17.799880	3155	3220	129	1	65	0.0153846
NODE_483_length_3442_cov_17.799880	3155	3220	133	1	65	0.0153846
NODE_483_length_3442_cov_17.799880	3155	3220	135	1	65	0.0153846
NODE_483_length_3442_cov_17.799880	3155	3220	136	1	65	0.0153846
NODE_483_length_3442_cov_17.799880	3155	3220	138	4	65	0.0615385
NODE_483_length_3442_cov_17.799880	3155	3220	140	2	65	0.0307692
NODE_483_length_3442_cov_17.799880	3155	3220	142	2	65	0.0307692
NODE_483_length_3442_cov_17.799880	3155	3220	147	2	65	0.0307692
NODE_483_length_3442_cov_17.799880	3155	3220	148	1	65	0.0153846
NODE_483_length_3442_cov_17.799880	3155	3220	149	1	65	0.0153846
NODE_483_length_3442_cov_17.799880	3155	3220	152	2	65	0.0307692
NODE_483_length_3442_cov_17.799880	3155	3220	153	1	65	0.0153846
NODE_483_length_3442_cov_17.799880	3155	3220	157	1	65	0.0153846
NODE_483_length_3442_cov_17.799880	3155	3220	164	1	65	0.0153846
NODE_483_length_3442_cov_17.799880	3155	3220	169	1	65	0.0153846
NODE_483_length_3442_cov_17.799880	3155	3220	172	1	65	0.0153846
NODE_483_length_3442_cov_17.799880	3155	3220	173	1	65	0.0153846
NODE_483_length_3442_cov_17.799880	3155	3220	183	2	65	0.0307692
NODE_483_length_3442_cov_17.799880	3155	3220	184	1	65	0.0153846
NODE_483_length_3442_cov_17.799880	3155	3220	185	1	65	0.0153846
NODE_483_length_3442_cov_17.799880	3155	3220	189	1	65	0.0153846
NODE_483_length_3442_cov_17.799880	3208	3273	152	1	65	0.0153846
NODE_483_length_3442_cov_17.799880	3208	3273	153	1	65	0.0153846
NODE_483_length_3442_cov_17.799880	3208	3273	157	1	65	0.0153846
NODE_483_length_3442_cov_17.799880	3208	3273	164	1	65	0.0153846
NODE_483_length_3442_cov_17.799880	3208	3273	169	1	65	0.0153846
NODE_483_length_3442_cov_17.799880	3208	3273	172	1	65	0.0153846
NODE_483_length_3442_cov_17.799880	3208	3273	173	1	65	0.0153846
NODE_483_length_3442_cov_17.799880	3208	3273	183	2	65	0.0307692
NODE_483_length_3442_cov_17.799880	3208	3273	184	1	65	0.0153846
NODE_483_length_3442_cov_17.799880	3208	3273	185	1	65	0.0153846
NODE_483_length_3442_cov_17.799880	3208	3273	189	1	65	0.0153846
NODE_483_length_3442_cov_17.799880	3208	3273	194	5	65	0.0769231
NODE_483_length_3442_cov_17.799880	3208	3273	198	2	65	0.0307692
NODE_483_length_3442_cov_17.799880	3208	3273	200	1	65	0.0153846
NODE_483_length_3442_cov_17.799880	3208	3273	202	1	65	0.0153846
NODE_483_length_3442_cov_17.799880	3208	3273	214	1	65	0.0153846
NODE_483_length_3442_cov_17.799880	3208	3273	226	1	65	0.0153846
NODE_483_length_3442_cov_17.799880	3208	3273	232	1	65	0.0153846
NODE_483_length_3442_cov_17.799880	3208	3273	234	1	65	0.0153846
NODE_483_length_3442_cov_17.799880	3208	3273	242	1	65	0.0153846
NODE_483_length_3442_cov_17.799880	3208	3273	250	1	65	0.0153846
NODE_483_length_3442_cov_17.799880	3208	3273	252	1	65	0.0153846
NODE_483_length_3442_cov_17.799880	3208	3273	269	1	65	0.0153846
NODE_483_length_3442_cov_17.799880	3208	3273	273	2	65	0.0307692
NODE_483_length_3442_cov_17.799880	3208	3273	278	1	65	0.0153846
NODE_483_length_3442_cov_17.799880	3208	3273	291	1	65	0.0153846
NODE_483_length_3442_cov_17.799880	3208	3273	303	1	65	0.0153846
NODE_483_length_3442_cov_17.799880	3208	3273	304	1	65	0.0153846
NODE_483_length_3442_cov_17.799880	3208	3273	305	2	65	0.0307692
NODE_483_length_3442_cov_17.799880	3208	3273	307	1	65	0.0153846
NODE_483_length_3442_cov_17.799880	3208	3273	309	1	65	0.0153846
NODE_483_length_3442_cov_17.799880	3208	3273	316	1	65	0.0153846
NODE_483_length_3442_cov_17.799880	3208	3273	321	1	65	0.0153846
NODE_483_length_3442_cov_17.799880	3208	3273	334	1	65	0.0153846
NODE_483_length_3442_cov_17.799880	3208	3273	355	1	65	0.0153846
NODE_483_length_3442_cov_17.799880	3208	3273	361	1	65	0.0153846
NODE_483_length_3442_cov_17.799880	3208	3273	365	1	65	0.0153846
NODE_483_length_3442_cov_17.799880	3208	3273	366	1	65	0.0153846
NODE_483_length_3442_cov_17.799880	3208	3273	370	1	65	0.0153846
NODE_483_length_3442_cov_17.799880	3208	3273	382	1	65	0.0153846
NODE_483_length_3442_cov_17.799880	3208	3273	390	1	65	0.0153846
NODE_483_length_3442_cov_17.799880	3208	3273	392	1	65	0.0153846
NODE_483_length_3442_cov_17.799880	3208	3273	402	1	65	0.0153846
NODE_483_length_3442_cov_17.799880	3208	3273	409	1	65	0.0153846
NODE_483_length_3442_cov_17.799880	3208	3273	414	1	65	0.0153846
NODE_483_length_3442_cov_17.799880	3208	3273	416	1	65	0.0153846
NODE_483_length_3442_cov_17.799880	3208	3273	425	1	65	0.0153846
NODE_483_length_3442_cov_17.799880	3208	3273	427	1	65	0.0153846
NODE_483_length_3442_cov_17.799880	3208	3273	428	1	65	0.0153846
NODE_483_length_3442_cov_17.799880	3208	3273	435	1	65	0.0153846
NODE_483_length_3442_cov_17.799880	3208	3273	449	1	65	0.0153846
NODE_483_length_3442_cov_17.799880	3208	3273	457	1	65	0.0153846
NODE_483_length_3442_cov_17.799880	3208	3273	463	1	65	0.0153846
NODE_483_length_3442_cov_17.799880	3208	3273	468	1	65	0.0153846
NODE_483_length_3442_cov_17.799880	3208	3273	481	1	65	0.0153846
NODE_483_length_3442_cov_17.799880	3208	3273	490	1	65	0.0153846
NODE_483_length_3442_cov_17.799880	3208	3273	491	1	65	0.0153846
NODE_486_length_3429_cov_5.070270	125	148	49	2	23	0.0869565
NODE_486_length_3429_cov_5.070270	125	148	51	6	23	0.2608696
NODE_486_length_3429_cov_5.070270	125	148	53	1	23	0.0434783
NODE_486_length_3429_cov_5.070270	125	148	55	9	23	0.3913043
NODE_486_length_3429_cov_5.070270	125	148	58	2	23	0.0869565
NODE_486_length_3429_cov_5.070270	125	148	59	3	23	0.1304348
NODE_493_length_3408_cov_2.406769	0	45	0	45	45	1.0000000
NODE_495_length_3405_cov_44.930127	2683	2759	2	2	76	0.0263158
NODE_495_length_3405_cov_44.930127	2683	2759	5	12	76	0.1578947
NODE_495_length_3405_cov_44.930127	2683	2759	9	11	76	0.1447368
NODE_495_length_3405_cov_44.930127	2683	2759	15	6	76	0.0789474
NODE_495_length_3405_cov_44.930127	2683	2759	16	7	76	0.0921053
NODE_495_length_3405_cov_44.930127	2683	2759	17	2	76	0.0263158
NODE_495_length_3405_cov_44.930127	2683	2759	18	36	76	0.4736842
NODE_495_length_3405_cov_44.930127	3116	3164	8	48	48	1.0000000
NODE_496_length_3402_cov_28.961550	128	183	0	15	55	0.2727273
NODE_496_length_3402_cov_28.961550	128	183	2	12	55	0.2181818
NODE_496_length_3402_cov_28.961550	128	183	4	18	55	0.3272727
NODE_496_length_3402_cov_28.961550	128	183	6	10	55	0.1818182
NODE_496_length_3402_cov_28.961550	3154	3234	38	15	80	0.1875000
NODE_496_length_3402_cov_28.961550	3154	3234	40	15	80	0.1875000
NODE_496_length_3402_cov_28.961550	3154	3234	42	5	80	0.0625000
NODE_496_length_3402_cov_28.961550	3154	3234	46	13	80	0.1625000
NODE_496_length_3402_cov_28.961550	3154	3234	47	1	80	0.0125000
NODE_496_length_3402_cov_28.961550	3154	3234	48	16	80	0.2000000
NODE_496_length_3402_cov_28.961550	3154	3234	50	7	80	0.0875000
NODE_496_length_3402_cov_28.961550	3154	3234	52	8	80	0.1000000
NODE_496_length_3402_cov_28.961550	3207	3287	2	2	80	0.0250000
NODE_496_length_3402_cov_28.961550	3207	3287	10	1	80	0.0125000
NODE_496_length_3402_cov_28.961550	3207	3287	16	3	80	0.0375000
NODE_496_length_3402_cov_28.961550	3207	3287	19	1	80	0.0125000
NODE_496_length_3402_cov_28.961550	3207	3287	20	3	80	0.0375000
NODE_496_length_3402_cov_28.961550	3207	3287	26	6	80	0.0750000
NODE_496_length_3402_cov_28.961550	3207	3287	28	7	80	0.0875000
NODE_496_length_3402_cov_28.961550	3207	3287	30	4	80	0.0500000
NODE_496_length_3402_cov_28.961550	3207	3287	31	6	80	0.0750000
NODE_496_length_3402_cov_28.961550	3207	3287	33	3	80	0.0375000
NODE_496_length_3402_cov_28.961550	3207	3287	34	12	80	0.1500000
NODE_496_length_3402_cov_28.961550	3207	3287	36	4	80	0.0500000
NODE_496_length_3402_cov_28.961550	3207	3287	38	12	80	0.1500000
NODE_496_length_3402_cov_28.961550	3207	3287	40	6	80	0.0750000
NODE_496_length_3402_cov_28.961550	3207	3287	42	2	80	0.0250000
NODE_496_length_3402_cov_28.961550	3207	3287	46	8	80	0.1000000
NODE_498_length_3393_cov_43.623558	1009	1075	2	1	66	0.0151515
NODE_498_length_3393_cov_43.623558	1009	1075	6	5	66	0.0757576
NODE_498_length_3393_cov_43.623558	1009	1075	15	2	66	0.0303030
NODE_498_length_3393_cov_43.623558	1009	1075	16	2	66	0.0303030
NODE_498_length_3393_cov_43.623558	1009	1075	18	2	66	0.0303030
NODE_498_length_3393_cov_43.623558	1009	1075	20	1	66	0.0151515
NODE_498_length_3393_cov_43.623558	1009	1075	22	5	66	0.0757576
NODE_498_length_3393_cov_43.623558	1009	1075	24	2	66	0.0303030
NODE_498_length_3393_cov_43.623558	1009	1075	26	3	66	0.0454545
NODE_498_length_3393_cov_43.623558	1009	1075	27	4	66	0.0606061
NODE_498_length_3393_cov_43.623558	1009	1075	29	1	66	0.0151515
NODE_498_length_3393_cov_43.623558	1009	1075	31	1	66	0.0151515
NODE_498_length_3393_cov_43.623558	1009	1075	34	1	66	0.0151515
NODE_498_length_3393_cov_43.623558	1009	1075	35	1	66	0.0151515
NODE_498_length_3393_cov_43.623558	1009	1075	39	4	66	0.0606061
NODE_498_length_3393_cov_43.623558	1009	1075	41	4	66	0.0606061
NODE_498_length_3393_cov_43.623558	1009	1075	43	1	66	0.0151515
NODE_498_length_3393_cov_43.623558	1009	1075	49	1	66	0.0151515
NODE_498_length_3393_cov_43.623558	1009	1075	51	1	66	0.0151515
NODE_498_length_3393_cov_43.623558	1009	1075	55	1	66	0.0151515
NODE_498_length_3393_cov_43.623558	1009	1075	56	1	66	0.0151515
NODE_498_length_3393_cov_43.623558	1009	1075	62	1	66	0.0151515
NODE_498_length_3393_cov_43.623558	1009	1075	64	2	66	0.0303030
NODE_498_length_3393_cov_43.623558	1009	1075	66	3	66	0.0454545
NODE_498_length_3393_cov_43.623558	1009	1075	69	3	66	0.0454545
NODE_498_length_3393_cov_43.623558	1009	1075	71	7	66	0.1060606
NODE_498_length_3393_cov_43.623558	1009	1075	73	6	66	0.0909091
NODE_498_length_3393_cov_43.623558	1048	1128	0	19	80	0.2375000
NODE_498_length_3393_cov_43.623558	1048	1128	1	34	80	0.4250000
NODE_498_length_3393_cov_43.623558	1048	1128	2	1	80	0.0125000
NODE_498_length_3393_cov_43.623558	1048	1128	6	5	80	0.0625000
NODE_498_length_3393_cov_43.623558	1048	1128	15	2	80	0.0250000
NODE_498_length_3393_cov_43.623558	1048	1128	16	2	80	0.0250000
NODE_498_length_3393_cov_43.623558	1048	1128	18	2	80	0.0250000
NODE_498_length_3393_cov_43.623558	1048	1128	20	1	80	0.0125000
NODE_498_length_3393_cov_43.623558	1048	1128	22	5	80	0.0625000
NODE_498_length_3393_cov_43.623558	1048	1128	24	2	80	0.0250000
NODE_498_length_3393_cov_43.623558	1048	1128	26	3	80	0.0375000
NODE_498_length_3393_cov_43.623558	1048	1128	27	4	80	0.0500000
NODE_498_length_3393_cov_43.623558	3086	3128	23	1	42	0.0238095
NODE_498_length_3393_cov_43.623558	3086	3128	101	1	42	0.0238095
NODE_498_length_3393_cov_43.623558	3086	3128	110	1	42	0.0238095
NODE_498_length_3393_cov_43.623558	3086	3128	170	1	42	0.0238095
NODE_498_length_3393_cov_43.623558	3086	3128	196	1	42	0.0238095
NODE_498_length_3393_cov_43.623558	3086	3128	231	1	42	0.0238095
NODE_498_length_3393_cov_43.623558	3086	3128	240	1	42	0.0238095
NODE_498_length_3393_cov_43.623558	3086	3128	263	1	42	0.0238095
NODE_498_length_3393_cov_43.623558	3086	3128	275	1	42	0.0238095
NODE_498_length_3393_cov_43.623558	3086	3128	284	1	42	0.0238095
NODE_498_length_3393_cov_43.623558	3086	3128	285	1	42	0.0238095
NODE_498_length_3393_cov_43.623558	3086	3128	292	1	42	0.0238095
NODE_498_length_3393_cov_43.623558	3086	3128	295	1	42	0.0238095
NODE_498_length_3393_cov_43.623558	3086	3128	297	1	42	0.0238095
NODE_498_length_3393_cov_43.623558	3086	3128	299	1	42	0.0238095
NODE_498_length_3393_cov_43.623558	3086	3128	302	1	42	0.0238095
NODE_498_length_3393_cov_43.623558	3086	3128	310	1	42	0.0238095
NODE_498_length_3393_cov_43.623558	3086	3128	312	3	42	0.0714286
NODE_498_length_3393_cov_43.623558	3086	3128	315	1	42	0.0238095
NODE_498_length_3393_cov_43.623558	3086	3128	328	1	42	0.0238095
NODE_498_length_3393_cov_43.623558	3086	3128	347	1	42	0.0238095
NODE_498_length_3393_cov_43.623558	3086	3128	357	1	42	0.0238095
NODE_498_length_3393_cov_43.623558	3086	3128	375	1	42	0.0238095
NODE_498_length_3393_cov_43.623558	3086	3128	381	1	42	0.0238095
NODE_498_length_3393_cov_43.623558	3086	3128	388	1	42	0.0238095
NODE_498_length_3393_cov_43.623558	3086	3128	393	1	42	0.0238095
NODE_498_length_3393_cov_43.623558	3086	3128	395	1	42	0.0238095
NODE_498_length_3393_cov_43.623558	3086	3128	398	1	42	0.0238095
NODE_498_length_3393_cov_43.623558	3086	3128	406	1	42	0.0238095
NODE_498_length_3393_cov_43.623558	3086	3128	413	1	42	0.0238095
NODE_498_length_3393_cov_43.623558	3086	3128	437	1	42	0.0238095
NODE_498_length_3393_cov_43.623558	3086	3128	450	2	42	0.0476190
NODE_498_length_3393_cov_43.623558	3086	3128	465	1	42	0.0238095
NODE_498_length_3393_cov_43.623558	3086	3128	473	1	42	0.0238095
NODE_498_length_3393_cov_43.623558	3086	3128	478	1	42	0.0238095
NODE_498_length_3393_cov_43.623558	3086	3128	494	1	42	0.0238095
NODE_498_length_3393_cov_43.623558	3086	3128	496	1	42	0.0238095
NODE_498_length_3393_cov_43.623558	3086	3128	498	1	42	0.0238095
NODE_498_length_3393_cov_43.623558	3086	3128	509	1	42	0.0238095
NODE_498_length_3393_cov_43.623558	3293	3373	243	1	80	0.0125000
NODE_498_length_3393_cov_43.623558	3293	3373	247	1	80	0.0125000
NODE_498_length_3393_cov_43.623558	3293	3373	256	1	80	0.0125000
NODE_498_length_3393_cov_43.623558	3293	3373	279	1	80	0.0125000
NODE_498_length_3393_cov_43.623558	3293	3373	308	1	80	0.0125000
NODE_498_length_3393_cov_43.623558	3293	3373	316	1	80	0.0125000
NODE_498_length_3393_cov_43.623558	3293	3373	320	2	80	0.0250000
NODE_498_length_3393_cov_43.623558	3293	3373	327	2	80	0.0250000
NODE_498_length_3393_cov_43.623558	3293	3373	338	1	80	0.0125000
NODE_498_length_3393_cov_43.623558	3293	3373	342	1	80	0.0125000
NODE_498_length_3393_cov_43.623558	3293	3373	370	1	80	0.0125000
NODE_498_length_3393_cov_43.623558	3293	3373	375	1	80	0.0125000
NODE_498_length_3393_cov_43.623558	3293	3373	396	1	80	0.0125000
NODE_498_length_3393_cov_43.623558	3293	3373	402	1	80	0.0125000
NODE_498_length_3393_cov_43.623558	3293	3373	411	1	80	0.0125000
NODE_498_length_3393_cov_43.623558	3293	3373	429	1	80	0.0125000
NODE_498_length_3393_cov_43.623558	3293	3373	457	1	80	0.0125000
NODE_498_length_3393_cov_43.623558	3293	3373	466	1	80	0.0125000
NODE_498_length_3393_cov_43.623558	3293	3373	477	1	80	0.0125000
NODE_498_length_3393_cov_43.623558	3293	3373	504	1	80	0.0125000
NODE_498_length_3393_cov_43.623558	3293	3373	513	1	80	0.0125000
NODE_498_length_3393_cov_43.623558	3293	3373	523	1	80	0.0125000
NODE_498_length_3393_cov_43.623558	3293	3373	533	1	80	0.0125000
NODE_498_length_3393_cov_43.623558	3293	3373	570	2	80	0.0250000
NODE_498_length_3393_cov_43.623558	3293	3373	581	1	80	0.0125000
NODE_498_length_3393_cov_43.623558	3293	3373	584	2	80	0.0250000
NODE_498_length_3393_cov_43.623558	3293	3373	586	2	80	0.0250000
NODE_498_length_3393_cov_43.623558	3293	3373	595	1	80	0.0125000
NODE_498_length_3393_cov_43.623558	3293	3373	599	1	80	0.0125000
NODE_498_length_3393_cov_43.623558	3293	3373	611	1	80	0.0125000
NODE_498_length_3393_cov_43.623558	3293	3373	620	1	80	0.0125000
NODE_498_length_3393_cov_43.623558	3293	3373	626	2	80	0.0250000
NODE_498_length_3393_cov_43.623558	3293	3373	634	1	80	0.0125000
NODE_498_length_3393_cov_43.623558	3293	3373	639	1	80	0.0125000
NODE_498_length_3393_cov_43.623558	3293	3373	655	1	80	0.0125000
NODE_498_length_3393_cov_43.623558	3293	3373	662	1	80	0.0125000
NODE_498_length_3393_cov_43.623558	3293	3373	666	2	80	0.0250000
NODE_498_length_3393_cov_43.623558	3293	3373	670	1	80	0.0125000
NODE_498_length_3393_cov_43.623558	3293	3373	678	1	80	0.0125000
NODE_498_length_3393_cov_43.623558	3293	3373	695	1	80	0.0125000
NODE_498_length_3393_cov_43.623558	3293	3373	699	1	80	0.0125000
NODE_498_length_3393_cov_43.623558	3293	3373	704	1	80	0.0125000
NODE_498_length_3393_cov_43.623558	3293	3373	711	1	80	0.0125000
NODE_498_length_3393_cov_43.623558	3293	3373	715	1	80	0.0125000
NODE_498_length_3393_cov_43.623558	3293	3373	720	1	80	0.0125000
NODE_498_length_3393_cov_43.623558	3293	3373	727	1	80	0.0125000
NODE_498_length_3393_cov_43.623558	3293	3373	729	2	80	0.0250000
NODE_498_length_3393_cov_43.623558	3293	3373	730	1	80	0.0125000
NODE_498_length_3393_cov_43.623558	3293	3373	743	1	80	0.0125000
NODE_498_length_3393_cov_43.623558	3293	3373	745	1	80	0.0125000
NODE_498_length_3393_cov_43.623558	3293	3373	755	1	80	0.0125000
NODE_498_length_3393_cov_43.623558	3293	3373	757	3	80	0.0375000
NODE_498_length_3393_cov_43.623558	3293	3373	765	1	80	0.0125000
NODE_498_length_3393_cov_43.623558	3293	3373	774	1	80	0.0125000
NODE_498_length_3393_cov_43.623558	3293	3373	778	1	80	0.0125000
NODE_498_length_3393_cov_43.623558	3293	3373	789	1	80	0.0125000
NODE_498_length_3393_cov_43.623558	3293	3373	795	1	80	0.0125000
NODE_498_length_3393_cov_43.623558	3293	3373	799	1	80	0.0125000
NODE_498_length_3393_cov_43.623558	3293	3373	806	1	80	0.0125000
NODE_498_length_3393_cov_43.623558	3293	3373	811	1	80	0.0125000
NODE_498_length_3393_cov_43.623558	3293	3373	814	1	80	0.0125000
NODE_498_length_3393_cov_43.623558	3293	3373	817	1	80	0.0125000
NODE_498_length_3393_cov_43.623558	3293	3373	819	1	80	0.0125000
NODE_498_length_3393_cov_43.623558	3293	3373	829	1	80	0.0125000
NODE_498_length_3393_cov_43.623558	3293	3373	839	1	80	0.0125000
NODE_498_length_3393_cov_43.623558	3293	3373	843	1	80	0.0125000
NODE_498_length_3393_cov_43.623558	3293	3373	849	1	80	0.0125000
NODE_498_length_3393_cov_43.623558	3293	3373	853	1	80	0.0125000
NODE_498_length_3393_cov_43.623558	3293	3373	860	1	80	0.0125000
NODE_498_length_3393_cov_43.623558	3293	3373	862	1	80	0.0125000
NODE_499_length_3392_cov_41.514728	255	335	4	32	80	0.4000000
NODE_499_length_3392_cov_41.514728	255	335	6	48	80	0.6000000
NODE_499_length_3392_cov_41.514728	308	388	0	1	80	0.0125000
NODE_499_length_3392_cov_41.514728	308	388	2	1	80	0.0125000
NODE_499_length_3392_cov_41.514728	308	388	4	78	80	0.9750000
NODE_499_length_3392_cov_41.514728	917	997	340	1	80	0.0125000
NODE_499_length_3392_cov_41.514728	917	997	343	1	80	0.0125000
NODE_499_length_3392_cov_41.514728	917	997	347	1	80	0.0125000
NODE_499_length_3392_cov_41.514728	917	997	352	1	80	0.0125000
NODE_499_length_3392_cov_41.514728	917	997	359	1	80	0.0125000
NODE_499_length_3392_cov_41.514728	917	997	367	1	80	0.0125000
NODE_499_length_3392_cov_41.514728	917	997	371	1	80	0.0125000
NODE_499_length_3392_cov_41.514728	917	997	376	1	80	0.0125000
NODE_499_length_3392_cov_41.514728	917	997	383	1	80	0.0125000
NODE_499_length_3392_cov_41.514728	917	997	385	1	80	0.0125000
NODE_499_length_3392_cov_41.514728	917	997	401	1	80	0.0125000
NODE_499_length_3392_cov_41.514728	917	997	415	1	80	0.0125000
NODE_499_length_3392_cov_41.514728	917	997	427	1	80	0.0125000
NODE_499_length_3392_cov_41.514728	917	997	439	1	80	0.0125000
NODE_499_length_3392_cov_41.514728	917	997	448	1	80	0.0125000
NODE_499_length_3392_cov_41.514728	917	997	452	1	80	0.0125000
NODE_499_length_3392_cov_41.514728	917	997	466	1	80	0.0125000
NODE_499_length_3392_cov_41.514728	917	997	473	1	80	0.0125000
NODE_499_length_3392_cov_41.514728	917	997	497	1	80	0.0125000
NODE_499_length_3392_cov_41.514728	917	997	511	1	80	0.0125000
NODE_499_length_3392_cov_41.514728	917	997	522	1	80	0.0125000
NODE_499_length_3392_cov_41.514728	917	997	528	1	80	0.0125000
NODE_499_length_3392_cov_41.514728	917	997	534	1	80	0.0125000
NODE_499_length_3392_cov_41.514728	917	997	539	1	80	0.0125000
NODE_499_length_3392_cov_41.514728	917	997	542	1	80	0.0125000
NODE_499_length_3392_cov_41.514728	917	997	545	1	80	0.0125000
NODE_499_length_3392_cov_41.514728	917	997	547	1	80	0.0125000
NODE_499_length_3392_cov_41.514728	917	997	549	2	80	0.0250000
NODE_499_length_3392_cov_41.514728	917	997	557	1	80	0.0125000
NODE_499_length_3392_cov_41.514728	917	997	567	2	80	0.0250000
NODE_499_length_3392_cov_41.514728	917	997	570	1	80	0.0125000
NODE_499_length_3392_cov_41.514728	917	997	572	1	80	0.0125000
NODE_499_length_3392_cov_41.514728	917	997	580	1	80	0.0125000
NODE_499_length_3392_cov_41.514728	917	997	590	1	80	0.0125000
NODE_499_length_3392_cov_41.514728	917	997	607	1	80	0.0125000
NODE_499_length_3392_cov_41.514728	917	997	610	1	80	0.0125000
NODE_499_length_3392_cov_41.514728	917	997	611	1	80	0.0125000
NODE_499_length_3392_cov_41.514728	917	997	613	1	80	0.0125000
NODE_499_length_3392_cov_41.514728	917	997	615	1	80	0.0125000
NODE_499_length_3392_cov_41.514728	917	997	617	2	80	0.0250000
NODE_499_length_3392_cov_41.514728	917	997	618	1	80	0.0125000
NODE_499_length_3392_cov_41.514728	917	997	619	2	80	0.0250000
NODE_499_length_3392_cov_41.514728	917	997	630	1	80	0.0125000
NODE_499_length_3392_cov_41.514728	917	997	632	1	80	0.0125000
NODE_499_length_3392_cov_41.514728	917	997	637	1	80	0.0125000
NODE_499_length_3392_cov_41.514728	917	997	639	1	80	0.0125000
NODE_499_length_3392_cov_41.514728	917	997	647	1	80	0.0125000
NODE_499_length_3392_cov_41.514728	917	997	652	1	80	0.0125000
NODE_499_length_3392_cov_41.514728	917	997	655	1	80	0.0125000
NODE_499_length_3392_cov_41.514728	917	997	656	1	80	0.0125000
NODE_499_length_3392_cov_41.514728	917	997	660	1	80	0.0125000
NODE_499_length_3392_cov_41.514728	917	997	681	1	80	0.0125000
NODE_499_length_3392_cov_41.514728	917	997	692	1	80	0.0125000
NODE_499_length_3392_cov_41.514728	917	997	697	1	80	0.0125000
NODE_499_length_3392_cov_41.514728	917	997	705	1	80	0.0125000
NODE_499_length_3392_cov_41.514728	917	997	711	1	80	0.0125000
NODE_499_length_3392_cov_41.514728	917	997	718	1	80	0.0125000
NODE_499_length_3392_cov_41.514728	917	997	724	1	80	0.0125000
NODE_499_length_3392_cov_41.514728	917	997	726	1	80	0.0125000
NODE_499_length_3392_cov_41.514728	917	997	754	1	80	0.0125000
NODE_499_length_3392_cov_41.514728	917	997	766	1	80	0.0125000
NODE_499_length_3392_cov_41.514728	917	997	777	1	80	0.0125000
NODE_499_length_3392_cov_41.514728	917	997	780	1	80	0.0125000
NODE_499_length_3392_cov_41.514728	917	997	785	1	80	0.0125000
NODE_499_length_3392_cov_41.514728	917	997	792	1	80	0.0125000
NODE_499_length_3392_cov_41.514728	917	997	796	2	80	0.0250000
NODE_499_length_3392_cov_41.514728	917	997	797	1	80	0.0125000
NODE_499_length_3392_cov_41.514728	917	997	802	2	80	0.0250000
NODE_499_length_3392_cov_41.514728	917	997	804	4	80	0.0500000
NODE_499_length_3392_cov_41.514728	917	997	806	1	80	0.0125000
NODE_499_length_3392_cov_41.514728	917	997	808	1	80	0.0125000
NODE_499_length_3392_cov_41.514728	970	1053	139	1	83	0.0120482
NODE_499_length_3392_cov_41.514728	970	1053	142	1	83	0.0120482
NODE_499_length_3392_cov_41.514728	970	1053	149	1	83	0.0120482
NODE_499_length_3392_cov_41.514728	970	1053	153	1	83	0.0120482
NODE_499_length_3392_cov_41.514728	970	1053	161	1	83	0.0120482
NODE_499_length_3392_cov_41.514728	970	1053	166	1	83	0.0120482
NODE_499_length_3392_cov_41.514728	970	1053	170	1	83	0.0120482
NODE_499_length_3392_cov_41.514728	970	1053	174	1	83	0.0120482
NODE_499_length_3392_cov_41.514728	970	1053	178	3	83	0.0361446
NODE_499_length_3392_cov_41.514728	970	1053	179	1	83	0.0120482
NODE_499_length_3392_cov_41.514728	970	1053	181	1	83	0.0120482
NODE_499_length_3392_cov_41.514728	970	1053	192	2	83	0.0240964
NODE_499_length_3392_cov_41.514728	970	1053	193	1	83	0.0120482
NODE_499_length_3392_cov_41.514728	970	1053	194	3	83	0.0361446
NODE_499_length_3392_cov_41.514728	970	1053	195	1	83	0.0120482
NODE_499_length_3392_cov_41.514728	970	1053	197	1	83	0.0120482
NODE_499_length_3392_cov_41.514728	970	1053	198	1	83	0.0120482
NODE_499_length_3392_cov_41.514728	970	1053	201	1	83	0.0120482
NODE_499_length_3392_cov_41.514728	970	1053	206	1	83	0.0120482
NODE_499_length_3392_cov_41.514728	970	1053	207	1	83	0.0120482
NODE_499_length_3392_cov_41.514728	970	1053	209	1	83	0.0120482
NODE_499_length_3392_cov_41.514728	970	1053	211	3	83	0.0361446
NODE_499_length_3392_cov_41.514728	970	1053	222	1	83	0.0120482
NODE_499_length_3392_cov_41.514728	970	1053	223	1	83	0.0120482
NODE_499_length_3392_cov_41.514728	970	1053	225	1	83	0.0120482
NODE_499_length_3392_cov_41.514728	970	1053	226	1	83	0.0120482
NODE_499_length_3392_cov_41.514728	970	1053	227	1	83	0.0120482
NODE_499_length_3392_cov_41.514728	970	1053	230	1	83	0.0120482
NODE_499_length_3392_cov_41.514728	970	1053	245	1	83	0.0120482
NODE_499_length_3392_cov_41.514728	970	1053	249	1	83	0.0120482
NODE_499_length_3392_cov_41.514728	970	1053	267	1	83	0.0120482
NODE_499_length_3392_cov_41.514728	970	1053	274	1	83	0.0120482
NODE_499_length_3392_cov_41.514728	970	1053	277	2	83	0.0240964
NODE_499_length_3392_cov_41.514728	970	1053	282	2	83	0.0240964
NODE_499_length_3392_cov_41.514728	970	1053	286	1	83	0.0120482
NODE_499_length_3392_cov_41.514728	970	1053	292	1	83	0.0120482
NODE_499_length_3392_cov_41.514728	970	1053	295	2	83	0.0240964
NODE_499_length_3392_cov_41.514728	970	1053	299	1	83	0.0120482
NODE_499_length_3392_cov_41.514728	970	1053	308	1	83	0.0120482
NODE_499_length_3392_cov_41.514728	970	1053	309	1	83	0.0120482
NODE_499_length_3392_cov_41.514728	970	1053	310	2	83	0.0240964
NODE_499_length_3392_cov_41.514728	970	1053	311	1	83	0.0120482
NODE_499_length_3392_cov_41.514728	970	1053	313	1	83	0.0120482
NODE_499_length_3392_cov_41.514728	970	1053	316	1	83	0.0120482
NODE_499_length_3392_cov_41.514728	970	1053	327	1	83	0.0120482
NODE_499_length_3392_cov_41.514728	970	1053	340	1	83	0.0120482
NODE_499_length_3392_cov_41.514728	970	1053	343	1	83	0.0120482
NODE_499_length_3392_cov_41.514728	970	1053	347	1	83	0.0120482
NODE_499_length_3392_cov_41.514728	970	1053	352	1	83	0.0120482
NODE_499_length_3392_cov_41.514728	970	1053	359	1	83	0.0120482
NODE_499_length_3392_cov_41.514728	970	1053	367	1	83	0.0120482
NODE_499_length_3392_cov_41.514728	970	1053	371	1	83	0.0120482
NODE_499_length_3392_cov_41.514728	970	1053	376	1	83	0.0120482
NODE_499_length_3392_cov_41.514728	970	1053	383	1	83	0.0120482
NODE_499_length_3392_cov_41.514728	970	1053	385	1	83	0.0120482
NODE_499_length_3392_cov_41.514728	970	1053	401	1	83	0.0120482
NODE_499_length_3392_cov_41.514728	970	1053	415	1	83	0.0120482
NODE_499_length_3392_cov_41.514728	970	1053	427	1	83	0.0120482
NODE_499_length_3392_cov_41.514728	970	1053	439	1	83	0.0120482
NODE_499_length_3392_cov_41.514728	970	1053	448	1	83	0.0120482
NODE_499_length_3392_cov_41.514728	970	1053	452	1	83	0.0120482
NODE_499_length_3392_cov_41.514728	970	1053	466	1	83	0.0120482
NODE_499_length_3392_cov_41.514728	970	1053	473	1	83	0.0120482
NODE_499_length_3392_cov_41.514728	970	1053	497	1	83	0.0120482
NODE_499_length_3392_cov_41.514728	970	1053	511	1	83	0.0120482
NODE_499_length_3392_cov_41.514728	970	1053	522	1	83	0.0120482
NODE_499_length_3392_cov_41.514728	970	1053	528	1	83	0.0120482
NODE_499_length_3392_cov_41.514728	970	1053	534	1	83	0.0120482
NODE_499_length_3392_cov_41.514728	970	1053	539	1	83	0.0120482
NODE_499_length_3392_cov_41.514728	970	1053	542	1	83	0.0120482
NODE_499_length_3392_cov_41.514728	970	1053	545	1	83	0.0120482
NODE_499_length_3392_cov_41.514728	970	1053	549	1	83	0.0120482
NODE_501_length_3389_cov_8.244073	2159	2239	0	80	80	1.0000000
NODE_501_length_3389_cov_8.244073	2212	2292	0	80	80	1.0000000
NODE_506_length_3363_cov_4.412684	56	124	28	1	68	0.0147059
NODE_506_length_3363_cov_4.412684	56	124	32	2	68	0.0294118
NODE_506_length_3363_cov_4.412684	56	124	36	3	68	0.0441176
NODE_506_length_3363_cov_4.412684	56	124	48	2	68	0.0294118
NODE_506_length_3363_cov_4.412684	56	124	50	1	68	0.0147059
NODE_506_length_3363_cov_4.412684	56	124	54	1	68	0.0147059
NODE_506_length_3363_cov_4.412684	56	124	60	1	68	0.0147059
NODE_506_length_3363_cov_4.412684	56	124	62	1	68	0.0147059
NODE_506_length_3363_cov_4.412684	56	124	66	2	68	0.0294118
NODE_506_length_3363_cov_4.412684	56	124	76	1	68	0.0147059
NODE_506_length_3363_cov_4.412684	56	124	78	6	68	0.0882353
NODE_506_length_3363_cov_4.412684	56	124	80	1	68	0.0147059
NODE_506_length_3363_cov_4.412684	56	124	82	46	68	0.6764706
NODE_510_length_3353_cov_2.687462	0	61	0	61	61	1.0000000
NODE_510_length_3353_cov_2.687462	0	61	0	61	61	1.0000000
NODE_510_length_3353_cov_2.687462	34	99	0	36	65	0.5538462
NODE_510_length_3353_cov_2.687462	34	99	1	29	65	0.4461538
NODE_513_length_3348_cov_243.959372	2473	2553	707	1	80	0.0125000
NODE_513_length_3348_cov_243.959372	2473	2553	710	1	80	0.0125000
NODE_513_length_3348_cov_243.959372	2473	2553	721	1	80	0.0125000
NODE_513_length_3348_cov_243.959372	2473	2553	723	1	80	0.0125000
NODE_513_length_3348_cov_243.959372	2473	2553	725	1	80	0.0125000
NODE_513_length_3348_cov_243.959372	2473	2553	736	1	80	0.0125000
NODE_513_length_3348_cov_243.959372	2473	2553	737	2	80	0.0250000
NODE_513_length_3348_cov_243.959372	2473	2553	741	1	80	0.0125000
NODE_513_length_3348_cov_243.959372	2473	2553	742	2	80	0.0250000
NODE_513_length_3348_cov_243.959372	2473	2553	744	1	80	0.0125000
NODE_513_length_3348_cov_243.959372	2473	2553	745	1	80	0.0125000
NODE_513_length_3348_cov_243.959372	2473	2553	746	3	80	0.0375000
NODE_513_length_3348_cov_243.959372	2473	2553	747	2	80	0.0250000
NODE_513_length_3348_cov_243.959372	2473	2553	748	2	80	0.0250000
NODE_513_length_3348_cov_243.959372	2473	2553	749	3	80	0.0375000
NODE_513_length_3348_cov_243.959372	2473	2553	750	1	80	0.0125000
NODE_513_length_3348_cov_243.959372	2473	2553	751	1	80	0.0125000
NODE_513_length_3348_cov_243.959372	2473	2553	752	1	80	0.0125000
NODE_513_length_3348_cov_243.959372	2473	2553	753	1	80	0.0125000
NODE_513_length_3348_cov_243.959372	2473	2553	754	2	80	0.0250000
NODE_513_length_3348_cov_243.959372	2473	2553	755	2	80	0.0250000
NODE_513_length_3348_cov_243.959372	2473	2553	757	1	80	0.0125000
NODE_513_length_3348_cov_243.959372	2473	2553	758	1	80	0.0125000
NODE_513_length_3348_cov_243.959372	2473	2553	760	1	80	0.0125000
NODE_513_length_3348_cov_243.959372	2473	2553	762	1	80	0.0125000
NODE_513_length_3348_cov_243.959372	2473	2553	763	1	80	0.0125000
NODE_513_length_3348_cov_243.959372	2473	2553	766	1	80	0.0125000
NODE_513_length_3348_cov_243.959372	2473	2553	768	1	80	0.0125000
NODE_513_length_3348_cov_243.959372	2473	2553	771	1	80	0.0125000
NODE_513_length_3348_cov_243.959372	2473	2553	772	2	80	0.0250000
NODE_513_length_3348_cov_243.959372	2473	2553	773	1	80	0.0125000
NODE_513_length_3348_cov_243.959372	2473	2553	774	2	80	0.0250000
NODE_513_length_3348_cov_243.959372	2473	2553	775	1	80	0.0125000
NODE_513_length_3348_cov_243.959372	2473	2553	777	1	80	0.0125000
NODE_513_length_3348_cov_243.959372	2473	2553	778	1	80	0.0125000
NODE_513_length_3348_cov_243.959372	2473	2553	779	1	80	0.0125000
NODE_513_length_3348_cov_243.959372	2473	2553	781	1	80	0.0125000
NODE_513_length_3348_cov_243.959372	2473	2553	783	1	80	0.0125000
NODE_513_length_3348_cov_243.959372	2473	2553	785	1	80	0.0125000
NODE_513_length_3348_cov_243.959372	2473	2553	786	2	80	0.0250000
NODE_513_length_3348_cov_243.959372	2473	2553	787	1	80	0.0125000
NODE_513_length_3348_cov_243.959372	2473	2553	788	2	80	0.0250000
NODE_513_length_3348_cov_243.959372	2473	2553	792	1	80	0.0125000
NODE_513_length_3348_cov_243.959372	2473	2553	797	1	80	0.0125000
NODE_513_length_3348_cov_243.959372	2473	2553	798	1	80	0.0125000
NODE_513_length_3348_cov_243.959372	2473	2553	802	1	80	0.0125000
NODE_513_length_3348_cov_243.959372	2473	2553	803	1	80	0.0125000
NODE_513_length_3348_cov_243.959372	2473	2553	804	1	80	0.0125000
NODE_513_length_3348_cov_243.959372	2473	2553	805	1	80	0.0125000
NODE_513_length_3348_cov_243.959372	2473	2553	808	1	80	0.0125000
NODE_513_length_3348_cov_243.959372	2473	2553	809	1	80	0.0125000
NODE_513_length_3348_cov_243.959372	2473	2553	810	1	80	0.0125000
NODE_513_length_3348_cov_243.959372	2473	2553	811	1	80	0.0125000
NODE_513_length_3348_cov_243.959372	2473	2553	812	1	80	0.0125000
NODE_513_length_3348_cov_243.959372	2473	2553	814	1	80	0.0125000
NODE_513_length_3348_cov_243.959372	2473	2553	815	2	80	0.0250000
NODE_513_length_3348_cov_243.959372	2473	2553	816	1	80	0.0125000
NODE_513_length_3348_cov_243.959372	2473	2553	818	2	80	0.0250000
NODE_513_length_3348_cov_243.959372	2473	2553	819	2	80	0.0250000
NODE_513_length_3348_cov_243.959372	2473	2553	825	2	80	0.0250000
NODE_513_length_3348_cov_243.959372	2473	2553	832	1	80	0.0125000
NODE_513_length_3348_cov_243.959372	2473	2553	839	1	80	0.0125000
NODE_513_length_3348_cov_243.959372	2526	2606	721	1	80	0.0125000
NODE_513_length_3348_cov_243.959372	2526	2606	736	1	80	0.0125000
NODE_513_length_3348_cov_243.959372	2526	2606	741	1	80	0.0125000
NODE_513_length_3348_cov_243.959372	2526	2606	742	1	80	0.0125000
NODE_513_length_3348_cov_243.959372	2526	2606	743	1	80	0.0125000
NODE_513_length_3348_cov_243.959372	2526	2606	745	1	80	0.0125000
NODE_513_length_3348_cov_243.959372	2526	2606	747	2	80	0.0250000
NODE_513_length_3348_cov_243.959372	2526	2606	750	1	80	0.0125000
NODE_513_length_3348_cov_243.959372	2526	2606	755	1	80	0.0125000
NODE_513_length_3348_cov_243.959372	2526	2606	756	1	80	0.0125000
NODE_513_length_3348_cov_243.959372	2526	2606	758	1	80	0.0125000
NODE_513_length_3348_cov_243.959372	2526	2606	760	1	80	0.0125000
NODE_513_length_3348_cov_243.959372	2526	2606	762	1	80	0.0125000
NODE_513_length_3348_cov_243.959372	2526	2606	772	2	80	0.0250000
NODE_513_length_3348_cov_243.959372	2526	2606	774	1	80	0.0125000
NODE_513_length_3348_cov_243.959372	2526	2606	777	1	80	0.0125000
NODE_513_length_3348_cov_243.959372	2526	2606	779	3	80	0.0375000
NODE_513_length_3348_cov_243.959372	2526	2606	780	1	80	0.0125000
NODE_513_length_3348_cov_243.959372	2526	2606	781	1	80	0.0125000
NODE_513_length_3348_cov_243.959372	2526	2606	782	2	80	0.0250000
NODE_513_length_3348_cov_243.959372	2526	2606	783	2	80	0.0250000
NODE_513_length_3348_cov_243.959372	2526	2606	784	1	80	0.0125000
NODE_513_length_3348_cov_243.959372	2526	2606	785	2	80	0.0250000
NODE_513_length_3348_cov_243.959372	2526	2606	792	1	80	0.0125000
NODE_513_length_3348_cov_243.959372	2526	2606	797	1	80	0.0125000
NODE_513_length_3348_cov_243.959372	2526	2606	798	2	80	0.0250000
NODE_513_length_3348_cov_243.959372	2526	2606	802	2	80	0.0250000
NODE_513_length_3348_cov_243.959372	2526	2606	805	1	80	0.0125000
NODE_513_length_3348_cov_243.959372	2526	2606	808	1	80	0.0125000
NODE_513_length_3348_cov_243.959372	2526	2606	809	2	80	0.0250000
NODE_513_length_3348_cov_243.959372	2526	2606	810	1	80	0.0125000
NODE_513_length_3348_cov_243.959372	2526	2606	811	2	80	0.0250000
NODE_513_length_3348_cov_243.959372	2526	2606	812	2	80	0.0250000
NODE_513_length_3348_cov_243.959372	2526	2606	814	1	80	0.0125000
NODE_513_length_3348_cov_243.959372	2526	2606	815	2	80	0.0250000
NODE_513_length_3348_cov_243.959372	2526	2606	816	2	80	0.0250000
NODE_513_length_3348_cov_243.959372	2526	2606	818	4	80	0.0500000
NODE_513_length_3348_cov_243.959372	2526	2606	819	2	80	0.0250000
NODE_513_length_3348_cov_243.959372	2526	2606	820	1	80	0.0125000
NODE_513_length_3348_cov_243.959372	2526	2606	822	1	80	0.0125000
NODE_513_length_3348_cov_243.959372	2526	2606	824	3	80	0.0375000
NODE_513_length_3348_cov_243.959372	2526	2606	825	5	80	0.0625000
NODE_513_length_3348_cov_243.959372	2526	2606	826	1	80	0.0125000
NODE_513_length_3348_cov_243.959372	2526	2606	827	2	80	0.0250000
NODE_513_length_3348_cov_243.959372	2526	2606	829	3	80	0.0375000
NODE_513_length_3348_cov_243.959372	2526	2606	830	1	80	0.0125000
NODE_513_length_3348_cov_243.959372	2526	2606	831	1	80	0.0125000
NODE_513_length_3348_cov_243.959372	2526	2606	832	2	80	0.0250000
NODE_513_length_3348_cov_243.959372	2526	2606	833	3	80	0.0375000
NODE_513_length_3348_cov_243.959372	2526	2606	839	1	80	0.0125000
NODE_514_length_3348_cov_31.953216	103	183	0	80	80	1.0000000
NODE_514_length_3348_cov_31.953216	105	179	0	74	74	1.0000000
NODE_514_length_3348_cov_31.953216	156	236	0	55	80	0.6875000
NODE_514_length_3348_cov_31.953216	156	236	2	3	80	0.0375000
NODE_514_length_3348_cov_31.953216	156	236	4	22	80	0.2750000
NODE_514_length_3348_cov_31.953216	156	236	0	55	80	0.6875000
NODE_514_length_3348_cov_31.953216	156	236	2	3	80	0.0375000
NODE_514_length_3348_cov_31.953216	156	236	4	22	80	0.2750000
NODE_514_length_3348_cov_31.953216	2405	2476	138	1	71	0.0140845
NODE_514_length_3348_cov_31.953216	2405	2476	141	1	71	0.0140845
NODE_514_length_3348_cov_31.953216	2405	2476	142	1	71	0.0140845
NODE_514_length_3348_cov_31.953216	2405	2476	143	1	71	0.0140845
NODE_514_length_3348_cov_31.953216	2405	2476	144	3	71	0.0422535
NODE_514_length_3348_cov_31.953216	2405	2476	145	4	71	0.0563380
NODE_514_length_3348_cov_31.953216	2405	2476	147	6	71	0.0845070
NODE_514_length_3348_cov_31.953216	2405	2476	149	4	71	0.0563380
NODE_514_length_3348_cov_31.953216	2405	2476	150	3	71	0.0422535
NODE_514_length_3348_cov_31.953216	2405	2476	151	3	71	0.0422535
NODE_514_length_3348_cov_31.953216	2405	2476	152	2	71	0.0281690
NODE_514_length_3348_cov_31.953216	2405	2476	153	1	71	0.0140845
NODE_514_length_3348_cov_31.953216	2405	2476	156	2	71	0.0281690
NODE_514_length_3348_cov_31.953216	2405	2476	158	2	71	0.0281690
NODE_514_length_3348_cov_31.953216	2405	2476	159	1	71	0.0140845
NODE_514_length_3348_cov_31.953216	2405	2476	160	1	71	0.0140845
NODE_514_length_3348_cov_31.953216	2405	2476	162	1	71	0.0140845
NODE_514_length_3348_cov_31.953216	2405	2476	163	4	71	0.0563380
NODE_514_length_3348_cov_31.953216	2405	2476	166	1	71	0.0140845
NODE_514_length_3348_cov_31.953216	2405	2476	167	2	71	0.0281690
NODE_514_length_3348_cov_31.953216	2405	2476	169	2	71	0.0281690
NODE_514_length_3348_cov_31.953216	2405	2476	170	3	71	0.0422535
NODE_514_length_3348_cov_31.953216	2405	2476	171	3	71	0.0422535
NODE_514_length_3348_cov_31.953216	2405	2476	172	3	71	0.0422535
NODE_514_length_3348_cov_31.953216	2405	2476	173	5	71	0.0704225
NODE_514_length_3348_cov_31.953216	2405	2476	175	1	71	0.0140845
NODE_514_length_3348_cov_31.953216	2405	2476	176	2	71	0.0281690
NODE_514_length_3348_cov_31.953216	2405	2476	177	1	71	0.0140845
NODE_514_length_3348_cov_31.953216	2405	2476	179	1	71	0.0140845
NODE_514_length_3348_cov_31.953216	2405	2476	191	2	71	0.0281690
NODE_514_length_3348_cov_31.953216	2405	2476	193	2	71	0.0281690
NODE_514_length_3348_cov_31.953216	2405	2476	195	2	71	0.0281690
NODE_514_length_3348_cov_31.953216	2458	2529	166	1	71	0.0140845
NODE_514_length_3348_cov_31.953216	2458	2529	167	2	71	0.0281690
NODE_514_length_3348_cov_31.953216	2458	2529	169	1	71	0.0140845
NODE_514_length_3348_cov_31.953216	2458	2529	171	1	71	0.0140845
NODE_514_length_3348_cov_31.953216	2458	2529	172	1	71	0.0140845
NODE_514_length_3348_cov_31.953216	2458	2529	173	3	71	0.0422535
NODE_514_length_3348_cov_31.953216	2458	2529	176	1	71	0.0140845
NODE_514_length_3348_cov_31.953216	2458	2529	177	1	71	0.0140845
NODE_514_length_3348_cov_31.953216	2458	2529	179	1	71	0.0140845
NODE_514_length_3348_cov_31.953216	2458	2529	191	3	71	0.0422535
NODE_514_length_3348_cov_31.953216	2458	2529	193	2	71	0.0281690
NODE_514_length_3348_cov_31.953216	2458	2529	195	8	71	0.1126761
NODE_514_length_3348_cov_31.953216	2458	2529	197	1	71	0.0140845
NODE_514_length_3348_cov_31.953216	2458	2529	200	1	71	0.0140845
NODE_514_length_3348_cov_31.953216	2458	2529	201	2	71	0.0281690
NODE_514_length_3348_cov_31.953216	2458	2529	202	1	71	0.0140845
NODE_514_length_3348_cov_31.953216	2458	2529	203	1	71	0.0140845
NODE_514_length_3348_cov_31.953216	2458	2529	205	1	71	0.0140845
NODE_514_length_3348_cov_31.953216	2458	2529	212	1	71	0.0140845
NODE_514_length_3348_cov_31.953216	2458	2529	216	1	71	0.0140845
NODE_514_length_3348_cov_31.953216	2458	2529	218	1	71	0.0140845
NODE_514_length_3348_cov_31.953216	2458	2529	221	2	71	0.0281690
NODE_514_length_3348_cov_31.953216	2458	2529	222	3	71	0.0422535
NODE_514_length_3348_cov_31.953216	2458	2529	223	2	71	0.0281690
NODE_514_length_3348_cov_31.953216	2458	2529	224	7	71	0.0985916
NODE_514_length_3348_cov_31.953216	2458	2529	225	6	71	0.0845070
NODE_514_length_3348_cov_31.953216	2458	2529	226	1	71	0.0140845
NODE_514_length_3348_cov_31.953216	2458	2529	227	7	71	0.0985916
NODE_514_length_3348_cov_31.953216	2458	2529	228	1	71	0.0140845
NODE_514_length_3348_cov_31.953216	2458	2529	229	3	71	0.0422535
NODE_514_length_3348_cov_31.953216	2458	2529	230	3	71	0.0422535
NODE_514_length_3348_cov_31.953216	2458	2529	231	1	71	0.0140845
NODE_517_length_3335_cov_19.649567	2100	2180	8	53	80	0.6625000
NODE_517_length_3335_cov_19.649567	2100	2180	10	14	80	0.1750000
NODE_517_length_3335_cov_19.649567	2100	2180	11	2	80	0.0250000
NODE_517_length_3335_cov_19.649567	2100	2180	12	11	80	0.1375000
NODE_517_length_3335_cov_19.649567	2153	2233	0	2	80	0.0250000
NODE_517_length_3335_cov_19.649567	2153	2233	4	38	80	0.4750000
NODE_517_length_3335_cov_19.649567	2153	2233	6	3	80	0.0375000
NODE_517_length_3335_cov_19.649567	2153	2233	8	37	80	0.4625000
NODE_517_length_3335_cov_19.649567	2229	2309	0	78	80	0.9750000
NODE_517_length_3335_cov_19.649567	2229	2309	4	2	80	0.0250000
NODE_517_length_3335_cov_19.649567	2282	2362	0	43	80	0.5375000
NODE_517_length_3335_cov_19.649567	2282	2362	2	37	80	0.4625000
NODE_518_length_3333_cov_24.805504	734	814	0	37	80	0.4625000
NODE_518_length_3333_cov_24.805504	734	814	2	43	80	0.5375000
NODE_518_length_3333_cov_24.805504	787	867	2	80	80	1.0000000
NODE_523_length_3312_cov_6.996576	85	165	0	80	80	1.0000000
NODE_523_length_3312_cov_6.996576	138	218	0	80	80	1.0000000
NODE_525_length_3302_cov_3.859195	3184	3262	12	4	78	0.0512821
NODE_525_length_3302_cov_3.859195	3184	3262	18	16	78	0.2051282
NODE_525_length_3302_cov_3.859195	3184	3262	24	26	78	0.3333333
NODE_525_length_3302_cov_3.859195	3184	3262	26	5	78	0.0641026
NODE_525_length_3302_cov_3.859195	3184	3262	28	27	78	0.3461539
NODE_525_length_3302_cov_3.859195	3184	3253	18	11	69	0.1594203
NODE_525_length_3302_cov_3.859195	3184	3253	24	26	69	0.3768116
NODE_525_length_3302_cov_3.859195	3184	3253	26	5	69	0.0724638
NODE_525_length_3302_cov_3.859195	3184	3253	28	27	69	0.3913043
NODE_526_length_3299_cov_6.014687	1632	1688	0	11	56	0.1964286
NODE_526_length_3299_cov_6.014687	1632	1688	2	4	56	0.0714286
NODE_526_length_3299_cov_6.014687	1632	1688	6	41	56	0.7321429
NODE_530_length_3290_cov_17.805390	773	853	0	80	80	1.0000000
NODE_530_length_3290_cov_17.805390	826	906	0	80	80	1.0000000
NODE_531_length_3290_cov_12.352554	2749	2829	0	80	80	1.0000000
NODE_531_length_3290_cov_12.352554	2802	2882	0	80	80	1.0000000
NODE_532_length_3286_cov_5.973015	0	50	0	2	50	0.0400000
NODE_532_length_3286_cov_5.973015	0	50	1	9	50	0.1800000
NODE_532_length_3286_cov_5.973015	0	50	3	39	50	0.7800000
NODE_532_length_3286_cov_5.973015	0	50	0	2	50	0.0400000
NODE_532_length_3286_cov_5.973015	0	50	1	9	50	0.1800000
NODE_532_length_3286_cov_5.973015	0	50	3	39	50	0.7800000
NODE_532_length_3286_cov_5.973015	0	50	0	2	50	0.0400000
NODE_532_length_3286_cov_5.973015	0	50	1	9	50	0.1800000
NODE_532_length_3286_cov_5.973015	0	50	3	39	50	0.7800000
NODE_532_length_3286_cov_5.973015	23	89	3	66	66	1.0000000
NODE_532_length_3286_cov_5.973015	23	94	3	71	71	1.0000000
NODE_533_length_3284_cov_6.453689	313	392	0	4	79	0.0506329
NODE_533_length_3284_cov_6.453689	313	392	2	17	79	0.2151899
NODE_533_length_3284_cov_6.453689	313	392	8	58	79	0.7341772
NODE_533_length_3284_cov_6.453689	365	445	4	13	80	0.1625000
NODE_533_length_3284_cov_6.453689	365	445	6	34	80	0.4250000
NODE_533_length_3284_cov_6.453689	365	445	8	33	80	0.4125000
NODE_541_length_3267_cov_12.768624	11	91	4	2	80	0.0250000
NODE_541_length_3267_cov_12.768624	11	91	5	9	80	0.1125000
NODE_541_length_3267_cov_12.768624	11	91	7	1	80	0.0125000
NODE_541_length_3267_cov_12.768624	11	91	9	1	80	0.0125000
NODE_541_length_3267_cov_12.768624	11	91	13	4	80	0.0500000
NODE_541_length_3267_cov_12.768624	11	91	14	1	80	0.0125000
NODE_541_length_3267_cov_12.768624	11	91	16	6	80	0.0750000
NODE_541_length_3267_cov_12.768624	11	91	18	3	80	0.0375000
NODE_541_length_3267_cov_12.768624	11	91	20	1	80	0.0125000
NODE_541_length_3267_cov_12.768624	11	91	24	5	80	0.0625000
NODE_541_length_3267_cov_12.768624	11	91	25	3	80	0.0375000
NODE_541_length_3267_cov_12.768624	11	91	27	23	80	0.2875000
NODE_541_length_3267_cov_12.768624	11	91	28	9	80	0.1125000
NODE_541_length_3267_cov_12.768624	11	91	29	9	80	0.1125000
NODE_541_length_3267_cov_12.768624	11	91	30	3	80	0.0375000
NODE_542_length_3266_cov_14.108304	2620	2684	5	7	64	0.1093750
NODE_542_length_3266_cov_14.108304	2620	2684	9	9	64	0.1406250
NODE_542_length_3266_cov_14.108304	2620	2684	13	2	64	0.0312500
NODE_542_length_3266_cov_14.108304	2620	2684	15	46	64	0.7187500
NODE_542_length_3266_cov_14.108304	2620	2684	5	7	64	0.1093750
NODE_542_length_3266_cov_14.108304	2620	2684	9	9	64	0.1406250
NODE_542_length_3266_cov_14.108304	2620	2684	13	2	64	0.0312500
NODE_542_length_3266_cov_14.108304	2620	2684	15	46	64	0.7187500
NODE_542_length_3266_cov_14.108304	2620	2684	5	7	64	0.1093750
NODE_542_length_3266_cov_14.108304	2620	2684	9	9	64	0.1406250
NODE_542_length_3266_cov_14.108304	2620	2684	13	2	64	0.0312500
NODE_542_length_3266_cov_14.108304	2620	2684	15	46	64	0.7187500
NODE_547_length_3242_cov_12.407891	391	471	0	53	80	0.6625000
NODE_547_length_3242_cov_12.407891	391	471	2	27	80	0.3375000
NODE_547_length_3242_cov_12.407891	444	524	2	80	80	1.0000000
NODE_550_length_3233_cov_19.903957	411	491	0	80	80	1.0000000
NODE_550_length_3233_cov_19.903957	411	491	0	80	80	1.0000000
NODE_550_length_3233_cov_19.903957	464	544	0	80	80	1.0000000
NODE_552_length_3232_cov_11.378870	2586	2621	1	3	35	0.0857143
NODE_552_length_3232_cov_11.378870	2586	2621	2	32	35	0.9142857
NODE_555_length_3214_cov_22.853291	2090	2170	19	2	80	0.0250000
NODE_555_length_3214_cov_22.853291	2090	2170	25	1	80	0.0125000
NODE_555_length_3214_cov_22.853291	2090	2170	27	1	80	0.0125000
NODE_555_length_3214_cov_22.853291	2090	2170	29	2	80	0.0250000
NODE_555_length_3214_cov_22.853291	2090	2170	34	1	80	0.0125000
NODE_555_length_3214_cov_22.853291	2090	2170	36	4	80	0.0500000
NODE_555_length_3214_cov_22.853291	2090	2170	37	5	80	0.0625000
NODE_555_length_3214_cov_22.853291	2090	2170	38	7	80	0.0875000
NODE_555_length_3214_cov_22.853291	2090	2170	39	26	80	0.3250000
NODE_555_length_3214_cov_22.853291	2090	2170	40	4	80	0.0500000
NODE_555_length_3214_cov_22.853291	2090	2170	41	2	80	0.0250000
NODE_555_length_3214_cov_22.853291	2090	2170	42	5	80	0.0625000
NODE_555_length_3214_cov_22.853291	2090	2170	46	2	80	0.0250000
NODE_555_length_3214_cov_22.853291	2090	2170	49	7	80	0.0875000
NODE_555_length_3214_cov_22.853291	2090	2170	51	2	80	0.0250000
NODE_555_length_3214_cov_22.853291	2090	2170	53	9	80	0.1125000
NODE_555_length_3214_cov_22.853291	2143	2223	40	2	80	0.0250000
NODE_555_length_3214_cov_22.853291	2143	2223	42	5	80	0.0625000
NODE_555_length_3214_cov_22.853291	2143	2223	43	2	80	0.0250000
NODE_555_length_3214_cov_22.853291	2143	2223	45	9	80	0.1125000
NODE_555_length_3214_cov_22.853291	2143	2223	46	3	80	0.0375000
NODE_555_length_3214_cov_22.853291	2143	2223	47	1	80	0.0125000
NODE_555_length_3214_cov_22.853291	2143	2223	48	6	80	0.0750000
NODE_555_length_3214_cov_22.853291	2143	2223	49	15	80	0.1875000
NODE_555_length_3214_cov_22.853291	2143	2223	51	9	80	0.1125000
NODE_555_length_3214_cov_22.853291	2143	2223	53	15	80	0.1875000
NODE_555_length_3214_cov_22.853291	2143	2223	54	13	80	0.1625000
NODE_555_length_3214_cov_22.853291	3028	3086	22	4	58	0.0689655
NODE_555_length_3214_cov_22.853291	3028	3086	25	4	58	0.0689655
NODE_555_length_3214_cov_22.853291	3028	3086	31	17	58	0.2931035
NODE_555_length_3214_cov_22.853291	3028	3086	36	1	58	0.0172414
NODE_555_length_3214_cov_22.853291	3028	3086	38	1	58	0.0172414
NODE_555_length_3214_cov_22.853291	3028	3086	40	3	58	0.0517241
NODE_555_length_3214_cov_22.853291	3028	3086	42	3	58	0.0517241
NODE_555_length_3214_cov_22.853291	3028	3086	43	1	58	0.0172414
NODE_555_length_3214_cov_22.853291	3028	3086	44	1	58	0.0172414
NODE_555_length_3214_cov_22.853291	3028	3086	45	1	58	0.0172414
NODE_555_length_3214_cov_22.853291	3028	3086	46	1	58	0.0172414
NODE_555_length_3214_cov_22.853291	3028	3086	48	1	58	0.0172414
NODE_555_length_3214_cov_22.853291	3028	3086	51	5	58	0.0862069
NODE_555_length_3214_cov_22.853291	3028	3086	52	9	58	0.1551724
NODE_555_length_3214_cov_22.853291	3028	3086	53	3	58	0.0517241
NODE_555_length_3214_cov_22.853291	3028	3086	55	1	58	0.0172414
NODE_555_length_3214_cov_22.853291	3028	3086	56	1	58	0.0172414
NODE_555_length_3214_cov_22.853291	3028	3086	58	1	58	0.0172414
NODE_556_length_3211_cov_1.921915	95	175	2	1	80	0.0125000
NODE_556_length_3211_cov_1.921915	95	175	4	2	80	0.0250000
NODE_556_length_3211_cov_1.921915	95	175	10	5	80	0.0625000
NODE_556_length_3211_cov_1.921915	95	175	16	10	80	0.1250000
NODE_556_length_3211_cov_1.921915	95	175	18	11	80	0.1375000
NODE_556_length_3211_cov_1.921915	95	175	22	5	80	0.0625000
NODE_556_length_3211_cov_1.921915	95	175	24	9	80	0.1125000
NODE_556_length_3211_cov_1.921915	95	175	26	15	80	0.1875000
NODE_556_length_3211_cov_1.921915	95	175	28	22	80	0.2750000
NODE_556_length_3211_cov_1.921915	148	178	2	4	30	0.1333333
NODE_556_length_3211_cov_1.921915	148	178	4	2	30	0.0666667
NODE_556_length_3211_cov_1.921915	148	178	10	5	30	0.1666667
NODE_556_length_3211_cov_1.921915	148	178	16	10	30	0.3333333
NODE_556_length_3211_cov_1.921915	148	178	18	9	30	0.3000000
NODE_557_length_3210_cov_7.428480	2040	2111	0	17	71	0.2394366
NODE_557_length_3210_cov_7.428480	2040	2111	8	33	71	0.4647887
NODE_557_length_3210_cov_7.428480	2040	2111	12	21	71	0.2957746
NODE_557_length_3210_cov_7.428480	2084	2164	8	6	80	0.0750000
NODE_557_length_3210_cov_7.428480	2084	2164	12	74	80	0.9250000
NODE_557_length_3210_cov_7.428480	2715	2797	2	9	82	0.1097561
NODE_557_length_3210_cov_7.428480	2715	2797	6	35	82	0.4268293
NODE_557_length_3210_cov_7.428480	2715	2797	8	38	82	0.4634146
NODE_557_length_3210_cov_7.428480	2770	2850	4	3	80	0.0375000
NODE_557_length_3210_cov_7.428480	2770	2850	8	77	80	0.9625000
NODE_562_length_3201_cov_3.591231	3120	3200	0	80	80	1.0000000
NODE_566_length_3189_cov_69.446602	137	188	0	41	51	0.8039216
NODE_566_length_3189_cov_69.446602	137	188	3	10	51	0.1960784
NODE_567_length_3188_cov_7.233085	1663	1743	7	6	80	0.0750000
NODE_567_length_3188_cov_7.233085	1663	1743	10	10	80	0.1250000
NODE_567_length_3188_cov_7.233085	1663	1743	12	54	80	0.6750000
NODE_567_length_3188_cov_7.233085	1663	1743	14	10	80	0.1250000
NODE_567_length_3188_cov_7.233085	1716	1796	4	15	80	0.1875000
NODE_567_length_3188_cov_7.233085	1716	1796	6	10	80	0.1250000
NODE_567_length_3188_cov_7.233085	1716	1796	7	25	80	0.3125000
NODE_567_length_3188_cov_7.233085	1716	1796	9	9	80	0.1125000
NODE_567_length_3188_cov_7.233085	1716	1796	10	1	80	0.0125000
NODE_567_length_3188_cov_7.233085	1716	1796	12	20	80	0.2500000
NODE_570_length_3177_cov_2.789474	2021	2042	0	21	21	1.0000000
NODE_575_length_3158_cov_19.018960	840	920	0	80	80	1.0000000
NODE_575_length_3158_cov_19.018960	893	973	0	80	80	1.0000000
NODE_575_length_3158_cov_19.018960	2833	2915	0	82	82	1.0000000
NODE_575_length_3158_cov_19.018960	2888	2959	0	71	71	1.0000000
NODE_576_length_3150_cov_26.520813	770	850	30	1	80	0.0125000
NODE_576_length_3150_cov_26.520813	770	850	31	2	80	0.0250000
NODE_576_length_3150_cov_26.520813	770	850	34	2	80	0.0250000
NODE_576_length_3150_cov_26.520813	770	850	36	2	80	0.0250000
NODE_576_length_3150_cov_26.520813	770	850	37	2	80	0.0250000
NODE_576_length_3150_cov_26.520813	770	850	39	3	80	0.0375000
NODE_576_length_3150_cov_26.520813	770	850	40	3	80	0.0375000
NODE_576_length_3150_cov_26.520813	770	850	41	2	80	0.0250000
NODE_576_length_3150_cov_26.520813	770	850	43	4	80	0.0500000
NODE_576_length_3150_cov_26.520813	770	850	47	8	80	0.1000000
NODE_576_length_3150_cov_26.520813	770	850	48	22	80	0.2750000
NODE_576_length_3150_cov_26.520813	770	850	51	1	80	0.0125000
NODE_576_length_3150_cov_26.520813	770	850	52	3	80	0.0375000
NODE_576_length_3150_cov_26.520813	770	850	53	13	80	0.1625000
NODE_576_length_3150_cov_26.520813	770	850	54	7	80	0.0875000
NODE_576_length_3150_cov_26.520813	770	850	55	5	80	0.0625000
NODE_576_length_3150_cov_26.520813	823	901	15	9	78	0.1153846
NODE_576_length_3150_cov_26.520813	823	901	19	1	78	0.0128205
NODE_576_length_3150_cov_26.520813	823	901	26	6	78	0.0769231
NODE_576_length_3150_cov_26.520813	823	901	31	2	78	0.0256410
NODE_576_length_3150_cov_26.520813	823	901	39	13	78	0.1666667
NODE_576_length_3150_cov_26.520813	823	901	48	4	78	0.0512821
NODE_576_length_3150_cov_26.520813	823	901	51	3	78	0.0384615
NODE_576_length_3150_cov_26.520813	823	901	52	11	78	0.1410256
NODE_576_length_3150_cov_26.520813	823	901	53	13	78	0.1666667
NODE_576_length_3150_cov_26.520813	823	901	54	12	78	0.1538462
NODE_576_length_3150_cov_26.520813	823	901	55	4	78	0.0512821
NODE_576_length_3150_cov_26.520813	2616	2696	0	20	80	0.2500000
NODE_576_length_3150_cov_26.520813	2616	2696	4	11	80	0.1375000
NODE_576_length_3150_cov_26.520813	2616	2696	8	39	80	0.4875000
NODE_576_length_3150_cov_26.520813	2616	2696	10	10	80	0.1250000
NODE_576_length_3150_cov_26.520813	2669	2749	6	9	80	0.1125000
NODE_576_length_3150_cov_26.520813	2669	2749	8	17	80	0.2125000
NODE_576_length_3150_cov_26.520813	2669	2749	10	54	80	0.6750000
NODE_577_length_3150_cov_5.923959	2313	2393	2	25	80	0.3125000
NODE_577_length_3150_cov_5.923959	2313	2393	4	50	80	0.6250000
NODE_577_length_3150_cov_5.923959	2313	2393	5	5	80	0.0625000
NODE_579_length_3148_cov_2.313873	3053	3105	0	52	52	1.0000000
NODE_581_length_3146_cov_18.277322	2418	2498	0	80	80	1.0000000
NODE_581_length_3146_cov_18.277322	2471	2551	0	61	80	0.7625000
NODE_581_length_3146_cov_18.277322	2471	2551	6	4	80	0.0500000
NODE_581_length_3146_cov_18.277322	2471	2551	9	7	80	0.0875000
NODE_581_length_3146_cov_18.277322	2471	2551	12	8	80	0.1000000
NODE_581_length_3146_cov_18.277322	2547	2627	12	28	80	0.3500000
NODE_581_length_3146_cov_18.277322	2547	2627	14	35	80	0.4375000
NODE_581_length_3146_cov_18.277322	2547	2627	23	9	80	0.1125000
NODE_581_length_3146_cov_18.277322	2547	2627	24	8	80	0.1000000
NODE_581_length_3146_cov_18.277322	2600	2680	14	10	80	0.1250000
NODE_581_length_3146_cov_18.277322	2600	2680	17	9	80	0.1125000
NODE_581_length_3146_cov_18.277322	2600	2680	22	1	80	0.0125000
NODE_581_length_3146_cov_18.277322	2600	2680	23	18	80	0.2250000
NODE_581_length_3146_cov_18.277322	2600	2680	24	42	80	0.5250000
NODE_581_length_3146_cov_18.277322	2975	3055	4	15	80	0.1875000
NODE_581_length_3146_cov_18.277322	2975	3055	5	1	80	0.0125000
NODE_581_length_3146_cov_18.277322	2975	3055	8	1	80	0.0125000
NODE_581_length_3146_cov_18.277322	2975	3055	9	1	80	0.0125000
NODE_581_length_3146_cov_18.277322	2975	3055	10	4	80	0.0500000
NODE_581_length_3146_cov_18.277322	2975	3055	12	23	80	0.2875000
NODE_581_length_3146_cov_18.277322	2975	3055	18	35	80	0.4375000
NODE_585_length_3134_cov_8.717957	1290	1362	18	7	72	0.0972222
NODE_585_length_3134_cov_8.717957	1290	1362	22	12	72	0.1666667
NODE_585_length_3134_cov_8.717957	1290	1362	24	2	72	0.0277778
NODE_585_length_3134_cov_8.717957	1290	1362	26	10	72	0.1388889
NODE_585_length_3134_cov_8.717957	1290	1362	28	4	72	0.0555556
NODE_585_length_3134_cov_8.717957	1290	1362	30	3	72	0.0416667
NODE_585_length_3134_cov_8.717957	1290	1362	32	4	72	0.0555556
NODE_585_length_3134_cov_8.717957	1290	1362	36	10	72	0.1388889
NODE_585_length_3134_cov_8.717957	1290	1362	37	7	72	0.0972222
NODE_585_length_3134_cov_8.717957	1290	1362	39	6	72	0.0833333
NODE_585_length_3134_cov_8.717957	1290	1362	41	4	72	0.0555556
NODE_585_length_3134_cov_8.717957	1290	1362	43	3	72	0.0416667
NODE_585_length_3134_cov_8.717957	1335	1415	36	14	80	0.1750000
NODE_585_length_3134_cov_8.717957	1335	1415	37	17	80	0.2125000
NODE_585_length_3134_cov_8.717957	1335	1415	38	1	80	0.0125000
NODE_585_length_3134_cov_8.717957	1335	1415	39	17	80	0.2125000
NODE_585_length_3134_cov_8.717957	1335	1415	40	5	80	0.0625000
NODE_585_length_3134_cov_8.717957	1335	1415	41	4	80	0.0500000
NODE_585_length_3134_cov_8.717957	1335	1415	42	2	80	0.0250000
NODE_585_length_3134_cov_8.717957	1335	1415	43	19	80	0.2375000
NODE_585_length_3134_cov_8.717957	1335	1415	44	1	80	0.0125000
NODE_586_length_3131_cov_26.910620	232	312	6	1	80	0.0125000
NODE_586_length_3131_cov_26.910620	232	312	12	79	80	0.9875000
NODE_586_length_3131_cov_26.910620	285	364	12	79	79	1.0000000
NODE_586_length_3131_cov_26.910620	2151	2231	0	80	80	1.0000000
NODE_586_length_3131_cov_26.910620	2155	2227	0	72	72	1.0000000
NODE_586_length_3131_cov_26.910620	2204	2284	0	80	80	1.0000000
NODE_586_length_3131_cov_26.910620	2208	2284	0	76	76	1.0000000
NODE_586_length_3131_cov_26.910620	2280	2360	0	80	80	1.0000000
NODE_586_length_3131_cov_26.910620	2333	2413	0	52	80	0.6500000
NODE_586_length_3131_cov_26.910620	2333	2413	4	28	80	0.3500000
NODE_590_length_3118_cov_5.059622	367	445	0	17	78	0.2179487
NODE_590_length_3118_cov_5.059622	367	445	1	3	78	0.0384615
NODE_590_length_3118_cov_5.059622	367	445	2	25	78	0.3205128
NODE_590_length_3118_cov_5.059622	367	445	4	17	78	0.2179487
NODE_590_length_3118_cov_5.059622	367	445	6	5	78	0.0641026
NODE_590_length_3118_cov_5.059622	367	445	8	11	78	0.1410256
NODE_590_length_3118_cov_5.059622	418	498	0	70	80	0.8750000
NODE_590_length_3118_cov_5.059622	418	498	1	3	80	0.0375000
NODE_590_length_3118_cov_5.059622	418	498	2	7	80	0.0875000
NODE_591_length_3117_cov_5.938038	2525	2605	0	80	80	1.0000000
NODE_591_length_3117_cov_5.938038	2578	2658	0	80	80	1.0000000
NODE_595_length_3110_cov_31.733643	2864	2923	0	58	59	0.9830508
NODE_595_length_3110_cov_31.733643	2864	2923	2	1	59	0.0169492
NODE_602_length_3093_cov_54.559786	571	651	2	43	80	0.5375000
NODE_602_length_3093_cov_54.559786	571	651	4	37	80	0.4625000
NODE_602_length_3093_cov_54.559786	624	704	0	5	80	0.0625000
NODE_602_length_3093_cov_54.559786	624	704	2	61	80	0.7625000
NODE_602_length_3093_cov_54.559786	624	704	4	14	80	0.1750000
NODE_602_length_3093_cov_54.559786	2901	2981	99	1	80	0.0125000
NODE_602_length_3093_cov_54.559786	2901	2981	103	3	80	0.0375000
NODE_602_length_3093_cov_54.559786	2901	2981	105	2	80	0.0250000
NODE_602_length_3093_cov_54.559786	2901	2981	111	1	80	0.0125000
NODE_602_length_3093_cov_54.559786	2901	2981	119	2	80	0.0250000
NODE_602_length_3093_cov_54.559786	2901	2981	120	2	80	0.0250000
NODE_602_length_3093_cov_54.559786	2901	2981	121	2	80	0.0250000
NODE_602_length_3093_cov_54.559786	2901	2981	122	2	80	0.0250000
NODE_602_length_3093_cov_54.559786	2901	2981	123	6	80	0.0750000
NODE_602_length_3093_cov_54.559786	2901	2981	125	2	80	0.0250000
NODE_602_length_3093_cov_54.559786	2901	2981	127	1	80	0.0125000
NODE_602_length_3093_cov_54.559786	2901	2981	129	3	80	0.0375000
NODE_602_length_3093_cov_54.559786	2901	2981	131	7	80	0.0875000
NODE_602_length_3093_cov_54.559786	2901	2981	132	2	80	0.0250000
NODE_602_length_3093_cov_54.559786	2901	2981	133	2	80	0.0250000
NODE_602_length_3093_cov_54.559786	2901	2981	134	1	80	0.0125000
NODE_602_length_3093_cov_54.559786	2901	2981	136	1	80	0.0125000
NODE_602_length_3093_cov_54.559786	2901	2981	142	2	80	0.0250000
NODE_602_length_3093_cov_54.559786	2901	2981	143	2	80	0.0250000
NODE_602_length_3093_cov_54.559786	2901	2981	145	1	80	0.0125000
NODE_602_length_3093_cov_54.559786	2901	2981	147	3	80	0.0375000
NODE_602_length_3093_cov_54.559786	2901	2981	149	1	80	0.0125000
NODE_602_length_3093_cov_54.559786	2901	2981	150	1	80	0.0125000
NODE_602_length_3093_cov_54.559786	2901	2981	151	1	80	0.0125000
NODE_602_length_3093_cov_54.559786	2901	2981	154	10	80	0.1250000
NODE_602_length_3093_cov_54.559786	2901	2981	156	1	80	0.0125000
NODE_602_length_3093_cov_54.559786	2901	2981	158	18	80	0.2250000
NODE_602_length_3093_cov_54.559786	2954	3034	35	3	80	0.0375000
NODE_602_length_3093_cov_54.559786	2954	3034	37	1	80	0.0125000
NODE_602_length_3093_cov_54.559786	2954	3034	41	1	80	0.0125000
NODE_602_length_3093_cov_54.559786	2954	3034	47	1	80	0.0125000
NODE_602_length_3093_cov_54.559786	2954	3034	49	1	80	0.0125000
NODE_602_length_3093_cov_54.559786	2954	3034	51	1	80	0.0125000
NODE_602_length_3093_cov_54.559786	2954	3034	57	1	80	0.0125000
NODE_602_length_3093_cov_54.559786	2954	3034	58	4	80	0.0500000
NODE_602_length_3093_cov_54.559786	2954	3034	62	3	80	0.0375000
NODE_602_length_3093_cov_54.559786	2954	3034	64	2	80	0.0250000
NODE_602_length_3093_cov_54.559786	2954	3034	66	3	80	0.0375000
NODE_602_length_3093_cov_54.559786	2954	3034	71	5	80	0.0625000
NODE_602_length_3093_cov_54.559786	2954	3034	75	1	80	0.0125000
NODE_602_length_3093_cov_54.559786	2954	3034	78	2	80	0.0250000
NODE_602_length_3093_cov_54.559786	2954	3034	85	1	80	0.0125000
NODE_602_length_3093_cov_54.559786	2954	3034	86	4	80	0.0500000
NODE_602_length_3093_cov_54.559786	2954	3034	88	1	80	0.0125000
NODE_602_length_3093_cov_54.559786	2954	3034	90	1	80	0.0125000
NODE_602_length_3093_cov_54.559786	2954	3034	97	4	80	0.0500000
NODE_602_length_3093_cov_54.559786	2954	3034	99	1	80	0.0125000
NODE_602_length_3093_cov_54.559786	2954	3034	100	1	80	0.0125000
NODE_602_length_3093_cov_54.559786	2954	3034	102	1	80	0.0125000
NODE_602_length_3093_cov_54.559786	2954	3034	106	2	80	0.0250000
NODE_602_length_3093_cov_54.559786	2954	3034	114	3	80	0.0375000
NODE_602_length_3093_cov_54.559786	2954	3034	116	2	80	0.0250000
NODE_602_length_3093_cov_54.559786	2954	3034	120	5	80	0.0625000
NODE_602_length_3093_cov_54.559786	2954	3034	122	2	80	0.0250000
NODE_602_length_3093_cov_54.559786	2954	3034	132	2	80	0.0250000
NODE_602_length_3093_cov_54.559786	2954	3034	134	1	80	0.0125000
NODE_602_length_3093_cov_54.559786	2954	3034	136	1	80	0.0125000
NODE_602_length_3093_cov_54.559786	2954	3034	142	2	80	0.0250000
NODE_602_length_3093_cov_54.559786	2954	3034	150	1	80	0.0125000
NODE_602_length_3093_cov_54.559786	2954	3034	154	5	80	0.0625000
NODE_602_length_3093_cov_54.559786	2954	3034	158	11	80	0.1375000
NODE_603_length_3091_cov_35.895722	1743	1804	0	11	61	0.1803279
NODE_603_length_3091_cov_35.895722	1743	1804	2	49	61	0.8032787
NODE_603_length_3091_cov_35.895722	1743	1804	3	1	61	0.0163934
NODE_603_length_3091_cov_35.895722	1777	1857	0	64	80	0.8000000
NODE_603_length_3091_cov_35.895722	1777	1857	2	16	80	0.2000000
NODE_603_length_3091_cov_35.895722	2472	2535	0	63	63	1.0000000
NODE_603_length_3091_cov_35.895722	2508	2553	0	45	45	1.0000000
NODE_603_length_3091_cov_35.895722	2534	2604	0	70	70	1.0000000
NODE_603_length_3091_cov_35.895722	2578	2618	0	40	40	1.0000000
NODE_603_length_3091_cov_35.895722	2586	2623	0	37	37	1.0000000
NODE_603_length_3091_cov_35.895722	2626	2671	0	45	45	1.0000000
NODE_603_length_3091_cov_35.895722	2682	2730	0	48	48	1.0000000
NODE_603_length_3091_cov_35.895722	2918	2969	0	51	51	1.0000000
NODE_603_length_3091_cov_35.895722	2942	2987	0	45	45	1.0000000
NODE_603_length_3091_cov_35.895722	2994	3039	0	45	45	1.0000000
NODE_607_length_3079_cov_7.081879	2340	2420	6	52	80	0.6500000
NODE_607_length_3079_cov_7.081879	2340	2420	8	13	80	0.1625000
NODE_607_length_3079_cov_7.081879	2340	2420	10	15	80	0.1875000
NODE_607_length_3079_cov_7.081879	2886	2938	104	2	52	0.0384615
NODE_607_length_3079_cov_7.081879	2886	2938	110	3	52	0.0576923
NODE_607_length_3079_cov_7.081879	2886	2938	111	2	52	0.0384615
NODE_607_length_3079_cov_7.081879	2886	2938	113	1	52	0.0192308
NODE_607_length_3079_cov_7.081879	2886	2938	114	7	52	0.1346154
NODE_607_length_3079_cov_7.081879	2886	2938	120	1	52	0.0192308
NODE_607_length_3079_cov_7.081879	2886	2938	125	1	52	0.0192308
NODE_607_length_3079_cov_7.081879	2886	2938	126	2	52	0.0384615
NODE_607_length_3079_cov_7.081879	2886	2938	127	2	52	0.0384615
NODE_607_length_3079_cov_7.081879	2886	2938	130	1	52	0.0192308
NODE_607_length_3079_cov_7.081879	2886	2938	131	8	52	0.1538462
NODE_607_length_3079_cov_7.081879	2886	2938	132	1	52	0.0192308
NODE_607_length_3079_cov_7.081879	2886	2938	133	2	52	0.0384615
NODE_607_length_3079_cov_7.081879	2886	2938	134	4	52	0.0769231
NODE_607_length_3079_cov_7.081879	2886	2938	138	1	52	0.0192308
NODE_607_length_3079_cov_7.081879	2886	2938	142	2	52	0.0384615
NODE_607_length_3079_cov_7.081879	2886	2938	143	1	52	0.0192308
NODE_607_length_3079_cov_7.081879	2886	2938	147	1	52	0.0192308
NODE_607_length_3079_cov_7.081879	2886	2938	149	1	52	0.0192308
NODE_607_length_3079_cov_7.081879	2886	2938	154	1	52	0.0192308
NODE_607_length_3079_cov_7.081879	2886	2938	155	1	52	0.0192308
NODE_607_length_3079_cov_7.081879	2886	2938	158	1	52	0.0192308
NODE_607_length_3079_cov_7.081879	2886	2938	166	3	52	0.0576923
NODE_607_length_3079_cov_7.081879	2886	2938	167	1	52	0.0192308
NODE_607_length_3079_cov_7.081879	2886	2938	172	1	52	0.0192308
NODE_607_length_3079_cov_7.081879	2886	2938	184	1	52	0.0192308
NODE_607_length_3079_cov_7.081879	2893	2959	113	1	66	0.0151515
NODE_607_length_3079_cov_7.081879	2893	2959	114	7	66	0.1060606
NODE_607_length_3079_cov_7.081879	2893	2959	120	1	66	0.0151515
NODE_607_length_3079_cov_7.081879	2893	2959	125	1	66	0.0151515
NODE_607_length_3079_cov_7.081879	2893	2959	126	2	66	0.0303030
NODE_607_length_3079_cov_7.081879	2893	2959	127	2	66	0.0303030
NODE_607_length_3079_cov_7.081879	2893	2959	130	1	66	0.0151515
NODE_607_length_3079_cov_7.081879	2893	2959	131	8	66	0.1212121
NODE_607_length_3079_cov_7.081879	2893	2959	132	1	66	0.0151515
NODE_607_length_3079_cov_7.081879	2893	2959	133	2	66	0.0303030
NODE_607_length_3079_cov_7.081879	2893	2959	134	4	66	0.0606061
NODE_607_length_3079_cov_7.081879	2893	2959	138	1	66	0.0151515
NODE_607_length_3079_cov_7.081879	2893	2959	142	2	66	0.0303030
NODE_607_length_3079_cov_7.081879	2893	2959	143	1	66	0.0151515
NODE_607_length_3079_cov_7.081879	2893	2959	147	1	66	0.0151515
NODE_607_length_3079_cov_7.081879	2893	2959	149	1	66	0.0151515
NODE_607_length_3079_cov_7.081879	2893	2959	154	1	66	0.0151515
NODE_607_length_3079_cov_7.081879	2893	2959	155	1	66	0.0151515
NODE_607_length_3079_cov_7.081879	2893	2959	158	1	66	0.0151515
NODE_607_length_3079_cov_7.081879	2893	2959	166	3	66	0.0454545
NODE_607_length_3079_cov_7.081879	2893	2959	167	1	66	0.0151515
NODE_607_length_3079_cov_7.081879	2893	2959	172	1	66	0.0151515
NODE_607_length_3079_cov_7.081879	2893	2959	184	1	66	0.0151515
NODE_607_length_3079_cov_7.081879	2893	2959	190	2	66	0.0303030
NODE_607_length_3079_cov_7.081879	2893	2959	191	2	66	0.0303030
NODE_607_length_3079_cov_7.081879	2893	2959	194	2	66	0.0303030
NODE_607_length_3079_cov_7.081879	2893	2959	196	1	66	0.0151515
NODE_607_length_3079_cov_7.081879	2893	2959	198	1	66	0.0151515
NODE_607_length_3079_cov_7.081879	2893	2959	201	2	66	0.0303030
NODE_607_length_3079_cov_7.081879	2893	2959	203	2	66	0.0303030
NODE_607_length_3079_cov_7.081879	2893	2959	205	1	66	0.0151515
NODE_607_length_3079_cov_7.081879	2893	2959	207	1	66	0.0151515
NODE_607_length_3079_cov_7.081879	2893	2959	213	1	66	0.0151515
NODE_607_length_3079_cov_7.081879	2893	2959	216	1	66	0.0151515
NODE_607_length_3079_cov_7.081879	2893	2959	217	1	66	0.0151515
NODE_607_length_3079_cov_7.081879	2893	2959	218	2	66	0.0303030
NODE_607_length_3079_cov_7.081879	2893	2959	221	1	66	0.0151515
NODE_607_length_3079_cov_7.081879	2893	2959	224	1	66	0.0151515
NODE_607_length_3079_cov_7.081879	2932	2993	166	3	61	0.0491803
NODE_607_length_3079_cov_7.081879	2932	2993	167	1	61	0.0163934
NODE_607_length_3079_cov_7.081879	2932	2993	172	1	61	0.0163934
NODE_607_length_3079_cov_7.081879	2932	2993	184	1	61	0.0163934
NODE_607_length_3079_cov_7.081879	2932	2993	190	2	61	0.0327869
NODE_607_length_3079_cov_7.081879	2932	2993	191	2	61	0.0327869
NODE_607_length_3079_cov_7.081879	2932	2993	194	2	61	0.0327869
NODE_607_length_3079_cov_7.081879	2932	2993	196	1	61	0.0163934
NODE_607_length_3079_cov_7.081879	2932	2993	198	1	61	0.0163934
NODE_607_length_3079_cov_7.081879	2932	2993	200	11	61	0.1803279
NODE_607_length_3079_cov_7.081879	2932	2993	201	2	61	0.0327869
NODE_607_length_3079_cov_7.081879	2932	2993	203	2	61	0.0327869
NODE_607_length_3079_cov_7.081879	2932	2993	204	1	61	0.0163934
NODE_607_length_3079_cov_7.081879	2932	2993	205	11	61	0.1803279
NODE_607_length_3079_cov_7.081879	2932	2993	206	6	61	0.0983607
NODE_607_length_3079_cov_7.081879	2932	2993	207	1	61	0.0163934
NODE_607_length_3079_cov_7.081879	2932	2993	213	1	61	0.0163934
NODE_607_length_3079_cov_7.081879	2932	2993	214	2	61	0.0327869
NODE_607_length_3079_cov_7.081879	2932	2993	216	1	61	0.0163934
NODE_607_length_3079_cov_7.081879	2932	2993	217	3	61	0.0491803
NODE_607_length_3079_cov_7.081879	2932	2993	218	4	61	0.0655738
NODE_607_length_3079_cov_7.081879	2932	2993	221	1	61	0.0163934
NODE_607_length_3079_cov_7.081879	2932	2993	224	1	61	0.0163934
NODE_607_length_3079_cov_7.081879	2932	2995	166	3	63	0.0476190
NODE_607_length_3079_cov_7.081879	2932	2995	167	1	63	0.0158730
NODE_607_length_3079_cov_7.081879	2932	2995	172	1	63	0.0158730
NODE_607_length_3079_cov_7.081879	2932	2995	184	1	63	0.0158730
NODE_607_length_3079_cov_7.081879	2932	2995	190	2	63	0.0317460
NODE_607_length_3079_cov_7.081879	2932	2995	191	2	63	0.0317460
NODE_607_length_3079_cov_7.081879	2932	2995	194	2	63	0.0317460
NODE_607_length_3079_cov_7.081879	2932	2995	196	1	63	0.0158730
NODE_607_length_3079_cov_7.081879	2932	2995	198	1	63	0.0158730
NODE_607_length_3079_cov_7.081879	2932	2995	200	13	63	0.2063492
NODE_607_length_3079_cov_7.081879	2932	2995	201	2	63	0.0317460
NODE_607_length_3079_cov_7.081879	2932	2995	203	2	63	0.0317460
NODE_607_length_3079_cov_7.081879	2932	2995	204	1	63	0.0158730
NODE_607_length_3079_cov_7.081879	2932	2995	205	11	63	0.1746032
NODE_607_length_3079_cov_7.081879	2932	2995	206	6	63	0.0952381
NODE_607_length_3079_cov_7.081879	2932	2995	207	1	63	0.0158730
NODE_607_length_3079_cov_7.081879	2932	2995	213	1	63	0.0158730
NODE_607_length_3079_cov_7.081879	2932	2995	214	2	63	0.0317460
NODE_607_length_3079_cov_7.081879	2932	2995	216	1	63	0.0158730
NODE_607_length_3079_cov_7.081879	2932	2995	217	3	63	0.0476190
NODE_607_length_3079_cov_7.081879	2932	2995	218	4	63	0.0634921
NODE_607_length_3079_cov_7.081879	2932	2995	221	1	63	0.0158730
NODE_607_length_3079_cov_7.081879	2932	2995	224	1	63	0.0158730
NODE_607_length_3079_cov_7.081879	2932	2995	166	3	63	0.0476190
NODE_607_length_3079_cov_7.081879	2932	2995	167	1	63	0.0158730
NODE_607_length_3079_cov_7.081879	2932	2995	172	1	63	0.0158730
NODE_607_length_3079_cov_7.081879	2932	2995	184	1	63	0.0158730
NODE_607_length_3079_cov_7.081879	2932	2995	190	2	63	0.0317460
NODE_607_length_3079_cov_7.081879	2932	2995	191	2	63	0.0317460
NODE_607_length_3079_cov_7.081879	2932	2995	194	2	63	0.0317460
NODE_607_length_3079_cov_7.081879	2932	2995	196	1	63	0.0158730
NODE_607_length_3079_cov_7.081879	2932	2995	198	1	63	0.0158730
NODE_607_length_3079_cov_7.081879	2932	2995	200	13	63	0.2063492
NODE_607_length_3079_cov_7.081879	2932	2995	201	2	63	0.0317460
NODE_607_length_3079_cov_7.081879	2932	2995	203	2	63	0.0317460
NODE_607_length_3079_cov_7.081879	2932	2995	204	1	63	0.0158730
NODE_607_length_3079_cov_7.081879	2932	2995	205	11	63	0.1746032
NODE_607_length_3079_cov_7.081879	2932	2995	206	6	63	0.0952381
NODE_607_length_3079_cov_7.081879	2932	2995	207	1	63	0.0158730
NODE_607_length_3079_cov_7.081879	2932	2995	213	1	63	0.0158730
NODE_607_length_3079_cov_7.081879	2932	2995	214	2	63	0.0317460
NODE_607_length_3079_cov_7.081879	2932	2995	216	1	63	0.0158730
NODE_607_length_3079_cov_7.081879	2932	2995	217	3	63	0.0476190
NODE_607_length_3079_cov_7.081879	2932	2995	218	4	63	0.0634921
NODE_607_length_3079_cov_7.081879	2932	2995	221	1	63	0.0158730
NODE_607_length_3079_cov_7.081879	2932	2995	224	1	63	0.0158730
NODE_608_length_3077_cov_23.535259	1244	1321	0	6	77	0.0779221
NODE_608_length_3077_cov_23.535259	1244	1321	2	20	77	0.2597403
NODE_608_length_3077_cov_23.535259	1244	1321	4	2	77	0.0259740
NODE_608_length_3077_cov_23.535259	1244	1321	10	49	77	0.6363636
NODE_608_length_3077_cov_23.535259	1911	1991	0	62	80	0.7750000
NODE_608_length_3077_cov_23.535259	1911	1991	2	18	80	0.2250000
NODE_608_length_3077_cov_23.535259	1964	2016	0	52	52	1.0000000
NODE_608_length_3077_cov_23.535259	2028	2114	0	50	86	0.5813953
NODE_608_length_3077_cov_23.535259	2028	2114	2	36	86	0.4186046
NODE_609_length_3077_cov_8.693083	1157	1237	4	4	80	0.0500000
NODE_609_length_3077_cov_8.693083	1157	1237	7	5	80	0.0625000
NODE_609_length_3077_cov_8.693083	1157	1237	9	16	80	0.2000000
NODE_609_length_3077_cov_8.693083	1157	1237	13	9	80	0.1125000
NODE_609_length_3077_cov_8.693083	1157	1237	15	15	80	0.1875000
NODE_609_length_3077_cov_8.693083	1157	1237	19	10	80	0.1250000
NODE_609_length_3077_cov_8.693083	1157	1237	22	3	80	0.0375000
NODE_609_length_3077_cov_8.693083	1157	1237	23	8	80	0.1000000
NODE_609_length_3077_cov_8.693083	1157	1237	24	10	80	0.1250000
NODE_609_length_3077_cov_8.693083	1161	1184	7	5	23	0.2173913
NODE_609_length_3077_cov_8.693083	1161	1184	9	16	23	0.6956522
NODE_609_length_3077_cov_8.693083	1161	1184	13	2	23	0.0869565
NODE_609_length_3077_cov_8.693083	1233	1313	24	8	80	0.1000000
NODE_609_length_3077_cov_8.693083	1233	1313	25	2	80	0.0250000
NODE_609_length_3077_cov_8.693083	1233	1313	26	3	80	0.0375000
NODE_609_length_3077_cov_8.693083	1233	1313	29	3	80	0.0375000
NODE_609_length_3077_cov_8.693083	1233	1313	31	2	80	0.0250000
NODE_609_length_3077_cov_8.693083	1233	1313	35	5	80	0.0625000
NODE_609_length_3077_cov_8.693083	1233	1313	37	2	80	0.0250000
NODE_609_length_3077_cov_8.693083	1233	1313	38	4	80	0.0500000
NODE_609_length_3077_cov_8.693083	1233	1313	39	7	80	0.0875000
NODE_609_length_3077_cov_8.693083	1233	1313	40	1	80	0.0125000
NODE_609_length_3077_cov_8.693083	1233	1313	41	1	80	0.0125000
NODE_609_length_3077_cov_8.693083	1233	1313	43	1	80	0.0125000
NODE_609_length_3077_cov_8.693083	1233	1313	47	4	80	0.0500000
NODE_609_length_3077_cov_8.693083	1233	1313	49	2	80	0.0250000
NODE_609_length_3077_cov_8.693083	1233	1313	51	5	80	0.0625000
NODE_609_length_3077_cov_8.693083	1233	1313	53	4	80	0.0500000
NODE_609_length_3077_cov_8.693083	1233	1313	55	5	80	0.0625000
NODE_609_length_3077_cov_8.693083	1233	1313	59	3	80	0.0375000
NODE_609_length_3077_cov_8.693083	1233	1313	61	4	80	0.0500000
NODE_609_length_3077_cov_8.693083	1233	1313	62	2	80	0.0250000
NODE_609_length_3077_cov_8.693083	1233	1313	63	3	80	0.0375000
NODE_609_length_3077_cov_8.693083	1233	1313	64	4	80	0.0500000
NODE_609_length_3077_cov_8.693083	1233	1313	65	5	80	0.0625000
NODE_609_length_3077_cov_8.693083	1286	1352	53	1	66	0.0151515
NODE_609_length_3077_cov_8.693083	1286	1352	55	5	66	0.0757576
NODE_609_length_3077_cov_8.693083	1286	1352	59	5	66	0.0757576
NODE_609_length_3077_cov_8.693083	1286	1352	61	14	66	0.2121212
NODE_609_length_3077_cov_8.693083	1286	1352	62	2	66	0.0303030
NODE_609_length_3077_cov_8.693083	1286	1352	63	6	66	0.0909091
NODE_609_length_3077_cov_8.693083	1286	1352	64	7	66	0.1060606
NODE_609_length_3077_cov_8.693083	1286	1352	65	12	66	0.1818182
NODE_609_length_3077_cov_8.693083	1286	1352	67	10	66	0.1515152
NODE_609_length_3077_cov_8.693083	1286	1352	69	4	66	0.0606061
NODE_609_length_3077_cov_8.693083	2672	2757	0	39	85	0.4588235
NODE_609_length_3077_cov_8.693083	2672	2757	2	46	85	0.5411765
NODE_611_length_3074_cov_2.996303	2561	2629	65	1	68	0.0147059
NODE_611_length_3074_cov_2.996303	2561	2629	74	1	68	0.0147059
NODE_611_length_3074_cov_2.996303	2561	2629	75	1	68	0.0147059
NODE_611_length_3074_cov_2.996303	2561	2629	84	1	68	0.0147059
NODE_611_length_3074_cov_2.996303	2561	2629	92	1	68	0.0147059
NODE_611_length_3074_cov_2.996303	2561	2629	103	1	68	0.0147059
NODE_611_length_3074_cov_2.996303	2561	2629	112	1	68	0.0147059
NODE_611_length_3074_cov_2.996303	2561	2629	137	2	68	0.0294118
NODE_611_length_3074_cov_2.996303	2561	2629	143	1	68	0.0147059
NODE_611_length_3074_cov_2.996303	2561	2629	147	1	68	0.0147059
NODE_611_length_3074_cov_2.996303	2561	2629	149	1	68	0.0147059
NODE_611_length_3074_cov_2.996303	2561	2629	160	1	68	0.0147059
NODE_611_length_3074_cov_2.996303	2561	2629	162	4	68	0.0588235
NODE_611_length_3074_cov_2.996303	2561	2629	171	1	68	0.0147059
NODE_611_length_3074_cov_2.996303	2561	2629	179	2	68	0.0294118
NODE_611_length_3074_cov_2.996303	2561	2629	183	1	68	0.0147059
NODE_611_length_3074_cov_2.996303	2561	2629	191	1	68	0.0147059
NODE_611_length_3074_cov_2.996303	2561	2629	201	1	68	0.0147059
NODE_611_length_3074_cov_2.996303	2561	2629	205	1	68	0.0147059
NODE_611_length_3074_cov_2.996303	2561	2629	214	1	68	0.0147059
NODE_611_length_3074_cov_2.996303	2561	2629	223	1	68	0.0147059
NODE_611_length_3074_cov_2.996303	2561	2629	226	1	68	0.0147059
NODE_611_length_3074_cov_2.996303	2561	2629	230	1	68	0.0147059
NODE_611_length_3074_cov_2.996303	2561	2629	232	1	68	0.0147059
NODE_611_length_3074_cov_2.996303	2561	2629	237	1	68	0.0147059
NODE_611_length_3074_cov_2.996303	2561	2629	238	2	68	0.0294118
NODE_611_length_3074_cov_2.996303	2561	2629	241	1	68	0.0147059
NODE_611_length_3074_cov_2.996303	2561	2629	246	1	68	0.0147059
NODE_611_length_3074_cov_2.996303	2561	2629	247	1	68	0.0147059
NODE_611_length_3074_cov_2.996303	2561	2629	257	1	68	0.0147059
NODE_611_length_3074_cov_2.996303	2561	2629	266	1	68	0.0147059
NODE_611_length_3074_cov_2.996303	2561	2629	275	1	68	0.0147059
NODE_611_length_3074_cov_2.996303	2561	2629	299	1	68	0.0147059
NODE_611_length_3074_cov_2.996303	2561	2629	302	1	68	0.0147059
NODE_611_length_3074_cov_2.996303	2561	2629	305	1	68	0.0147059
NODE_611_length_3074_cov_2.996303	2561	2629	307	1	68	0.0147059
NODE_611_length_3074_cov_2.996303	2561	2629	314	1	68	0.0147059
NODE_611_length_3074_cov_2.996303	2561	2629	319	1	68	0.0147059
NODE_611_length_3074_cov_2.996303	2561	2629	322	1	68	0.0147059
NODE_611_length_3074_cov_2.996303	2561	2629	326	1	68	0.0147059
NODE_611_length_3074_cov_2.996303	2561	2629	331	1	68	0.0147059
NODE_611_length_3074_cov_2.996303	2561	2629	333	1	68	0.0147059
NODE_611_length_3074_cov_2.996303	2561	2629	344	1	68	0.0147059
NODE_611_length_3074_cov_2.996303	2561	2629	350	1	68	0.0147059
NODE_611_length_3074_cov_2.996303	2561	2629	355	1	68	0.0147059
NODE_611_length_3074_cov_2.996303	2561	2629	363	1	68	0.0147059
NODE_611_length_3074_cov_2.996303	2561	2629	365	1	68	0.0147059
NODE_611_length_3074_cov_2.996303	2561	2629	366	1	68	0.0147059
NODE_611_length_3074_cov_2.996303	2561	2629	376	1	68	0.0147059
NODE_611_length_3074_cov_2.996303	2561	2629	384	1	68	0.0147059
NODE_611_length_3074_cov_2.996303	2561	2629	391	1	68	0.0147059
NODE_611_length_3074_cov_2.996303	2561	2629	405	1	68	0.0147059
NODE_611_length_3074_cov_2.996303	2561	2629	409	1	68	0.0147059
NODE_611_length_3074_cov_2.996303	2561	2629	422	1	68	0.0147059
NODE_611_length_3074_cov_2.996303	2561	2629	429	1	68	0.0147059
NODE_611_length_3074_cov_2.996303	2561	2629	433	2	68	0.0294118
NODE_611_length_3074_cov_2.996303	2561	2629	455	1	68	0.0147059
NODE_611_length_3074_cov_2.996303	2561	2629	462	1	68	0.0147059
NODE_611_length_3074_cov_2.996303	2561	2629	481	1	68	0.0147059
NODE_611_length_3074_cov_2.996303	2561	2629	485	1	68	0.0147059
NODE_611_length_3074_cov_2.996303	2561	2629	491	1	68	0.0147059
NODE_615_length_3069_cov_2.448822	2948	2991	0	24	43	0.5581396
NODE_615_length_3069_cov_2.448822	2948	2991	2	19	43	0.4418605
NODE_616_length_3059_cov_20.037500	346	426	10	24	80	0.3000000
NODE_616_length_3059_cov_20.037500	346	426	12	20	80	0.2500000
NODE_616_length_3059_cov_20.037500	346	426	13	5	80	0.0625000
NODE_616_length_3059_cov_20.037500	346	426	15	31	80	0.3875000
NODE_616_length_3059_cov_20.037500	399	479	4	26	80	0.3250000
NODE_616_length_3059_cov_20.037500	399	479	10	2	80	0.0250000
NODE_616_length_3059_cov_20.037500	399	479	15	52	80	0.6500000
NODE_616_length_3059_cov_20.037500	1317	1397	4	35	80	0.4375000
NODE_616_length_3059_cov_20.037500	1317	1397	8	45	80	0.5625000
NODE_616_length_3059_cov_20.037500	1370	1447	7	4	77	0.0519481
NODE_616_length_3059_cov_20.037500	1370	1447	8	62	77	0.8051948
NODE_616_length_3059_cov_20.037500	1370	1447	10	11	77	0.1428571
NODE_616_length_3059_cov_20.037500	2514	2594	0	80	80	1.0000000
NODE_616_length_3059_cov_20.037500	2567	2647	0	80	80	1.0000000
NODE_617_length_3058_cov_21.767489	2802	2882	0	10	80	0.1250000
NODE_617_length_3058_cov_21.767489	2802	2882	1	8	80	0.1000000
NODE_617_length_3058_cov_21.767489	2802	2882	2	20	80	0.2500000
NODE_617_length_3058_cov_21.767489	2802	2882	5	3	80	0.0375000
NODE_617_length_3058_cov_21.767489	2802	2882	6	37	80	0.4625000
NODE_617_length_3058_cov_21.767489	2802	2882	10	1	80	0.0125000
NODE_617_length_3058_cov_21.767489	2802	2882	13	1	80	0.0125000
NODE_617_length_3058_cov_21.767489	2855	2930	6	45	75	0.6000000
NODE_617_length_3058_cov_21.767489	2855	2930	8	30	75	0.4000000
NODE_621_length_3047_cov_47.232361	418	489	0	6	71	0.0845070
NODE_621_length_3047_cov_47.232361	418	489	4	65	71	0.9154930
NODE_621_length_3047_cov_47.232361	758	801	9	1	43	0.0232558
NODE_621_length_3047_cov_47.232361	758	801	10	2	43	0.0465116
NODE_621_length_3047_cov_47.232361	758	801	14	4	43	0.0930233
NODE_621_length_3047_cov_47.232361	758	801	16	1	43	0.0232558
NODE_621_length_3047_cov_47.232361	758	801	20	1	43	0.0232558
NODE_621_length_3047_cov_47.232361	758	801	22	1	43	0.0232558
NODE_621_length_3047_cov_47.232361	758	801	25	1	43	0.0232558
NODE_621_length_3047_cov_47.232361	758	801	26	2	43	0.0465116
NODE_621_length_3047_cov_47.232361	758	801	27	1	43	0.0232558
NODE_621_length_3047_cov_47.232361	758	801	32	1	43	0.0232558
NODE_621_length_3047_cov_47.232361	758	801	36	4	43	0.0930233
NODE_621_length_3047_cov_47.232361	758	801	38	1	43	0.0232558
NODE_621_length_3047_cov_47.232361	758	801	39	1	43	0.0232558
NODE_621_length_3047_cov_47.232361	758	801	42	4	43	0.0930233
NODE_621_length_3047_cov_47.232361	758	801	43	1	43	0.0232558
NODE_621_length_3047_cov_47.232361	758	801	45	2	43	0.0465116
NODE_621_length_3047_cov_47.232361	758	801	47	1	43	0.0232558
NODE_621_length_3047_cov_47.232361	758	801	48	2	43	0.0465116
NODE_621_length_3047_cov_47.232361	758	801	51	5	43	0.1162791
NODE_621_length_3047_cov_47.232361	758	801	52	1	43	0.0232558
NODE_621_length_3047_cov_47.232361	758	801	53	5	43	0.1162791
NODE_621_length_3047_cov_47.232361	758	801	55	1	43	0.0232558
NODE_623_length_3044_cov_38.951783	1702	1782	0	72	80	0.9000000
NODE_623_length_3044_cov_38.951783	1702	1782	2	8	80	0.1000000
NODE_623_length_3044_cov_38.951783	1755	1835	0	19	80	0.2375000
NODE_623_length_3044_cov_38.951783	1755	1835	2	61	80	0.7625000
NODE_623_length_3044_cov_38.951783	1831	1911	0	63	80	0.7875000
NODE_623_length_3044_cov_38.951783	1831	1911	2	17	80	0.2125000
NODE_623_length_3044_cov_38.951783	1884	1964	0	31	80	0.3875000
NODE_623_length_3044_cov_38.951783	1884	1964	2	49	80	0.6125000
NODE_623_length_3044_cov_38.951783	2556	2636	0	80	80	1.0000000
NODE_623_length_3044_cov_38.951783	2609	2689	0	80	80	1.0000000
NODE_625_length_3039_cov_3.258163	261	337	0	1	76	0.0131579
NODE_625_length_3039_cov_3.258163	261	337	1	1	76	0.0131579
NODE_625_length_3039_cov_3.258163	261	337	2	15	76	0.1973684
NODE_625_length_3039_cov_3.258163	261	337	4	45	76	0.5921053
NODE_625_length_3039_cov_3.258163	261	337	6	6	76	0.0789474
NODE_625_length_3039_cov_3.258163	261	337	7	8	76	0.1052632
NODE_625_length_3039_cov_3.258163	261	336	1	1	75	0.0133333
NODE_625_length_3039_cov_3.258163	261	336	2	15	75	0.2000000
NODE_625_length_3039_cov_3.258163	261	336	4	45	75	0.6000000
NODE_625_length_3039_cov_3.258163	261	336	6	6	75	0.0800000
NODE_625_length_3039_cov_3.258163	261	336	7	8	75	0.1066667
NODE_625_length_3039_cov_3.258163	261	337	0	1	76	0.0131579
NODE_625_length_3039_cov_3.258163	261	337	1	1	76	0.0131579
NODE_625_length_3039_cov_3.258163	261	337	2	15	76	0.1973684
NODE_625_length_3039_cov_3.258163	261	337	4	45	76	0.5921053
NODE_625_length_3039_cov_3.258163	261	337	6	6	76	0.0789474
NODE_625_length_3039_cov_3.258163	261	337	7	8	76	0.1052632
NODE_625_length_3039_cov_3.258163	270	337	0	1	67	0.0149254
NODE_625_length_3039_cov_3.258163	270	337	1	1	67	0.0149254
NODE_625_length_3039_cov_3.258163	270	337	2	15	67	0.2238806
NODE_625_length_3039_cov_3.258163	270	337	4	45	67	0.6716418
NODE_625_length_3039_cov_3.258163	270	337	6	5	67	0.0746269
NODE_627_length_3036_cov_8.968676	2303	2367	4	19	64	0.2968750
NODE_627_length_3036_cov_8.968676	2303	2367	6	16	64	0.2500000
NODE_627_length_3036_cov_8.968676	2303	2367	7	1	64	0.0156250
NODE_627_length_3036_cov_8.968676	2303	2367	8	28	64	0.4375000
NODE_627_length_3036_cov_8.968676	2340	2420	6	11	80	0.1375000
NODE_627_length_3036_cov_8.968676	2340	2420	7	1	80	0.0125000
NODE_627_length_3036_cov_8.968676	2340	2420	8	16	80	0.2000000
NODE_627_length_3036_cov_8.968676	2340	2420	10	20	80	0.2500000
NODE_627_length_3036_cov_8.968676	2340	2420	12	14	80	0.1750000
NODE_627_length_3036_cov_8.968676	2340	2420	14	18	80	0.2250000
NODE_627_length_3036_cov_8.968676	2416	2496	4	17	80	0.2125000
NODE_627_length_3036_cov_8.968676	2416	2496	5	15	80	0.1875000
NODE_627_length_3036_cov_8.968676	2416	2496	6	16	80	0.2000000
NODE_627_length_3036_cov_8.968676	2416	2496	7	1	80	0.0125000
NODE_627_length_3036_cov_8.968676	2416	2496	8	17	80	0.2125000
NODE_627_length_3036_cov_8.968676	2416	2496	10	14	80	0.1750000
NODE_627_length_3036_cov_8.968676	2469	2549	4	40	80	0.5000000
NODE_627_length_3036_cov_8.968676	2469	2549	5	3	80	0.0375000
NODE_627_length_3036_cov_8.968676	2469	2549	6	31	80	0.3875000
NODE_627_length_3036_cov_8.968676	2469	2549	8	6	80	0.0750000
NODE_629_length_3032_cov_7.470849	1026	1068	32	1	42	0.0238095
NODE_629_length_3032_cov_7.470849	1026	1068	33	2	42	0.0476190
NODE_629_length_3032_cov_7.470849	1026	1068	34	7	42	0.1666667
NODE_629_length_3032_cov_7.470849	1026	1068	36	2	42	0.0476190
NODE_629_length_3032_cov_7.470849	1026	1068	38	6	42	0.1428571
NODE_629_length_3032_cov_7.470849	1026	1068	39	9	42	0.2142857
NODE_629_length_3032_cov_7.470849	1026	1068	40	4	42	0.0952381
NODE_629_length_3032_cov_7.470849	1026	1068	41	10	42	0.2380952
NODE_629_length_3032_cov_7.470849	1026	1068	43	1	42	0.0238095
NODE_630_length_3025_cov_11.862611	2371	2451	0	58	80	0.7250000
NODE_630_length_3025_cov_11.862611	2371	2451	1	18	80	0.2250000
NODE_630_length_3025_cov_11.862611	2371	2451	2	4	80	0.0500000
NODE_630_length_3025_cov_11.862611	2424	2504	0	5	80	0.0625000
NODE_630_length_3025_cov_11.862611	2424	2504	1	18	80	0.2250000
NODE_630_length_3025_cov_11.862611	2424	2504	2	24	80	0.3000000
NODE_630_length_3025_cov_11.862611	2424	2504	6	27	80	0.3375000
NODE_630_length_3025_cov_11.862611	2424	2504	10	6	80	0.0750000
NODE_630_length_3025_cov_11.862611	2500	2580	5	2	80	0.0250000
NODE_630_length_3025_cov_11.862611	2500	2580	6	9	80	0.1125000
NODE_630_length_3025_cov_11.862611	2500	2580	10	69	80	0.8625000
NODE_630_length_3025_cov_11.862611	2553	2633	0	37	80	0.4625000
NODE_630_length_3025_cov_11.862611	2553	2633	1	4	80	0.0500000
NODE_630_length_3025_cov_11.862611	2553	2633	4	2	80	0.0250000
NODE_630_length_3025_cov_11.862611	2553	2633	5	12	80	0.1500000
NODE_630_length_3025_cov_11.862611	2553	2633	6	9	80	0.1125000
NODE_630_length_3025_cov_11.862611	2553	2633	10	16	80	0.2000000
NODE_635_length_3012_cov_33.100240	2379	2459	4	14	80	0.1750000
NODE_635_length_3012_cov_33.100240	2379	2459	6	51	80	0.6375000
NODE_635_length_3012_cov_33.100240	2379	2459	8	15	80	0.1875000
NODE_635_length_3012_cov_33.100240	2432	2512	2	3	80	0.0375000
NODE_635_length_3012_cov_33.100240	2432	2512	4	46	80	0.5750000
NODE_635_length_3012_cov_33.100240	2432	2512	5	7	80	0.0875000
NODE_635_length_3012_cov_33.100240	2432	2512	6	24	80	0.3000000
NODE_637_length_3007_cov_11.843535	2641	2721	0	4	80	0.0500000
NODE_637_length_3007_cov_11.843535	2641	2721	2	4	80	0.0500000
NODE_637_length_3007_cov_11.843535	2641	2721	5	6	80	0.0750000
NODE_637_length_3007_cov_11.843535	2641	2721	6	53	80	0.6625000
NODE_637_length_3007_cov_11.843535	2641	2721	8	13	80	0.1625000
NODE_643_length_2992_cov_2.636709	2032	2112	0	80	80	1.0000000
NODE_643_length_2992_cov_2.636709	2085	2165	0	50	80	0.6250000
NODE_643_length_2992_cov_2.636709	2085	2165	5	26	80	0.3250000
NODE_643_length_2992_cov_2.636709	2085	2165	6	4	80	0.0500000
NODE_646_length_2978_cov_4.883293	382	452	0	19	70	0.2714286
NODE_646_length_2978_cov_4.883293	382	452	2	51	70	0.7285714
NODE_646_length_2978_cov_4.883293	1858	1938	0	80	80	1.0000000
NODE_646_length_2978_cov_4.883293	1926	1991	0	65	65	1.0000000
NODE_646_length_2978_cov_4.883293	1987	2066	0	79	79	1.0000000
NODE_646_length_2978_cov_4.883293	2040	2079	0	39	39	1.0000000
NODE_647_length_2976_cov_24.683003	1764	1844	0	80	80	1.0000000
NODE_647_length_2976_cov_24.683003	1817	1897	0	80	80	1.0000000
NODE_647_length_2976_cov_24.683003	1893	1973	0	80	80	1.0000000
NODE_647_length_2976_cov_24.683003	1946	2026	0	80	80	1.0000000
NODE_651_length_2967_cov_16.146095	238	318	6	39	80	0.4875000
NODE_651_length_2967_cov_16.146095	238	318	8	17	80	0.2125000
NODE_651_length_2967_cov_16.146095	238	318	10	24	80	0.3000000
NODE_651_length_2967_cov_16.146095	291	371	6	36	80	0.4500000
NODE_651_length_2967_cov_16.146095	291	371	8	2	80	0.0250000
NODE_651_length_2967_cov_16.146095	291	371	10	42	80	0.5250000
NODE_651_length_2967_cov_16.146095	367	447	6	19	80	0.2375000
NODE_651_length_2967_cov_16.146095	367	447	10	46	80	0.5750000
NODE_651_length_2967_cov_16.146095	367	447	11	10	80	0.1250000
NODE_651_length_2967_cov_16.146095	367	447	12	5	80	0.0625000
NODE_651_length_2967_cov_16.146095	420	500	6	66	80	0.8250000
NODE_651_length_2967_cov_16.146095	420	500	10	14	80	0.1750000
NODE_653_length_2965_cov_19.913468	92	134	50	5	42	0.1190476
NODE_653_length_2965_cov_19.913468	92	134	51	1	42	0.0238095
NODE_653_length_2965_cov_19.913468	92	134	62	2	42	0.0476190
NODE_653_length_2965_cov_19.913468	92	134	64	7	42	0.1666667
NODE_653_length_2965_cov_19.913468	92	134	73	2	42	0.0476190
NODE_653_length_2965_cov_19.913468	92	134	87	1	42	0.0238095
NODE_653_length_2965_cov_19.913468	92	134	92	2	42	0.0476190
NODE_653_length_2965_cov_19.913468	92	134	104	1	42	0.0238095
NODE_653_length_2965_cov_19.913468	92	134	110	21	42	0.5000000
NODE_653_length_2965_cov_19.913468	109	178	2	1	69	0.0144928
NODE_653_length_2965_cov_19.913468	109	178	4	2	69	0.0289855
NODE_653_length_2965_cov_19.913468	109	178	6	4	69	0.0579710
NODE_653_length_2965_cov_19.913468	109	178	8	2	69	0.0289855
NODE_653_length_2965_cov_19.913468	109	178	10	3	69	0.0434783
NODE_653_length_2965_cov_19.913468	109	178	12	6	69	0.0869565
NODE_653_length_2965_cov_19.913468	109	178	14	1	69	0.0144928
NODE_653_length_2965_cov_19.913468	109	178	18	3	69	0.0434783
NODE_653_length_2965_cov_19.913468	109	178	22	1	69	0.0144928
NODE_653_length_2965_cov_19.913468	109	178	24	3	69	0.0434783
NODE_653_length_2965_cov_19.913468	109	178	28	1	69	0.0144928
NODE_653_length_2965_cov_19.913468	109	178	32	6	69	0.0869565
NODE_653_length_2965_cov_19.913468	109	178	36	1	69	0.0144928
NODE_653_length_2965_cov_19.913468	109	178	40	4	69	0.0579710
NODE_653_length_2965_cov_19.913468	109	178	42	1	69	0.0144928
NODE_653_length_2965_cov_19.913468	109	178	44	2	69	0.0289855
NODE_653_length_2965_cov_19.913468	109	178	48	3	69	0.0434783
NODE_653_length_2965_cov_19.913468	109	178	50	5	69	0.0724638
NODE_653_length_2965_cov_19.913468	109	178	51	1	69	0.0144928
NODE_653_length_2965_cov_19.913468	109	178	62	2	69	0.0289855
NODE_653_length_2965_cov_19.913468	109	178	64	7	69	0.1014493
NODE_653_length_2965_cov_19.913468	109	178	73	2	69	0.0289855
NODE_653_length_2965_cov_19.913468	109	178	87	1	69	0.0144928
NODE_653_length_2965_cov_19.913468	109	178	92	2	69	0.0289855
NODE_653_length_2965_cov_19.913468	109	178	104	1	69	0.0144928
NODE_653_length_2965_cov_19.913468	109	178	110	4	69	0.0579710
NODE_653_length_2965_cov_19.913468	109	178	2	1	69	0.0144928
NODE_653_length_2965_cov_19.913468	109	178	4	2	69	0.0289855
NODE_653_length_2965_cov_19.913468	109	178	6	4	69	0.0579710
NODE_653_length_2965_cov_19.913468	109	178	8	2	69	0.0289855
NODE_653_length_2965_cov_19.913468	109	178	10	3	69	0.0434783
NODE_653_length_2965_cov_19.913468	109	178	12	6	69	0.0869565
NODE_653_length_2965_cov_19.913468	109	178	14	1	69	0.0144928
NODE_653_length_2965_cov_19.913468	109	178	18	3	69	0.0434783
NODE_653_length_2965_cov_19.913468	109	178	22	1	69	0.0144928
NODE_653_length_2965_cov_19.913468	109	178	24	3	69	0.0434783
NODE_653_length_2965_cov_19.913468	109	178	28	1	69	0.0144928
NODE_653_length_2965_cov_19.913468	109	178	32	6	69	0.0869565
NODE_653_length_2965_cov_19.913468	109	178	36	1	69	0.0144928
NODE_653_length_2965_cov_19.913468	109	178	40	4	69	0.0579710
NODE_653_length_2965_cov_19.913468	109	178	42	1	69	0.0144928
NODE_653_length_2965_cov_19.913468	109	178	44	2	69	0.0289855
NODE_653_length_2965_cov_19.913468	109	178	48	3	69	0.0434783
NODE_653_length_2965_cov_19.913468	109	178	50	5	69	0.0724638
NODE_653_length_2965_cov_19.913468	109	178	51	1	69	0.0144928
NODE_653_length_2965_cov_19.913468	109	178	62	2	69	0.0289855
NODE_653_length_2965_cov_19.913468	109	178	64	7	69	0.1014493
NODE_653_length_2965_cov_19.913468	109	178	73	2	69	0.0289855
NODE_653_length_2965_cov_19.913468	109	178	87	1	69	0.0144928
NODE_653_length_2965_cov_19.913468	109	178	92	2	69	0.0289855
NODE_653_length_2965_cov_19.913468	109	178	104	1	69	0.0144928
NODE_653_length_2965_cov_19.913468	109	178	110	4	69	0.0579710
NODE_653_length_2965_cov_19.913468	2298	2378	0	80	80	1.0000000
NODE_653_length_2965_cov_19.913468	2351	2431	0	80	80	1.0000000
NODE_653_length_2965_cov_19.913468	2427	2507	0	80	80	1.0000000
NODE_653_length_2965_cov_19.913468	2480	2560	0	80	80	1.0000000
NODE_656_length_2960_cov_35.741699	459	539	0	80	80	1.0000000
NODE_656_length_2960_cov_35.741699	512	592	0	80	80	1.0000000
NODE_659_length_2951_cov_7.195652	1100	1141	270	1	41	0.0243902
NODE_659_length_2951_cov_7.195652	1100	1141	271	1	41	0.0243902
NODE_659_length_2951_cov_7.195652	1100	1141	276	1	41	0.0243902
NODE_659_length_2951_cov_7.195652	1100	1141	292	1	41	0.0243902
NODE_659_length_2951_cov_7.195652	1100	1141	293	1	41	0.0243902
NODE_659_length_2951_cov_7.195652	1100	1141	295	3	41	0.0731707
NODE_659_length_2951_cov_7.195652	1100	1141	299	1	41	0.0243902
NODE_659_length_2951_cov_7.195652	1100	1141	301	1	41	0.0243902
NODE_659_length_2951_cov_7.195652	1100	1141	310	2	41	0.0487805
NODE_659_length_2951_cov_7.195652	1100	1141	312	1	41	0.0243902
NODE_659_length_2951_cov_7.195652	1100	1141	317	1	41	0.0243902
NODE_659_length_2951_cov_7.195652	1100	1141	322	1	41	0.0243902
NODE_659_length_2951_cov_7.195652	1100	1141	326	1	41	0.0243902
NODE_659_length_2951_cov_7.195652	1100	1141	336	1	41	0.0243902
NODE_659_length_2951_cov_7.195652	1100	1141	341	2	41	0.0487805
NODE_659_length_2951_cov_7.195652	1100	1141	342	1	41	0.0243902
NODE_659_length_2951_cov_7.195652	1100	1141	348	1	41	0.0243902
NODE_659_length_2951_cov_7.195652	1100	1141	363	1	41	0.0243902
NODE_659_length_2951_cov_7.195652	1100	1141	365	1	41	0.0243902
NODE_659_length_2951_cov_7.195652	1100	1141	373	1	41	0.0243902
NODE_659_length_2951_cov_7.195652	1100	1141	383	1	41	0.0243902
NODE_659_length_2951_cov_7.195652	1100	1141	387	1	41	0.0243902
NODE_659_length_2951_cov_7.195652	1100	1141	395	1	41	0.0243902
NODE_659_length_2951_cov_7.195652	1100	1141	398	1	41	0.0243902
NODE_659_length_2951_cov_7.195652	1100	1141	410	1	41	0.0243902
NODE_659_length_2951_cov_7.195652	1100	1141	414	2	41	0.0487805
NODE_659_length_2951_cov_7.195652	1100	1141	415	1	41	0.0243902
NODE_659_length_2951_cov_7.195652	1100	1141	416	3	41	0.0731707
NODE_659_length_2951_cov_7.195652	1100	1141	418	2	41	0.0487805
NODE_659_length_2951_cov_7.195652	1100	1141	432	1	41	0.0243902
NODE_659_length_2951_cov_7.195652	1100	1141	434	1	41	0.0243902
NODE_659_length_2951_cov_7.195652	1100	1141	442	1	41	0.0243902
NODE_659_length_2951_cov_7.195652	1100	1141	444	1	41	0.0243902
NODE_665_length_2935_cov_37.693230	1492	1572	20	1	80	0.0125000
NODE_665_length_2935_cov_37.693230	1492	1572	22	4	80	0.0500000
NODE_665_length_2935_cov_37.693230	1492	1572	24	2	80	0.0250000
NODE_665_length_2935_cov_37.693230	1492	1572	26	3	80	0.0375000
NODE_665_length_2935_cov_37.693230	1492	1572	29	2	80	0.0250000
NODE_665_length_2935_cov_37.693230	1492	1572	30	2	80	0.0250000
NODE_665_length_2935_cov_37.693230	1492	1572	31	1	80	0.0125000
NODE_665_length_2935_cov_37.693230	1492	1572	32	7	80	0.0875000
NODE_665_length_2935_cov_37.693230	1492	1572	34	11	80	0.1375000
NODE_665_length_2935_cov_37.693230	1492	1572	36	5	80	0.0625000
NODE_665_length_2935_cov_37.693230	1492	1572	38	11	80	0.1375000
NODE_665_length_2935_cov_37.693230	1492	1572	40	31	80	0.3875000
NODE_665_length_2935_cov_37.693230	1534	1589	21	2	55	0.0363636
NODE_665_length_2935_cov_37.693230	1534	1589	23	3	55	0.0545455
NODE_665_length_2935_cov_37.693230	1534	1589	24	2	55	0.0363636
NODE_665_length_2935_cov_37.693230	1534	1589	25	1	55	0.0181818
NODE_665_length_2935_cov_37.693230	1534	1589	27	3	55	0.0545455
NODE_665_length_2935_cov_37.693230	1534	1589	29	8	55	0.1454545
NODE_665_length_2935_cov_37.693230	1534	1589	31	1	55	0.0181818
NODE_665_length_2935_cov_37.693230	1534	1589	32	7	55	0.1272727
NODE_665_length_2935_cov_37.693230	1534	1589	34	5	55	0.0909091
NODE_665_length_2935_cov_37.693230	1534	1589	36	1	55	0.0181818
NODE_665_length_2935_cov_37.693230	1534	1589	38	9	55	0.1636364
NODE_665_length_2935_cov_37.693230	1534	1589	40	13	55	0.2363636
NODE_665_length_2935_cov_37.693230	1545	1619	9	9	74	0.1216216
NODE_665_length_2935_cov_37.693230	1545	1619	11	6	74	0.0810811
NODE_665_length_2935_cov_37.693230	1545	1619	13	4	74	0.0540541
NODE_665_length_2935_cov_37.693230	1545	1619	17	3	74	0.0405405
NODE_665_length_2935_cov_37.693230	1545	1619	19	3	74	0.0405405
NODE_665_length_2935_cov_37.693230	1545	1619	21	7	74	0.0945946
NODE_665_length_2935_cov_37.693230	1545	1619	23	3	74	0.0405405
NODE_665_length_2935_cov_37.693230	1545	1619	24	2	74	0.0270270
NODE_665_length_2935_cov_37.693230	1545	1619	25	1	74	0.0135135
NODE_665_length_2935_cov_37.693230	1545	1619	27	3	74	0.0405405
NODE_665_length_2935_cov_37.693230	1545	1619	29	8	74	0.1081081
NODE_665_length_2935_cov_37.693230	1545	1619	31	1	74	0.0135135
NODE_665_length_2935_cov_37.693230	1545	1619	32	7	74	0.0945946
NODE_665_length_2935_cov_37.693230	1545	1619	34	5	74	0.0675676
NODE_665_length_2935_cov_37.693230	1545	1619	36	1	74	0.0135135
NODE_665_length_2935_cov_37.693230	1545	1619	38	9	74	0.1216216
NODE_665_length_2935_cov_37.693230	1545	1619	40	2	74	0.0270270
NODE_665_length_2935_cov_37.693230	1625	1701	4	47	76	0.6184211
NODE_665_length_2935_cov_37.693230	1625	1701	5	11	76	0.1447368
NODE_665_length_2935_cov_37.693230	1625	1701	6	14	76	0.1842105
NODE_665_length_2935_cov_37.693230	1625	1701	7	4	76	0.0526316
NODE_665_length_2935_cov_37.693230	2863	2906	2	43	43	1.0000000
NODE_675_length_2913_cov_4.376688	2664	2739	8	43	75	0.5733333
NODE_675_length_2913_cov_4.376688	2664	2739	10	4	75	0.0533333
NODE_675_length_2913_cov_4.376688	2664	2739	12	5	75	0.0666667
NODE_675_length_2913_cov_4.376688	2664	2739	14	23	75	0.3066667
NODE_675_length_2913_cov_4.376688	2664	2723	8	42	59	0.7118644
NODE_675_length_2913_cov_4.376688	2664	2723	14	17	59	0.2881356
NODE_675_length_2913_cov_4.376688	2664	2739	8	43	75	0.5733333
NODE_675_length_2913_cov_4.376688	2664	2739	10	4	75	0.0533333
NODE_675_length_2913_cov_4.376688	2664	2739	12	5	75	0.0666667
NODE_675_length_2913_cov_4.376688	2664	2739	14	23	75	0.3066667
NODE_675_length_2913_cov_4.376688	2664	2739	8	43	75	0.5733333
NODE_675_length_2913_cov_4.376688	2664	2739	10	4	75	0.0533333
NODE_675_length_2913_cov_4.376688	2664	2739	12	5	75	0.0666667
NODE_675_length_2913_cov_4.376688	2664	2739	14	23	75	0.3066667
NODE_675_length_2913_cov_4.376688	2673	2739	8	34	66	0.5151515
NODE_675_length_2913_cov_4.376688	2673	2739	10	4	66	0.0606061
NODE_675_length_2913_cov_4.376688	2673	2739	12	5	66	0.0757576
NODE_675_length_2913_cov_4.376688	2673	2739	14	23	66	0.3484848
NODE_675_length_2913_cov_4.376688	2717	2780	8	38	63	0.6031746
NODE_675_length_2913_cov_4.376688	2717	2780	9	4	63	0.0634921
NODE_675_length_2913_cov_4.376688	2717	2780	10	4	63	0.0634921
NODE_675_length_2913_cov_4.376688	2717	2780	12	5	63	0.0793651
NODE_675_length_2913_cov_4.376688	2717	2780	14	12	63	0.1904762
NODE_675_length_2913_cov_4.376688	2745	2778	8	31	33	0.9393939
NODE_675_length_2913_cov_4.376688	2745	2778	9	2	33	0.0606061
NODE_677_length_2909_cov_71.975089	2090	2174	33	1	84	0.0119048
NODE_677_length_2909_cov_71.975089	2090	2174	34	1	84	0.0119048
NODE_677_length_2909_cov_71.975089	2090	2174	35	1	84	0.0119048
NODE_677_length_2909_cov_71.975089	2090	2174	38	1	84	0.0119048
NODE_677_length_2909_cov_71.975089	2090	2174	43	2	84	0.0238095
NODE_677_length_2909_cov_71.975089	2090	2174	44	3	84	0.0357143
NODE_677_length_2909_cov_71.975089	2090	2174	51	1	84	0.0119048
NODE_677_length_2909_cov_71.975089	2090	2174	58	1	84	0.0119048
NODE_677_length_2909_cov_71.975089	2090	2174	61	1	84	0.0119048
NODE_677_length_2909_cov_71.975089	2090	2174	65	1	84	0.0119048
NODE_677_length_2909_cov_71.975089	2090	2174	71	3	84	0.0357143
NODE_677_length_2909_cov_71.975089	2090	2174	73	1	84	0.0119048
NODE_677_length_2909_cov_71.975089	2090	2174	77	3	84	0.0357143
NODE_677_length_2909_cov_71.975089	2090	2174	79	3	84	0.0357143
NODE_677_length_2909_cov_71.975089	2090	2174	83	1	84	0.0119048
NODE_677_length_2909_cov_71.975089	2090	2174	85	1	84	0.0119048
NODE_677_length_2909_cov_71.975089	2090	2174	87	3	84	0.0357143
NODE_677_length_2909_cov_71.975089	2090	2174	89	1	84	0.0119048
NODE_677_length_2909_cov_71.975089	2090	2174	90	3	84	0.0357143
NODE_677_length_2909_cov_71.975089	2090	2174	91	5	84	0.0595238
NODE_677_length_2909_cov_71.975089	2090	2174	94	1	84	0.0119048
NODE_677_length_2909_cov_71.975089	2090	2174	98	1	84	0.0119048
NODE_677_length_2909_cov_71.975089	2090	2174	99	1	84	0.0119048
NODE_677_length_2909_cov_71.975089	2090	2174	100	3	84	0.0357143
NODE_677_length_2909_cov_71.975089	2090	2174	101	1	84	0.0119048
NODE_677_length_2909_cov_71.975089	2090	2174	104	4	84	0.0476190
NODE_677_length_2909_cov_71.975089	2090	2174	109	1	84	0.0119048
NODE_677_length_2909_cov_71.975089	2090	2174	116	1	84	0.0119048
NODE_677_length_2909_cov_71.975089	2090	2174	124	1	84	0.0119048
NODE_677_length_2909_cov_71.975089	2090	2174	126	1	84	0.0119048
NODE_677_length_2909_cov_71.975089	2090	2174	127	1	84	0.0119048
NODE_677_length_2909_cov_71.975089	2090	2174	133	2	84	0.0238095
NODE_677_length_2909_cov_71.975089	2090	2174	136	1	84	0.0119048
NODE_677_length_2909_cov_71.975089	2090	2174	138	1	84	0.0119048
NODE_677_length_2909_cov_71.975089	2090	2174	139	1	84	0.0119048
NODE_677_length_2909_cov_71.975089	2090	2174	141	1	84	0.0119048
NODE_677_length_2909_cov_71.975089	2090	2174	145	1	84	0.0119048
NODE_677_length_2909_cov_71.975089	2090	2174	153	1	84	0.0119048
NODE_677_length_2909_cov_71.975089	2090	2174	158	1	84	0.0119048
NODE_677_length_2909_cov_71.975089	2090	2174	165	1	84	0.0119048
NODE_677_length_2909_cov_71.975089	2090	2174	173	1	84	0.0119048
NODE_677_length_2909_cov_71.975089	2090	2174	175	2	84	0.0238095
NODE_677_length_2909_cov_71.975089	2090	2174	176	2	84	0.0238095
NODE_677_length_2909_cov_71.975089	2090	2174	178	2	84	0.0238095
NODE_677_length_2909_cov_71.975089	2090	2174	180	2	84	0.0238095
NODE_677_length_2909_cov_71.975089	2090	2174	183	1	84	0.0119048
NODE_677_length_2909_cov_71.975089	2090	2174	185	3	84	0.0357143
NODE_677_length_2909_cov_71.975089	2090	2174	189	1	84	0.0119048
NODE_677_length_2909_cov_71.975089	2090	2174	191	1	84	0.0119048
NODE_677_length_2909_cov_71.975089	2090	2174	194	1	84	0.0119048
NODE_677_length_2909_cov_71.975089	2090	2174	195	2	84	0.0238095
NODE_677_length_2909_cov_71.975089	2090	2174	199	1	84	0.0119048
NODE_677_length_2909_cov_71.975089	2090	2174	200	1	84	0.0119048
NODE_677_length_2909_cov_71.975089	2090	2174	204	1	84	0.0119048
NODE_678_length_2908_cov_5.937344	2495	2575	0	80	80	1.0000000
NODE_678_length_2908_cov_5.937344	2548	2628	0	80	80	1.0000000
NODE_678_length_2908_cov_5.937344	2624	2704	0	80	80	1.0000000
NODE_678_length_2908_cov_5.937344	2677	2757	0	80	80	1.0000000
NODE_679_length_2905_cov_12.777619	2358	2419	2	58	61	0.9508197
NODE_679_length_2905_cov_12.777619	2358	2419	12	3	61	0.0491803
NODE_679_length_2905_cov_12.777619	2358	2419	2	58	61	0.9508197
NODE_679_length_2905_cov_12.777619	2358	2419	12	3	61	0.0491803
NODE_679_length_2905_cov_12.777619	2358	2419	2	58	61	0.9508197
NODE_679_length_2905_cov_12.777619	2358	2419	12	3	61	0.0491803
NODE_679_length_2905_cov_12.777619	2392	2472	2	66	80	0.8250000
NODE_679_length_2905_cov_12.777619	2392	2472	4	14	80	0.1750000
NODE_680_length_2903_cov_5.474322	2423	2464	38	1	41	0.0243902
NODE_680_length_2903_cov_5.474322	2423	2464	40	1	41	0.0243902
NODE_680_length_2903_cov_5.474322	2423	2464	42	2	41	0.0487805
NODE_680_length_2903_cov_5.474322	2423	2464	45	2	41	0.0487805
NODE_680_length_2903_cov_5.474322	2423	2464	47	2	41	0.0487805
NODE_680_length_2903_cov_5.474322	2423	2464	48	33	41	0.8048781
NODE_684_length_2898_cov_5.786352	0	74	0	59	74	0.7972973
NODE_684_length_2898_cov_5.786352	0	74	2	15	74	0.2027027
NODE_684_length_2898_cov_5.786352	47	124	0	12	77	0.1558442
NODE_684_length_2898_cov_5.786352	47	124	2	34	77	0.4415585
NODE_684_length_2898_cov_5.786352	47	124	3	9	77	0.1168831
NODE_684_length_2898_cov_5.786352	47	124	4	22	77	0.2857143
NODE_686_length_2895_cov_8.519313	869	949	1	52	80	0.6500000
NODE_686_length_2895_cov_8.519313	869	949	2	28	80	0.3500000
NODE_686_length_2895_cov_8.519313	922	1002	2	80	80	1.0000000
NODE_688_length_2894_cov_2.036136	2677	2757	6	3	80	0.0375000
NODE_688_length_2894_cov_2.036136	2677	2757	8	2	80	0.0250000
NODE_688_length_2894_cov_2.036136	2677	2757	12	5	80	0.0625000
NODE_688_length_2894_cov_2.036136	2677	2757	16	10	80	0.1250000
NODE_688_length_2894_cov_2.036136	2677	2757	18	5	80	0.0625000
NODE_688_length_2894_cov_2.036136	2677	2757	20	28	80	0.3500000
NODE_688_length_2894_cov_2.036136	2677	2757	22	27	80	0.3375000
NODE_689_length_2891_cov_7.938037	193	275	2	4	82	0.0487805
NODE_689_length_2891_cov_7.938037	193	275	3	8	82	0.0975610
NODE_689_length_2891_cov_7.938037	193	275	4	18	82	0.2195122
NODE_689_length_2891_cov_7.938037	193	275	6	11	82	0.1341463
NODE_689_length_2891_cov_7.938037	193	275	8	2	82	0.0243902
NODE_689_length_2891_cov_7.938037	193	275	10	2	82	0.0243902
NODE_689_length_2891_cov_7.938037	193	275	11	1	82	0.0121951
NODE_689_length_2891_cov_7.938037	193	275	13	1	82	0.0121951
NODE_689_length_2891_cov_7.938037	193	275	15	2	82	0.0243902
NODE_689_length_2891_cov_7.938037	193	275	16	4	82	0.0487805
NODE_689_length_2891_cov_7.938037	193	275	18	4	82	0.0487805
NODE_689_length_2891_cov_7.938037	193	275	20	3	82	0.0365854
NODE_689_length_2891_cov_7.938037	193	275	22	1	82	0.0121951
NODE_689_length_2891_cov_7.938037	193	275	32	1	82	0.0121951
NODE_689_length_2891_cov_7.938037	193	275	34	3	82	0.0365854
NODE_689_length_2891_cov_7.938037	193	275	36	2	82	0.0243902
NODE_689_length_2891_cov_7.938037	193	275	38	8	82	0.0975610
NODE_689_length_2891_cov_7.938037	193	275	40	2	82	0.0243902
NODE_689_length_2891_cov_7.938037	193	275	44	1	82	0.0121951
NODE_689_length_2891_cov_7.938037	193	275	46	1	82	0.0121951
NODE_689_length_2891_cov_7.938037	193	275	48	1	82	0.0121951
NODE_689_length_2891_cov_7.938037	193	275	50	1	82	0.0121951
NODE_689_length_2891_cov_7.938037	193	275	54	1	82	0.0121951
NODE_691_length_2889_cov_11.426882	407	487	0	80	80	1.0000000
NODE_691_length_2889_cov_11.426882	460	540	0	34	80	0.4250000
NODE_691_length_2889_cov_11.426882	460	540	1	11	80	0.1375000
NODE_691_length_2889_cov_11.426882	460	540	2	35	80	0.4375000
NODE_691_length_2889_cov_11.426882	1006	1086	5	3	80	0.0375000
NODE_691_length_2889_cov_11.426882	1006	1086	9	2	80	0.0250000
NODE_691_length_2889_cov_11.426882	1006	1086	13	6	80	0.0750000
NODE_691_length_2889_cov_11.426882	1006	1086	15	3	80	0.0375000
NODE_691_length_2889_cov_11.426882	1006	1086	17	5	80	0.0625000
NODE_691_length_2889_cov_11.426882	1006	1086	19	1	80	0.0125000
NODE_691_length_2889_cov_11.426882	1006	1086	21	1	80	0.0125000
NODE_691_length_2889_cov_11.426882	1006	1086	27	5	80	0.0625000
NODE_691_length_2889_cov_11.426882	1006	1086	28	9	80	0.1125000
NODE_691_length_2889_cov_11.426882	1006	1086	30	5	80	0.0625000
NODE_691_length_2889_cov_11.426882	1006	1086	33	2	80	0.0250000
NODE_691_length_2889_cov_11.426882	1006	1086	35	1	80	0.0125000
NODE_691_length_2889_cov_11.426882	1006	1086	37	15	80	0.1875000
NODE_691_length_2889_cov_11.426882	1006	1086	38	4	80	0.0500000
NODE_691_length_2889_cov_11.426882	1006	1086	39	4	80	0.0500000
NODE_691_length_2889_cov_11.426882	1006	1086	44	1	80	0.0125000
NODE_691_length_2889_cov_11.426882	1006	1086	45	3	80	0.0375000
NODE_691_length_2889_cov_11.426882	1006	1086	47	7	80	0.0875000
NODE_691_length_2889_cov_11.426882	1006	1086	49	3	80	0.0375000
NODE_691_length_2889_cov_11.426882	1007	1086	5	3	79	0.0379747
NODE_691_length_2889_cov_11.426882	1007	1086	9	2	79	0.0253165
NODE_691_length_2889_cov_11.426882	1007	1086	13	6	79	0.0759494
NODE_691_length_2889_cov_11.426882	1007	1086	15	3	79	0.0379747
NODE_691_length_2889_cov_11.426882	1007	1086	17	5	79	0.0632911
NODE_691_length_2889_cov_11.426882	1007	1086	19	1	79	0.0126582
NODE_691_length_2889_cov_11.426882	1007	1086	21	1	79	0.0126582
NODE_691_length_2889_cov_11.426882	1007	1086	27	5	79	0.0632911
NODE_691_length_2889_cov_11.426882	1007	1086	28	9	79	0.1139240
NODE_691_length_2889_cov_11.426882	1007	1086	30	5	79	0.0632911
NODE_691_length_2889_cov_11.426882	1007	1086	33	2	79	0.0253165
NODE_691_length_2889_cov_11.426882	1007	1086	35	1	79	0.0126582
NODE_691_length_2889_cov_11.426882	1007	1086	37	15	79	0.1898734
NODE_691_length_2889_cov_11.426882	1007	1086	38	4	79	0.0506329
NODE_691_length_2889_cov_11.426882	1007	1086	39	4	79	0.0506329
NODE_691_length_2889_cov_11.426882	1007	1086	44	1	79	0.0126582
NODE_691_length_2889_cov_11.426882	1007	1086	45	3	79	0.0379747
NODE_691_length_2889_cov_11.426882	1007	1086	47	7	79	0.0886076
NODE_691_length_2889_cov_11.426882	1007	1086	49	2	79	0.0253165
NODE_691_length_2889_cov_11.426882	1059	1138	0	47	79	0.5949367
NODE_691_length_2889_cov_11.426882	1059	1138	2	3	79	0.0379747
NODE_691_length_2889_cov_11.426882	1059	1138	5	5	79	0.0632911
NODE_691_length_2889_cov_11.426882	1059	1138	9	2	79	0.0253165
NODE_691_length_2889_cov_11.426882	1059	1138	13	6	79	0.0759494
NODE_691_length_2889_cov_11.426882	1059	1138	15	3	79	0.0379747
NODE_691_length_2889_cov_11.426882	1059	1138	17	5	79	0.0632911
NODE_691_length_2889_cov_11.426882	1059	1138	19	1	79	0.0126582
NODE_691_length_2889_cov_11.426882	1059	1138	21	1	79	0.0126582
NODE_691_length_2889_cov_11.426882	1059	1138	27	5	79	0.0632911
NODE_691_length_2889_cov_11.426882	1059	1138	28	1	79	0.0126582
NODE_691_length_2889_cov_11.426882	1059	1138	0	47	79	0.5949367
NODE_691_length_2889_cov_11.426882	1059	1138	2	3	79	0.0379747
NODE_691_length_2889_cov_11.426882	1059	1138	5	5	79	0.0632911
NODE_691_length_2889_cov_11.426882	1059	1138	9	2	79	0.0253165
NODE_691_length_2889_cov_11.426882	1059	1138	13	6	79	0.0759494
NODE_691_length_2889_cov_11.426882	1059	1138	15	3	79	0.0379747
NODE_691_length_2889_cov_11.426882	1059	1138	17	5	79	0.0632911
NODE_691_length_2889_cov_11.426882	1059	1138	19	1	79	0.0126582
NODE_691_length_2889_cov_11.426882	1059	1138	21	1	79	0.0126582
NODE_691_length_2889_cov_11.426882	1059	1138	27	5	79	0.0632911
NODE_691_length_2889_cov_11.426882	1059	1138	28	1	79	0.0126582
NODE_693_length_2888_cov_3.789172	992	1072	2	6	80	0.0750000
NODE_693_length_2888_cov_3.789172	992	1072	6	9	80	0.1125000
NODE_693_length_2888_cov_3.789172	992	1072	8	65	80	0.8125000
NODE_693_length_2888_cov_3.789172	1045	1087	2	21	42	0.5000000
NODE_693_length_2888_cov_3.789172	1045	1087	8	21	42	0.5000000
NODE_697_length_2878_cov_6.277798	2712	2781	5	1	69	0.0144928
NODE_697_length_2878_cov_6.277798	2712	2781	7	2	69	0.0289855
NODE_697_length_2878_cov_6.277798	2712	2781	9	26	69	0.3768116
NODE_697_length_2878_cov_6.277798	2712	2781	11	25	69	0.3623188
NODE_697_length_2878_cov_6.277798	2712	2781	12	15	69	0.2173913
NODE_703_length_2862_cov_9.060803	2409	2489	0	80	80	1.0000000
NODE_703_length_2862_cov_9.060803	2462	2542	0	30	80	0.3750000
NODE_703_length_2862_cov_9.060803	2462	2542	2	50	80	0.6250000
NODE_712_length_2840_cov_2.079533	1660	1740	0	80	80	1.0000000
NODE_713_length_2839_cov_16.762044	327	402	0	75	75	1.0000000
NODE_713_length_2839_cov_16.762044	380	468	0	88	88	1.0000000
NODE_713_length_2839_cov_16.762044	1021	1101	0	80	80	1.0000000
NODE_713_length_2839_cov_16.762044	1074	1154	0	80	80	1.0000000
NODE_714_length_2835_cov_29.691520	1552	1581	151	3	29	0.1034483
NODE_714_length_2835_cov_29.691520	1552	1581	153	4	29	0.1379310
NODE_714_length_2835_cov_29.691520	1552	1581	156	1	29	0.0344828
NODE_714_length_2835_cov_29.691520	1552	1581	158	3	29	0.1034483
NODE_714_length_2835_cov_29.691520	1552	1581	159	1	29	0.0344828
NODE_714_length_2835_cov_29.691520	1552	1581	162	1	29	0.0344828
NODE_714_length_2835_cov_29.691520	1552	1581	165	1	29	0.0344828
NODE_714_length_2835_cov_29.691520	1552	1581	167	4	29	0.1379310
NODE_714_length_2835_cov_29.691520	1552	1581	169	1	29	0.0344828
NODE_714_length_2835_cov_29.691520	1552	1581	170	1	29	0.0344828
NODE_714_length_2835_cov_29.691520	1552	1581	173	2	29	0.0689655
NODE_714_length_2835_cov_29.691520	1552	1581	175	2	29	0.0689655
NODE_714_length_2835_cov_29.691520	1552	1581	176	3	29	0.1034483
NODE_714_length_2835_cov_29.691520	1552	1581	178	1	29	0.0344828
NODE_714_length_2835_cov_29.691520	1552	1581	179	1	29	0.0344828
NODE_714_length_2835_cov_29.691520	1554	1629	42	1	75	0.0133333
NODE_714_length_2835_cov_29.691520	1554	1629	44	2	75	0.0266667
NODE_714_length_2835_cov_29.691520	1554	1629	47	1	75	0.0133333
NODE_714_length_2835_cov_29.691520	1554	1629	48	1	75	0.0133333
NODE_714_length_2835_cov_29.691520	1554	1629	50	1	75	0.0133333
NODE_714_length_2835_cov_29.691520	1554	1629	51	1	75	0.0133333
NODE_714_length_2835_cov_29.691520	1554	1629	52	2	75	0.0266667
NODE_714_length_2835_cov_29.691520	1554	1629	58	1	75	0.0133333
NODE_714_length_2835_cov_29.691520	1554	1629	68	1	75	0.0133333
NODE_714_length_2835_cov_29.691520	1554	1629	73	1	75	0.0133333
NODE_714_length_2835_cov_29.691520	1554	1629	75	2	75	0.0266667
NODE_714_length_2835_cov_29.691520	1554	1629	84	2	75	0.0266667
NODE_714_length_2835_cov_29.691520	1554	1629	96	1	75	0.0133333
NODE_714_length_2835_cov_29.691520	1554	1629	99	1	75	0.0133333
NODE_714_length_2835_cov_29.691520	1554	1629	101	1	75	0.0133333
NODE_714_length_2835_cov_29.691520	1554	1629	103	1	75	0.0133333
NODE_714_length_2835_cov_29.691520	1554	1629	105	2	75	0.0266667
NODE_714_length_2835_cov_29.691520	1554	1629	111	1	75	0.0133333
NODE_714_length_2835_cov_29.691520	1554	1629	116	1	75	0.0133333
NODE_714_length_2835_cov_29.691520	1554	1629	119	2	75	0.0266667
NODE_714_length_2835_cov_29.691520	1554	1629	123	1	75	0.0133333
NODE_714_length_2835_cov_29.691520	1554	1629	124	1	75	0.0133333
NODE_714_length_2835_cov_29.691520	1554	1629	126	3	75	0.0400000
NODE_714_length_2835_cov_29.691520	1554	1629	128	1	75	0.0133333
NODE_714_length_2835_cov_29.691520	1554	1629	130	1	75	0.0133333
NODE_714_length_2835_cov_29.691520	1554	1629	134	2	75	0.0266667
NODE_714_length_2835_cov_29.691520	1554	1629	135	1	75	0.0133333
NODE_714_length_2835_cov_29.691520	1554	1629	139	4	75	0.0533333
NODE_714_length_2835_cov_29.691520	1554	1629	140	1	75	0.0133333
NODE_714_length_2835_cov_29.691520	1554	1629	144	1	75	0.0133333
NODE_714_length_2835_cov_29.691520	1554	1629	147	2	75	0.0266667
NODE_714_length_2835_cov_29.691520	1554	1629	149	1	75	0.0133333
NODE_714_length_2835_cov_29.691520	1554	1629	151	6	75	0.0800000
NODE_714_length_2835_cov_29.691520	1554	1629	153	4	75	0.0533333
NODE_714_length_2835_cov_29.691520	1554	1629	156	1	75	0.0133333
NODE_714_length_2835_cov_29.691520	1554	1629	158	3	75	0.0400000
NODE_714_length_2835_cov_29.691520	1554	1629	159	1	75	0.0133333
NODE_714_length_2835_cov_29.691520	1554	1629	162	1	75	0.0133333
NODE_714_length_2835_cov_29.691520	1554	1629	165	1	75	0.0133333
NODE_714_length_2835_cov_29.691520	1554	1629	167	4	75	0.0533333
NODE_714_length_2835_cov_29.691520	1554	1629	169	1	75	0.0133333
NODE_714_length_2835_cov_29.691520	1554	1629	170	1	75	0.0133333
NODE_714_length_2835_cov_29.691520	1554	1629	173	2	75	0.0266667
NODE_714_length_2835_cov_29.691520	1554	1629	175	2	75	0.0266667
NODE_714_length_2835_cov_29.691520	1554	1629	176	3	75	0.0400000
NODE_720_length_2825_cov_9.731108	487	567	0	3	80	0.0375000
NODE_720_length_2825_cov_9.731108	487	567	9	30	80	0.3750000
NODE_720_length_2825_cov_9.731108	487	567	11	31	80	0.3875000
NODE_720_length_2825_cov_9.731108	487	567	19	16	80	0.2000000
NODE_720_length_2825_cov_9.731108	540	620	11	11	80	0.1375000
NODE_720_length_2825_cov_9.731108	540	620	18	8	80	0.1000000
NODE_720_length_2825_cov_9.731108	540	620	19	60	80	0.7500000
NODE_720_length_2825_cov_9.731108	540	620	20	1	80	0.0125000
NODE_726_length_2810_cov_2.844338	206	289	37	3	83	0.0361446
NODE_726_length_2810_cov_2.844338	206	289	39	2	83	0.0240964
NODE_726_length_2810_cov_2.844338	206	289	41	1	83	0.0120482
NODE_726_length_2810_cov_2.844338	206	289	42	2	83	0.0240964
NODE_726_length_2810_cov_2.844338	206	289	45	5	83	0.0602410
NODE_726_length_2810_cov_2.844338	206	289	47	8	83	0.0963855
NODE_726_length_2810_cov_2.844338	206	289	49	4	83	0.0481928
NODE_726_length_2810_cov_2.844338	206	289	50	1	83	0.0120482
NODE_726_length_2810_cov_2.844338	206	289	52	10	83	0.1204819
NODE_726_length_2810_cov_2.844338	206	289	55	5	83	0.0602410
NODE_726_length_2810_cov_2.844338	206	289	57	1	83	0.0120482
NODE_726_length_2810_cov_2.844338	206	289	58	1	83	0.0120482
NODE_726_length_2810_cov_2.844338	206	289	59	2	83	0.0240964
NODE_726_length_2810_cov_2.844338	206	289	66	1	83	0.0120482
NODE_726_length_2810_cov_2.844338	206	289	67	1	83	0.0120482
NODE_726_length_2810_cov_2.844338	206	289	69	1	83	0.0120482
NODE_726_length_2810_cov_2.844338	206	289	71	2	83	0.0240964
NODE_726_length_2810_cov_2.844338	206	289	72	1	83	0.0120482
NODE_726_length_2810_cov_2.844338	206	289	74	6	83	0.0722892
NODE_726_length_2810_cov_2.844338	206	289	76	1	83	0.0120482
NODE_726_length_2810_cov_2.844338	206	289	82	3	83	0.0361446
NODE_726_length_2810_cov_2.844338	206	289	84	6	83	0.0722892
NODE_726_length_2810_cov_2.844338	206	289	85	1	83	0.0120482
NODE_726_length_2810_cov_2.844338	206	289	88	1	83	0.0120482
NODE_726_length_2810_cov_2.844338	206	289	91	2	83	0.0240964
NODE_726_length_2810_cov_2.844338	206	289	92	2	83	0.0240964
NODE_726_length_2810_cov_2.844338	206	289	93	3	83	0.0361446
NODE_726_length_2810_cov_2.844338	206	289	94	5	83	0.0602410
NODE_726_length_2810_cov_2.844338	206	289	99	2	83	0.0240964
NODE_728_length_2808_cov_2.867110	140	163	4	1	23	0.0434783
NODE_728_length_2808_cov_2.867110	140	163	6	2	23	0.0869565
NODE_728_length_2808_cov_2.867110	140	163	8	15	23	0.6521739
NODE_728_length_2808_cov_2.867110	140	163	10	5	23	0.2173913
NODE_729_length_2807_cov_8.423191	125	205	0	80	80	1.0000000
NODE_729_length_2807_cov_8.423191	178	258	0	80	80	1.0000000
NODE_729_length_2807_cov_8.423191	2451	2515	0	64	64	1.0000000
NODE_735_length_2801_cov_26.131384	461	521	0	60	60	1.0000000
NODE_735_length_2801_cov_26.131384	494	574	0	80	80	1.0000000
NODE_735_length_2801_cov_26.131384	1536	1596	22	1	60	0.0166667
NODE_735_length_2801_cov_26.131384	1536	1596	24	2	60	0.0333333
NODE_735_length_2801_cov_26.131384	1536	1596	26	2	60	0.0333333
NODE_735_length_2801_cov_26.131384	1536	1596	28	2	60	0.0333333
NODE_735_length_2801_cov_26.131384	1536	1596	30	1	60	0.0166667
NODE_735_length_2801_cov_26.131384	1536	1596	32	1	60	0.0166667
NODE_735_length_2801_cov_26.131384	1536	1596	36	1	60	0.0166667
NODE_735_length_2801_cov_26.131384	1536	1596	38	1	60	0.0166667
NODE_735_length_2801_cov_26.131384	1536	1596	44	1	60	0.0166667
NODE_735_length_2801_cov_26.131384	1536	1596	48	1	60	0.0166667
NODE_735_length_2801_cov_26.131384	1536	1596	50	1	60	0.0166667
NODE_735_length_2801_cov_26.131384	1536	1596	52	1	60	0.0166667
NODE_735_length_2801_cov_26.131384	1536	1596	54	1	60	0.0166667
NODE_735_length_2801_cov_26.131384	1536	1596	56	1	60	0.0166667
NODE_735_length_2801_cov_26.131384	1536	1596	58	1	60	0.0166667
NODE_735_length_2801_cov_26.131384	1536	1596	59	1	60	0.0166667
NODE_735_length_2801_cov_26.131384	1536	1596	63	2	60	0.0333333
NODE_735_length_2801_cov_26.131384	1536	1596	67	2	60	0.0333333
NODE_735_length_2801_cov_26.131384	1536	1596	69	1	60	0.0166667
NODE_735_length_2801_cov_26.131384	1536	1596	70	1	60	0.0166667
NODE_735_length_2801_cov_26.131384	1536	1596	72	1	60	0.0166667
NODE_735_length_2801_cov_26.131384	1536	1596	74	1	60	0.0166667
NODE_735_length_2801_cov_26.131384	1536	1596	80	2	60	0.0333333
NODE_735_length_2801_cov_26.131384	1536	1596	86	2	60	0.0333333
NODE_735_length_2801_cov_26.131384	1536	1596	88	1	60	0.0166667
NODE_735_length_2801_cov_26.131384	1536	1596	91	4	60	0.0666667
NODE_735_length_2801_cov_26.131384	1536	1596	93	2	60	0.0333333
NODE_735_length_2801_cov_26.131384	1536	1596	97	2	60	0.0333333
NODE_735_length_2801_cov_26.131384	1536	1596	99	1	60	0.0166667
NODE_735_length_2801_cov_26.131384	1536	1596	100	2	60	0.0333333
NODE_735_length_2801_cov_26.131384	1536	1596	105	2	60	0.0333333
NODE_735_length_2801_cov_26.131384	1536	1596	107	1	60	0.0166667
NODE_735_length_2801_cov_26.131384	1536	1596	109	3	60	0.0500000
NODE_735_length_2801_cov_26.131384	1536	1596	111	8	60	0.1333333
NODE_735_length_2801_cov_26.131384	1536	1596	120	1	60	0.0166667
NODE_735_length_2801_cov_26.131384	1536	1596	124	2	60	0.0333333
NODE_735_length_2801_cov_26.131384	1815	1881	0	66	66	1.0000000
NODE_735_length_2801_cov_26.131384	1854	1934	0	80	80	1.0000000
NODE_736_length_2801_cov_3.594375	2589	2645	0	56	56	1.0000000
NODE_738_length_2796_cov_94.511680	1090	1137	24	3	47	0.0638298
NODE_738_length_2796_cov_94.511680	1090	1137	28	3	47	0.0638298
NODE_738_length_2796_cov_94.511680	1090	1137	30	1	47	0.0212766
NODE_738_length_2796_cov_94.511680	1090	1137	34	3	47	0.0638298
NODE_738_length_2796_cov_94.511680	1090	1137	38	1	47	0.0212766
NODE_738_length_2796_cov_94.511680	1090	1137	44	1	47	0.0212766
NODE_738_length_2796_cov_94.511680	1090	1137	45	2	47	0.0425532
NODE_738_length_2796_cov_94.511680	1090	1137	48	2	47	0.0425532
NODE_738_length_2796_cov_94.511680	1090	1137	52	1	47	0.0212766
NODE_738_length_2796_cov_94.511680	1090	1137	54	3	47	0.0638298
NODE_738_length_2796_cov_94.511680	1090	1137	55	1	47	0.0212766
NODE_738_length_2796_cov_94.511680	1090	1137	57	2	47	0.0425532
NODE_738_length_2796_cov_94.511680	1090	1137	59	1	47	0.0212766
NODE_738_length_2796_cov_94.511680	1090	1137	63	1	47	0.0212766
NODE_738_length_2796_cov_94.511680	1090	1137	66	1	47	0.0212766
NODE_738_length_2796_cov_94.511680	1090	1137	68	3	47	0.0638298
NODE_738_length_2796_cov_94.511680	1090	1137	70	2	47	0.0425532
NODE_738_length_2796_cov_94.511680	1090	1137	75	1	47	0.0212766
NODE_738_length_2796_cov_94.511680	1090	1137	77	1	47	0.0212766
NODE_738_length_2796_cov_94.511680	1090	1137	79	5	47	0.1063830
NODE_738_length_2796_cov_94.511680	1090	1137	84	1	47	0.0212766
NODE_738_length_2796_cov_94.511680	1090	1137	104	1	47	0.0212766
NODE_738_length_2796_cov_94.511680	1090	1137	107	1	47	0.0212766
NODE_738_length_2796_cov_94.511680	1090	1137	109	1	47	0.0212766
NODE_738_length_2796_cov_94.511680	1090	1137	117	1	47	0.0212766
NODE_738_length_2796_cov_94.511680	1090	1137	121	1	47	0.0212766
NODE_738_length_2796_cov_94.511680	1090	1137	126	1	47	0.0212766
NODE_738_length_2796_cov_94.511680	1090	1137	131	1	47	0.0212766
NODE_738_length_2796_cov_94.511680	1090	1137	133	1	47	0.0212766
NODE_738_length_2796_cov_94.511680	2717	2796	0	79	79	1.0000000
NODE_744_length_2791_cov_9.997028	310	390	2	80	80	1.0000000
NODE_744_length_2791_cov_9.997028	363	443	0	49	80	0.6125000
NODE_744_length_2791_cov_9.997028	363	443	2	31	80	0.3875000
NODE_752_length_2778_cov_31.340799	2241	2321	0	80	80	1.0000000
NODE_752_length_2778_cov_31.340799	2294	2374	0	27	80	0.3375000
NODE_752_length_2778_cov_31.340799	2294	2374	4	53	80	0.6625000
NODE_752_length_2778_cov_31.340799	2370	2450	4	33	80	0.4125000
NODE_752_length_2778_cov_31.340799	2370	2450	6	30	80	0.3750000
NODE_752_length_2778_cov_31.340799	2370	2450	8	17	80	0.2125000
NODE_752_length_2778_cov_31.340799	2423	2503	2	25	80	0.3125000
NODE_752_length_2778_cov_31.340799	2423	2503	6	55	80	0.6875000
NODE_752_length_2778_cov_31.340799	2564	2620	0	45	56	0.8035714
NODE_752_length_2778_cov_31.340799	2564	2620	2	11	56	0.1964286
NODE_758_length_2767_cov_12.450150	1941	2021	0	35	80	0.4375000
NODE_758_length_2767_cov_12.450150	1941	2021	2	14	80	0.1750000
NODE_758_length_2767_cov_12.450150	1941	2021	4	31	80	0.3875000
NODE_758_length_2767_cov_12.450150	1994	2074	2	13	80	0.1625000
NODE_758_length_2767_cov_12.450150	1994	2074	4	67	80	0.8375000
NODE_767_length_2745_cov_5.322751	511	583	0	72	72	1.0000000
NODE_777_length_2720_cov_25.561618	2213	2293	2	80	80	1.0000000
NODE_777_length_2720_cov_25.561618	2266	2346	2	80	80	1.0000000
NODE_782_length_2716_cov_39.885747	715	795	8	52	80	0.6500000
NODE_782_length_2716_cov_39.885747	715	795	9	3	80	0.0375000
NODE_782_length_2716_cov_39.885747	715	795	10	25	80	0.3125000
NODE_782_length_2716_cov_39.885747	768	848	2	5	80	0.0625000
NODE_782_length_2716_cov_39.885747	768	848	4	37	80	0.4625000
NODE_782_length_2716_cov_39.885747	768	848	6	4	80	0.0500000
NODE_782_length_2716_cov_39.885747	768	848	8	30	80	0.3750000
NODE_782_length_2716_cov_39.885747	768	848	9	3	80	0.0375000
NODE_782_length_2716_cov_39.885747	768	848	10	1	80	0.0125000
NODE_782_length_2716_cov_39.885747	844	924	0	10	80	0.1250000
NODE_782_length_2716_cov_39.885747	844	924	2	70	80	0.8750000
NODE_782_length_2716_cov_39.885747	897	977	0	63	80	0.7875000
NODE_782_length_2716_cov_39.885747	897	977	2	17	80	0.2125000
NODE_785_length_2710_cov_10.896974	2410	2446	0	36	36	1.0000000
NODE_785_length_2710_cov_10.896974	2419	2499	0	32	80	0.4000000
NODE_785_length_2710_cov_10.896974	2419	2499	4	48	80	0.6000000
NODE_788_length_2708_cov_25.097355	2289	2369	0	80	80	1.0000000
NODE_788_length_2708_cov_25.097355	2342	2422	0	49	80	0.6125000
NODE_788_length_2708_cov_25.097355	2342	2422	2	31	80	0.3875000
NODE_789_length_2708_cov_14.569950	18	98	208	1	80	0.0125000
NODE_789_length_2708_cov_14.569950	18	98	211	1	80	0.0125000
NODE_789_length_2708_cov_14.569950	18	98	214	1	80	0.0125000
NODE_789_length_2708_cov_14.569950	18	98	218	1	80	0.0125000
NODE_789_length_2708_cov_14.569950	18	98	219	1	80	0.0125000
NODE_789_length_2708_cov_14.569950	18	98	235	1	80	0.0125000
NODE_789_length_2708_cov_14.569950	18	98	242	1	80	0.0125000
NODE_789_length_2708_cov_14.569950	18	98	244	2	80	0.0250000
NODE_789_length_2708_cov_14.569950	18	98	246	1	80	0.0125000
NODE_789_length_2708_cov_14.569950	18	98	250	3	80	0.0375000
NODE_789_length_2708_cov_14.569950	18	98	252	2	80	0.0250000
NODE_789_length_2708_cov_14.569950	18	98	257	2	80	0.0250000
NODE_789_length_2708_cov_14.569950	18	98	258	3	80	0.0375000
NODE_789_length_2708_cov_14.569950	18	98	266	1	80	0.0125000
NODE_789_length_2708_cov_14.569950	18	98	274	6	80	0.0750000
NODE_789_length_2708_cov_14.569950	18	98	276	53	80	0.6625000
NODE_789_length_2708_cov_14.569950	71	134	30	1	63	0.0158730
NODE_789_length_2708_cov_14.569950	71	134	78	1	63	0.0158730
NODE_789_length_2708_cov_14.569950	71	134	106	1	63	0.0158730
NODE_789_length_2708_cov_14.569950	71	134	133	1	63	0.0158730
NODE_789_length_2708_cov_14.569950	71	134	150	1	63	0.0158730
NODE_789_length_2708_cov_14.569950	71	134	162	1	63	0.0158730
NODE_789_length_2708_cov_14.569950	71	134	170	1	63	0.0158730
NODE_789_length_2708_cov_14.569950	71	134	186	1	63	0.0158730
NODE_789_length_2708_cov_14.569950	71	134	193	1	63	0.0158730
NODE_789_length_2708_cov_14.569950	71	134	195	1	63	0.0158730
NODE_789_length_2708_cov_14.569950	71	134	201	1	63	0.0158730
NODE_789_length_2708_cov_14.569950	71	134	208	3	63	0.0476190
NODE_789_length_2708_cov_14.569950	71	134	212	1	63	0.0158730
NODE_789_length_2708_cov_14.569950	71	134	214	3	63	0.0476190
NODE_789_length_2708_cov_14.569950	71	134	216	1	63	0.0158730
NODE_789_length_2708_cov_14.569950	71	134	224	1	63	0.0158730
NODE_789_length_2708_cov_14.569950	71	134	226	4	63	0.0634921
NODE_789_length_2708_cov_14.569950	71	134	240	1	63	0.0158730
NODE_789_length_2708_cov_14.569950	71	134	250	1	63	0.0158730
NODE_789_length_2708_cov_14.569950	71	134	260	1	63	0.0158730
NODE_789_length_2708_cov_14.569950	71	134	264	2	63	0.0317460
NODE_789_length_2708_cov_14.569950	71	134	266	1	63	0.0158730
NODE_789_length_2708_cov_14.569950	71	134	268	1	63	0.0158730
NODE_789_length_2708_cov_14.569950	71	134	276	32	63	0.5079365
NODE_797_length_2691_cov_35.457948	401	481	0	42	80	0.5250000
NODE_797_length_2691_cov_35.457948	401	481	2	38	80	0.4750000
NODE_797_length_2691_cov_35.457948	454	534	2	80	80	1.0000000
NODE_803_length_2684_cov_17.345068	146	194	0	23	48	0.4791667
NODE_803_length_2684_cov_17.345068	146	194	2	25	48	0.5208333
NODE_803_length_2684_cov_17.345068	146	194	0	23	48	0.4791667
NODE_803_length_2684_cov_17.345068	146	194	2	25	48	0.5208333
NODE_803_length_2684_cov_17.345068	146	194	0	23	48	0.4791667
NODE_803_length_2684_cov_17.345068	146	194	2	25	48	0.5208333
NODE_803_length_2684_cov_17.345068	146	194	0	23	48	0.4791667
NODE_803_length_2684_cov_17.345068	146	194	2	25	48	0.5208333
NODE_803_length_2684_cov_17.345068	146	194	0	23	48	0.4791667
NODE_803_length_2684_cov_17.345068	146	194	2	25	48	0.5208333
NODE_805_length_2682_cov_43.500581	913	992	495	2	79	0.0253165
NODE_805_length_2682_cov_43.500581	913	992	497	1	79	0.0126582
NODE_805_length_2682_cov_43.500581	913	992	498	1	79	0.0126582
NODE_805_length_2682_cov_43.500581	913	992	499	1	79	0.0126582
NODE_805_length_2682_cov_43.500581	913	992	504	1	79	0.0126582
NODE_805_length_2682_cov_43.500581	913	992	505	2	79	0.0253165
NODE_805_length_2682_cov_43.500581	913	992	506	3	79	0.0379747
NODE_805_length_2682_cov_43.500581	913	992	508	1	79	0.0126582
NODE_805_length_2682_cov_43.500581	913	992	509	1	79	0.0126582
NODE_805_length_2682_cov_43.500581	913	992	535	1	79	0.0126582
NODE_805_length_2682_cov_43.500581	913	992	537	1	79	0.0126582
NODE_805_length_2682_cov_43.500581	913	992	538	1	79	0.0126582
NODE_805_length_2682_cov_43.500581	913	992	541	2	79	0.0253165
NODE_805_length_2682_cov_43.500581	913	992	542	3	79	0.0379747
NODE_805_length_2682_cov_43.500581	913	992	544	2	79	0.0253165
NODE_805_length_2682_cov_43.500581	913	992	546	1	79	0.0126582
NODE_805_length_2682_cov_43.500581	913	992	548	1	79	0.0126582
NODE_805_length_2682_cov_43.500581	913	992	551	1	79	0.0126582
NODE_805_length_2682_cov_43.500581	913	992	554	3	79	0.0379747
NODE_805_length_2682_cov_43.500581	913	992	557	1	79	0.0126582
NODE_805_length_2682_cov_43.500581	913	992	559	1	79	0.0126582
NODE_805_length_2682_cov_43.500581	913	992	572	1	79	0.0126582
NODE_805_length_2682_cov_43.500581	913	992	577	1	79	0.0126582
NODE_805_length_2682_cov_43.500581	913	992	584	1	79	0.0126582
NODE_805_length_2682_cov_43.500581	913	992	585	1	79	0.0126582
NODE_805_length_2682_cov_43.500581	913	992	586	2	79	0.0253165
NODE_805_length_2682_cov_43.500581	913	992	589	2	79	0.0253165
NODE_805_length_2682_cov_43.500581	913	992	590	1	79	0.0126582
NODE_805_length_2682_cov_43.500581	913	992	591	2	79	0.0253165
NODE_805_length_2682_cov_43.500581	913	992	594	1	79	0.0126582
NODE_805_length_2682_cov_43.500581	913	992	596	1	79	0.0126582
NODE_805_length_2682_cov_43.500581	913	992	598	1	79	0.0126582
NODE_805_length_2682_cov_43.500581	913	992	599	1	79	0.0126582
NODE_805_length_2682_cov_43.500581	913	992	604	1	79	0.0126582
NODE_805_length_2682_cov_43.500581	913	992	606	1	79	0.0126582
NODE_805_length_2682_cov_43.500581	913	992	608	2	79	0.0253165
NODE_805_length_2682_cov_43.500581	913	992	609	1	79	0.0126582
NODE_805_length_2682_cov_43.500581	913	992	613	1	79	0.0126582
NODE_805_length_2682_cov_43.500581	913	992	616	1	79	0.0126582
NODE_805_length_2682_cov_43.500581	913	992	620	1	79	0.0126582
NODE_805_length_2682_cov_43.500581	913	992	632	1	79	0.0126582
NODE_805_length_2682_cov_43.500581	913	992	633	2	79	0.0253165
NODE_805_length_2682_cov_43.500581	913	992	636	1	79	0.0126582
NODE_805_length_2682_cov_43.500581	913	992	637	1	79	0.0126582
NODE_805_length_2682_cov_43.500581	913	992	639	1	79	0.0126582
NODE_805_length_2682_cov_43.500581	913	992	641	2	79	0.0253165
NODE_805_length_2682_cov_43.500581	913	992	647	1	79	0.0126582
NODE_805_length_2682_cov_43.500581	913	992	648	2	79	0.0253165
NODE_805_length_2682_cov_43.500581	913	992	649	1	79	0.0126582
NODE_805_length_2682_cov_43.500581	913	992	681	1	79	0.0126582
NODE_805_length_2682_cov_43.500581	913	992	683	1	79	0.0126582
NODE_805_length_2682_cov_43.500581	913	992	688	1	79	0.0126582
NODE_805_length_2682_cov_43.500581	913	992	691	1	79	0.0126582
NODE_805_length_2682_cov_43.500581	913	992	706	1	79	0.0126582
NODE_805_length_2682_cov_43.500581	913	992	720	1	79	0.0126582
NODE_805_length_2682_cov_43.500581	913	992	724	1	79	0.0126582
NODE_805_length_2682_cov_43.500581	913	992	728	1	79	0.0126582
NODE_805_length_2682_cov_43.500581	913	992	734	1	79	0.0126582
NODE_805_length_2682_cov_43.500581	913	992	736	1	79	0.0126582
NODE_805_length_2682_cov_43.500581	913	992	739	1	79	0.0126582
NODE_805_length_2682_cov_43.500581	913	992	742	1	79	0.0126582
NODE_805_length_2682_cov_43.500581	913	992	744	1	79	0.0126582
NODE_805_length_2682_cov_43.500581	965	1002	463	2	37	0.0540541
NODE_805_length_2682_cov_43.500581	965	1002	468	1	37	0.0270270
NODE_805_length_2682_cov_43.500581	965	1002	474	1	37	0.0270270
NODE_805_length_2682_cov_43.500581	965	1002	484	1	37	0.0270270
NODE_805_length_2682_cov_43.500581	965	1002	487	2	37	0.0540541
NODE_805_length_2682_cov_43.500581	965	1002	491	1	37	0.0270270
NODE_805_length_2682_cov_43.500581	965	1002	493	2	37	0.0540541
NODE_805_length_2682_cov_43.500581	965	1002	495	2	37	0.0540541
NODE_805_length_2682_cov_43.500581	965	1002	497	1	37	0.0270270
NODE_805_length_2682_cov_43.500581	965	1002	498	1	37	0.0270270
NODE_805_length_2682_cov_43.500581	965	1002	499	1	37	0.0270270
NODE_805_length_2682_cov_43.500581	965	1002	504	1	37	0.0270270
NODE_805_length_2682_cov_43.500581	965	1002	505	2	37	0.0540541
NODE_805_length_2682_cov_43.500581	965	1002	506	3	37	0.0810811
NODE_805_length_2682_cov_43.500581	965	1002	508	1	37	0.0270270
NODE_805_length_2682_cov_43.500581	965	1002	509	1	37	0.0270270
NODE_805_length_2682_cov_43.500581	965	1002	535	1	37	0.0270270
NODE_805_length_2682_cov_43.500581	965	1002	537	1	37	0.0270270
NODE_805_length_2682_cov_43.500581	965	1002	538	1	37	0.0270270
NODE_805_length_2682_cov_43.500581	965	1002	541	2	37	0.0540541
NODE_805_length_2682_cov_43.500581	965	1002	542	3	37	0.0810811
NODE_805_length_2682_cov_43.500581	965	1002	544	2	37	0.0540541
NODE_805_length_2682_cov_43.500581	965	1002	546	1	37	0.0270270
NODE_805_length_2682_cov_43.500581	965	1002	548	1	37	0.0270270
NODE_805_length_2682_cov_43.500581	965	1002	554	2	37	0.0540541
NODE_808_length_2675_cov_10.369565	209	289	28	9	80	0.1125000
NODE_808_length_2675_cov_10.369565	209	289	29	5	80	0.0625000
NODE_808_length_2675_cov_10.369565	209	289	30	8	80	0.1000000
NODE_808_length_2675_cov_10.369565	209	289	34	13	80	0.1625000
NODE_808_length_2675_cov_10.369565	209	289	36	30	80	0.3750000
NODE_808_length_2675_cov_10.369565	209	289	38	15	80	0.1875000
NODE_813_length_2670_cov_17.489304	1995	2075	0	52	80	0.6500000
NODE_813_length_2670_cov_17.489304	1995	2075	2	28	80	0.3500000
NODE_813_length_2670_cov_17.489304	2048	2128	0	80	80	1.0000000
NODE_813_length_2670_cov_17.489304	2124	2204	0	80	80	1.0000000
NODE_813_length_2670_cov_17.489304	2177	2257	0	80	80	1.0000000
NODE_815_length_2665_cov_19.145752	548	628	0	80	80	1.0000000
NODE_815_length_2665_cov_19.145752	601	681	0	80	80	1.0000000
NODE_815_length_2665_cov_19.145752	2099	2176	0	66	77	0.8571429
NODE_815_length_2665_cov_19.145752	2099	2176	4	11	77	0.1428571
NODE_815_length_2665_cov_19.145752	2172	2252	4	80	80	1.0000000
NODE_815_length_2665_cov_19.145752	2172	2252	4	80	80	1.0000000
NODE_815_length_2665_cov_19.145752	2225	2267	0	11	42	0.2619048
NODE_815_length_2665_cov_19.145752	2225	2267	4	31	42	0.7380952
NODE_816_length_2664_cov_4.175049	2005	2085	4	11	80	0.1375000
NODE_816_length_2664_cov_4.175049	2005	2085	8	69	80	0.8625000
NODE_816_length_2664_cov_4.175049	2058	2138	0	2	80	0.0250000
NODE_816_length_2664_cov_4.175049	2058	2138	4	51	80	0.6375000
NODE_816_length_2664_cov_4.175049	2058	2138	8	27	80	0.3375000
NODE_822_length_2650_cov_19.800862	800	880	20	1	80	0.0125000
NODE_822_length_2650_cov_19.800862	800	880	22	6	80	0.0750000
NODE_822_length_2650_cov_19.800862	800	880	24	3	80	0.0375000
NODE_822_length_2650_cov_19.800862	800	880	26	3	80	0.0375000
NODE_822_length_2650_cov_19.800862	800	880	28	14	80	0.1750000
NODE_822_length_2650_cov_19.800862	800	880	30	3	80	0.0375000
NODE_822_length_2650_cov_19.800862	800	880	32	3	80	0.0375000
NODE_822_length_2650_cov_19.800862	800	880	36	17	80	0.2125000
NODE_822_length_2650_cov_19.800862	800	880	38	18	80	0.2250000
NODE_822_length_2650_cov_19.800862	800	880	40	12	80	0.1500000
NODE_824_length_2645_cov_8.618225	931	1011	0	80	80	1.0000000
NODE_824_length_2645_cov_8.618225	984	1064	0	80	80	1.0000000
NODE_827_length_2640_cov_16.462810	94	164	294	1	70	0.0142857
NODE_827_length_2640_cov_16.462810	94	164	298	2	70	0.0285714
NODE_827_length_2640_cov_16.462810	94	164	301	1	70	0.0142857
NODE_827_length_2640_cov_16.462810	94	164	307	1	70	0.0142857
NODE_827_length_2640_cov_16.462810	94	164	311	1	70	0.0142857
NODE_827_length_2640_cov_16.462810	94	164	312	1	70	0.0142857
NODE_827_length_2640_cov_16.462810	94	164	314	1	70	0.0142857
NODE_827_length_2640_cov_16.462810	94	164	316	1	70	0.0142857
NODE_827_length_2640_cov_16.462810	94	164	325	1	70	0.0142857
NODE_827_length_2640_cov_16.462810	94	164	328	1	70	0.0142857
NODE_827_length_2640_cov_16.462810	94	164	337	1	70	0.0142857
NODE_827_length_2640_cov_16.462810	94	164	342	1	70	0.0142857
NODE_827_length_2640_cov_16.462810	94	164	344	1	70	0.0142857
NODE_827_length_2640_cov_16.462810	94	164	357	1	70	0.0142857
NODE_827_length_2640_cov_16.462810	94	164	369	2	70	0.0285714
NODE_827_length_2640_cov_16.462810	94	164	382	1	70	0.0142857
NODE_827_length_2640_cov_16.462810	94	164	384	1	70	0.0142857
NODE_827_length_2640_cov_16.462810	94	164	385	1	70	0.0142857
NODE_827_length_2640_cov_16.462810	94	164	397	1	70	0.0142857
NODE_827_length_2640_cov_16.462810	94	164	401	1	70	0.0142857
NODE_827_length_2640_cov_16.462810	94	164	407	1	70	0.0142857
NODE_827_length_2640_cov_16.462810	94	164	424	1	70	0.0142857
NODE_827_length_2640_cov_16.462810	94	164	426	1	70	0.0142857
NODE_827_length_2640_cov_16.462810	94	164	436	1	70	0.0142857
NODE_827_length_2640_cov_16.462810	94	164	439	1	70	0.0142857
NODE_827_length_2640_cov_16.462810	94	164	444	1	70	0.0142857
NODE_827_length_2640_cov_16.462810	94	164	453	1	70	0.0142857
NODE_827_length_2640_cov_16.462810	94	164	462	1	70	0.0142857
NODE_827_length_2640_cov_16.462810	94	164	464	1	70	0.0142857
NODE_827_length_2640_cov_16.462810	94	164	466	1	70	0.0142857
NODE_827_length_2640_cov_16.462810	94	164	470	1	70	0.0142857
NODE_827_length_2640_cov_16.462810	94	164	473	1	70	0.0142857
NODE_827_length_2640_cov_16.462810	94	164	479	2	70	0.0285714
NODE_827_length_2640_cov_16.462810	94	164	482	2	70	0.0285714
NODE_827_length_2640_cov_16.462810	94	164	483	1	70	0.0142857
NODE_827_length_2640_cov_16.462810	94	164	490	1	70	0.0142857
NODE_827_length_2640_cov_16.462810	94	164	497	1	70	0.0142857
NODE_827_length_2640_cov_16.462810	94	164	498	1	70	0.0142857
NODE_827_length_2640_cov_16.462810	94	164	501	1	70	0.0142857
NODE_827_length_2640_cov_16.462810	94	164	503	1	70	0.0142857
NODE_827_length_2640_cov_16.462810	94	164	519	1	70	0.0142857
NODE_827_length_2640_cov_16.462810	94	164	521	1	70	0.0142857
NODE_827_length_2640_cov_16.462810	94	164	533	1	70	0.0142857
NODE_827_length_2640_cov_16.462810	94	164	536	1	70	0.0142857
NODE_827_length_2640_cov_16.462810	94	164	537	1	70	0.0142857
NODE_827_length_2640_cov_16.462810	94	164	543	1	70	0.0142857
NODE_827_length_2640_cov_16.462810	94	164	547	1	70	0.0142857
NODE_827_length_2640_cov_16.462810	94	164	548	1	70	0.0142857
NODE_827_length_2640_cov_16.462810	94	164	549	2	70	0.0285714
NODE_827_length_2640_cov_16.462810	94	164	551	2	70	0.0285714
NODE_827_length_2640_cov_16.462810	94	164	554	5	70	0.0714286
NODE_827_length_2640_cov_16.462810	94	164	556	1	70	0.0142857
NODE_827_length_2640_cov_16.462810	94	164	558	2	70	0.0285714
NODE_827_length_2640_cov_16.462810	94	164	560	1	70	0.0142857
NODE_827_length_2640_cov_16.462810	94	164	562	1	70	0.0142857
NODE_827_length_2640_cov_16.462810	94	164	564	3	70	0.0428571
NODE_827_length_2640_cov_16.462810	94	164	566	1	70	0.0142857
NODE_827_length_2640_cov_16.462810	147	209	188	1	62	0.0161290
NODE_827_length_2640_cov_16.462810	147	209	190	1	62	0.0161290
NODE_827_length_2640_cov_16.462810	147	209	194	1	62	0.0161290
NODE_827_length_2640_cov_16.462810	147	209	202	1	62	0.0161290
NODE_827_length_2640_cov_16.462810	147	209	204	1	62	0.0161290
NODE_827_length_2640_cov_16.462810	147	209	205	2	62	0.0322581
NODE_827_length_2640_cov_16.462810	147	209	206	1	62	0.0161290
NODE_827_length_2640_cov_16.462810	147	209	207	1	62	0.0161290
NODE_827_length_2640_cov_16.462810	147	209	209	1	62	0.0161290
NODE_827_length_2640_cov_16.462810	147	209	211	2	62	0.0322581
NODE_827_length_2640_cov_16.462810	147	209	214	2	62	0.0322581
NODE_827_length_2640_cov_16.462810	147	209	215	1	62	0.0161290
NODE_827_length_2640_cov_16.462810	147	209	219	2	62	0.0322581
NODE_827_length_2640_cov_16.462810	147	209	220	2	62	0.0322581
NODE_827_length_2640_cov_16.462810	147	209	221	1	62	0.0161290
NODE_827_length_2640_cov_16.462810	147	209	222	1	62	0.0161290
NODE_827_length_2640_cov_16.462810	147	209	224	1	62	0.0161290
NODE_827_length_2640_cov_16.462810	147	209	225	1	62	0.0161290
NODE_827_length_2640_cov_16.462810	147	209	227	1	62	0.0161290
NODE_827_length_2640_cov_16.462810	147	209	229	1	62	0.0161290
NODE_827_length_2640_cov_16.462810	147	209	237	1	62	0.0161290
NODE_827_length_2640_cov_16.462810	147	209	243	1	62	0.0161290
NODE_827_length_2640_cov_16.462810	147	209	253	1	62	0.0161290
NODE_827_length_2640_cov_16.462810	147	209	257	1	62	0.0161290
NODE_827_length_2640_cov_16.462810	147	209	266	2	62	0.0322581
NODE_827_length_2640_cov_16.462810	147	209	272	1	62	0.0161290
NODE_827_length_2640_cov_16.462810	147	209	275	1	62	0.0161290
NODE_827_length_2640_cov_16.462810	147	209	276	1	62	0.0161290
NODE_827_length_2640_cov_16.462810	147	209	283	2	62	0.0322581
NODE_827_length_2640_cov_16.462810	147	209	284	2	62	0.0322581
NODE_827_length_2640_cov_16.462810	147	209	285	1	62	0.0161290
NODE_827_length_2640_cov_16.462810	147	209	286	1	62	0.0161290
NODE_827_length_2640_cov_16.462810	147	209	287	1	62	0.0161290
NODE_827_length_2640_cov_16.462810	147	209	288	2	62	0.0322581
NODE_827_length_2640_cov_16.462810	147	209	289	1	62	0.0161290
NODE_827_length_2640_cov_16.462810	147	209	292	1	62	0.0161290
NODE_827_length_2640_cov_16.462810	147	209	294	1	62	0.0161290
NODE_827_length_2640_cov_16.462810	147	209	298	2	62	0.0322581
NODE_827_length_2640_cov_16.462810	147	209	301	1	62	0.0161290
NODE_827_length_2640_cov_16.462810	147	209	307	1	62	0.0161290
NODE_827_length_2640_cov_16.462810	147	209	311	1	62	0.0161290
NODE_827_length_2640_cov_16.462810	147	209	312	1	62	0.0161290
NODE_827_length_2640_cov_16.462810	147	209	314	1	62	0.0161290
NODE_827_length_2640_cov_16.462810	147	209	316	1	62	0.0161290
NODE_827_length_2640_cov_16.462810	147	209	325	1	62	0.0161290
NODE_827_length_2640_cov_16.462810	147	209	328	1	62	0.0161290
NODE_827_length_2640_cov_16.462810	147	209	337	1	62	0.0161290
NODE_827_length_2640_cov_16.462810	147	209	342	1	62	0.0161290
NODE_827_length_2640_cov_16.462810	147	209	344	1	62	0.0161290
NODE_827_length_2640_cov_16.462810	147	209	357	1	62	0.0161290
NODE_827_length_2640_cov_16.462810	147	209	369	2	62	0.0322581
NODE_828_length_2636_cov_200.191171	561	641	269	1	80	0.0125000
NODE_828_length_2636_cov_200.191171	561	641	270	1	80	0.0125000
NODE_828_length_2636_cov_200.191171	561	641	272	1	80	0.0125000
NODE_828_length_2636_cov_200.191171	561	641	273	1	80	0.0125000
NODE_828_length_2636_cov_200.191171	561	641	274	3	80	0.0375000
NODE_828_length_2636_cov_200.191171	561	641	276	1	80	0.0125000
NODE_828_length_2636_cov_200.191171	561	641	277	1	80	0.0125000
NODE_828_length_2636_cov_200.191171	561	641	278	3	80	0.0375000
NODE_828_length_2636_cov_200.191171	561	641	280	1	80	0.0125000
NODE_828_length_2636_cov_200.191171	561	641	282	1	80	0.0125000
NODE_828_length_2636_cov_200.191171	561	641	283	1	80	0.0125000
NODE_828_length_2636_cov_200.191171	561	641	284	1	80	0.0125000
NODE_828_length_2636_cov_200.191171	561	641	288	1	80	0.0125000
NODE_828_length_2636_cov_200.191171	561	641	289	2	80	0.0250000
NODE_828_length_2636_cov_200.191171	561	641	291	2	80	0.0250000
NODE_828_length_2636_cov_200.191171	561	641	292	1	80	0.0125000
NODE_828_length_2636_cov_200.191171	561	641	293	1	80	0.0125000
NODE_828_length_2636_cov_200.191171	561	641	295	1	80	0.0125000
NODE_828_length_2636_cov_200.191171	561	641	297	1	80	0.0125000
NODE_828_length_2636_cov_200.191171	561	641	298	1	80	0.0125000
NODE_828_length_2636_cov_200.191171	561	641	299	3	80	0.0375000
NODE_828_length_2636_cov_200.191171	561	641	301	2	80	0.0250000
NODE_828_length_2636_cov_200.191171	561	641	302	3	80	0.0375000
NODE_828_length_2636_cov_200.191171	561	641	304	1	80	0.0125000
NODE_828_length_2636_cov_200.191171	561	641	311	2	80	0.0250000
NODE_828_length_2636_cov_200.191171	561	641	313	2	80	0.0250000
NODE_828_length_2636_cov_200.191171	561	641	314	2	80	0.0250000
NODE_828_length_2636_cov_200.191171	561	641	317	3	80	0.0375000
NODE_828_length_2636_cov_200.191171	561	641	319	2	80	0.0250000
NODE_828_length_2636_cov_200.191171	561	641	322	2	80	0.0250000
NODE_828_length_2636_cov_200.191171	561	641	327	2	80	0.0250000
NODE_828_length_2636_cov_200.191171	561	641	333	1	80	0.0125000
NODE_828_length_2636_cov_200.191171	561	641	335	8	80	0.1000000
NODE_828_length_2636_cov_200.191171	561	641	336	6	80	0.0750000
NODE_828_length_2636_cov_200.191171	561	641	337	6	80	0.0750000
NODE_828_length_2636_cov_200.191171	561	641	338	3	80	0.0375000
NODE_828_length_2636_cov_200.191171	561	641	339	1	80	0.0125000
NODE_828_length_2636_cov_200.191171	561	641	340	1	80	0.0125000
NODE_828_length_2636_cov_200.191171	561	641	341	1	80	0.0125000
NODE_828_length_2636_cov_200.191171	561	641	343	3	80	0.0375000
NODE_828_length_2636_cov_200.191171	614	695	120	1	81	0.0123457
NODE_828_length_2636_cov_200.191171	614	695	122	2	81	0.0246914
NODE_828_length_2636_cov_200.191171	614	695	124	1	81	0.0123457
NODE_828_length_2636_cov_200.191171	614	695	126	1	81	0.0123457
NODE_828_length_2636_cov_200.191171	614	695	127	1	81	0.0123457
NODE_828_length_2636_cov_200.191171	614	695	133	1	81	0.0123457
NODE_828_length_2636_cov_200.191171	614	695	135	2	81	0.0246914
NODE_828_length_2636_cov_200.191171	614	695	137	1	81	0.0123457
NODE_828_length_2636_cov_200.191171	614	695	138	4	81	0.0493827
NODE_828_length_2636_cov_200.191171	614	695	155	1	81	0.0123457
NODE_828_length_2636_cov_200.191171	614	695	160	1	81	0.0123457
NODE_828_length_2636_cov_200.191171	614	695	164	3	81	0.0370370
NODE_828_length_2636_cov_200.191171	614	695	165	1	81	0.0123457
NODE_828_length_2636_cov_200.191171	614	695	167	1	81	0.0123457
NODE_828_length_2636_cov_200.191171	614	695	169	1	81	0.0123457
NODE_828_length_2636_cov_200.191171	614	695	172	1	81	0.0123457
NODE_828_length_2636_cov_200.191171	614	695	173	2	81	0.0246914
NODE_828_length_2636_cov_200.191171	614	695	174	1	81	0.0123457
NODE_828_length_2636_cov_200.191171	614	695	178	1	81	0.0123457
NODE_828_length_2636_cov_200.191171	614	695	190	1	81	0.0123457
NODE_828_length_2636_cov_200.191171	614	695	194	1	81	0.0123457
NODE_828_length_2636_cov_200.191171	614	695	195	1	81	0.0123457
NODE_828_length_2636_cov_200.191171	614	695	210	1	81	0.0123457
NODE_828_length_2636_cov_200.191171	614	695	220	1	81	0.0123457
NODE_828_length_2636_cov_200.191171	614	695	224	1	81	0.0123457
NODE_828_length_2636_cov_200.191171	614	695	229	1	81	0.0123457
NODE_828_length_2636_cov_200.191171	614	695	230	1	81	0.0123457
NODE_828_length_2636_cov_200.191171	614	695	233	4	81	0.0493827
NODE_828_length_2636_cov_200.191171	614	695	234	1	81	0.0123457
NODE_828_length_2636_cov_200.191171	614	695	240	1	81	0.0123457
NODE_828_length_2636_cov_200.191171	614	695	249	1	81	0.0123457
NODE_828_length_2636_cov_200.191171	614	695	251	1	81	0.0123457
NODE_828_length_2636_cov_200.191171	614	695	253	1	81	0.0123457
NODE_828_length_2636_cov_200.191171	614	695	255	1	81	0.0123457
NODE_828_length_2636_cov_200.191171	614	695	257	1	81	0.0123457
NODE_828_length_2636_cov_200.191171	614	695	259	1	81	0.0123457
NODE_828_length_2636_cov_200.191171	614	695	262	4	81	0.0493827
NODE_828_length_2636_cov_200.191171	614	695	263	1	81	0.0123457
NODE_828_length_2636_cov_200.191171	614	695	265	1	81	0.0123457
NODE_828_length_2636_cov_200.191171	614	695	278	3	81	0.0370370
NODE_828_length_2636_cov_200.191171	614	695	283	1	81	0.0123457
NODE_828_length_2636_cov_200.191171	614	695	284	1	81	0.0123457
NODE_828_length_2636_cov_200.191171	614	695	288	1	81	0.0123457
NODE_828_length_2636_cov_200.191171	614	695	289	2	81	0.0246914
NODE_828_length_2636_cov_200.191171	614	695	291	2	81	0.0246914
NODE_828_length_2636_cov_200.191171	614	695	293	1	81	0.0123457
NODE_828_length_2636_cov_200.191171	614	695	299	3	81	0.0370370
NODE_828_length_2636_cov_200.191171	614	695	304	1	81	0.0123457
NODE_828_length_2636_cov_200.191171	614	695	311	2	81	0.0246914
NODE_828_length_2636_cov_200.191171	614	695	313	1	81	0.0123457
NODE_828_length_2636_cov_200.191171	614	695	314	2	81	0.0246914
NODE_828_length_2636_cov_200.191171	614	695	317	3	81	0.0370370
NODE_828_length_2636_cov_200.191171	614	695	319	2	81	0.0246914
NODE_828_length_2636_cov_200.191171	614	695	322	2	81	0.0246914
NODE_828_length_2636_cov_200.191171	614	695	333	1	81	0.0123457
NODE_830_length_2631_cov_10.831754	446	526	2	5	80	0.0625000
NODE_830_length_2631_cov_10.831754	446	526	4	15	80	0.1875000
NODE_830_length_2631_cov_10.831754	446	526	5	19	80	0.2375000
NODE_830_length_2631_cov_10.831754	446	526	7	13	80	0.1625000
NODE_830_length_2631_cov_10.831754	446	526	9	7	80	0.0875000
NODE_830_length_2631_cov_10.831754	446	526	10	21	80	0.2625000
NODE_830_length_2631_cov_10.831754	499	572	0	20	73	0.2739726
NODE_830_length_2631_cov_10.831754	499	572	2	31	73	0.4246575
NODE_830_length_2631_cov_10.831754	499	572	4	15	73	0.2054795
NODE_830_length_2631_cov_10.831754	499	572	5	7	73	0.0958904
NODE_833_length_2622_cov_63.057471	1877	1953	240	1	76	0.0131579
NODE_833_length_2622_cov_63.057471	1877	1953	252	1	76	0.0131579
NODE_833_length_2622_cov_63.057471	1877	1953	254	1	76	0.0131579
NODE_833_length_2622_cov_63.057471	1877	1953	258	1	76	0.0131579
NODE_833_length_2622_cov_63.057471	1877	1953	259	2	76	0.0263158
NODE_833_length_2622_cov_63.057471	1877	1953	263	1	76	0.0131579
NODE_833_length_2622_cov_63.057471	1877	1953	269	1	76	0.0131579
NODE_833_length_2622_cov_63.057471	1877	1953	271	1	76	0.0131579
NODE_833_length_2622_cov_63.057471	1877	1953	273	2	76	0.0263158
NODE_833_length_2622_cov_63.057471	1877	1953	277	1	76	0.0131579
NODE_833_length_2622_cov_63.057471	1877	1953	278	1	76	0.0131579
NODE_833_length_2622_cov_63.057471	1877	1953	288	1	76	0.0131579
NODE_833_length_2622_cov_63.057471	1877	1953	291	1	76	0.0131579
NODE_833_length_2622_cov_63.057471	1877	1953	292	2	76	0.0263158
NODE_833_length_2622_cov_63.057471	1877	1953	296	1	76	0.0131579
NODE_833_length_2622_cov_63.057471	1877	1953	298	1	76	0.0131579
NODE_833_length_2622_cov_63.057471	1877	1953	299	2	76	0.0263158
NODE_833_length_2622_cov_63.057471	1877	1953	300	2	76	0.0263158
NODE_833_length_2622_cov_63.057471	1877	1953	301	1	76	0.0131579
NODE_833_length_2622_cov_63.057471	1877	1953	302	1	76	0.0131579
NODE_833_length_2622_cov_63.057471	1877	1953	303	3	76	0.0394737
NODE_833_length_2622_cov_63.057471	1877	1953	304	1	76	0.0131579
NODE_833_length_2622_cov_63.057471	1877	1953	305	2	76	0.0263158
NODE_833_length_2622_cov_63.057471	1877	1953	307	2	76	0.0263158
NODE_833_length_2622_cov_63.057471	1877	1953	308	1	76	0.0131579
NODE_833_length_2622_cov_63.057471	1877	1953	309	4	76	0.0526316
NODE_833_length_2622_cov_63.057471	1877	1953	310	1	76	0.0131579
NODE_833_length_2622_cov_63.057471	1877	1953	312	7	76	0.0921053
NODE_833_length_2622_cov_63.057471	1877	1953	313	1	76	0.0131579
NODE_833_length_2622_cov_63.057471	1877	1953	314	3	76	0.0394737
NODE_833_length_2622_cov_63.057471	1877	1953	315	2	76	0.0263158
NODE_833_length_2622_cov_63.057471	1877	1953	316	4	76	0.0526316
NODE_833_length_2622_cov_63.057471	1877	1953	318	4	76	0.0526316
NODE_833_length_2622_cov_63.057471	1877	1953	319	5	76	0.0657895
NODE_833_length_2622_cov_63.057471	1877	1953	320	6	76	0.0789474
NODE_833_length_2622_cov_63.057471	1877	1953	321	1	76	0.0131579
NODE_833_length_2622_cov_63.057471	1877	1953	322	2	76	0.0263158
NODE_833_length_2622_cov_63.057471	1877	1953	323	2	76	0.0263158
NODE_833_length_2622_cov_63.057471	2426	2506	79	1	80	0.0125000
NODE_833_length_2622_cov_63.057471	2426	2506	81	2	80	0.0250000
NODE_833_length_2622_cov_63.057471	2426	2506	82	1	80	0.0125000
NODE_833_length_2622_cov_63.057471	2426	2506	87	2	80	0.0250000
NODE_833_length_2622_cov_63.057471	2426	2506	88	1	80	0.0125000
NODE_833_length_2622_cov_63.057471	2426	2506	89	2	80	0.0250000
NODE_833_length_2622_cov_63.057471	2426	2506	90	2	80	0.0250000
NODE_833_length_2622_cov_63.057471	2426	2506	93	1	80	0.0125000
NODE_833_length_2622_cov_63.057471	2426	2506	100	1	80	0.0125000
NODE_833_length_2622_cov_63.057471	2426	2506	101	1	80	0.0125000
NODE_833_length_2622_cov_63.057471	2426	2506	102	1	80	0.0125000
NODE_833_length_2622_cov_63.057471	2426	2506	104	1	80	0.0125000
NODE_833_length_2622_cov_63.057471	2426	2506	107	2	80	0.0250000
NODE_833_length_2622_cov_63.057471	2426	2506	109	4	80	0.0500000
NODE_833_length_2622_cov_63.057471	2426	2506	111	2	80	0.0250000
NODE_833_length_2622_cov_63.057471	2426	2506	113	1	80	0.0125000
NODE_833_length_2622_cov_63.057471	2426	2506	114	2	80	0.0250000
NODE_833_length_2622_cov_63.057471	2426	2506	116	5	80	0.0625000
NODE_833_length_2622_cov_63.057471	2426	2506	118	1	80	0.0125000
NODE_833_length_2622_cov_63.057471	2426	2506	119	2	80	0.0250000
NODE_833_length_2622_cov_63.057471	2426	2506	120	1	80	0.0125000
NODE_833_length_2622_cov_63.057471	2426	2506	122	1	80	0.0125000
NODE_833_length_2622_cov_63.057471	2426	2506	126	1	80	0.0125000
NODE_833_length_2622_cov_63.057471	2426	2506	128	1	80	0.0125000
NODE_833_length_2622_cov_63.057471	2426	2506	131	1	80	0.0125000
NODE_833_length_2622_cov_63.057471	2426	2506	132	1	80	0.0125000
NODE_833_length_2622_cov_63.057471	2426	2506	135	3	80	0.0375000
NODE_833_length_2622_cov_63.057471	2426	2506	136	1	80	0.0125000
NODE_833_length_2622_cov_63.057471	2426	2506	137	1	80	0.0125000
NODE_833_length_2622_cov_63.057471	2426	2506	144	1	80	0.0125000
NODE_833_length_2622_cov_63.057471	2426	2506	145	3	80	0.0375000
NODE_833_length_2622_cov_63.057471	2426	2506	146	2	80	0.0250000
NODE_833_length_2622_cov_63.057471	2426	2506	147	1	80	0.0125000
NODE_833_length_2622_cov_63.057471	2426	2506	149	1	80	0.0125000
NODE_833_length_2622_cov_63.057471	2426	2506	155	1	80	0.0125000
NODE_833_length_2622_cov_63.057471	2426	2506	157	1	80	0.0125000
NODE_833_length_2622_cov_63.057471	2426	2506	161	2	80	0.0250000
NODE_833_length_2622_cov_63.057471	2426	2506	163	3	80	0.0375000
NODE_833_length_2622_cov_63.057471	2426	2506	164	2	80	0.0250000
NODE_833_length_2622_cov_63.057471	2426	2506	165	3	80	0.0375000
NODE_833_length_2622_cov_63.057471	2426	2506	166	2	80	0.0250000
NODE_833_length_2622_cov_63.057471	2426	2506	167	2	80	0.0250000
NODE_833_length_2622_cov_63.057471	2426	2506	168	5	80	0.0625000
NODE_833_length_2622_cov_63.057471	2426	2506	171	3	80	0.0375000
NODE_833_length_2622_cov_63.057471	2426	2506	172	1	80	0.0125000
NODE_833_length_2622_cov_63.057471	2426	2506	174	1	80	0.0125000
NODE_833_length_2622_cov_63.057471	2479	2559	129	2	80	0.0250000
NODE_833_length_2622_cov_63.057471	2479	2559	131	1	80	0.0125000
NODE_833_length_2622_cov_63.057471	2479	2559	133	6	80	0.0750000
NODE_833_length_2622_cov_63.057471	2479	2559	135	4	80	0.0500000
NODE_833_length_2622_cov_63.057471	2479	2559	138	1	80	0.0125000
NODE_833_length_2622_cov_63.057471	2479	2559	141	2	80	0.0250000
NODE_833_length_2622_cov_63.057471	2479	2559	147	1	80	0.0125000
NODE_833_length_2622_cov_63.057471	2479	2559	149	2	80	0.0250000
NODE_833_length_2622_cov_63.057471	2479	2559	151	2	80	0.0250000
NODE_833_length_2622_cov_63.057471	2479	2559	153	2	80	0.0250000
NODE_833_length_2622_cov_63.057471	2479	2559	154	1	80	0.0125000
NODE_833_length_2622_cov_63.057471	2479	2559	155	1	80	0.0125000
NODE_833_length_2622_cov_63.057471	2479	2559	156	9	80	0.1125000
NODE_833_length_2622_cov_63.057471	2479	2559	157	1	80	0.0125000
NODE_833_length_2622_cov_63.057471	2479	2559	158	1	80	0.0125000
NODE_833_length_2622_cov_63.057471	2479	2559	161	2	80	0.0250000
NODE_833_length_2622_cov_63.057471	2479	2559	162	1	80	0.0125000
NODE_833_length_2622_cov_63.057471	2479	2559	163	3	80	0.0375000
NODE_833_length_2622_cov_63.057471	2479	2559	164	2	80	0.0250000
NODE_833_length_2622_cov_63.057471	2479	2559	165	3	80	0.0375000
NODE_833_length_2622_cov_63.057471	2479	2559	166	11	80	0.1375000
NODE_833_length_2622_cov_63.057471	2479	2559	167	2	80	0.0250000
NODE_833_length_2622_cov_63.057471	2479	2559	168	9	80	0.1125000
NODE_833_length_2622_cov_63.057471	2479	2559	169	1	80	0.0125000
NODE_833_length_2622_cov_63.057471	2479	2559	170	4	80	0.0500000
NODE_833_length_2622_cov_63.057471	2479	2559	171	3	80	0.0375000
NODE_833_length_2622_cov_63.057471	2479	2559	172	1	80	0.0125000
NODE_833_length_2622_cov_63.057471	2479	2559	174	2	80	0.0250000
NODE_836_length_2617_cov_16.817315	1404	1448	8	42	44	0.9545454
NODE_836_length_2617_cov_16.817315	1404	1448	10	2	44	0.0454545
NODE_836_length_2617_cov_16.817315	1467	1521	6	9	54	0.1666667
NODE_836_length_2617_cov_16.817315	1467	1521	8	8	54	0.1481481
NODE_836_length_2617_cov_16.817315	1467	1521	9	31	54	0.5740741
NODE_836_length_2617_cov_16.817315	1467	1521	10	6	54	0.1111111
NODE_839_length_2610_cov_2.232577	2127	2163	0	36	36	1.0000000
NODE_840_length_2609_cov_13.245418	2066	2146	0	33	80	0.4125000
NODE_840_length_2609_cov_13.245418	2066	2146	4	47	80	0.5875000
NODE_840_length_2609_cov_13.245418	2119	2199	0	5	80	0.0625000
NODE_840_length_2609_cov_13.245418	2119	2199	4	75	80	0.9375000
NODE_840_length_2609_cov_13.245418	2195	2275	0	80	80	1.0000000
NODE_840_length_2609_cov_13.245418	2248	2328	0	80	80	1.0000000
NODE_845_length_2595_cov_5.638622	2157	2237	0	80	80	1.0000000
NODE_847_length_2594_cov_109.880160	386	450	49	2	64	0.0312500
NODE_847_length_2594_cov_109.880160	386	450	53	1	64	0.0156250
NODE_847_length_2594_cov_109.880160	386	450	55	1	64	0.0156250
NODE_847_length_2594_cov_109.880160	386	450	56	5	64	0.0781250
NODE_847_length_2594_cov_109.880160	386	450	57	2	64	0.0312500
NODE_847_length_2594_cov_109.880160	386	450	64	1	64	0.0156250
NODE_847_length_2594_cov_109.880160	386	450	76	1	64	0.0156250
NODE_847_length_2594_cov_109.880160	386	450	78	1	64	0.0156250
NODE_847_length_2594_cov_109.880160	386	450	84	1	64	0.0156250
NODE_847_length_2594_cov_109.880160	386	450	92	1	64	0.0156250
NODE_847_length_2594_cov_109.880160	386	450	97	1	64	0.0156250
NODE_847_length_2594_cov_109.880160	386	450	117	1	64	0.0156250
NODE_847_length_2594_cov_109.880160	386	450	128	1	64	0.0156250
NODE_847_length_2594_cov_109.880160	386	450	140	1	64	0.0156250
NODE_847_length_2594_cov_109.880160	386	450	149	1	64	0.0156250
NODE_847_length_2594_cov_109.880160	386	450	152	1	64	0.0156250
NODE_847_length_2594_cov_109.880160	386	450	153	1	64	0.0156250
NODE_847_length_2594_cov_109.880160	386	450	159	1	64	0.0156250
NODE_847_length_2594_cov_109.880160	386	450	161	1	64	0.0156250
NODE_847_length_2594_cov_109.880160	386	450	173	1	64	0.0156250
NODE_847_length_2594_cov_109.880160	386	450	176	1	64	0.0156250
NODE_847_length_2594_cov_109.880160	386	450	180	2	64	0.0312500
NODE_847_length_2594_cov_109.880160	386	450	194	1	64	0.0156250
NODE_847_length_2594_cov_109.880160	386	450	196	1	64	0.0156250
NODE_847_length_2594_cov_109.880160	386	450	201	2	64	0.0312500
NODE_847_length_2594_cov_109.880160	386	450	202	1	64	0.0156250
NODE_847_length_2594_cov_109.880160	386	450	203	1	64	0.0156250
NODE_847_length_2594_cov_109.880160	386	450	206	1	64	0.0156250
NODE_847_length_2594_cov_109.880160	386	450	214	1	64	0.0156250
NODE_847_length_2594_cov_109.880160	386	450	222	1	64	0.0156250
NODE_847_length_2594_cov_109.880160	386	450	227	1	64	0.0156250
NODE_847_length_2594_cov_109.880160	386	450	231	1	64	0.0156250
NODE_847_length_2594_cov_109.880160	386	450	237	2	64	0.0312500
NODE_847_length_2594_cov_109.880160	386	450	241	2	64	0.0312500
NODE_847_length_2594_cov_109.880160	386	450	243	4	64	0.0625000
NODE_847_length_2594_cov_109.880160	386	450	247	4	64	0.0625000
NODE_847_length_2594_cov_109.880160	386	450	252	1	64	0.0156250
NODE_847_length_2594_cov_109.880160	386	450	253	1	64	0.0156250
NODE_847_length_2594_cov_109.880160	386	450	256	1	64	0.0156250
NODE_847_length_2594_cov_109.880160	386	450	260	1	64	0.0156250
NODE_847_length_2594_cov_109.880160	386	450	262	1	64	0.0156250
NODE_847_length_2594_cov_109.880160	386	450	264	1	64	0.0156250
NODE_847_length_2594_cov_109.880160	386	450	266	2	64	0.0312500
NODE_847_length_2594_cov_109.880160	386	450	270	4	64	0.0625000
NODE_856_length_2575_cov_4.890549	1860	1912	2	1	52	0.0192308
NODE_856_length_2575_cov_4.890549	1860	1912	4	51	52	0.9807692
NODE_857_length_2572_cov_46.828548	302	382	0	80	80	1.0000000
NODE_857_length_2572_cov_46.828548	355	435	0	80	80	1.0000000
NODE_868_length_2551_cov_40.721860	1104	1150	10	16	46	0.3478261
NODE_868_length_2551_cov_40.721860	1104	1150	12	30	46	0.6521739
NODE_868_length_2551_cov_40.721860	1199	1259	4	14	60	0.2333333
NODE_868_length_2551_cov_40.721860	1199	1259	6	40	60	0.6666667
NODE_868_length_2551_cov_40.721860	1199	1259	8	1	60	0.0166667
NODE_868_length_2551_cov_40.721860	1199	1259	9	1	60	0.0166667
NODE_868_length_2551_cov_40.721860	1199	1259	10	4	60	0.0666667
NODE_870_length_2547_cov_218.062908	436	486	1	2	50	0.0400000
NODE_870_length_2547_cov_218.062908	436	486	2	20	50	0.4000000
NODE_870_length_2547_cov_218.062908	436	486	3	1	50	0.0200000
NODE_870_length_2547_cov_218.062908	436	486	4	1	50	0.0200000
NODE_870_length_2547_cov_218.062908	436	486	6	3	50	0.0600000
NODE_870_length_2547_cov_218.062908	436	486	7	2	50	0.0400000
NODE_870_length_2547_cov_218.062908	436	486	9	1	50	0.0200000
NODE_870_length_2547_cov_218.062908	436	486	15	1	50	0.0200000
NODE_870_length_2547_cov_218.062908	436	486	21	1	50	0.0200000
NODE_870_length_2547_cov_218.062908	436	486	30	1	50	0.0200000
NODE_870_length_2547_cov_218.062908	436	486	33	2	50	0.0400000
NODE_870_length_2547_cov_218.062908	436	486	35	1	50	0.0200000
NODE_870_length_2547_cov_218.062908	436	486	39	1	50	0.0200000
NODE_870_length_2547_cov_218.062908	436	486	41	2	50	0.0400000
NODE_870_length_2547_cov_218.062908	436	486	45	3	50	0.0600000
NODE_870_length_2547_cov_218.062908	436	486	48	1	50	0.0200000
NODE_870_length_2547_cov_218.062908	436	486	53	1	50	0.0200000
NODE_870_length_2547_cov_218.062908	436	486	55	1	50	0.0200000
NODE_870_length_2547_cov_218.062908	436	486	59	1	50	0.0200000
NODE_870_length_2547_cov_218.062908	436	486	61	1	50	0.0200000
NODE_870_length_2547_cov_218.062908	436	486	63	3	50	0.0600000
NODE_879_length_2527_cov_27.275947	503	548	85	2	45	0.0444444
NODE_879_length_2527_cov_27.275947	503	548	89	3	45	0.0666667
NODE_879_length_2527_cov_27.275947	503	548	92	2	45	0.0444444
NODE_879_length_2527_cov_27.275947	503	548	94	3	45	0.0666667
NODE_879_length_2527_cov_27.275947	503	548	95	5	45	0.1111111
NODE_879_length_2527_cov_27.275947	503	548	96	5	45	0.1111111
NODE_879_length_2527_cov_27.275947	503	548	97	2	45	0.0444444
NODE_879_length_2527_cov_27.275947	503	548	98	2	45	0.0444444
NODE_879_length_2527_cov_27.275947	503	548	99	5	45	0.1111111
NODE_879_length_2527_cov_27.275947	503	548	100	1	45	0.0222222
NODE_879_length_2527_cov_27.275947	503	548	101	5	45	0.1111111
NODE_879_length_2527_cov_27.275947	503	548	103	7	45	0.1555556
NODE_879_length_2527_cov_27.275947	503	548	105	3	45	0.0666667
NODE_884_length_2519_cov_15.991322	2122	2202	8	80	80	1.0000000
NODE_884_length_2519_cov_15.991322	2175	2255	0	47	80	0.5875000
NODE_884_length_2519_cov_15.991322	2175	2255	8	33	80	0.4125000
NODE_885_length_2518_cov_7.035965	62	142	71	1	80	0.0125000
NODE_885_length_2518_cov_7.035965	62	142	73	1	80	0.0125000
NODE_885_length_2518_cov_7.035965	62	142	75	1	80	0.0125000
NODE_885_length_2518_cov_7.035965	62	142	77	1	80	0.0125000
NODE_885_length_2518_cov_7.035965	62	142	78	7	80	0.0875000
NODE_885_length_2518_cov_7.035965	62	142	80	1	80	0.0125000
NODE_885_length_2518_cov_7.035965	62	142	82	2	80	0.0250000
NODE_885_length_2518_cov_7.035965	62	142	84	11	80	0.1375000
NODE_885_length_2518_cov_7.035965	62	142	85	1	80	0.0125000
NODE_885_length_2518_cov_7.035965	62	142	86	9	80	0.1125000
NODE_885_length_2518_cov_7.035965	62	142	88	6	80	0.0750000
NODE_885_length_2518_cov_7.035965	62	142	89	2	80	0.0250000
NODE_885_length_2518_cov_7.035965	62	142	90	5	80	0.0625000
NODE_885_length_2518_cov_7.035965	62	142	91	21	80	0.2625000
NODE_885_length_2518_cov_7.035965	62	142	92	11	80	0.1375000
NODE_885_length_2518_cov_7.035965	2005	2085	0	80	80	1.0000000
NODE_885_length_2518_cov_7.035965	2058	2138	0	80	80	1.0000000
NODE_887_length_2515_cov_37.984272	393	473	0	80	80	1.0000000
NODE_887_length_2515_cov_37.984272	446	526	0	80	80	1.0000000
NODE_887_length_2515_cov_37.984272	1896	1976	0	36	80	0.4500000
NODE_887_length_2515_cov_37.984272	1896	1976	2	44	80	0.5500000
NODE_887_length_2515_cov_37.984272	1949	2029	0	18	80	0.2250000
NODE_887_length_2515_cov_37.984272	1949	2029	2	62	80	0.7750000
NODE_887_length_2515_cov_37.984272	2025	2105	0	7	80	0.0875000
NODE_887_length_2515_cov_37.984272	2025	2105	13	19	80	0.2375000
NODE_887_length_2515_cov_37.984272	2025	2105	14	54	80	0.6750000
NODE_887_length_2515_cov_37.984272	2025	2104	0	7	79	0.0886076
NODE_887_length_2515_cov_37.984272	2025	2104	13	18	79	0.2278481
NODE_887_length_2515_cov_37.984272	2025	2104	14	54	79	0.6835443
NODE_887_length_2515_cov_37.984272	2078	2158	0	3	80	0.0375000
NODE_887_length_2515_cov_37.984272	2078	2158	13	69	80	0.8625000
NODE_887_length_2515_cov_37.984272	2078	2158	14	8	80	0.1000000
NODE_888_length_2512_cov_48.259428	1299	1379	21	5	80	0.0625000
NODE_888_length_2512_cov_48.259428	1299	1379	23	5	80	0.0625000
NODE_888_length_2512_cov_48.259428	1299	1379	24	16	80	0.2000000
NODE_888_length_2512_cov_48.259428	1299	1379	25	2	80	0.0250000
NODE_888_length_2512_cov_48.259428	1299	1379	26	3	80	0.0375000
NODE_888_length_2512_cov_48.259428	1299	1379	28	28	80	0.3500000
NODE_888_length_2512_cov_48.259428	1299	1379	29	7	80	0.0875000
NODE_888_length_2512_cov_48.259428	1299	1379	30	2	80	0.0250000
NODE_888_length_2512_cov_48.259428	1299	1379	31	6	80	0.0750000
NODE_888_length_2512_cov_48.259428	1299	1379	32	6	80	0.0750000
NODE_888_length_2512_cov_48.259428	1352	1432	12	13	80	0.1625000
NODE_888_length_2512_cov_48.259428	1352	1432	14	20	80	0.2500000
NODE_888_length_2512_cov_48.259428	1352	1432	16	5	80	0.0625000
NODE_888_length_2512_cov_48.259428	1352	1432	18	2	80	0.0250000
NODE_888_length_2512_cov_48.259428	1352	1432	24	29	80	0.3625000
NODE_888_length_2512_cov_48.259428	1352	1432	28	11	80	0.1375000
NODE_888_length_2512_cov_48.259428	1428	1512	12	1	84	0.0119048
NODE_888_length_2512_cov_48.259428	1428	1512	14	1	84	0.0119048
NODE_888_length_2512_cov_48.259428	1428	1512	16	2	84	0.0238095
NODE_888_length_2512_cov_48.259428	1428	1512	18	3	84	0.0357143
NODE_888_length_2512_cov_48.259428	1428	1512	22	3	84	0.0357143
NODE_888_length_2512_cov_48.259428	1428	1512	30	4	84	0.0476190
NODE_888_length_2512_cov_48.259428	1428	1512	32	9	84	0.1071429
NODE_888_length_2512_cov_48.259428	1428	1512	36	1	84	0.0119048
NODE_888_length_2512_cov_48.259428	1428	1512	41	5	84	0.0595238
NODE_888_length_2512_cov_48.259428	1428	1512	43	2	84	0.0238095
NODE_888_length_2512_cov_48.259428	1428	1512	47	1	84	0.0119048
NODE_888_length_2512_cov_48.259428	1428	1512	48	9	84	0.1071429
NODE_888_length_2512_cov_48.259428	1428	1512	49	7	84	0.0833333
NODE_888_length_2512_cov_48.259428	1428	1512	57	2	84	0.0238095
NODE_888_length_2512_cov_48.259428	1428	1512	59	2	84	0.0238095
NODE_888_length_2512_cov_48.259428	1428	1512	61	1	84	0.0119048
NODE_888_length_2512_cov_48.259428	1428	1512	63	1	84	0.0119048
NODE_888_length_2512_cov_48.259428	1428	1512	65	1	84	0.0119048
NODE_888_length_2512_cov_48.259428	1428	1512	71	1	84	0.0119048
NODE_888_length_2512_cov_48.259428	1428	1512	77	1	84	0.0119048
NODE_888_length_2512_cov_48.259428	1428	1512	80	1	84	0.0119048
NODE_888_length_2512_cov_48.259428	1428	1512	85	2	84	0.0238095
NODE_888_length_2512_cov_48.259428	1428	1512	87	1	84	0.0119048
NODE_888_length_2512_cov_48.259428	1428	1512	89	3	84	0.0357143
NODE_888_length_2512_cov_48.259428	1428	1512	96	7	84	0.0833333
NODE_888_length_2512_cov_48.259428	1428	1512	100	2	84	0.0238095
NODE_888_length_2512_cov_48.259428	1428	1512	101	3	84	0.0357143
NODE_888_length_2512_cov_48.259428	1428	1512	107	1	84	0.0119048
NODE_888_length_2512_cov_48.259428	1428	1512	109	3	84	0.0357143
NODE_888_length_2512_cov_48.259428	1428	1512	111	4	84	0.0476190
NODE_888_length_2512_cov_48.259428	1485	1565	80	1	80	0.0125000
NODE_888_length_2512_cov_48.259428	1485	1565	85	2	80	0.0250000
NODE_888_length_2512_cov_48.259428	1485	1565	87	1	80	0.0125000
NODE_888_length_2512_cov_48.259428	1485	1565	89	3	80	0.0375000
NODE_888_length_2512_cov_48.259428	1485	1565	92	1	80	0.0125000
NODE_888_length_2512_cov_48.259428	1485	1565	94	3	80	0.0375000
NODE_888_length_2512_cov_48.259428	1485	1565	96	10	80	0.1250000
NODE_888_length_2512_cov_48.259428	1485	1565	98	5	80	0.0625000
NODE_888_length_2512_cov_48.259428	1485	1565	100	7	80	0.0875000
NODE_888_length_2512_cov_48.259428	1485	1565	101	3	80	0.0375000
NODE_888_length_2512_cov_48.259428	1485	1565	107	1	80	0.0125000
NODE_888_length_2512_cov_48.259428	1485	1565	108	2	80	0.0250000
NODE_888_length_2512_cov_48.259428	1485	1565	109	3	80	0.0375000
NODE_888_length_2512_cov_48.259428	1485	1565	110	18	80	0.2250000
NODE_888_length_2512_cov_48.259428	1485	1565	111	20	80	0.2500000
NODE_891_length_2505_cov_102.009975	390	470	4	58	80	0.7250000
NODE_891_length_2505_cov_102.009975	390	470	8	22	80	0.2750000
NODE_891_length_2505_cov_102.009975	443	510	0	4	67	0.0597015
NODE_891_length_2505_cov_102.009975	443	510	4	63	67	0.9402985
NODE_894_length_2499_cov_2.655417	2325	2375	9	2	50	0.0400000
NODE_894_length_2499_cov_2.655417	2325	2375	10	1	50	0.0200000
NODE_894_length_2499_cov_2.655417	2325	2375	13	2	50	0.0400000
NODE_894_length_2499_cov_2.655417	2325	2375	15	2	50	0.0400000
NODE_894_length_2499_cov_2.655417	2325	2375	16	1	50	0.0200000
NODE_894_length_2499_cov_2.655417	2325	2375	19	1	50	0.0200000
NODE_894_length_2499_cov_2.655417	2325	2375	21	1	50	0.0200000
NODE_894_length_2499_cov_2.655417	2325	2375	23	2	50	0.0400000
NODE_894_length_2499_cov_2.655417	2325	2375	27	2	50	0.0400000
NODE_894_length_2499_cov_2.655417	2325	2375	30	2	50	0.0400000
NODE_894_length_2499_cov_2.655417	2325	2375	31	3	50	0.0600000
NODE_894_length_2499_cov_2.655417	2325	2375	33	11	50	0.2200000
NODE_894_length_2499_cov_2.655417	2325	2375	35	20	50	0.4000000
NODE_895_length_2498_cov_9.614840	239	281	0	6	42	0.1428571
NODE_895_length_2498_cov_9.614840	239	281	1	36	42	0.8571429
NODE_895_length_2498_cov_9.614840	254	335	1	40	81	0.4938272
NODE_895_length_2498_cov_9.614840	254	335	2	36	81	0.4444444
NODE_895_length_2498_cov_9.614840	254	335	6	5	81	0.0617284
NODE_895_length_2498_cov_9.614840	254	335	1	40	81	0.4938272
NODE_895_length_2498_cov_9.614840	254	335	2	36	81	0.4444444
NODE_895_length_2498_cov_9.614840	254	335	6	5	81	0.0617284
NODE_895_length_2498_cov_9.614840	331	411	5	16	80	0.2000000
NODE_895_length_2498_cov_9.614840	331	411	6	64	80	0.8000000
NODE_895_length_2498_cov_9.614840	384	464	0	20	80	0.2500000
NODE_895_length_2498_cov_9.614840	384	464	1	3	80	0.0375000
NODE_895_length_2498_cov_9.614840	384	464	5	46	80	0.5750000
NODE_895_length_2498_cov_9.614840	384	464	6	11	80	0.1375000
NODE_898_length_2495_cov_5.151085	2395	2444	0	2	49	0.0408163
NODE_898_length_2495_cov_5.151085	2395	2444	2	17	49	0.3469388
NODE_898_length_2495_cov_5.151085	2395	2444	4	30	49	0.6122449
NODE_898_length_2495_cov_5.151085	2395	2444	0	2	49	0.0408163
NODE_898_length_2495_cov_5.151085	2395	2444	2	17	49	0.3469388
NODE_898_length_2495_cov_5.151085	2395	2444	4	30	49	0.6122449
NODE_898_length_2495_cov_5.151085	2396	2444	0	2	48	0.0416667
NODE_898_length_2495_cov_5.151085	2396	2444	2	17	48	0.3541667
NODE_898_length_2495_cov_5.151085	2396	2444	4	29	48	0.6041667
NODE_898_length_2495_cov_5.151085	2396	2444	0	2	48	0.0416667
NODE_898_length_2495_cov_5.151085	2396	2444	2	17	48	0.3541667
NODE_898_length_2495_cov_5.151085	2396	2444	4	29	48	0.6041667
NODE_898_length_2495_cov_5.151085	2396	2444	0	2	48	0.0416667
NODE_898_length_2495_cov_5.151085	2396	2444	2	17	48	0.3541667
NODE_898_length_2495_cov_5.151085	2396	2444	4	29	48	0.6041667
NODE_900_length_2492_cov_43.645215	408	488	0	15	80	0.1875000
NODE_900_length_2492_cov_43.645215	408	488	6	65	80	0.8125000
NODE_903_length_2489_cov_15.105021	204	234	2	30	30	1.0000000
NODE_905_length_2488_cov_2.434910	2141	2200	14	7	59	0.1186441
NODE_905_length_2488_cov_2.434910	2141	2200	16	6	59	0.1016949
NODE_905_length_2488_cov_2.434910	2141	2200	18	1	59	0.0169492
NODE_905_length_2488_cov_2.434910	2141	2200	20	9	59	0.1525424
NODE_905_length_2488_cov_2.434910	2141	2200	22	14	59	0.2372881
NODE_905_length_2488_cov_2.434910	2141	2200	24	22	59	0.3728814
NODE_906_length_2484_cov_335.301887	224	279	1032	1	55	0.0181818
NODE_906_length_2484_cov_335.301887	224	279	1035	1	55	0.0181818
NODE_906_length_2484_cov_335.301887	224	279	1040	1	55	0.0181818
NODE_906_length_2484_cov_335.301887	224	279	1045	1	55	0.0181818
NODE_906_length_2484_cov_335.301887	224	279	1058	1	55	0.0181818
NODE_906_length_2484_cov_335.301887	224	279	1096	1	55	0.0181818
NODE_906_length_2484_cov_335.301887	224	279	1104	1	55	0.0181818
NODE_906_length_2484_cov_335.301887	224	279	1118	1	55	0.0181818
NODE_906_length_2484_cov_335.301887	224	279	1126	1	55	0.0181818
NODE_906_length_2484_cov_335.301887	224	279	1127	1	55	0.0181818
NODE_906_length_2484_cov_335.301887	224	279	1135	1	55	0.0181818
NODE_906_length_2484_cov_335.301887	224	279	1137	1	55	0.0181818
NODE_906_length_2484_cov_335.301887	224	279	1144	1	55	0.0181818
NODE_906_length_2484_cov_335.301887	224	279	1151	1	55	0.0181818
NODE_906_length_2484_cov_335.301887	224	279	1156	1	55	0.0181818
NODE_906_length_2484_cov_335.301887	224	279	1159	2	55	0.0363636
NODE_906_length_2484_cov_335.301887	224	279	1176	1	55	0.0181818
NODE_906_length_2484_cov_335.301887	224	279	1196	1	55	0.0181818
NODE_906_length_2484_cov_335.301887	224	279	1201	1	55	0.0181818
NODE_906_length_2484_cov_335.301887	224	279	1211	1	55	0.0181818
NODE_906_length_2484_cov_335.301887	224	279	1215	1	55	0.0181818
NODE_906_length_2484_cov_335.301887	224	279	1217	1	55	0.0181818
NODE_906_length_2484_cov_335.301887	224	279	1222	1	55	0.0181818
NODE_906_length_2484_cov_335.301887	224	279	1223	1	55	0.0181818
NODE_906_length_2484_cov_335.301887	224	279	1241	1	55	0.0181818
NODE_906_length_2484_cov_335.301887	224	279	1244	1	55	0.0181818
NODE_906_length_2484_cov_335.301887	224	279	1246	1	55	0.0181818
NODE_906_length_2484_cov_335.301887	224	279	1247	1	55	0.0181818
NODE_906_length_2484_cov_335.301887	224	279	1250	1	55	0.0181818
NODE_906_length_2484_cov_335.301887	224	279	1253	2	55	0.0363636
NODE_906_length_2484_cov_335.301887	224	279	1259	1	55	0.0181818
NODE_906_length_2484_cov_335.301887	224	279	1260	1	55	0.0181818
NODE_906_length_2484_cov_335.301887	224	279	1261	1	55	0.0181818
NODE_906_length_2484_cov_335.301887	224	279	1263	1	55	0.0181818
NODE_906_length_2484_cov_335.301887	224	279	1268	1	55	0.0181818
NODE_906_length_2484_cov_335.301887	224	279	1270	2	55	0.0363636
NODE_906_length_2484_cov_335.301887	224	279	1271	2	55	0.0363636
NODE_906_length_2484_cov_335.301887	224	279	1274	1	55	0.0181818
NODE_906_length_2484_cov_335.301887	224	279	1275	2	55	0.0363636
NODE_906_length_2484_cov_335.301887	224	279	1276	1	55	0.0181818
NODE_906_length_2484_cov_335.301887	224	279	1277	3	55	0.0545455
NODE_906_length_2484_cov_335.301887	224	279	1279	1	55	0.0181818
NODE_906_length_2484_cov_335.301887	224	279	1281	3	55	0.0545455
NODE_906_length_2484_cov_335.301887	224	279	1283	1	55	0.0181818
NODE_906_length_2484_cov_335.301887	224	279	1284	1	55	0.0181818
NODE_906_length_2484_cov_335.301887	224	279	1286	1	55	0.0181818
NODE_906_length_2484_cov_335.301887	252	332	1101	1	80	0.0125000
NODE_906_length_2484_cov_335.301887	252	332	1104	1	80	0.0125000
NODE_906_length_2484_cov_335.301887	252	332	1109	1	80	0.0125000
NODE_906_length_2484_cov_335.301887	252	332	1123	1	80	0.0125000
NODE_906_length_2484_cov_335.301887	252	332	1134	1	80	0.0125000
NODE_906_length_2484_cov_335.301887	252	332	1146	1	80	0.0125000
NODE_906_length_2484_cov_335.301887	252	332	1149	1	80	0.0125000
NODE_906_length_2484_cov_335.301887	252	332	1154	1	80	0.0125000
NODE_906_length_2484_cov_335.301887	252	332	1161	1	80	0.0125000
NODE_906_length_2484_cov_335.301887	252	332	1168	1	80	0.0125000
NODE_906_length_2484_cov_335.301887	252	332	1173	1	80	0.0125000
NODE_906_length_2484_cov_335.301887	252	332	1185	1	80	0.0125000
NODE_906_length_2484_cov_335.301887	252	332	1189	1	80	0.0125000
NODE_906_length_2484_cov_335.301887	252	332	1206	1	80	0.0125000
NODE_906_length_2484_cov_335.301887	252	332	1223	1	80	0.0125000
NODE_906_length_2484_cov_335.301887	252	332	1235	1	80	0.0125000
NODE_906_length_2484_cov_335.301887	252	332	1247	1	80	0.0125000
NODE_906_length_2484_cov_335.301887	252	332	1249	2	80	0.0250000
NODE_906_length_2484_cov_335.301887	252	332	1250	1	80	0.0125000
NODE_906_length_2484_cov_335.301887	252	332	1251	1	80	0.0125000
NODE_906_length_2484_cov_335.301887	252	332	1252	1	80	0.0125000
NODE_906_length_2484_cov_335.301887	252	332	1253	2	80	0.0250000
NODE_906_length_2484_cov_335.301887	252	332	1259	1	80	0.0125000
NODE_906_length_2484_cov_335.301887	252	332	1260	1	80	0.0125000
NODE_906_length_2484_cov_335.301887	252	332	1261	1	80	0.0125000
NODE_906_length_2484_cov_335.301887	252	332	1263	1	80	0.0125000
NODE_906_length_2484_cov_335.301887	252	332	1266	1	80	0.0125000
NODE_906_length_2484_cov_335.301887	252	332	1267	3	80	0.0375000
NODE_906_length_2484_cov_335.301887	252	332	1268	2	80	0.0250000
NODE_906_length_2484_cov_335.301887	252	332	1269	2	80	0.0250000
NODE_906_length_2484_cov_335.301887	252	332	1270	2	80	0.0250000
NODE_906_length_2484_cov_335.301887	252	332	1271	3	80	0.0375000
NODE_906_length_2484_cov_335.301887	252	332	1272	1	80	0.0125000
NODE_906_length_2484_cov_335.301887	252	332	1273	1	80	0.0125000
NODE_906_length_2484_cov_335.301887	252	332	1274	3	80	0.0375000
NODE_906_length_2484_cov_335.301887	252	332	1275	3	80	0.0375000
NODE_906_length_2484_cov_335.301887	252	332	1276	2	80	0.0250000
NODE_906_length_2484_cov_335.301887	252	332	1277	3	80	0.0375000
NODE_906_length_2484_cov_335.301887	252	332	1279	1	80	0.0125000
NODE_906_length_2484_cov_335.301887	252	332	1280	1	80	0.0125000
NODE_906_length_2484_cov_335.301887	252	332	1281	3	80	0.0375000
NODE_906_length_2484_cov_335.301887	252	332	1282	2	80	0.0250000
NODE_906_length_2484_cov_335.301887	252	332	1283	3	80	0.0375000
NODE_906_length_2484_cov_335.301887	252	332	1284	3	80	0.0375000
NODE_906_length_2484_cov_335.301887	252	332	1286	2	80	0.0250000
NODE_906_length_2484_cov_335.301887	252	332	1287	2	80	0.0250000
NODE_906_length_2484_cov_335.301887	252	332	1288	1	80	0.0125000
NODE_906_length_2484_cov_335.301887	252	332	1289	3	80	0.0375000
NODE_906_length_2484_cov_335.301887	252	332	1291	1	80	0.0125000
NODE_906_length_2484_cov_335.301887	252	332	1293	1	80	0.0125000
NODE_906_length_2484_cov_335.301887	252	332	1296	1	80	0.0125000
NODE_906_length_2484_cov_335.301887	252	332	1299	2	80	0.0250000
NODE_912_length_2479_cov_90.381092	369	449	0	80	80	1.0000000
NODE_912_length_2479_cov_90.381092	422	499	0	77	77	1.0000000
NODE_912_length_2479_cov_90.381092	1610	1685	194	1	75	0.0133333
NODE_912_length_2479_cov_90.381092	1610	1685	233	1	75	0.0133333
NODE_912_length_2479_cov_90.381092	1610	1685	255	1	75	0.0133333
NODE_912_length_2479_cov_90.381092	1610	1685	266	1	75	0.0133333
NODE_912_length_2479_cov_90.381092	1610	1685	289	1	75	0.0133333
NODE_912_length_2479_cov_90.381092	1610	1685	293	1	75	0.0133333
NODE_912_length_2479_cov_90.381092	1610	1685	307	1	75	0.0133333
NODE_912_length_2479_cov_90.381092	1610	1685	309	2	75	0.0266667
NODE_912_length_2479_cov_90.381092	1610	1685	317	1	75	0.0133333
NODE_912_length_2479_cov_90.381092	1610	1685	347	1	75	0.0133333
NODE_912_length_2479_cov_90.381092	1610	1685	349	1	75	0.0133333
NODE_912_length_2479_cov_90.381092	1610	1685	355	1	75	0.0133333
NODE_912_length_2479_cov_90.381092	1610	1685	357	1	75	0.0133333
NODE_912_length_2479_cov_90.381092	1610	1685	361	1	75	0.0133333
NODE_912_length_2479_cov_90.381092	1610	1685	362	1	75	0.0133333
NODE_912_length_2479_cov_90.381092	1610	1685	370	1	75	0.0133333
NODE_912_length_2479_cov_90.381092	1610	1685	393	1	75	0.0133333
NODE_912_length_2479_cov_90.381092	1610	1685	403	1	75	0.0133333
NODE_912_length_2479_cov_90.381092	1610	1685	411	1	75	0.0133333
NODE_912_length_2479_cov_90.381092	1610	1685	416	1	75	0.0133333
NODE_912_length_2479_cov_90.381092	1610	1685	428	1	75	0.0133333
NODE_912_length_2479_cov_90.381092	1610	1685	432	1	75	0.0133333
NODE_912_length_2479_cov_90.381092	1610	1685	439	1	75	0.0133333
NODE_912_length_2479_cov_90.381092	1610	1685	445	2	75	0.0266667
NODE_912_length_2479_cov_90.381092	1610	1685	466	1	75	0.0133333
NODE_912_length_2479_cov_90.381092	1610	1685	472	2	75	0.0266667
NODE_912_length_2479_cov_90.381092	1610	1685	482	1	75	0.0133333
NODE_912_length_2479_cov_90.381092	1610	1685	483	1	75	0.0133333
NODE_912_length_2479_cov_90.381092	1610	1685	484	1	75	0.0133333
NODE_912_length_2479_cov_90.381092	1610	1685	501	2	75	0.0266667
NODE_912_length_2479_cov_90.381092	1610	1685	517	1	75	0.0133333
NODE_912_length_2479_cov_90.381092	1610	1685	526	1	75	0.0133333
NODE_912_length_2479_cov_90.381092	1610	1685	536	1	75	0.0133333
NODE_912_length_2479_cov_90.381092	1610	1685	542	1	75	0.0133333
NODE_912_length_2479_cov_90.381092	1610	1685	543	1	75	0.0133333
NODE_912_length_2479_cov_90.381092	1610	1685	564	1	75	0.0133333
NODE_912_length_2479_cov_90.381092	1610	1685	576	1	75	0.0133333
NODE_912_length_2479_cov_90.381092	1610	1685	582	1	75	0.0133333
NODE_912_length_2479_cov_90.381092	1610	1685	594	2	75	0.0266667
NODE_912_length_2479_cov_90.381092	1610	1685	607	1	75	0.0133333
NODE_912_length_2479_cov_90.381092	1610	1685	611	1	75	0.0133333
NODE_912_length_2479_cov_90.381092	1610	1685	621	1	75	0.0133333
NODE_912_length_2479_cov_90.381092	1610	1685	622	1	75	0.0133333
NODE_912_length_2479_cov_90.381092	1610	1685	632	1	75	0.0133333
NODE_912_length_2479_cov_90.381092	1610	1685	635	1	75	0.0133333
NODE_912_length_2479_cov_90.381092	1610	1685	645	1	75	0.0133333
NODE_912_length_2479_cov_90.381092	1610	1685	659	1	75	0.0133333
NODE_912_length_2479_cov_90.381092	1610	1685	661	1	75	0.0133333
NODE_912_length_2479_cov_90.381092	1610	1685	665	1	75	0.0133333
NODE_912_length_2479_cov_90.381092	1610	1685	668	1	75	0.0133333
NODE_912_length_2479_cov_90.381092	1610	1685	674	1	75	0.0133333
NODE_912_length_2479_cov_90.381092	1610	1685	681	1	75	0.0133333
NODE_912_length_2479_cov_90.381092	1610	1685	688	1	75	0.0133333
NODE_912_length_2479_cov_90.381092	1610	1685	690	1	75	0.0133333
NODE_912_length_2479_cov_90.381092	1610	1685	701	3	75	0.0400000
NODE_912_length_2479_cov_90.381092	1610	1685	703	2	75	0.0266667
NODE_912_length_2479_cov_90.381092	1610	1685	704	1	75	0.0133333
NODE_912_length_2479_cov_90.381092	1610	1685	714	2	75	0.0266667
NODE_912_length_2479_cov_90.381092	1610	1685	716	1	75	0.0133333
NODE_912_length_2479_cov_90.381092	1610	1685	720	1	75	0.0133333
NODE_912_length_2479_cov_90.381092	1610	1685	723	1	75	0.0133333
NODE_912_length_2479_cov_90.381092	1610	1685	729	1	75	0.0133333
NODE_912_length_2479_cov_90.381092	1610	1685	733	1	75	0.0133333
NODE_912_length_2479_cov_90.381092	1610	1685	734	1	75	0.0133333
NODE_912_length_2479_cov_90.381092	1610	1685	735	2	75	0.0266667
NODE_912_length_2479_cov_90.381092	1658	1730	632	1	72	0.0138889
NODE_912_length_2479_cov_90.381092	1658	1730	635	1	72	0.0138889
NODE_912_length_2479_cov_90.381092	1658	1730	645	1	72	0.0138889
NODE_912_length_2479_cov_90.381092	1658	1730	659	2	72	0.0277778
NODE_912_length_2479_cov_90.381092	1658	1730	661	1	72	0.0138889
NODE_912_length_2479_cov_90.381092	1658	1730	665	1	72	0.0138889
NODE_912_length_2479_cov_90.381092	1658	1730	668	1	72	0.0138889
NODE_912_length_2479_cov_90.381092	1658	1730	674	1	72	0.0138889
NODE_912_length_2479_cov_90.381092	1658	1730	675	1	72	0.0138889
NODE_912_length_2479_cov_90.381092	1658	1730	677	1	72	0.0138889
NODE_912_length_2479_cov_90.381092	1658	1730	679	5	72	0.0694444
NODE_912_length_2479_cov_90.381092	1658	1730	680	2	72	0.0277778
NODE_912_length_2479_cov_90.381092	1658	1730	681	6	72	0.0833333
NODE_912_length_2479_cov_90.381092	1658	1730	683	1	72	0.0138889
NODE_912_length_2479_cov_90.381092	1658	1730	684	1	72	0.0138889
NODE_912_length_2479_cov_90.381092	1658	1730	688	1	72	0.0138889
NODE_912_length_2479_cov_90.381092	1658	1730	689	1	72	0.0138889
NODE_912_length_2479_cov_90.381092	1658	1730	690	1	72	0.0138889
NODE_912_length_2479_cov_90.381092	1658	1730	692	1	72	0.0138889
NODE_912_length_2479_cov_90.381092	1658	1730	699	1	72	0.0138889
NODE_912_length_2479_cov_90.381092	1658	1730	700	1	72	0.0138889
NODE_912_length_2479_cov_90.381092	1658	1730	701	3	72	0.0416667
NODE_912_length_2479_cov_90.381092	1658	1730	702	1	72	0.0138889
NODE_912_length_2479_cov_90.381092	1658	1730	703	2	72	0.0277778
NODE_912_length_2479_cov_90.381092	1658	1730	704	1	72	0.0138889
NODE_912_length_2479_cov_90.381092	1658	1730	707	1	72	0.0138889
NODE_912_length_2479_cov_90.381092	1658	1730	708	1	72	0.0138889
NODE_912_length_2479_cov_90.381092	1658	1730	709	2	72	0.0277778
NODE_912_length_2479_cov_90.381092	1658	1730	710	1	72	0.0138889
NODE_912_length_2479_cov_90.381092	1658	1730	712	2	72	0.0277778
NODE_912_length_2479_cov_90.381092	1658	1730	714	2	72	0.0277778
NODE_912_length_2479_cov_90.381092	1658	1730	716	2	72	0.0277778
NODE_912_length_2479_cov_90.381092	1658	1730	720	1	72	0.0138889
NODE_912_length_2479_cov_90.381092	1658	1730	721	1	72	0.0138889
NODE_912_length_2479_cov_90.381092	1658	1730	723	1	72	0.0138889
NODE_912_length_2479_cov_90.381092	1658	1730	724	1	72	0.0138889
NODE_912_length_2479_cov_90.381092	1658	1730	729	3	72	0.0416667
NODE_912_length_2479_cov_90.381092	1658	1730	732	1	72	0.0138889
NODE_912_length_2479_cov_90.381092	1658	1730	733	2	72	0.0277778
NODE_912_length_2479_cov_90.381092	1658	1730	734	1	72	0.0138889
NODE_912_length_2479_cov_90.381092	1658	1730	735	4	72	0.0555556
NODE_912_length_2479_cov_90.381092	1658	1730	736	1	72	0.0138889
NODE_912_length_2479_cov_90.381092	1658	1730	738	2	72	0.0277778
NODE_912_length_2479_cov_90.381092	1658	1730	740	1	72	0.0138889
NODE_912_length_2479_cov_90.381092	1658	1730	742	2	72	0.0277778
NODE_912_length_2479_cov_90.381092	1658	1730	746	1	72	0.0138889
NODE_913_length_2479_cov_3.433193	2379	2426	0	47	47	1.0000000
NODE_913_length_2479_cov_3.433193	2399	2479	0	80	80	1.0000000
NODE_915_length_2474_cov_7.237895	399	479	0	80	80	1.0000000
NODE_915_length_2474_cov_7.237895	452	532	0	80	80	1.0000000
NODE_922_length_2465_cov_3.098056	2133	2213	0	11	80	0.1375000
NODE_922_length_2465_cov_3.098056	2133	2213	4	69	80	0.8625000
NODE_922_length_2465_cov_3.098056	2191	2253	4	62	62	1.0000000
NODE_923_length_2464_cov_24.562791	331	409	0	78	78	1.0000000
NODE_923_length_2464_cov_24.562791	382	462	0	80	80	1.0000000
NODE_924_length_2461_cov_2.696444	292	372	0	80	80	1.0000000
NODE_924_length_2461_cov_2.696444	345	425	0	80	80	1.0000000
NODE_938_length_2447_cov_16.079216	2344	2424	18	1	80	0.0125000
NODE_938_length_2447_cov_16.079216	2344	2424	20	3	80	0.0375000
NODE_938_length_2447_cov_16.079216	2344	2424	24	1	80	0.0125000
NODE_938_length_2447_cov_16.079216	2344	2424	28	1	80	0.0125000
NODE_938_length_2447_cov_16.079216	2344	2424	31	2	80	0.0250000
NODE_938_length_2447_cov_16.079216	2344	2424	32	8	80	0.1000000
NODE_938_length_2447_cov_16.079216	2344	2424	34	4	80	0.0500000
NODE_938_length_2447_cov_16.079216	2344	2424	40	1	80	0.0125000
NODE_938_length_2447_cov_16.079216	2344	2424	42	4	80	0.0500000
NODE_938_length_2447_cov_16.079216	2344	2424	43	1	80	0.0125000
NODE_938_length_2447_cov_16.079216	2344	2424	45	6	80	0.0750000
NODE_938_length_2447_cov_16.079216	2344	2424	47	6	80	0.0750000
NODE_938_length_2447_cov_16.079216	2344	2424	49	3	80	0.0375000
NODE_938_length_2447_cov_16.079216	2344	2424	51	4	80	0.0500000
NODE_938_length_2447_cov_16.079216	2344	2424	52	2	80	0.0250000
NODE_938_length_2447_cov_16.079216	2344	2424	54	2	80	0.0250000
NODE_938_length_2447_cov_16.079216	2344	2424	56	3	80	0.0375000
NODE_938_length_2447_cov_16.079216	2344	2424	59	1	80	0.0125000
NODE_938_length_2447_cov_16.079216	2344	2424	60	6	80	0.0750000
NODE_938_length_2447_cov_16.079216	2344	2424	61	8	80	0.1000000
NODE_938_length_2447_cov_16.079216	2344	2424	66	1	80	0.0125000
NODE_938_length_2447_cov_16.079216	2344	2424	67	1	80	0.0125000
NODE_938_length_2447_cov_16.079216	2344	2424	69	1	80	0.0125000
NODE_938_length_2447_cov_16.079216	2344	2424	73	2	80	0.0250000
NODE_938_length_2447_cov_16.079216	2344	2424	75	8	80	0.1000000
NODE_938_length_2447_cov_16.079216	2397	2447	1	1	50	0.0200000
NODE_938_length_2447_cov_16.079216	2397	2447	2	1	50	0.0200000
NODE_938_length_2447_cov_16.079216	2397	2447	4	1	50	0.0200000
NODE_938_length_2447_cov_16.079216	2397	2447	8	8	50	0.1600000
NODE_938_length_2447_cov_16.079216	2397	2447	12	11	50	0.2200000
NODE_938_length_2447_cov_16.079216	2397	2447	16	1	50	0.0200000
NODE_938_length_2447_cov_16.079216	2397	2447	18	1	50	0.0200000
NODE_938_length_2447_cov_16.079216	2397	2447	20	3	50	0.0600000
NODE_938_length_2447_cov_16.079216	2397	2447	24	1	50	0.0200000
NODE_938_length_2447_cov_16.079216	2397	2447	28	1	50	0.0200000
NODE_938_length_2447_cov_16.079216	2397	2447	31	2	50	0.0400000
NODE_938_length_2447_cov_16.079216	2397	2447	32	8	50	0.1600000
NODE_938_length_2447_cov_16.079216	2397	2447	34	4	50	0.0800000
NODE_938_length_2447_cov_16.079216	2397	2447	40	1	50	0.0200000
NODE_938_length_2447_cov_16.079216	2397	2447	42	4	50	0.0800000
NODE_938_length_2447_cov_16.079216	2397	2447	43	1	50	0.0200000
NODE_938_length_2447_cov_16.079216	2397	2447	45	1	50	0.0200000
NODE_940_length_2446_cov_2.341287	1521	1578	0	13	57	0.2280702
NODE_940_length_2446_cov_2.341287	1521	1578	2	44	57	0.7719298
NODE_940_length_2446_cov_2.341287	1551	1593	2	42	42	1.0000000
NODE_949_length_2437_cov_13.341745	418	498	0	20	80	0.2500000
NODE_949_length_2437_cov_13.341745	418	498	2	60	80	0.7500000
NODE_949_length_2437_cov_13.341745	471	551	0	50	80	0.6250000
NODE_949_length_2437_cov_13.341745	471	551	2	8	80	0.1000000
NODE_949_length_2437_cov_13.341745	471	551	4	2	80	0.0250000
NODE_949_length_2437_cov_13.341745	471	551	5	3	80	0.0375000
NODE_949_length_2437_cov_13.341745	471	551	6	11	80	0.1375000
NODE_949_length_2437_cov_13.341745	471	551	17	2	80	0.0250000
NODE_949_length_2437_cov_13.341745	471	551	28	2	80	0.0250000
NODE_949_length_2437_cov_13.341745	471	551	29	1	80	0.0125000
NODE_949_length_2437_cov_13.341745	471	551	33	1	80	0.0125000
NODE_951_length_2432_cov_70.360909	1875	1955	0	32	80	0.4000000
NODE_951_length_2432_cov_70.360909	1875	1955	2	48	80	0.6000000
NODE_951_length_2432_cov_70.360909	1928	2008	0	45	80	0.5625000
NODE_951_length_2432_cov_70.360909	1928	2008	2	35	80	0.4375000
NODE_955_length_2430_cov_19.835264	0	68	20	1	68	0.0147059
NODE_955_length_2430_cov_19.835264	0	68	26	1	68	0.0147059
NODE_955_length_2430_cov_19.835264	0	68	33	1	68	0.0147059
NODE_955_length_2430_cov_19.835264	0	68	41	1	68	0.0147059
NODE_955_length_2430_cov_19.835264	0	68	44	1	68	0.0147059
NODE_955_length_2430_cov_19.835264	0	68	60	1	68	0.0147059
NODE_955_length_2430_cov_19.835264	0	68	62	1	68	0.0147059
NODE_955_length_2430_cov_19.835264	0	68	63	2	68	0.0294118
NODE_955_length_2430_cov_19.835264	0	68	65	1	68	0.0147059
NODE_955_length_2430_cov_19.835264	0	68	75	1	68	0.0147059
NODE_955_length_2430_cov_19.835264	0	68	78	2	68	0.0294118
NODE_955_length_2430_cov_19.835264	0	68	79	1	68	0.0147059
NODE_955_length_2430_cov_19.835264	0	68	80	1	68	0.0147059
NODE_955_length_2430_cov_19.835264	0	68	81	1	68	0.0147059
NODE_955_length_2430_cov_19.835264	0	68	85	2	68	0.0294118
NODE_955_length_2430_cov_19.835264	0	68	89	2	68	0.0294118
NODE_955_length_2430_cov_19.835264	0	68	93	1	68	0.0147059
NODE_955_length_2430_cov_19.835264	0	68	95	3	68	0.0441176
NODE_955_length_2430_cov_19.835264	0	68	103	1	68	0.0147059
NODE_955_length_2430_cov_19.835264	0	68	106	4	68	0.0588235
NODE_955_length_2430_cov_19.835264	0	68	107	1	68	0.0147059
NODE_955_length_2430_cov_19.835264	0	68	111	4	68	0.0588235
NODE_955_length_2430_cov_19.835264	0	68	113	2	68	0.0294118
NODE_955_length_2430_cov_19.835264	0	68	122	2	68	0.0294118
NODE_955_length_2430_cov_19.835264	0	68	126	1	68	0.0147059
NODE_955_length_2430_cov_19.835264	0	68	131	2	68	0.0294118
NODE_955_length_2430_cov_19.835264	0	68	135	2	68	0.0294118
NODE_955_length_2430_cov_19.835264	0	68	136	1	68	0.0147059
NODE_955_length_2430_cov_19.835264	0	68	139	1	68	0.0147059
NODE_955_length_2430_cov_19.835264	0	68	141	2	68	0.0294118
NODE_955_length_2430_cov_19.835264	0	68	143	1	68	0.0147059
NODE_955_length_2430_cov_19.835264	0	68	144	3	68	0.0441176
NODE_955_length_2430_cov_19.835264	0	68	146	1	68	0.0147059
NODE_955_length_2430_cov_19.835264	0	68	150	1	68	0.0147059
NODE_955_length_2430_cov_19.835264	0	68	153	1	68	0.0147059
NODE_955_length_2430_cov_19.835264	0	68	155	1	68	0.0147059
NODE_955_length_2430_cov_19.835264	0	68	157	2	68	0.0294118
NODE_955_length_2430_cov_19.835264	0	68	159	1	68	0.0147059
NODE_955_length_2430_cov_19.835264	0	68	163	1	68	0.0147059
NODE_955_length_2430_cov_19.835264	0	68	167	1	68	0.0147059
NODE_955_length_2430_cov_19.835264	0	68	177	1	68	0.0147059
NODE_955_length_2430_cov_19.835264	0	68	180	1	68	0.0147059
NODE_955_length_2430_cov_19.835264	0	68	184	1	68	0.0147059
NODE_955_length_2430_cov_19.835264	0	68	185	4	68	0.0588235
NODE_955_length_2430_cov_19.835264	0	68	191	1	68	0.0147059
NODE_955_length_2430_cov_19.835264	0	24	20	1	24	0.0416667
NODE_955_length_2430_cov_19.835264	0	24	26	1	24	0.0416667
NODE_955_length_2430_cov_19.835264	0	24	33	1	24	0.0416667
NODE_955_length_2430_cov_19.835264	0	24	41	1	24	0.0416667
NODE_955_length_2430_cov_19.835264	0	24	44	1	24	0.0416667
NODE_955_length_2430_cov_19.835264	0	24	60	1	24	0.0416667
NODE_955_length_2430_cov_19.835264	0	24	62	1	24	0.0416667
NODE_955_length_2430_cov_19.835264	0	24	63	2	24	0.0833333
NODE_955_length_2430_cov_19.835264	0	24	65	1	24	0.0416667
NODE_955_length_2430_cov_19.835264	0	24	75	1	24	0.0416667
NODE_955_length_2430_cov_19.835264	0	24	78	2	24	0.0833333
NODE_955_length_2430_cov_19.835264	0	24	79	1	24	0.0416667
NODE_955_length_2430_cov_19.835264	0	24	80	1	24	0.0416667
NODE_955_length_2430_cov_19.835264	0	24	81	1	24	0.0416667
NODE_955_length_2430_cov_19.835264	0	24	85	2	24	0.0833333
NODE_955_length_2430_cov_19.835264	0	24	89	2	24	0.0833333
NODE_955_length_2430_cov_19.835264	0	24	93	1	24	0.0416667
NODE_955_length_2430_cov_19.835264	0	24	95	3	24	0.1250000
NODE_956_length_2428_cov_179.842422	538	618	6	79	80	0.9875000
NODE_956_length_2428_cov_179.842422	538	618	10	1	80	0.0125000
NODE_956_length_2428_cov_179.842422	591	671	4	24	80	0.3000000
NODE_956_length_2428_cov_179.842422	591	671	6	28	80	0.3500000
NODE_956_length_2428_cov_179.842422	591	671	7	16	80	0.2000000
NODE_956_length_2428_cov_179.842422	591	671	10	12	80	0.1500000
NODE_956_length_2428_cov_179.842422	667	747	2	60	80	0.7500000
NODE_956_length_2428_cov_179.842422	667	747	4	20	80	0.2500000
NODE_956_length_2428_cov_179.842422	720	800	2	62	80	0.7750000
NODE_956_length_2428_cov_179.842422	720	800	4	18	80	0.2250000
NODE_956_length_2428_cov_179.842422	1308	1388	0	80	80	1.0000000
NODE_956_length_2428_cov_179.842422	1361	1441	0	80	80	1.0000000
NODE_956_length_2428_cov_179.842422	1437	1517	0	80	80	1.0000000
NODE_956_length_2428_cov_179.842422	1490	1570	0	80	80	1.0000000
NODE_956_length_2428_cov_179.842422	1986	2026	1482	1	40	0.0250000
NODE_956_length_2428_cov_179.842422	1986	2026	1483	1	40	0.0250000
NODE_956_length_2428_cov_179.842422	1986	2026	1488	1	40	0.0250000
NODE_956_length_2428_cov_179.842422	1986	2026	1489	1	40	0.0250000
NODE_956_length_2428_cov_179.842422	1986	2026	1491	1	40	0.0250000
NODE_956_length_2428_cov_179.842422	1986	2026	1492	1	40	0.0250000
NODE_956_length_2428_cov_179.842422	1986	2026	1495	2	40	0.0500000
NODE_956_length_2428_cov_179.842422	1986	2026	1496	1	40	0.0250000
NODE_956_length_2428_cov_179.842422	1986	2026	1497	1	40	0.0250000
NODE_956_length_2428_cov_179.842422	1986	2026	1498	1	40	0.0250000
NODE_956_length_2428_cov_179.842422	1986	2026	1504	2	40	0.0500000
NODE_956_length_2428_cov_179.842422	1986	2026	1519	1	40	0.0250000
NODE_956_length_2428_cov_179.842422	1986	2026	1522	1	40	0.0250000
NODE_956_length_2428_cov_179.842422	1986	2026	1523	1	40	0.0250000
NODE_956_length_2428_cov_179.842422	1986	2026	1525	1	40	0.0250000
NODE_956_length_2428_cov_179.842422	1986	2026	1527	2	40	0.0500000
NODE_956_length_2428_cov_179.842422	1986	2026	1528	1	40	0.0250000
NODE_956_length_2428_cov_179.842422	1986	2026	1538	1	40	0.0250000
NODE_956_length_2428_cov_179.842422	1986	2026	1552	1	40	0.0250000
NODE_956_length_2428_cov_179.842422	1986	2026	1556	1	40	0.0250000
NODE_956_length_2428_cov_179.842422	1986	2026	1561	1	40	0.0250000
NODE_956_length_2428_cov_179.842422	1986	2026	1562	1	40	0.0250000
NODE_956_length_2428_cov_179.842422	1986	2026	1573	1	40	0.0250000
NODE_956_length_2428_cov_179.842422	1986	2026	1578	1	40	0.0250000
NODE_956_length_2428_cov_179.842422	1986	2026	1581	1	40	0.0250000
NODE_956_length_2428_cov_179.842422	1986	2026	1582	1	40	0.0250000
NODE_956_length_2428_cov_179.842422	1986	2026	1587	1	40	0.0250000
NODE_956_length_2428_cov_179.842422	1986	2026	1591	2	40	0.0500000
NODE_956_length_2428_cov_179.842422	1986	2026	1593	1	40	0.0250000
NODE_956_length_2428_cov_179.842422	1986	2026	1594	1	40	0.0250000
NODE_956_length_2428_cov_179.842422	1986	2026	1608	1	40	0.0250000
NODE_956_length_2428_cov_179.842422	1986	2026	1622	1	40	0.0250000
NODE_956_length_2428_cov_179.842422	1986	2026	1636	1	40	0.0250000
NODE_956_length_2428_cov_179.842422	1986	2026	1637	1	40	0.0250000
NODE_956_length_2428_cov_179.842422	1986	2026	1646	1	40	0.0250000
NODE_956_length_2428_cov_179.842422	1986	2026	1648	1	40	0.0250000
NODE_959_length_2422_cov_6.665088	197	255	3	1	58	0.0172414
NODE_959_length_2422_cov_6.665088	197	255	4	15	58	0.2586207
NODE_959_length_2422_cov_6.665088	197	255	6	42	58	0.7241379
NODE_963_length_2414_cov_32.871706	411	491	0	80	80	1.0000000
NODE_963_length_2414_cov_32.871706	464	544	0	80	80	1.0000000
NODE_964_length_2414_cov_2.105832	2349	2390	0	41	41	1.0000000
NODE_968_length_2410_cov_9.107313	1874	1954	0	73	80	0.9125000
NODE_968_length_2410_cov_9.107313	1874	1954	2	7	80	0.0875000
NODE_968_length_2410_cov_9.107313	1927	2007	0	20	80	0.2500000
NODE_968_length_2410_cov_9.107313	1927	2007	2	60	80	0.7500000
NODE_977_length_2390_cov_20.371454	1753	1833	0	57	80	0.7125000
NODE_977_length_2390_cov_20.371454	1753	1833	2	23	80	0.2875000
NODE_977_length_2390_cov_20.371454	1806	1886	0	80	80	1.0000000
NODE_979_length_2389_cov_17.904803	1601	1681	0	80	80	1.0000000
NODE_979_length_2389_cov_17.904803	1654	1734	0	80	80	1.0000000
NODE_979_length_2389_cov_17.904803	1730	1810	0	40	80	0.5000000
NODE_979_length_2389_cov_17.904803	1730	1810	2	40	80	0.5000000
NODE_979_length_2389_cov_17.904803	1783	1863	2	34	80	0.4250000
NODE_979_length_2389_cov_17.904803	1783	1863	3	3	80	0.0375000
NODE_979_length_2389_cov_17.904803	1783	1863	4	43	80	0.5375000
NODE_988_length_2381_cov_32.280894	398	478	0	3	80	0.0375000
NODE_988_length_2381_cov_32.280894	398	478	4	77	80	0.9625000
NODE_988_length_2381_cov_32.280894	451	531	0	56	80	0.7000000
NODE_988_length_2381_cov_32.280894	451	531	4	24	80	0.3000000
NODE_988_length_2381_cov_32.280894	527	607	0	30	80	0.3750000
NODE_988_length_2381_cov_32.280894	527	607	1	1	80	0.0125000
NODE_988_length_2381_cov_32.280894	527	607	2	49	80	0.6125000
NODE_988_length_2381_cov_32.280894	580	660	0	24	80	0.3000000
NODE_988_length_2381_cov_32.280894	580	660	2	56	80	0.7000000
NODE_988_length_2381_cov_32.280894	2288	2368	0	80	80	1.0000000
NODE_997_length_2369_cov_4.896916	241	321	5	4	80	0.0500000
NODE_997_length_2369_cov_4.896916	241	321	6	76	80	0.9500000
NODE_997_length_2369_cov_4.896916	294	374	0	47	80	0.5875000
NODE_997_length_2369_cov_4.896916	294	374	5	10	80	0.1250000
NODE_997_length_2369_cov_4.896916	294	374	6	23	80	0.2875000
NODE_1002_length_2364_cov_2.482561	0	79	0	79	79	1.0000000
NODE_1004_length_2360_cov_8.620080	587	651	37	26	64	0.4062500
NODE_1004_length_2360_cov_8.620080	587	651	38	15	64	0.2343750
NODE_1004_length_2360_cov_8.620080	587	651	39	4	64	0.0625000
NODE_1004_length_2360_cov_8.620080	587	651	40	3	64	0.0468750
NODE_1004_length_2360_cov_8.620080	587	651	41	10	64	0.1562500
NODE_1004_length_2360_cov_8.620080	587	651	42	2	64	0.0312500
NODE_1004_length_2360_cov_8.620080	587	651	44	4	64	0.0625000
NODE_1004_length_2360_cov_8.620080	587	651	37	26	64	0.4062500
NODE_1004_length_2360_cov_8.620080	587	651	38	15	64	0.2343750
NODE_1004_length_2360_cov_8.620080	587	651	39	4	64	0.0625000
NODE_1004_length_2360_cov_8.620080	587	651	40	3	64	0.0468750
NODE_1004_length_2360_cov_8.620080	587	651	41	10	64	0.1562500
NODE_1004_length_2360_cov_8.620080	587	651	42	2	64	0.0312500
NODE_1004_length_2360_cov_8.620080	587	651	44	4	64	0.0625000
NODE_1004_length_2360_cov_8.620080	624	684	28	7	60	0.1166667
NODE_1004_length_2360_cov_8.620080	624	684	30	1	60	0.0166667
NODE_1004_length_2360_cov_8.620080	624	684	32	7	60	0.1166667
NODE_1004_length_2360_cov_8.620080	624	684	37	1	60	0.0166667
NODE_1004_length_2360_cov_8.620080	624	684	38	17	60	0.2833333
NODE_1004_length_2360_cov_8.620080	624	684	39	9	60	0.1500000
NODE_1004_length_2360_cov_8.620080	624	684	40	4	60	0.0666667
NODE_1004_length_2360_cov_8.620080	624	684	41	4	60	0.0666667
NODE_1004_length_2360_cov_8.620080	624	684	42	6	60	0.1000000
NODE_1004_length_2360_cov_8.620080	624	684	44	4	60	0.0666667
NODE_1004_length_2360_cov_8.620080	1827	1907	0	80	80	1.0000000
NODE_1004_length_2360_cov_8.620080	1880	1960	0	80	80	1.0000000
NODE_1005_length_2359_cov_22.317257	958	1038	0	26	80	0.3250000
NODE_1005_length_2359_cov_22.317257	958	1038	8	54	80	0.6750000
NODE_1005_length_2359_cov_22.317257	1011	1091	8	80	80	1.0000000
NODE_1008_length_2357_cov_25.711249	716	796	6	59	80	0.7375000
NODE_1008_length_2357_cov_25.711249	716	796	8	4	80	0.0500000
NODE_1008_length_2357_cov_25.711249	716	796	10	17	80	0.2125000
NODE_1008_length_2357_cov_25.711249	769	849	6	10	80	0.1250000
NODE_1008_length_2357_cov_25.711249	769	849	7	12	80	0.1500000
NODE_1008_length_2357_cov_25.711249	769	849	10	58	80	0.7250000
NODE_1015_length_2345_cov_5.386465	1845	1925	0	80	80	1.0000000
NODE_1015_length_2345_cov_5.386465	1898	1978	0	80	80	1.0000000
NODE_1016_length_2344_cov_6.236526	1208	1269	8	22	61	0.3606557
NODE_1016_length_2344_cov_6.236526	1208	1269	10	39	61	0.6393443
NODE_1016_length_2344_cov_6.236526	1208	1269	8	22	61	0.3606557
NODE_1016_length_2344_cov_6.236526	1208	1269	10	39	61	0.6393443
NODE_1016_length_2344_cov_6.236526	1208	1269	8	22	61	0.3606557
NODE_1016_length_2344_cov_6.236526	1208	1269	10	39	61	0.6393443
NODE_1016_length_2344_cov_6.236526	1208	1267	8	22	59	0.3728814
NODE_1016_length_2344_cov_6.236526	1208	1267	10	37	59	0.6271186
NODE_1023_length_2332_cov_4.725929	34	101	26	2	67	0.0298507
NODE_1023_length_2332_cov_4.725929	34	101	28	3	67	0.0447761
NODE_1023_length_2332_cov_4.725929	34	101	30	60	67	0.8955224
NODE_1023_length_2332_cov_4.725929	34	101	36	2	67	0.0298507
NODE_1027_length_2327_cov_18.210952	2213	2293	0	29	80	0.3625000
NODE_1027_length_2327_cov_18.210952	2213	2293	4	17	80	0.2125000
NODE_1027_length_2327_cov_18.210952	2213	2293	6	34	80	0.4250000
NODE_1027_length_2327_cov_18.210952	2266	2327	0	61	61	1.0000000
NODE_1028_length_2326_cov_15.583745	1709	1789	0	31	80	0.3875000
NODE_1028_length_2326_cov_15.583745	1709	1789	6	16	80	0.2000000
NODE_1028_length_2326_cov_15.583745	1709	1789	15	1	80	0.0125000
NODE_1028_length_2326_cov_15.583745	1709	1789	16	21	80	0.2625000
NODE_1028_length_2326_cov_15.583745	1709	1789	22	7	80	0.0875000
NODE_1028_length_2326_cov_15.583745	1709	1789	24	4	80	0.0500000
NODE_1028_length_2326_cov_15.583745	1762	1842	16	16	80	0.2000000
NODE_1028_length_2326_cov_15.583745	1762	1842	22	7	80	0.0875000
NODE_1028_length_2326_cov_15.583745	1762	1842	24	57	80	0.7125000
NODE_1030_length_2325_cov_14.998652	553	633	0	80	80	1.0000000
NODE_1030_length_2325_cov_14.998652	606	686	0	80	80	1.0000000
NODE_1034_length_2317_cov_11.956718	920	1000	0	80	80	1.0000000
NODE_1034_length_2317_cov_11.956718	973	1053	0	80	80	1.0000000
NODE_1034_length_2317_cov_11.956718	1049	1129	0	35	80	0.4375000
NODE_1034_length_2317_cov_11.956718	1049	1129	4	7	80	0.0875000
NODE_1034_length_2317_cov_11.956718	1049	1129	8	20	80	0.2500000
NODE_1034_length_2317_cov_11.956718	1049	1129	12	18	80	0.2250000
NODE_1034_length_2317_cov_11.956718	1102	1184	8	13	82	0.1585366
NODE_1034_length_2317_cov_11.956718	1102	1184	12	69	82	0.8414634
NODE_1037_length_2316_cov_8.556608	168	247	146	1	79	0.0126582
NODE_1037_length_2316_cov_8.556608	168	247	148	2	79	0.0253165
NODE_1037_length_2316_cov_8.556608	168	247	150	1	79	0.0126582
NODE_1037_length_2316_cov_8.556608	168	247	153	1	79	0.0126582
NODE_1037_length_2316_cov_8.556608	168	247	157	1	79	0.0126582
NODE_1037_length_2316_cov_8.556608	168	247	159	1	79	0.0126582
NODE_1037_length_2316_cov_8.556608	168	247	161	1	79	0.0126582
NODE_1037_length_2316_cov_8.556608	168	247	166	1	79	0.0126582
NODE_1037_length_2316_cov_8.556608	168	247	178	1	79	0.0126582
NODE_1037_length_2316_cov_8.556608	168	247	180	1	79	0.0126582
NODE_1037_length_2316_cov_8.556608	168	247	181	1	79	0.0126582
NODE_1037_length_2316_cov_8.556608	168	247	183	1	79	0.0126582
NODE_1037_length_2316_cov_8.556608	168	247	197	1	79	0.0126582
NODE_1037_length_2316_cov_8.556608	168	247	201	1	79	0.0126582
NODE_1037_length_2316_cov_8.556608	168	247	203	1	79	0.0126582
NODE_1037_length_2316_cov_8.556608	168	247	207	1	79	0.0126582
NODE_1037_length_2316_cov_8.556608	168	247	218	2	79	0.0253165
NODE_1037_length_2316_cov_8.556608	168	247	220	1	79	0.0126582
NODE_1037_length_2316_cov_8.556608	168	247	227	1	79	0.0126582
NODE_1037_length_2316_cov_8.556608	168	247	228	1	79	0.0126582
NODE_1037_length_2316_cov_8.556608	168	247	233	6	79	0.0759494
NODE_1037_length_2316_cov_8.556608	168	247	234	1	79	0.0126582
NODE_1037_length_2316_cov_8.556608	168	247	237	3	79	0.0379747
NODE_1037_length_2316_cov_8.556608	168	247	239	1	79	0.0126582
NODE_1037_length_2316_cov_8.556608	168	247	246	2	79	0.0253165
NODE_1037_length_2316_cov_8.556608	168	247	247	3	79	0.0379747
NODE_1037_length_2316_cov_8.556608	168	247	248	4	79	0.0506329
NODE_1037_length_2316_cov_8.556608	168	247	249	2	79	0.0253165
NODE_1037_length_2316_cov_8.556608	168	247	250	5	79	0.0632911
NODE_1037_length_2316_cov_8.556608	168	247	251	2	79	0.0253165
NODE_1037_length_2316_cov_8.556608	168	247	252	6	79	0.0759494
NODE_1037_length_2316_cov_8.556608	168	247	254	1	79	0.0126582
NODE_1037_length_2316_cov_8.556608	168	247	256	1	79	0.0126582
NODE_1037_length_2316_cov_8.556608	168	247	258	1	79	0.0126582
NODE_1037_length_2316_cov_8.556608	168	247	259	7	79	0.0886076
NODE_1037_length_2316_cov_8.556608	168	247	260	1	79	0.0126582
NODE_1037_length_2316_cov_8.556608	168	247	261	2	79	0.0253165
NODE_1037_length_2316_cov_8.556608	168	247	269	1	79	0.0126582
NODE_1037_length_2316_cov_8.556608	168	247	270	1	79	0.0126582
NODE_1037_length_2316_cov_8.556608	168	247	271	3	79	0.0379747
NODE_1037_length_2316_cov_8.556608	168	247	272	1	79	0.0126582
NODE_1037_length_2316_cov_8.556608	168	247	273	3	79	0.0379747
NODE_1037_length_2316_cov_8.556608	1117	1198	46	1	81	0.0123457
NODE_1037_length_2316_cov_8.556608	1117	1198	47	2	81	0.0246914
NODE_1037_length_2316_cov_8.556608	1117	1198	49	1	81	0.0123457
NODE_1037_length_2316_cov_8.556608	1117	1198	51	4	81	0.0493827
NODE_1037_length_2316_cov_8.556608	1117	1198	52	1	81	0.0123457
NODE_1037_length_2316_cov_8.556608	1117	1198	53	8	81	0.0987654
NODE_1037_length_2316_cov_8.556608	1117	1198	54	1	81	0.0123457
NODE_1037_length_2316_cov_8.556608	1117	1198	55	10	81	0.1234568
NODE_1037_length_2316_cov_8.556608	1117	1198	56	6	81	0.0740741
NODE_1037_length_2316_cov_8.556608	1117	1198	57	9	81	0.1111111
NODE_1037_length_2316_cov_8.556608	1117	1198	58	2	81	0.0246914
NODE_1037_length_2316_cov_8.556608	1117	1198	59	2	81	0.0246914
NODE_1037_length_2316_cov_8.556608	1117	1198	61	2	81	0.0246914
NODE_1037_length_2316_cov_8.556608	1117	1198	63	2	81	0.0246914
NODE_1037_length_2316_cov_8.556608	1117	1198	64	16	81	0.1975309
NODE_1037_length_2316_cov_8.556608	1117	1198	65	2	81	0.0246914
NODE_1037_length_2316_cov_8.556608	1117	1198	67	3	81	0.0370370
NODE_1037_length_2316_cov_8.556608	1117	1198	68	9	81	0.1111111
NODE_1037_length_2316_cov_8.556608	1369	1412	190	4	43	0.0930233
NODE_1037_length_2316_cov_8.556608	1369	1412	191	1	43	0.0232558
NODE_1037_length_2316_cov_8.556608	1369	1412	192	1	43	0.0232558
NODE_1037_length_2316_cov_8.556608	1369	1412	193	3	43	0.0697674
NODE_1037_length_2316_cov_8.556608	1369	1412	197	1	43	0.0232558
NODE_1037_length_2316_cov_8.556608	1369	1412	201	1	43	0.0232558
NODE_1037_length_2316_cov_8.556608	1369	1412	206	1	43	0.0232558
NODE_1037_length_2316_cov_8.556608	1369	1412	210	1	43	0.0232558
NODE_1037_length_2316_cov_8.556608	1369	1412	214	1	43	0.0232558
NODE_1037_length_2316_cov_8.556608	1369	1412	219	2	43	0.0465116
NODE_1037_length_2316_cov_8.556608	1369	1412	222	2	43	0.0465116
NODE_1037_length_2316_cov_8.556608	1369	1412	224	1	43	0.0232558
NODE_1037_length_2316_cov_8.556608	1369	1412	227	1	43	0.0232558
NODE_1037_length_2316_cov_8.556608	1369	1412	237	1	43	0.0232558
NODE_1037_length_2316_cov_8.556608	1369	1412	239	2	43	0.0465116
NODE_1037_length_2316_cov_8.556608	1369	1412	240	1	43	0.0232558
NODE_1037_length_2316_cov_8.556608	1369	1412	243	3	43	0.0697674
NODE_1037_length_2316_cov_8.556608	1369	1412	245	2	43	0.0465116
NODE_1037_length_2316_cov_8.556608	1369	1412	247	2	43	0.0465116
NODE_1037_length_2316_cov_8.556608	1369	1412	248	1	43	0.0232558
NODE_1037_length_2316_cov_8.556608	1369	1412	250	1	43	0.0232558
NODE_1037_length_2316_cov_8.556608	1369	1412	251	2	43	0.0465116
NODE_1037_length_2316_cov_8.556608	1369	1412	252	1	43	0.0232558
NODE_1037_length_2316_cov_8.556608	1369	1412	255	1	43	0.0232558
NODE_1037_length_2316_cov_8.556608	1369	1412	258	1	43	0.0232558
NODE_1037_length_2316_cov_8.556608	1369	1412	265	2	43	0.0465116
NODE_1037_length_2316_cov_8.556608	1369	1412	267	1	43	0.0232558
NODE_1037_length_2316_cov_8.556608	1369	1412	269	1	43	0.0232558
NODE_1037_length_2316_cov_8.556608	1369	1412	270	1	43	0.0232558
NODE_1040_length_2311_cov_2.821881	2121	2201	0	80	80	1.0000000
NODE_1040_length_2311_cov_2.821881	2174	2225	0	51	51	1.0000000
NODE_1044_length_2306_cov_17.347984	995	1075	10	80	80	1.0000000
NODE_1044_length_2306_cov_17.347984	1048	1128	0	20	80	0.2500000
NODE_1044_length_2306_cov_17.347984	1048	1128	10	60	80	0.7500000
NODE_1052_length_2300_cov_9.803271	934	1014	0	8	80	0.1000000
NODE_1052_length_2300_cov_9.803271	934	1014	2	72	80	0.9000000
NODE_1052_length_2300_cov_9.803271	1892	1965	0	73	73	1.0000000
NODE_1059_length_2289_cov_17.807306	968	1026	119	2	58	0.0344828
NODE_1059_length_2289_cov_17.807306	968	1026	120	2	58	0.0344828
NODE_1059_length_2289_cov_17.807306	968	1026	122	1	58	0.0172414
NODE_1059_length_2289_cov_17.807306	968	1026	123	4	58	0.0689655
NODE_1059_length_2289_cov_17.807306	968	1026	124	6	58	0.1034483
NODE_1059_length_2289_cov_17.807306	968	1026	125	2	58	0.0344828
NODE_1059_length_2289_cov_17.807306	968	1026	126	6	58	0.1034483
NODE_1059_length_2289_cov_17.807306	968	1026	127	1	58	0.0172414
NODE_1059_length_2289_cov_17.807306	968	1026	128	11	58	0.1896552
NODE_1059_length_2289_cov_17.807306	968	1026	129	4	58	0.0689655
NODE_1059_length_2289_cov_17.807306	968	1026	130	5	58	0.0862069
NODE_1059_length_2289_cov_17.807306	968	1026	131	2	58	0.0344828
NODE_1059_length_2289_cov_17.807306	968	1026	132	2	58	0.0344828
NODE_1059_length_2289_cov_17.807306	968	1026	133	4	58	0.0689655
NODE_1059_length_2289_cov_17.807306	968	1026	136	2	58	0.0344828
NODE_1059_length_2289_cov_17.807306	968	1026	137	1	58	0.0172414
NODE_1059_length_2289_cov_17.807306	968	1026	138	3	58	0.0517241
NODE_1059_length_2289_cov_17.807306	1021	1079	95	1	58	0.0172414
NODE_1059_length_2289_cov_17.807306	1021	1079	97	4	58	0.0689655
NODE_1059_length_2289_cov_17.807306	1021	1079	98	1	58	0.0172414
NODE_1059_length_2289_cov_17.807306	1021	1079	99	3	58	0.0517241
NODE_1059_length_2289_cov_17.807306	1021	1079	101	2	58	0.0344828
NODE_1059_length_2289_cov_17.807306	1021	1079	102	2	58	0.0344828
NODE_1059_length_2289_cov_17.807306	1021	1079	104	2	58	0.0344828
NODE_1059_length_2289_cov_17.807306	1021	1079	105	1	58	0.0172414
NODE_1059_length_2289_cov_17.807306	1021	1079	106	2	58	0.0344828
NODE_1059_length_2289_cov_17.807306	1021	1079	107	6	58	0.1034483
NODE_1059_length_2289_cov_17.807306	1021	1079	108	3	58	0.0517241
NODE_1059_length_2289_cov_17.807306	1021	1079	109	6	58	0.1034483
NODE_1059_length_2289_cov_17.807306	1021	1079	110	2	58	0.0344828
NODE_1059_length_2289_cov_17.807306	1021	1079	116	1	58	0.0172414
NODE_1059_length_2289_cov_17.807306	1021	1079	118	1	58	0.0172414
NODE_1059_length_2289_cov_17.807306	1021	1079	122	3	58	0.0517241
NODE_1059_length_2289_cov_17.807306	1021	1079	123	2	58	0.0344828
NODE_1059_length_2289_cov_17.807306	1021	1079	124	2	58	0.0344828
NODE_1059_length_2289_cov_17.807306	1021	1079	125	7	58	0.1206897
NODE_1059_length_2289_cov_17.807306	1021	1079	126	3	58	0.0517241
NODE_1059_length_2289_cov_17.807306	1021	1079	128	1	58	0.0172414
NODE_1059_length_2289_cov_17.807306	1021	1079	131	2	58	0.0344828
NODE_1059_length_2289_cov_17.807306	1021	1079	133	1	58	0.0172414
NODE_1060_length_2289_cov_7.736986	2161	2218	197	1	57	0.0175439
NODE_1060_length_2289_cov_7.736986	2161	2218	226	1	57	0.0175439
NODE_1060_length_2289_cov_7.736986	2161	2218	229	1	57	0.0175439
NODE_1060_length_2289_cov_7.736986	2161	2218	233	1	57	0.0175439
NODE_1060_length_2289_cov_7.736986	2161	2218	239	1	57	0.0175439
NODE_1060_length_2289_cov_7.736986	2161	2218	247	1	57	0.0175439
NODE_1060_length_2289_cov_7.736986	2161	2218	263	3	57	0.0526316
NODE_1060_length_2289_cov_7.736986	2161	2218	270	1	57	0.0175439
NODE_1060_length_2289_cov_7.736986	2161	2218	292	1	57	0.0175439
NODE_1060_length_2289_cov_7.736986	2161	2218	295	2	57	0.0350877
NODE_1060_length_2289_cov_7.736986	2161	2218	315	1	57	0.0175439
NODE_1060_length_2289_cov_7.736986	2161	2218	317	1	57	0.0175439
NODE_1060_length_2289_cov_7.736986	2161	2218	319	3	57	0.0526316
NODE_1060_length_2289_cov_7.736986	2161	2218	335	1	57	0.0175439
NODE_1060_length_2289_cov_7.736986	2161	2218	355	1	57	0.0175439
NODE_1060_length_2289_cov_7.736986	2161	2218	367	1	57	0.0175439
NODE_1060_length_2289_cov_7.736986	2161	2218	371	1	57	0.0175439
NODE_1060_length_2289_cov_7.736986	2161	2218	373	1	57	0.0175439
NODE_1060_length_2289_cov_7.736986	2161	2218	377	2	57	0.0350877
NODE_1060_length_2289_cov_7.736986	2161	2218	389	1	57	0.0175439
NODE_1060_length_2289_cov_7.736986	2161	2218	390	31	57	0.5438597
NODE_1060_length_2289_cov_7.736986	2191	2271	259	1	80	0.0125000
NODE_1060_length_2289_cov_7.736986	2191	2271	267	1	80	0.0125000
NODE_1060_length_2289_cov_7.736986	2191	2271	271	1	80	0.0125000
NODE_1060_length_2289_cov_7.736986	2191	2271	285	1	80	0.0125000
NODE_1060_length_2289_cov_7.736986	2191	2271	286	1	80	0.0125000
NODE_1060_length_2289_cov_7.736986	2191	2271	307	1	80	0.0125000
NODE_1060_length_2289_cov_7.736986	2191	2271	311	1	80	0.0125000
NODE_1060_length_2289_cov_7.736986	2191	2271	315	1	80	0.0125000
NODE_1060_length_2289_cov_7.736986	2191	2271	327	1	80	0.0125000
NODE_1060_length_2289_cov_7.736986	2191	2271	343	1	80	0.0125000
NODE_1060_length_2289_cov_7.736986	2191	2271	359	2	80	0.0250000
NODE_1060_length_2289_cov_7.736986	2191	2271	363	2	80	0.0250000
NODE_1060_length_2289_cov_7.736986	2191	2271	377	1	80	0.0125000
NODE_1060_length_2289_cov_7.736986	2191	2271	383	4	80	0.0500000
NODE_1060_length_2289_cov_7.736986	2191	2271	387	4	80	0.0500000
NODE_1060_length_2289_cov_7.736986	2191	2271	388	22	80	0.2750000
NODE_1060_length_2289_cov_7.736986	2191	2271	390	35	80	0.4375000
NODE_1061_length_2288_cov_8.539973	340	420	0	53	80	0.6625000
NODE_1061_length_2288_cov_8.539973	340	420	2	3	80	0.0375000
NODE_1061_length_2288_cov_8.539973	340	420	4	3	80	0.0375000
NODE_1061_length_2288_cov_8.539973	340	420	6	1	80	0.0125000
NODE_1061_length_2288_cov_8.539973	340	420	8	13	80	0.1625000
NODE_1061_length_2288_cov_8.539973	340	420	10	1	80	0.0125000
NODE_1061_length_2288_cov_8.539973	340	420	11	2	80	0.0250000
NODE_1061_length_2288_cov_8.539973	340	420	12	4	80	0.0500000
NODE_1061_length_2288_cov_8.539973	393	473	0	77	80	0.9625000
NODE_1061_length_2288_cov_8.539973	393	473	4	3	80	0.0375000
NODE_1065_length_2278_cov_19.655805	450	530	0	14	80	0.1750000
NODE_1065_length_2278_cov_19.655805	450	530	2	66	80	0.8250000
NODE_1065_length_2278_cov_19.655805	503	583	0	24	80	0.3000000
NODE_1065_length_2278_cov_19.655805	503	583	2	56	80	0.7000000
NODE_1065_length_2278_cov_19.655805	579	659	2	24	80	0.3000000
NODE_1065_length_2278_cov_19.655805	579	659	4	56	80	0.7000000
NODE_1065_length_2278_cov_19.655805	632	712	0	18	80	0.2250000
NODE_1065_length_2278_cov_19.655805	632	712	2	6	80	0.0750000
NODE_1065_length_2278_cov_19.655805	632	712	4	56	80	0.7000000
NODE_1071_length_2272_cov_26.123792	226	306	0	80	80	1.0000000
NODE_1071_length_2272_cov_26.123792	279	359	0	80	80	1.0000000
NODE_1071_length_2272_cov_26.123792	1684	1731	33	1	47	0.0212766
NODE_1071_length_2272_cov_26.123792	1684	1731	39	1	47	0.0212766
NODE_1071_length_2272_cov_26.123792	1684	1731	53	1	47	0.0212766
NODE_1071_length_2272_cov_26.123792	1684	1731	94	1	47	0.0212766
NODE_1071_length_2272_cov_26.123792	1684	1731	117	1	47	0.0212766
NODE_1071_length_2272_cov_26.123792	1684	1731	127	1	47	0.0212766
NODE_1071_length_2272_cov_26.123792	1684	1731	136	1	47	0.0212766
NODE_1071_length_2272_cov_26.123792	1684	1731	144	1	47	0.0212766
NODE_1071_length_2272_cov_26.123792	1684	1731	148	1	47	0.0212766
NODE_1071_length_2272_cov_26.123792	1684	1731	154	1	47	0.0212766
NODE_1071_length_2272_cov_26.123792	1684	1731	156	1	47	0.0212766
NODE_1071_length_2272_cov_26.123792	1684	1731	167	1	47	0.0212766
NODE_1071_length_2272_cov_26.123792	1684	1731	170	1	47	0.0212766
NODE_1071_length_2272_cov_26.123792	1684	1731	172	1	47	0.0212766
NODE_1071_length_2272_cov_26.123792	1684	1731	173	1	47	0.0212766
NODE_1071_length_2272_cov_26.123792	1684	1731	180	1	47	0.0212766
NODE_1071_length_2272_cov_26.123792	1684	1731	184	1	47	0.0212766
NODE_1071_length_2272_cov_26.123792	1684	1731	189	1	47	0.0212766
NODE_1071_length_2272_cov_26.123792	1684	1731	196	1	47	0.0212766
NODE_1071_length_2272_cov_26.123792	1684	1731	200	1	47	0.0212766
NODE_1071_length_2272_cov_26.123792	1684	1731	206	1	47	0.0212766
NODE_1071_length_2272_cov_26.123792	1684	1731	218	1	47	0.0212766
NODE_1071_length_2272_cov_26.123792	1684	1731	230	1	47	0.0212766
NODE_1071_length_2272_cov_26.123792	1684	1731	239	1	47	0.0212766
NODE_1071_length_2272_cov_26.123792	1684	1731	240	1	47	0.0212766
NODE_1071_length_2272_cov_26.123792	1684	1731	244	1	47	0.0212766
NODE_1071_length_2272_cov_26.123792	1684	1731	253	1	47	0.0212766
NODE_1071_length_2272_cov_26.123792	1684	1731	260	1	47	0.0212766
NODE_1071_length_2272_cov_26.123792	1684	1731	261	1	47	0.0212766
NODE_1071_length_2272_cov_26.123792	1684	1731	267	1	47	0.0212766
NODE_1071_length_2272_cov_26.123792	1684	1731	282	1	47	0.0212766
NODE_1071_length_2272_cov_26.123792	1684	1731	287	1	47	0.0212766
NODE_1071_length_2272_cov_26.123792	1684	1731	290	1	47	0.0212766
NODE_1071_length_2272_cov_26.123792	1684	1731	299	1	47	0.0212766
NODE_1071_length_2272_cov_26.123792	1684	1731	305	1	47	0.0212766
NODE_1071_length_2272_cov_26.123792	1684	1731	320	2	47	0.0425532
NODE_1071_length_2272_cov_26.123792	1684	1731	326	1	47	0.0212766
NODE_1071_length_2272_cov_26.123792	1684	1731	331	1	47	0.0212766
NODE_1071_length_2272_cov_26.123792	1684	1731	348	1	47	0.0212766
NODE_1071_length_2272_cov_26.123792	1684	1731	350	1	47	0.0212766
NODE_1071_length_2272_cov_26.123792	1684	1731	361	1	47	0.0212766
NODE_1071_length_2272_cov_26.123792	1684	1731	365	1	47	0.0212766
NODE_1071_length_2272_cov_26.123792	1684	1731	388	1	47	0.0212766
NODE_1071_length_2272_cov_26.123792	1684	1731	400	1	47	0.0212766
NODE_1071_length_2272_cov_26.123792	1684	1731	415	2	47	0.0425532
NODE_1071_length_2272_cov_26.123792	1694	1725	136	1	31	0.0322581
NODE_1071_length_2272_cov_26.123792	1694	1725	144	1	31	0.0322581
NODE_1071_length_2272_cov_26.123792	1694	1725	148	1	31	0.0322581
NODE_1071_length_2272_cov_26.123792	1694	1725	154	1	31	0.0322581
NODE_1071_length_2272_cov_26.123792	1694	1725	156	1	31	0.0322581
NODE_1071_length_2272_cov_26.123792	1694	1725	167	1	31	0.0322581
NODE_1071_length_2272_cov_26.123792	1694	1725	170	1	31	0.0322581
NODE_1071_length_2272_cov_26.123792	1694	1725	172	1	31	0.0322581
NODE_1071_length_2272_cov_26.123792	1694	1725	173	1	31	0.0322581
NODE_1071_length_2272_cov_26.123792	1694	1725	180	1	31	0.0322581
NODE_1071_length_2272_cov_26.123792	1694	1725	184	1	31	0.0322581
NODE_1071_length_2272_cov_26.123792	1694	1725	189	1	31	0.0322581
NODE_1071_length_2272_cov_26.123792	1694	1725	196	1	31	0.0322581
NODE_1071_length_2272_cov_26.123792	1694	1725	200	1	31	0.0322581
NODE_1071_length_2272_cov_26.123792	1694	1725	206	1	31	0.0322581
NODE_1071_length_2272_cov_26.123792	1694	1725	218	1	31	0.0322581
NODE_1071_length_2272_cov_26.123792	1694	1725	230	1	31	0.0322581
NODE_1071_length_2272_cov_26.123792	1694	1725	239	1	31	0.0322581
NODE_1071_length_2272_cov_26.123792	1694	1725	240	1	31	0.0322581
NODE_1071_length_2272_cov_26.123792	1694	1725	244	1	31	0.0322581
NODE_1071_length_2272_cov_26.123792	1694	1725	253	1	31	0.0322581
NODE_1071_length_2272_cov_26.123792	1694	1725	260	1	31	0.0322581
NODE_1071_length_2272_cov_26.123792	1694	1725	261	1	31	0.0322581
NODE_1071_length_2272_cov_26.123792	1694	1725	267	1	31	0.0322581
NODE_1071_length_2272_cov_26.123792	1694	1725	282	1	31	0.0322581
NODE_1071_length_2272_cov_26.123792	1694	1725	287	1	31	0.0322581
NODE_1071_length_2272_cov_26.123792	1694	1725	290	1	31	0.0322581
NODE_1071_length_2272_cov_26.123792	1694	1725	299	1	31	0.0322581
NODE_1071_length_2272_cov_26.123792	1694	1725	305	1	31	0.0322581
NODE_1071_length_2272_cov_26.123792	1694	1725	320	2	31	0.0645161
NODE_1071_length_2272_cov_26.123792	1759	1833	0	26	74	0.3513514
NODE_1071_length_2272_cov_26.123792	1759	1833	2	23	74	0.3108108
NODE_1071_length_2272_cov_26.123792	1759	1833	3	25	74	0.3378378
NODE_1071_length_2272_cov_26.123792	1812	1892	0	80	80	1.0000000
NODE_1072_length_2272_cov_8.175334	213	293	136	1	80	0.0125000
NODE_1072_length_2272_cov_8.175334	213	293	137	3	80	0.0375000
NODE_1072_length_2272_cov_8.175334	213	293	139	6	80	0.0750000
NODE_1072_length_2272_cov_8.175334	213	293	141	6	80	0.0750000
NODE_1072_length_2272_cov_8.175334	213	293	143	1	80	0.0125000
NODE_1072_length_2272_cov_8.175334	213	293	145	1	80	0.0125000
NODE_1072_length_2272_cov_8.175334	213	293	149	2	80	0.0250000
NODE_1072_length_2272_cov_8.175334	213	293	150	1	80	0.0125000
NODE_1072_length_2272_cov_8.175334	213	293	151	1	80	0.0125000
NODE_1072_length_2272_cov_8.175334	213	293	152	1	80	0.0125000
NODE_1072_length_2272_cov_8.175334	213	293	155	1	80	0.0125000
NODE_1072_length_2272_cov_8.175334	213	293	156	2	80	0.0250000
NODE_1072_length_2272_cov_8.175334	213	293	157	1	80	0.0125000
NODE_1072_length_2272_cov_8.175334	213	293	158	2	80	0.0250000
NODE_1072_length_2272_cov_8.175334	213	293	164	3	80	0.0375000
NODE_1072_length_2272_cov_8.175334	213	293	165	3	80	0.0375000
NODE_1072_length_2272_cov_8.175334	213	293	168	2	80	0.0250000
NODE_1072_length_2272_cov_8.175334	213	293	169	3	80	0.0375000
NODE_1072_length_2272_cov_8.175334	213	293	170	1	80	0.0125000
NODE_1072_length_2272_cov_8.175334	213	293	172	2	80	0.0250000
NODE_1072_length_2272_cov_8.175334	213	293	175	1	80	0.0125000
NODE_1072_length_2272_cov_8.175334	213	293	176	2	80	0.0250000
NODE_1072_length_2272_cov_8.175334	213	293	177	2	80	0.0250000
NODE_1072_length_2272_cov_8.175334	213	293	178	2	80	0.0250000
NODE_1072_length_2272_cov_8.175334	213	293	179	2	80	0.0250000
NODE_1072_length_2272_cov_8.175334	213	293	180	6	80	0.0750000
NODE_1072_length_2272_cov_8.175334	213	293	181	1	80	0.0125000
NODE_1072_length_2272_cov_8.175334	213	293	182	9	80	0.1125000
NODE_1072_length_2272_cov_8.175334	213	293	183	7	80	0.0875000
NODE_1072_length_2272_cov_8.175334	213	293	185	5	80	0.0625000
NODE_1072_length_2272_cov_8.175334	266	346	11	1	80	0.0125000
NODE_1072_length_2272_cov_8.175334	266	346	22	1	80	0.0125000
NODE_1072_length_2272_cov_8.175334	266	346	48	1	80	0.0125000
NODE_1072_length_2272_cov_8.175334	266	346	50	1	80	0.0125000
NODE_1072_length_2272_cov_8.175334	266	346	54	3	80	0.0375000
NODE_1072_length_2272_cov_8.175334	266	346	62	2	80	0.0250000
NODE_1072_length_2272_cov_8.175334	266	346	63	1	80	0.0125000
NODE_1072_length_2272_cov_8.175334	266	346	68	1	80	0.0125000
NODE_1072_length_2272_cov_8.175334	266	346	70	2	80	0.0250000
NODE_1072_length_2272_cov_8.175334	266	346	71	2	80	0.0250000
NODE_1072_length_2272_cov_8.175334	266	346	75	3	80	0.0375000
NODE_1072_length_2272_cov_8.175334	266	346	77	1	80	0.0125000
NODE_1072_length_2272_cov_8.175334	266	346	79	1	80	0.0125000
NODE_1072_length_2272_cov_8.175334	266	346	80	3	80	0.0375000
NODE_1072_length_2272_cov_8.175334	266	346	82	1	80	0.0125000
NODE_1072_length_2272_cov_8.175334	266	346	84	1	80	0.0125000
NODE_1072_length_2272_cov_8.175334	266	346	88	1	80	0.0125000
NODE_1072_length_2272_cov_8.175334	266	346	90	2	80	0.0250000
NODE_1072_length_2272_cov_8.175334	266	346	94	1	80	0.0125000
NODE_1072_length_2272_cov_8.175334	266	346	96	1	80	0.0125000
NODE_1072_length_2272_cov_8.175334	266	346	98	1	80	0.0125000
NODE_1072_length_2272_cov_8.175334	266	346	102	1	80	0.0125000
NODE_1072_length_2272_cov_8.175334	266	346	114	1	80	0.0125000
NODE_1072_length_2272_cov_8.175334	266	346	117	1	80	0.0125000
NODE_1072_length_2272_cov_8.175334	266	346	123	2	80	0.0250000
NODE_1072_length_2272_cov_8.175334	266	346	125	1	80	0.0125000
NODE_1072_length_2272_cov_8.175334	266	346	127	4	80	0.0500000
NODE_1072_length_2272_cov_8.175334	266	346	131	5	80	0.0625000
NODE_1072_length_2272_cov_8.175334	266	346	134	5	80	0.0625000
NODE_1072_length_2272_cov_8.175334	266	346	136	3	80	0.0375000
NODE_1072_length_2272_cov_8.175334	266	346	137	2	80	0.0250000
NODE_1072_length_2272_cov_8.175334	266	346	139	2	80	0.0250000
NODE_1072_length_2272_cov_8.175334	266	346	141	5	80	0.0625000
NODE_1072_length_2272_cov_8.175334	266	346	143	1	80	0.0125000
NODE_1072_length_2272_cov_8.175334	266	346	149	1	80	0.0125000
NODE_1072_length_2272_cov_8.175334	266	346	150	1	80	0.0125000
NODE_1072_length_2272_cov_8.175334	266	346	152	1	80	0.0125000
NODE_1072_length_2272_cov_8.175334	266	346	157	1	80	0.0125000
NODE_1072_length_2272_cov_8.175334	266	346	158	2	80	0.0250000
NODE_1072_length_2272_cov_8.175334	266	346	165	3	80	0.0375000
NODE_1072_length_2272_cov_8.175334	266	346	168	2	80	0.0250000
NODE_1072_length_2272_cov_8.175334	266	346	169	3	80	0.0375000
NODE_1072_length_2272_cov_8.175334	266	346	172	2	80	0.0250000
NODE_1077_length_2266_cov_13.206276	359	439	0	41	80	0.5125000
NODE_1077_length_2266_cov_13.206276	359	439	13	38	80	0.4750000
NODE_1077_length_2266_cov_13.206276	359	439	15	1	80	0.0125000
NODE_1077_length_2266_cov_13.206276	412	492	0	80	80	1.0000000
NODE_1077_length_2266_cov_13.206276	488	568	0	80	80	1.0000000
NODE_1077_length_2266_cov_13.206276	541	627	0	86	86	1.0000000
NODE_1078_length_2262_cov_11.759131	413	493	0	80	80	1.0000000
NODE_1078_length_2262_cov_11.759131	466	546	0	80	80	1.0000000
NODE_1079_length_2260_cov_37.814901	219	299	0	80	80	1.0000000
NODE_1079_length_2260_cov_37.814901	742	822	0	80	80	1.0000000
NODE_1079_length_2260_cov_37.814901	795	875	0	80	80	1.0000000
NODE_1079_length_2260_cov_37.814901	1533	1613	2	37	80	0.4625000
NODE_1079_length_2260_cov_37.814901	1533	1613	4	43	80	0.5375000
NODE_1079_length_2260_cov_37.814901	1586	1666	2	79	80	0.9875000
NODE_1079_length_2260_cov_37.814901	1586	1666	4	1	80	0.0125000
NODE_1079_length_2260_cov_37.814901	1662	1742	0	70	80	0.8750000
NODE_1079_length_2260_cov_37.814901	1662	1742	2	10	80	0.1250000
NODE_1079_length_2260_cov_37.814901	1715	1795	0	80	80	1.0000000
NODE_1082_length_2253_cov_8.904828	472	552	13	2	80	0.0250000
NODE_1082_length_2253_cov_8.904828	472	552	17	1	80	0.0125000
NODE_1082_length_2253_cov_8.904828	472	552	19	1	80	0.0125000
NODE_1082_length_2253_cov_8.904828	472	552	22	1	80	0.0125000
NODE_1082_length_2253_cov_8.904828	472	552	23	8	80	0.1000000
NODE_1082_length_2253_cov_8.904828	472	552	25	6	80	0.0750000
NODE_1082_length_2253_cov_8.904828	472	552	27	6	80	0.0750000
NODE_1082_length_2253_cov_8.904828	472	552	28	2	80	0.0250000
NODE_1082_length_2253_cov_8.904828	472	552	32	7	80	0.0875000
NODE_1082_length_2253_cov_8.904828	472	552	34	1	80	0.0125000
NODE_1082_length_2253_cov_8.904828	472	552	36	2	80	0.0250000
NODE_1082_length_2253_cov_8.904828	472	552	38	1	80	0.0125000
NODE_1082_length_2253_cov_8.904828	472	552	40	1	80	0.0125000
NODE_1082_length_2253_cov_8.904828	472	552	42	1	80	0.0125000
NODE_1082_length_2253_cov_8.904828	472	552	45	1	80	0.0125000
NODE_1082_length_2253_cov_8.904828	472	552	47	2	80	0.0250000
NODE_1082_length_2253_cov_8.904828	472	552	49	4	80	0.0500000
NODE_1082_length_2253_cov_8.904828	472	552	55	4	80	0.0500000
NODE_1082_length_2253_cov_8.904828	472	552	57	1	80	0.0125000
NODE_1082_length_2253_cov_8.904828	472	552	61	4	80	0.0500000
NODE_1082_length_2253_cov_8.904828	472	552	65	3	80	0.0375000
NODE_1082_length_2253_cov_8.904828	472	552	67	8	80	0.1000000
NODE_1082_length_2253_cov_8.904828	472	552	71	4	80	0.0500000
NODE_1082_length_2253_cov_8.904828	472	552	75	5	80	0.0625000
NODE_1082_length_2253_cov_8.904828	472	552	77	1	80	0.0125000
NODE_1082_length_2253_cov_8.904828	472	552	79	2	80	0.0250000
NODE_1082_length_2253_cov_8.904828	472	552	81	1	80	0.0125000
NODE_1085_length_2252_cov_2.801208	1128	1170	0	42	42	1.0000000
NODE_1085_length_2252_cov_2.801208	1137	1172	0	35	35	1.0000000
NODE_1086_length_2252_cov_2.078031	13	62	0	49	49	1.0000000
NODE_1086_length_2252_cov_2.078031	13	61	0	48	48	1.0000000
NODE_1086_length_2252_cov_2.078031	13	62	0	49	49	1.0000000
NODE_1086_length_2252_cov_2.078031	13	62	0	49	49	1.0000000
NODE_1086_length_2252_cov_2.078031	13	61	0	48	48	1.0000000
NODE_1087_length_2251_cov_15.458178	1443	1506	0	32	63	0.5079365
NODE_1087_length_2251_cov_15.458178	1443	1506	1	17	63	0.2698413
NODE_1087_length_2251_cov_15.458178	1443	1506	4	1	63	0.0158730
NODE_1087_length_2251_cov_15.458178	1443	1506	5	1	63	0.0158730
NODE_1087_length_2251_cov_15.458178	1443	1506	6	1	63	0.0158730
NODE_1087_length_2251_cov_15.458178	1443	1506	9	1	63	0.0158730
NODE_1087_length_2251_cov_15.458178	1443	1506	10	6	63	0.0952381
NODE_1087_length_2251_cov_15.458178	1443	1506	12	1	63	0.0158730
NODE_1087_length_2251_cov_15.458178	1443	1506	14	3	63	0.0476190
NODE_1087_length_2251_cov_15.458178	1496	1550	9	1	54	0.0185185
NODE_1087_length_2251_cov_15.458178	1496	1550	10	5	54	0.0925926
NODE_1087_length_2251_cov_15.458178	1496	1550	12	1	54	0.0185185
NODE_1087_length_2251_cov_15.458178	1496	1550	14	8	54	0.1481481
NODE_1087_length_2251_cov_15.458178	1496	1550	15	2	54	0.0370370
NODE_1087_length_2251_cov_15.458178	1496	1550	16	5	54	0.0925926
NODE_1087_length_2251_cov_15.458178	1496	1550	18	2	54	0.0370370
NODE_1087_length_2251_cov_15.458178	1496	1550	21	2	54	0.0370370
NODE_1087_length_2251_cov_15.458178	1496	1550	25	1	54	0.0185185
NODE_1087_length_2251_cov_15.458178	1496	1550	26	6	54	0.1111111
NODE_1087_length_2251_cov_15.458178	1496	1550	28	7	54	0.1296296
NODE_1087_length_2251_cov_15.458178	1496	1550	30	3	54	0.0555556
NODE_1087_length_2251_cov_15.458178	1496	1550	32	1	54	0.0185185
NODE_1087_length_2251_cov_15.458178	1496	1550	33	2	54	0.0370370
NODE_1087_length_2251_cov_15.458178	1496	1550	35	4	54	0.0740741
NODE_1087_length_2251_cov_15.458178	1496	1550	38	1	54	0.0185185
NODE_1087_length_2251_cov_15.458178	1496	1550	42	1	54	0.0185185
NODE_1087_length_2251_cov_15.458178	1496	1550	45	2	54	0.0370370
NODE_1089_length_2250_cov_18.370990	1658	1738	0	42	80	0.5250000
NODE_1089_length_2250_cov_18.370990	1658	1738	4	38	80	0.4750000
NODE_1089_length_2250_cov_18.370990	1711	1791	4	59	80	0.7375000
NODE_1089_length_2250_cov_18.370990	1711	1791	6	21	80	0.2625000
NODE_1090_length_2250_cov_5.331474	1844	1924	0	80	80	1.0000000
NODE_1093_length_2247_cov_7.906890	364	436	0	72	72	1.0000000
NODE_1095_length_2246_cov_7.612948	1992	2055	14	2	63	0.0317460
NODE_1095_length_2246_cov_7.612948	1992	2055	15	12	63	0.1904762
NODE_1095_length_2246_cov_7.612948	1992	2055	17	35	63	0.5555556
NODE_1095_length_2246_cov_7.612948	1992	2055	18	1	63	0.0158730
NODE_1095_length_2246_cov_7.612948	1992	2055	19	10	63	0.1587302
NODE_1095_length_2246_cov_7.612948	1992	2055	20	3	63	0.0476190
NODE_1095_length_2246_cov_7.612948	2045	2108	11	22	63	0.3492064
NODE_1095_length_2246_cov_7.612948	2045	2108	15	2	63	0.0317460
NODE_1095_length_2246_cov_7.612948	2045	2108	17	35	63	0.5555556
NODE_1095_length_2246_cov_7.612948	2045	2108	18	4	63	0.0634921
NODE_1104_length_2233_cov_35.127460	1517	1597	0	80	80	1.0000000
NODE_1104_length_2233_cov_35.127460	1570	1650	0	80	80	1.0000000
NODE_1105_length_2231_cov_45.701689	315	396	22	5	81	0.0617284
NODE_1105_length_2231_cov_45.701689	315	396	24	6	81	0.0740741
NODE_1105_length_2231_cov_45.701689	315	396	26	6	81	0.0740741
NODE_1105_length_2231_cov_45.701689	315	396	27	7	81	0.0864198
NODE_1105_length_2231_cov_45.701689	315	396	28	24	81	0.2962963
NODE_1105_length_2231_cov_45.701689	315	396	30	4	81	0.0493827
NODE_1105_length_2231_cov_45.701689	315	396	34	8	81	0.0987654
NODE_1105_length_2231_cov_45.701689	315	396	36	9	81	0.1111111
NODE_1105_length_2231_cov_45.701689	315	396	40	5	81	0.0617284
NODE_1105_length_2231_cov_45.701689	315	396	42	1	81	0.0123457
NODE_1105_length_2231_cov_45.701689	315	396	44	6	81	0.0740741
NODE_1105_length_2231_cov_45.701689	369	449	2	4	80	0.0500000
NODE_1105_length_2231_cov_45.701689	369	449	3	7	80	0.0875000
NODE_1105_length_2231_cov_45.701689	369	449	4	2	80	0.0250000
NODE_1105_length_2231_cov_45.701689	369	449	6	5	80	0.0625000
NODE_1105_length_2231_cov_45.701689	369	449	7	2	80	0.0250000
NODE_1105_length_2231_cov_45.701689	369	449	11	14	80	0.1750000
NODE_1105_length_2231_cov_45.701689	369	449	12	2	80	0.0250000
NODE_1105_length_2231_cov_45.701689	369	449	14	8	80	0.1000000
NODE_1105_length_2231_cov_45.701689	369	449	16	2	80	0.0250000
NODE_1105_length_2231_cov_45.701689	369	449	18	2	80	0.0250000
NODE_1105_length_2231_cov_45.701689	369	449	20	4	80	0.0500000
NODE_1105_length_2231_cov_45.701689	369	449	22	6	80	0.0750000
NODE_1105_length_2231_cov_45.701689	369	449	24	6	80	0.0750000
NODE_1105_length_2231_cov_45.701689	369	449	26	6	80	0.0750000
NODE_1105_length_2231_cov_45.701689	369	449	27	7	80	0.0875000
NODE_1105_length_2231_cov_45.701689	369	449	28	3	80	0.0375000
NODE_1105_length_2231_cov_45.701689	496	576	0	80	80	1.0000000
NODE_1105_length_2231_cov_45.701689	582	662	0	80	80	1.0000000
NODE_1105_length_2231_cov_45.701689	625	705	0	75	80	0.9375000
NODE_1105_length_2231_cov_45.701689	625	705	6	5	80	0.0625000
NODE_1105_length_2231_cov_45.701689	711	791	6	80	80	1.0000000
NODE_1105_length_2231_cov_45.701689	1141	1186	0	6	45	0.1333333
NODE_1105_length_2231_cov_45.701689	1141	1186	4	13	45	0.2888889
NODE_1105_length_2231_cov_45.701689	1141	1186	6	26	45	0.5777778
NODE_1105_length_2231_cov_45.701689	1787	1867	8	80	80	1.0000000
NODE_1105_length_2231_cov_45.701689	1840	1920	7	13	80	0.1625000
NODE_1105_length_2231_cov_45.701689	1840	1920	8	67	80	0.8375000
NODE_1106_length_2230_cov_12.608634	1520	1600	0	70	80	0.8750000
NODE_1106_length_2230_cov_12.608634	1520	1600	2	10	80	0.1250000
NODE_1106_length_2230_cov_12.608634	1573	1653	0	17	80	0.2125000
NODE_1106_length_2230_cov_12.608634	1573	1653	2	63	80	0.7875000
NODE_1112_length_2218_cov_5.292591	1427	1497	8	25	70	0.3571429
NODE_1112_length_2218_cov_5.292591	1427	1497	10	19	70	0.2714286
NODE_1112_length_2218_cov_5.292591	1427	1497	12	26	70	0.3714286
NODE_1112_length_2218_cov_5.292591	1470	1536	8	9	66	0.1363636
NODE_1112_length_2218_cov_5.292591	1470	1536	10	39	66	0.5909091
NODE_1112_length_2218_cov_5.292591	1470	1536	12	18	66	0.2727273
NODE_1115_length_2215_cov_51.865784	108	188	0	80	80	1.0000000
NODE_1115_length_2215_cov_51.865784	161	241	0	80	80	1.0000000
NODE_1115_length_2215_cov_51.865784	237	317	0	80	80	1.0000000
NODE_1115_length_2215_cov_51.865784	290	370	0	80	80	1.0000000
NODE_1115_length_2215_cov_51.865784	1030	1102	33	1	72	0.0138889
NODE_1115_length_2215_cov_51.865784	1030	1102	44	5	72	0.0694444
NODE_1115_length_2215_cov_51.865784	1030	1102	46	2	72	0.0277778
NODE_1115_length_2215_cov_51.865784	1030	1102	52	3	72	0.0416667
NODE_1115_length_2215_cov_51.865784	1030	1102	53	3	72	0.0416667
NODE_1115_length_2215_cov_51.865784	1030	1102	55	1	72	0.0138889
NODE_1115_length_2215_cov_51.865784	1030	1102	57	10	72	0.1388889
NODE_1115_length_2215_cov_51.865784	1030	1102	60	1	72	0.0138889
NODE_1115_length_2215_cov_51.865784	1030	1102	61	2	72	0.0277778
NODE_1115_length_2215_cov_51.865784	1030	1102	63	4	72	0.0555556
NODE_1115_length_2215_cov_51.865784	1030	1102	65	1	72	0.0138889
NODE_1115_length_2215_cov_51.865784	1030	1102	69	1	72	0.0138889
NODE_1115_length_2215_cov_51.865784	1030	1102	70	5	72	0.0694444
NODE_1115_length_2215_cov_51.865784	1030	1102	71	2	72	0.0277778
NODE_1115_length_2215_cov_51.865784	1030	1102	76	1	72	0.0138889
NODE_1115_length_2215_cov_51.865784	1030	1102	85	3	72	0.0416667
NODE_1115_length_2215_cov_51.865784	1030	1102	90	2	72	0.0277778
NODE_1115_length_2215_cov_51.865784	1030	1102	95	2	72	0.0277778
NODE_1115_length_2215_cov_51.865784	1030	1102	98	3	72	0.0416667
NODE_1115_length_2215_cov_51.865784	1030	1102	100	1	72	0.0138889
NODE_1115_length_2215_cov_51.865784	1030	1102	106	2	72	0.0277778
NODE_1115_length_2215_cov_51.865784	1030	1102	107	1	72	0.0138889
NODE_1115_length_2215_cov_51.865784	1030	1102	112	2	72	0.0277778
NODE_1115_length_2215_cov_51.865784	1030	1102	113	5	72	0.0694444
NODE_1115_length_2215_cov_51.865784	1030	1102	114	1	72	0.0138889
NODE_1115_length_2215_cov_51.865784	1030	1102	116	1	72	0.0138889
NODE_1115_length_2215_cov_51.865784	1030	1102	117	3	72	0.0416667
NODE_1115_length_2215_cov_51.865784	1030	1102	118	1	72	0.0138889
NODE_1115_length_2215_cov_51.865784	1030	1102	120	1	72	0.0138889
NODE_1115_length_2215_cov_51.865784	1030	1102	122	2	72	0.0277778
NODE_1115_length_2215_cov_51.865784	1571	1651	0	35	80	0.4375000
NODE_1115_length_2215_cov_51.865784	1571	1651	2	45	80	0.5625000
NODE_1115_length_2215_cov_51.865784	1624	1704	0	80	80	1.0000000
NODE_1117_length_2212_cov_63.988168	459	539	0	80	80	1.0000000
NODE_1117_length_2212_cov_63.988168	512	592	0	80	80	1.0000000
NODE_1117_length_2212_cov_63.988168	588	668	0	80	80	1.0000000
NODE_1117_length_2212_cov_63.988168	641	721	0	35	80	0.4375000
NODE_1117_length_2212_cov_63.988168	641	721	2	45	80	0.5625000
NODE_1119_length_2212_cov_4.632750	1479	1559	0	80	80	1.0000000
NODE_1119_length_2212_cov_4.632750	1532	1612	0	80	80	1.0000000
NODE_1122_length_2211_cov_16.247159	1808	1888	2	23	80	0.2875000
NODE_1122_length_2211_cov_16.247159	1808	1888	4	4	80	0.0500000
NODE_1122_length_2211_cov_16.247159	1808	1888	6	53	80	0.6625000
NODE_1124_length_2207_cov_46.766129	1273	1348	258	2	75	0.0266667
NODE_1124_length_2207_cov_46.766129	1273	1348	259	1	75	0.0133333
NODE_1124_length_2207_cov_46.766129	1273	1348	260	1	75	0.0133333
NODE_1124_length_2207_cov_46.766129	1273	1348	261	1	75	0.0133333
NODE_1124_length_2207_cov_46.766129	1273	1348	262	1	75	0.0133333
NODE_1124_length_2207_cov_46.766129	1273	1348	263	5	75	0.0666667
NODE_1124_length_2207_cov_46.766129	1273	1348	265	3	75	0.0400000
NODE_1124_length_2207_cov_46.766129	1273	1348	266	2	75	0.0266667
NODE_1124_length_2207_cov_46.766129	1273	1348	267	1	75	0.0133333
NODE_1124_length_2207_cov_46.766129	1273	1348	268	1	75	0.0133333
NODE_1124_length_2207_cov_46.766129	1273	1348	269	2	75	0.0266667
NODE_1124_length_2207_cov_46.766129	1273	1348	270	2	75	0.0266667
NODE_1124_length_2207_cov_46.766129	1273	1348	271	3	75	0.0400000
NODE_1124_length_2207_cov_46.766129	1273	1348	276	1	75	0.0133333
NODE_1124_length_2207_cov_46.766129	1273	1348	282	1	75	0.0133333
NODE_1124_length_2207_cov_46.766129	1273	1348	284	2	75	0.0266667
NODE_1124_length_2207_cov_46.766129	1273	1348	285	1	75	0.0133333
NODE_1124_length_2207_cov_46.766129	1273	1348	286	1	75	0.0133333
NODE_1124_length_2207_cov_46.766129	1273	1348	288	1	75	0.0133333
NODE_1124_length_2207_cov_46.766129	1273	1348	290	3	75	0.0400000
NODE_1124_length_2207_cov_46.766129	1273	1348	292	1	75	0.0133333
NODE_1124_length_2207_cov_46.766129	1273	1348	296	1	75	0.0133333
NODE_1124_length_2207_cov_46.766129	1273	1348	298	1	75	0.0133333
NODE_1124_length_2207_cov_46.766129	1273	1348	299	1	75	0.0133333
NODE_1124_length_2207_cov_46.766129	1273	1348	300	2	75	0.0266667
NODE_1124_length_2207_cov_46.766129	1273	1348	302	1	75	0.0133333
NODE_1124_length_2207_cov_46.766129	1273	1348	304	2	75	0.0266667
NODE_1124_length_2207_cov_46.766129	1273	1348	305	1	75	0.0133333
NODE_1124_length_2207_cov_46.766129	1273	1348	308	1	75	0.0133333
NODE_1124_length_2207_cov_46.766129	1273	1348	309	5	75	0.0666667
NODE_1124_length_2207_cov_46.766129	1273	1348	312	3	75	0.0400000
NODE_1124_length_2207_cov_46.766129	1273	1348	313	4	75	0.0533333
NODE_1124_length_2207_cov_46.766129	1273	1348	314	3	75	0.0400000
NODE_1124_length_2207_cov_46.766129	1273	1348	315	4	75	0.0533333
NODE_1124_length_2207_cov_46.766129	1273	1348	316	3	75	0.0400000
NODE_1124_length_2207_cov_46.766129	1273	1348	317	3	75	0.0400000
NODE_1124_length_2207_cov_46.766129	1273	1348	319	1	75	0.0133333
NODE_1124_length_2207_cov_46.766129	1273	1348	320	2	75	0.0266667
NODE_1124_length_2207_cov_46.766129	1273	1348	321	1	75	0.0133333
NODE_1124_length_2207_cov_46.766129	1324	1401	125	2	77	0.0259740
NODE_1124_length_2207_cov_46.766129	1324	1401	127	1	77	0.0129870
NODE_1124_length_2207_cov_46.766129	1324	1401	129	1	77	0.0129870
NODE_1124_length_2207_cov_46.766129	1324	1401	137	1	77	0.0129870
NODE_1124_length_2207_cov_46.766129	1324	1401	144	1	77	0.0129870
NODE_1124_length_2207_cov_46.766129	1324	1401	145	3	77	0.0389610
NODE_1124_length_2207_cov_46.766129	1324	1401	147	2	77	0.0259740
NODE_1124_length_2207_cov_46.766129	1324	1401	148	2	77	0.0259740
NODE_1124_length_2207_cov_46.766129	1324	1401	151	1	77	0.0129870
NODE_1124_length_2207_cov_46.766129	1324	1401	154	1	77	0.0129870
NODE_1124_length_2207_cov_46.766129	1324	1401	160	1	77	0.0129870
NODE_1124_length_2207_cov_46.766129	1324	1401	166	1	77	0.0129870
NODE_1124_length_2207_cov_46.766129	1324	1401	168	1	77	0.0129870
NODE_1124_length_2207_cov_46.766129	1324	1401	176	2	77	0.0259740
NODE_1124_length_2207_cov_46.766129	1324	1401	181	1	77	0.0129870
NODE_1124_length_2207_cov_46.766129	1324	1401	186	1	77	0.0129870
NODE_1124_length_2207_cov_46.766129	1324	1401	190	1	77	0.0129870
NODE_1124_length_2207_cov_46.766129	1324	1401	191	1	77	0.0129870
NODE_1124_length_2207_cov_46.766129	1324	1401	194	1	77	0.0129870
NODE_1124_length_2207_cov_46.766129	1324	1401	202	1	77	0.0129870
NODE_1124_length_2207_cov_46.766129	1324	1401	206	1	77	0.0129870
NODE_1124_length_2207_cov_46.766129	1324	1401	207	2	77	0.0259740
NODE_1124_length_2207_cov_46.766129	1324	1401	208	2	77	0.0259740
NODE_1124_length_2207_cov_46.766129	1324	1401	211	2	77	0.0259740
NODE_1124_length_2207_cov_46.766129	1324	1401	213	1	77	0.0129870
NODE_1124_length_2207_cov_46.766129	1324	1401	224	1	77	0.0129870
NODE_1124_length_2207_cov_46.766129	1324	1401	225	2	77	0.0259740
NODE_1124_length_2207_cov_46.766129	1324	1401	227	1	77	0.0129870
NODE_1124_length_2207_cov_46.766129	1324	1401	228	1	77	0.0129870
NODE_1124_length_2207_cov_46.766129	1324	1401	231	1	77	0.0129870
NODE_1124_length_2207_cov_46.766129	1324	1401	235	1	77	0.0129870
NODE_1124_length_2207_cov_46.766129	1324	1401	237	1	77	0.0129870
NODE_1124_length_2207_cov_46.766129	1324	1401	245	1	77	0.0129870
NODE_1124_length_2207_cov_46.766129	1324	1401	249	4	77	0.0519481
NODE_1124_length_2207_cov_46.766129	1324	1401	252	3	77	0.0389610
NODE_1124_length_2207_cov_46.766129	1324	1401	255	2	77	0.0259740
NODE_1124_length_2207_cov_46.766129	1324	1401	258	2	77	0.0259740
NODE_1124_length_2207_cov_46.766129	1324	1401	259	1	77	0.0129870
NODE_1124_length_2207_cov_46.766129	1324	1401	260	2	77	0.0259740
NODE_1124_length_2207_cov_46.766129	1324	1401	261	1	77	0.0129870
NODE_1124_length_2207_cov_46.766129	1324	1401	262	1	77	0.0129870
NODE_1124_length_2207_cov_46.766129	1324	1401	263	5	77	0.0649351
NODE_1124_length_2207_cov_46.766129	1324	1401	265	3	77	0.0389610
NODE_1124_length_2207_cov_46.766129	1324	1401	266	2	77	0.0259740
NODE_1124_length_2207_cov_46.766129	1324	1401	267	1	77	0.0129870
NODE_1124_length_2207_cov_46.766129	1324	1401	268	1	77	0.0129870
NODE_1124_length_2207_cov_46.766129	1324	1401	269	2	77	0.0259740
NODE_1124_length_2207_cov_46.766129	1324	1401	270	1	77	0.0129870
NODE_1124_length_2207_cov_46.766129	1324	1401	271	3	77	0.0389610
NODE_1127_length_2205_cov_12.762108	1818	1898	2	80	80	1.0000000
NODE_1127_length_2205_cov_12.762108	1871	1951	0	31	80	0.3875000
NODE_1127_length_2205_cov_12.762108	1871	1951	2	49	80	0.6125000
NODE_1127_length_2205_cov_12.762108	1872	1951	0	31	79	0.3924051
NODE_1127_length_2205_cov_12.762108	1872	1951	2	48	79	0.6075949
NODE_1127_length_2205_cov_12.762108	1947	2020	0	66	73	0.9041096
NODE_1127_length_2205_cov_12.762108	1947	2020	2	7	73	0.0958904
NODE_1128_length_2202_cov_8.687114	1848	1912	0	64	64	1.0000000
NODE_1130_length_2200_cov_10.639695	1461	1541	0	6	80	0.0750000
NODE_1130_length_2200_cov_10.639695	1461	1541	2	41	80	0.5125000
NODE_1130_length_2200_cov_10.639695	1461	1541	4	18	80	0.2250000
NODE_1130_length_2200_cov_10.639695	1461	1541	6	15	80	0.1875000
NODE_1130_length_2200_cov_10.639695	1514	1594	4	53	80	0.6625000
NODE_1130_length_2200_cov_10.639695	1514	1594	6	27	80	0.3375000
NODE_1131_length_2199_cov_10.839524	1709	1789	0	15	80	0.1875000
NODE_1131_length_2199_cov_10.839524	1709	1789	2	65	80	0.8125000
NODE_1131_length_2199_cov_10.839524	1762	1842	0	29	80	0.3625000
NODE_1131_length_2199_cov_10.839524	1762	1842	2	51	80	0.6375000
NODE_1135_length_2196_cov_64.718646	885	965	10	22	80	0.2750000
NODE_1135_length_2196_cov_64.718646	885	965	12	2	80	0.0250000
NODE_1135_length_2196_cov_64.718646	885	965	20	8	80	0.1000000
NODE_1135_length_2196_cov_64.718646	885	965	21	15	80	0.1875000
NODE_1135_length_2196_cov_64.718646	885	965	22	11	80	0.1375000
NODE_1135_length_2196_cov_64.718646	885	965	23	2	80	0.0250000
NODE_1135_length_2196_cov_64.718646	885	965	25	12	80	0.1500000
NODE_1135_length_2196_cov_64.718646	885	965	26	8	80	0.1000000
NODE_1135_length_2196_cov_64.718646	938	1018	12	18	80	0.2250000
NODE_1135_length_2196_cov_64.718646	938	1018	18	8	80	0.1000000
NODE_1135_length_2196_cov_64.718646	938	1018	21	3	80	0.0375000
NODE_1135_length_2196_cov_64.718646	938	1018	22	11	80	0.1375000
NODE_1135_length_2196_cov_64.718646	938	1018	23	13	80	0.1625000
NODE_1135_length_2196_cov_64.718646	938	1018	25	27	80	0.3375000
NODE_1138_length_2195_cov_8.443225	114	136	8	6	22	0.2727273
NODE_1138_length_2195_cov_8.443225	114	136	10	16	22	0.7272727
NODE_1139_length_2195_cov_6.113550	1245	1330	0	85	85	1.0000000
NODE_1139_length_2195_cov_6.113550	1306	1352	0	46	46	1.0000000
NODE_1141_length_2194_cov_1.366587	15	77	0	38	62	0.6129032
NODE_1141_length_2194_cov_1.366587	15	77	2	21	62	0.3387097
NODE_1141_length_2194_cov_1.366587	15	77	6	3	62	0.0483871
NODE_1142_length_2193_cov_8.320917	374	454	0	80	80	1.0000000
NODE_1142_length_2193_cov_8.320917	427	502	0	73	75	0.9733334
NODE_1142_length_2193_cov_8.320917	427	502	2	2	75	0.0266667
NODE_1146_length_2189_cov_36.884689	383	463	0	47	80	0.5875000
NODE_1146_length_2189_cov_36.884689	383	463	2	33	80	0.4125000
NODE_1146_length_2189_cov_36.884689	436	516	0	80	80	1.0000000
NODE_1146_length_2189_cov_36.884689	1257	1337	0	80	80	1.0000000
NODE_1146_length_2189_cov_36.884689	1310	1390	0	80	80	1.0000000
NODE_1146_length_2189_cov_36.884689	1427	1507	2	37	80	0.4625000
NODE_1146_length_2189_cov_36.884689	1427	1507	4	30	80	0.3750000
NODE_1146_length_2189_cov_36.884689	1427	1507	6	13	80	0.1625000
NODE_1146_length_2189_cov_36.884689	1480	1560	0	5	80	0.0625000
NODE_1146_length_2189_cov_36.884689	1480	1560	2	8	80	0.1000000
NODE_1146_length_2189_cov_36.884689	1480	1560	4	34	80	0.4250000
NODE_1146_length_2189_cov_36.884689	1480	1560	6	33	80	0.4125000
NODE_1152_length_2184_cov_9.464748	1536	1616	0	2	80	0.0250000
NODE_1152_length_2184_cov_9.464748	1536	1616	2	78	80	0.9750000
NODE_1152_length_2184_cov_9.464748	1589	1669	0	24	80	0.3000000
NODE_1152_length_2184_cov_9.464748	1589	1669	2	56	80	0.7000000
NODE_1154_length_2183_cov_45.471209	1632	1712	0	64	80	0.8000000
NODE_1154_length_2183_cov_45.471209	1632	1712	1	16	80	0.2000000
NODE_1154_length_2183_cov_45.471209	1685	1765	0	11	80	0.1375000
NODE_1154_length_2183_cov_45.471209	1685	1765	1	69	80	0.8625000
NODE_1159_length_2176_cov_47.338950	0	52	0	52	52	1.0000000
NODE_1162_length_2174_cov_40.560964	1638	1718	0	14	80	0.1750000
NODE_1162_length_2174_cov_40.560964	1638	1718	2	66	80	0.8250000
NODE_1162_length_2174_cov_40.560964	1691	1771	0	52	80	0.6500000
NODE_1162_length_2174_cov_40.560964	1691	1771	2	28	80	0.3500000
NODE_1163_length_2174_cov_35.399518	284	364	0	80	80	1.0000000
NODE_1163_length_2174_cov_35.399518	337	414	0	77	77	1.0000000
NODE_1163_length_2174_cov_35.399518	1542	1620	167	1	78	0.0128205
NODE_1163_length_2174_cov_35.399518	1542	1620	172	1	78	0.0128205
NODE_1163_length_2174_cov_35.399518	1542	1620	173	2	78	0.0256410
NODE_1163_length_2174_cov_35.399518	1542	1620	174	3	78	0.0384615
NODE_1163_length_2174_cov_35.399518	1542	1620	175	4	78	0.0512821
NODE_1163_length_2174_cov_35.399518	1542	1620	176	9	78	0.1153846
NODE_1163_length_2174_cov_35.399518	1542	1620	177	2	78	0.0256410
NODE_1163_length_2174_cov_35.399518	1542	1620	178	2	78	0.0256410
NODE_1163_length_2174_cov_35.399518	1542	1620	179	5	78	0.0641026
NODE_1163_length_2174_cov_35.399518	1542	1620	180	1	78	0.0128205
NODE_1163_length_2174_cov_35.399518	1542	1620	181	2	78	0.0256410
NODE_1163_length_2174_cov_35.399518	1542	1620	182	3	78	0.0384615
NODE_1163_length_2174_cov_35.399518	1542	1620	188	1	78	0.0128205
NODE_1163_length_2174_cov_35.399518	1542	1620	196	1	78	0.0128205
NODE_1163_length_2174_cov_35.399518	1542	1620	197	1	78	0.0128205
NODE_1163_length_2174_cov_35.399518	1542	1620	198	2	78	0.0256410
NODE_1163_length_2174_cov_35.399518	1542	1620	199	1	78	0.0128205
NODE_1163_length_2174_cov_35.399518	1542	1620	200	3	78	0.0384615
NODE_1163_length_2174_cov_35.399518	1542	1620	201	2	78	0.0256410
NODE_1163_length_2174_cov_35.399518	1542	1620	202	8	78	0.1025641
NODE_1163_length_2174_cov_35.399518	1542	1620	204	1	78	0.0128205
NODE_1163_length_2174_cov_35.399518	1542	1620	205	3	78	0.0384615
NODE_1163_length_2174_cov_35.399518	1542	1620	206	5	78	0.0641026
NODE_1163_length_2174_cov_35.399518	1542	1620	207	5	78	0.0641026
NODE_1163_length_2174_cov_35.399518	1542	1620	208	7	78	0.0897436
NODE_1163_length_2174_cov_35.399518	1542	1620	210	3	78	0.0384615
NODE_1163_length_2174_cov_35.399518	1593	1673	163	1	80	0.0125000
NODE_1163_length_2174_cov_35.399518	1593	1673	164	1	80	0.0125000
NODE_1163_length_2174_cov_35.399518	1593	1673	166	3	80	0.0375000
NODE_1163_length_2174_cov_35.399518	1593	1673	167	2	80	0.0250000
NODE_1163_length_2174_cov_35.399518	1593	1673	168	2	80	0.0250000
NODE_1163_length_2174_cov_35.399518	1593	1673	169	2	80	0.0250000
NODE_1163_length_2174_cov_35.399518	1593	1673	170	5	80	0.0625000
NODE_1163_length_2174_cov_35.399518	1593	1673	171	1	80	0.0125000
NODE_1163_length_2174_cov_35.399518	1593	1673	172	2	80	0.0250000
NODE_1163_length_2174_cov_35.399518	1593	1673	173	3	80	0.0375000
NODE_1163_length_2174_cov_35.399518	1593	1673	174	5	80	0.0625000
NODE_1163_length_2174_cov_35.399518	1593	1673	175	4	80	0.0500000
NODE_1163_length_2174_cov_35.399518	1593	1673	176	5	80	0.0625000
NODE_1163_length_2174_cov_35.399518	1593	1673	177	3	80	0.0375000
NODE_1163_length_2174_cov_35.399518	1593	1673	179	5	80	0.0625000
NODE_1163_length_2174_cov_35.399518	1593	1673	180	1	80	0.0125000
NODE_1163_length_2174_cov_35.399518	1593	1673	181	1	80	0.0125000
NODE_1163_length_2174_cov_35.399518	1593	1673	182	2	80	0.0250000
NODE_1163_length_2174_cov_35.399518	1593	1673	185	1	80	0.0125000
NODE_1163_length_2174_cov_35.399518	1593	1673	186	1	80	0.0125000
NODE_1163_length_2174_cov_35.399518	1593	1673	198	1	80	0.0125000
NODE_1163_length_2174_cov_35.399518	1593	1673	200	1	80	0.0125000
NODE_1163_length_2174_cov_35.399518	1593	1673	204	2	80	0.0250000
NODE_1163_length_2174_cov_35.399518	1593	1673	209	2	80	0.0250000
NODE_1163_length_2174_cov_35.399518	1593	1673	211	2	80	0.0250000
NODE_1163_length_2174_cov_35.399518	1593	1673	213	1	80	0.0125000
NODE_1163_length_2174_cov_35.399518	1593	1673	214	1	80	0.0125000
NODE_1163_length_2174_cov_35.399518	1593	1673	215	2	80	0.0250000
NODE_1163_length_2174_cov_35.399518	1593	1673	216	2	80	0.0250000
NODE_1163_length_2174_cov_35.399518	1593	1673	218	2	80	0.0250000
NODE_1163_length_2174_cov_35.399518	1593	1673	220	1	80	0.0125000
NODE_1163_length_2174_cov_35.399518	1593	1673	221	3	80	0.0375000
NODE_1163_length_2174_cov_35.399518	1593	1673	222	1	80	0.0125000
NODE_1163_length_2174_cov_35.399518	1593	1673	225	1	80	0.0125000
NODE_1163_length_2174_cov_35.399518	1593	1673	231	1	80	0.0125000
NODE_1163_length_2174_cov_35.399518	1593	1673	233	2	80	0.0250000
NODE_1163_length_2174_cov_35.399518	1593	1673	234	2	80	0.0250000
NODE_1163_length_2174_cov_35.399518	1593	1673	235	2	80	0.0250000
NODE_1163_length_2174_cov_35.399518	1593	1673	237	1	80	0.0125000
NODE_1163_length_2174_cov_35.399518	2075	2152	86	77	77	1.0000000
NODE_1163_length_2174_cov_35.399518	2075	2152	86	77	77	1.0000000
NODE_1163_length_2174_cov_35.399518	2075	2152	86	77	77	1.0000000
NODE_1163_length_2174_cov_35.399518	2125	2174	0	1	49	0.0204082
NODE_1163_length_2174_cov_35.399518	2125	2174	4	5	49	0.1020408
NODE_1163_length_2174_cov_35.399518	2125	2174	8	1	49	0.0204082
NODE_1163_length_2174_cov_35.399518	2125	2174	16	2	49	0.0408163
NODE_1163_length_2174_cov_35.399518	2125	2174	18	4	49	0.0816327
NODE_1163_length_2174_cov_35.399518	2125	2174	28	1	49	0.0204082
NODE_1163_length_2174_cov_35.399518	2125	2174	32	3	49	0.0612245
NODE_1163_length_2174_cov_35.399518	2125	2174	58	1	49	0.0204082
NODE_1163_length_2174_cov_35.399518	2125	2174	78	4	49	0.0816327
NODE_1163_length_2174_cov_35.399518	2125	2174	86	27	49	0.5510204
NODE_1163_length_2174_cov_35.399518	2128	2174	0	1	46	0.0217391
NODE_1163_length_2174_cov_35.399518	2128	2174	4	5	46	0.1086956
NODE_1163_length_2174_cov_35.399518	2128	2174	8	1	46	0.0217391
NODE_1163_length_2174_cov_35.399518	2128	2174	16	2	46	0.0434783
NODE_1163_length_2174_cov_35.399518	2128	2174	18	4	46	0.0869565
NODE_1163_length_2174_cov_35.399518	2128	2174	28	1	46	0.0217391
NODE_1163_length_2174_cov_35.399518	2128	2174	32	3	46	0.0652174
NODE_1163_length_2174_cov_35.399518	2128	2174	58	1	46	0.0217391
NODE_1163_length_2174_cov_35.399518	2128	2174	78	4	46	0.0869565
NODE_1163_length_2174_cov_35.399518	2128	2174	86	24	46	0.5217391
NODE_1163_length_2174_cov_35.399518	2130	2174	0	1	44	0.0227273
NODE_1163_length_2174_cov_35.399518	2130	2174	4	5	44	0.1136364
NODE_1163_length_2174_cov_35.399518	2130	2174	8	1	44	0.0227273
NODE_1163_length_2174_cov_35.399518	2130	2174	16	2	44	0.0454545
NODE_1163_length_2174_cov_35.399518	2130	2174	18	4	44	0.0909091
NODE_1163_length_2174_cov_35.399518	2130	2174	28	1	44	0.0227273
NODE_1163_length_2174_cov_35.399518	2130	2174	32	3	44	0.0681818
NODE_1163_length_2174_cov_35.399518	2130	2174	58	1	44	0.0227273
NODE_1163_length_2174_cov_35.399518	2130	2174	78	4	44	0.0909091
NODE_1163_length_2174_cov_35.399518	2130	2174	86	22	44	0.5000000
NODE_1164_length_2172_cov_44.861553	1110	1190	2	18	80	0.2250000
NODE_1164_length_2172_cov_44.861553	1110	1190	4	62	80	0.7750000
NODE_1164_length_2172_cov_44.861553	1163	1243	2	71	80	0.8875000
NODE_1164_length_2172_cov_44.861553	1163	1243	4	9	80	0.1125000
NODE_1164_length_2172_cov_44.861553	1239	1319	0	22	80	0.2750000
NODE_1164_length_2172_cov_44.861553	1239	1319	2	58	80	0.7250000
NODE_1164_length_2172_cov_44.861553	1292	1372	0	75	80	0.9375000
NODE_1164_length_2172_cov_44.861553	1292	1372	2	5	80	0.0625000
NODE_1166_length_2167_cov_33.133946	414	494	6	9	80	0.1125000
NODE_1166_length_2167_cov_33.133946	414	494	8	58	80	0.7250000
NODE_1166_length_2167_cov_33.133946	414	494	10	13	80	0.1625000
NODE_1166_length_2167_cov_33.133946	467	547	2	41	80	0.5125000
NODE_1166_length_2167_cov_33.133946	467	547	8	32	80	0.4000000
NODE_1166_length_2167_cov_33.133946	467	547	10	7	80	0.0875000
NODE_1166_length_2167_cov_33.133946	543	623	0	75	80	0.9375000
NODE_1166_length_2167_cov_33.133946	543	623	2	5	80	0.0625000
NODE_1166_length_2167_cov_33.133946	596	676	0	51	80	0.6375000
NODE_1166_length_2167_cov_33.133946	596	676	1	3	80	0.0375000
NODE_1166_length_2167_cov_33.133946	596	676	2	13	80	0.1625000
NODE_1166_length_2167_cov_33.133946	596	676	6	13	80	0.1625000
NODE_1169_length_2165_cov_21.460794	980	1060	0	80	80	1.0000000
NODE_1169_length_2165_cov_21.460794	1033	1113	0	72	80	0.9000000
NODE_1169_length_2165_cov_21.460794	1033	1113	2	8	80	0.1000000
NODE_1176_length_2157_cov_22.284257	989	1069	0	80	80	1.0000000
NODE_1176_length_2157_cov_22.284257	1042	1122	0	80	80	1.0000000
NODE_1176_length_2157_cov_22.284257	1118	1198	0	42	80	0.5250000
NODE_1176_length_2157_cov_22.284257	1118	1198	2	38	80	0.4750000
NODE_1176_length_2157_cov_22.284257	1171	1251	0	4	80	0.0500000
NODE_1176_length_2157_cov_22.284257	1171	1251	1	1	80	0.0125000
NODE_1176_length_2157_cov_22.284257	1171	1251	2	75	80	0.9375000
NODE_1177_length_2157_cov_8.830418	867	947	0	80	80	1.0000000
NODE_1177_length_2157_cov_8.830418	920	1000	0	57	80	0.7125000
NODE_1177_length_2157_cov_8.830418	920	1000	10	23	80	0.2875000
NODE_1177_length_2157_cov_8.830418	996	1076	10	80	80	1.0000000
NODE_1177_length_2157_cov_8.830418	1049	1129	0	5	80	0.0625000
NODE_1177_length_2157_cov_8.830418	1049	1129	9	1	80	0.0125000
NODE_1177_length_2157_cov_8.830418	1049	1129	10	74	80	0.9250000
NODE_1178_length_2156_cov_25.065630	0	41	15	1	41	0.0243902
NODE_1178_length_2156_cov_25.065630	0	41	18	2	41	0.0487805
NODE_1178_length_2156_cov_25.065630	0	41	25	2	41	0.0487805
NODE_1178_length_2156_cov_25.065630	0	41	28	1	41	0.0243902
NODE_1178_length_2156_cov_25.065630	0	41	33	2	41	0.0487805
NODE_1178_length_2156_cov_25.065630	0	41	35	1	41	0.0243902
NODE_1178_length_2156_cov_25.065630	0	41	39	4	41	0.0975610
NODE_1178_length_2156_cov_25.065630	0	41	41	2	41	0.0487805
NODE_1178_length_2156_cov_25.065630	0	41	49	1	41	0.0243902
NODE_1178_length_2156_cov_25.065630	0	41	51	5	41	0.1219512
NODE_1178_length_2156_cov_25.065630	0	41	54	4	41	0.0975610
NODE_1178_length_2156_cov_25.065630	0	41	55	5	41	0.1219512
NODE_1178_length_2156_cov_25.065630	0	41	65	3	41	0.0731707
NODE_1178_length_2156_cov_25.065630	0	41	69	1	41	0.0243902
NODE_1178_length_2156_cov_25.065630	0	41	73	1	41	0.0243902
NODE_1178_length_2156_cov_25.065630	0	41	75	1	41	0.0243902
NODE_1178_length_2156_cov_25.065630	0	41	77	2	41	0.0487805
NODE_1178_length_2156_cov_25.065630	0	41	83	2	41	0.0487805
NODE_1178_length_2156_cov_25.065630	0	41	85	1	41	0.0243902
NODE_1178_length_2156_cov_25.065630	14	94	41	1	80	0.0125000
NODE_1178_length_2156_cov_25.065630	14	94	49	1	80	0.0125000
NODE_1178_length_2156_cov_25.065630	14	94	51	5	80	0.0625000
NODE_1178_length_2156_cov_25.065630	14	94	54	4	80	0.0500000
NODE_1178_length_2156_cov_25.065630	14	94	55	5	80	0.0625000
NODE_1178_length_2156_cov_25.065630	14	94	65	3	80	0.0375000
NODE_1178_length_2156_cov_25.065630	14	94	69	1	80	0.0125000
NODE_1178_length_2156_cov_25.065630	14	94	73	1	80	0.0125000
NODE_1178_length_2156_cov_25.065630	14	94	75	1	80	0.0125000
NODE_1178_length_2156_cov_25.065630	14	94	77	2	80	0.0250000
NODE_1178_length_2156_cov_25.065630	14	94	83	2	80	0.0250000
NODE_1178_length_2156_cov_25.065630	14	94	85	1	80	0.0125000
NODE_1178_length_2156_cov_25.065630	14	94	89	1	80	0.0125000
NODE_1178_length_2156_cov_25.065630	14	94	93	1	80	0.0125000
NODE_1178_length_2156_cov_25.065630	14	94	95	3	80	0.0375000
NODE_1178_length_2156_cov_25.065630	14	94	97	4	80	0.0500000
NODE_1178_length_2156_cov_25.065630	14	94	101	5	80	0.0625000
NODE_1178_length_2156_cov_25.065630	14	94	102	1	80	0.0125000
NODE_1178_length_2156_cov_25.065630	14	94	104	2	80	0.0250000
NODE_1178_length_2156_cov_25.065630	14	94	107	4	80	0.0500000
NODE_1178_length_2156_cov_25.065630	14	94	108	1	80	0.0125000
NODE_1178_length_2156_cov_25.065630	14	94	109	1	80	0.0125000
NODE_1178_length_2156_cov_25.065630	14	94	111	1	80	0.0125000
NODE_1178_length_2156_cov_25.065630	14	94	113	3	80	0.0375000
NODE_1178_length_2156_cov_25.065630	14	94	115	5	80	0.0625000
NODE_1178_length_2156_cov_25.065630	14	94	116	2	80	0.0250000
NODE_1178_length_2156_cov_25.065630	14	94	117	1	80	0.0125000
NODE_1178_length_2156_cov_25.065630	14	94	120	1	80	0.0125000
NODE_1178_length_2156_cov_25.065630	14	94	121	1	80	0.0125000
NODE_1178_length_2156_cov_25.065630	14	94	122	1	80	0.0125000
NODE_1178_length_2156_cov_25.065630	14	94	124	9	80	0.1125000
NODE_1178_length_2156_cov_25.065630	14	94	125	6	80	0.0750000
NODE_1181_length_2156_cov_3.216334	1890	1970	0	80	80	1.0000000
NODE_1181_length_2156_cov_3.216334	1943	2023	0	80	80	1.0000000
NODE_1184_length_2153_cov_11.610029	1968	2048	0	66	80	0.8250000
NODE_1184_length_2153_cov_11.610029	1968	2048	2	3	80	0.0375000
NODE_1184_length_2153_cov_11.610029	1968	2048	4	1	80	0.0125000
NODE_1184_length_2153_cov_11.610029	1968	2048	6	2	80	0.0250000
NODE_1184_length_2153_cov_11.610029	1968	2048	14	1	80	0.0125000
NODE_1184_length_2153_cov_11.610029	1968	2048	20	1	80	0.0125000
NODE_1184_length_2153_cov_11.610029	1968	2048	22	1	80	0.0125000
NODE_1184_length_2153_cov_11.610029	1968	2048	24	2	80	0.0250000
NODE_1184_length_2153_cov_11.610029	1968	2048	26	3	80	0.0375000
NODE_1184_length_2153_cov_11.610029	1977	2048	0	57	71	0.8028169
NODE_1184_length_2153_cov_11.610029	1977	2048	2	3	71	0.0422535
NODE_1184_length_2153_cov_11.610029	1977	2048	4	1	71	0.0140845
NODE_1184_length_2153_cov_11.610029	1977	2048	6	2	71	0.0281690
NODE_1184_length_2153_cov_11.610029	1977	2048	14	1	71	0.0140845
NODE_1184_length_2153_cov_11.610029	1977	2048	20	1	71	0.0140845
NODE_1184_length_2153_cov_11.610029	1977	2048	22	1	71	0.0140845
NODE_1184_length_2153_cov_11.610029	1977	2048	24	2	71	0.0281690
NODE_1184_length_2153_cov_11.610029	1977	2048	26	3	71	0.0422535
NODE_1190_length_2147_cov_25.116211	814	894	14	15	80	0.1875000
NODE_1190_length_2147_cov_25.116211	814	894	16	4	80	0.0500000
NODE_1190_length_2147_cov_25.116211	814	894	18	10	80	0.1250000
NODE_1190_length_2147_cov_25.116211	814	894	19	2	80	0.0250000
NODE_1190_length_2147_cov_25.116211	814	894	20	3	80	0.0375000
NODE_1190_length_2147_cov_25.116211	814	894	21	10	80	0.1250000
NODE_1190_length_2147_cov_25.116211	814	894	23	5	80	0.0625000
NODE_1190_length_2147_cov_25.116211	814	894	25	13	80	0.1625000
NODE_1190_length_2147_cov_25.116211	814	894	27	14	80	0.1750000
NODE_1190_length_2147_cov_25.116211	814	894	29	4	80	0.0500000
NODE_1190_length_2147_cov_25.116211	867	947	18	12	80	0.1500000
NODE_1190_length_2147_cov_25.116211	867	947	20	15	80	0.1875000
NODE_1190_length_2147_cov_25.116211	867	947	23	1	80	0.0125000
NODE_1190_length_2147_cov_25.116211	867	947	25	34	80	0.4250000
NODE_1190_length_2147_cov_25.116211	867	947	27	14	80	0.1750000
NODE_1190_length_2147_cov_25.116211	867	947	29	4	80	0.0500000
NODE_1197_length_2136_cov_16.947472	279	359	0	19	80	0.2375000
NODE_1197_length_2136_cov_16.947472	279	359	2	12	80	0.1500000
NODE_1197_length_2136_cov_16.947472	279	359	6	49	80	0.6125000
NODE_1197_length_2136_cov_16.947472	332	412	0	7	80	0.0875000
NODE_1197_length_2136_cov_16.947472	332	412	2	17	80	0.2125000
NODE_1197_length_2136_cov_16.947472	332	412	6	56	80	0.7000000
NODE_1197_length_2136_cov_16.947472	408	488	0	80	80	1.0000000
NODE_1197_length_2136_cov_16.947472	461	541	0	80	80	1.0000000
NODE_1199_length_2133_cov_15.038840	498	578	0	80	80	1.0000000
NODE_1199_length_2133_cov_15.038840	551	631	0	80	80	1.0000000
NODE_1199_length_2133_cov_15.038840	627	707	0	80	80	1.0000000
NODE_1199_length_2133_cov_15.038840	680	722	0	42	42	1.0000000
NODE_1204_length_2128_cov_11.799409	1698	1778	0	80	80	1.0000000
NODE_1204_length_2128_cov_11.799409	1751	1831	0	80	80	1.0000000
NODE_1206_length_2126_cov_6.854465	1614	1694	0	40	80	0.5000000
NODE_1206_length_2126_cov_6.854465	1614	1694	2	40	80	0.5000000
NODE_1206_length_2126_cov_6.854465	1667	1747	0	80	80	1.0000000
NODE_1209_length_2123_cov_12.668478	102	143	0	16	41	0.3902439
NODE_1209_length_2123_cov_12.668478	102	143	1	24	41	0.5853658
NODE_1209_length_2123_cov_12.668478	102	143	2	1	41	0.0243902
NODE_1209_length_2123_cov_12.668478	1474	1500	0	26	26	1.0000000
NODE_1209_length_2123_cov_12.668478	1552	1601	0	49	49	1.0000000
NODE_1209_length_2123_cov_12.668478	1574	1654	0	44	80	0.5500000
NODE_1209_length_2123_cov_12.668478	1574	1654	2	36	80	0.4500000
NODE_1211_length_2121_cov_10.101879	497	577	4	11	80	0.1375000
NODE_1211_length_2121_cov_10.101879	497	577	6	69	80	0.8625000
NODE_1211_length_2121_cov_10.101879	550	630	0	33	80	0.4125000
NODE_1211_length_2121_cov_10.101879	550	630	4	31	80	0.3875000
NODE_1211_length_2121_cov_10.101879	550	630	6	16	80	0.2000000
NODE_1211_length_2121_cov_10.101879	1935	2008	0	15	73	0.2054795
NODE_1211_length_2121_cov_10.101879	1935	2008	2	58	73	0.7945206
NODE_1212_length_2121_cov_9.964886	1523	1603	0	22	80	0.2750000
NODE_1212_length_2121_cov_9.964886	1523	1603	4	58	80	0.7250000
NODE_1212_length_2121_cov_9.964886	1576	1656	0	75	80	0.9375000
NODE_1212_length_2121_cov_9.964886	1576	1656	4	5	80	0.0625000
NODE_1213_length_2120_cov_24.609599	25	92	0	67	67	1.0000000
NODE_1215_length_2119_cov_18.446040	366	446	0	52	80	0.6500000
NODE_1215_length_2119_cov_18.446040	366	446	2	28	80	0.3500000
NODE_1215_length_2119_cov_18.446040	419	499	2	80	80	1.0000000
NODE_1215_length_2119_cov_18.446040	1239	1319	0	24	80	0.3000000
NODE_1215_length_2119_cov_18.446040	1239	1319	2	56	80	0.7000000
NODE_1215_length_2119_cov_18.446040	1292	1372	0	18	80	0.2250000
NODE_1215_length_2119_cov_18.446040	1292	1372	2	62	80	0.7750000
NODE_1225_length_2110_cov_8.668324	1755	1835	0	80	80	1.0000000
NODE_1225_length_2110_cov_8.668324	1808	1888	0	80	80	1.0000000
NODE_1227_length_2106_cov_14.643747	1579	1659	2	9	80	0.1125000
NODE_1227_length_2106_cov_14.643747	1579	1659	8	71	80	0.8875000
NODE_1227_length_2106_cov_14.643747	1632	1712	0	44	80	0.5500000
NODE_1227_length_2106_cov_14.643747	1632	1712	2	18	80	0.2250000
NODE_1227_length_2106_cov_14.643747	1632	1712	8	18	80	0.2250000
NODE_1227_length_2106_cov_14.643747	1708	1786	0	78	78	1.0000000
NODE_1227_length_2106_cov_14.643747	1759	1839	0	80	80	1.0000000
NODE_1228_length_2106_cov_3.173393	48	96	0	48	48	1.0000000
NODE_1228_length_2106_cov_3.173393	48	96	0	48	48	1.0000000
NODE_1228_length_2106_cov_3.173393	48	96	0	48	48	1.0000000
NODE_1228_length_2106_cov_3.173393	48	96	0	48	48	1.0000000
NODE_1228_length_2106_cov_3.173393	48	96	0	48	48	1.0000000
NODE_1229_length_2102_cov_23.872192	390	470	2	26	80	0.3250000
NODE_1229_length_2102_cov_23.872192	390	470	4	54	80	0.6750000
NODE_1229_length_2102_cov_23.872192	443	523	3	6	80	0.0750000
NODE_1229_length_2102_cov_23.872192	443	523	4	62	80	0.7750000
NODE_1229_length_2102_cov_23.872192	443	523	5	12	80	0.1500000
NODE_1229_length_2102_cov_23.872192	519	599	3	8	80	0.1000000
NODE_1229_length_2102_cov_23.872192	519	599	4	35	80	0.4375000
NODE_1229_length_2102_cov_23.872192	519	599	5	21	80	0.2625000
NODE_1229_length_2102_cov_23.872192	519	599	8	16	80	0.2000000
NODE_1229_length_2102_cov_23.872192	572	652	1	1	80	0.0125000
NODE_1229_length_2102_cov_23.872192	572	652	2	12	80	0.1500000
NODE_1229_length_2102_cov_23.872192	572	652	3	2	80	0.0250000
NODE_1229_length_2102_cov_23.872192	572	652	4	9	80	0.1125000
NODE_1229_length_2102_cov_23.872192	572	652	6	9	80	0.1125000
NODE_1229_length_2102_cov_23.872192	572	652	8	47	80	0.5875000
NODE_1229_length_2102_cov_23.872192	1049	1101	350	2	52	0.0384615
NODE_1229_length_2102_cov_23.872192	1049	1101	351	2	52	0.0384615
NODE_1229_length_2102_cov_23.872192	1049	1101	354	3	52	0.0576923
NODE_1229_length_2102_cov_23.872192	1049	1101	355	2	52	0.0384615
NODE_1229_length_2102_cov_23.872192	1049	1101	357	3	52	0.0576923
NODE_1229_length_2102_cov_23.872192	1049	1101	358	3	52	0.0576923
NODE_1229_length_2102_cov_23.872192	1049	1101	359	1	52	0.0192308
NODE_1229_length_2102_cov_23.872192	1049	1101	360	1	52	0.0192308
NODE_1229_length_2102_cov_23.872192	1049	1101	361	1	52	0.0192308
NODE_1229_length_2102_cov_23.872192	1049	1101	362	3	52	0.0576923
NODE_1229_length_2102_cov_23.872192	1049	1101	364	3	52	0.0576923
NODE_1229_length_2102_cov_23.872192	1049	1101	368	1	52	0.0192308
NODE_1229_length_2102_cov_23.872192	1049	1101	372	2	52	0.0384615
NODE_1229_length_2102_cov_23.872192	1049	1101	373	1	52	0.0192308
NODE_1229_length_2102_cov_23.872192	1049	1101	374	6	52	0.1153846
NODE_1229_length_2102_cov_23.872192	1049	1101	375	2	52	0.0384615
NODE_1229_length_2102_cov_23.872192	1049	1101	377	1	52	0.0192308
NODE_1229_length_2102_cov_23.872192	1049	1101	379	1	52	0.0192308
NODE_1229_length_2102_cov_23.872192	1049	1101	381	1	52	0.0192308
NODE_1229_length_2102_cov_23.872192	1049	1101	385	6	52	0.1153846
NODE_1229_length_2102_cov_23.872192	1049	1101	386	3	52	0.0576923
NODE_1229_length_2102_cov_23.872192	1049	1101	387	1	52	0.0192308
NODE_1229_length_2102_cov_23.872192	1049	1101	388	2	52	0.0384615
NODE_1229_length_2102_cov_23.872192	1049	1101	389	1	52	0.0192308
NODE_1231_length_2100_cov_21.504248	450	530	0	24	80	0.3000000
NODE_1231_length_2100_cov_21.504248	450	530	3	3	80	0.0375000
NODE_1231_length_2100_cov_21.504248	450	530	4	53	80	0.6625000
NODE_1231_length_2100_cov_21.504248	503	578	2	3	75	0.0400000
NODE_1231_length_2100_cov_21.504248	503	578	4	63	75	0.8400000
NODE_1231_length_2100_cov_21.504248	503	578	6	9	75	0.1200000
NODE_1231_length_2100_cov_21.504248	579	659	0	30	80	0.3750000
NODE_1231_length_2100_cov_21.504248	579	659	2	50	80	0.6250000
NODE_1231_length_2100_cov_21.504248	632	712	0	80	80	1.0000000
NODE_1231_length_2100_cov_21.504248	1420	1500	0	80	80	1.0000000
NODE_1231_length_2100_cov_21.504248	1473	1553	0	80	80	1.0000000
NODE_1232_length_2100_cov_6.399300	1510	1590	0	49	80	0.6125000
NODE_1232_length_2100_cov_6.399300	1510	1590	2	31	80	0.3875000
NODE_1232_length_2100_cov_6.399300	1559	1590	2	31	31	1.0000000
NODE_1232_length_2100_cov_6.399300	1563	1644	0	7	81	0.0864198
NODE_1232_length_2100_cov_6.399300	1563	1644	2	74	81	0.9135802
NODE_1232_length_2100_cov_6.399300	1563	1644	0	7	81	0.0864198
NODE_1232_length_2100_cov_6.399300	1563	1644	2	74	81	0.9135802
NODE_1234_length_2099_cov_40.603500	960	1040	2	80	80	1.0000000
NODE_1234_length_2099_cov_40.603500	1013	1093	0	41	80	0.5125000
NODE_1234_length_2099_cov_40.603500	1013	1093	2	39	80	0.4875000
NODE_1234_length_2099_cov_40.603500	1089	1169	0	40	80	0.5000000
NODE_1234_length_2099_cov_40.603500	1089	1169	2	40	80	0.5000000
NODE_1234_length_2099_cov_40.603500	1142	1222	0	13	80	0.1625000
NODE_1234_length_2099_cov_40.603500	1142	1222	2	67	80	0.8375000
NODE_1235_length_2098_cov_62.733867	1042	1122	0	80	80	1.0000000
NODE_1235_length_2098_cov_62.733867	1095	1175	0	80	80	1.0000000
NODE_1235_length_2098_cov_62.733867	1171	1251	0	21	80	0.2625000
NODE_1235_length_2098_cov_62.733867	1171	1251	2	20	80	0.2500000
NODE_1235_length_2098_cov_62.733867	1171	1251	4	8	80	0.1000000
NODE_1235_length_2098_cov_62.733867	1171	1251	6	31	80	0.3875000
NODE_1235_length_2098_cov_62.733867	1224	1304	6	50	80	0.6250000
NODE_1235_length_2098_cov_62.733867	1224	1304	10	30	80	0.3750000
NODE_1236_length_2098_cov_20.220110	550	630	2	20	80	0.2500000
NODE_1236_length_2098_cov_20.220110	550	630	4	24	80	0.3000000
NODE_1236_length_2098_cov_20.220110	550	630	6	36	80	0.4500000
NODE_1236_length_2098_cov_20.220110	603	683	4	40	80	0.5000000
NODE_1236_length_2098_cov_20.220110	603	683	6	40	80	0.5000000
NODE_1236_length_2098_cov_20.220110	1571	1651	4	3	80	0.0375000
NODE_1236_length_2098_cov_20.220110	1571	1651	6	77	80	0.9625000
NODE_1236_length_2098_cov_20.220110	1624	1704	6	80	80	1.0000000
NODE_1237_length_2098_cov_8.261631	324	404	4	73	80	0.9125000
NODE_1237_length_2098_cov_8.261631	324	404	6	7	80	0.0875000
NODE_1239_length_2095_cov_29.930862	1128	1209	225	1	81	0.0123457
NODE_1239_length_2095_cov_29.930862	1128	1209	232	1	81	0.0123457
NODE_1239_length_2095_cov_29.930862	1128	1209	255	1	81	0.0123457
NODE_1239_length_2095_cov_29.930862	1128	1209	271	1	81	0.0123457
NODE_1239_length_2095_cov_29.930862	1128	1209	277	1	81	0.0123457
NODE_1239_length_2095_cov_29.930862	1128	1209	287	1	81	0.0123457
NODE_1239_length_2095_cov_29.930862	1128	1209	305	1	81	0.0123457
NODE_1239_length_2095_cov_29.930862	1128	1209	310	1	81	0.0123457
NODE_1239_length_2095_cov_29.930862	1128	1209	319	1	81	0.0123457
NODE_1239_length_2095_cov_29.930862	1128	1209	322	1	81	0.0123457
NODE_1239_length_2095_cov_29.930862	1128	1209	330	1	81	0.0123457
NODE_1239_length_2095_cov_29.930862	1128	1209	346	1	81	0.0123457
NODE_1239_length_2095_cov_29.930862	1128	1209	353	1	81	0.0123457
NODE_1239_length_2095_cov_29.930862	1128	1209	354	1	81	0.0123457
NODE_1239_length_2095_cov_29.930862	1128	1209	356	1	81	0.0123457
NODE_1239_length_2095_cov_29.930862	1128	1209	365	1	81	0.0123457
NODE_1239_length_2095_cov_29.930862	1128	1209	368	2	81	0.0246914
NODE_1239_length_2095_cov_29.930862	1128	1209	374	1	81	0.0123457
NODE_1239_length_2095_cov_29.930862	1128	1209	387	2	81	0.0246914
NODE_1239_length_2095_cov_29.930862	1128	1209	411	1	81	0.0123457
NODE_1239_length_2095_cov_29.930862	1128	1209	418	1	81	0.0123457
NODE_1239_length_2095_cov_29.930862	1128	1209	430	1	81	0.0123457
NODE_1239_length_2095_cov_29.930862	1128	1209	437	1	81	0.0123457
NODE_1239_length_2095_cov_29.930862	1128	1209	443	1	81	0.0123457
NODE_1239_length_2095_cov_29.930862	1128	1209	469	1	81	0.0123457
NODE_1239_length_2095_cov_29.930862	1128	1209	477	1	81	0.0123457
NODE_1239_length_2095_cov_29.930862	1128	1209	479	1	81	0.0123457
NODE_1239_length_2095_cov_29.930862	1128	1209	482	1	81	0.0123457
NODE_1239_length_2095_cov_29.930862	1128	1209	486	1	81	0.0123457
NODE_1239_length_2095_cov_29.930862	1128	1209	487	1	81	0.0123457
NODE_1239_length_2095_cov_29.930862	1128	1209	493	1	81	0.0123457
NODE_1239_length_2095_cov_29.930862	1128	1209	498	1	81	0.0123457
NODE_1239_length_2095_cov_29.930862	1128	1209	502	1	81	0.0123457
NODE_1239_length_2095_cov_29.930862	1128	1209	506	1	81	0.0123457
NODE_1239_length_2095_cov_29.930862	1128	1209	523	1	81	0.0123457
NODE_1239_length_2095_cov_29.930862	1128	1209	525	1	81	0.0123457
NODE_1239_length_2095_cov_29.930862	1128	1209	526	1	81	0.0123457
NODE_1239_length_2095_cov_29.930862	1128	1209	535	1	81	0.0123457
NODE_1239_length_2095_cov_29.930862	1128	1209	545	1	81	0.0123457
NODE_1239_length_2095_cov_29.930862	1128	1209	552	1	81	0.0123457
NODE_1239_length_2095_cov_29.930862	1128	1209	568	1	81	0.0123457
NODE_1239_length_2095_cov_29.930862	1128	1209	571	1	81	0.0123457
NODE_1239_length_2095_cov_29.930862	1128	1209	579	1	81	0.0123457
NODE_1239_length_2095_cov_29.930862	1128	1209	589	1	81	0.0123457
NODE_1239_length_2095_cov_29.930862	1128	1209	595	1	81	0.0123457
NODE_1239_length_2095_cov_29.930862	1128	1209	607	1	81	0.0123457
NODE_1239_length_2095_cov_29.930862	1128	1209	613	1	81	0.0123457
NODE_1239_length_2095_cov_29.930862	1128	1209	620	1	81	0.0123457
NODE_1239_length_2095_cov_29.930862	1128	1209	627	1	81	0.0123457
NODE_1239_length_2095_cov_29.930862	1128	1209	631	1	81	0.0123457
NODE_1239_length_2095_cov_29.930862	1128	1209	636	1	81	0.0123457
NODE_1239_length_2095_cov_29.930862	1128	1209	643	2	81	0.0246914
NODE_1239_length_2095_cov_29.930862	1128	1209	644	1	81	0.0123457
NODE_1239_length_2095_cov_29.930862	1128	1209	646	1	81	0.0123457
NODE_1239_length_2095_cov_29.930862	1128	1209	663	1	81	0.0123457
NODE_1239_length_2095_cov_29.930862	1128	1209	669	1	81	0.0123457
NODE_1239_length_2095_cov_29.930862	1128	1209	687	1	81	0.0123457
NODE_1239_length_2095_cov_29.930862	1128	1209	693	1	81	0.0123457
NODE_1239_length_2095_cov_29.930862	1128	1209	701	1	81	0.0123457
NODE_1239_length_2095_cov_29.930862	1128	1209	710	1	81	0.0123457
NODE_1239_length_2095_cov_29.930862	1128	1209	727	1	81	0.0123457
NODE_1239_length_2095_cov_29.930862	1128	1209	728	1	81	0.0123457
NODE_1239_length_2095_cov_29.930862	1128	1209	748	1	81	0.0123457
NODE_1239_length_2095_cov_29.930862	1128	1209	752	1	81	0.0123457
NODE_1239_length_2095_cov_29.930862	1128	1209	756	1	81	0.0123457
NODE_1239_length_2095_cov_29.930862	1128	1209	770	1	81	0.0123457
NODE_1239_length_2095_cov_29.930862	1128	1209	775	1	81	0.0123457
NODE_1239_length_2095_cov_29.930862	1128	1209	784	1	81	0.0123457
NODE_1239_length_2095_cov_29.930862	1128	1209	785	1	81	0.0123457
NODE_1239_length_2095_cov_29.930862	1128	1209	788	1	81	0.0123457
NODE_1239_length_2095_cov_29.930862	1128	1209	798	1	81	0.0123457
NODE_1239_length_2095_cov_29.930862	1128	1209	799	2	81	0.0246914
NODE_1239_length_2095_cov_29.930862	1128	1209	813	1	81	0.0123457
NODE_1239_length_2095_cov_29.930862	1128	1209	820	1	81	0.0123457
NODE_1239_length_2095_cov_29.930862	1128	1209	825	1	81	0.0123457
NODE_1239_length_2095_cov_29.930862	1128	1209	833	1	81	0.0123457
NODE_1239_length_2095_cov_29.930862	1128	1209	837	1	81	0.0123457
NODE_1239_length_2095_cov_29.930862	1204	1258	813	1	54	0.0185185
NODE_1239_length_2095_cov_29.930862	1204	1258	820	1	54	0.0185185
NODE_1239_length_2095_cov_29.930862	1204	1258	825	1	54	0.0185185
NODE_1239_length_2095_cov_29.930862	1204	1258	833	1	54	0.0185185
NODE_1239_length_2095_cov_29.930862	1204	1258	837	1	54	0.0185185
NODE_1239_length_2095_cov_29.930862	1204	1258	859	1	54	0.0185185
NODE_1239_length_2095_cov_29.930862	1204	1258	861	1	54	0.0185185
NODE_1239_length_2095_cov_29.930862	1204	1258	862	2	54	0.0370370
NODE_1239_length_2095_cov_29.930862	1204	1258	866	1	54	0.0185185
NODE_1239_length_2095_cov_29.930862	1204	1258	868	2	54	0.0370370
NODE_1239_length_2095_cov_29.930862	1204	1258	870	1	54	0.0185185
NODE_1239_length_2095_cov_29.930862	1204	1258	871	1	54	0.0185185
NODE_1239_length_2095_cov_29.930862	1204	1258	872	1	54	0.0185185
NODE_1239_length_2095_cov_29.930862	1204	1258	873	1	54	0.0185185
NODE_1239_length_2095_cov_29.930862	1204	1258	874	2	54	0.0370370
NODE_1239_length_2095_cov_29.930862	1204	1258	875	1	54	0.0185185
NODE_1239_length_2095_cov_29.930862	1204	1258	876	1	54	0.0185185
NODE_1239_length_2095_cov_29.930862	1204	1258	877	2	54	0.0370370
NODE_1239_length_2095_cov_29.930862	1204	1258	879	2	54	0.0370370
NODE_1239_length_2095_cov_29.930862	1204	1258	880	2	54	0.0370370
NODE_1239_length_2095_cov_29.930862	1204	1258	881	1	54	0.0185185
NODE_1239_length_2095_cov_29.930862	1204	1258	883	1	54	0.0185185
NODE_1239_length_2095_cov_29.930862	1204	1258	884	3	54	0.0555556
NODE_1239_length_2095_cov_29.930862	1204	1258	887	1	54	0.0185185
NODE_1239_length_2095_cov_29.930862	1204	1258	888	1	54	0.0185185
NODE_1239_length_2095_cov_29.930862	1204	1258	897	1	54	0.0185185
NODE_1239_length_2095_cov_29.930862	1204	1258	898	2	54	0.0370370
NODE_1239_length_2095_cov_29.930862	1204	1258	899	2	54	0.0370370
NODE_1239_length_2095_cov_29.930862	1204	1258	900	3	54	0.0555556
NODE_1239_length_2095_cov_29.930862	1204	1258	902	1	54	0.0185185
NODE_1239_length_2095_cov_29.930862	1204	1258	903	1	54	0.0185185
NODE_1239_length_2095_cov_29.930862	1204	1258	904	4	54	0.0740741
NODE_1239_length_2095_cov_29.930862	1204	1258	905	2	54	0.0370370
NODE_1239_length_2095_cov_29.930862	1204	1258	906	1	54	0.0185185
NODE_1239_length_2095_cov_29.930862	1204	1258	908	2	54	0.0370370
NODE_1239_length_2095_cov_29.930862	1204	1258	910	1	54	0.0185185
NODE_1239_length_2095_cov_29.930862	1204	1258	912	1	54	0.0185185
NODE_1251_length_2084_cov_1.720403	959	1039	2	79	80	0.9875000
NODE_1251_length_2084_cov_1.720403	959	1039	4	1	80	0.0125000
NODE_1251_length_2084_cov_1.720403	1012	1092	0	4	80	0.0500000
NODE_1251_length_2084_cov_1.720403	1012	1092	2	76	80	0.9500000
NODE_1252_length_2083_cov_5.864415	419	499	0	80	80	1.0000000
NODE_1252_length_2083_cov_5.864415	472	552	0	80	80	1.0000000
NODE_1252_length_2083_cov_5.864415	548	628	0	80	80	1.0000000
NODE_1252_length_2083_cov_5.864415	601	681	0	80	80	1.0000000
NODE_1256_length_2078_cov_47.394644	311	391	0	11	80	0.1375000
NODE_1256_length_2078_cov_47.394644	311	391	2	69	80	0.8625000
NODE_1256_length_2078_cov_47.394644	364	444	0	64	80	0.8000000
NODE_1256_length_2078_cov_47.394644	364	444	2	16	80	0.2000000
NODE_1256_length_2078_cov_47.394644	440	520	0	28	80	0.3500000
NODE_1256_length_2078_cov_47.394644	440	520	1	1	80	0.0125000
NODE_1256_length_2078_cov_47.394644	440	520	2	51	80	0.6375000
NODE_1256_length_2078_cov_47.394644	493	573	2	35	80	0.4375000
NODE_1256_length_2078_cov_47.394644	493	573	3	4	80	0.0500000
NODE_1256_length_2078_cov_47.394644	493	573	5	41	80	0.5125000
NODE_1267_length_2067_cov_13.647866	1349	1429	2	39	80	0.4875000
NODE_1267_length_2067_cov_13.647866	1349	1429	6	41	80	0.5125000
NODE_1267_length_2067_cov_13.647866	1402	1482	6	80	80	1.0000000
NODE_1269_length_2066_cov_19.127605	1497	1577	8	13	80	0.1625000
NODE_1269_length_2066_cov_19.127605	1497	1577	9	4	80	0.0500000
NODE_1269_length_2066_cov_19.127605	1497	1577	10	63	80	0.7875000
NODE_1269_length_2066_cov_19.127605	1550	1630	3	21	80	0.2625000
NODE_1269_length_2066_cov_19.127605	1550	1630	5	1	80	0.0125000
NODE_1269_length_2066_cov_19.127605	1550	1630	6	27	80	0.3375000
NODE_1269_length_2066_cov_19.127605	1550	1630	8	14	80	0.1750000
NODE_1269_length_2066_cov_19.127605	1550	1630	10	17	80	0.2125000
NODE_1274_length_2061_cov_43.187054	364	444	0	80	80	1.0000000
NODE_1274_length_2061_cov_43.187054	417	497	0	80	80	1.0000000
NODE_1275_length_2061_cov_3.251784	981	1033	0	52	52	1.0000000
NODE_1275_length_2061_cov_3.251784	1006	1086	0	80	80	1.0000000
NODE_1277_length_2058_cov_4.531394	1844	1875	2	4	31	0.1290323
NODE_1277_length_2058_cov_4.531394	1844	1875	8	13	31	0.4193548
NODE_1277_length_2058_cov_4.531394	1844	1875	10	1	31	0.0322581
NODE_1277_length_2058_cov_4.531394	1844	1875	12	3	31	0.0967742
NODE_1277_length_2058_cov_4.531394	1844	1875	14	5	31	0.1612903
NODE_1277_length_2058_cov_4.531394	1844	1875	16	5	31	0.1612903
NODE_1277_length_2058_cov_4.531394	1848	1928	8	13	80	0.1625000
NODE_1277_length_2058_cov_4.531394	1848	1928	10	1	80	0.0125000
NODE_1277_length_2058_cov_4.531394	1848	1928	12	3	80	0.0375000
NODE_1277_length_2058_cov_4.531394	1848	1928	14	5	80	0.0625000
NODE_1277_length_2058_cov_4.531394	1848	1928	16	8	80	0.1000000
NODE_1277_length_2058_cov_4.531394	1848	1928	18	14	80	0.1750000
NODE_1277_length_2058_cov_4.531394	1848	1928	20	1	80	0.0125000
NODE_1277_length_2058_cov_4.531394	1848	1928	22	9	80	0.1125000
NODE_1277_length_2058_cov_4.531394	1848	1928	24	26	80	0.3250000
NODE_1279_length_2056_cov_20.525805	749	829	0	80	80	1.0000000
NODE_1279_length_2056_cov_20.525805	802	882	0	80	80	1.0000000
NODE_1279_length_2056_cov_20.525805	878	958	0	22	80	0.2750000
NODE_1279_length_2056_cov_20.525805	878	958	2	58	80	0.7250000
NODE_1279_length_2056_cov_20.525805	931	1011	0	43	80	0.5375000
NODE_1279_length_2056_cov_20.525805	931	1011	2	37	80	0.4625000
NODE_1281_length_2055_cov_10.047546	1468	1548	0	80	80	1.0000000
NODE_1281_length_2055_cov_10.047546	1521	1601	0	80	80	1.0000000
NODE_1286_length_2049_cov_6.846154	270	350	0	2	80	0.0250000
NODE_1286_length_2049_cov_6.846154	270	350	2	78	80	0.9750000
NODE_1286_length_2049_cov_6.846154	323	403	0	55	80	0.6875000
NODE_1286_length_2049_cov_6.846154	323	403	2	25	80	0.3125000
NODE_1286_length_2049_cov_6.846154	1595	1674	0	79	79	1.0000000
NODE_1286_length_2049_cov_6.846154	1648	1712	0	64	64	1.0000000
NODE_1293_length_2045_cov_46.790339	876	956	14	5	80	0.0625000
NODE_1293_length_2045_cov_46.790339	876	956	16	3	80	0.0375000
NODE_1293_length_2045_cov_46.790339	876	956	18	7	80	0.0875000
NODE_1293_length_2045_cov_46.790339	876	956	22	29	80	0.3625000
NODE_1293_length_2045_cov_46.790339	876	956	24	2	80	0.0250000
NODE_1293_length_2045_cov_46.790339	876	956	26	28	80	0.3500000
NODE_1293_length_2045_cov_46.790339	876	956	28	6	80	0.0750000
NODE_1293_length_2045_cov_46.790339	929	1009	11	12	80	0.1500000
NODE_1293_length_2045_cov_46.790339	929	1009	14	11	80	0.1375000
NODE_1293_length_2045_cov_46.790339	929	1009	15	4	80	0.0500000
NODE_1293_length_2045_cov_46.790339	929	1009	16	3	80	0.0375000
NODE_1293_length_2045_cov_46.790339	929	1009	17	24	80	0.3000000
NODE_1293_length_2045_cov_46.790339	929	1009	19	7	80	0.0875000
NODE_1293_length_2045_cov_46.790339	929	1009	24	2	80	0.0250000
NODE_1293_length_2045_cov_46.790339	929	1009	26	11	80	0.1375000
NODE_1293_length_2045_cov_46.790339	929	1009	28	6	80	0.0750000
NODE_1293_length_2045_cov_46.790339	1005	1085	6	6	80	0.0750000
NODE_1293_length_2045_cov_46.790339	1005	1085	8	19	80	0.2375000
NODE_1293_length_2045_cov_46.790339	1005	1085	10	23	80	0.2875000
NODE_1293_length_2045_cov_46.790339	1005	1085	11	8	80	0.1000000
NODE_1293_length_2045_cov_46.790339	1005	1085	12	24	80	0.3000000
NODE_1293_length_2045_cov_46.790339	1058	1138	2	28	80	0.3500000
NODE_1293_length_2045_cov_46.790339	1058	1138	4	17	80	0.2125000
NODE_1293_length_2045_cov_46.790339	1058	1138	6	14	80	0.1750000
NODE_1293_length_2045_cov_46.790339	1058	1138	8	5	80	0.0625000
NODE_1293_length_2045_cov_46.790339	1058	1138	10	16	80	0.2000000
NODE_1298_length_2042_cov_4.447761	241	315	2	44	74	0.5945946
NODE_1298_length_2042_cov_4.447761	241	315	4	30	74	0.4054054
NODE_1301_length_2040_cov_30.109737	1760	1844	297	1	84	0.0119048
NODE_1301_length_2040_cov_30.109737	1760	1844	299	1	84	0.0119048
NODE_1301_length_2040_cov_30.109737	1760	1844	305	1	84	0.0119048
NODE_1301_length_2040_cov_30.109737	1760	1844	306	1	84	0.0119048
NODE_1301_length_2040_cov_30.109737	1760	1844	309	3	84	0.0357143
NODE_1301_length_2040_cov_30.109737	1760	1844	311	3	84	0.0357143
NODE_1301_length_2040_cov_30.109737	1760	1844	316	3	84	0.0357143
NODE_1301_length_2040_cov_30.109737	1760	1844	317	2	84	0.0238095
NODE_1301_length_2040_cov_30.109737	1760	1844	318	1	84	0.0119048
NODE_1301_length_2040_cov_30.109737	1760	1844	319	2	84	0.0238095
NODE_1301_length_2040_cov_30.109737	1760	1844	320	1	84	0.0119048
NODE_1301_length_2040_cov_30.109737	1760	1844	323	3	84	0.0357143
NODE_1301_length_2040_cov_30.109737	1760	1844	325	1	84	0.0119048
NODE_1301_length_2040_cov_30.109737	1760	1844	328	1	84	0.0119048
NODE_1301_length_2040_cov_30.109737	1760	1844	329	4	84	0.0476190
NODE_1301_length_2040_cov_30.109737	1760	1844	330	1	84	0.0119048
NODE_1301_length_2040_cov_30.109737	1760	1844	331	1	84	0.0119048
NODE_1301_length_2040_cov_30.109737	1760	1844	333	3	84	0.0357143
NODE_1301_length_2040_cov_30.109737	1760	1844	334	4	84	0.0476190
NODE_1301_length_2040_cov_30.109737	1760	1844	337	1	84	0.0119048
NODE_1301_length_2040_cov_30.109737	1760	1844	339	2	84	0.0238095
NODE_1301_length_2040_cov_30.109737	1760	1844	340	2	84	0.0238095
NODE_1301_length_2040_cov_30.109737	1760	1844	342	1	84	0.0119048
NODE_1301_length_2040_cov_30.109737	1760	1844	344	5	84	0.0595238
NODE_1301_length_2040_cov_30.109737	1760	1844	345	1	84	0.0119048
NODE_1301_length_2040_cov_30.109737	1760	1844	346	2	84	0.0238095
NODE_1301_length_2040_cov_30.109737	1760	1844	348	4	84	0.0476190
NODE_1301_length_2040_cov_30.109737	1760	1844	350	1	84	0.0119048
NODE_1301_length_2040_cov_30.109737	1760	1844	351	1	84	0.0119048
NODE_1301_length_2040_cov_30.109737	1760	1844	352	4	84	0.0476190
NODE_1301_length_2040_cov_30.109737	1760	1844	353	2	84	0.0238095
NODE_1301_length_2040_cov_30.109737	1760	1844	354	3	84	0.0357143
NODE_1301_length_2040_cov_30.109737	1760	1844	355	2	84	0.0238095
NODE_1301_length_2040_cov_30.109737	1760	1844	356	2	84	0.0238095
NODE_1301_length_2040_cov_30.109737	1760	1844	358	3	84	0.0357143
NODE_1301_length_2040_cov_30.109737	1760	1844	359	1	84	0.0119048
NODE_1301_length_2040_cov_30.109737	1760	1844	360	1	84	0.0119048
NODE_1301_length_2040_cov_30.109737	1760	1844	361	2	84	0.0238095
NODE_1301_length_2040_cov_30.109737	1760	1844	362	2	84	0.0238095
NODE_1301_length_2040_cov_30.109737	1760	1844	363	2	84	0.0238095
NODE_1301_length_2040_cov_30.109737	1760	1844	364	2	84	0.0238095
NODE_1301_length_2040_cov_30.109737	1760	1844	365	1	84	0.0119048
NODE_1306_length_2036_cov_11.672173	369	449	0	28	80	0.3500000
NODE_1306_length_2036_cov_11.672173	369	449	4	9	80	0.1125000
NODE_1306_length_2036_cov_11.672173	369	449	6	43	80	0.5375000
NODE_1306_length_2036_cov_11.672173	422	502	0	1	80	0.0125000
NODE_1306_length_2036_cov_11.672173	422	502	2	18	80	0.2250000
NODE_1306_length_2036_cov_11.672173	422	502	6	61	80	0.7625000
NODE_1312_length_2032_cov_11.188308	416	496	0	80	80	1.0000000
NODE_1312_length_2032_cov_11.188308	469	549	0	80	80	1.0000000
NODE_1318_length_2027_cov_43.702282	1129	1209	0	2	80	0.0250000
NODE_1318_length_2027_cov_43.702282	1129	1209	1	26	80	0.3250000
NODE_1318_length_2027_cov_43.702282	1129	1209	2	47	80	0.5875000
NODE_1318_length_2027_cov_43.702282	1129	1209	4	5	80	0.0625000
NODE_1318_length_2027_cov_43.702282	1182	1262	1	18	80	0.2250000
NODE_1318_length_2027_cov_43.702282	1182	1262	2	62	80	0.7750000
NODE_1318_length_2027_cov_43.702282	1258	1338	0	66	80	0.8250000
NODE_1318_length_2027_cov_43.702282	1258	1338	2	14	80	0.1750000
NODE_1318_length_2027_cov_43.702282	1311	1391	0	51	80	0.6375000
NODE_1318_length_2027_cov_43.702282	1311	1391	2	29	80	0.3625000
NODE_1319_length_2027_cov_6.558610	229	303	0	23	74	0.3108108
NODE_1319_length_2027_cov_6.558610	229	303	2	11	74	0.1486486
NODE_1319_length_2027_cov_6.558610	229	303	4	40	74	0.5405405
NODE_1319_length_2027_cov_6.558610	229	303	0	23	74	0.3108108
NODE_1319_length_2027_cov_6.558610	229	303	2	11	74	0.1486486
NODE_1319_length_2027_cov_6.558610	229	303	4	40	74	0.5405405
NODE_1319_length_2027_cov_6.558610	276	356	0	2	80	0.0250000
NODE_1319_length_2027_cov_6.558610	276	356	2	37	80	0.4625000
NODE_1319_length_2027_cov_6.558610	276	356	4	41	80	0.5125000
NODE_1320_length_2026_cov_18.457706	688	768	8	2	80	0.0250000
NODE_1320_length_2026_cov_18.457706	688	768	10	1	80	0.0125000
NODE_1320_length_2026_cov_18.457706	688	768	12	1	80	0.0125000
NODE_1320_length_2026_cov_18.457706	688	768	14	68	80	0.8500000
NODE_1320_length_2026_cov_18.457706	688	768	16	2	80	0.0250000
NODE_1320_length_2026_cov_18.457706	688	768	18	6	80	0.0750000
NODE_1320_length_2026_cov_18.457706	741	821	4	2	80	0.0250000
NODE_1320_length_2026_cov_18.457706	741	821	6	2	80	0.0250000
NODE_1320_length_2026_cov_18.457706	741	821	7	6	80	0.0750000
NODE_1320_length_2026_cov_18.457706	741	821	8	45	80	0.5625000
NODE_1320_length_2026_cov_18.457706	741	821	10	1	80	0.0125000
NODE_1320_length_2026_cov_18.457706	741	821	14	24	80	0.3000000
NODE_1324_length_2025_cov_10.711319	617	697	0	80	80	1.0000000
NODE_1324_length_2025_cov_10.711319	712	783	6	26	71	0.3661972
NODE_1324_length_2025_cov_10.711319	712	783	8	27	71	0.3802817
NODE_1324_length_2025_cov_10.711319	712	783	10	18	71	0.2535211
NODE_1324_length_2025_cov_10.711319	756	829	4	37	73	0.5068493
NODE_1324_length_2025_cov_10.711319	756	829	8	9	73	0.1232877
NODE_1324_length_2025_cov_10.711319	756	829	10	27	73	0.3698630
NODE_1325_length_2024_cov_33.891948	1045	1125	0	26	80	0.3250000
NODE_1325_length_2024_cov_33.891948	1045	1125	2	12	80	0.1500000
NODE_1325_length_2024_cov_33.891948	1045	1125	4	19	80	0.2375000
NODE_1325_length_2024_cov_33.891948	1045	1125	6	23	80	0.2875000
NODE_1325_length_2024_cov_33.891948	1098	1178	0	14	80	0.1750000
NODE_1325_length_2024_cov_33.891948	1098	1178	2	10	80	0.1250000
NODE_1325_length_2024_cov_33.891948	1098	1178	4	4	80	0.0500000
NODE_1325_length_2024_cov_33.891948	1098	1178	6	52	80	0.6500000
NODE_1331_length_2018_cov_33.742053	1215	1295	264	1	80	0.0125000
NODE_1331_length_2018_cov_33.742053	1215	1295	268	1	80	0.0125000
NODE_1331_length_2018_cov_33.742053	1215	1295	272	1	80	0.0125000
NODE_1331_length_2018_cov_33.742053	1215	1295	274	1	80	0.0125000
NODE_1331_length_2018_cov_33.742053	1215	1295	275	2	80	0.0250000
NODE_1331_length_2018_cov_33.742053	1215	1295	277	2	80	0.0250000
NODE_1331_length_2018_cov_33.742053	1215	1295	278	1	80	0.0125000
NODE_1331_length_2018_cov_33.742053	1215	1295	283	2	80	0.0250000
NODE_1331_length_2018_cov_33.742053	1215	1295	284	2	80	0.0250000
NODE_1331_length_2018_cov_33.742053	1215	1295	285	1	80	0.0125000
NODE_1331_length_2018_cov_33.742053	1215	1295	286	4	80	0.0500000
NODE_1331_length_2018_cov_33.742053	1215	1295	288	4	80	0.0500000
NODE_1331_length_2018_cov_33.742053	1215	1295	289	2	80	0.0250000
NODE_1331_length_2018_cov_33.742053	1215	1295	292	1	80	0.0125000
NODE_1331_length_2018_cov_33.742053	1215	1295	294	1	80	0.0125000
NODE_1331_length_2018_cov_33.742053	1215	1295	299	2	80	0.0250000
NODE_1331_length_2018_cov_33.742053	1215	1295	316	1	80	0.0125000
NODE_1331_length_2018_cov_33.742053	1215	1295	317	4	80	0.0500000
NODE_1331_length_2018_cov_33.742053	1215	1295	318	3	80	0.0375000
NODE_1331_length_2018_cov_33.742053	1215	1295	319	1	80	0.0125000
NODE_1331_length_2018_cov_33.742053	1215	1295	321	1	80	0.0125000
NODE_1331_length_2018_cov_33.742053	1215	1295	322	3	80	0.0375000
NODE_1331_length_2018_cov_33.742053	1215	1295	323	1	80	0.0125000
NODE_1331_length_2018_cov_33.742053	1215	1295	324	2	80	0.0250000
NODE_1331_length_2018_cov_33.742053	1215	1295	325	3	80	0.0375000
NODE_1331_length_2018_cov_33.742053	1215	1295	326	4	80	0.0500000
NODE_1331_length_2018_cov_33.742053	1215	1295	327	2	80	0.0250000
NODE_1331_length_2018_cov_33.742053	1215	1295	328	1	80	0.0125000
NODE_1331_length_2018_cov_33.742053	1215	1295	329	1	80	0.0125000
NODE_1331_length_2018_cov_33.742053	1215	1295	331	1	80	0.0125000
NODE_1331_length_2018_cov_33.742053	1215	1295	332	1	80	0.0125000
NODE_1331_length_2018_cov_33.742053	1215	1295	333	4	80	0.0500000
NODE_1331_length_2018_cov_33.742053	1215	1295	334	2	80	0.0250000
NODE_1331_length_2018_cov_33.742053	1215	1295	341	1	80	0.0125000
NODE_1331_length_2018_cov_33.742053	1215	1295	343	1	80	0.0125000
NODE_1331_length_2018_cov_33.742053	1215	1295	345	1	80	0.0125000
NODE_1331_length_2018_cov_33.742053	1215	1295	346	2	80	0.0250000
NODE_1331_length_2018_cov_33.742053	1215	1295	350	1	80	0.0125000
NODE_1331_length_2018_cov_33.742053	1215	1295	353	1	80	0.0125000
NODE_1331_length_2018_cov_33.742053	1215	1295	356	1	80	0.0125000
NODE_1331_length_2018_cov_33.742053	1215	1295	357	1	80	0.0125000
NODE_1331_length_2018_cov_33.742053	1215	1295	363	1	80	0.0125000
NODE_1331_length_2018_cov_33.742053	1215	1295	365	2	80	0.0250000
NODE_1331_length_2018_cov_33.742053	1215	1295	370	3	80	0.0375000
NODE_1331_length_2018_cov_33.742053	1215	1295	372	2	80	0.0250000
NODE_1331_length_2018_cov_33.742053	1268	1298	327	1	30	0.0333333
NODE_1331_length_2018_cov_33.742053	1268	1298	328	1	30	0.0333333
NODE_1331_length_2018_cov_33.742053	1268	1298	329	1	30	0.0333333
NODE_1331_length_2018_cov_33.742053	1268	1298	331	1	30	0.0333333
NODE_1331_length_2018_cov_33.742053	1268	1298	333	4	30	0.1333333
NODE_1331_length_2018_cov_33.742053	1268	1298	334	2	30	0.0666667
NODE_1331_length_2018_cov_33.742053	1268	1298	341	1	30	0.0333333
NODE_1331_length_2018_cov_33.742053	1268	1298	343	1	30	0.0333333
NODE_1331_length_2018_cov_33.742053	1268	1298	345	1	30	0.0333333
NODE_1331_length_2018_cov_33.742053	1268	1298	346	2	30	0.0666667
NODE_1331_length_2018_cov_33.742053	1268	1298	350	1	30	0.0333333
NODE_1331_length_2018_cov_33.742053	1268	1298	353	1	30	0.0333333
NODE_1331_length_2018_cov_33.742053	1268	1298	356	1	30	0.0333333
NODE_1331_length_2018_cov_33.742053	1268	1298	357	2	30	0.0666667
NODE_1331_length_2018_cov_33.742053	1268	1298	360	1	30	0.0333333
NODE_1331_length_2018_cov_33.742053	1268	1298	361	1	30	0.0333333
NODE_1331_length_2018_cov_33.742053	1268	1298	363	1	30	0.0333333
NODE_1331_length_2018_cov_33.742053	1268	1298	365	2	30	0.0666667
NODE_1331_length_2018_cov_33.742053	1268	1298	370	3	30	0.1000000
NODE_1331_length_2018_cov_33.742053	1268	1298	372	2	30	0.0666667
NODE_1331_length_2018_cov_33.742053	1876	1942	314	1	66	0.0151515
NODE_1331_length_2018_cov_33.742053	1876	1942	328	1	66	0.0151515
NODE_1331_length_2018_cov_33.742053	1876	1942	330	1	66	0.0151515
NODE_1331_length_2018_cov_33.742053	1876	1942	339	1	66	0.0151515
NODE_1331_length_2018_cov_33.742053	1876	1942	354	1	66	0.0151515
NODE_1331_length_2018_cov_33.742053	1876	1942	375	1	66	0.0151515
NODE_1331_length_2018_cov_33.742053	1876	1942	386	1	66	0.0151515
NODE_1331_length_2018_cov_33.742053	1876	1942	400	1	66	0.0151515
NODE_1331_length_2018_cov_33.742053	1876	1942	404	1	66	0.0151515
NODE_1331_length_2018_cov_33.742053	1876	1942	409	1	66	0.0151515
NODE_1331_length_2018_cov_33.742053	1876	1942	413	1	66	0.0151515
NODE_1331_length_2018_cov_33.742053	1876	1942	429	1	66	0.0151515
NODE_1331_length_2018_cov_33.742053	1876	1942	435	1	66	0.0151515
NODE_1331_length_2018_cov_33.742053	1876	1942	436	1	66	0.0151515
NODE_1331_length_2018_cov_33.742053	1876	1942	445	1	66	0.0151515
NODE_1331_length_2018_cov_33.742053	1876	1942	455	1	66	0.0151515
NODE_1331_length_2018_cov_33.742053	1876	1942	465	1	66	0.0151515
NODE_1331_length_2018_cov_33.742053	1876	1942	469	3	66	0.0454545
NODE_1331_length_2018_cov_33.742053	1876	1942	470	1	66	0.0151515
NODE_1331_length_2018_cov_33.742053	1876	1942	473	2	66	0.0303030
NODE_1331_length_2018_cov_33.742053	1876	1942	474	1	66	0.0151515
NODE_1331_length_2018_cov_33.742053	1876	1942	479	1	66	0.0151515
NODE_1331_length_2018_cov_33.742053	1876	1942	481	1	66	0.0151515
NODE_1331_length_2018_cov_33.742053	1876	1942	482	1	66	0.0151515
NODE_1331_length_2018_cov_33.742053	1876	1942	486	1	66	0.0151515
NODE_1331_length_2018_cov_33.742053	1876	1942	510	1	66	0.0151515
NODE_1331_length_2018_cov_33.742053	1876	1942	511	1	66	0.0151515
NODE_1331_length_2018_cov_33.742053	1876	1942	517	1	66	0.0151515
NODE_1331_length_2018_cov_33.742053	1876	1942	525	1	66	0.0151515
NODE_1331_length_2018_cov_33.742053	1876	1942	526	1	66	0.0151515
NODE_1331_length_2018_cov_33.742053	1876	1942	537	1	66	0.0151515
NODE_1331_length_2018_cov_33.742053	1876	1942	542	1	66	0.0151515
NODE_1331_length_2018_cov_33.742053	1876	1942	555	1	66	0.0151515
NODE_1331_length_2018_cov_33.742053	1876	1942	563	1	66	0.0151515
NODE_1331_length_2018_cov_33.742053	1876	1942	570	1	66	0.0151515
NODE_1331_length_2018_cov_33.742053	1876	1942	591	1	66	0.0151515
NODE_1331_length_2018_cov_33.742053	1876	1942	605	1	66	0.0151515
NODE_1331_length_2018_cov_33.742053	1876	1942	606	1	66	0.0151515
NODE_1331_length_2018_cov_33.742053	1876	1942	607	1	66	0.0151515
NODE_1331_length_2018_cov_33.742053	1876	1942	618	1	66	0.0151515
NODE_1331_length_2018_cov_33.742053	1876	1942	620	1	66	0.0151515
NODE_1331_length_2018_cov_33.742053	1876	1942	621	1	66	0.0151515
NODE_1331_length_2018_cov_33.742053	1876	1942	638	1	66	0.0151515
NODE_1331_length_2018_cov_33.742053	1876	1942	656	1	66	0.0151515
NODE_1331_length_2018_cov_33.742053	1876	1942	664	1	66	0.0151515
NODE_1331_length_2018_cov_33.742053	1876	1942	671	1	66	0.0151515
NODE_1331_length_2018_cov_33.742053	1876	1942	672	1	66	0.0151515
NODE_1331_length_2018_cov_33.742053	1876	1942	676	1	66	0.0151515
NODE_1331_length_2018_cov_33.742053	1876	1942	698	1	66	0.0151515
NODE_1331_length_2018_cov_33.742053	1876	1942	702	2	66	0.0303030
NODE_1331_length_2018_cov_33.742053	1876	1942	705	1	66	0.0151515
NODE_1331_length_2018_cov_33.742053	1876	1942	707	1	66	0.0151515
NODE_1331_length_2018_cov_33.742053	1876	1942	719	1	66	0.0151515
NODE_1331_length_2018_cov_33.742053	1876	1942	720	1	66	0.0151515
NODE_1331_length_2018_cov_33.742053	1876	1942	724	1	66	0.0151515
NODE_1331_length_2018_cov_33.742053	1876	1942	727	1	66	0.0151515
NODE_1331_length_2018_cov_33.742053	1876	1942	728	1	66	0.0151515
NODE_1331_length_2018_cov_33.742053	1876	1942	731	1	66	0.0151515
NODE_1331_length_2018_cov_33.742053	1876	1942	732	1	66	0.0151515
NODE_1331_length_2018_cov_33.742053	1876	1942	734	1	66	0.0151515
NODE_1331_length_2018_cov_33.742053	1876	1942	735	1	66	0.0151515
NODE_1331_length_2018_cov_33.742053	1876	1942	738	1	66	0.0151515
NODE_1331_length_2018_cov_33.742053	1915	1995	47	2	80	0.0250000
NODE_1331_length_2018_cov_33.742053	1915	1995	50	1	80	0.0125000
NODE_1331_length_2018_cov_33.742053	1915	1995	53	1	80	0.0125000
NODE_1331_length_2018_cov_33.742053	1915	1995	72	1	80	0.0125000
NODE_1331_length_2018_cov_33.742053	1915	1995	77	1	80	0.0125000
NODE_1331_length_2018_cov_33.742053	1915	1995	79	1	80	0.0125000
NODE_1331_length_2018_cov_33.742053	1915	1995	80	1	80	0.0125000
NODE_1331_length_2018_cov_33.742053	1915	1995	82	1	80	0.0125000
NODE_1331_length_2018_cov_33.742053	1915	1995	97	1	80	0.0125000
NODE_1331_length_2018_cov_33.742053	1915	1995	102	1	80	0.0125000
NODE_1331_length_2018_cov_33.742053	1915	1995	110	1	80	0.0125000
NODE_1331_length_2018_cov_33.742053	1915	1995	111	2	80	0.0250000
NODE_1331_length_2018_cov_33.742053	1915	1995	112	1	80	0.0125000
NODE_1331_length_2018_cov_33.742053	1915	1995	118	1	80	0.0125000
NODE_1331_length_2018_cov_33.742053	1915	1995	124	1	80	0.0125000
NODE_1331_length_2018_cov_33.742053	1915	1995	129	1	80	0.0125000
NODE_1331_length_2018_cov_33.742053	1915	1995	134	2	80	0.0250000
NODE_1331_length_2018_cov_33.742053	1915	1995	146	1	80	0.0125000
NODE_1331_length_2018_cov_33.742053	1915	1995	151	1	80	0.0125000
NODE_1331_length_2018_cov_33.742053	1915	1995	152	1	80	0.0125000
NODE_1331_length_2018_cov_33.742053	1915	1995	158	1	80	0.0125000
NODE_1331_length_2018_cov_33.742053	1915	1995	169	1	80	0.0125000
NODE_1331_length_2018_cov_33.742053	1915	1995	171	1	80	0.0125000
NODE_1331_length_2018_cov_33.742053	1915	1995	172	1	80	0.0125000
NODE_1331_length_2018_cov_33.742053	1915	1995	175	1	80	0.0125000
NODE_1331_length_2018_cov_33.742053	1915	1995	180	1	80	0.0125000
NODE_1331_length_2018_cov_33.742053	1915	1995	181	1	80	0.0125000
NODE_1331_length_2018_cov_33.742053	1915	1995	183	1	80	0.0125000
NODE_1331_length_2018_cov_33.742053	1915	1995	193	1	80	0.0125000
NODE_1331_length_2018_cov_33.742053	1915	1995	204	2	80	0.0250000
NODE_1331_length_2018_cov_33.742053	1915	1995	208	1	80	0.0125000
NODE_1331_length_2018_cov_33.742053	1915	1995	215	1	80	0.0125000
NODE_1331_length_2018_cov_33.742053	1915	1995	221	1	80	0.0125000
NODE_1331_length_2018_cov_33.742053	1915	1995	227	1	80	0.0125000
NODE_1331_length_2018_cov_33.742053	1915	1995	246	1	80	0.0125000
NODE_1331_length_2018_cov_33.742053	1915	1995	250	1	80	0.0125000
NODE_1331_length_2018_cov_33.742053	1915	1995	252	1	80	0.0125000
NODE_1331_length_2018_cov_33.742053	1915	1995	258	1	80	0.0125000
NODE_1331_length_2018_cov_33.742053	1915	1995	260	1	80	0.0125000
NODE_1331_length_2018_cov_33.742053	1915	1995	264	1	80	0.0125000
NODE_1331_length_2018_cov_33.742053	1915	1995	273	1	80	0.0125000
NODE_1331_length_2018_cov_33.742053	1915	1995	286	1	80	0.0125000
NODE_1331_length_2018_cov_33.742053	1915	1995	288	1	80	0.0125000
NODE_1331_length_2018_cov_33.742053	1915	1995	292	1	80	0.0125000
NODE_1331_length_2018_cov_33.742053	1915	1995	296	1	80	0.0125000
NODE_1331_length_2018_cov_33.742053	1915	1995	303	1	80	0.0125000
NODE_1331_length_2018_cov_33.742053	1915	1995	304	1	80	0.0125000
NODE_1331_length_2018_cov_33.742053	1915	1995	309	2	80	0.0250000
NODE_1331_length_2018_cov_33.742053	1915	1995	314	1	80	0.0125000
NODE_1331_length_2018_cov_33.742053	1915	1995	328	1	80	0.0125000
NODE_1331_length_2018_cov_33.742053	1915	1995	330	1	80	0.0125000
NODE_1331_length_2018_cov_33.742053	1915	1995	339	1	80	0.0125000
NODE_1331_length_2018_cov_33.742053	1915	1995	354	1	80	0.0125000
NODE_1331_length_2018_cov_33.742053	1915	1995	375	1	80	0.0125000
NODE_1331_length_2018_cov_33.742053	1915	1995	386	1	80	0.0125000
NODE_1331_length_2018_cov_33.742053	1915	1995	400	1	80	0.0125000
NODE_1331_length_2018_cov_33.742053	1915	1995	404	1	80	0.0125000
NODE_1331_length_2018_cov_33.742053	1915	1995	409	1	80	0.0125000
NODE_1331_length_2018_cov_33.742053	1915	1995	413	1	80	0.0125000
NODE_1331_length_2018_cov_33.742053	1915	1995	429	1	80	0.0125000
NODE_1331_length_2018_cov_33.742053	1915	1995	435	1	80	0.0125000
NODE_1331_length_2018_cov_33.742053	1915	1995	436	1	80	0.0125000
NODE_1331_length_2018_cov_33.742053	1915	1995	445	1	80	0.0125000
NODE_1331_length_2018_cov_33.742053	1915	1995	455	1	80	0.0125000
NODE_1331_length_2018_cov_33.742053	1915	1995	465	1	80	0.0125000
NODE_1331_length_2018_cov_33.742053	1915	1995	469	3	80	0.0375000
NODE_1331_length_2018_cov_33.742053	1915	1995	470	1	80	0.0125000
NODE_1331_length_2018_cov_33.742053	1915	1995	473	2	80	0.0250000
NODE_1331_length_2018_cov_33.742053	1915	1995	474	1	80	0.0125000
NODE_1331_length_2018_cov_33.742053	1915	1995	479	1	80	0.0125000
NODE_1331_length_2018_cov_33.742053	1915	1995	481	1	80	0.0125000
NODE_1331_length_2018_cov_33.742053	1915	1995	482	1	80	0.0125000
NODE_1337_length_2011_cov_22.430439	434	514	0	52	80	0.6500000
NODE_1337_length_2011_cov_22.430439	434	514	2	28	80	0.3500000
NODE_1337_length_2011_cov_22.430439	487	567	0	80	80	1.0000000
NODE_1337_length_2011_cov_22.430439	1124	1204	0	35	80	0.4375000
NODE_1337_length_2011_cov_22.430439	1124	1204	4	45	80	0.5625000
NODE_1337_length_2011_cov_22.430439	1177	1257	0	2	80	0.0250000
NODE_1337_length_2011_cov_22.430439	1177	1257	4	78	80	0.9750000
NODE_1343_length_2001_cov_10.416404	692	772	0	80	80	1.0000000
NODE_1343_length_2001_cov_10.416404	745	825	0	80	80	1.0000000
NODE_1350_length_1991_cov_112.926533	212	292	217	1	80	0.0125000
NODE_1350_length_1991_cov_112.926533	212	292	222	1	80	0.0125000
NODE_1350_length_1991_cov_112.926533	212	292	231	1	80	0.0125000
NODE_1350_length_1991_cov_112.926533	212	292	239	1	80	0.0125000
NODE_1350_length_1991_cov_112.926533	212	292	240	1	80	0.0125000
NODE_1350_length_1991_cov_112.926533	212	292	241	1	80	0.0125000
NODE_1350_length_1991_cov_112.926533	212	292	260	1	80	0.0125000
NODE_1350_length_1991_cov_112.926533	212	292	261	1	80	0.0125000
NODE_1350_length_1991_cov_112.926533	212	292	263	2	80	0.0250000
NODE_1350_length_1991_cov_112.926533	212	292	264	1	80	0.0125000
NODE_1350_length_1991_cov_112.926533	212	292	267	1	80	0.0125000
NODE_1350_length_1991_cov_112.926533	212	292	269	1	80	0.0125000
NODE_1350_length_1991_cov_112.926533	212	292	271	1	80	0.0125000
NODE_1350_length_1991_cov_112.926533	212	292	272	1	80	0.0125000
NODE_1350_length_1991_cov_112.926533	212	292	273	2	80	0.0250000
NODE_1350_length_1991_cov_112.926533	212	292	277	4	80	0.0500000
NODE_1350_length_1991_cov_112.926533	212	292	278	1	80	0.0125000
NODE_1350_length_1991_cov_112.926533	212	292	280	3	80	0.0375000
NODE_1350_length_1991_cov_112.926533	212	292	281	7	80	0.0875000
NODE_1350_length_1991_cov_112.926533	212	292	282	4	80	0.0500000
NODE_1350_length_1991_cov_112.926533	212	292	285	2	80	0.0250000
NODE_1350_length_1991_cov_112.926533	212	292	287	1	80	0.0125000
NODE_1350_length_1991_cov_112.926533	212	292	288	6	80	0.0750000
NODE_1350_length_1991_cov_112.926533	212	292	290	2	80	0.0250000
NODE_1350_length_1991_cov_112.926533	212	292	293	7	80	0.0875000
NODE_1350_length_1991_cov_112.926533	212	292	294	1	80	0.0125000
NODE_1350_length_1991_cov_112.926533	212	292	296	4	80	0.0500000
NODE_1350_length_1991_cov_112.926533	212	292	300	8	80	0.1000000
NODE_1350_length_1991_cov_112.926533	212	292	302	4	80	0.0500000
NODE_1350_length_1991_cov_112.926533	212	292	304	2	80	0.0250000
NODE_1350_length_1991_cov_112.926533	212	292	306	7	80	0.0875000
NODE_1352_length_1988_cov_13.736368	865	945	2	6	80	0.0750000
NODE_1352_length_1988_cov_13.736368	865	945	4	24	80	0.3000000
NODE_1352_length_1988_cov_13.736368	865	945	6	50	80	0.6250000
NODE_1352_length_1988_cov_13.736368	918	998	2	16	80	0.2000000
NODE_1352_length_1988_cov_13.736368	918	998	4	45	80	0.5625000
NODE_1352_length_1988_cov_13.736368	918	998	6	19	80	0.2375000
NODE_1353_length_1988_cov_9.980413	1616	1696	0	80	80	1.0000000
NODE_1353_length_1988_cov_9.980413	1669	1749	0	80	80	1.0000000
NODE_1356_length_1983_cov_17.332803	494	574	0	30	80	0.3750000
NODE_1356_length_1983_cov_17.332803	494	574	2	50	80	0.6250000
NODE_1356_length_1983_cov_17.332803	547	627	0	80	80	1.0000000
NODE_1356_length_1983_cov_17.332803	1600	1680	0	80	80	1.0000000
NODE_1356_length_1983_cov_17.332803	1653	1733	0	39	80	0.4875000
NODE_1356_length_1983_cov_17.332803	1653	1733	2	41	80	0.5125000
NODE_1359_length_1982_cov_17.164100	457	537	0	80	80	1.0000000
NODE_1359_length_1982_cov_17.164100	510	590	0	80	80	1.0000000
NODE_1359_length_1982_cov_17.164100	586	666	0	80	80	1.0000000
NODE_1359_length_1982_cov_17.164100	639	723	0	84	84	1.0000000
NODE_1360_length_1981_cov_46.444208	0	70	0	19	70	0.2714286
NODE_1360_length_1981_cov_46.444208	0	70	2	51	70	0.7285714
NODE_1362_length_1979_cov_1.630851	1554	1634	0	80	80	1.0000000
NODE_1364_length_1976_cov_1.959510	154	215	6	9	61	0.1475410
NODE_1364_length_1976_cov_1.959510	154	215	9	2	61	0.0327869
NODE_1364_length_1976_cov_1.959510	154	215	10	12	61	0.1967213
NODE_1364_length_1976_cov_1.959510	154	215	12	38	61	0.6229508
NODE_1364_length_1976_cov_1.959510	154	215	6	9	61	0.1475410
NODE_1364_length_1976_cov_1.959510	154	215	9	2	61	0.0327869
NODE_1364_length_1976_cov_1.959510	154	215	10	12	61	0.1967213
NODE_1364_length_1976_cov_1.959510	154	215	12	38	61	0.6229508
NODE_1364_length_1976_cov_1.959510	154	213	6	7	59	0.1186441
NODE_1364_length_1976_cov_1.959510	154	213	9	2	59	0.0338983
NODE_1364_length_1976_cov_1.959510	154	213	10	12	59	0.2033898
NODE_1364_length_1976_cov_1.959510	154	213	12	38	59	0.6440678
NODE_1365_length_1974_cov_8.058133	617	697	4	21	80	0.2625000
NODE_1365_length_1974_cov_8.058133	617	697	8	59	80	0.7375000
NODE_1365_length_1974_cov_8.058133	670	750	4	61	80	0.7625000
NODE_1365_length_1974_cov_8.058133	670	750	8	19	80	0.2375000
NODE_1366_length_1973_cov_14.885272	640	726	0	86	86	1.0000000
NODE_1366_length_1973_cov_14.885272	699	779	0	80	80	1.0000000
NODE_1366_length_1973_cov_14.885272	1389	1469	6	62	80	0.7750000
NODE_1366_length_1973_cov_14.885272	1389	1469	8	10	80	0.1250000
NODE_1366_length_1973_cov_14.885272	1389	1469	12	6	80	0.0750000
NODE_1366_length_1973_cov_14.885272	1389	1469	14	2	80	0.0250000
NODE_1366_length_1973_cov_14.885272	1442	1522	6	9	80	0.1125000
NODE_1366_length_1973_cov_14.885272	1442	1522	8	63	80	0.7875000
NODE_1366_length_1973_cov_14.885272	1442	1522	12	6	80	0.0750000
NODE_1366_length_1973_cov_14.885272	1442	1522	14	2	80	0.0250000
NODE_1372_length_1971_cov_3.126068	1662	1742	33	2	80	0.0250000
NODE_1372_length_1971_cov_3.126068	1662	1742	34	10	80	0.1250000
NODE_1372_length_1971_cov_3.126068	1662	1742	36	1	80	0.0125000
NODE_1372_length_1971_cov_3.126068	1662	1742	38	2	80	0.0250000
NODE_1372_length_1971_cov_3.126068	1662	1742	43	11	80	0.1375000
NODE_1372_length_1971_cov_3.126068	1662	1742	46	10	80	0.1250000
NODE_1372_length_1971_cov_3.126068	1662	1742	47	2	80	0.0250000
NODE_1372_length_1971_cov_3.126068	1662	1742	51	1	80	0.0125000
NODE_1372_length_1971_cov_3.126068	1662	1742	55	4	80	0.0500000
NODE_1372_length_1971_cov_3.126068	1662	1742	56	7	80	0.0875000
NODE_1372_length_1971_cov_3.126068	1662	1742	57	10	80	0.1250000
NODE_1372_length_1971_cov_3.126068	1662	1742	58	3	80	0.0375000
NODE_1372_length_1971_cov_3.126068	1662	1742	60	5	80	0.0625000
NODE_1372_length_1971_cov_3.126068	1662	1742	62	5	80	0.0625000
NODE_1372_length_1971_cov_3.126068	1662	1742	64	2	80	0.0250000
NODE_1372_length_1971_cov_3.126068	1662	1742	65	1	80	0.0125000
NODE_1372_length_1971_cov_3.126068	1662	1742	66	1	80	0.0125000
NODE_1372_length_1971_cov_3.126068	1662	1742	67	3	80	0.0375000
NODE_1372_length_1971_cov_3.126068	1715	1799	41	2	84	0.0238095
NODE_1372_length_1971_cov_3.126068	1715	1799	43	2	84	0.0238095
NODE_1372_length_1971_cov_3.126068	1715	1799	45	1	84	0.0119048
NODE_1372_length_1971_cov_3.126068	1715	1799	46	1	84	0.0119048
NODE_1372_length_1971_cov_3.126068	1715	1799	49	2	84	0.0238095
NODE_1372_length_1971_cov_3.126068	1715	1799	51	3	84	0.0357143
NODE_1372_length_1971_cov_3.126068	1715	1799	54	1	84	0.0119048
NODE_1372_length_1971_cov_3.126068	1715	1799	55	5	84	0.0595238
NODE_1372_length_1971_cov_3.126068	1715	1799	56	6	84	0.0714286
NODE_1372_length_1971_cov_3.126068	1715	1799	57	13	84	0.1547619
NODE_1372_length_1971_cov_3.126068	1715	1799	58	3	84	0.0357143
NODE_1372_length_1971_cov_3.126068	1715	1799	59	4	84	0.0476190
NODE_1372_length_1971_cov_3.126068	1715	1799	60	5	84	0.0595238
NODE_1372_length_1971_cov_3.126068	1715	1799	62	5	84	0.0595238
NODE_1372_length_1971_cov_3.126068	1715	1799	63	11	84	0.1309524
NODE_1372_length_1971_cov_3.126068	1715	1799	64	2	84	0.0238095
NODE_1372_length_1971_cov_3.126068	1715	1799	65	3	84	0.0357143
NODE_1372_length_1971_cov_3.126068	1715	1799	66	3	84	0.0357143
NODE_1372_length_1971_cov_3.126068	1715	1799	67	12	84	0.1428571
NODE_1386_length_1962_cov_23.774557	281	311	6	30	30	1.0000000
NODE_1386_length_1962_cov_23.774557	329	355	6	7	26	0.2692308
NODE_1386_length_1962_cov_23.774557	329	355	8	19	26	0.7307692
NODE_1386_length_1962_cov_23.774557	408	487	2	24	79	0.3037975
NODE_1386_length_1962_cov_23.774557	408	487	4	20	79	0.2531646
NODE_1386_length_1962_cov_23.774557	408	487	6	35	79	0.4430380
NODE_1386_length_1962_cov_23.774557	460	540	2	8	80	0.1000000
NODE_1386_length_1962_cov_23.774557	460	540	4	65	80	0.8125000
NODE_1386_length_1962_cov_23.774557	460	540	6	7	80	0.0875000
NODE_1386_length_1962_cov_23.774557	1417	1497	0	80	80	1.0000000
NODE_1386_length_1962_cov_23.774557	1470	1550	0	80	80	1.0000000
NODE_1386_length_1962_cov_23.774557	1607	1640	0	33	33	1.0000000
NODE_1395_length_1953_cov_26.183927	1	81	0	4	80	0.0500000
NODE_1395_length_1953_cov_26.183927	1	81	8	3	80	0.0375000
NODE_1395_length_1953_cov_26.183927	1	81	10	3	80	0.0375000
NODE_1395_length_1953_cov_26.183927	1	81	12	2	80	0.0250000
NODE_1395_length_1953_cov_26.183927	1	81	18	15	80	0.1875000
NODE_1395_length_1953_cov_26.183927	1	81	20	53	80	0.6625000
NODE_1395_length_1953_cov_26.183927	6	28	8	2	22	0.0909091
NODE_1395_length_1953_cov_26.183927	6	28	10	3	22	0.1363636
NODE_1395_length_1953_cov_26.183927	6	28	12	2	22	0.0909091
NODE_1395_length_1953_cov_26.183927	6	28	18	15	22	0.6818182
NODE_1395_length_1953_cov_26.183927	152	232	0	80	80	1.0000000
NODE_1395_length_1953_cov_26.183927	205	257	0	50	52	0.9615384
NODE_1395_length_1953_cov_26.183927	205	257	10	1	52	0.0192308
NODE_1395_length_1953_cov_26.183927	205	257	19	1	52	0.0192308
NODE_1405_length_1943_cov_11.218547	516	596	2	34	80	0.4250000
NODE_1405_length_1943_cov_11.218547	516	596	4	46	80	0.5750000
NODE_1405_length_1943_cov_11.218547	569	649	0	53	80	0.6625000
NODE_1405_length_1943_cov_11.218547	569	649	2	27	80	0.3375000
NODE_1408_length_1941_cov_14.407709	891	921	0	30	30	1.0000000
NODE_1408_length_1941_cov_14.407709	894	964	0	70	70	1.0000000
NODE_1408_length_1941_cov_14.407709	1878	1941	0	63	63	1.0000000
NODE_1409_length_1941_cov_9.632465	139	213	2	30	74	0.4054054
NODE_1409_length_1941_cov_9.632465	139	213	4	44	74	0.5945946
NODE_1409_length_1941_cov_9.632465	139	219	2	30	80	0.3750000
NODE_1409_length_1941_cov_9.632465	139	219	4	50	80	0.6250000
NODE_1409_length_1941_cov_9.632465	139	194	2	30	55	0.5454546
NODE_1409_length_1941_cov_9.632465	139	194	4	25	55	0.4545455
NODE_1409_length_1941_cov_9.632465	192	272	0	18	80	0.2250000
NODE_1409_length_1941_cov_9.632465	192	272	2	14	80	0.1750000
NODE_1409_length_1941_cov_9.632465	192	272	4	48	80	0.6000000
NODE_1414_length_1936_cov_13.338596	679	759	4	6	80	0.0750000
NODE_1414_length_1936_cov_13.338596	679	759	6	18	80	0.2250000
NODE_1414_length_1936_cov_13.338596	679	759	14	40	80	0.5000000
NODE_1414_length_1936_cov_13.338596	679	759	16	6	80	0.0750000
NODE_1414_length_1936_cov_13.338596	679	759	18	10	80	0.1250000
NODE_1414_length_1936_cov_13.338596	732	812	6	30	80	0.3750000
NODE_1414_length_1936_cov_13.338596	732	812	8	19	80	0.2375000
NODE_1414_length_1936_cov_13.338596	732	812	10	22	80	0.2750000
NODE_1414_length_1936_cov_13.338596	732	812	18	9	80	0.1125000
NODE_1414_length_1936_cov_13.338596	738	812	6	30	74	0.4054054
NODE_1414_length_1936_cov_13.338596	738	812	8	19	74	0.2567568
NODE_1414_length_1936_cov_13.338596	738	812	10	22	74	0.2972973
NODE_1414_length_1936_cov_13.338596	738	812	18	3	74	0.0405405
NODE_1414_length_1936_cov_13.338596	738	759	6	18	21	0.8571429
NODE_1414_length_1936_cov_13.338596	738	759	18	3	21	0.1428571
NODE_1415_length_1936_cov_12.592814	102	153	0	27	51	0.5294118
NODE_1415_length_1936_cov_12.592814	102	153	2	24	51	0.4705882
NODE_1415_length_1936_cov_12.592814	154	230	18	1	76	0.0131579
NODE_1415_length_1936_cov_12.592814	154	230	20	3	76	0.0394737
NODE_1415_length_1936_cov_12.592814	154	230	22	1	76	0.0131579
NODE_1415_length_1936_cov_12.592814	154	230	24	2	76	0.0263158
NODE_1415_length_1936_cov_12.592814	154	230	26	2	76	0.0263158
NODE_1415_length_1936_cov_12.592814	154	230	28	5	76	0.0657895
NODE_1415_length_1936_cov_12.592814	154	230	30	9	76	0.1184211
NODE_1415_length_1936_cov_12.592814	154	230	32	53	76	0.6973684
NODE_1415_length_1936_cov_12.592814	211	251	10	3	40	0.0750000
NODE_1415_length_1936_cov_12.592814	211	251	18	11	40	0.2750000
NODE_1415_length_1936_cov_12.592814	211	251	20	4	40	0.1000000
NODE_1415_length_1936_cov_12.592814	211	251	26	5	40	0.1250000
NODE_1415_length_1936_cov_12.592814	211	251	28	3	40	0.0750000
NODE_1415_length_1936_cov_12.592814	211	251	32	14	40	0.3500000
NODE_1416_length_1933_cov_86.724646	1044	1124	2	53	80	0.6625000
NODE_1416_length_1933_cov_86.724646	1044	1124	4	27	80	0.3375000
NODE_1416_length_1933_cov_86.724646	1097	1177	0	44	80	0.5500000
NODE_1416_length_1933_cov_86.724646	1097	1177	2	36	80	0.4500000
NODE_1416_length_1933_cov_86.724646	1173	1253	0	69	80	0.8625000
NODE_1416_length_1933_cov_86.724646	1173	1253	2	11	80	0.1375000
NODE_1416_length_1933_cov_86.724646	1226	1306	0	16	80	0.2000000
NODE_1416_length_1933_cov_86.724646	1226	1306	2	64	80	0.8000000
NODE_1419_length_1932_cov_5.905074	1534	1614	6	32	80	0.4000000
NODE_1419_length_1932_cov_5.905074	1534	1614	8	48	80	0.6000000
NODE_1422_length_1930_cov_3.005461	1700	1780	105	1	80	0.0125000
NODE_1422_length_1930_cov_3.005461	1700	1780	121	4	80	0.0500000
NODE_1422_length_1930_cov_3.005461	1700	1780	123	6	80	0.0750000
NODE_1422_length_1930_cov_3.005461	1700	1780	125	2	80	0.0250000
NODE_1422_length_1930_cov_3.005461	1700	1780	131	2	80	0.0250000
NODE_1422_length_1930_cov_3.005461	1700	1780	133	3	80	0.0375000
NODE_1422_length_1930_cov_3.005461	1700	1780	136	3	80	0.0375000
NODE_1422_length_1930_cov_3.005461	1700	1780	140	3	80	0.0375000
NODE_1422_length_1930_cov_3.005461	1700	1780	142	10	80	0.1250000
NODE_1422_length_1930_cov_3.005461	1700	1780	147	12	80	0.1500000
NODE_1422_length_1930_cov_3.005461	1700	1780	148	34	80	0.4250000
NODE_1427_length_1928_cov_2.580098	74	131	76	1	57	0.0175439
NODE_1427_length_1928_cov_2.580098	74	131	81	1	57	0.0175439
NODE_1427_length_1928_cov_2.580098	74	131	84	1	57	0.0175439
NODE_1427_length_1928_cov_2.580098	74	131	86	6	57	0.1052632
NODE_1427_length_1928_cov_2.580098	74	131	88	1	57	0.0175439
NODE_1427_length_1928_cov_2.580098	74	131	98	10	57	0.1754386
NODE_1427_length_1928_cov_2.580098	74	131	100	3	57	0.0526316
NODE_1427_length_1928_cov_2.580098	74	131	102	22	57	0.3859649
NODE_1427_length_1928_cov_2.580098	74	131	104	1	57	0.0175439
NODE_1427_length_1928_cov_2.580098	74	131	106	11	57	0.1929825
NODE_1427_length_1928_cov_2.580098	127	184	37	7	57	0.1228070
NODE_1427_length_1928_cov_2.580098	127	184	51	3	57	0.0526316
NODE_1427_length_1928_cov_2.580098	127	184	53	1	57	0.0175439
NODE_1427_length_1928_cov_2.580098	127	184	55	2	57	0.0350877
NODE_1427_length_1928_cov_2.580098	127	184	57	5	57	0.0877193
NODE_1427_length_1928_cov_2.580098	127	184	59	1	57	0.0175439
NODE_1427_length_1928_cov_2.580098	127	184	69	1	57	0.0175439
NODE_1427_length_1928_cov_2.580098	127	184	77	1	57	0.0175439
NODE_1427_length_1928_cov_2.580098	127	184	78	3	57	0.0526316
NODE_1427_length_1928_cov_2.580098	127	184	80	5	57	0.0877193
NODE_1427_length_1928_cov_2.580098	127	184	82	1	57	0.0175439
NODE_1427_length_1928_cov_2.580098	127	184	88	1	57	0.0175439
NODE_1427_length_1928_cov_2.580098	127	184	89	2	57	0.0350877
NODE_1427_length_1928_cov_2.580098	127	184	90	6	57	0.1052632
NODE_1427_length_1928_cov_2.580098	127	184	92	2	57	0.0350877
NODE_1427_length_1928_cov_2.580098	127	184	95	1	57	0.0175439
NODE_1427_length_1928_cov_2.580098	127	184	97	1	57	0.0175439
NODE_1427_length_1928_cov_2.580098	127	184	99	4	57	0.0701754
NODE_1427_length_1928_cov_2.580098	127	184	101	4	57	0.0701754
NODE_1427_length_1928_cov_2.580098	127	184	102	6	57	0.1052632
NODE_1434_length_1919_cov_17.901099	454	529	0	75	75	1.0000000
NODE_1434_length_1919_cov_17.901099	507	558	0	50	51	0.9803922
NODE_1434_length_1919_cov_17.901099	507	558	2	1	51	0.0196078
NODE_1436_length_1918_cov_14.876855	314	396	16	10	82	0.1219512
NODE_1436_length_1918_cov_14.876855	314	396	18	3	82	0.0365854
NODE_1436_length_1918_cov_14.876855	314	396	20	21	82	0.2560976
NODE_1436_length_1918_cov_14.876855	314	396	22	48	82	0.5853658
NODE_1438_length_1918_cov_3.493128	9	55	0	5	46	0.1086956
NODE_1438_length_1918_cov_3.493128	9	55	4	17	46	0.3695652
NODE_1438_length_1918_cov_3.493128	9	55	6	16	46	0.3478261
NODE_1438_length_1918_cov_3.493128	9	55	8	4	46	0.0869565
NODE_1438_length_1918_cov_3.493128	9	55	12	4	46	0.0869565
NODE_1438_length_1918_cov_3.493128	1480	1561	0	81	81	1.0000000
NODE_1440_length_1916_cov_4.426527	162	192	0	30	30	1.0000000
NODE_1442_length_1915_cov_35.787996	106	186	35	3	80	0.0375000
NODE_1442_length_1915_cov_35.787996	106	186	37	3	80	0.0375000
NODE_1442_length_1915_cov_35.787996	106	186	41	2	80	0.0250000
NODE_1442_length_1915_cov_35.787996	106	186	47	3	80	0.0375000
NODE_1442_length_1915_cov_35.787996	106	186	49	3	80	0.0375000
NODE_1442_length_1915_cov_35.787996	106	186	51	1	80	0.0125000
NODE_1442_length_1915_cov_35.787996	106	186	55	3	80	0.0375000
NODE_1442_length_1915_cov_35.787996	106	186	61	6	80	0.0750000
NODE_1442_length_1915_cov_35.787996	106	186	63	1	80	0.0125000
NODE_1442_length_1915_cov_35.787996	106	186	65	4	80	0.0500000
NODE_1442_length_1915_cov_35.787996	106	186	69	1	80	0.0125000
NODE_1442_length_1915_cov_35.787996	106	186	73	1	80	0.0125000
NODE_1442_length_1915_cov_35.787996	106	186	75	3	80	0.0375000
NODE_1442_length_1915_cov_35.787996	106	186	79	3	80	0.0375000
NODE_1442_length_1915_cov_35.787996	106	186	80	9	80	0.1125000
NODE_1442_length_1915_cov_35.787996	106	186	82	3	80	0.0375000
NODE_1442_length_1915_cov_35.787996	106	186	84	6	80	0.0750000
NODE_1442_length_1915_cov_35.787996	106	186	88	5	80	0.0625000
NODE_1442_length_1915_cov_35.787996	106	186	90	6	80	0.0750000
NODE_1442_length_1915_cov_35.787996	106	186	94	5	80	0.0625000
NODE_1442_length_1915_cov_35.787996	106	186	96	1	80	0.0125000
NODE_1442_length_1915_cov_35.787996	106	186	98	8	80	0.1000000
NODE_1451_length_1905_cov_18.464563	740	820	0	26	80	0.3250000
NODE_1451_length_1905_cov_18.464563	740	820	4	11	80	0.1375000
NODE_1451_length_1905_cov_18.464563	740	820	6	30	80	0.3750000
NODE_1451_length_1905_cov_18.464563	740	820	12	13	80	0.1625000
NODE_1451_length_1905_cov_18.464563	793	873	6	27	80	0.3375000
NODE_1451_length_1905_cov_18.464563	793	873	8	35	80	0.4375000
NODE_1451_length_1905_cov_18.464563	793	873	12	18	80	0.2250000
NODE_1451_length_1905_cov_18.464563	869	949	2	16	80	0.2000000
NODE_1451_length_1905_cov_18.464563	869	949	6	19	80	0.2375000
NODE_1451_length_1905_cov_18.464563	869	949	7	36	80	0.4500000
NODE_1451_length_1905_cov_18.464563	869	949	8	9	80	0.1125000
NODE_1451_length_1905_cov_18.464563	922	1010	0	18	88	0.2045455
NODE_1451_length_1905_cov_18.464563	922	1010	2	59	88	0.6704546
NODE_1451_length_1905_cov_18.464563	922	1010	7	11	88	0.1250000
NODE_1452_length_1905_cov_7.197121	596	676	0	46	80	0.5750000
NODE_1452_length_1905_cov_7.197121	596	676	2	34	80	0.4250000
NODE_1452_length_1905_cov_7.197121	649	682	2	33	33	1.0000000
NODE_1455_length_1902_cov_1.633943	1728	1792	48	2	64	0.0312500
NODE_1455_length_1902_cov_1.633943	1728	1792	50	1	64	0.0156250
NODE_1455_length_1902_cov_1.633943	1728	1792	59	2	64	0.0312500
NODE_1455_length_1902_cov_1.633943	1728	1792	63	1	64	0.0156250
NODE_1455_length_1902_cov_1.633943	1728	1792	65	3	64	0.0468750
NODE_1455_length_1902_cov_1.633943	1728	1792	68	1	64	0.0156250
NODE_1455_length_1902_cov_1.633943	1728	1792	69	1	64	0.0156250
NODE_1455_length_1902_cov_1.633943	1728	1792	71	2	64	0.0312500
NODE_1455_length_1902_cov_1.633943	1728	1792	77	1	64	0.0156250
NODE_1455_length_1902_cov_1.633943	1728	1792	79	3	64	0.0468750
NODE_1455_length_1902_cov_1.633943	1728	1792	81	3	64	0.0468750
NODE_1455_length_1902_cov_1.633943	1728	1792	86	1	64	0.0156250
NODE_1455_length_1902_cov_1.633943	1728	1792	88	9	64	0.1406250
NODE_1455_length_1902_cov_1.633943	1728	1792	92	7	64	0.1093750
NODE_1455_length_1902_cov_1.633943	1728	1792	96	2	64	0.0312500
NODE_1455_length_1902_cov_1.633943	1728	1792	98	3	64	0.0468750
NODE_1455_length_1902_cov_1.633943	1728	1792	99	3	64	0.0468750
NODE_1455_length_1902_cov_1.633943	1728	1792	101	14	64	0.2187500
NODE_1455_length_1902_cov_1.633943	1728	1792	103	5	64	0.0781250
NODE_1458_length_1900_cov_1.081066	1805	1851	4	46	46	1.0000000
NODE_1458_length_1900_cov_1.081066	1824	1900	0	4	76	0.0526316
NODE_1458_length_1900_cov_1.081066	1824	1900	3	1	76	0.0131579
NODE_1458_length_1900_cov_1.081066	1824	1900	4	71	76	0.9342105
NODE_1461_length_1895_cov_17.940980	1070	1150	2	1	80	0.0125000
NODE_1461_length_1895_cov_17.940980	1070	1150	4	11	80	0.1375000
NODE_1461_length_1895_cov_17.940980	1070	1150	10	52	80	0.6500000
NODE_1461_length_1895_cov_17.940980	1070	1150	12	16	80	0.2000000
NODE_1461_length_1895_cov_17.940980	1123	1203	4	5	80	0.0625000
NODE_1461_length_1895_cov_17.940980	1123	1203	10	63	80	0.7875000
NODE_1461_length_1895_cov_17.940980	1123	1203	12	12	80	0.1500000
NODE_1466_length_1893_cov_3.299331	918	998	2	57	80	0.7125000
NODE_1466_length_1893_cov_3.299331	918	998	4	23	80	0.2875000
NODE_1467_length_1892_cov_5.158394	317	397	2	63	80	0.7875000
NODE_1467_length_1892_cov_5.158394	317	397	4	17	80	0.2125000
NODE_1467_length_1892_cov_5.158394	370	445	0	1	75	0.0133333
NODE_1467_length_1892_cov_5.158394	370	445	2	68	75	0.9066667
NODE_1467_length_1892_cov_5.158394	370	445	4	6	75	0.0800000
NODE_1469_length_1889_cov_4.049162	1652	1686	0	15	34	0.4411765
NODE_1469_length_1889_cov_4.049162	1652	1686	2	19	34	0.5588235
NODE_1470_length_1889_cov_3.888268	960	1040	0	80	80	1.0000000
NODE_1470_length_1889_cov_3.888268	1013	1093	0	80	80	1.0000000
NODE_1472_length_1888_cov_17.106764	15	96	69	3	81	0.0370370
NODE_1472_length_1888_cov_17.106764	15	96	73	1	81	0.0123457
NODE_1472_length_1888_cov_17.106764	15	96	78	2	81	0.0246914
NODE_1472_length_1888_cov_17.106764	15	96	80	2	81	0.0246914
NODE_1472_length_1888_cov_17.106764	15	96	84	1	81	0.0123457
NODE_1472_length_1888_cov_17.106764	15	96	90	2	81	0.0246914
NODE_1472_length_1888_cov_17.106764	15	96	100	3	81	0.0370370
NODE_1472_length_1888_cov_17.106764	15	96	104	1	81	0.0123457
NODE_1472_length_1888_cov_17.106764	15	96	110	3	81	0.0370370
NODE_1472_length_1888_cov_17.106764	15	96	111	12	81	0.1481481
NODE_1472_length_1888_cov_17.106764	15	96	112	10	81	0.1234568
NODE_1472_length_1888_cov_17.106764	15	96	118	4	81	0.0493827
NODE_1472_length_1888_cov_17.106764	15	96	122	11	81	0.1358025
NODE_1472_length_1888_cov_17.106764	15	96	124	8	81	0.0987654
NODE_1472_length_1888_cov_17.106764	15	96	126	13	81	0.1604938
NODE_1472_length_1888_cov_17.106764	15	96	128	5	81	0.0617284
NODE_1472_length_1888_cov_17.106764	68	143	32	4	75	0.0533333
NODE_1472_length_1888_cov_17.106764	68	143	37	4	75	0.0533333
NODE_1472_length_1888_cov_17.106764	68	143	39	1	75	0.0133333
NODE_1472_length_1888_cov_17.106764	68	143	43	1	75	0.0133333
NODE_1472_length_1888_cov_17.106764	68	143	63	1	75	0.0133333
NODE_1472_length_1888_cov_17.106764	68	143	69	1	75	0.0133333
NODE_1472_length_1888_cov_17.106764	68	143	77	1	75	0.0133333
NODE_1472_length_1888_cov_17.106764	68	143	83	1	75	0.0133333
NODE_1472_length_1888_cov_17.106764	68	143	86	1	75	0.0133333
NODE_1472_length_1888_cov_17.106764	68	143	88	3	75	0.0400000
NODE_1472_length_1888_cov_17.106764	68	143	90	1	75	0.0133333
NODE_1472_length_1888_cov_17.106764	68	143	94	1	75	0.0133333
NODE_1472_length_1888_cov_17.106764	68	143	100	1	75	0.0133333
NODE_1472_length_1888_cov_17.106764	68	143	102	3	75	0.0400000
NODE_1472_length_1888_cov_17.106764	68	143	104	1	75	0.0133333
NODE_1472_length_1888_cov_17.106764	68	143	106	1	75	0.0133333
NODE_1472_length_1888_cov_17.106764	68	143	108	1	75	0.0133333
NODE_1472_length_1888_cov_17.106764	68	143	111	1	75	0.0133333
NODE_1472_length_1888_cov_17.106764	68	143	112	1	75	0.0133333
NODE_1472_length_1888_cov_17.106764	68	143	114	1	75	0.0133333
NODE_1472_length_1888_cov_17.106764	68	143	121	2	75	0.0266667
NODE_1472_length_1888_cov_17.106764	68	143	122	2	75	0.0266667
NODE_1472_length_1888_cov_17.106764	68	143	123	3	75	0.0400000
NODE_1472_length_1888_cov_17.106764	68	143	124	9	75	0.1200000
NODE_1472_length_1888_cov_17.106764	68	143	126	13	75	0.1733333
NODE_1472_length_1888_cov_17.106764	68	143	128	6	75	0.0800000
NODE_1472_length_1888_cov_17.106764	68	143	130	10	75	0.1333333
NODE_1477_length_1885_cov_4.439530	441	521	2	80	80	1.0000000
NODE_1477_length_1885_cov_4.439530	494	574	0	52	80	0.6500000
NODE_1477_length_1885_cov_4.439530	494	574	2	28	80	0.3500000
NODE_1483_length_1882_cov_5.884464	1499	1579	2	14	80	0.1750000
NODE_1483_length_1882_cov_5.884464	1499	1579	4	66	80	0.8250000
NODE_1483_length_1882_cov_5.884464	1552	1632	0	10	80	0.1250000
NODE_1483_length_1882_cov_5.884464	1552	1632	2	34	80	0.4250000
NODE_1483_length_1882_cov_5.884464	1552	1632	4	36	80	0.4500000
NODE_1493_length_1875_cov_3.974662	1650	1730	6	12	80	0.1500000
NODE_1493_length_1875_cov_3.974662	1650	1730	8	10	80	0.1250000
NODE_1493_length_1875_cov_3.974662	1650	1730	10	21	80	0.2625000
NODE_1493_length_1875_cov_3.974662	1650	1730	12	2	80	0.0250000
NODE_1493_length_1875_cov_3.974662	1650	1730	14	8	80	0.1000000
NODE_1493_length_1875_cov_3.974662	1650	1730	18	1	80	0.0125000
NODE_1493_length_1875_cov_3.974662	1650	1730	20	26	80	0.3250000
NODE_1497_length_1872_cov_21.355330	153	201	0	48	48	1.0000000
NODE_1503_length_1868_cov_96.046919	1018	1098	12	26	80	0.3250000
NODE_1503_length_1868_cov_96.046919	1018	1098	14	7	80	0.0875000
NODE_1503_length_1868_cov_96.046919	1018	1098	16	1	80	0.0125000
NODE_1503_length_1868_cov_96.046919	1018	1098	18	4	80	0.0500000
NODE_1503_length_1868_cov_96.046919	1018	1098	22	8	80	0.1000000
NODE_1503_length_1868_cov_96.046919	1018	1098	34	6	80	0.0750000
NODE_1503_length_1868_cov_96.046919	1018	1098	40	15	80	0.1875000
NODE_1503_length_1868_cov_96.046919	1018	1098	44	2	80	0.0250000
NODE_1503_length_1868_cov_96.046919	1018	1098	45	2	80	0.0250000
NODE_1503_length_1868_cov_96.046919	1018	1098	47	1	80	0.0125000
NODE_1503_length_1868_cov_96.046919	1018	1098	48	3	80	0.0375000
NODE_1503_length_1868_cov_96.046919	1018	1098	49	5	80	0.0625000
NODE_1503_length_1868_cov_96.046919	1071	1151	40	15	80	0.1875000
NODE_1503_length_1868_cov_96.046919	1071	1151	44	7	80	0.0875000
NODE_1503_length_1868_cov_96.046919	1071	1151	45	2	80	0.0250000
NODE_1503_length_1868_cov_96.046919	1071	1151	46	20	80	0.2500000
NODE_1503_length_1868_cov_96.046919	1071	1151	47	1	80	0.0125000
NODE_1503_length_1868_cov_96.046919	1071	1151	48	3	80	0.0375000
NODE_1503_length_1868_cov_96.046919	1071	1151	49	7	80	0.0875000
NODE_1503_length_1868_cov_96.046919	1071	1151	50	4	80	0.0500000
NODE_1503_length_1868_cov_96.046919	1071	1151	51	2	80	0.0250000
NODE_1503_length_1868_cov_96.046919	1071	1151	52	15	80	0.1875000
NODE_1503_length_1868_cov_96.046919	1071	1151	53	2	80	0.0250000
NODE_1503_length_1868_cov_96.046919	1071	1151	54	2	80	0.0250000
NODE_1508_length_1866_cov_53.869270	1149	1229	0	80	80	1.0000000
NODE_1508_length_1866_cov_53.869270	1202	1282	0	80	80	1.0000000
NODE_1508_length_1866_cov_53.869270	1278	1358	0	80	80	1.0000000
NODE_1508_length_1866_cov_53.869270	1331	1411	0	80	80	1.0000000
NODE_1510_length_1866_cov_3.347482	888	966	2	34	78	0.4358974
NODE_1510_length_1866_cov_3.347482	888	966	4	44	78	0.5641026
NODE_1510_length_1866_cov_3.347482	939	1019	0	24	80	0.3000000
NODE_1510_length_1866_cov_3.347482	939	1019	2	56	80	0.7000000
NODE_1513_length_1863_cov_11.265306	698	778	2	80	80	1.0000000
NODE_1513_length_1863_cov_11.265306	751	831	0	36	80	0.4500000
NODE_1513_length_1863_cov_11.265306	751	831	2	44	80	0.5500000
NODE_1518_length_1858_cov_19.019329	23	85	4	62	62	1.0000000
NODE_1518_length_1858_cov_19.019329	1125	1205	0	80	80	1.0000000
NODE_1518_length_1858_cov_19.019329	1178	1256	0	78	78	1.0000000
NODE_1518_length_1858_cov_19.019329	1387	1464	2	41	77	0.5324675
NODE_1518_length_1858_cov_19.019329	1387	1464	4	36	77	0.4675325
NODE_1518_length_1858_cov_19.019329	1440	1503	2	22	63	0.3492064
NODE_1518_length_1858_cov_19.019329	1440	1503	4	41	63	0.6507937
NODE_1519_length_1857_cov_18.402730	1282	1348	0	60	66	0.9090909
NODE_1519_length_1857_cov_18.402730	1282	1348	2	6	66	0.0909091
NODE_1519_length_1857_cov_18.402730	1321	1401	0	21	80	0.2625000
NODE_1519_length_1857_cov_18.402730	1321	1401	2	59	80	0.7375000
NODE_1519_length_1857_cov_18.402730	1397	1477	0	30	80	0.3750000
NODE_1519_length_1857_cov_18.402730	1397	1477	2	50	80	0.6250000
NODE_1519_length_1857_cov_18.402730	1450	1530	0	80	80	1.0000000
NODE_1531_length_1845_cov_12.653494	473	553	0	80	80	1.0000000
NODE_1531_length_1845_cov_12.653494	526	606	0	80	80	1.0000000
NODE_1546_length_1833_cov_31.337947	810	888	0	78	78	1.0000000
NODE_1546_length_1833_cov_31.337947	861	941	0	80	80	1.0000000
NODE_1546_length_1833_cov_31.337947	937	1017	0	43	80	0.5375000
NODE_1546_length_1833_cov_31.337947	937	1017	4	37	80	0.4625000
NODE_1546_length_1833_cov_31.337947	990	1070	0	15	80	0.1875000
NODE_1546_length_1833_cov_31.337947	990	1070	4	65	80	0.8125000
NODE_1550_length_1831_cov_3.065820	112	154	26	3	42	0.0714286
NODE_1550_length_1831_cov_3.065820	112	154	28	1	42	0.0238095
NODE_1550_length_1831_cov_3.065820	112	154	30	5	42	0.1190476
NODE_1550_length_1831_cov_3.065820	112	154	36	1	42	0.0238095
NODE_1550_length_1831_cov_3.065820	112	154	38	1	42	0.0238095
NODE_1550_length_1831_cov_3.065820	112	154	39	3	42	0.0714286
NODE_1550_length_1831_cov_3.065820	112	154	41	3	42	0.0714286
NODE_1550_length_1831_cov_3.065820	112	154	42	2	42	0.0476190
NODE_1550_length_1831_cov_3.065820	112	154	49	1	42	0.0238095
NODE_1550_length_1831_cov_3.065820	112	154	50	1	42	0.0238095
NODE_1550_length_1831_cov_3.065820	112	154	54	1	42	0.0238095
NODE_1550_length_1831_cov_3.065820	112	154	60	2	42	0.0476190
NODE_1550_length_1831_cov_3.065820	112	154	68	1	42	0.0238095
NODE_1550_length_1831_cov_3.065820	112	154	70	5	42	0.1190476
NODE_1550_length_1831_cov_3.065820	112	154	72	6	42	0.1428571
NODE_1550_length_1831_cov_3.065820	112	154	74	3	42	0.0714286
NODE_1550_length_1831_cov_3.065820	112	154	76	3	42	0.0714286
NODE_1553_length_1830_cov_2.512998	123	203	10	27	80	0.3375000
NODE_1553_length_1830_cov_2.512998	123	203	14	53	80	0.6625000
NODE_1553_length_1830_cov_2.512998	176	256	4	26	80	0.3250000
NODE_1553_length_1830_cov_2.512998	176	256	13	1	80	0.0125000
NODE_1553_length_1830_cov_2.512998	176	256	14	53	80	0.6625000
NODE_1553_length_1830_cov_2.512998	308	357	0	3	49	0.0612245
NODE_1553_length_1830_cov_2.512998	308	357	2	46	49	0.9387755
NODE_1554_length_1828_cov_40.437825	789	869	2	80	80	1.0000000
NODE_1554_length_1828_cov_40.437825	842	922	0	27	80	0.3375000
NODE_1554_length_1828_cov_40.437825	842	922	2	53	80	0.6625000
NODE_1554_length_1828_cov_40.437825	918	998	0	20	80	0.2500000
NODE_1554_length_1828_cov_40.437825	918	998	1	1	80	0.0125000
NODE_1554_length_1828_cov_40.437825	918	998	8	51	80	0.6375000
NODE_1554_length_1828_cov_40.437825	918	998	14	8	80	0.1000000
NODE_1554_length_1828_cov_40.437825	971	1051	8	19	80	0.2375000
NODE_1554_length_1828_cov_40.437825	971	1051	14	61	80	0.7625000
NODE_1559_length_1825_cov_6.652955	641	689	0	48	48	1.0000000
NODE_1559_length_1825_cov_6.652955	694	744	2	11	50	0.2200000
NODE_1559_length_1825_cov_6.652955	694	744	4	39	50	0.7800000
NODE_1562_length_1824_cov_10.152464	685	765	16	4	80	0.0500000
NODE_1562_length_1824_cov_10.152464	685	765	19	6	80	0.0750000
NODE_1562_length_1824_cov_10.152464	685	765	20	4	80	0.0500000
NODE_1562_length_1824_cov_10.152464	685	765	21	22	80	0.2750000
NODE_1562_length_1824_cov_10.152464	685	765	23	20	80	0.2500000
NODE_1562_length_1824_cov_10.152464	685	765	27	3	80	0.0375000
NODE_1562_length_1824_cov_10.152464	685	765	28	2	80	0.0250000
NODE_1562_length_1824_cov_10.152464	685	765	29	3	80	0.0375000
NODE_1562_length_1824_cov_10.152464	685	765	31	15	80	0.1875000
NODE_1562_length_1824_cov_10.152464	685	765	35	1	80	0.0125000
NODE_1562_length_1824_cov_10.152464	738	818	16	24	80	0.3000000
NODE_1562_length_1824_cov_10.152464	738	818	20	9	80	0.1125000
NODE_1562_length_1824_cov_10.152464	738	818	22	1	80	0.0125000
NODE_1562_length_1824_cov_10.152464	738	818	23	3	80	0.0375000
NODE_1562_length_1824_cov_10.152464	738	818	24	4	80	0.0500000
NODE_1562_length_1824_cov_10.152464	738	818	27	3	80	0.0375000
NODE_1562_length_1824_cov_10.152464	738	818	28	8	80	0.1000000
NODE_1562_length_1824_cov_10.152464	738	818	29	3	80	0.0375000
NODE_1562_length_1824_cov_10.152464	738	818	30	1	80	0.0125000
NODE_1562_length_1824_cov_10.152464	738	818	31	15	80	0.1875000
NODE_1562_length_1824_cov_10.152464	738	818	32	1	80	0.0125000
NODE_1562_length_1824_cov_10.152464	738	818	35	8	80	0.1000000
NODE_1562_length_1824_cov_10.152464	1412	1433	19	15	21	0.7142857
NODE_1562_length_1824_cov_10.152464	1412	1433	21	6	21	0.2857143
NODE_1564_length_1821_cov_7.682346	953	1033	0	80	80	1.0000000
NODE_1564_length_1821_cov_7.682346	1006	1086	0	80	80	1.0000000
NODE_1566_length_1820_cov_12.061592	477	557	0	18	80	0.2250000
NODE_1566_length_1820_cov_12.061592	477	557	8	1	80	0.0125000
NODE_1566_length_1820_cov_12.061592	477	557	9	26	80	0.3250000
NODE_1566_length_1820_cov_12.061592	477	557	10	35	80	0.4375000
NODE_1566_length_1820_cov_12.061592	530	610	9	2	80	0.0250000
NODE_1566_length_1820_cov_12.061592	530	610	10	78	80	0.9750000
NODE_1566_length_1820_cov_12.061592	1232	1312	0	79	80	0.9875000
NODE_1566_length_1820_cov_12.061592	1232	1312	9	1	80	0.0125000
NODE_1566_length_1820_cov_12.061592	1285	1365	0	80	80	1.0000000
NODE_1572_length_1817_cov_8.302095	63	122	0	4	59	0.0677966
NODE_1572_length_1817_cov_8.302095	63	122	6	3	59	0.0508475
NODE_1572_length_1817_cov_8.302095	63	122	8	1	59	0.0169492
NODE_1572_length_1817_cov_8.302095	63	122	10	51	59	0.8644068
NODE_1572_length_1817_cov_8.302095	1195	1275	0	67	80	0.8375000
NODE_1572_length_1817_cov_8.302095	1195	1275	2	13	80	0.1625000
NODE_1572_length_1817_cov_8.302095	1248	1328	0	14	80	0.1750000
NODE_1572_length_1817_cov_8.302095	1248	1328	2	37	80	0.4625000
NODE_1572_length_1817_cov_8.302095	1248	1328	6	29	80	0.3625000
NODE_1573_length_1816_cov_25.489225	1059	1139	0	30	80	0.3750000
NODE_1573_length_1816_cov_25.489225	1059	1139	2	50	80	0.6250000
NODE_1573_length_1816_cov_25.489225	1112	1192	0	32	80	0.4000000
NODE_1573_length_1816_cov_25.489225	1112	1192	2	48	80	0.6000000
NODE_1578_length_1812_cov_11.453006	398	427	0	26	29	0.8965517
NODE_1578_length_1812_cov_11.453006	398	427	2	3	29	0.1034483
NODE_1578_length_1812_cov_11.453006	400	480	0	79	80	0.9875000
NODE_1578_length_1812_cov_11.453006	400	480	2	1	80	0.0125000
NODE_1586_length_1807_cov_3.977752	1743	1807	0	64	64	1.0000000
NODE_1590_length_1806_cov_2.681312	1461	1541	2	6	80	0.0750000
NODE_1590_length_1806_cov_2.681312	1461	1541	6	4	80	0.0500000
NODE_1590_length_1806_cov_2.681312	1461	1541	7	9	80	0.1125000
NODE_1590_length_1806_cov_2.681312	1461	1541	8	2	80	0.0250000
NODE_1590_length_1806_cov_2.681312	1461	1541	10	2	80	0.0250000
NODE_1590_length_1806_cov_2.681312	1461	1541	11	1	80	0.0125000
NODE_1590_length_1806_cov_2.681312	1461	1541	14	9	80	0.1125000
NODE_1590_length_1806_cov_2.681312	1461	1541	15	2	80	0.0250000
NODE_1590_length_1806_cov_2.681312	1461	1541	17	6	80	0.0750000
NODE_1590_length_1806_cov_2.681312	1461	1541	21	3	80	0.0375000
NODE_1590_length_1806_cov_2.681312	1461	1541	25	2	80	0.0250000
NODE_1590_length_1806_cov_2.681312	1461	1541	27	4	80	0.0500000
NODE_1590_length_1806_cov_2.681312	1461	1541	29	1	80	0.0125000
NODE_1590_length_1806_cov_2.681312	1461	1541	31	1	80	0.0125000
NODE_1590_length_1806_cov_2.681312	1461	1541	33	1	80	0.0125000
NODE_1590_length_1806_cov_2.681312	1461	1541	35	1	80	0.0125000
NODE_1590_length_1806_cov_2.681312	1461	1541	37	6	80	0.0750000
NODE_1590_length_1806_cov_2.681312	1461	1541	39	1	80	0.0125000
NODE_1590_length_1806_cov_2.681312	1461	1541	41	3	80	0.0375000
NODE_1590_length_1806_cov_2.681312	1461	1541	43	6	80	0.0750000
NODE_1590_length_1806_cov_2.681312	1461	1541	47	5	80	0.0625000
NODE_1590_length_1806_cov_2.681312	1461	1541	48	1	80	0.0125000
NODE_1590_length_1806_cov_2.681312	1461	1541	49	1	80	0.0125000
NODE_1590_length_1806_cov_2.681312	1461	1541	51	1	80	0.0125000
NODE_1590_length_1806_cov_2.681312	1461	1541	56	2	80	0.0250000
NODE_1590_length_1806_cov_2.681312	1517	1594	0	36	77	0.4675325
NODE_1590_length_1806_cov_2.681312	1517	1594	2	23	77	0.2987013
NODE_1590_length_1806_cov_2.681312	1517	1594	6	4	77	0.0519481
NODE_1590_length_1806_cov_2.681312	1517	1594	7	9	77	0.1168831
NODE_1590_length_1806_cov_2.681312	1517	1594	8	2	77	0.0259740
NODE_1590_length_1806_cov_2.681312	1517	1594	10	2	77	0.0259740
NODE_1590_length_1806_cov_2.681312	1517	1594	11	1	77	0.0129870
NODE_1593_length_1805_cov_10.271395	258	329	0	71	71	1.0000000
NODE_1593_length_1805_cov_10.271395	311	391	0	33	80	0.4125000
NODE_1593_length_1805_cov_10.271395	311	391	2	47	80	0.5875000
NODE_1598_length_1802_cov_11.546682	1284	1364	0	80	80	1.0000000
NODE_1598_length_1802_cov_11.546682	1337	1417	0	80	80	1.0000000
NODE_1600_length_1801_cov_12.145711	85	165	18	19	80	0.2375000
NODE_1600_length_1801_cov_12.145711	85	165	21	4	80	0.0500000
NODE_1600_length_1801_cov_12.145711	85	165	26	7	80	0.0875000
NODE_1600_length_1801_cov_12.145711	85	165	35	4	80	0.0500000
NODE_1600_length_1801_cov_12.145711	85	165	37	1	80	0.0125000
NODE_1600_length_1801_cov_12.145711	85	165	40	11	80	0.1375000
NODE_1600_length_1801_cov_12.145711	85	165	42	1	80	0.0125000
NODE_1600_length_1801_cov_12.145711	85	165	43	3	80	0.0375000
NODE_1600_length_1801_cov_12.145711	85	165	45	25	80	0.3125000
NODE_1600_length_1801_cov_12.145711	85	165	47	3	80	0.0375000
NODE_1600_length_1801_cov_12.145711	85	165	49	2	80	0.0250000
NODE_1600_length_1801_cov_12.145711	138	218	18	5	80	0.0625000
NODE_1600_length_1801_cov_12.145711	138	218	20	5	80	0.0625000
NODE_1600_length_1801_cov_12.145711	138	218	32	11	80	0.1375000
NODE_1600_length_1801_cov_12.145711	138	218	34	8	80	0.1000000
NODE_1600_length_1801_cov_12.145711	138	218	36	1	80	0.0125000
NODE_1600_length_1801_cov_12.145711	138	218	37	3	80	0.0375000
NODE_1600_length_1801_cov_12.145711	138	218	45	25	80	0.3125000
NODE_1600_length_1801_cov_12.145711	138	218	46	17	80	0.2125000
NODE_1600_length_1801_cov_12.145711	138	218	47	3	80	0.0375000
NODE_1600_length_1801_cov_12.145711	138	218	49	2	80	0.0250000
NODE_1601_length_1801_cov_9.793184	1010	1090	4	3	80	0.0375000
NODE_1601_length_1801_cov_9.793184	1010	1090	6	12	80	0.1500000
NODE_1601_length_1801_cov_9.793184	1010	1090	8	3	80	0.0375000
NODE_1601_length_1801_cov_9.793184	1010	1090	10	62	80	0.7750000
NODE_1601_length_1801_cov_9.793184	1063	1143	0	17	80	0.2125000
NODE_1601_length_1801_cov_9.793184	1063	1143	4	39	80	0.4875000
NODE_1601_length_1801_cov_9.793184	1063	1143	6	12	80	0.1500000
NODE_1601_length_1801_cov_9.793184	1063	1143	8	3	80	0.0375000
NODE_1601_length_1801_cov_9.793184	1063	1143	10	9	80	0.1125000
NODE_1604_length_1800_cov_15.074662	695	775	0	80	80	1.0000000
NODE_1604_length_1800_cov_15.074662	755	826	0	71	71	1.0000000
NODE_1605_length_1800_cov_7.281599	10	74	66	1	64	0.0156250
NODE_1605_length_1800_cov_7.281599	10	74	76	1	64	0.0156250
NODE_1605_length_1800_cov_7.281599	10	74	116	1	64	0.0156250
NODE_1605_length_1800_cov_7.281599	10	74	122	2	64	0.0312500
NODE_1605_length_1800_cov_7.281599	10	74	124	1	64	0.0156250
NODE_1605_length_1800_cov_7.281599	10	74	130	6	64	0.0937500
NODE_1605_length_1800_cov_7.281599	10	74	144	3	64	0.0468750
NODE_1605_length_1800_cov_7.281599	10	74	147	1	64	0.0156250
NODE_1605_length_1800_cov_7.281599	10	74	152	1	64	0.0156250
NODE_1605_length_1800_cov_7.281599	10	74	175	1	64	0.0156250
NODE_1605_length_1800_cov_7.281599	10	74	182	2	64	0.0312500
NODE_1605_length_1800_cov_7.281599	10	74	188	1	64	0.0156250
NODE_1605_length_1800_cov_7.281599	10	74	189	2	64	0.0312500
NODE_1605_length_1800_cov_7.281599	10	74	190	1	64	0.0156250
NODE_1605_length_1800_cov_7.281599	10	74	191	1	64	0.0156250
NODE_1605_length_1800_cov_7.281599	10	74	192	8	64	0.1250000
NODE_1605_length_1800_cov_7.281599	10	74	193	4	64	0.0625000
NODE_1605_length_1800_cov_7.281599	10	74	196	1	64	0.0156250
NODE_1605_length_1800_cov_7.281599	10	74	202	1	64	0.0156250
NODE_1605_length_1800_cov_7.281599	10	74	204	1	64	0.0156250
NODE_1605_length_1800_cov_7.281599	10	74	209	2	64	0.0312500
NODE_1605_length_1800_cov_7.281599	10	74	212	2	64	0.0312500
NODE_1605_length_1800_cov_7.281599	10	74	214	3	64	0.0468750
NODE_1605_length_1800_cov_7.281599	10	74	219	3	64	0.0468750
NODE_1605_length_1800_cov_7.281599	10	74	220	5	64	0.0781250
NODE_1605_length_1800_cov_7.281599	10	74	222	5	64	0.0781250
NODE_1605_length_1800_cov_7.281599	10	74	224	2	64	0.0312500
NODE_1605_length_1800_cov_7.281599	10	74	228	1	64	0.0156250
NODE_1605_length_1800_cov_7.281599	10	74	232	1	64	0.0156250
NODE_1605_length_1800_cov_7.281599	10	74	66	1	64	0.0156250
NODE_1605_length_1800_cov_7.281599	10	74	76	1	64	0.0156250
NODE_1605_length_1800_cov_7.281599	10	74	116	1	64	0.0156250
NODE_1605_length_1800_cov_7.281599	10	74	122	2	64	0.0312500
NODE_1605_length_1800_cov_7.281599	10	74	124	1	64	0.0156250
NODE_1605_length_1800_cov_7.281599	10	74	130	6	64	0.0937500
NODE_1605_length_1800_cov_7.281599	10	74	144	3	64	0.0468750
NODE_1605_length_1800_cov_7.281599	10	74	147	1	64	0.0156250
NODE_1605_length_1800_cov_7.281599	10	74	152	1	64	0.0156250
NODE_1605_length_1800_cov_7.281599	10	74	175	1	64	0.0156250
NODE_1605_length_1800_cov_7.281599	10	74	182	2	64	0.0312500
NODE_1605_length_1800_cov_7.281599	10	74	188	1	64	0.0156250
NODE_1605_length_1800_cov_7.281599	10	74	189	2	64	0.0312500
NODE_1605_length_1800_cov_7.281599	10	74	190	1	64	0.0156250
NODE_1605_length_1800_cov_7.281599	10	74	191	1	64	0.0156250
NODE_1605_length_1800_cov_7.281599	10	74	192	8	64	0.1250000
NODE_1605_length_1800_cov_7.281599	10	74	193	4	64	0.0625000
NODE_1605_length_1800_cov_7.281599	10	74	196	1	64	0.0156250
NODE_1605_length_1800_cov_7.281599	10	74	202	1	64	0.0156250
NODE_1605_length_1800_cov_7.281599	10	74	204	1	64	0.0156250
NODE_1605_length_1800_cov_7.281599	10	74	209	2	64	0.0312500
NODE_1605_length_1800_cov_7.281599	10	74	212	2	64	0.0312500
NODE_1605_length_1800_cov_7.281599	10	74	214	3	64	0.0468750
NODE_1605_length_1800_cov_7.281599	10	74	219	3	64	0.0468750
NODE_1605_length_1800_cov_7.281599	10	74	220	5	64	0.0781250
NODE_1605_length_1800_cov_7.281599	10	74	222	5	64	0.0781250
NODE_1605_length_1800_cov_7.281599	10	74	224	2	64	0.0312500
NODE_1605_length_1800_cov_7.281599	10	74	228	1	64	0.0156250
NODE_1605_length_1800_cov_7.281599	10	74	232	1	64	0.0156250
NODE_1605_length_1800_cov_7.281599	10	74	66	1	64	0.0156250
NODE_1605_length_1800_cov_7.281599	10	74	76	1	64	0.0156250
NODE_1605_length_1800_cov_7.281599	10	74	116	1	64	0.0156250
NODE_1605_length_1800_cov_7.281599	10	74	122	2	64	0.0312500
NODE_1605_length_1800_cov_7.281599	10	74	124	1	64	0.0156250
NODE_1605_length_1800_cov_7.281599	10	74	130	6	64	0.0937500
NODE_1605_length_1800_cov_7.281599	10	74	144	3	64	0.0468750
NODE_1605_length_1800_cov_7.281599	10	74	147	1	64	0.0156250
NODE_1605_length_1800_cov_7.281599	10	74	152	1	64	0.0156250
NODE_1605_length_1800_cov_7.281599	10	74	175	1	64	0.0156250
NODE_1605_length_1800_cov_7.281599	10	74	182	2	64	0.0312500
NODE_1605_length_1800_cov_7.281599	10	74	188	1	64	0.0156250
NODE_1605_length_1800_cov_7.281599	10	74	189	2	64	0.0312500
NODE_1605_length_1800_cov_7.281599	10	74	190	1	64	0.0156250
NODE_1605_length_1800_cov_7.281599	10	74	191	1	64	0.0156250
NODE_1605_length_1800_cov_7.281599	10	74	192	8	64	0.1250000
NODE_1605_length_1800_cov_7.281599	10	74	193	4	64	0.0625000
NODE_1605_length_1800_cov_7.281599	10	74	196	1	64	0.0156250
NODE_1605_length_1800_cov_7.281599	10	74	202	1	64	0.0156250
NODE_1605_length_1800_cov_7.281599	10	74	204	1	64	0.0156250
NODE_1605_length_1800_cov_7.281599	10	74	209	2	64	0.0312500
NODE_1605_length_1800_cov_7.281599	10	74	212	2	64	0.0312500
NODE_1605_length_1800_cov_7.281599	10	74	214	3	64	0.0468750
NODE_1605_length_1800_cov_7.281599	10	74	219	3	64	0.0468750
NODE_1605_length_1800_cov_7.281599	10	74	220	5	64	0.0781250
NODE_1605_length_1800_cov_7.281599	10	74	222	5	64	0.0781250
NODE_1605_length_1800_cov_7.281599	10	74	224	2	64	0.0312500
NODE_1605_length_1800_cov_7.281599	10	74	228	1	64	0.0156250
NODE_1605_length_1800_cov_7.281599	10	74	232	1	64	0.0156250
NODE_1605_length_1800_cov_7.281599	47	127	196	1	80	0.0125000
NODE_1605_length_1800_cov_7.281599	47	127	202	1	80	0.0125000
NODE_1605_length_1800_cov_7.281599	47	127	204	1	80	0.0125000
NODE_1605_length_1800_cov_7.281599	47	127	209	2	80	0.0250000
NODE_1605_length_1800_cov_7.281599	47	127	212	2	80	0.0250000
NODE_1605_length_1800_cov_7.281599	47	127	214	3	80	0.0375000
NODE_1605_length_1800_cov_7.281599	47	127	218	3	80	0.0375000
NODE_1605_length_1800_cov_7.281599	47	127	219	3	80	0.0375000
NODE_1605_length_1800_cov_7.281599	47	127	220	6	80	0.0750000
NODE_1605_length_1800_cov_7.281599	47	127	222	5	80	0.0625000
NODE_1605_length_1800_cov_7.281599	47	127	224	2	80	0.0250000
NODE_1605_length_1800_cov_7.281599	47	127	226	2	80	0.0250000
NODE_1605_length_1800_cov_7.281599	47	127	228	1	80	0.0125000
NODE_1605_length_1800_cov_7.281599	47	127	232	1	80	0.0125000
NODE_1605_length_1800_cov_7.281599	47	127	233	1	80	0.0125000
NODE_1605_length_1800_cov_7.281599	47	127	237	1	80	0.0125000
NODE_1605_length_1800_cov_7.281599	47	127	238	4	80	0.0500000
NODE_1605_length_1800_cov_7.281599	47	127	239	2	80	0.0250000
NODE_1605_length_1800_cov_7.281599	47	127	241	5	80	0.0625000
NODE_1605_length_1800_cov_7.281599	47	127	246	1	80	0.0125000
NODE_1605_length_1800_cov_7.281599	47	127	247	6	80	0.0750000
NODE_1605_length_1800_cov_7.281599	47	127	249	5	80	0.0625000
NODE_1605_length_1800_cov_7.281599	47	127	251	6	80	0.0750000
NODE_1605_length_1800_cov_7.281599	47	127	252	5	80	0.0625000
NODE_1605_length_1800_cov_7.281599	47	127	253	11	80	0.1375000
NODE_1605_length_1800_cov_7.281599	63	126	218	2	63	0.0317460
NODE_1605_length_1800_cov_7.281599	63	126	220	3	63	0.0476190
NODE_1605_length_1800_cov_7.281599	63	126	222	5	63	0.0793651
NODE_1605_length_1800_cov_7.281599	63	126	224	2	63	0.0317460
NODE_1605_length_1800_cov_7.281599	63	126	226	2	63	0.0317460
NODE_1605_length_1800_cov_7.281599	63	126	228	1	63	0.0158730
NODE_1605_length_1800_cov_7.281599	63	126	232	1	63	0.0158730
NODE_1605_length_1800_cov_7.281599	63	126	233	1	63	0.0158730
NODE_1605_length_1800_cov_7.281599	63	126	237	1	63	0.0158730
NODE_1605_length_1800_cov_7.281599	63	126	238	4	63	0.0634921
NODE_1605_length_1800_cov_7.281599	63	126	239	2	63	0.0317460
NODE_1605_length_1800_cov_7.281599	63	126	241	5	63	0.0793651
NODE_1605_length_1800_cov_7.281599	63	126	246	1	63	0.0158730
NODE_1605_length_1800_cov_7.281599	63	126	247	6	63	0.0952381
NODE_1605_length_1800_cov_7.281599	63	126	249	5	63	0.0793651
NODE_1605_length_1800_cov_7.281599	63	126	251	6	63	0.0952381
NODE_1605_length_1800_cov_7.281599	63	126	252	5	63	0.0793651
NODE_1605_length_1800_cov_7.281599	63	126	253	11	63	0.1746032
NODE_1616_length_1793_cov_16.161157	539	619	0	80	80	1.0000000
NODE_1616_length_1793_cov_16.161157	592	672	0	80	80	1.0000000
NODE_1616_length_1793_cov_16.161157	1202	1281	2	37	79	0.4683544
NODE_1616_length_1793_cov_16.161157	1202	1281	4	42	79	0.5316456
NODE_1616_length_1793_cov_16.161157	1254	1335	0	29	81	0.3580247
NODE_1616_length_1793_cov_16.161157	1254	1335	2	49	81	0.6049383
NODE_1616_length_1793_cov_16.161157	1254	1335	4	3	81	0.0370370
NODE_1617_length_1793_cov_14.322904	521	601	0	80	80	1.0000000
NODE_1617_length_1793_cov_14.322904	574	654	0	80	80	1.0000000
NODE_1617_length_1793_cov_14.322904	1230	1310	0	80	80	1.0000000
NODE_1618_length_1791_cov_5.516548	1190	1261	0	71	71	1.0000000
NODE_1621_length_1790_cov_4.282082	684	764	0	41	80	0.5125000
NODE_1621_length_1790_cov_4.282082	684	764	2	39	80	0.4875000
NODE_1621_length_1790_cov_4.282082	737	817	0	8	80	0.1000000
NODE_1621_length_1790_cov_4.282082	737	817	2	72	80	0.9000000
NODE_1623_length_1788_cov_39.558911	385	465	0	80	80	1.0000000
NODE_1623_length_1788_cov_39.558911	438	518	0	80	80	1.0000000
NODE_1623_length_1788_cov_39.558911	514	594	0	80	80	1.0000000
NODE_1623_length_1788_cov_39.558911	567	647	0	80	80	1.0000000
NODE_1624_length_1787_cov_44.927133	530	610	74	7	80	0.0875000
NODE_1624_length_1787_cov_44.927133	530	610	80	1	80	0.0125000
NODE_1624_length_1787_cov_44.927133	530	610	83	2	80	0.0250000
NODE_1624_length_1787_cov_44.927133	530	610	85	2	80	0.0250000
NODE_1624_length_1787_cov_44.927133	530	610	86	3	80	0.0375000
NODE_1624_length_1787_cov_44.927133	530	610	88	4	80	0.0500000
NODE_1624_length_1787_cov_44.927133	530	610	89	2	80	0.0250000
NODE_1624_length_1787_cov_44.927133	530	610	90	3	80	0.0375000
NODE_1624_length_1787_cov_44.927133	530	610	91	5	80	0.0625000
NODE_1624_length_1787_cov_44.927133	530	610	92	3	80	0.0375000
NODE_1624_length_1787_cov_44.927133	530	610	93	2	80	0.0250000
NODE_1624_length_1787_cov_44.927133	530	610	95	1	80	0.0125000
NODE_1624_length_1787_cov_44.927133	530	610	96	2	80	0.0250000
NODE_1624_length_1787_cov_44.927133	530	610	98	2	80	0.0250000
NODE_1624_length_1787_cov_44.927133	530	610	99	8	80	0.1000000
NODE_1624_length_1787_cov_44.927133	530	610	100	2	80	0.0250000
NODE_1624_length_1787_cov_44.927133	530	610	101	4	80	0.0500000
NODE_1624_length_1787_cov_44.927133	530	610	102	3	80	0.0375000
NODE_1624_length_1787_cov_44.927133	530	610	103	6	80	0.0750000
NODE_1624_length_1787_cov_44.927133	530	610	104	1	80	0.0125000
NODE_1624_length_1787_cov_44.927133	530	610	105	2	80	0.0250000
NODE_1624_length_1787_cov_44.927133	530	610	106	5	80	0.0625000
NODE_1624_length_1787_cov_44.927133	530	610	107	3	80	0.0375000
NODE_1624_length_1787_cov_44.927133	530	610	108	6	80	0.0750000
NODE_1624_length_1787_cov_44.927133	530	610	109	1	80	0.0125000
NODE_1625_length_1787_cov_2.752370	675	755	2	16	80	0.2000000
NODE_1625_length_1787_cov_2.752370	675	755	4	40	80	0.5000000
NODE_1625_length_1787_cov_2.752370	675	755	6	24	80	0.3000000
NODE_1625_length_1787_cov_2.752370	728	806	2	67	78	0.8589743
NODE_1625_length_1787_cov_2.752370	728	806	6	11	78	0.1410256
NODE_1626_length_1786_cov_13.459395	523	603	0	25	80	0.3125000
NODE_1626_length_1786_cov_13.459395	523	603	2	55	80	0.6875000
NODE_1626_length_1786_cov_13.459395	576	656	0	7	80	0.0875000
NODE_1626_length_1786_cov_13.459395	576	656	2	73	80	0.9125000
NODE_1633_length_1784_cov_40.769733	358	438	0	80	80	1.0000000
NODE_1633_length_1784_cov_40.769733	411	491	0	80	80	1.0000000
NODE_1633_length_1784_cov_40.769733	1057	1137	0	80	80	1.0000000
NODE_1633_length_1784_cov_40.769733	1110	1190	0	80	80	1.0000000
NODE_1633_length_1784_cov_40.769733	1186	1266	0	80	80	1.0000000
NODE_1633_length_1784_cov_40.769733	1239	1319	0	80	80	1.0000000
NODE_1634_length_1784_cov_6.049258	1646	1725	0	18	79	0.2278481
NODE_1634_length_1784_cov_6.049258	1646	1725	3	1	79	0.0126582
NODE_1634_length_1784_cov_6.049258	1646	1725	4	60	79	0.7594936
NODE_1637_length_1783_cov_45.569477	600	680	0	23	80	0.2875000
NODE_1637_length_1783_cov_45.569477	600	680	2	4	80	0.0500000
NODE_1637_length_1783_cov_45.569477	600	680	4	53	80	0.6625000
NODE_1637_length_1783_cov_45.569477	653	733	0	76	80	0.9500000
NODE_1637_length_1783_cov_45.569477	653	733	2	4	80	0.0500000
NODE_1640_length_1780_cov_21.089233	361	441	0	80	80	1.0000000
NODE_1640_length_1780_cov_21.089233	414	494	0	80	80	1.0000000
NODE_1640_length_1780_cov_21.089233	1031	1104	30	3	73	0.0410959
NODE_1640_length_1780_cov_21.089233	1031	1104	32	2	73	0.0273973
NODE_1640_length_1780_cov_21.089233	1031	1104	34	1	73	0.0136986
NODE_1640_length_1780_cov_21.089233	1031	1104	39	1	73	0.0136986
NODE_1640_length_1780_cov_21.089233	1031	1104	40	1	73	0.0136986
NODE_1640_length_1780_cov_21.089233	1031	1104	42	3	73	0.0410959
NODE_1640_length_1780_cov_21.089233	1031	1104	44	2	73	0.0273973
NODE_1640_length_1780_cov_21.089233	1031	1104	47	1	73	0.0136986
NODE_1640_length_1780_cov_21.089233	1031	1104	49	4	73	0.0547945
NODE_1640_length_1780_cov_21.089233	1031	1104	51	1	73	0.0136986
NODE_1640_length_1780_cov_21.089233	1031	1104	53	2	73	0.0273973
NODE_1640_length_1780_cov_21.089233	1031	1104	55	1	73	0.0136986
NODE_1640_length_1780_cov_21.089233	1031	1104	57	4	73	0.0547945
NODE_1640_length_1780_cov_21.089233	1031	1104	58	6	73	0.0821918
NODE_1640_length_1780_cov_21.089233	1031	1104	60	1	73	0.0136986
NODE_1640_length_1780_cov_21.089233	1031	1104	62	2	73	0.0273973
NODE_1640_length_1780_cov_21.089233	1031	1104	64	2	73	0.0273973
NODE_1640_length_1780_cov_21.089233	1031	1104	65	2	73	0.0273973
NODE_1640_length_1780_cov_21.089233	1031	1104	67	6	73	0.0821918
NODE_1640_length_1780_cov_21.089233	1031	1104	70	5	73	0.0684932
NODE_1640_length_1780_cov_21.089233	1031	1104	72	5	73	0.0684932
NODE_1640_length_1780_cov_21.089233	1031	1104	74	1	73	0.0136986
NODE_1640_length_1780_cov_21.089233	1031	1104	75	1	73	0.0136986
NODE_1640_length_1780_cov_21.089233	1031	1104	79	3	73	0.0410959
NODE_1640_length_1780_cov_21.089233	1031	1104	81	1	73	0.0136986
NODE_1640_length_1780_cov_21.089233	1031	1104	86	2	73	0.0273973
NODE_1640_length_1780_cov_21.089233	1031	1104	88	5	73	0.0684932
NODE_1640_length_1780_cov_21.089233	1031	1104	89	1	73	0.0136986
NODE_1640_length_1780_cov_21.089233	1031	1104	94	1	73	0.0136986
NODE_1640_length_1780_cov_21.089233	1031	1104	96	1	73	0.0136986
NODE_1640_length_1780_cov_21.089233	1031	1104	99	2	73	0.0273973
NODE_1640_length_1780_cov_21.089233	1071	1112	67	5	41	0.1219512
NODE_1640_length_1780_cov_21.089233	1071	1112	70	5	41	0.1219512
NODE_1640_length_1780_cov_21.089233	1071	1112	72	5	41	0.1219512
NODE_1640_length_1780_cov_21.089233	1071	1112	74	1	41	0.0243902
NODE_1640_length_1780_cov_21.089233	1071	1112	75	1	41	0.0243902
NODE_1640_length_1780_cov_21.089233	1071	1112	79	3	41	0.0731707
NODE_1640_length_1780_cov_21.089233	1071	1112	81	1	41	0.0243902
NODE_1640_length_1780_cov_21.089233	1071	1112	86	2	41	0.0487805
NODE_1640_length_1780_cov_21.089233	1071	1112	88	5	41	0.1219512
NODE_1640_length_1780_cov_21.089233	1071	1112	89	1	41	0.0243902
NODE_1640_length_1780_cov_21.089233	1071	1112	94	1	41	0.0243902
NODE_1640_length_1780_cov_21.089233	1071	1112	96	1	41	0.0243902
NODE_1640_length_1780_cov_21.089233	1071	1112	99	3	41	0.0731707
NODE_1640_length_1780_cov_21.089233	1071	1112	102	1	41	0.0243902
NODE_1640_length_1780_cov_21.089233	1071	1112	104	1	41	0.0243902
NODE_1640_length_1780_cov_21.089233	1071	1112	106	1	41	0.0243902
NODE_1640_length_1780_cov_21.089233	1071	1112	111	1	41	0.0243902
NODE_1640_length_1780_cov_21.089233	1071	1112	113	2	41	0.0487805
NODE_1640_length_1780_cov_21.089233	1071	1112	115	1	41	0.0243902
NODE_1641_length_1780_cov_7.837597	1682	1747	0	65	65	1.0000000
NODE_1649_length_1778_cov_52.804050	1528	1568	4	3	40	0.0750000
NODE_1649_length_1778_cov_52.804050	1528	1568	12	5	40	0.1250000
NODE_1649_length_1778_cov_52.804050	1528	1568	13	1	40	0.0250000
NODE_1649_length_1778_cov_52.804050	1528	1568	22	4	40	0.1000000
NODE_1649_length_1778_cov_52.804050	1528	1568	28	1	40	0.0250000
NODE_1649_length_1778_cov_52.804050	1528	1568	34	1	40	0.0250000
NODE_1649_length_1778_cov_52.804050	1528	1568	36	1	40	0.0250000
NODE_1649_length_1778_cov_52.804050	1528	1568	116	23	40	0.5750000
NODE_1649_length_1778_cov_52.804050	1528	1568	118	1	40	0.0250000
NODE_1649_length_1778_cov_52.804050	1541	1621	28	1	80	0.0125000
NODE_1649_length_1778_cov_52.804050	1541	1621	34	1	80	0.0125000
NODE_1649_length_1778_cov_52.804050	1541	1621	36	1	80	0.0125000
NODE_1649_length_1778_cov_52.804050	1541	1621	116	23	80	0.2875000
NODE_1649_length_1778_cov_52.804050	1541	1621	118	2	80	0.0250000
NODE_1649_length_1778_cov_52.804050	1541	1621	120	7	80	0.0875000
NODE_1649_length_1778_cov_52.804050	1541	1621	137	1	80	0.0125000
NODE_1649_length_1778_cov_52.804050	1541	1621	138	1	80	0.0125000
NODE_1649_length_1778_cov_52.804050	1541	1621	140	21	80	0.2625000
NODE_1649_length_1778_cov_52.804050	1541	1621	141	21	80	0.2625000
NODE_1649_length_1778_cov_52.804050	1541	1621	144	1	80	0.0125000
NODE_1649_length_1778_cov_52.804050	1541	1621	28	1	80	0.0125000
NODE_1649_length_1778_cov_52.804050	1541	1621	34	1	80	0.0125000
NODE_1649_length_1778_cov_52.804050	1541	1621	36	1	80	0.0125000
NODE_1649_length_1778_cov_52.804050	1541	1621	116	23	80	0.2875000
NODE_1649_length_1778_cov_52.804050	1541	1621	118	2	80	0.0250000
NODE_1649_length_1778_cov_52.804050	1541	1621	120	7	80	0.0875000
NODE_1649_length_1778_cov_52.804050	1541	1621	137	1	80	0.0125000
NODE_1649_length_1778_cov_52.804050	1541	1621	138	1	80	0.0125000
NODE_1649_length_1778_cov_52.804050	1541	1621	140	21	80	0.2625000
NODE_1649_length_1778_cov_52.804050	1541	1621	141	21	80	0.2625000
NODE_1649_length_1778_cov_52.804050	1541	1621	144	1	80	0.0125000
NODE_1649_length_1778_cov_52.804050	1541	1621	28	1	80	0.0125000
NODE_1649_length_1778_cov_52.804050	1541	1621	34	1	80	0.0125000
NODE_1649_length_1778_cov_52.804050	1541	1621	36	1	80	0.0125000
NODE_1649_length_1778_cov_52.804050	1541	1621	116	23	80	0.2875000
NODE_1649_length_1778_cov_52.804050	1541	1621	118	2	80	0.0250000
NODE_1649_length_1778_cov_52.804050	1541	1621	120	7	80	0.0875000
NODE_1649_length_1778_cov_52.804050	1541	1621	137	1	80	0.0125000
NODE_1649_length_1778_cov_52.804050	1541	1621	138	1	80	0.0125000
NODE_1649_length_1778_cov_52.804050	1541	1621	140	21	80	0.2625000
NODE_1649_length_1778_cov_52.804050	1541	1621	141	21	80	0.2625000
NODE_1649_length_1778_cov_52.804050	1541	1621	144	1	80	0.0125000
NODE_1649_length_1778_cov_52.804050	1541	1621	28	1	80	0.0125000
NODE_1649_length_1778_cov_52.804050	1541	1621	34	1	80	0.0125000
NODE_1649_length_1778_cov_52.804050	1541	1621	36	1	80	0.0125000
NODE_1649_length_1778_cov_52.804050	1541	1621	116	23	80	0.2875000
NODE_1649_length_1778_cov_52.804050	1541	1621	118	2	80	0.0250000
NODE_1649_length_1778_cov_52.804050	1541	1621	120	7	80	0.0875000
NODE_1649_length_1778_cov_52.804050	1541	1621	137	1	80	0.0125000
NODE_1649_length_1778_cov_52.804050	1541	1621	138	1	80	0.0125000
NODE_1649_length_1778_cov_52.804050	1541	1621	140	21	80	0.2625000
NODE_1649_length_1778_cov_52.804050	1541	1621	141	21	80	0.2625000
NODE_1649_length_1778_cov_52.804050	1541	1621	144	1	80	0.0125000
NODE_1649_length_1778_cov_52.804050	1541	1621	28	1	80	0.0125000
NODE_1649_length_1778_cov_52.804050	1541	1621	34	1	80	0.0125000
NODE_1649_length_1778_cov_52.804050	1541	1621	36	1	80	0.0125000
NODE_1649_length_1778_cov_52.804050	1541	1621	116	23	80	0.2875000
NODE_1649_length_1778_cov_52.804050	1541	1621	118	2	80	0.0250000
NODE_1649_length_1778_cov_52.804050	1541	1621	120	7	80	0.0875000
NODE_1649_length_1778_cov_52.804050	1541	1621	137	1	80	0.0125000
NODE_1649_length_1778_cov_52.804050	1541	1621	138	1	80	0.0125000
NODE_1649_length_1778_cov_52.804050	1541	1621	140	21	80	0.2625000
NODE_1649_length_1778_cov_52.804050	1541	1621	141	21	80	0.2625000
NODE_1649_length_1778_cov_52.804050	1541	1621	144	1	80	0.0125000
NODE_1649_length_1778_cov_52.804050	1541	1621	28	1	80	0.0125000
NODE_1649_length_1778_cov_52.804050	1541	1621	34	1	80	0.0125000
NODE_1649_length_1778_cov_52.804050	1541	1621	36	1	80	0.0125000
NODE_1649_length_1778_cov_52.804050	1541	1621	116	23	80	0.2875000
NODE_1649_length_1778_cov_52.804050	1541	1621	118	2	80	0.0250000
NODE_1649_length_1778_cov_52.804050	1541	1621	120	7	80	0.0875000
NODE_1649_length_1778_cov_52.804050	1541	1621	137	1	80	0.0125000
NODE_1649_length_1778_cov_52.804050	1541	1621	138	1	80	0.0125000
NODE_1649_length_1778_cov_52.804050	1541	1621	140	21	80	0.2625000
NODE_1649_length_1778_cov_52.804050	1541	1621	141	21	80	0.2625000
NODE_1649_length_1778_cov_52.804050	1541	1621	144	1	80	0.0125000
NODE_1649_length_1778_cov_52.804050	1617	1697	111	8	80	0.1000000
NODE_1649_length_1778_cov_52.804050	1617	1697	115	11	80	0.1375000
NODE_1649_length_1778_cov_52.804050	1617	1697	140	3	80	0.0375000
NODE_1649_length_1778_cov_52.804050	1617	1697	144	6	80	0.0750000
NODE_1649_length_1778_cov_52.804050	1617	1697	146	1	80	0.0125000
NODE_1649_length_1778_cov_52.804050	1617	1697	148	2	80	0.0250000
NODE_1649_length_1778_cov_52.804050	1617	1697	155	1	80	0.0125000
NODE_1649_length_1778_cov_52.804050	1617	1697	167	1	80	0.0125000
NODE_1649_length_1778_cov_52.804050	1617	1697	184	2	80	0.0250000
NODE_1649_length_1778_cov_52.804050	1617	1697	188	1	80	0.0125000
NODE_1649_length_1778_cov_52.804050	1617	1697	190	6	80	0.0750000
NODE_1649_length_1778_cov_52.804050	1617	1697	191	1	80	0.0125000
NODE_1649_length_1778_cov_52.804050	1617	1697	192	19	80	0.2375000
NODE_1649_length_1778_cov_52.804050	1617	1697	194	1	80	0.0125000
NODE_1649_length_1778_cov_52.804050	1617	1697	202	3	80	0.0375000
NODE_1649_length_1778_cov_52.804050	1617	1697	207	3	80	0.0375000
NODE_1649_length_1778_cov_52.804050	1617	1697	209	2	80	0.0250000
NODE_1649_length_1778_cov_52.804050	1617	1697	212	1	80	0.0125000
NODE_1649_length_1778_cov_52.804050	1617	1697	213	2	80	0.0250000
NODE_1649_length_1778_cov_52.804050	1617	1697	214	5	80	0.0625000
NODE_1649_length_1778_cov_52.804050	1617	1697	215	1	80	0.0125000
NODE_1649_length_1778_cov_52.804050	1617	1697	111	8	80	0.1000000
NODE_1649_length_1778_cov_52.804050	1617	1697	115	11	80	0.1375000
NODE_1649_length_1778_cov_52.804050	1617	1697	140	3	80	0.0375000
NODE_1649_length_1778_cov_52.804050	1617	1697	144	6	80	0.0750000
NODE_1649_length_1778_cov_52.804050	1617	1697	146	1	80	0.0125000
NODE_1649_length_1778_cov_52.804050	1617	1697	148	2	80	0.0250000
NODE_1649_length_1778_cov_52.804050	1617	1697	155	1	80	0.0125000
NODE_1649_length_1778_cov_52.804050	1617	1697	167	1	80	0.0125000
NODE_1649_length_1778_cov_52.804050	1617	1697	184	2	80	0.0250000
NODE_1649_length_1778_cov_52.804050	1617	1697	188	1	80	0.0125000
NODE_1649_length_1778_cov_52.804050	1617	1697	190	6	80	0.0750000
NODE_1649_length_1778_cov_52.804050	1617	1697	191	1	80	0.0125000
NODE_1649_length_1778_cov_52.804050	1617	1697	192	19	80	0.2375000
NODE_1649_length_1778_cov_52.804050	1617	1697	194	1	80	0.0125000
NODE_1649_length_1778_cov_52.804050	1617	1697	202	3	80	0.0375000
NODE_1649_length_1778_cov_52.804050	1617	1697	207	3	80	0.0375000
NODE_1649_length_1778_cov_52.804050	1617	1697	209	2	80	0.0250000
NODE_1649_length_1778_cov_52.804050	1617	1697	212	1	80	0.0125000
NODE_1649_length_1778_cov_52.804050	1617	1697	213	2	80	0.0250000
NODE_1649_length_1778_cov_52.804050	1617	1697	214	5	80	0.0625000
NODE_1649_length_1778_cov_52.804050	1617	1697	215	1	80	0.0125000
NODE_1649_length_1778_cov_52.804050	1617	1697	111	8	80	0.1000000
NODE_1649_length_1778_cov_52.804050	1617	1697	115	11	80	0.1375000
NODE_1649_length_1778_cov_52.804050	1617	1697	140	3	80	0.0375000
NODE_1649_length_1778_cov_52.804050	1617	1697	144	6	80	0.0750000
NODE_1649_length_1778_cov_52.804050	1617	1697	146	1	80	0.0125000
NODE_1649_length_1778_cov_52.804050	1617	1697	148	2	80	0.0250000
NODE_1649_length_1778_cov_52.804050	1617	1697	155	1	80	0.0125000
NODE_1649_length_1778_cov_52.804050	1617	1697	167	1	80	0.0125000
NODE_1649_length_1778_cov_52.804050	1617	1697	184	2	80	0.0250000
NODE_1649_length_1778_cov_52.804050	1617	1697	188	1	80	0.0125000
NODE_1649_length_1778_cov_52.804050	1617	1697	190	6	80	0.0750000
NODE_1649_length_1778_cov_52.804050	1617	1697	191	1	80	0.0125000
NODE_1649_length_1778_cov_52.804050	1617	1697	192	19	80	0.2375000
NODE_1649_length_1778_cov_52.804050	1617	1697	194	1	80	0.0125000
NODE_1649_length_1778_cov_52.804050	1617	1697	202	3	80	0.0375000
NODE_1649_length_1778_cov_52.804050	1617	1697	207	3	80	0.0375000
NODE_1649_length_1778_cov_52.804050	1617	1697	209	2	80	0.0250000
NODE_1649_length_1778_cov_52.804050	1617	1697	212	1	80	0.0125000
NODE_1649_length_1778_cov_52.804050	1617	1697	213	2	80	0.0250000
NODE_1649_length_1778_cov_52.804050	1617	1697	214	5	80	0.0625000
NODE_1649_length_1778_cov_52.804050	1617	1697	215	1	80	0.0125000
NODE_1649_length_1778_cov_52.804050	1617	1697	111	8	80	0.1000000
NODE_1649_length_1778_cov_52.804050	1617	1697	115	11	80	0.1375000
NODE_1649_length_1778_cov_52.804050	1617	1697	140	3	80	0.0375000
NODE_1649_length_1778_cov_52.804050	1617	1697	144	6	80	0.0750000
NODE_1649_length_1778_cov_52.804050	1617	1697	146	1	80	0.0125000
NODE_1649_length_1778_cov_52.804050	1617	1697	148	2	80	0.0250000
NODE_1649_length_1778_cov_52.804050	1617	1697	155	1	80	0.0125000
NODE_1649_length_1778_cov_52.804050	1617	1697	167	1	80	0.0125000
NODE_1649_length_1778_cov_52.804050	1617	1697	184	2	80	0.0250000
NODE_1649_length_1778_cov_52.804050	1617	1697	188	1	80	0.0125000
NODE_1649_length_1778_cov_52.804050	1617	1697	190	6	80	0.0750000
NODE_1649_length_1778_cov_52.804050	1617	1697	191	1	80	0.0125000
NODE_1649_length_1778_cov_52.804050	1617	1697	192	19	80	0.2375000
NODE_1649_length_1778_cov_52.804050	1617	1697	194	1	80	0.0125000
NODE_1649_length_1778_cov_52.804050	1617	1697	202	3	80	0.0375000
NODE_1649_length_1778_cov_52.804050	1617	1697	207	3	80	0.0375000
NODE_1649_length_1778_cov_52.804050	1617	1697	209	2	80	0.0250000
NODE_1649_length_1778_cov_52.804050	1617	1697	212	1	80	0.0125000
NODE_1649_length_1778_cov_52.804050	1617	1697	213	2	80	0.0250000
NODE_1649_length_1778_cov_52.804050	1617	1697	214	5	80	0.0625000
NODE_1649_length_1778_cov_52.804050	1617	1697	215	1	80	0.0125000
NODE_1649_length_1778_cov_52.804050	1670	1750	69	2	80	0.0250000
NODE_1649_length_1778_cov_52.804050	1670	1750	71	5	80	0.0625000
NODE_1649_length_1778_cov_52.804050	1670	1750	75	1	80	0.0125000
NODE_1649_length_1778_cov_52.804050	1670	1750	81	3	80	0.0375000
NODE_1649_length_1778_cov_52.804050	1670	1750	83	14	80	0.1750000
NODE_1649_length_1778_cov_52.804050	1670	1750	85	3	80	0.0375000
NODE_1649_length_1778_cov_52.804050	1670	1750	105	5	80	0.0625000
NODE_1649_length_1778_cov_52.804050	1670	1750	107	12	80	0.1500000
NODE_1649_length_1778_cov_52.804050	1670	1750	109	6	80	0.0750000
NODE_1649_length_1778_cov_52.804050	1670	1750	111	10	80	0.1250000
NODE_1649_length_1778_cov_52.804050	1670	1750	115	11	80	0.1375000
NODE_1649_length_1778_cov_52.804050	1670	1750	184	2	80	0.0250000
NODE_1649_length_1778_cov_52.804050	1670	1750	191	1	80	0.0125000
NODE_1649_length_1778_cov_52.804050	1670	1750	192	4	80	0.0500000
NODE_1649_length_1778_cov_52.804050	1670	1750	194	1	80	0.0125000
NODE_1649_length_1778_cov_52.804050	1670	1750	69	2	80	0.0250000
NODE_1649_length_1778_cov_52.804050	1670	1750	71	5	80	0.0625000
NODE_1649_length_1778_cov_52.804050	1670	1750	75	1	80	0.0125000
NODE_1649_length_1778_cov_52.804050	1670	1750	81	3	80	0.0375000
NODE_1649_length_1778_cov_52.804050	1670	1750	83	14	80	0.1750000
NODE_1649_length_1778_cov_52.804050	1670	1750	85	3	80	0.0375000
NODE_1649_length_1778_cov_52.804050	1670	1750	105	5	80	0.0625000
NODE_1649_length_1778_cov_52.804050	1670	1750	107	12	80	0.1500000
NODE_1649_length_1778_cov_52.804050	1670	1750	109	6	80	0.0750000
NODE_1649_length_1778_cov_52.804050	1670	1750	111	10	80	0.1250000
NODE_1649_length_1778_cov_52.804050	1670	1750	115	11	80	0.1375000
NODE_1649_length_1778_cov_52.804050	1670	1750	184	2	80	0.0250000
NODE_1649_length_1778_cov_52.804050	1670	1750	191	1	80	0.0125000
NODE_1649_length_1778_cov_52.804050	1670	1750	192	4	80	0.0500000
NODE_1649_length_1778_cov_52.804050	1670	1750	194	1	80	0.0125000
NODE_1649_length_1778_cov_52.804050	1670	1750	69	2	80	0.0250000
NODE_1649_length_1778_cov_52.804050	1670	1750	71	5	80	0.0625000
NODE_1649_length_1778_cov_52.804050	1670	1750	75	1	80	0.0125000
NODE_1649_length_1778_cov_52.804050	1670	1750	81	3	80	0.0375000
NODE_1649_length_1778_cov_52.804050	1670	1750	83	14	80	0.1750000
NODE_1649_length_1778_cov_52.804050	1670	1750	85	3	80	0.0375000
NODE_1649_length_1778_cov_52.804050	1670	1750	105	5	80	0.0625000
NODE_1649_length_1778_cov_52.804050	1670	1750	107	12	80	0.1500000
NODE_1649_length_1778_cov_52.804050	1670	1750	109	6	80	0.0750000
NODE_1649_length_1778_cov_52.804050	1670	1750	111	10	80	0.1250000
NODE_1649_length_1778_cov_52.804050	1670	1750	115	11	80	0.1375000
NODE_1649_length_1778_cov_52.804050	1670	1750	184	2	80	0.0250000
NODE_1649_length_1778_cov_52.804050	1670	1750	191	1	80	0.0125000
NODE_1649_length_1778_cov_52.804050	1670	1750	192	4	80	0.0500000
NODE_1649_length_1778_cov_52.804050	1670	1750	194	1	80	0.0125000
NODE_1649_length_1778_cov_52.804050	1670	1741	81	2	71	0.0281690
NODE_1649_length_1778_cov_52.804050	1670	1741	83	14	71	0.1971831
NODE_1649_length_1778_cov_52.804050	1670	1741	85	3	71	0.0422535
NODE_1649_length_1778_cov_52.804050	1670	1741	105	5	71	0.0704225
NODE_1649_length_1778_cov_52.804050	1670	1741	107	12	71	0.1690141
NODE_1649_length_1778_cov_52.804050	1670	1741	109	6	71	0.0845070
NODE_1649_length_1778_cov_52.804050	1670	1741	111	10	71	0.1408451
NODE_1649_length_1778_cov_52.804050	1670	1741	115	11	71	0.1549296
NODE_1649_length_1778_cov_52.804050	1670	1741	184	2	71	0.0281690
NODE_1649_length_1778_cov_52.804050	1670	1741	191	1	71	0.0140845
NODE_1649_length_1778_cov_52.804050	1670	1741	192	4	71	0.0563380
NODE_1649_length_1778_cov_52.804050	1670	1741	194	1	71	0.0140845
NODE_1649_length_1778_cov_52.804050	1673	1743	75	1	70	0.0142857
NODE_1649_length_1778_cov_52.804050	1673	1743	81	3	70	0.0428571
NODE_1649_length_1778_cov_52.804050	1673	1743	83	14	70	0.2000000
NODE_1649_length_1778_cov_52.804050	1673	1743	85	3	70	0.0428571
NODE_1649_length_1778_cov_52.804050	1673	1743	105	5	70	0.0714286
NODE_1649_length_1778_cov_52.804050	1673	1743	107	12	70	0.1714286
NODE_1649_length_1778_cov_52.804050	1673	1743	109	6	70	0.0857143
NODE_1649_length_1778_cov_52.804050	1673	1743	111	10	70	0.1428571
NODE_1649_length_1778_cov_52.804050	1673	1743	115	11	70	0.1571429
NODE_1649_length_1778_cov_52.804050	1673	1743	184	2	70	0.0285714
NODE_1649_length_1778_cov_52.804050	1673	1743	191	1	70	0.0142857
NODE_1649_length_1778_cov_52.804050	1673	1743	192	1	70	0.0142857
NODE_1649_length_1778_cov_52.804050	1673	1743	194	1	70	0.0142857
NODE_1649_length_1778_cov_52.804050	1679	1750	69	2	71	0.0281690
NODE_1649_length_1778_cov_52.804050	1679	1750	71	5	71	0.0704225
NODE_1649_length_1778_cov_52.804050	1679	1750	75	1	71	0.0140845
NODE_1649_length_1778_cov_52.804050	1679	1750	81	3	71	0.0422535
NODE_1649_length_1778_cov_52.804050	1679	1750	83	14	71	0.1971831
NODE_1649_length_1778_cov_52.804050	1679	1750	85	3	71	0.0422535
NODE_1649_length_1778_cov_52.804050	1679	1750	105	5	71	0.0704225
NODE_1649_length_1778_cov_52.804050	1679	1750	107	12	71	0.1690141
NODE_1649_length_1778_cov_52.804050	1679	1750	109	6	71	0.0845070
NODE_1649_length_1778_cov_52.804050	1679	1750	111	10	71	0.1408451
NODE_1649_length_1778_cov_52.804050	1679	1750	115	10	71	0.1408451
NODE_1651_length_1776_cov_43.081694	1246	1308	0	18	62	0.2903226
NODE_1651_length_1776_cov_43.081694	1246	1308	5	6	62	0.0967742
NODE_1651_length_1776_cov_43.081694	1246	1308	6	35	62	0.5645161
NODE_1651_length_1776_cov_43.081694	1246	1308	7	2	62	0.0322581
NODE_1651_length_1776_cov_43.081694	1246	1308	16	1	62	0.0161290
NODE_1651_length_1776_cov_43.081694	1281	1361	0	1	80	0.0125000
NODE_1651_length_1776_cov_43.081694	1281	1361	6	79	80	0.9875000
NODE_1652_length_1776_cov_9.256410	1120	1200	0	80	80	1.0000000
NODE_1652_length_1776_cov_9.256410	1173	1253	0	80	80	1.0000000
NODE_1652_length_1776_cov_9.256410	1249	1329	0	80	80	1.0000000
NODE_1652_length_1776_cov_9.256410	1302	1382	0	80	80	1.0000000
NODE_1657_length_1775_cov_54.208234	1103	1167	278	1	64	0.0156250
NODE_1657_length_1775_cov_54.208234	1103	1167	279	1	64	0.0156250
NODE_1657_length_1775_cov_54.208234	1103	1167	280	1	64	0.0156250
NODE_1657_length_1775_cov_54.208234	1103	1167	281	1	64	0.0156250
NODE_1657_length_1775_cov_54.208234	1103	1167	282	2	64	0.0312500
NODE_1657_length_1775_cov_54.208234	1103	1167	284	2	64	0.0312500
NODE_1657_length_1775_cov_54.208234	1103	1167	286	1	64	0.0156250
NODE_1657_length_1775_cov_54.208234	1103	1167	287	3	64	0.0468750
NODE_1657_length_1775_cov_54.208234	1103	1167	288	3	64	0.0468750
NODE_1657_length_1775_cov_54.208234	1103	1167	289	1	64	0.0156250
NODE_1657_length_1775_cov_54.208234	1103	1167	291	1	64	0.0156250
NODE_1657_length_1775_cov_54.208234	1103	1167	292	1	64	0.0156250
NODE_1657_length_1775_cov_54.208234	1103	1167	293	1	64	0.0156250
NODE_1657_length_1775_cov_54.208234	1103	1167	294	1	64	0.0156250
NODE_1657_length_1775_cov_54.208234	1103	1167	296	1	64	0.0156250
NODE_1657_length_1775_cov_54.208234	1103	1167	302	1	64	0.0156250
NODE_1657_length_1775_cov_54.208234	1103	1167	305	1	64	0.0156250
NODE_1657_length_1775_cov_54.208234	1103	1167	320	1	64	0.0156250
NODE_1657_length_1775_cov_54.208234	1103	1167	322	1	64	0.0156250
NODE_1657_length_1775_cov_54.208234	1103	1167	323	1	64	0.0156250
NODE_1657_length_1775_cov_54.208234	1103	1167	325	1	64	0.0156250
NODE_1657_length_1775_cov_54.208234	1103	1167	329	1	64	0.0156250
NODE_1657_length_1775_cov_54.208234	1103	1167	341	2	64	0.0312500
NODE_1657_length_1775_cov_54.208234	1103	1167	342	2	64	0.0312500
NODE_1657_length_1775_cov_54.208234	1103	1167	345	1	64	0.0156250
NODE_1657_length_1775_cov_54.208234	1103	1167	347	2	64	0.0312500
NODE_1657_length_1775_cov_54.208234	1103	1167	350	1	64	0.0156250
NODE_1657_length_1775_cov_54.208234	1103	1167	351	2	64	0.0312500
NODE_1657_length_1775_cov_54.208234	1103	1167	352	5	64	0.0781250
NODE_1657_length_1775_cov_54.208234	1103	1167	353	2	64	0.0312500
NODE_1657_length_1775_cov_54.208234	1103	1167	354	1	64	0.0156250
NODE_1657_length_1775_cov_54.208234	1103	1167	355	1	64	0.0156250
NODE_1657_length_1775_cov_54.208234	1103	1167	363	4	64	0.0625000
NODE_1657_length_1775_cov_54.208234	1103	1167	370	1	64	0.0156250
NODE_1657_length_1775_cov_54.208234	1103	1167	372	3	64	0.0468750
NODE_1657_length_1775_cov_54.208234	1103	1167	374	1	64	0.0156250
NODE_1657_length_1775_cov_54.208234	1103	1167	375	1	64	0.0156250
NODE_1657_length_1775_cov_54.208234	1103	1167	376	2	64	0.0312500
NODE_1657_length_1775_cov_54.208234	1103	1167	377	1	64	0.0156250
NODE_1657_length_1775_cov_54.208234	1103	1167	378	1	64	0.0156250
NODE_1657_length_1775_cov_54.208234	1103	1167	380	1	64	0.0156250
NODE_1657_length_1775_cov_54.208234	1103	1167	381	2	64	0.0312500
NODE_1657_length_1775_cov_54.208234	1103	1167	278	1	64	0.0156250
NODE_1657_length_1775_cov_54.208234	1103	1167	279	1	64	0.0156250
NODE_1657_length_1775_cov_54.208234	1103	1167	280	1	64	0.0156250
NODE_1657_length_1775_cov_54.208234	1103	1167	281	1	64	0.0156250
NODE_1657_length_1775_cov_54.208234	1103	1167	282	2	64	0.0312500
NODE_1657_length_1775_cov_54.208234	1103	1167	284	2	64	0.0312500
NODE_1657_length_1775_cov_54.208234	1103	1167	286	1	64	0.0156250
NODE_1657_length_1775_cov_54.208234	1103	1167	287	3	64	0.0468750
NODE_1657_length_1775_cov_54.208234	1103	1167	288	3	64	0.0468750
NODE_1657_length_1775_cov_54.208234	1103	1167	289	1	64	0.0156250
NODE_1657_length_1775_cov_54.208234	1103	1167	291	1	64	0.0156250
NODE_1657_length_1775_cov_54.208234	1103	1167	292	1	64	0.0156250
NODE_1657_length_1775_cov_54.208234	1103	1167	293	1	64	0.0156250
NODE_1657_length_1775_cov_54.208234	1103	1167	294	1	64	0.0156250
NODE_1657_length_1775_cov_54.208234	1103	1167	296	1	64	0.0156250
NODE_1657_length_1775_cov_54.208234	1103	1167	302	1	64	0.0156250
NODE_1657_length_1775_cov_54.208234	1103	1167	305	1	64	0.0156250
NODE_1657_length_1775_cov_54.208234	1103	1167	320	1	64	0.0156250
NODE_1657_length_1775_cov_54.208234	1103	1167	322	1	64	0.0156250
NODE_1657_length_1775_cov_54.208234	1103	1167	323	1	64	0.0156250
NODE_1657_length_1775_cov_54.208234	1103	1167	325	1	64	0.0156250
NODE_1657_length_1775_cov_54.208234	1103	1167	329	1	64	0.0156250
NODE_1657_length_1775_cov_54.208234	1103	1167	341	2	64	0.0312500
NODE_1657_length_1775_cov_54.208234	1103	1167	342	2	64	0.0312500
NODE_1657_length_1775_cov_54.208234	1103	1167	345	1	64	0.0156250
NODE_1657_length_1775_cov_54.208234	1103	1167	347	2	64	0.0312500
NODE_1657_length_1775_cov_54.208234	1103	1167	350	1	64	0.0156250
NODE_1657_length_1775_cov_54.208234	1103	1167	351	2	64	0.0312500
NODE_1657_length_1775_cov_54.208234	1103	1167	352	5	64	0.0781250
NODE_1657_length_1775_cov_54.208234	1103	1167	353	2	64	0.0312500
NODE_1657_length_1775_cov_54.208234	1103	1167	354	1	64	0.0156250
NODE_1657_length_1775_cov_54.208234	1103	1167	355	1	64	0.0156250
NODE_1657_length_1775_cov_54.208234	1103	1167	363	4	64	0.0625000
NODE_1657_length_1775_cov_54.208234	1103	1167	370	1	64	0.0156250
NODE_1657_length_1775_cov_54.208234	1103	1167	372	3	64	0.0468750
NODE_1657_length_1775_cov_54.208234	1103	1167	374	1	64	0.0156250
NODE_1657_length_1775_cov_54.208234	1103	1167	375	1	64	0.0156250
NODE_1657_length_1775_cov_54.208234	1103	1167	376	2	64	0.0312500
NODE_1657_length_1775_cov_54.208234	1103	1167	377	1	64	0.0156250
NODE_1657_length_1775_cov_54.208234	1103	1167	378	1	64	0.0156250
NODE_1657_length_1775_cov_54.208234	1103	1167	380	1	64	0.0156250
NODE_1657_length_1775_cov_54.208234	1103	1167	381	2	64	0.0312500
NODE_1657_length_1775_cov_54.208234	1140	1200	285	1	60	0.0166667
NODE_1657_length_1775_cov_54.208234	1140	1200	290	1	60	0.0166667
NODE_1657_length_1775_cov_54.208234	1140	1200	291	2	60	0.0333333
NODE_1657_length_1775_cov_54.208234	1140	1200	292	6	60	0.1000000
NODE_1657_length_1775_cov_54.208234	1140	1200	293	7	60	0.1166667
NODE_1657_length_1775_cov_54.208234	1140	1200	297	1	60	0.0166667
NODE_1657_length_1775_cov_54.208234	1140	1200	305	1	60	0.0166667
NODE_1657_length_1775_cov_54.208234	1140	1200	314	3	60	0.0500000
NODE_1657_length_1775_cov_54.208234	1140	1200	316	1	60	0.0166667
NODE_1657_length_1775_cov_54.208234	1140	1200	322	1	60	0.0166667
NODE_1657_length_1775_cov_54.208234	1140	1200	331	1	60	0.0166667
NODE_1657_length_1775_cov_54.208234	1140	1200	333	5	60	0.0833333
NODE_1657_length_1775_cov_54.208234	1140	1200	334	1	60	0.0166667
NODE_1657_length_1775_cov_54.208234	1140	1200	335	2	60	0.0333333
NODE_1657_length_1775_cov_54.208234	1140	1200	341	2	60	0.0333333
NODE_1657_length_1775_cov_54.208234	1140	1200	342	2	60	0.0333333
NODE_1657_length_1775_cov_54.208234	1140	1200	345	1	60	0.0166667
NODE_1657_length_1775_cov_54.208234	1140	1200	347	2	60	0.0333333
NODE_1657_length_1775_cov_54.208234	1140	1200	350	1	60	0.0166667
NODE_1657_length_1775_cov_54.208234	1140	1200	351	2	60	0.0333333
NODE_1657_length_1775_cov_54.208234	1140	1200	352	1	60	0.0166667
NODE_1657_length_1775_cov_54.208234	1140	1200	353	2	60	0.0333333
NODE_1657_length_1775_cov_54.208234	1140	1200	355	1	60	0.0166667
NODE_1657_length_1775_cov_54.208234	1140	1200	363	2	60	0.0333333
NODE_1657_length_1775_cov_54.208234	1140	1200	370	1	60	0.0166667
NODE_1657_length_1775_cov_54.208234	1140	1200	372	3	60	0.0500000
NODE_1657_length_1775_cov_54.208234	1140	1200	374	1	60	0.0166667
NODE_1657_length_1775_cov_54.208234	1140	1200	375	1	60	0.0166667
NODE_1657_length_1775_cov_54.208234	1140	1200	376	1	60	0.0166667
NODE_1657_length_1775_cov_54.208234	1140	1200	378	1	60	0.0166667
NODE_1657_length_1775_cov_54.208234	1140	1200	380	1	60	0.0166667
NODE_1657_length_1775_cov_54.208234	1140	1200	381	2	60	0.0333333
NODE_1658_length_1775_cov_13.181981	1170	1250	0	80	80	1.0000000
NODE_1658_length_1775_cov_13.181981	1223	1303	0	80	80	1.0000000
NODE_1659_length_1775_cov_4.218974	1304	1384	0	80	80	1.0000000
NODE_1659_length_1775_cov_4.218974	1357	1437	0	80	80	1.0000000
NODE_1660_length_1774_cov_48.617313	345	425	0	80	80	1.0000000
NODE_1660_length_1774_cov_48.617313	398	478	0	80	80	1.0000000
NODE_1660_length_1774_cov_48.617313	474	554	0	80	80	1.0000000
NODE_1660_length_1774_cov_48.617313	527	607	0	80	80	1.0000000
NODE_1660_length_1774_cov_48.617313	1027	1107	0	80	80	1.0000000
NODE_1660_length_1774_cov_48.617313	1080	1160	0	78	80	0.9750000
NODE_1660_length_1774_cov_48.617313	1080	1160	2	2	80	0.0250000
NODE_1660_length_1774_cov_48.617313	1156	1236	0	2	80	0.0250000
NODE_1660_length_1774_cov_48.617313	1156	1236	2	21	80	0.2625000
NODE_1660_length_1774_cov_48.617313	1156	1236	6	1	80	0.0125000
NODE_1660_length_1774_cov_48.617313	1156	1236	8	56	80	0.7000000
NODE_1660_length_1774_cov_48.617313	1209	1289	2	2	80	0.0250000
NODE_1660_length_1774_cov_48.617313	1209	1289	4	7	80	0.0875000
NODE_1660_length_1774_cov_48.617313	1209	1289	5	1	80	0.0125000
NODE_1660_length_1774_cov_48.617313	1209	1289	6	14	80	0.1750000
NODE_1660_length_1774_cov_48.617313	1209	1289	8	56	80	0.7000000
NODE_1662_length_1774_cov_8.011343	1655	1735	0	80	80	1.0000000
NODE_1663_length_1773_cov_5.547192	433	513	0	4	80	0.0500000
NODE_1663_length_1773_cov_5.547192	433	513	2	76	80	0.9500000
NODE_1663_length_1773_cov_5.547192	486	566	0	31	80	0.3875000
NODE_1663_length_1773_cov_5.547192	486	566	2	49	80	0.6125000
NODE_1664_length_1773_cov_3.925329	267	347	0	80	80	1.0000000
NODE_1664_length_1773_cov_3.925329	320	400	0	80	80	1.0000000
NODE_1666_length_1770_cov_9.912029	369	437	0	68	68	1.0000000
NODE_1666_length_1770_cov_9.912029	388	431	0	43	43	1.0000000
NODE_1666_length_1770_cov_9.912029	509	577	0	68	68	1.0000000
NODE_1666_length_1770_cov_9.912029	515	571	0	56	56	1.0000000
NODE_1666_length_1770_cov_9.912029	579	618	0	39	39	1.0000000
NODE_1666_length_1770_cov_9.912029	697	776	0	79	79	1.0000000
NODE_1666_length_1770_cov_9.912029	714	794	0	80	80	1.0000000
NODE_1666_length_1770_cov_9.912029	767	819	0	52	52	1.0000000
NODE_1666_length_1770_cov_9.912029	785	819	0	34	34	1.0000000
NODE_1667_length_1768_cov_9.134811	687	736	75	1	49	0.0204082
NODE_1667_length_1768_cov_9.134811	687	736	80	2	49	0.0408163
NODE_1667_length_1768_cov_9.134811	687	736	81	2	49	0.0408163
NODE_1667_length_1768_cov_9.134811	687	736	82	5	49	0.1020408
NODE_1667_length_1768_cov_9.134811	687	736	83	1	49	0.0204082
NODE_1667_length_1768_cov_9.134811	687	736	84	4	49	0.0816327
NODE_1667_length_1768_cov_9.134811	687	736	85	3	49	0.0612245
NODE_1667_length_1768_cov_9.134811	687	736	86	13	49	0.2653061
NODE_1667_length_1768_cov_9.134811	687	736	87	2	49	0.0408163
NODE_1667_length_1768_cov_9.134811	687	736	88	5	49	0.1020408
NODE_1667_length_1768_cov_9.134811	687	736	89	3	49	0.0612245
NODE_1667_length_1768_cov_9.134811	687	736	90	2	49	0.0408163
NODE_1667_length_1768_cov_9.134811	687	736	91	6	49	0.1224490
NODE_1668_length_1768_cov_6.605153	1207	1287	0	5	80	0.0625000
NODE_1668_length_1768_cov_6.605153	1207	1287	2	75	80	0.9375000
NODE_1668_length_1768_cov_6.605153	1260	1340	0	5	80	0.0625000
NODE_1668_length_1768_cov_6.605153	1260	1340	2	75	80	0.9375000
NODE_1668_length_1768_cov_6.605153	1336	1416	0	49	80	0.6125000
NODE_1668_length_1768_cov_6.605153	1336	1416	2	31	80	0.3875000
NODE_1668_length_1768_cov_6.605153	1389	1469	0	80	80	1.0000000
NODE_1669_length_1767_cov_5.475420	508	588	5	8	80	0.1000000
NODE_1669_length_1767_cov_5.475420	508	588	6	20	80	0.2500000
NODE_1669_length_1767_cov_5.475420	508	588	7	5	80	0.0625000
NODE_1669_length_1767_cov_5.475420	508	588	8	36	80	0.4500000
NODE_1669_length_1767_cov_5.475420	508	588	9	11	80	0.1375000
NODE_1680_length_1762_cov_18.673482	606	686	0	80	80	1.0000000
NODE_1680_length_1762_cov_18.673482	659	739	0	80	80	1.0000000
NODE_1680_length_1762_cov_18.673482	735	815	0	80	80	1.0000000
NODE_1680_length_1762_cov_18.673482	788	868	0	80	80	1.0000000
NODE_1681_length_1762_cov_6.760072	1033	1113	0	26	80	0.3250000
NODE_1681_length_1762_cov_6.760072	1033	1113	2	54	80	0.6750000
NODE_1681_length_1762_cov_6.760072	1086	1166	2	80	80	1.0000000
NODE_1685_length_1760_cov_8.064419	941	1021	2	80	80	1.0000000
NODE_1685_length_1760_cov_8.064419	994	1074	0	4	80	0.0500000
NODE_1685_length_1760_cov_8.064419	994	1074	2	76	80	0.9500000
NODE_1692_length_1758_cov_99.869198	599	679	4	69	80	0.8625000
NODE_1692_length_1758_cov_99.869198	599	679	6	11	80	0.1375000
NODE_1692_length_1758_cov_99.869198	652	732	2	3	80	0.0375000
NODE_1692_length_1758_cov_99.869198	652	732	4	59	80	0.7375000
NODE_1692_length_1758_cov_99.869198	652	732	6	18	80	0.2250000
NODE_1692_length_1758_cov_99.869198	728	808	0	9	80	0.1125000
NODE_1692_length_1758_cov_99.869198	728	808	2	33	80	0.4125000
NODE_1692_length_1758_cov_99.869198	728	808	4	38	80	0.4750000
NODE_1692_length_1758_cov_99.869198	781	861	0	9	80	0.1125000
NODE_1692_length_1758_cov_99.869198	781	861	2	30	80	0.3750000
NODE_1692_length_1758_cov_99.869198	781	861	4	41	80	0.5125000
NODE_1693_length_1757_cov_3.126659	49	121	0	72	72	1.0000000
NODE_1696_length_1755_cov_9.938406	231	311	0	60	80	0.7500000
NODE_1696_length_1755_cov_9.938406	231	311	2	20	80	0.2500000
NODE_1696_length_1755_cov_9.938406	284	364	0	80	80	1.0000000
NODE_1698_length_1755_cov_3.614130	171	222	4	20	51	0.3921569
NODE_1698_length_1755_cov_3.614130	171	222	6	8	51	0.1568628
NODE_1698_length_1755_cov_3.614130	171	222	8	2	51	0.0392157
NODE_1698_length_1755_cov_3.614130	171	222	10	21	51	0.4117647
NODE_1699_length_1754_cov_8.523263	0	77	0	38	77	0.4935065
NODE_1699_length_1754_cov_8.523263	0	77	4	39	77	0.5064935
NODE_1699_length_1754_cov_8.523263	0	77	0	38	77	0.4935065
NODE_1699_length_1754_cov_8.523263	0	77	4	39	77	0.5064935
NODE_1699_length_1754_cov_8.523263	0	77	0	38	77	0.4935065
NODE_1699_length_1754_cov_8.523263	0	77	4	39	77	0.5064935
NODE_1699_length_1754_cov_8.523263	50	99	4	45	49	0.9183673
NODE_1699_length_1754_cov_8.523263	50	99	6	4	49	0.0816327
NODE_1699_length_1754_cov_8.523263	53	99	4	42	46	0.9130435
NODE_1699_length_1754_cov_8.523263	53	99	6	4	46	0.0869565
NODE_1699_length_1754_cov_8.523263	55	99	4	40	44	0.9090909
NODE_1699_length_1754_cov_8.523263	55	99	6	4	44	0.0909091
NODE_1700_length_1753_cov_26.851874	356	436	0	39	80	0.4875000
NODE_1700_length_1753_cov_26.851874	356	436	2	31	80	0.3875000
NODE_1700_length_1753_cov_26.851874	356	436	4	10	80	0.1250000
NODE_1700_length_1753_cov_26.851874	409	489	2	51	80	0.6375000
NODE_1700_length_1753_cov_26.851874	409	489	4	29	80	0.3625000
NODE_1701_length_1753_cov_12.297461	355	435	0	6	80	0.0750000
NODE_1701_length_1753_cov_12.297461	355	435	16	1	80	0.0125000
NODE_1701_length_1753_cov_12.297461	355	435	17	32	80	0.4000000
NODE_1701_length_1753_cov_12.297461	355	435	18	41	80	0.5125000
NODE_1701_length_1753_cov_12.297461	408	488	0	59	80	0.7375000
NODE_1701_length_1753_cov_12.297461	408	488	16	1	80	0.0125000
NODE_1701_length_1753_cov_12.297461	408	488	17	20	80	0.2500000
NODE_1705_length_1750_cov_90.732283	1191	1254	218	1	63	0.0158730
NODE_1705_length_1750_cov_90.732283	1191	1254	219	2	63	0.0317460
NODE_1705_length_1750_cov_90.732283	1191	1254	220	3	63	0.0476190
NODE_1705_length_1750_cov_90.732283	1191	1254	221	3	63	0.0476190
NODE_1705_length_1750_cov_90.732283	1191	1254	222	1	63	0.0158730
NODE_1705_length_1750_cov_90.732283	1191	1254	223	2	63	0.0317460
NODE_1705_length_1750_cov_90.732283	1191	1254	226	1	63	0.0158730
NODE_1705_length_1750_cov_90.732283	1191	1254	232	1	63	0.0158730
NODE_1705_length_1750_cov_90.732283	1191	1254	235	1	63	0.0158730
NODE_1705_length_1750_cov_90.732283	1191	1254	237	1	63	0.0158730
NODE_1705_length_1750_cov_90.732283	1191	1254	239	1	63	0.0158730
NODE_1705_length_1750_cov_90.732283	1191	1254	242	2	63	0.0317460
NODE_1705_length_1750_cov_90.732283	1191	1254	245	2	63	0.0317460
NODE_1705_length_1750_cov_90.732283	1191	1254	246	3	63	0.0476190
NODE_1705_length_1750_cov_90.732283	1191	1254	249	1	63	0.0158730
NODE_1705_length_1750_cov_90.732283	1191	1254	253	2	63	0.0317460
NODE_1705_length_1750_cov_90.732283	1191	1254	254	1	63	0.0158730
NODE_1705_length_1750_cov_90.732283	1191	1254	257	3	63	0.0476190
NODE_1705_length_1750_cov_90.732283	1191	1254	258	2	63	0.0317460
NODE_1705_length_1750_cov_90.732283	1191	1254	260	2	63	0.0317460
NODE_1705_length_1750_cov_90.732283	1191	1254	261	2	63	0.0317460
NODE_1705_length_1750_cov_90.732283	1191	1254	262	3	63	0.0476190
NODE_1705_length_1750_cov_90.732283	1191	1254	264	1	63	0.0158730
NODE_1705_length_1750_cov_90.732283	1191	1254	265	1	63	0.0158730
NODE_1705_length_1750_cov_90.732283	1191	1254	269	1	63	0.0158730
NODE_1705_length_1750_cov_90.732283	1191	1254	270	1	63	0.0158730
NODE_1705_length_1750_cov_90.732283	1191	1254	276	1	63	0.0158730
NODE_1705_length_1750_cov_90.732283	1191	1254	278	1	63	0.0158730
NODE_1705_length_1750_cov_90.732283	1191	1254	279	2	63	0.0317460
NODE_1705_length_1750_cov_90.732283	1191	1254	282	4	63	0.0634921
NODE_1705_length_1750_cov_90.732283	1191	1254	283	5	63	0.0793651
NODE_1705_length_1750_cov_90.732283	1191	1254	285	1	63	0.0158730
NODE_1705_length_1750_cov_90.732283	1191	1254	287	2	63	0.0317460
NODE_1705_length_1750_cov_90.732283	1191	1254	288	1	63	0.0158730
NODE_1705_length_1750_cov_90.732283	1191	1254	290	1	63	0.0158730
NODE_1705_length_1750_cov_90.732283	1191	1254	292	1	63	0.0158730
NODE_1705_length_1750_cov_90.732283	1239	1310	279	2	71	0.0281690
NODE_1705_length_1750_cov_90.732283	1239	1310	282	4	71	0.0563380
NODE_1705_length_1750_cov_90.732283	1239	1310	283	4	71	0.0563380
NODE_1705_length_1750_cov_90.732283	1239	1310	285	1	71	0.0140845
NODE_1705_length_1750_cov_90.732283	1239	1310	287	2	71	0.0281690
NODE_1705_length_1750_cov_90.732283	1239	1310	290	1	71	0.0140845
NODE_1705_length_1750_cov_90.732283	1239	1310	292	1	71	0.0140845
NODE_1705_length_1750_cov_90.732283	1239	1310	297	1	71	0.0140845
NODE_1705_length_1750_cov_90.732283	1239	1310	298	1	71	0.0140845
NODE_1705_length_1750_cov_90.732283	1239	1310	300	2	71	0.0281690
NODE_1705_length_1750_cov_90.732283	1239	1310	302	2	71	0.0281690
NODE_1705_length_1750_cov_90.732283	1239	1310	307	1	71	0.0140845
NODE_1705_length_1750_cov_90.732283	1239	1310	308	1	71	0.0140845
NODE_1705_length_1750_cov_90.732283	1239	1310	310	1	71	0.0140845
NODE_1705_length_1750_cov_90.732283	1239	1310	311	2	71	0.0281690
NODE_1705_length_1750_cov_90.732283	1239	1310	314	1	71	0.0140845
NODE_1705_length_1750_cov_90.732283	1239	1310	315	2	71	0.0281690
NODE_1705_length_1750_cov_90.732283	1239	1310	316	2	71	0.0281690
NODE_1705_length_1750_cov_90.732283	1239	1310	317	3	71	0.0422535
NODE_1705_length_1750_cov_90.732283	1239	1310	318	2	71	0.0281690
NODE_1705_length_1750_cov_90.732283	1239	1310	319	4	71	0.0563380
NODE_1705_length_1750_cov_90.732283	1239	1310	321	1	71	0.0140845
NODE_1705_length_1750_cov_90.732283	1239	1310	323	5	71	0.0704225
NODE_1705_length_1750_cov_90.732283	1239	1310	324	3	71	0.0422535
NODE_1705_length_1750_cov_90.732283	1239	1310	325	2	71	0.0281690
NODE_1705_length_1750_cov_90.732283	1239	1310	326	2	71	0.0281690
NODE_1705_length_1750_cov_90.732283	1239	1310	328	3	71	0.0422535
NODE_1705_length_1750_cov_90.732283	1239	1310	329	4	71	0.0563380
NODE_1705_length_1750_cov_90.732283	1239	1310	330	1	71	0.0140845
NODE_1705_length_1750_cov_90.732283	1239	1310	331	3	71	0.0422535
NODE_1705_length_1750_cov_90.732283	1239	1310	332	2	71	0.0281690
NODE_1705_length_1750_cov_90.732283	1239	1310	334	1	71	0.0140845
NODE_1705_length_1750_cov_90.732283	1239	1310	335	1	71	0.0140845
NODE_1705_length_1750_cov_90.732283	1239	1310	341	1	71	0.0140845
NODE_1705_length_1750_cov_90.732283	1239	1310	342	1	71	0.0140845
NODE_1705_length_1750_cov_90.732283	1239	1310	343	1	71	0.0140845
NODE_1711_length_1746_cov_3.095932	458	524	0	2	66	0.0303030
NODE_1711_length_1746_cov_3.095932	458	524	1	11	66	0.1666667
NODE_1711_length_1746_cov_3.095932	458	524	4	2	66	0.0303030
NODE_1711_length_1746_cov_3.095932	458	524	5	22	66	0.3333333
NODE_1711_length_1746_cov_3.095932	458	524	6	29	66	0.4393939
NODE_1712_length_1745_cov_7.646416	430	510	2	26	80	0.3250000
NODE_1712_length_1745_cov_7.646416	430	510	4	54	80	0.6750000
NODE_1712_length_1745_cov_7.646416	483	563	0	51	80	0.6375000
NODE_1712_length_1745_cov_7.646416	483	563	2	8	80	0.1000000
NODE_1712_length_1745_cov_7.646416	483	563	4	21	80	0.2625000
NODE_1715_length_1744_cov_10.144681	1213	1289	0	10	76	0.1315790
NODE_1715_length_1744_cov_10.144681	1213	1289	2	17	76	0.2236842
NODE_1715_length_1744_cov_10.144681	1213	1289	6	9	76	0.1184211
NODE_1715_length_1744_cov_10.144681	1213	1289	8	2	76	0.0263158
NODE_1715_length_1744_cov_10.144681	1213	1289	10	3	76	0.0394737
NODE_1715_length_1744_cov_10.144681	1213	1289	12	6	76	0.0789474
NODE_1715_length_1744_cov_10.144681	1213	1289	16	29	76	0.3815790
NODE_1715_length_1744_cov_10.144681	1262	1342	14	6	80	0.0750000
NODE_1715_length_1744_cov_10.144681	1262	1342	15	5	80	0.0625000
NODE_1715_length_1744_cov_10.144681	1262	1342	16	69	80	0.8625000
NODE_1719_length_1742_cov_18.923311	699	776	0	77	77	1.0000000
NODE_1719_length_1742_cov_18.923311	749	829	0	80	80	1.0000000
NODE_1722_length_1741_cov_7.657734	1234	1314	0	80	80	1.0000000
NODE_1722_length_1741_cov_7.657734	1287	1367	0	80	80	1.0000000
NODE_1722_length_1741_cov_7.657734	1363	1443	0	80	80	1.0000000
NODE_1722_length_1741_cov_7.657734	1416	1496	0	80	80	1.0000000
NODE_1726_length_1740_cov_38.411335	517	597	0	80	80	1.0000000
NODE_1726_length_1740_cov_38.411335	570	650	0	80	80	1.0000000
NODE_1726_length_1740_cov_38.411335	646	726	0	80	80	1.0000000
NODE_1726_length_1740_cov_38.411335	699	779	0	80	80	1.0000000
NODE_1727_length_1740_cov_10.843388	552	632	0	80	80	1.0000000
NODE_1727_length_1740_cov_10.843388	708	788	0	80	80	1.0000000
NODE_1727_length_1740_cov_10.843388	708	788	0	80	80	1.0000000
NODE_1727_length_1740_cov_10.843388	708	788	0	80	80	1.0000000
NODE_1727_length_1740_cov_10.843388	761	841	0	56	80	0.7000000
NODE_1727_length_1740_cov_10.843388	761	841	2	24	80	0.3000000
NODE_1727_length_1740_cov_10.843388	761	808	0	47	47	1.0000000
NODE_1727_length_1740_cov_10.843388	761	808	0	47	47	1.0000000
NODE_1737_length_1736_cov_71.959682	841	901	81	4	60	0.0666667
NODE_1737_length_1736_cov_71.959682	841	901	82	14	60	0.2333333
NODE_1737_length_1736_cov_71.959682	841	901	83	1	60	0.0166667
NODE_1737_length_1736_cov_71.959682	841	901	84	2	60	0.0333333
NODE_1737_length_1736_cov_71.959682	841	901	86	6	60	0.1000000
NODE_1737_length_1736_cov_71.959682	841	901	87	9	60	0.1500000
NODE_1737_length_1736_cov_71.959682	841	901	89	3	60	0.0500000
NODE_1737_length_1736_cov_71.959682	841	901	90	1	60	0.0166667
NODE_1737_length_1736_cov_71.959682	841	901	91	4	60	0.0666667
NODE_1737_length_1736_cov_71.959682	841	901	92	9	60	0.1500000
NODE_1737_length_1736_cov_71.959682	841	901	93	2	60	0.0333333
NODE_1737_length_1736_cov_71.959682	841	901	95	5	60	0.0833333
NODE_1738_length_1736_cov_29.174710	1361	1390	250	1	29	0.0344828
NODE_1738_length_1736_cov_29.174710	1361	1390	251	4	29	0.1379310
NODE_1738_length_1736_cov_29.174710	1361	1390	252	5	29	0.1724138
NODE_1738_length_1736_cov_29.174710	1361	1390	253	4	29	0.1379310
NODE_1738_length_1736_cov_29.174710	1361	1390	254	1	29	0.0344828
NODE_1738_length_1736_cov_29.174710	1361	1390	255	4	29	0.1379310
NODE_1738_length_1736_cov_29.174710	1361	1390	256	2	29	0.0689655
NODE_1738_length_1736_cov_29.174710	1361	1390	257	3	29	0.1034483
NODE_1738_length_1736_cov_29.174710	1361	1390	259	2	29	0.0689655
NODE_1738_length_1736_cov_29.174710	1361	1390	260	3	29	0.1034483
NODE_1738_length_1736_cov_29.174710	1566	1628	305	1	62	0.0161290
NODE_1738_length_1736_cov_29.174710	1566	1628	309	1	62	0.0161290
NODE_1738_length_1736_cov_29.174710	1566	1628	322	1	62	0.0161290
NODE_1738_length_1736_cov_29.174710	1566	1628	326	1	62	0.0161290
NODE_1738_length_1736_cov_29.174710	1566	1628	327	1	62	0.0161290
NODE_1738_length_1736_cov_29.174710	1566	1628	329	2	62	0.0322581
NODE_1738_length_1736_cov_29.174710	1566	1628	333	1	62	0.0161290
NODE_1738_length_1736_cov_29.174710	1566	1628	334	2	62	0.0322581
NODE_1738_length_1736_cov_29.174710	1566	1628	336	4	62	0.0645161
NODE_1738_length_1736_cov_29.174710	1566	1628	338	2	62	0.0322581
NODE_1738_length_1736_cov_29.174710	1566	1628	344	1	62	0.0161290
NODE_1738_length_1736_cov_29.174710	1566	1628	345	1	62	0.0161290
NODE_1738_length_1736_cov_29.174710	1566	1628	346	2	62	0.0322581
NODE_1738_length_1736_cov_29.174710	1566	1628	348	1	62	0.0161290
NODE_1738_length_1736_cov_29.174710	1566	1628	359	1	62	0.0161290
NODE_1738_length_1736_cov_29.174710	1566	1628	367	1	62	0.0161290
NODE_1738_length_1736_cov_29.174710	1566	1628	371	1	62	0.0161290
NODE_1738_length_1736_cov_29.174710	1566	1628	373	3	62	0.0483871
NODE_1738_length_1736_cov_29.174710	1566	1628	377	1	62	0.0161290
NODE_1738_length_1736_cov_29.174710	1566	1628	379	1	62	0.0161290
NODE_1738_length_1736_cov_29.174710	1566	1628	381	1	62	0.0161290
NODE_1738_length_1736_cov_29.174710	1566	1628	400	1	62	0.0161290
NODE_1738_length_1736_cov_29.174710	1566	1628	403	3	62	0.0483871
NODE_1738_length_1736_cov_29.174710	1566	1628	404	3	62	0.0483871
NODE_1738_length_1736_cov_29.174710	1566	1628	405	2	62	0.0322581
NODE_1738_length_1736_cov_29.174710	1566	1628	406	6	62	0.0967742
NODE_1738_length_1736_cov_29.174710	1566	1628	408	1	62	0.0161290
NODE_1738_length_1736_cov_29.174710	1566	1628	410	1	62	0.0161290
NODE_1738_length_1736_cov_29.174710	1566	1628	412	1	62	0.0161290
NODE_1738_length_1736_cov_29.174710	1566	1628	414	3	62	0.0483871
NODE_1738_length_1736_cov_29.174710	1566	1628	415	2	62	0.0322581
NODE_1738_length_1736_cov_29.174710	1566	1628	416	1	62	0.0161290
NODE_1738_length_1736_cov_29.174710	1566	1628	417	1	62	0.0161290
NODE_1738_length_1736_cov_29.174710	1566	1628	425	2	62	0.0322581
NODE_1738_length_1736_cov_29.174710	1566	1628	427	1	62	0.0161290
NODE_1738_length_1736_cov_29.174710	1566	1628	428	1	62	0.0161290
NODE_1738_length_1736_cov_29.174710	1566	1628	432	1	62	0.0161290
NODE_1738_length_1736_cov_29.174710	1566	1628	435	2	62	0.0322581
NODE_1743_length_1732_cov_6.162890	807	887	0	17	80	0.2125000
NODE_1743_length_1732_cov_6.162890	807	887	1	15	80	0.1875000
NODE_1743_length_1732_cov_6.162890	807	887	3	6	80	0.0750000
NODE_1743_length_1732_cov_6.162890	807	887	4	42	80	0.5250000
NODE_1743_length_1732_cov_6.162890	860	940	2	10	80	0.1250000
NODE_1743_length_1732_cov_6.162890	860	940	4	70	80	0.8750000
NODE_1749_length_1729_cov_23.708589	364	443	0	79	79	1.0000000
NODE_1749_length_1729_cov_23.708589	416	496	0	80	80	1.0000000
NODE_1749_length_1729_cov_23.708589	492	572	0	80	80	1.0000000
NODE_1749_length_1729_cov_23.708589	545	625	0	80	80	1.0000000
NODE_1753_length_1728_cov_26.505832	259	339	0	80	80	1.0000000
NODE_1753_length_1728_cov_26.505832	312	392	0	80	80	1.0000000
NODE_1757_length_1725_cov_142.158057	767	814	697	1	47	0.0212766
NODE_1757_length_1725_cov_142.158057	767	814	701	2	47	0.0425532
NODE_1757_length_1725_cov_142.158057	767	814	707	1	47	0.0212766
NODE_1757_length_1725_cov_142.158057	767	814	711	1	47	0.0212766
NODE_1757_length_1725_cov_142.158057	767	814	723	1	47	0.0212766
NODE_1757_length_1725_cov_142.158057	767	814	729	1	47	0.0212766
NODE_1757_length_1725_cov_142.158057	767	814	730	1	47	0.0212766
NODE_1757_length_1725_cov_142.158057	767	814	731	1	47	0.0212766
NODE_1757_length_1725_cov_142.158057	767	814	734	1	47	0.0212766
NODE_1757_length_1725_cov_142.158057	767	814	746	1	47	0.0212766
NODE_1757_length_1725_cov_142.158057	767	814	761	1	47	0.0212766
NODE_1757_length_1725_cov_142.158057	767	814	768	1	47	0.0212766
NODE_1757_length_1725_cov_142.158057	767	814	770	1	47	0.0212766
NODE_1757_length_1725_cov_142.158057	767	814	779	1	47	0.0212766
NODE_1757_length_1725_cov_142.158057	767	814	790	1	47	0.0212766
NODE_1757_length_1725_cov_142.158057	767	814	794	1	47	0.0212766
NODE_1757_length_1725_cov_142.158057	767	814	804	1	47	0.0212766
NODE_1757_length_1725_cov_142.158057	767	814	806	1	47	0.0212766
NODE_1757_length_1725_cov_142.158057	767	814	818	1	47	0.0212766
NODE_1757_length_1725_cov_142.158057	767	814	821	1	47	0.0212766
NODE_1757_length_1725_cov_142.158057	767	814	822	1	47	0.0212766
NODE_1757_length_1725_cov_142.158057	767	814	835	1	47	0.0212766
NODE_1757_length_1725_cov_142.158057	767	814	841	1	47	0.0212766
NODE_1757_length_1725_cov_142.158057	767	814	849	1	47	0.0212766
NODE_1757_length_1725_cov_142.158057	767	814	853	1	47	0.0212766
NODE_1757_length_1725_cov_142.158057	767	814	854	1	47	0.0212766
NODE_1757_length_1725_cov_142.158057	767	814	861	1	47	0.0212766
NODE_1757_length_1725_cov_142.158057	767	814	863	1	47	0.0212766
NODE_1757_length_1725_cov_142.158057	767	814	869	2	47	0.0425532
NODE_1757_length_1725_cov_142.158057	767	814	875	1	47	0.0212766
NODE_1757_length_1725_cov_142.158057	767	814	878	1	47	0.0212766
NODE_1757_length_1725_cov_142.158057	767	814	879	1	47	0.0212766
NODE_1757_length_1725_cov_142.158057	767	814	880	2	47	0.0425532
NODE_1757_length_1725_cov_142.158057	767	814	882	3	47	0.0638298
NODE_1757_length_1725_cov_142.158057	767	814	884	1	47	0.0212766
NODE_1757_length_1725_cov_142.158057	767	814	886	2	47	0.0425532
NODE_1757_length_1725_cov_142.158057	767	814	887	2	47	0.0425532
NODE_1757_length_1725_cov_142.158057	767	814	888	1	47	0.0212766
NODE_1757_length_1725_cov_142.158057	767	814	896	1	47	0.0212766
NODE_1757_length_1725_cov_142.158057	767	814	900	1	47	0.0212766
NODE_1757_length_1725_cov_142.158057	803	867	759	2	64	0.0312500
NODE_1757_length_1725_cov_142.158057	803	867	770	1	64	0.0156250
NODE_1757_length_1725_cov_142.158057	803	867	773	1	64	0.0156250
NODE_1757_length_1725_cov_142.158057	803	867	775	1	64	0.0156250
NODE_1757_length_1725_cov_142.158057	803	867	776	1	64	0.0156250
NODE_1757_length_1725_cov_142.158057	803	867	777	1	64	0.0156250
NODE_1757_length_1725_cov_142.158057	803	867	779	1	64	0.0156250
NODE_1757_length_1725_cov_142.158057	803	867	781	1	64	0.0156250
NODE_1757_length_1725_cov_142.158057	803	867	786	1	64	0.0156250
NODE_1757_length_1725_cov_142.158057	803	867	795	1	64	0.0156250
NODE_1757_length_1725_cov_142.158057	803	867	799	1	64	0.0156250
NODE_1757_length_1725_cov_142.158057	803	867	801	1	64	0.0156250
NODE_1757_length_1725_cov_142.158057	803	867	803	1	64	0.0156250
NODE_1757_length_1725_cov_142.158057	803	867	806	1	64	0.0156250
NODE_1757_length_1725_cov_142.158057	803	867	812	1	64	0.0156250
NODE_1757_length_1725_cov_142.158057	803	867	825	1	64	0.0156250
NODE_1757_length_1725_cov_142.158057	803	867	830	1	64	0.0156250
NODE_1757_length_1725_cov_142.158057	803	867	835	1	64	0.0156250
NODE_1757_length_1725_cov_142.158057	803	867	843	1	64	0.0156250
NODE_1757_length_1725_cov_142.158057	803	867	847	1	64	0.0156250
NODE_1757_length_1725_cov_142.158057	803	867	853	1	64	0.0156250
NODE_1757_length_1725_cov_142.158057	803	867	855	1	64	0.0156250
NODE_1757_length_1725_cov_142.158057	803	867	866	1	64	0.0156250
NODE_1757_length_1725_cov_142.158057	803	867	867	2	64	0.0312500
NODE_1757_length_1725_cov_142.158057	803	867	868	1	64	0.0156250
NODE_1757_length_1725_cov_142.158057	803	867	869	1	64	0.0156250
NODE_1757_length_1725_cov_142.158057	803	867	871	2	64	0.0312500
NODE_1757_length_1725_cov_142.158057	803	867	877	2	64	0.0312500
NODE_1757_length_1725_cov_142.158057	803	867	878	1	64	0.0156250
NODE_1757_length_1725_cov_142.158057	803	867	879	2	64	0.0312500
NODE_1757_length_1725_cov_142.158057	803	867	880	3	64	0.0468750
NODE_1757_length_1725_cov_142.158057	803	867	882	3	64	0.0468750
NODE_1757_length_1725_cov_142.158057	803	867	883	2	64	0.0312500
NODE_1757_length_1725_cov_142.158057	803	867	884	2	64	0.0312500
NODE_1757_length_1725_cov_142.158057	803	867	885	1	64	0.0156250
NODE_1757_length_1725_cov_142.158057	803	867	887	5	64	0.0781250
NODE_1757_length_1725_cov_142.158057	803	867	888	5	64	0.0781250
NODE_1757_length_1725_cov_142.158057	803	867	889	1	64	0.0156250
NODE_1757_length_1725_cov_142.158057	803	867	890	3	64	0.0468750
NODE_1757_length_1725_cov_142.158057	803	867	891	1	64	0.0156250
NODE_1757_length_1725_cov_142.158057	803	867	892	1	64	0.0156250
NODE_1757_length_1725_cov_142.158057	803	867	894	1	64	0.0156250
NODE_1757_length_1725_cov_142.158057	803	867	896	1	64	0.0156250
NODE_1759_length_1724_cov_17.931077	677	746	2	11	69	0.1594203
NODE_1759_length_1724_cov_17.931077	677	746	4	28	69	0.4057971
NODE_1759_length_1724_cov_17.931077	677	746	6	30	69	0.4347826
NODE_1759_length_1724_cov_17.931077	788	850	2	40	62	0.6451613
NODE_1759_length_1724_cov_17.931077	788	850	4	8	62	0.1290323
NODE_1759_length_1724_cov_17.931077	788	850	6	14	62	0.2258064
NODE_1761_length_1723_cov_35.355296	1174	1254	0	80	80	1.0000000
NODE_1761_length_1723_cov_35.355296	1227	1307	0	80	80	1.0000000
NODE_1763_length_1722_cov_13.235367	708	788	2	80	80	1.0000000
NODE_1763_length_1722_cov_13.235367	761	841	1	7	80	0.0875000
NODE_1763_length_1722_cov_13.235367	761	841	2	73	80	0.9125000
NODE_1763_length_1722_cov_13.235367	1319	1399	0	80	80	1.0000000
NODE_1763_length_1722_cov_13.235367	1372	1452	0	80	80	1.0000000
NODE_1765_length_1720_cov_27.328192	1248	1307	16	2	59	0.0338983
NODE_1765_length_1720_cov_27.328192	1248	1307	24	1	59	0.0169492
NODE_1765_length_1720_cov_27.328192	1248	1307	25	11	59	0.1864407
NODE_1765_length_1720_cov_27.328192	1248	1307	33	1	59	0.0169492
NODE_1765_length_1720_cov_27.328192	1248	1307	34	1	59	0.0169492
NODE_1765_length_1720_cov_27.328192	1248	1307	37	10	59	0.1694915
NODE_1765_length_1720_cov_27.328192	1248	1307	47	20	59	0.3389831
NODE_1765_length_1720_cov_27.328192	1248	1307	51	7	59	0.1186441
NODE_1765_length_1720_cov_27.328192	1248	1307	53	6	59	0.1016949
NODE_1765_length_1720_cov_27.328192	1280	1360	34	1	80	0.0125000
NODE_1765_length_1720_cov_27.328192	1280	1360	36	1	80	0.0125000
NODE_1765_length_1720_cov_27.328192	1280	1360	45	4	80	0.0500000
NODE_1765_length_1720_cov_27.328192	1280	1360	47	14	80	0.1750000
NODE_1765_length_1720_cov_27.328192	1280	1360	51	7	80	0.0875000
NODE_1765_length_1720_cov_27.328192	1280	1360	53	51	80	0.6375000
NODE_1765_length_1720_cov_27.328192	1280	1360	55	2	80	0.0250000
NODE_1766_length_1720_cov_4.129550	241	321	0	80	80	1.0000000
NODE_1766_length_1720_cov_4.129550	294	374	0	80	80	1.0000000
NODE_1768_length_1719_cov_9.878395	410	490	0	80	80	1.0000000
NODE_1768_length_1719_cov_9.878395	463	543	0	80	80	1.0000000
NODE_1768_length_1719_cov_9.878395	539	619	0	47	80	0.5875000
NODE_1768_length_1719_cov_9.878395	539	619	2	33	80	0.4125000
NODE_1768_length_1719_cov_9.878395	592	672	0	18	80	0.2250000
NODE_1768_length_1719_cov_9.878395	592	672	2	62	80	0.7750000
NODE_1772_length_1717_cov_5.159456	145	219	0	3	74	0.0405405
NODE_1772_length_1717_cov_5.159456	145	219	4	4	74	0.0540541
NODE_1772_length_1717_cov_5.159456	145	219	8	2	74	0.0270270
NODE_1772_length_1717_cov_5.159456	145	219	11	5	74	0.0675676
NODE_1772_length_1717_cov_5.159456	145	219	12	1	74	0.0135135
NODE_1772_length_1717_cov_5.159456	145	219	14	2	74	0.0270270
NODE_1772_length_1717_cov_5.159456	145	219	16	7	74	0.0945946
NODE_1772_length_1717_cov_5.159456	145	219	18	1	74	0.0135135
NODE_1772_length_1717_cov_5.159456	145	219	36	6	74	0.0810811
NODE_1772_length_1717_cov_5.159456	145	219	38	1	74	0.0135135
NODE_1772_length_1717_cov_5.159456	145	219	40	2	74	0.0270270
NODE_1772_length_1717_cov_5.159456	145	219	42	1	74	0.0135135
NODE_1772_length_1717_cov_5.159456	145	219	46	1	74	0.0135135
NODE_1772_length_1717_cov_5.159456	145	219	48	3	74	0.0405405
NODE_1772_length_1717_cov_5.159456	145	219	50	3	74	0.0405405
NODE_1772_length_1717_cov_5.159456	145	219	52	5	74	0.0675676
NODE_1772_length_1717_cov_5.159456	145	219	53	1	74	0.0135135
NODE_1772_length_1717_cov_5.159456	145	219	57	1	74	0.0135135
NODE_1772_length_1717_cov_5.159456	145	219	59	1	74	0.0135135
NODE_1772_length_1717_cov_5.159456	145	219	61	4	74	0.0540541
NODE_1772_length_1717_cov_5.159456	145	219	65	1	74	0.0135135
NODE_1772_length_1717_cov_5.159456	145	219	67	2	74	0.0270270
NODE_1772_length_1717_cov_5.159456	145	219	69	5	74	0.0675676
NODE_1772_length_1717_cov_5.159456	145	219	71	8	74	0.1081081
NODE_1772_length_1717_cov_5.159456	145	219	75	4	74	0.0540541
NODE_1772_length_1717_cov_5.159456	1450	1508	0	7	58	0.1206897
NODE_1772_length_1717_cov_5.159456	1450	1508	1	51	58	0.8793104
NODE_1772_length_1717_cov_5.159456	1503	1561	0	49	58	0.8448276
NODE_1772_length_1717_cov_5.159456	1503	1561	1	9	58	0.1551724
NODE_1778_length_1715_cov_12.607054	555	635	0	80	80	1.0000000
NODE_1778_length_1715_cov_12.607054	608	688	0	80	80	1.0000000
NODE_1778_length_1715_cov_12.607054	684	764	0	80	80	1.0000000
NODE_1778_length_1715_cov_12.607054	737	817	0	80	80	1.0000000
NODE_1788_length_1707_cov_16.909204	397	477	0	59	80	0.7375000
NODE_1788_length_1707_cov_16.909204	397	477	2	21	80	0.2625000
NODE_1788_length_1707_cov_16.909204	450	530	0	6	80	0.0750000
NODE_1788_length_1707_cov_16.909204	450	530	2	74	80	0.9250000
NODE_1788_length_1707_cov_16.909204	1151	1231	0	80	80	1.0000000
NODE_1788_length_1707_cov_16.909204	1204	1284	0	80	80	1.0000000
NODE_1792_length_1705_cov_19.645081	451	531	0	2	80	0.0250000
NODE_1792_length_1705_cov_19.645081	451	531	2	48	80	0.6000000
NODE_1792_length_1705_cov_19.645081	451	531	6	30	80	0.3750000
NODE_1792_length_1705_cov_19.645081	504	584	0	10	80	0.1250000
NODE_1792_length_1705_cov_19.645081	504	584	6	70	80	0.8750000
NODE_1792_length_1705_cov_19.645081	580	660	0	80	80	1.0000000
NODE_1792_length_1705_cov_19.645081	633	714	0	81	81	1.0000000
NODE_1792_length_1705_cov_19.645081	1315	1395	0	9	80	0.1125000
NODE_1792_length_1705_cov_19.645081	1315	1395	2	71	80	0.8875000
NODE_1792_length_1705_cov_19.645081	1368	1448	0	24	80	0.3000000
NODE_1792_length_1705_cov_19.645081	1368	1448	2	56	80	0.7000000
NODE_1796_length_1703_cov_26.016833	1201	1264	0	4	63	0.0634921
NODE_1796_length_1703_cov_26.016833	1201	1264	4	45	63	0.7142857
NODE_1796_length_1703_cov_26.016833	1201	1264	12	1	63	0.0158730
NODE_1796_length_1703_cov_26.016833	1201	1264	14	2	63	0.0317460
NODE_1796_length_1703_cov_26.016833	1201	1264	49	1	63	0.0158730
NODE_1796_length_1703_cov_26.016833	1201	1264	62	1	63	0.0158730
NODE_1796_length_1703_cov_26.016833	1201	1264	65	1	63	0.0158730
NODE_1796_length_1703_cov_26.016833	1201	1264	115	1	63	0.0158730
NODE_1796_length_1703_cov_26.016833	1201	1264	126	1	63	0.0158730
NODE_1796_length_1703_cov_26.016833	1201	1264	130	1	63	0.0158730
NODE_1796_length_1703_cov_26.016833	1201	1264	133	1	63	0.0158730
NODE_1796_length_1703_cov_26.016833	1201	1264	147	1	63	0.0158730
NODE_1796_length_1703_cov_26.016833	1201	1264	151	2	63	0.0317460
NODE_1796_length_1703_cov_26.016833	1201	1264	153	1	63	0.0158730
NODE_1796_length_1703_cov_26.016833	1207	1264	0	4	57	0.0701754
NODE_1796_length_1703_cov_26.016833	1207	1264	4	45	57	0.7894737
NODE_1796_length_1703_cov_26.016833	1207	1264	12	1	57	0.0175439
NODE_1796_length_1703_cov_26.016833	1207	1264	14	2	57	0.0350877
NODE_1796_length_1703_cov_26.016833	1207	1264	49	1	57	0.0175439
NODE_1796_length_1703_cov_26.016833	1207	1264	62	1	57	0.0175439
NODE_1796_length_1703_cov_26.016833	1207	1264	65	1	57	0.0175439
NODE_1796_length_1703_cov_26.016833	1207	1264	115	1	57	0.0175439
NODE_1796_length_1703_cov_26.016833	1207	1264	126	1	57	0.0175439
NODE_1796_length_1703_cov_26.016833	1207	1264	0	4	57	0.0701754
NODE_1796_length_1703_cov_26.016833	1207	1264	4	45	57	0.7894737
NODE_1796_length_1703_cov_26.016833	1207	1264	12	1	57	0.0175439
NODE_1796_length_1703_cov_26.016833	1207	1264	14	2	57	0.0350877
NODE_1796_length_1703_cov_26.016833	1207	1264	49	1	57	0.0175439
NODE_1796_length_1703_cov_26.016833	1207	1264	62	1	57	0.0175439
NODE_1796_length_1703_cov_26.016833	1207	1264	65	1	57	0.0175439
NODE_1796_length_1703_cov_26.016833	1207	1264	115	1	57	0.0175439
NODE_1796_length_1703_cov_26.016833	1207	1264	126	1	57	0.0175439
NODE_1799_length_1701_cov_15.969413	1490	1565	46	1	75	0.0133333
NODE_1799_length_1701_cov_15.969413	1490	1565	54	1	75	0.0133333
NODE_1799_length_1701_cov_15.969413	1490	1565	60	1	75	0.0133333
NODE_1799_length_1701_cov_15.969413	1490	1565	72	1	75	0.0133333
NODE_1799_length_1701_cov_15.969413	1490	1565	82	1	75	0.0133333
NODE_1799_length_1701_cov_15.969413	1490	1565	88	1	75	0.0133333
NODE_1799_length_1701_cov_15.969413	1490	1565	91	1	75	0.0133333
NODE_1799_length_1701_cov_15.969413	1490	1565	100	1	75	0.0133333
NODE_1799_length_1701_cov_15.969413	1490	1565	107	2	75	0.0266667
NODE_1799_length_1701_cov_15.969413	1490	1565	108	2	75	0.0266667
NODE_1799_length_1701_cov_15.969413	1490	1565	111	1	75	0.0133333
NODE_1799_length_1701_cov_15.969413	1490	1565	118	1	75	0.0133333
NODE_1799_length_1701_cov_15.969413	1490	1565	123	1	75	0.0133333
NODE_1799_length_1701_cov_15.969413	1490	1565	125	1	75	0.0133333
NODE_1799_length_1701_cov_15.969413	1490	1565	129	1	75	0.0133333
NODE_1799_length_1701_cov_15.969413	1490	1565	135	3	75	0.0400000
NODE_1799_length_1701_cov_15.969413	1490	1565	144	1	75	0.0133333
NODE_1799_length_1701_cov_15.969413	1490	1565	145	1	75	0.0133333
NODE_1799_length_1701_cov_15.969413	1490	1565	146	1	75	0.0133333
NODE_1799_length_1701_cov_15.969413	1490	1565	148	1	75	0.0133333
NODE_1799_length_1701_cov_15.969413	1490	1565	161	1	75	0.0133333
NODE_1799_length_1701_cov_15.969413	1490	1565	167	2	75	0.0266667
NODE_1799_length_1701_cov_15.969413	1490	1565	168	1	75	0.0133333
NODE_1799_length_1701_cov_15.969413	1490	1565	171	1	75	0.0133333
NODE_1799_length_1701_cov_15.969413	1490	1565	175	3	75	0.0400000
NODE_1799_length_1701_cov_15.969413	1490	1565	176	1	75	0.0133333
NODE_1799_length_1701_cov_15.969413	1490	1565	182	4	75	0.0533333
NODE_1799_length_1701_cov_15.969413	1490	1565	184	2	75	0.0266667
NODE_1799_length_1701_cov_15.969413	1490	1565	190	1	75	0.0133333
NODE_1799_length_1701_cov_15.969413	1490	1565	192	2	75	0.0266667
NODE_1799_length_1701_cov_15.969413	1490	1565	195	1	75	0.0133333
NODE_1799_length_1701_cov_15.969413	1490	1565	201	1	75	0.0133333
NODE_1799_length_1701_cov_15.969413	1490	1565	212	1	75	0.0133333
NODE_1799_length_1701_cov_15.969413	1490	1565	214	1	75	0.0133333
NODE_1799_length_1701_cov_15.969413	1490	1565	218	1	75	0.0133333
NODE_1799_length_1701_cov_15.969413	1490	1565	219	1	75	0.0133333
NODE_1799_length_1701_cov_15.969413	1490	1565	220	1	75	0.0133333
NODE_1799_length_1701_cov_15.969413	1490	1565	221	1	75	0.0133333
NODE_1799_length_1701_cov_15.969413	1490	1565	223	1	75	0.0133333
NODE_1799_length_1701_cov_15.969413	1490	1565	225	4	75	0.0533333
NODE_1799_length_1701_cov_15.969413	1490	1565	226	3	75	0.0400000
NODE_1799_length_1701_cov_15.969413	1490	1565	228	1	75	0.0133333
NODE_1799_length_1701_cov_15.969413	1490	1565	229	2	75	0.0266667
NODE_1799_length_1701_cov_15.969413	1490	1565	237	1	75	0.0133333
NODE_1799_length_1701_cov_15.969413	1490	1565	241	2	75	0.0266667
NODE_1799_length_1701_cov_15.969413	1490	1565	242	2	75	0.0266667
NODE_1799_length_1701_cov_15.969413	1490	1565	245	1	75	0.0133333
NODE_1799_length_1701_cov_15.969413	1490	1565	253	1	75	0.0133333
NODE_1799_length_1701_cov_15.969413	1490	1565	254	1	75	0.0133333
NODE_1799_length_1701_cov_15.969413	1490	1565	256	1	75	0.0133333
NODE_1799_length_1701_cov_15.969413	1490	1565	265	2	75	0.0266667
NODE_1799_length_1701_cov_15.969413	1490	1565	266	2	75	0.0266667
NODE_1799_length_1701_cov_15.969413	1490	1565	268	1	75	0.0133333
NODE_1799_length_1701_cov_15.969413	1538	1603	220	1	65	0.0153846
NODE_1799_length_1701_cov_15.969413	1538	1603	221	1	65	0.0153846
NODE_1799_length_1701_cov_15.969413	1538	1603	223	1	65	0.0153846
NODE_1799_length_1701_cov_15.969413	1538	1603	225	4	65	0.0615385
NODE_1799_length_1701_cov_15.969413	1538	1603	226	3	65	0.0461538
NODE_1799_length_1701_cov_15.969413	1538	1603	228	1	65	0.0153846
NODE_1799_length_1701_cov_15.969413	1538	1603	229	2	65	0.0307692
NODE_1799_length_1701_cov_15.969413	1538	1603	237	1	65	0.0153846
NODE_1799_length_1701_cov_15.969413	1538	1603	241	2	65	0.0307692
NODE_1799_length_1701_cov_15.969413	1538	1603	242	2	65	0.0307692
NODE_1799_length_1701_cov_15.969413	1538	1603	245	1	65	0.0153846
NODE_1799_length_1701_cov_15.969413	1538	1603	253	1	65	0.0153846
NODE_1799_length_1701_cov_15.969413	1538	1603	254	1	65	0.0153846
NODE_1799_length_1701_cov_15.969413	1538	1603	256	1	65	0.0153846
NODE_1799_length_1701_cov_15.969413	1538	1603	265	2	65	0.0307692
NODE_1799_length_1701_cov_15.969413	1538	1603	266	2	65	0.0307692
NODE_1799_length_1701_cov_15.969413	1538	1603	268	2	65	0.0307692
NODE_1799_length_1701_cov_15.969413	1538	1603	270	1	65	0.0153846
NODE_1799_length_1701_cov_15.969413	1538	1603	272	1	65	0.0153846
NODE_1799_length_1701_cov_15.969413	1538	1603	274	4	65	0.0615385
NODE_1799_length_1701_cov_15.969413	1538	1603	278	2	65	0.0307692
NODE_1799_length_1701_cov_15.969413	1538	1603	280	4	65	0.0615385
NODE_1799_length_1701_cov_15.969413	1538	1603	282	1	65	0.0153846
NODE_1799_length_1701_cov_15.969413	1538	1603	283	4	65	0.0615385
NODE_1799_length_1701_cov_15.969413	1538	1603	284	1	65	0.0153846
NODE_1799_length_1701_cov_15.969413	1538	1603	285	1	65	0.0153846
NODE_1799_length_1701_cov_15.969413	1538	1603	286	3	65	0.0461538
NODE_1799_length_1701_cov_15.969413	1538	1603	288	1	65	0.0153846
NODE_1799_length_1701_cov_15.969413	1538	1603	290	2	65	0.0307692
NODE_1799_length_1701_cov_15.969413	1538	1603	291	1	65	0.0153846
NODE_1799_length_1701_cov_15.969413	1538	1603	292	10	65	0.1538462
NODE_1799_length_1701_cov_15.969413	1538	1603	294	1	65	0.0153846
NODE_1800_length_1701_cov_13.549313	607	687	9	37	80	0.4625000
NODE_1800_length_1701_cov_13.549313	607	687	10	43	80	0.5375000
NODE_1800_length_1701_cov_13.549313	660	740	0	43	80	0.5375000
NODE_1800_length_1701_cov_13.549313	660	740	9	37	80	0.4625000
NODE_1805_length_1700_cov_20.003123	1168	1197	449	1	29	0.0344828
NODE_1805_length_1700_cov_20.003123	1168	1197	450	1	29	0.0344828
NODE_1805_length_1700_cov_20.003123	1168	1197	451	3	29	0.1034483
NODE_1805_length_1700_cov_20.003123	1168	1197	453	2	29	0.0689655
NODE_1805_length_1700_cov_20.003123	1168	1197	454	2	29	0.0689655
NODE_1805_length_1700_cov_20.003123	1168	1197	455	4	29	0.1379310
NODE_1805_length_1700_cov_20.003123	1168	1197	456	2	29	0.0689655
NODE_1805_length_1700_cov_20.003123	1168	1197	458	3	29	0.1034483
NODE_1805_length_1700_cov_20.003123	1168	1197	459	1	29	0.0344828
NODE_1805_length_1700_cov_20.003123	1168	1197	461	1	29	0.0344828
NODE_1805_length_1700_cov_20.003123	1168	1197	463	2	29	0.0689655
NODE_1805_length_1700_cov_20.003123	1168	1197	465	2	29	0.0689655
NODE_1805_length_1700_cov_20.003123	1168	1197	467	2	29	0.0689655
NODE_1805_length_1700_cov_20.003123	1168	1197	469	1	29	0.0344828
NODE_1805_length_1700_cov_20.003123	1168	1197	470	1	29	0.0344828
NODE_1805_length_1700_cov_20.003123	1168	1197	471	1	29	0.0344828
NODE_1805_length_1700_cov_20.003123	1184	1263	431	1	79	0.0126582
NODE_1805_length_1700_cov_20.003123	1184	1263	432	3	79	0.0379747
NODE_1805_length_1700_cov_20.003123	1184	1263	433	1	79	0.0126582
NODE_1805_length_1700_cov_20.003123	1184	1263	434	2	79	0.0253165
NODE_1805_length_1700_cov_20.003123	1184	1263	435	1	79	0.0126582
NODE_1805_length_1700_cov_20.003123	1184	1263	436	1	79	0.0126582
NODE_1805_length_1700_cov_20.003123	1184	1263	437	1	79	0.0126582
NODE_1805_length_1700_cov_20.003123	1184	1263	438	2	79	0.0253165
NODE_1805_length_1700_cov_20.003123	1184	1263	439	3	79	0.0379747
NODE_1805_length_1700_cov_20.003123	1184	1263	440	6	79	0.0759494
NODE_1805_length_1700_cov_20.003123	1184	1263	441	5	79	0.0632911
NODE_1805_length_1700_cov_20.003123	1184	1263	442	5	79	0.0632911
NODE_1805_length_1700_cov_20.003123	1184	1263	443	1	79	0.0126582
NODE_1805_length_1700_cov_20.003123	1184	1263	444	4	79	0.0506329
NODE_1805_length_1700_cov_20.003123	1184	1263	445	1	79	0.0126582
NODE_1805_length_1700_cov_20.003123	1184	1263	446	4	79	0.0506329
NODE_1805_length_1700_cov_20.003123	1184	1263	447	3	79	0.0379747
NODE_1805_length_1700_cov_20.003123	1184	1263	448	4	79	0.0506329
NODE_1805_length_1700_cov_20.003123	1184	1263	449	2	79	0.0253165
NODE_1805_length_1700_cov_20.003123	1184	1263	450	2	79	0.0253165
NODE_1805_length_1700_cov_20.003123	1184	1263	451	1	79	0.0126582
NODE_1805_length_1700_cov_20.003123	1184	1263	452	3	79	0.0379747
NODE_1805_length_1700_cov_20.003123	1184	1263	453	2	79	0.0253165
NODE_1805_length_1700_cov_20.003123	1184	1263	454	4	79	0.0506329
NODE_1805_length_1700_cov_20.003123	1184	1263	455	2	79	0.0253165
NODE_1805_length_1700_cov_20.003123	1184	1263	456	4	79	0.0506329
NODE_1805_length_1700_cov_20.003123	1184	1263	457	3	79	0.0379747
NODE_1805_length_1700_cov_20.003123	1184	1263	458	1	79	0.0126582
NODE_1805_length_1700_cov_20.003123	1184	1263	459	4	79	0.0506329
NODE_1805_length_1700_cov_20.003123	1184	1263	461	1	79	0.0126582
NODE_1805_length_1700_cov_20.003123	1184	1263	463	2	79	0.0253165
NODE_1810_length_1698_cov_19.175735	1001	1081	10	12	80	0.1500000
NODE_1810_length_1698_cov_19.175735	1001	1081	11	45	80	0.5625000
NODE_1810_length_1698_cov_19.175735	1001	1081	12	8	80	0.1000000
NODE_1810_length_1698_cov_19.175735	1001	1081	15	15	80	0.1875000
NODE_1810_length_1698_cov_19.175735	1054	1134	4	1	80	0.0125000
NODE_1810_length_1698_cov_19.175735	1054	1134	8	32	80	0.4000000
NODE_1810_length_1698_cov_19.175735	1054	1134	11	12	80	0.1500000
NODE_1810_length_1698_cov_19.175735	1054	1134	13	15	80	0.1875000
NODE_1810_length_1698_cov_19.175735	1054	1134	15	20	80	0.2500000
NODE_1814_length_1696_cov_11.494678	590	670	0	80	80	1.0000000
NODE_1814_length_1696_cov_11.494678	643	723	0	80	80	1.0000000
NODE_1815_length_1696_cov_6.620539	369	449	0	80	80	1.0000000
NODE_1815_length_1696_cov_6.620539	422	502	0	80	80	1.0000000
NODE_1816_length_1695_cov_27.783208	399	479	9	65	80	0.8125000
NODE_1816_length_1695_cov_27.783208	399	479	11	15	80	0.1875000
NODE_1816_length_1695_cov_27.783208	452	532	2	16	80	0.2000000
NODE_1816_length_1695_cov_27.783208	452	532	9	12	80	0.1500000
NODE_1816_length_1695_cov_27.783208	452	532	11	52	80	0.6500000
NODE_1817_length_1695_cov_12.084586	1047	1127	0	80	80	1.0000000
NODE_1817_length_1695_cov_12.084586	1100	1180	0	80	80	1.0000000
NODE_1825_length_1692_cov_4.557439	727	807	0	80	80	1.0000000
NODE_1825_length_1692_cov_4.557439	780	860	0	80	80	1.0000000
NODE_1830_length_1689_cov_5.844025	1210	1285	2	10	75	0.1333333
NODE_1830_length_1689_cov_5.844025	1210	1285	4	65	75	0.8666667
NODE_1830_length_1689_cov_5.844025	1260	1338	2	9	78	0.1153846
NODE_1830_length_1689_cov_5.844025	1260	1338	4	50	78	0.6410257
NODE_1830_length_1689_cov_5.844025	1260	1338	6	19	78	0.2435897
NODE_1837_length_1682_cov_14.416930	1183	1263	1	23	80	0.2875000
NODE_1837_length_1682_cov_14.416930	1183	1263	2	57	80	0.7125000
NODE_1837_length_1682_cov_14.416930	1236	1315	0	40	79	0.5063291
NODE_1837_length_1682_cov_14.416930	1236	1315	1	35	79	0.4430380
NODE_1837_length_1682_cov_14.416930	1236	1315	2	4	79	0.0506329
NODE_1843_length_1678_cov_23.965168	636	716	0	80	80	1.0000000
NODE_1843_length_1678_cov_23.965168	689	769	0	80	80	1.0000000
NODE_1843_length_1678_cov_23.965168	1145	1225	2	1	80	0.0125000
NODE_1843_length_1678_cov_23.965168	1145	1225	10	79	80	0.9875000
NODE_1843_length_1678_cov_23.965168	1198	1278	0	29	80	0.3625000
NODE_1843_length_1678_cov_23.965168	1198	1278	2	25	80	0.3125000
NODE_1843_length_1678_cov_23.965168	1198	1278	10	26	80	0.3250000
NODE_1846_length_1677_cov_3.578580	407	487	0	80	80	1.0000000
NODE_1846_length_1677_cov_3.578580	460	530	0	70	70	1.0000000
NODE_1846_length_1677_cov_3.578580	666	724	0	10	58	0.1724138
NODE_1846_length_1677_cov_3.578580	666	724	2	48	58	0.8275862
NODE_1856_length_1670_cov_29.264163	741	821	0	80	80	1.0000000
NODE_1856_length_1670_cov_29.264163	794	874	0	80	80	1.0000000
NODE_1857_length_1669_cov_5.913376	246	326	0	80	80	1.0000000
NODE_1857_length_1669_cov_5.913376	299	379	0	50	80	0.6250000
NODE_1857_length_1669_cov_5.913376	299	379	2	30	80	0.3750000
NODE_1860_length_1668_cov_18.372212	1100	1180	0	80	80	1.0000000
NODE_1860_length_1668_cov_18.372212	1153	1233	0	80	80	1.0000000
NODE_1861_length_1667_cov_15.651786	902	982	0	4	80	0.0500000
NODE_1861_length_1667_cov_15.651786	902	982	2	4	80	0.0500000
NODE_1861_length_1667_cov_15.651786	902	982	7	11	80	0.1375000
NODE_1861_length_1667_cov_15.651786	902	982	12	38	80	0.4750000
NODE_1861_length_1667_cov_15.651786	902	982	13	23	80	0.2875000
NODE_1861_length_1667_cov_15.651786	955	1035	0	5	80	0.0625000
NODE_1861_length_1667_cov_15.651786	955	1035	2	11	80	0.1375000
NODE_1861_length_1667_cov_15.651786	955	1035	8	13	80	0.1625000
NODE_1861_length_1667_cov_15.651786	955	1035	12	5	80	0.0625000
NODE_1861_length_1667_cov_15.651786	955	1035	13	46	80	0.5750000
NODE_1862_length_1667_cov_3.661352	649	679	0	30	30	1.0000000
NODE_1865_length_1666_cov_4.601149	1541	1623	7	12	82	0.1463415
NODE_1865_length_1666_cov_4.601149	1541	1623	11	5	82	0.0609756
NODE_1865_length_1666_cov_4.601149	1541	1623	17	9	82	0.1097561
NODE_1865_length_1666_cov_4.601149	1541	1623	18	20	82	0.2439024
NODE_1865_length_1666_cov_4.601149	1541	1623	19	36	82	0.4390244
NODE_1865_length_1666_cov_4.601149	1553	1613	11	5	60	0.0833333
NODE_1865_length_1666_cov_4.601149	1553	1613	18	19	60	0.3166667
NODE_1865_length_1666_cov_4.601149	1553	1613	19	36	60	0.6000000
NODE_1865_length_1666_cov_4.601149	1553	1613	11	5	60	0.0833333
NODE_1865_length_1666_cov_4.601149	1553	1613	18	19	60	0.3166667
NODE_1865_length_1666_cov_4.601149	1553	1613	19	36	60	0.6000000
NODE_1865_length_1666_cov_4.601149	1557	1623	11	1	66	0.0151515
NODE_1865_length_1666_cov_4.601149	1557	1623	17	9	66	0.1363636
NODE_1865_length_1666_cov_4.601149	1557	1623	18	20	66	0.3030303
NODE_1865_length_1666_cov_4.601149	1557	1623	19	36	66	0.5454546
NODE_1865_length_1666_cov_4.601149	1596	1666	5	2	70	0.0285714
NODE_1865_length_1666_cov_4.601149	1596	1666	9	1	70	0.0142857
NODE_1865_length_1666_cov_4.601149	1596	1666	17	49	70	0.7000000
NODE_1865_length_1666_cov_4.601149	1596	1666	18	18	70	0.2571429
NODE_1865_length_1666_cov_4.601149	1596	1666	5	2	70	0.0285714
NODE_1865_length_1666_cov_4.601149	1596	1666	9	1	70	0.0142857
NODE_1865_length_1666_cov_4.601149	1596	1666	17	49	70	0.7000000
NODE_1865_length_1666_cov_4.601149	1596	1666	18	18	70	0.2571429
NODE_1865_length_1666_cov_4.601149	1596	1666	5	2	70	0.0285714
NODE_1865_length_1666_cov_4.601149	1596	1666	9	1	70	0.0142857
NODE_1865_length_1666_cov_4.601149	1596	1666	17	49	70	0.7000000
NODE_1865_length_1666_cov_4.601149	1596	1666	18	18	70	0.2571429
NODE_1872_length_1662_cov_16.638516	538	618	0	54	80	0.6750000
NODE_1872_length_1662_cov_16.638516	538	618	2	26	80	0.3250000
NODE_1872_length_1662_cov_16.638516	591	671	0	1	80	0.0125000
NODE_1872_length_1662_cov_16.638516	591	671	2	79	80	0.9875000
NODE_1872_length_1662_cov_16.638516	667	747	0	10	80	0.1250000
NODE_1872_length_1662_cov_16.638516	667	747	1	56	80	0.7000000
NODE_1872_length_1662_cov_16.638516	667	747	2	14	80	0.1750000
NODE_1872_length_1662_cov_16.638516	720	800	1	80	80	1.0000000
NODE_1876_length_1660_cov_28.297886	415	495	6	7	80	0.0875000
NODE_1876_length_1660_cov_28.297886	415	495	8	73	80	0.9125000
NODE_1876_length_1660_cov_28.297886	468	548	0	35	80	0.4375000
NODE_1876_length_1660_cov_28.297886	468	548	5	1	80	0.0125000
NODE_1876_length_1660_cov_28.297886	468	548	6	11	80	0.1375000
NODE_1876_length_1660_cov_28.297886	468	548	8	33	80	0.4125000
NODE_1886_length_1654_cov_17.245016	631	711	0	46	80	0.5750000
NODE_1886_length_1654_cov_17.245016	631	711	4	34	80	0.4250000
NODE_1886_length_1654_cov_17.245016	684	764	0	14	80	0.1750000
NODE_1886_length_1654_cov_17.245016	684	764	4	66	80	0.8250000
NODE_1888_length_1653_cov_34.827542	0	41	2	17	41	0.4146341
NODE_1888_length_1653_cov_34.827542	0	41	4	17	41	0.4146341
NODE_1888_length_1653_cov_34.827542	0	41	5	7	41	0.1707317
NODE_1888_length_1653_cov_34.827542	14	44	2	3	30	0.1000000
NODE_1888_length_1653_cov_34.827542	14	44	4	17	30	0.5666667
NODE_1888_length_1653_cov_34.827542	14	44	5	8	30	0.2666667
NODE_1888_length_1653_cov_34.827542	14	44	6	2	30	0.0666667
NODE_1888_length_1653_cov_34.827542	1081	1161	2	9	80	0.1125000
NODE_1888_length_1653_cov_34.827542	1081	1161	4	24	80	0.3000000
NODE_1888_length_1653_cov_34.827542	1081	1161	6	7	80	0.0875000
NODE_1888_length_1653_cov_34.827542	1081	1161	8	31	80	0.3875000
NODE_1888_length_1653_cov_34.827542	1081	1161	12	9	80	0.1125000
NODE_1888_length_1653_cov_34.827542	1134	1214	8	18	80	0.2250000
NODE_1888_length_1653_cov_34.827542	1134	1214	12	19	80	0.2375000
NODE_1888_length_1653_cov_34.827542	1134	1214	14	25	80	0.3125000
NODE_1888_length_1653_cov_34.827542	1134	1214	15	8	80	0.1000000
NODE_1888_length_1653_cov_34.827542	1134	1214	16	10	80	0.1250000
NODE_1888_length_1653_cov_34.827542	1210	1290	10	1	80	0.0125000
NODE_1888_length_1653_cov_34.827542	1210	1290	12	1	80	0.0125000
NODE_1888_length_1653_cov_34.827542	1210	1290	14	56	80	0.7000000
NODE_1888_length_1653_cov_34.827542	1210	1290	16	12	80	0.1500000
NODE_1888_length_1653_cov_34.827542	1210	1290	17	3	80	0.0375000
NODE_1888_length_1653_cov_34.827542	1210	1290	19	4	80	0.0500000
NODE_1888_length_1653_cov_34.827542	1210	1290	20	3	80	0.0375000
NODE_1888_length_1653_cov_34.827542	1263	1339	3	6	76	0.0789474
NODE_1888_length_1653_cov_34.827542	1263	1339	4	24	76	0.3157895
NODE_1888_length_1653_cov_34.827542	1263	1339	8	12	76	0.1578947
NODE_1888_length_1653_cov_34.827542	1263	1339	10	1	76	0.0131579
NODE_1888_length_1653_cov_34.827542	1263	1339	12	8	76	0.1052632
NODE_1888_length_1653_cov_34.827542	1263	1339	14	25	76	0.3289474
NODE_1892_length_1652_cov_23.939472	1352	1432	0	80	80	1.0000000
NODE_1892_length_1652_cov_23.939472	1405	1485	0	80	80	1.0000000
NODE_1894_length_1651_cov_3.916881	1552	1617	2	65	65	1.0000000
NODE_1899_length_1649_cov_7.480000	774	854	0	27	80	0.3375000
NODE_1899_length_1649_cov_7.480000	774	854	2	53	80	0.6625000
NODE_1899_length_1649_cov_7.480000	827	907	0	17	80	0.2125000
NODE_1899_length_1649_cov_7.480000	827	907	2	63	80	0.7875000
NODE_1903_length_1647_cov_3.534238	1012	1075	0	8	63	0.1269841
NODE_1903_length_1647_cov_3.534238	1012	1075	2	55	63	0.8730159
NODE_1906_length_1645_cov_16.040103	155	235	0	80	80	1.0000000
NODE_1906_length_1645_cov_16.040103	208	288	0	80	80	1.0000000
NODE_1906_length_1645_cov_16.040103	1090	1170	0	53	80	0.6625000
NODE_1906_length_1645_cov_16.040103	1090	1170	2	3	80	0.0375000
NODE_1906_length_1645_cov_16.040103	1090	1170	4	24	80	0.3000000
NODE_1906_length_1645_cov_16.040103	1143	1222	0	79	79	1.0000000
NODE_1908_length_1644_cov_2.902913	1160	1240	6	24	80	0.3000000
NODE_1908_length_1644_cov_2.902913	1160	1240	8	56	80	0.7000000
NODE_1917_length_1641_cov_34.032425	487	567	0	80	80	1.0000000
NODE_1917_length_1641_cov_34.032425	540	620	0	80	80	1.0000000
NODE_1917_length_1641_cov_34.032425	616	696	0	80	80	1.0000000
NODE_1917_length_1641_cov_34.032425	669	749	0	80	80	1.0000000
NODE_1917_length_1641_cov_34.032425	1168	1248	0	80	80	1.0000000
NODE_1917_length_1641_cov_34.032425	1219	1301	0	82	82	1.0000000
NODE_1918_length_1641_cov_7.042802	339	390	0	51	51	1.0000000
NODE_1922_length_1640_cov_33.097339	943	1023	0	1	80	0.0125000
NODE_1922_length_1640_cov_33.097339	943	1023	2	79	80	0.9875000
NODE_1922_length_1640_cov_33.097339	996	1076	0	54	80	0.6750000
NODE_1922_length_1640_cov_33.097339	996	1076	2	26	80	0.3250000
NODE_1922_length_1640_cov_33.097339	1072	1152	0	80	80	1.0000000
NODE_1922_length_1640_cov_33.097339	1125	1206	0	37	81	0.4567901
NODE_1922_length_1640_cov_33.097339	1125	1206	2	44	81	0.5432099
NODE_1923_length_1640_cov_18.519143	471	551	0	80	80	1.0000000
NODE_1923_length_1640_cov_18.519143	524	604	0	80	80	1.0000000
NODE_1925_length_1639_cov_6.585714	975	1056	0	81	81	1.0000000
NODE_1925_length_1639_cov_6.585714	1028	1109	0	81	81	1.0000000
NODE_1926_length_1639_cov_2.163636	1260	1334	0	16	74	0.2162162
NODE_1926_length_1639_cov_2.163636	1260	1334	2	13	74	0.1756757
NODE_1926_length_1639_cov_2.163636	1260	1334	6	45	74	0.6081081
NODE_1926_length_1639_cov_2.163636	1312	1387	1	23	75	0.3066667
NODE_1926_length_1639_cov_2.163636	1312	1387	5	2	75	0.0266667
NODE_1926_length_1639_cov_2.163636	1312	1387	6	50	75	0.6666667
NODE_1928_length_1638_cov_18.598441	443	523	0	80	80	1.0000000
NODE_1928_length_1638_cov_18.598441	496	576	0	80	80	1.0000000
NODE_1928_length_1638_cov_18.598441	1157	1237	0	36	80	0.4500000
NODE_1928_length_1638_cov_18.598441	1157	1237	2	44	80	0.5500000
NODE_1928_length_1638_cov_18.598441	1210	1290	0	80	80	1.0000000
NODE_1932_length_1637_cov_12.048765	410	490	2	80	80	1.0000000
NODE_1932_length_1637_cov_12.048765	463	543	2	68	80	0.8500000
NODE_1932_length_1637_cov_12.048765	463	543	4	12	80	0.1500000
NODE_1932_length_1637_cov_12.048765	1081	1161	0	70	80	0.8750000
NODE_1932_length_1637_cov_12.048765	1081	1161	2	10	80	0.1250000
NODE_1932_length_1637_cov_12.048765	1134	1214	0	17	80	0.2125000
NODE_1932_length_1637_cov_12.048765	1134	1214	2	63	80	0.7875000
NODE_1934_length_1635_cov_21.022786	958	1038	0	31	80	0.3875000
NODE_1934_length_1635_cov_21.022786	958	1038	2	49	80	0.6125000
NODE_1934_length_1635_cov_21.022786	1011	1091	0	31	80	0.3875000
NODE_1934_length_1635_cov_21.022786	1011	1091	2	49	80	0.6125000
NODE_1934_length_1635_cov_21.022786	1087	1167	0	17	80	0.2125000
NODE_1934_length_1635_cov_21.022786	1087	1167	2	63	80	0.7875000
NODE_1934_length_1635_cov_21.022786	1140	1220	0	17	80	0.2125000
NODE_1934_length_1635_cov_21.022786	1140	1220	2	63	80	0.7875000
NODE_1936_length_1633_cov_16.743807	1067	1147	0	80	80	1.0000000
NODE_1936_length_1633_cov_16.743807	1120	1200	0	80	80	1.0000000
NODE_1937_length_1633_cov_14.271838	977	1057	0	32	80	0.4000000
NODE_1937_length_1633_cov_14.271838	977	1057	2	16	80	0.2000000
NODE_1937_length_1633_cov_14.271838	977	1057	4	32	80	0.4000000
NODE_1937_length_1633_cov_14.271838	1030	1110	4	58	80	0.7250000
NODE_1937_length_1633_cov_14.271838	1030	1110	6	20	80	0.2500000
NODE_1937_length_1633_cov_14.271838	1030	1110	8	2	80	0.0250000
NODE_1937_length_1633_cov_14.271838	1106	1186	4	32	80	0.4000000
NODE_1937_length_1633_cov_14.271838	1106	1186	6	36	80	0.4500000
NODE_1937_length_1633_cov_14.271838	1106	1186	8	12	80	0.1500000
NODE_1937_length_1633_cov_14.271838	1159	1239	0	33	80	0.4125000
NODE_1937_length_1633_cov_14.271838	1159	1239	2	19	80	0.2375000
NODE_1937_length_1633_cov_14.271838	1159	1239	4	28	80	0.3500000
NODE_1939_length_1631_cov_25.881201	424	504	0	80	80	1.0000000
NODE_1939_length_1631_cov_25.881201	477	557	0	80	80	1.0000000
NODE_1939_length_1631_cov_25.881201	553	633	0	65	80	0.8125000
NODE_1939_length_1631_cov_25.881201	553	633	4	15	80	0.1875000
NODE_1939_length_1631_cov_25.881201	606	686	0	12	80	0.1500000
NODE_1939_length_1631_cov_25.881201	606	686	4	68	80	0.8500000
NODE_1943_length_1629_cov_32.733987	518	598	2	80	80	1.0000000
NODE_1943_length_1629_cov_32.733987	635	715	0	80	80	1.0000000
NODE_1943_length_1629_cov_32.733987	688	768	0	80	80	1.0000000
NODE_1946_length_1628_cov_15.551995	1454	1518	245	1	64	0.0156250
NODE_1946_length_1628_cov_15.551995	1454	1518	247	1	64	0.0156250
NODE_1946_length_1628_cov_15.551995	1454	1518	269	1	64	0.0156250
NODE_1946_length_1628_cov_15.551995	1454	1518	283	1	64	0.0156250
NODE_1946_length_1628_cov_15.551995	1454	1518	303	1	64	0.0156250
NODE_1946_length_1628_cov_15.551995	1454	1518	305	1	64	0.0156250
NODE_1946_length_1628_cov_15.551995	1454	1518	314	1	64	0.0156250
NODE_1946_length_1628_cov_15.551995	1454	1518	326	1	64	0.0156250
NODE_1946_length_1628_cov_15.551995	1454	1518	338	1	64	0.0156250
NODE_1946_length_1628_cov_15.551995	1454	1518	344	1	64	0.0156250
NODE_1946_length_1628_cov_15.551995	1454	1518	348	1	64	0.0156250
NODE_1946_length_1628_cov_15.551995	1454	1518	355	1	64	0.0156250
NODE_1946_length_1628_cov_15.551995	1454	1518	362	1	64	0.0156250
NODE_1946_length_1628_cov_15.551995	1454	1518	380	1	64	0.0156250
NODE_1946_length_1628_cov_15.551995	1454	1518	395	1	64	0.0156250
NODE_1946_length_1628_cov_15.551995	1454	1518	400	1	64	0.0156250
NODE_1946_length_1628_cov_15.551995	1454	1518	414	1	64	0.0156250
NODE_1946_length_1628_cov_15.551995	1454	1518	422	1	64	0.0156250
NODE_1946_length_1628_cov_15.551995	1454	1518	432	1	64	0.0156250
NODE_1946_length_1628_cov_15.551995	1454	1518	438	1	64	0.0156250
NODE_1946_length_1628_cov_15.551995	1454	1518	451	1	64	0.0156250
NODE_1946_length_1628_cov_15.551995	1454	1518	453	1	64	0.0156250
NODE_1946_length_1628_cov_15.551995	1454	1518	463	1	64	0.0156250
NODE_1946_length_1628_cov_15.551995	1454	1518	471	1	64	0.0156250
NODE_1946_length_1628_cov_15.551995	1454	1518	475	1	64	0.0156250
NODE_1946_length_1628_cov_15.551995	1454	1518	477	1	64	0.0156250
NODE_1946_length_1628_cov_15.551995	1454	1518	484	1	64	0.0156250
NODE_1946_length_1628_cov_15.551995	1454	1518	488	1	64	0.0156250
NODE_1946_length_1628_cov_15.551995	1454	1518	506	1	64	0.0156250
NODE_1946_length_1628_cov_15.551995	1454	1518	516	1	64	0.0156250
NODE_1946_length_1628_cov_15.551995	1454	1518	521	1	64	0.0156250
NODE_1946_length_1628_cov_15.551995	1454	1518	527	1	64	0.0156250
NODE_1946_length_1628_cov_15.551995	1454	1518	533	1	64	0.0156250
NODE_1946_length_1628_cov_15.551995	1454	1518	535	1	64	0.0156250
NODE_1946_length_1628_cov_15.551995	1454	1518	542	2	64	0.0312500
NODE_1946_length_1628_cov_15.551995	1454	1518	548	1	64	0.0156250
NODE_1946_length_1628_cov_15.551995	1454	1518	550	1	64	0.0156250
NODE_1946_length_1628_cov_15.551995	1454	1518	554	1	64	0.0156250
NODE_1946_length_1628_cov_15.551995	1454	1518	556	1	64	0.0156250
NODE_1946_length_1628_cov_15.551995	1454	1518	560	2	64	0.0312500
NODE_1946_length_1628_cov_15.551995	1454	1518	570	2	64	0.0312500
NODE_1946_length_1628_cov_15.551995	1454	1518	580	1	64	0.0156250
NODE_1946_length_1628_cov_15.551995	1454	1518	584	1	64	0.0156250
NODE_1946_length_1628_cov_15.551995	1454	1518	592	1	64	0.0156250
NODE_1946_length_1628_cov_15.551995	1454	1518	600	1	64	0.0156250
NODE_1946_length_1628_cov_15.551995	1454	1518	604	1	64	0.0156250
NODE_1946_length_1628_cov_15.551995	1454	1518	606	1	64	0.0156250
NODE_1946_length_1628_cov_15.551995	1454	1518	609	1	64	0.0156250
NODE_1946_length_1628_cov_15.551995	1454	1518	617	4	64	0.0625000
NODE_1946_length_1628_cov_15.551995	1454	1518	619	1	64	0.0156250
NODE_1946_length_1628_cov_15.551995	1454	1518	625	1	64	0.0156250
NODE_1946_length_1628_cov_15.551995	1454	1518	627	1	64	0.0156250
NODE_1946_length_1628_cov_15.551995	1454	1518	630	1	64	0.0156250
NODE_1946_length_1628_cov_15.551995	1454	1518	638	1	64	0.0156250
NODE_1946_length_1628_cov_15.551995	1454	1518	642	3	64	0.0468750
NODE_1946_length_1628_cov_15.551995	1454	1518	646	1	64	0.0156250
NODE_1947_length_1628_cov_4.852845	81	163	18	10	82	0.1219512
NODE_1947_length_1628_cov_4.852845	81	163	20	10	82	0.1219512
NODE_1947_length_1628_cov_4.852845	81	163	26	1	82	0.0121951
NODE_1947_length_1628_cov_4.852845	81	163	28	40	82	0.4878049
NODE_1947_length_1628_cov_4.852845	81	163	30	21	82	0.2560976
NODE_1952_length_1626_cov_20.549443	495	575	0	69	80	0.8625000
NODE_1952_length_1626_cov_20.549443	495	575	6	11	80	0.1375000
NODE_1952_length_1626_cov_20.549443	548	628	0	16	80	0.2000000
NODE_1952_length_1626_cov_20.549443	548	628	6	11	80	0.1375000
NODE_1952_length_1626_cov_20.549443	548	628	14	53	80	0.6625000
NODE_1953_length_1626_cov_6.552718	1189	1269	6	23	80	0.2875000
NODE_1953_length_1626_cov_6.552718	1189	1269	8	3	80	0.0375000
NODE_1953_length_1626_cov_6.552718	1189	1269	10	37	80	0.4625000
NODE_1953_length_1626_cov_6.552718	1189	1269	14	17	80	0.2125000
NODE_1953_length_1626_cov_6.552718	1242	1321	4	23	79	0.2911392
NODE_1953_length_1626_cov_6.552718	1242	1321	7	8	79	0.1012658
NODE_1953_length_1626_cov_6.552718	1242	1321	9	7	79	0.0886076
NODE_1953_length_1626_cov_6.552718	1242	1321	10	24	79	0.3037975
NODE_1953_length_1626_cov_6.552718	1242	1321	14	17	79	0.2151899
NODE_1954_length_1626_cov_4.728880	247	329	2	47	82	0.5731707
NODE_1954_length_1626_cov_4.728880	247	329	4	35	82	0.4268293
NODE_1954_length_1626_cov_4.728880	302	382	2	70	80	0.8750000
NODE_1954_length_1626_cov_4.728880	302	382	4	10	80	0.1250000
NODE_1956_length_1625_cov_20.598952	938	1018	0	80	80	1.0000000
NODE_1956_length_1625_cov_20.598952	991	1071	0	80	80	1.0000000
NODE_1962_length_1623_cov_28.551181	416	486	16	3	70	0.0428571
NODE_1962_length_1623_cov_28.551181	416	486	18	1	70	0.0142857
NODE_1962_length_1623_cov_28.551181	416	486	19	4	70	0.0571429
NODE_1962_length_1623_cov_28.551181	416	486	23	40	70	0.5714286
NODE_1962_length_1623_cov_28.551181	416	486	25	1	70	0.0142857
NODE_1962_length_1623_cov_28.551181	416	486	27	4	70	0.0571429
NODE_1962_length_1623_cov_28.551181	416	486	29	6	70	0.0857143
NODE_1962_length_1623_cov_28.551181	416	486	31	8	70	0.1142857
NODE_1962_length_1623_cov_28.551181	416	486	33	3	70	0.0428571
NODE_1962_length_1623_cov_28.551181	459	507	2	3	48	0.0625000
NODE_1962_length_1623_cov_28.551181	459	507	6	2	48	0.0416667
NODE_1962_length_1623_cov_28.551181	459	507	7	1	48	0.0208333
NODE_1962_length_1623_cov_28.551181	459	507	9	1	48	0.0208333
NODE_1962_length_1623_cov_28.551181	459	507	12	3	48	0.0625000
NODE_1962_length_1623_cov_28.551181	459	507	14	1	48	0.0208333
NODE_1962_length_1623_cov_28.551181	459	507	16	13	48	0.2708333
NODE_1962_length_1623_cov_28.551181	459	507	18	1	48	0.0208333
NODE_1962_length_1623_cov_28.551181	459	507	19	4	48	0.0833333
NODE_1962_length_1623_cov_28.551181	459	507	23	19	48	0.3958333
NODE_1965_length_1622_cov_7.969140	645	725	0	80	80	1.0000000
NODE_1965_length_1622_cov_7.969140	698	778	0	80	80	1.0000000
NODE_1970_length_1621_cov_2.192510	330	401	7	1	71	0.0140845
NODE_1970_length_1621_cov_2.192510	330	401	8	3	71	0.0422535
NODE_1970_length_1621_cov_2.192510	330	401	9	1	71	0.0140845
NODE_1970_length_1621_cov_2.192510	330	401	11	2	71	0.0281690
NODE_1970_length_1621_cov_2.192510	330	401	12	18	71	0.2535211
NODE_1970_length_1621_cov_2.192510	330	401	14	6	71	0.0845070
NODE_1970_length_1621_cov_2.192510	330	401	16	16	71	0.2253521
NODE_1970_length_1621_cov_2.192510	330	401	18	11	71	0.1549296
NODE_1970_length_1621_cov_2.192510	330	401	19	11	71	0.1549296
NODE_1970_length_1621_cov_2.192510	330	401	21	2	71	0.0281690
NODE_1975_length_1618_cov_44.138907	361	441	0	28	80	0.3500000
NODE_1975_length_1618_cov_44.138907	361	441	4	52	80	0.6500000
NODE_1975_length_1618_cov_44.138907	414	494	0	21	80	0.2625000
NODE_1975_length_1618_cov_44.138907	414	494	4	59	80	0.7375000
NODE_1975_length_1618_cov_44.138907	1063	1143	0	80	80	1.0000000
NODE_1975_length_1618_cov_44.138907	1116	1196	0	80	80	1.0000000
NODE_1976_length_1618_cov_5.779460	332	414	4	15	82	0.1829268
NODE_1976_length_1618_cov_5.779460	332	414	8	33	82	0.4024390
NODE_1976_length_1618_cov_5.779460	332	414	10	34	82	0.4146341
NODE_1976_length_1618_cov_5.779460	387	467	0	9	80	0.1125000
NODE_1976_length_1618_cov_5.779460	387	467	2	13	80	0.1625000
NODE_1976_length_1618_cov_5.779460	387	467	6	7	80	0.0875000
NODE_1976_length_1618_cov_5.779460	387	467	8	2	80	0.0250000
NODE_1976_length_1618_cov_5.779460	387	467	10	49	80	0.6125000
NODE_1976_length_1618_cov_5.779460	972	1028	2	23	56	0.4107143
NODE_1976_length_1618_cov_5.779460	972	1028	4	18	56	0.3214286
NODE_1976_length_1618_cov_5.779460	972	1028	6	15	56	0.2678571
NODE_1980_length_1616_cov_5.313777	589	669	0	56	80	0.7000000
NODE_1980_length_1616_cov_5.313777	589	669	2	24	80	0.3000000
NODE_1980_length_1616_cov_5.313777	642	722	0	3	80	0.0375000
NODE_1980_length_1616_cov_5.313777	642	722	2	77	80	0.9625000
NODE_1981_length_1615_cov_12.575858	1032	1112	2	15	80	0.1875000
NODE_1981_length_1615_cov_12.575858	1032	1112	6	65	80	0.8125000
NODE_1981_length_1615_cov_12.575858	1085	1162	0	21	77	0.2727273
NODE_1981_length_1615_cov_12.575858	1085	1162	4	16	77	0.2077922
NODE_1981_length_1615_cov_12.575858	1085	1162	6	40	77	0.5194805
NODE_1981_length_1615_cov_12.575858	1158	1238	0	80	80	1.0000000
NODE_1981_length_1615_cov_12.575858	1211	1291	0	80	80	1.0000000
NODE_1983_length_1614_cov_94.900990	0	46	8	6	46	0.1304348
NODE_1983_length_1614_cov_94.900990	0	46	10	4	46	0.0869565
NODE_1983_length_1614_cov_94.900990	0	46	12	11	46	0.2391304
NODE_1983_length_1614_cov_94.900990	0	46	16	25	46	0.5434783
NODE_1983_length_1614_cov_94.900990	23	99	16	76	76	1.0000000
NODE_1984_length_1614_cov_18.799340	655	735	0	18	80	0.2250000
NODE_1984_length_1614_cov_18.799340	655	735	3	1	80	0.0125000
NODE_1984_length_1614_cov_18.799340	655	735	4	61	80	0.7625000
NODE_1984_length_1614_cov_18.799340	708	788	0	71	80	0.8875000
NODE_1984_length_1614_cov_18.799340	708	788	3	1	80	0.0125000
NODE_1984_length_1614_cov_18.799340	708	788	4	8	80	0.1000000
NODE_1986_length_1613_cov_6.865258	1128	1203	4	64	75	0.8533334
NODE_1986_length_1613_cov_6.865258	1128	1203	6	11	75	0.1466667
NODE_1986_length_1613_cov_6.865258	1176	1256	3	6	80	0.0750000
NODE_1986_length_1613_cov_6.865258	1176	1256	4	37	80	0.4625000
NODE_1986_length_1613_cov_6.865258	1176	1256	5	9	80	0.1125000
NODE_1986_length_1613_cov_6.865258	1176	1256	6	15	80	0.1875000
NODE_1986_length_1613_cov_6.865258	1176	1256	7	8	80	0.1000000
NODE_1986_length_1613_cov_6.865258	1176	1256	8	5	80	0.0625000
NODE_1993_length_1610_cov_18.014560	1035	1115	0	80	80	1.0000000
NODE_1993_length_1610_cov_18.014560	1088	1168	0	80	80	1.0000000
NODE_2001_length_1603_cov_9.128324	1109	1189	0	80	80	1.0000000
NODE_2001_length_1603_cov_9.128324	1162	1242	0	80	80	1.0000000
NODE_2003_length_1602_cov_79.840319	1378	1445	211	2	67	0.0298507
NODE_2003_length_1602_cov_79.840319	1378	1445	212	2	67	0.0298507
NODE_2003_length_1602_cov_79.840319	1378	1445	215	5	67	0.0746269
NODE_2003_length_1602_cov_79.840319	1378	1445	216	2	67	0.0298507
NODE_2003_length_1602_cov_79.840319	1378	1445	220	1	67	0.0149254
NODE_2003_length_1602_cov_79.840319	1378	1445	223	1	67	0.0149254
NODE_2003_length_1602_cov_79.840319	1378	1445	225	1	67	0.0149254
NODE_2003_length_1602_cov_79.840319	1378	1445	228	1	67	0.0149254
NODE_2003_length_1602_cov_79.840319	1378	1445	230	1	67	0.0149254
NODE_2003_length_1602_cov_79.840319	1378	1445	231	2	67	0.0298507
NODE_2003_length_1602_cov_79.840319	1378	1445	232	3	67	0.0447761
NODE_2003_length_1602_cov_79.840319	1378	1445	237	1	67	0.0149254
NODE_2003_length_1602_cov_79.840319	1378	1445	244	1	67	0.0149254
NODE_2003_length_1602_cov_79.840319	1378	1445	246	1	67	0.0149254
NODE_2003_length_1602_cov_79.840319	1378	1445	250	1	67	0.0149254
NODE_2003_length_1602_cov_79.840319	1378	1445	254	1	67	0.0149254
NODE_2003_length_1602_cov_79.840319	1378	1445	266	1	67	0.0149254
NODE_2003_length_1602_cov_79.840319	1378	1445	268	1	67	0.0149254
NODE_2003_length_1602_cov_79.840319	1378	1445	272	1	67	0.0149254
NODE_2003_length_1602_cov_79.840319	1378	1445	274	1	67	0.0149254
NODE_2003_length_1602_cov_79.840319	1378	1445	275	1	67	0.0149254
NODE_2003_length_1602_cov_79.840319	1378	1445	282	2	67	0.0298507
NODE_2003_length_1602_cov_79.840319	1378	1445	286	1	67	0.0149254
NODE_2003_length_1602_cov_79.840319	1378	1445	292	1	67	0.0149254
NODE_2003_length_1602_cov_79.840319	1378	1445	295	2	67	0.0298507
NODE_2003_length_1602_cov_79.840319	1378	1445	297	3	67	0.0447761
NODE_2003_length_1602_cov_79.840319	1378	1445	298	3	67	0.0447761
NODE_2003_length_1602_cov_79.840319	1378	1445	302	1	67	0.0149254
NODE_2003_length_1602_cov_79.840319	1378	1445	303	1	67	0.0149254
NODE_2003_length_1602_cov_79.840319	1378	1445	306	1	67	0.0149254
NODE_2003_length_1602_cov_79.840319	1378	1445	307	1	67	0.0149254
NODE_2003_length_1602_cov_79.840319	1378	1445	308	2	67	0.0298507
NODE_2003_length_1602_cov_79.840319	1378	1445	309	1	67	0.0149254
NODE_2003_length_1602_cov_79.840319	1378	1445	311	3	67	0.0447761
NODE_2003_length_1602_cov_79.840319	1378	1445	312	1	67	0.0149254
NODE_2003_length_1602_cov_79.840319	1378	1445	313	2	67	0.0298507
NODE_2003_length_1602_cov_79.840319	1378	1445	318	1	67	0.0149254
NODE_2003_length_1602_cov_79.840319	1378	1445	319	1	67	0.0149254
NODE_2003_length_1602_cov_79.840319	1378	1445	320	3	67	0.0447761
NODE_2003_length_1602_cov_79.840319	1378	1445	321	1	67	0.0149254
NODE_2003_length_1602_cov_79.840319	1378	1445	322	1	67	0.0149254
NODE_2003_length_1602_cov_79.840319	1378	1445	323	2	67	0.0298507
NODE_2003_length_1602_cov_79.840319	1378	1445	328	1	67	0.0149254
NODE_2003_length_1602_cov_79.840319	1378	1445	331	1	67	0.0149254
NODE_2003_length_1602_cov_79.840319	1462	1508	114	1	46	0.0217391
NODE_2003_length_1602_cov_79.840319	1462	1508	116	1	46	0.0217391
NODE_2003_length_1602_cov_79.840319	1462	1508	117	1	46	0.0217391
NODE_2003_length_1602_cov_79.840319	1462	1508	118	5	46	0.1086956
NODE_2003_length_1602_cov_79.840319	1462	1508	121	1	46	0.0217391
NODE_2003_length_1602_cov_79.840319	1462	1508	125	2	46	0.0434783
NODE_2003_length_1602_cov_79.840319	1462	1508	129	1	46	0.0217391
NODE_2003_length_1602_cov_79.840319	1462	1508	130	2	46	0.0434783
NODE_2003_length_1602_cov_79.840319	1462	1508	131	1	46	0.0217391
NODE_2003_length_1602_cov_79.840319	1462	1508	136	2	46	0.0434783
NODE_2003_length_1602_cov_79.840319	1462	1508	137	1	46	0.0217391
NODE_2003_length_1602_cov_79.840319	1462	1508	142	3	46	0.0652174
NODE_2003_length_1602_cov_79.840319	1462	1508	144	1	46	0.0217391
NODE_2003_length_1602_cov_79.840319	1462	1508	145	1	46	0.0217391
NODE_2003_length_1602_cov_79.840319	1462	1508	147	2	46	0.0434783
NODE_2003_length_1602_cov_79.840319	1462	1508	149	1	46	0.0217391
NODE_2003_length_1602_cov_79.840319	1462	1508	151	2	46	0.0434783
NODE_2003_length_1602_cov_79.840319	1462	1508	160	2	46	0.0434783
NODE_2003_length_1602_cov_79.840319	1462	1508	161	1	46	0.0217391
NODE_2003_length_1602_cov_79.840319	1462	1508	163	1	46	0.0217391
NODE_2003_length_1602_cov_79.840319	1462	1508	165	1	46	0.0217391
NODE_2003_length_1602_cov_79.840319	1462	1508	169	1	46	0.0217391
NODE_2003_length_1602_cov_79.840319	1462	1508	173	1	46	0.0217391
NODE_2003_length_1602_cov_79.840319	1462	1508	175	1	46	0.0217391
NODE_2003_length_1602_cov_79.840319	1462	1508	176	1	46	0.0217391
NODE_2003_length_1602_cov_79.840319	1462	1508	177	3	46	0.0652174
NODE_2003_length_1602_cov_79.840319	1462	1508	178	1	46	0.0217391
NODE_2003_length_1602_cov_79.840319	1462	1508	179	2	46	0.0434783
NODE_2003_length_1602_cov_79.840319	1462	1508	183	2	46	0.0434783
NODE_2003_length_1602_cov_79.840319	1462	1508	185	1	46	0.0217391
NODE_2004_length_1602_cov_2.701264	1490	1570	4	10	80	0.1250000
NODE_2004_length_1602_cov_2.701264	1490	1570	8	4	80	0.0500000
NODE_2004_length_1602_cov_2.701264	1490	1570	12	10	80	0.1250000
NODE_2004_length_1602_cov_2.701264	1490	1570	14	56	80	0.7000000
NODE_2009_length_1600_cov_34.988008	785	865	7	23	80	0.2875000
NODE_2009_length_1600_cov_34.988008	785	865	10	15	80	0.1875000
NODE_2009_length_1600_cov_34.988008	785	865	11	11	80	0.1375000
NODE_2009_length_1600_cov_34.988008	785	865	13	1	80	0.0125000
NODE_2009_length_1600_cov_34.988008	785	865	14	30	80	0.3750000
NODE_2009_length_1600_cov_34.988008	838	918	0	34	80	0.4250000
NODE_2009_length_1600_cov_34.988008	838	918	4	11	80	0.1375000
NODE_2009_length_1600_cov_34.988008	838	918	7	31	80	0.3875000
NODE_2009_length_1600_cov_34.988008	838	918	11	4	80	0.0500000
NODE_2009_length_1600_cov_34.988008	914	994	0	20	80	0.2500000
NODE_2009_length_1600_cov_34.988008	914	994	2	55	80	0.6875000
NODE_2009_length_1600_cov_34.988008	914	994	4	5	80	0.0625000
NODE_2009_length_1600_cov_34.988008	967	1047	2	44	80	0.5500000
NODE_2009_length_1600_cov_34.988008	967	1047	4	36	80	0.4500000
NODE_2011_length_1600_cov_11.383744	0	72	0	72	72	1.0000000
NODE_2011_length_1600_cov_11.383744	45	99	0	54	54	1.0000000
NODE_2011_length_1600_cov_11.383744	891	971	0	80	80	1.0000000
NODE_2011_length_1600_cov_11.383744	944	1024	0	80	80	1.0000000
NODE_2013_length_1600_cov_7.236509	1037	1109	0	72	72	1.0000000
NODE_2013_length_1600_cov_7.236509	1090	1160	0	70	70	1.0000000
NODE_2018_length_1598_cov_29.337558	335	415	0	80	80	1.0000000
NODE_2018_length_1598_cov_29.337558	388	468	0	71	80	0.8875000
NODE_2018_length_1598_cov_29.337558	388	468	2	2	80	0.0250000
NODE_2018_length_1598_cov_29.337558	388	468	4	7	80	0.0875000
NODE_2018_length_1598_cov_29.337558	464	516	4	4	52	0.0769231
NODE_2018_length_1598_cov_29.337558	464	516	6	8	52	0.1538462
NODE_2018_length_1598_cov_29.337558	464	516	10	11	52	0.2115385
NODE_2018_length_1598_cov_29.337558	464	516	12	14	52	0.2692308
NODE_2018_length_1598_cov_29.337558	464	516	14	15	52	0.2884615
NODE_2018_length_1598_cov_29.337558	1026	1106	0	26	80	0.3250000
NODE_2018_length_1598_cov_29.337558	1026	1106	2	54	80	0.6750000
NODE_2018_length_1598_cov_29.337558	1079	1159	2	80	80	1.0000000
NODE_2019_length_1598_cov_3.730487	1117	1197	2	2	80	0.0250000
NODE_2019_length_1598_cov_3.730487	1117	1197	4	65	80	0.8125000
NODE_2019_length_1598_cov_3.730487	1117	1197	6	13	80	0.1625000
NODE_2021_length_1597_cov_7.434579	1373	1453	19	3	80	0.0375000
NODE_2021_length_1597_cov_7.434579	1373	1453	24	8	80	0.1000000
NODE_2021_length_1597_cov_7.434579	1373	1453	28	1	80	0.0125000
NODE_2021_length_1597_cov_7.434579	1373	1453	43	3	80	0.0375000
NODE_2021_length_1597_cov_7.434579	1373	1453	44	1	80	0.0125000
NODE_2021_length_1597_cov_7.434579	1373	1453	45	2	80	0.0250000
NODE_2021_length_1597_cov_7.434579	1373	1453	46	3	80	0.0375000
NODE_2021_length_1597_cov_7.434579	1373	1453	49	5	80	0.0625000
NODE_2021_length_1597_cov_7.434579	1373	1453	52	4	80	0.0500000
NODE_2021_length_1597_cov_7.434579	1373	1453	53	2	80	0.0250000
NODE_2021_length_1597_cov_7.434579	1373	1453	61	2	80	0.0250000
NODE_2021_length_1597_cov_7.434579	1373	1453	64	1	80	0.0125000
NODE_2021_length_1597_cov_7.434579	1373	1453	65	2	80	0.0250000
NODE_2021_length_1597_cov_7.434579	1373	1453	67	2	80	0.0250000
NODE_2021_length_1597_cov_7.434579	1373	1453	71	1	80	0.0125000
NODE_2021_length_1597_cov_7.434579	1373	1453	77	1	80	0.0125000
NODE_2021_length_1597_cov_7.434579	1373	1453	81	1	80	0.0125000
NODE_2021_length_1597_cov_7.434579	1373	1453	84	1	80	0.0125000
NODE_2021_length_1597_cov_7.434579	1373	1453	86	2	80	0.0250000
NODE_2021_length_1597_cov_7.434579	1373	1453	88	1	80	0.0125000
NODE_2021_length_1597_cov_7.434579	1373	1453	89	1	80	0.0125000
NODE_2021_length_1597_cov_7.434579	1373	1453	91	1	80	0.0125000
NODE_2021_length_1597_cov_7.434579	1373	1453	101	2	80	0.0250000
NODE_2021_length_1597_cov_7.434579	1373	1453	103	7	80	0.0875000
NODE_2021_length_1597_cov_7.434579	1373	1453	104	1	80	0.0125000
NODE_2021_length_1597_cov_7.434579	1373	1453	105	2	80	0.0250000
NODE_2021_length_1597_cov_7.434579	1373	1453	117	1	80	0.0125000
NODE_2021_length_1597_cov_7.434579	1373	1453	158	1	80	0.0125000
NODE_2021_length_1597_cov_7.434579	1373	1453	160	1	80	0.0125000
NODE_2021_length_1597_cov_7.434579	1373	1453	166	2	80	0.0250000
NODE_2021_length_1597_cov_7.434579	1373	1453	174	1	80	0.0125000
NODE_2021_length_1597_cov_7.434579	1373	1453	179	1	80	0.0125000
NODE_2021_length_1597_cov_7.434579	1373	1453	183	1	80	0.0125000
NODE_2021_length_1597_cov_7.434579	1373	1453	185	1	80	0.0125000
NODE_2021_length_1597_cov_7.434579	1373	1453	191	1	80	0.0125000
NODE_2021_length_1597_cov_7.434579	1373	1453	193	1	80	0.0125000
NODE_2021_length_1597_cov_7.434579	1373	1453	195	1	80	0.0125000
NODE_2021_length_1597_cov_7.434579	1373	1453	203	1	80	0.0125000
NODE_2021_length_1597_cov_7.434579	1373	1453	215	1	80	0.0125000
NODE_2021_length_1597_cov_7.434579	1373	1453	229	1	80	0.0125000
NODE_2021_length_1597_cov_7.434579	1373	1453	232	1	80	0.0125000
NODE_2021_length_1597_cov_7.434579	1373	1453	233	1	80	0.0125000
NODE_2021_length_1597_cov_7.434579	1373	1453	237	1	80	0.0125000
NODE_2021_length_1597_cov_7.434579	1373	1453	241	1	80	0.0125000
NODE_2021_length_1597_cov_7.434579	1373	1453	245	1	80	0.0125000
NODE_2021_length_1597_cov_7.434579	1382	1453	24	2	71	0.0281690
NODE_2021_length_1597_cov_7.434579	1382	1453	28	1	71	0.0140845
NODE_2021_length_1597_cov_7.434579	1382	1453	43	3	71	0.0422535
NODE_2021_length_1597_cov_7.434579	1382	1453	44	1	71	0.0140845
NODE_2021_length_1597_cov_7.434579	1382	1453	45	2	71	0.0281690
NODE_2021_length_1597_cov_7.434579	1382	1453	46	3	71	0.0422535
NODE_2021_length_1597_cov_7.434579	1382	1453	49	5	71	0.0704225
NODE_2021_length_1597_cov_7.434579	1382	1453	52	4	71	0.0563380
NODE_2021_length_1597_cov_7.434579	1382	1453	53	2	71	0.0281690
NODE_2021_length_1597_cov_7.434579	1382	1453	61	2	71	0.0281690
NODE_2021_length_1597_cov_7.434579	1382	1453	64	1	71	0.0140845
NODE_2021_length_1597_cov_7.434579	1382	1453	65	2	71	0.0281690
NODE_2021_length_1597_cov_7.434579	1382	1453	67	2	71	0.0281690
NODE_2021_length_1597_cov_7.434579	1382	1453	71	1	71	0.0140845
NODE_2021_length_1597_cov_7.434579	1382	1453	77	1	71	0.0140845
NODE_2021_length_1597_cov_7.434579	1382	1453	81	1	71	0.0140845
NODE_2021_length_1597_cov_7.434579	1382	1453	84	1	71	0.0140845
NODE_2021_length_1597_cov_7.434579	1382	1453	86	2	71	0.0281690
NODE_2021_length_1597_cov_7.434579	1382	1453	88	1	71	0.0140845
NODE_2021_length_1597_cov_7.434579	1382	1453	89	1	71	0.0140845
NODE_2021_length_1597_cov_7.434579	1382	1453	91	1	71	0.0140845
NODE_2021_length_1597_cov_7.434579	1382	1453	101	2	71	0.0281690
NODE_2021_length_1597_cov_7.434579	1382	1453	103	7	71	0.0985916
NODE_2021_length_1597_cov_7.434579	1382	1453	104	1	71	0.0140845
NODE_2021_length_1597_cov_7.434579	1382	1453	105	2	71	0.0281690
NODE_2021_length_1597_cov_7.434579	1382	1453	117	1	71	0.0140845
NODE_2021_length_1597_cov_7.434579	1382	1453	158	1	71	0.0140845
NODE_2021_length_1597_cov_7.434579	1382	1453	160	1	71	0.0140845
NODE_2021_length_1597_cov_7.434579	1382	1453	166	2	71	0.0281690
NODE_2021_length_1597_cov_7.434579	1382	1453	174	1	71	0.0140845
NODE_2021_length_1597_cov_7.434579	1382	1453	179	1	71	0.0140845
NODE_2021_length_1597_cov_7.434579	1382	1453	183	1	71	0.0140845
NODE_2021_length_1597_cov_7.434579	1382	1453	185	1	71	0.0140845
NODE_2021_length_1597_cov_7.434579	1382	1453	191	1	71	0.0140845
NODE_2021_length_1597_cov_7.434579	1382	1453	193	1	71	0.0140845
NODE_2021_length_1597_cov_7.434579	1382	1453	195	1	71	0.0140845
NODE_2021_length_1597_cov_7.434579	1382	1453	203	1	71	0.0140845
NODE_2021_length_1597_cov_7.434579	1382	1453	215	1	71	0.0140845
NODE_2021_length_1597_cov_7.434579	1382	1453	229	1	71	0.0140845
NODE_2021_length_1597_cov_7.434579	1382	1453	232	1	71	0.0140845
NODE_2021_length_1597_cov_7.434579	1382	1453	233	1	71	0.0140845
NODE_2021_length_1597_cov_7.434579	1382	1453	237	1	71	0.0140845
NODE_2021_length_1597_cov_7.434579	1382	1453	241	1	71	0.0140845
NODE_2021_length_1597_cov_7.434579	1382	1453	245	1	71	0.0140845
NODE_2022_length_1595_cov_16.788770	215	267	12	52	52	1.0000000
NODE_2022_length_1595_cov_16.788770	614	673	6	6	59	0.1016949
NODE_2022_length_1595_cov_16.788770	614	673	8	1	59	0.0169492
NODE_2022_length_1595_cov_16.788770	614	673	10	14	59	0.2372881
NODE_2022_length_1595_cov_16.788770	614	673	12	2	59	0.0338983
NODE_2022_length_1595_cov_16.788770	614	673	14	28	59	0.4745763
NODE_2022_length_1595_cov_16.788770	614	673	16	8	59	0.1355932
NODE_2025_length_1593_cov_22.412316	144	224	0	37	80	0.4625000
NODE_2025_length_1593_cov_22.412316	144	224	2	43	80	0.5375000
NODE_2025_length_1593_cov_22.412316	197	277	2	79	80	0.9875000
NODE_2025_length_1593_cov_22.412316	197	277	4	1	80	0.0125000
NODE_2025_length_1593_cov_22.412316	1192	1272	0	80	80	1.0000000
NODE_2025_length_1593_cov_22.412316	1245	1325	0	80	80	1.0000000
NODE_2026_length_1593_cov_14.092369	357	437	2	80	80	1.0000000
NODE_2026_length_1593_cov_14.092369	410	490	0	41	80	0.5125000
NODE_2026_length_1593_cov_14.092369	410	490	2	39	80	0.4875000
NODE_2026_length_1593_cov_14.092369	1061	1141	2	80	80	1.0000000
NODE_2026_length_1593_cov_14.092369	1114	1194	0	35	80	0.4375000
NODE_2026_length_1593_cov_14.092369	1114	1194	2	45	80	0.5625000
NODE_2031_length_1592_cov_4.576691	277	357	4	34	80	0.4250000
NODE_2031_length_1592_cov_4.576691	277	357	6	46	80	0.5750000
NODE_2031_length_1592_cov_4.576691	330	410	0	19	80	0.2375000
NODE_2031_length_1592_cov_4.576691	330	410	4	61	80	0.7625000
NODE_2034_length_1591_cov_15.481233	841	921	0	12	80	0.1500000
NODE_2034_length_1591_cov_15.481233	841	921	1	10	80	0.1250000
NODE_2034_length_1591_cov_15.481233	841	921	2	58	80	0.7250000
NODE_2034_length_1591_cov_15.481233	894	974	2	80	80	1.0000000
NODE_2035_length_1591_cov_4.040885	35	65	0	30	30	1.0000000
NODE_2035_length_1591_cov_4.040885	38	99	0	59	61	0.9672131
NODE_2035_length_1591_cov_4.040885	38	99	7	1	61	0.0163934
NODE_2035_length_1591_cov_4.040885	38	99	9	1	61	0.0163934
NODE_2042_length_1589_cov_10.184564	379	459	0	38	80	0.4750000
NODE_2042_length_1589_cov_10.184564	379	459	2	42	80	0.5250000
NODE_2042_length_1589_cov_10.184564	432	512	0	8	80	0.1000000
NODE_2042_length_1589_cov_10.184564	432	512	2	72	80	0.9000000
NODE_2042_length_1589_cov_10.184564	473	512	0	8	39	0.2051282
NODE_2042_length_1589_cov_10.184564	473	512	2	31	39	0.7948718
NODE_2042_length_1589_cov_10.184564	508	588	0	80	80	1.0000000
NODE_2042_length_1589_cov_10.184564	561	641	0	80	80	1.0000000
NODE_2043_length_1588_cov_9.955675	415	495	1	11	80	0.1375000
NODE_2043_length_1588_cov_9.955675	415	495	2	69	80	0.8625000
NODE_2043_length_1588_cov_9.955675	468	548	0	17	80	0.2125000
NODE_2043_length_1588_cov_9.955675	468	548	1	47	80	0.5875000
NODE_2043_length_1588_cov_9.955675	468	548	2	16	80	0.2000000
NODE_2046_length_1587_cov_7.942204	710	790	2	9	80	0.1125000
NODE_2046_length_1587_cov_7.942204	710	790	4	34	80	0.4250000
NODE_2046_length_1587_cov_7.942204	710	790	6	15	80	0.1875000
NODE_2046_length_1587_cov_7.942204	710	790	8	22	80	0.2750000
NODE_2046_length_1587_cov_7.942204	763	843	2	4	80	0.0500000
NODE_2046_length_1587_cov_7.942204	763	843	4	4	80	0.0500000
NODE_2046_length_1587_cov_7.942204	763	843	6	47	80	0.5875000
NODE_2046_length_1587_cov_7.942204	763	843	8	25	80	0.3125000
NODE_2049_length_1586_cov_6.488231	447	474	0	27	27	1.0000000
NODE_2049_length_1586_cov_6.488231	447	527	0	80	80	1.0000000
NODE_2049_length_1586_cov_6.488231	500	580	0	80	80	1.0000000
NODE_2056_length_1583_cov_27.825472	800	880	0	80	80	1.0000000
NODE_2056_length_1583_cov_27.825472	853	933	0	46	80	0.5750000
NODE_2056_length_1583_cov_27.825472	853	933	2	34	80	0.4250000
NODE_2056_length_1583_cov_27.825472	929	1009	0	32	80	0.4000000
NODE_2056_length_1583_cov_27.825472	929	1009	2	48	80	0.6000000
NODE_2056_length_1583_cov_27.825472	982	1062	0	80	80	1.0000000
NODE_2060_length_1581_cov_10.610661	457	537	0	80	80	1.0000000
NODE_2060_length_1581_cov_10.610661	510	590	0	80	80	1.0000000
NODE_2065_length_1579_cov_7.395946	5	80	0	75	75	1.0000000
NODE_2065_length_1579_cov_7.395946	58	126	0	68	68	1.0000000
NODE_2066_length_1579_cov_7.152027	1331	1409	0	26	78	0.3333333
NODE_2066_length_1579_cov_7.152027	1331	1409	2	52	78	0.6666667
NODE_2066_length_1579_cov_7.152027	1382	1462	0	31	80	0.3875000
NODE_2066_length_1579_cov_7.152027	1382	1462	2	49	80	0.6125000
NODE_2067_length_1579_cov_6.741892	4	52	26	1	48	0.0208333
NODE_2067_length_1579_cov_6.741892	4	52	28	1	48	0.0208333
NODE_2067_length_1579_cov_6.741892	4	52	32	7	48	0.1458333
NODE_2067_length_1579_cov_6.741892	4	52	51	1	48	0.0208333
NODE_2067_length_1579_cov_6.741892	4	52	54	1	48	0.0208333
NODE_2067_length_1579_cov_6.741892	4	52	55	3	48	0.0625000
NODE_2067_length_1579_cov_6.741892	4	52	58	1	48	0.0208333
NODE_2067_length_1579_cov_6.741892	4	52	61	4	48	0.0833333
NODE_2067_length_1579_cov_6.741892	4	52	65	6	48	0.1250000
NODE_2067_length_1579_cov_6.741892	4	52	67	2	48	0.0416667
NODE_2067_length_1579_cov_6.741892	4	52	69	4	48	0.0833333
NODE_2067_length_1579_cov_6.741892	4	52	74	7	48	0.1458333
NODE_2067_length_1579_cov_6.741892	4	52	84	2	48	0.0416667
NODE_2067_length_1579_cov_6.741892	4	52	88	8	48	0.1666667
NODE_2067_length_1579_cov_6.741892	4	52	26	1	48	0.0208333
NODE_2067_length_1579_cov_6.741892	4	52	28	1	48	0.0208333
NODE_2067_length_1579_cov_6.741892	4	52	32	7	48	0.1458333
NODE_2067_length_1579_cov_6.741892	4	52	51	1	48	0.0208333
NODE_2067_length_1579_cov_6.741892	4	52	54	1	48	0.0208333
NODE_2067_length_1579_cov_6.741892	4	52	55	3	48	0.0625000
NODE_2067_length_1579_cov_6.741892	4	52	58	1	48	0.0208333
NODE_2067_length_1579_cov_6.741892	4	52	61	4	48	0.0833333
NODE_2067_length_1579_cov_6.741892	4	52	65	6	48	0.1250000
NODE_2067_length_1579_cov_6.741892	4	52	67	2	48	0.0416667
NODE_2067_length_1579_cov_6.741892	4	52	69	4	48	0.0833333
NODE_2067_length_1579_cov_6.741892	4	52	74	7	48	0.1458333
NODE_2067_length_1579_cov_6.741892	4	52	84	2	48	0.0416667
NODE_2067_length_1579_cov_6.741892	4	52	88	8	48	0.1666667
NODE_2067_length_1579_cov_6.741892	4	52	26	1	48	0.0208333
NODE_2067_length_1579_cov_6.741892	4	52	28	1	48	0.0208333
NODE_2067_length_1579_cov_6.741892	4	52	32	7	48	0.1458333
NODE_2067_length_1579_cov_6.741892	4	52	51	1	48	0.0208333
NODE_2067_length_1579_cov_6.741892	4	52	54	1	48	0.0208333
NODE_2067_length_1579_cov_6.741892	4	52	55	3	48	0.0625000
NODE_2067_length_1579_cov_6.741892	4	52	58	1	48	0.0208333
NODE_2067_length_1579_cov_6.741892	4	52	61	4	48	0.0833333
NODE_2067_length_1579_cov_6.741892	4	52	65	6	48	0.1250000
NODE_2067_length_1579_cov_6.741892	4	52	67	2	48	0.0416667
NODE_2067_length_1579_cov_6.741892	4	52	69	4	48	0.0833333
NODE_2067_length_1579_cov_6.741892	4	52	74	7	48	0.1458333
NODE_2067_length_1579_cov_6.741892	4	52	84	2	48	0.0416667
NODE_2067_length_1579_cov_6.741892	4	52	88	8	48	0.1666667
NODE_2067_length_1579_cov_6.741892	25	105	65	4	80	0.0500000
NODE_2067_length_1579_cov_6.741892	25	105	67	2	80	0.0250000
NODE_2067_length_1579_cov_6.741892	25	105	69	4	80	0.0500000
NODE_2067_length_1579_cov_6.741892	25	105	74	7	80	0.0875000
NODE_2067_length_1579_cov_6.741892	25	105	84	2	80	0.0250000
NODE_2067_length_1579_cov_6.741892	25	105	88	8	80	0.1000000
NODE_2067_length_1579_cov_6.741892	25	105	90	1	80	0.0125000
NODE_2067_length_1579_cov_6.741892	25	105	92	5	80	0.0625000
NODE_2067_length_1579_cov_6.741892	25	105	94	2	80	0.0250000
NODE_2067_length_1579_cov_6.741892	25	105	95	14	80	0.1750000
NODE_2067_length_1579_cov_6.741892	25	105	96	31	80	0.3875000
NODE_2067_length_1579_cov_6.741892	25	91	65	4	66	0.0606061
NODE_2067_length_1579_cov_6.741892	25	91	67	2	66	0.0303030
NODE_2067_length_1579_cov_6.741892	25	91	69	4	66	0.0606061
NODE_2067_length_1579_cov_6.741892	25	91	74	7	66	0.1060606
NODE_2067_length_1579_cov_6.741892	25	91	84	2	66	0.0303030
NODE_2067_length_1579_cov_6.741892	25	91	88	8	66	0.1212121
NODE_2067_length_1579_cov_6.741892	25	91	92	4	66	0.0606061
NODE_2067_length_1579_cov_6.741892	25	91	94	2	66	0.0303030
NODE_2067_length_1579_cov_6.741892	25	91	95	14	66	0.2121212
NODE_2067_length_1579_cov_6.741892	25	91	96	19	66	0.2878788
NODE_2067_length_1579_cov_6.741892	25	96	65	4	71	0.0563380
NODE_2067_length_1579_cov_6.741892	25	96	67	2	71	0.0281690
NODE_2067_length_1579_cov_6.741892	25	96	69	4	71	0.0563380
NODE_2067_length_1579_cov_6.741892	25	96	74	7	71	0.0985916
NODE_2067_length_1579_cov_6.741892	25	96	84	2	71	0.0281690
NODE_2067_length_1579_cov_6.741892	25	96	88	8	71	0.1126761
NODE_2067_length_1579_cov_6.741892	25	96	92	4	71	0.0563380
NODE_2067_length_1579_cov_6.741892	25	96	94	2	71	0.0281690
NODE_2067_length_1579_cov_6.741892	25	96	95	14	71	0.1971831
NODE_2067_length_1579_cov_6.741892	25	96	96	24	71	0.3380282
NODE_2076_length_1575_cov_4.250000	993	1073	2	80	80	1.0000000
NODE_2076_length_1575_cov_4.250000	1046	1126	0	48	80	0.6000000
NODE_2076_length_1575_cov_4.250000	1046	1126	2	32	80	0.4000000
NODE_2078_length_1574_cov_40.682034	551	631	8	15	80	0.1875000
NODE_2078_length_1574_cov_40.682034	551	631	10	25	80	0.3125000
NODE_2078_length_1574_cov_40.682034	551	631	12	40	80	0.5000000
NODE_2078_length_1574_cov_40.682034	604	684	0	23	80	0.2875000
NODE_2078_length_1574_cov_40.682034	604	684	4	22	80	0.2750000
NODE_2078_length_1574_cov_40.682034	604	684	8	23	80	0.2875000
NODE_2078_length_1574_cov_40.682034	604	684	10	12	80	0.1500000
NODE_2078_length_1574_cov_40.682034	680	760	0	80	80	1.0000000
NODE_2078_length_1574_cov_40.682034	733	813	0	80	80	1.0000000
NODE_2079_length_1574_cov_7.572203	1306	1386	0	80	80	1.0000000
NODE_2079_length_1574_cov_7.572203	1359	1439	0	80	80	1.0000000
NODE_2081_length_1573_cov_16.107191	437	512	0	75	75	1.0000000
NODE_2081_length_1573_cov_16.107191	485	565	0	80	80	1.0000000
NODE_2081_length_1573_cov_16.107191	561	639	0	51	78	0.6538461
NODE_2081_length_1573_cov_16.107191	561	639	2	27	78	0.3461539
NODE_2081_length_1573_cov_16.107191	612	692	2	33	80	0.4125000
NODE_2081_length_1573_cov_16.107191	612	692	4	47	80	0.5875000
NODE_2085_length_1572_cov_25.966735	359	404	204	3	45	0.0666667
NODE_2085_length_1572_cov_25.966735	359	404	205	2	45	0.0444444
NODE_2085_length_1572_cov_25.966735	359	404	206	1	45	0.0222222
NODE_2085_length_1572_cov_25.966735	359	404	207	5	45	0.1111111
NODE_2085_length_1572_cov_25.966735	359	404	209	4	45	0.0888889
NODE_2085_length_1572_cov_25.966735	359	404	210	2	45	0.0444444
NODE_2085_length_1572_cov_25.966735	359	404	211	3	45	0.0666667
NODE_2085_length_1572_cov_25.966735	359	404	212	1	45	0.0222222
NODE_2085_length_1572_cov_25.966735	359	404	213	1	45	0.0222222
NODE_2085_length_1572_cov_25.966735	359	404	215	1	45	0.0222222
NODE_2085_length_1572_cov_25.966735	359	404	216	2	45	0.0444444
NODE_2085_length_1572_cov_25.966735	359	404	217	1	45	0.0222222
NODE_2085_length_1572_cov_25.966735	359	404	218	1	45	0.0222222
NODE_2085_length_1572_cov_25.966735	359	404	219	1	45	0.0222222
NODE_2085_length_1572_cov_25.966735	359	404	221	2	45	0.0444444
NODE_2085_length_1572_cov_25.966735	359	404	224	4	45	0.0888889
NODE_2085_length_1572_cov_25.966735	359	404	228	2	45	0.0444444
NODE_2085_length_1572_cov_25.966735	359	404	230	1	45	0.0222222
NODE_2085_length_1572_cov_25.966735	359	404	231	1	45	0.0222222
NODE_2085_length_1572_cov_25.966735	359	404	232	1	45	0.0222222
NODE_2085_length_1572_cov_25.966735	359	404	233	2	45	0.0444444
NODE_2085_length_1572_cov_25.966735	359	404	234	1	45	0.0222222
NODE_2085_length_1572_cov_25.966735	359	404	235	1	45	0.0222222
NODE_2085_length_1572_cov_25.966735	359	404	241	1	45	0.0222222
NODE_2085_length_1572_cov_25.966735	359	404	245	1	45	0.0222222
NODE_2085_length_1572_cov_25.966735	405	477	198	3	72	0.0416667
NODE_2085_length_1572_cov_25.966735	405	477	201	2	72	0.0277778
NODE_2085_length_1572_cov_25.966735	405	477	202	4	72	0.0555556
NODE_2085_length_1572_cov_25.966735	405	477	203	8	72	0.1111111
NODE_2085_length_1572_cov_25.966735	405	477	205	3	72	0.0416667
NODE_2085_length_1572_cov_25.966735	405	477	206	2	72	0.0277778
NODE_2085_length_1572_cov_25.966735	405	477	207	2	72	0.0277778
NODE_2085_length_1572_cov_25.966735	405	477	208	1	72	0.0138889
NODE_2085_length_1572_cov_25.966735	405	477	209	2	72	0.0277778
NODE_2085_length_1572_cov_25.966735	405	477	210	3	72	0.0416667
NODE_2085_length_1572_cov_25.966735	405	477	211	3	72	0.0416667
NODE_2085_length_1572_cov_25.966735	405	477	212	5	72	0.0694444
NODE_2085_length_1572_cov_25.966735	405	477	213	1	72	0.0138889
NODE_2085_length_1572_cov_25.966735	405	477	214	4	72	0.0555556
NODE_2085_length_1572_cov_25.966735	405	477	215	2	72	0.0277778
NODE_2085_length_1572_cov_25.966735	405	477	216	1	72	0.0138889
NODE_2085_length_1572_cov_25.966735	405	477	217	1	72	0.0138889
NODE_2085_length_1572_cov_25.966735	405	477	218	1	72	0.0138889
NODE_2085_length_1572_cov_25.966735	405	477	219	1	72	0.0138889
NODE_2085_length_1572_cov_25.966735	405	477	221	2	72	0.0277778
NODE_2085_length_1572_cov_25.966735	405	477	222	4	72	0.0555556
NODE_2085_length_1572_cov_25.966735	405	477	224	1	72	0.0138889
NODE_2085_length_1572_cov_25.966735	405	477	225	1	72	0.0138889
NODE_2085_length_1572_cov_25.966735	405	477	227	2	72	0.0277778
NODE_2085_length_1572_cov_25.966735	405	477	230	2	72	0.0277778
NODE_2085_length_1572_cov_25.966735	405	477	232	2	72	0.0277778
NODE_2085_length_1572_cov_25.966735	405	477	236	2	72	0.0277778
NODE_2085_length_1572_cov_25.966735	405	477	238	1	72	0.0138889
NODE_2085_length_1572_cov_25.966735	405	477	239	3	72	0.0416667
NODE_2085_length_1572_cov_25.966735	405	477	240	2	72	0.0277778
NODE_2085_length_1572_cov_25.966735	405	477	244	1	72	0.0138889
NODE_2085_length_1572_cov_25.966735	1016	1096	0	40	80	0.5000000
NODE_2085_length_1572_cov_25.966735	1016	1096	2	40	80	0.5000000
NODE_2085_length_1572_cov_25.966735	1069	1149	0	3	80	0.0375000
NODE_2085_length_1572_cov_25.966735	1069	1149	2	77	80	0.9625000
NODE_2086_length_1572_cov_3.513238	1386	1462	8	2	76	0.0263158
NODE_2086_length_1572_cov_3.513238	1386	1462	10	6	76	0.0789474
NODE_2086_length_1572_cov_3.513238	1386	1462	12	15	76	0.1973684
NODE_2086_length_1572_cov_3.513238	1386	1462	13	4	76	0.0526316
NODE_2086_length_1572_cov_3.513238	1386	1462	15	6	76	0.0789474
NODE_2086_length_1572_cov_3.513238	1386	1462	16	3	76	0.0394737
NODE_2086_length_1572_cov_3.513238	1386	1462	17	13	76	0.1710526
NODE_2086_length_1572_cov_3.513238	1386	1462	18	3	76	0.0394737
NODE_2086_length_1572_cov_3.513238	1386	1462	19	4	76	0.0526316
NODE_2086_length_1572_cov_3.513238	1386	1462	21	4	76	0.0526316
NODE_2086_length_1572_cov_3.513238	1386	1462	23	1	76	0.0131579
NODE_2086_length_1572_cov_3.513238	1386	1462	25	5	76	0.0657895
NODE_2086_length_1572_cov_3.513238	1386	1462	27	4	76	0.0526316
NODE_2086_length_1572_cov_3.513238	1386	1462	29	6	76	0.0789474
NODE_2090_length_1570_cov_21.745071	700	780	0	25	80	0.3125000
NODE_2090_length_1570_cov_21.745071	700	780	4	55	80	0.6875000
NODE_2090_length_1570_cov_21.745071	753	833	4	80	80	1.0000000
NODE_2091_length_1570_cov_3.276003	387	467	0	80	80	1.0000000
NODE_2091_length_1570_cov_3.276003	440	520	0	80	80	1.0000000
NODE_2093_length_1569_cov_53.941497	741	821	0	34	80	0.4250000
NODE_2093_length_1569_cov_53.941497	741	821	16	18	80	0.2250000
NODE_2093_length_1569_cov_53.941497	741	821	17	16	80	0.2000000
NODE_2093_length_1569_cov_53.941497	741	821	18	12	80	0.1500000
NODE_2093_length_1569_cov_53.941497	794	874	0	80	80	1.0000000
NODE_2093_length_1569_cov_53.941497	870	950	0	80	80	1.0000000
NODE_2093_length_1569_cov_53.941497	923	1003	0	80	80	1.0000000
NODE_2094_length_1569_cov_12.426531	640	720	0	80	80	1.0000000
NODE_2094_length_1569_cov_12.426531	693	773	0	80	80	1.0000000
NODE_2094_length_1569_cov_12.426531	769	849	0	80	80	1.0000000
NODE_2094_length_1569_cov_12.426531	822	902	0	80	80	1.0000000
NODE_2095_length_1569_cov_12.365986	450	530	22	20	80	0.2500000
NODE_2095_length_1569_cov_12.365986	450	530	30	6	80	0.0750000
NODE_2095_length_1569_cov_12.365986	450	530	32	8	80	0.1000000
NODE_2095_length_1569_cov_12.365986	450	530	34	46	80	0.5750000
NODE_2095_length_1569_cov_12.365986	450	530	22	20	80	0.2500000
NODE_2095_length_1569_cov_12.365986	450	530	30	6	80	0.0750000
NODE_2095_length_1569_cov_12.365986	450	530	32	8	80	0.1000000
NODE_2095_length_1569_cov_12.365986	450	530	34	46	80	0.5750000
NODE_2095_length_1569_cov_12.365986	503	564	28	4	61	0.0655738
NODE_2095_length_1569_cov_12.365986	503	564	30	7	61	0.1147541
NODE_2095_length_1569_cov_12.365986	503	564	32	26	61	0.4262295
NODE_2095_length_1569_cov_12.365986	503	564	34	24	61	0.3934426
NODE_2095_length_1569_cov_12.365986	503	556	30	3	53	0.0566038
NODE_2095_length_1569_cov_12.365986	503	556	32	26	53	0.4905660
NODE_2095_length_1569_cov_12.365986	503	556	34	24	53	0.4528302
NODE_2096_length_1569_cov_11.599320	798	878	4	47	80	0.5875000
NODE_2096_length_1569_cov_11.599320	798	878	6	33	80	0.4125000
NODE_2096_length_1569_cov_11.599320	851	931	2	16	80	0.2000000
NODE_2096_length_1569_cov_11.599320	851	931	4	38	80	0.4750000
NODE_2096_length_1569_cov_11.599320	851	931	6	26	80	0.3250000
NODE_2097_length_1569_cov_10.917687	521	601	0	80	80	1.0000000
NODE_2097_length_1569_cov_10.917687	574	654	0	80	80	1.0000000
NODE_2108_length_1563_cov_15.357240	590	670	0	35	80	0.4375000
NODE_2108_length_1563_cov_15.357240	590	670	5	1	80	0.0125000
NODE_2108_length_1563_cov_15.357240	590	670	6	44	80	0.5500000
NODE_2108_length_1563_cov_15.357240	643	723	6	80	80	1.0000000
NODE_2110_length_1561_cov_18.420657	354	434	0	15	80	0.1875000
NODE_2110_length_1561_cov_18.420657	354	434	4	65	80	0.8125000
NODE_2110_length_1561_cov_18.420657	407	487	0	18	80	0.2250000
NODE_2110_length_1561_cov_18.420657	407	487	4	62	80	0.7750000
NODE_2110_length_1561_cov_18.420657	483	563	0	80	80	1.0000000
NODE_2110_length_1561_cov_18.420657	536	616	0	80	80	1.0000000
NODE_2116_length_1559_cov_7.071233	347	427	0	80	80	1.0000000
NODE_2116_length_1559_cov_7.071233	400	478	0	78	78	1.0000000
NODE_2116_length_1559_cov_7.071233	1187	1238	2	51	51	1.0000000
NODE_2118_length_1558_cov_3.486635	338	418	0	80	80	1.0000000
NODE_2118_length_1558_cov_3.486635	391	471	0	80	80	1.0000000
NODE_2119_length_1557_cov_17.089163	542	622	0	80	80	1.0000000
NODE_2119_length_1557_cov_17.089163	595	675	0	80	80	1.0000000
NODE_2120_length_1557_cov_4.639918	0	56	0	56	56	1.0000000
NODE_2120_length_1557_cov_4.639918	49	112	0	63	63	1.0000000
NODE_2120_length_1557_cov_4.639918	85	161	0	76	76	1.0000000
NODE_2123_length_1556_cov_23.289636	456	536	0	80	80	1.0000000
NODE_2123_length_1556_cov_23.289636	509	589	0	80	80	1.0000000
NODE_2123_length_1556_cov_23.289636	681	761	0	47	80	0.5875000
NODE_2123_length_1556_cov_23.289636	681	761	2	33	80	0.4125000
NODE_2123_length_1556_cov_23.289636	734	814	2	35	80	0.4375000
NODE_2123_length_1556_cov_23.289636	734	814	4	4	80	0.0500000
NODE_2123_length_1556_cov_23.289636	734	814	5	2	80	0.0250000
NODE_2123_length_1556_cov_23.289636	734	814	6	39	80	0.4875000
NODE_2123_length_1556_cov_23.289636	1445	1525	154	4	80	0.0500000
NODE_2123_length_1556_cov_23.289636	1445	1525	164	2	80	0.0250000
NODE_2123_length_1556_cov_23.289636	1445	1525	169	1	80	0.0125000
NODE_2123_length_1556_cov_23.289636	1445	1525	172	73	80	0.9125000
NODE_2124_length_1556_cov_7.494166	300	380	0	31	80	0.3875000
NODE_2124_length_1556_cov_7.494166	300	380	2	49	80	0.6125000
NODE_2124_length_1556_cov_7.494166	353	433	0	80	80	1.0000000
NODE_2126_length_1555_cov_13.461538	666	746	2	26	80	0.3250000
NODE_2126_length_1555_cov_13.461538	666	746	4	33	80	0.4125000
NODE_2126_length_1555_cov_13.461538	666	746	6	21	80	0.2625000
NODE_2126_length_1555_cov_13.461538	719	799	2	16	80	0.2000000
NODE_2126_length_1555_cov_13.461538	719	799	4	13	80	0.1625000
NODE_2126_length_1555_cov_13.461538	719	799	6	51	80	0.6375000
NODE_2127_length_1554_cov_30.239175	144	226	2	82	82	1.0000000
NODE_2127_length_1554_cov_30.239175	199	279	2	27	80	0.3375000
NODE_2127_length_1554_cov_30.239175	199	279	4	2	80	0.0250000
NODE_2127_length_1554_cov_30.239175	199	279	6	2	80	0.0250000
NODE_2127_length_1554_cov_30.239175	199	279	8	4	80	0.0500000
NODE_2127_length_1554_cov_30.239175	199	279	10	3	80	0.0375000
NODE_2127_length_1554_cov_30.239175	199	279	12	1	80	0.0125000
NODE_2127_length_1554_cov_30.239175	199	279	13	6	80	0.0750000
NODE_2127_length_1554_cov_30.239175	199	279	15	1	80	0.0125000
NODE_2127_length_1554_cov_30.239175	199	279	17	4	80	0.0500000
NODE_2127_length_1554_cov_30.239175	199	279	19	5	80	0.0625000
NODE_2127_length_1554_cov_30.239175	199	279	20	1	80	0.0125000
NODE_2127_length_1554_cov_30.239175	199	279	23	3	80	0.0375000
NODE_2127_length_1554_cov_30.239175	199	279	25	5	80	0.0625000
NODE_2127_length_1554_cov_30.239175	199	279	26	6	80	0.0750000
NODE_2127_length_1554_cov_30.239175	199	279	27	6	80	0.0750000
NODE_2127_length_1554_cov_30.239175	199	279	28	3	80	0.0375000
NODE_2127_length_1554_cov_30.239175	199	279	29	1	80	0.0125000
NODE_2127_length_1554_cov_30.239175	877	903	0	26	26	1.0000000
NODE_2127_length_1554_cov_30.239175	930	1010	4	80	80	1.0000000
NODE_2127_length_1554_cov_30.239175	983	1063	2	7	80	0.0875000
NODE_2127_length_1554_cov_30.239175	983	1063	4	73	80	0.9125000
NODE_2128_length_1554_cov_5.381443	1494	1554	24	1	60	0.0166667
NODE_2128_length_1554_cov_5.381443	1494	1554	29	2	60	0.0333333
NODE_2128_length_1554_cov_5.381443	1494	1554	31	2	60	0.0333333
NODE_2128_length_1554_cov_5.381443	1494	1554	33	1	60	0.0166667
NODE_2128_length_1554_cov_5.381443	1494	1554	40	1	60	0.0166667
NODE_2128_length_1554_cov_5.381443	1494	1554	42	5	60	0.0833333
NODE_2128_length_1554_cov_5.381443	1494	1554	44	1	60	0.0166667
NODE_2128_length_1554_cov_5.381443	1494	1554	46	47	60	0.7833334
NODE_2132_length_1552_cov_11.367515	379	445	0	66	66	1.0000000
NODE_2132_length_1552_cov_11.367515	418	484	0	66	66	1.0000000
NODE_2138_length_1549_cov_15.480000	1288	1368	0	80	80	1.0000000
NODE_2138_length_1549_cov_15.480000	1341	1421	0	80	80	1.0000000
NODE_2142_length_1548_cov_12.789510	770	850	0	75	80	0.9375000
NODE_2142_length_1548_cov_12.789510	770	850	2	5	80	0.0625000
NODE_2142_length_1548_cov_12.789510	823	903	0	80	80	1.0000000
NODE_2149_length_1546_cov_24.069800	775	855	0	80	80	1.0000000
NODE_2149_length_1546_cov_24.069800	828	908	0	80	80	1.0000000
NODE_2150_length_1546_cov_10.911541	417	497	2	10	80	0.1250000
NODE_2150_length_1546_cov_10.911541	417	497	4	8	80	0.1000000
NODE_2150_length_1546_cov_10.911541	417	497	6	53	80	0.6625000
NODE_2150_length_1546_cov_10.911541	417	497	8	9	80	0.1125000
NODE_2150_length_1546_cov_10.911541	470	550	4	35	80	0.4375000
NODE_2150_length_1546_cov_10.911541	470	550	6	45	80	0.5625000
NODE_2150_length_1546_cov_10.911541	1065	1145	0	80	80	1.0000000
NODE_2150_length_1546_cov_10.911541	1118	1198	0	80	80	1.0000000
NODE_2155_length_1543_cov_10.400970	480	560	0	80	80	1.0000000
NODE_2155_length_1543_cov_10.400970	533	613	0	80	80	1.0000000
NODE_2156_length_1543_cov_4.532548	43	98	0	30	55	0.5454546
NODE_2156_length_1543_cov_4.532548	43	98	1	21	55	0.3818182
NODE_2156_length_1543_cov_4.532548	43	98	2	4	55	0.0727273
NODE_2162_length_1541_cov_7.316921	523	603	0	5	80	0.0625000
NODE_2162_length_1541_cov_7.316921	523	603	2	75	80	0.9375000
NODE_2162_length_1541_cov_7.316921	576	658	0	19	82	0.2317073
NODE_2162_length_1541_cov_7.316921	576	658	2	61	82	0.7439024
NODE_2162_length_1541_cov_7.316921	576	658	3	1	82	0.0121951
NODE_2162_length_1541_cov_7.316921	576	658	4	1	82	0.0121951
NODE_2165_length_1539_cov_19.067361	334	414	0	80	80	1.0000000
NODE_2165_length_1539_cov_19.067361	387	467	0	80	80	1.0000000
NODE_2165_length_1539_cov_19.067361	463	543	0	51	80	0.6375000
NODE_2165_length_1539_cov_19.067361	463	543	10	29	80	0.3625000
NODE_2165_length_1539_cov_19.067361	516	596	10	64	80	0.8000000
NODE_2165_length_1539_cov_19.067361	516	596	12	16	80	0.2000000
NODE_2171_length_1538_cov_68.273801	604	684	0	80	80	1.0000000
NODE_2171_length_1538_cov_68.273801	657	737	0	80	80	1.0000000
NODE_2172_length_1538_cov_2.402363	1456	1499	0	43	43	1.0000000
NODE_2173_length_1537_cov_39.413074	782	862	0	80	80	1.0000000
NODE_2173_length_1537_cov_39.413074	835	915	0	80	80	1.0000000
NODE_2173_length_1537_cov_39.413074	911	991	0	80	80	1.0000000
NODE_2173_length_1537_cov_39.413074	964	1044	0	73	80	0.9125000
NODE_2173_length_1537_cov_39.413074	964	1044	2	7	80	0.0875000
NODE_2174_length_1537_cov_30.412378	739	819	6	7	80	0.0875000
NODE_2174_length_1537_cov_30.412378	739	819	18	2	80	0.0250000
NODE_2174_length_1537_cov_30.412378	739	819	19	3	80	0.0375000
NODE_2174_length_1537_cov_30.412378	739	819	22	68	80	0.8500000
NODE_2174_length_1537_cov_30.412378	792	872	10	30	80	0.3750000
NODE_2174_length_1537_cov_30.412378	792	872	16	23	80	0.2875000
NODE_2174_length_1537_cov_30.412378	792	872	18	1	80	0.0125000
NODE_2174_length_1537_cov_30.412378	792	872	19	3	80	0.0375000
NODE_2174_length_1537_cov_30.412378	792	872	22	23	80	0.2875000
NODE_2174_length_1537_cov_30.412378	868	948	0	62	80	0.7750000
NODE_2174_length_1537_cov_30.412378	868	948	10	18	80	0.2250000
NODE_2174_length_1537_cov_30.412378	921	1001	0	80	80	1.0000000
NODE_2175_length_1537_cov_18.707232	669	749	4	80	80	1.0000000
NODE_2175_length_1537_cov_18.707232	722	802	0	24	80	0.3000000
NODE_2175_length_1537_cov_18.707232	722	802	4	56	80	0.7000000
NODE_2176_length_1536_cov_24.991649	832	912	0	80	80	1.0000000
NODE_2176_length_1536_cov_24.991649	885	965	0	80	80	1.0000000
NODE_2176_length_1536_cov_24.991649	961	1041	0	19	80	0.2375000
NODE_2176_length_1536_cov_24.991649	961	1041	4	33	80	0.4125000
NODE_2176_length_1536_cov_24.991649	961	1041	8	28	80	0.3500000
NODE_2176_length_1536_cov_24.991649	1014	1094	8	37	80	0.4625000
NODE_2176_length_1536_cov_24.991649	1014	1094	10	31	80	0.3875000
NODE_2176_length_1536_cov_24.991649	1014	1094	14	12	80	0.1500000
NODE_2183_length_1535_cov_46.662256	992	1072	0	80	80	1.0000000
NODE_2183_length_1535_cov_46.662256	1045	1125	0	45	80	0.5625000
NODE_2183_length_1535_cov_46.662256	1045	1125	2	35	80	0.4375000
NODE_2183_length_1535_cov_46.662256	1127	1203	0	38	76	0.5000000
NODE_2183_length_1535_cov_46.662256	1127	1203	2	38	76	0.5000000
NODE_2183_length_1535_cov_46.662256	1176	1256	0	80	80	1.0000000
NODE_2184_length_1535_cov_32.610724	992	1072	0	16	80	0.2000000
NODE_2184_length_1535_cov_32.610724	992	1072	2	64	80	0.8000000
NODE_2184_length_1535_cov_32.610724	1045	1125	0	69	80	0.8625000
NODE_2184_length_1535_cov_32.610724	1045	1125	2	11	80	0.1375000
NODE_2184_length_1535_cov_32.610724	1121	1201	0	25	80	0.3125000
NODE_2184_length_1535_cov_32.610724	1121	1201	4	55	80	0.6875000
NODE_2184_length_1535_cov_32.610724	1174	1254	0	5	80	0.0625000
NODE_2184_length_1535_cov_32.610724	1174	1254	1	16	80	0.2000000
NODE_2184_length_1535_cov_32.610724	1174	1254	2	14	80	0.1750000
NODE_2184_length_1535_cov_32.610724	1174	1254	4	45	80	0.5625000
NODE_2185_length_1535_cov_25.406685	619	699	0	19	80	0.2375000
NODE_2185_length_1535_cov_25.406685	619	699	2	7	80	0.0875000
NODE_2185_length_1535_cov_25.406685	619	699	4	54	80	0.6750000
NODE_2185_length_1535_cov_25.406685	672	752	0	30	80	0.3750000
NODE_2185_length_1535_cov_25.406685	672	752	4	50	80	0.6250000
NODE_2190_length_1534_cov_13.542857	439	519	0	7	80	0.0875000
NODE_2190_length_1534_cov_13.542857	439	519	2	73	80	0.9125000
NODE_2190_length_1534_cov_13.542857	492	567	0	55	75	0.7333333
NODE_2190_length_1534_cov_13.542857	492	567	2	20	75	0.2666667
NODE_2197_length_1531_cov_17.336592	324	404	0	32	80	0.4000000
NODE_2197_length_1531_cov_17.336592	324	404	2	11	80	0.1375000
NODE_2197_length_1531_cov_17.336592	324	404	4	37	80	0.4625000
NODE_2198_length_1531_cov_6.267458	606	686	0	25	80	0.3125000
NODE_2198_length_1531_cov_6.267458	606	686	2	55	80	0.6875000
NODE_2198_length_1531_cov_6.267458	659	739	2	80	80	1.0000000
NODE_2199_length_1530_cov_13.514326	323	403	2	12	80	0.1500000
NODE_2199_length_1530_cov_13.514326	323	403	4	68	80	0.8500000
NODE_2199_length_1530_cov_13.514326	376	456	0	4	80	0.0500000
NODE_2199_length_1530_cov_13.514326	376	456	2	61	80	0.7625000
NODE_2199_length_1530_cov_13.514326	376	456	4	15	80	0.1875000
NODE_2199_length_1530_cov_13.514326	1465	1513	0	48	48	1.0000000
NODE_2200_length_1530_cov_9.012579	637	717	0	60	80	0.7500000
NODE_2200_length_1530_cov_9.012579	637	717	2	20	80	0.2500000
NODE_2200_length_1530_cov_9.012579	690	770	0	7	80	0.0875000
NODE_2200_length_1530_cov_9.012579	690	770	2	73	80	0.9125000
NODE_2203_length_1529_cov_21.061538	983	1063	0	80	80	1.0000000
NODE_2203_length_1529_cov_21.061538	1036	1116	0	80	80	1.0000000
NODE_2205_length_1529_cov_1.380420	219	282	0	4	63	0.0634921
NODE_2205_length_1529_cov_1.380420	219	282	4	41	63	0.6507937
NODE_2205_length_1529_cov_1.380420	219	282	6	2	63	0.0317460
NODE_2205_length_1529_cov_1.380420	219	282	8	16	63	0.2539683
NODE_2205_length_1529_cov_1.380420	272	323	4	10	51	0.1960784
NODE_2205_length_1529_cov_1.380420	272	323	8	41	51	0.8039216
NODE_2206_length_1528_cov_8.578027	449	529	2	80	80	1.0000000
NODE_2206_length_1528_cov_8.578027	502	582	0	17	80	0.2125000
NODE_2206_length_1528_cov_8.578027	502	582	2	63	80	0.7875000
NODE_2210_length_1526_cov_92.265592	986	1066	4	10	80	0.1250000
NODE_2210_length_1526_cov_92.265592	986	1066	11	1	80	0.0125000
NODE_2210_length_1526_cov_92.265592	986	1066	12	20	80	0.2500000
NODE_2210_length_1526_cov_92.265592	986	1066	19	49	80	0.6125000
NODE_2210_length_1526_cov_92.265592	1039	1119	15	2	80	0.0250000
NODE_2210_length_1526_cov_92.265592	1039	1119	17	3	80	0.0375000
NODE_2210_length_1526_cov_92.265592	1039	1119	19	75	80	0.9375000
NODE_2211_length_1526_cov_4.051857	291	370	5	1	79	0.0126582
NODE_2211_length_1526_cov_4.051857	291	370	7	3	79	0.0379747
NODE_2211_length_1526_cov_4.051857	291	370	9	33	79	0.4177215
NODE_2211_length_1526_cov_4.051857	291	370	10	1	79	0.0126582
NODE_2211_length_1526_cov_4.051857	291	370	11	7	79	0.0886076
NODE_2211_length_1526_cov_4.051857	291	370	12	4	79	0.0506329
NODE_2211_length_1526_cov_4.051857	291	370	13	30	79	0.3797468
NODE_2213_length_1525_cov_20.232118	1014	1090	330	1	76	0.0131579
NODE_2213_length_1525_cov_20.232118	1014	1090	331	1	76	0.0131579
NODE_2213_length_1525_cov_20.232118	1014	1090	333	1	76	0.0131579
NODE_2213_length_1525_cov_20.232118	1014	1090	337	1	76	0.0131579
NODE_2213_length_1525_cov_20.232118	1014	1090	339	1	76	0.0131579
NODE_2213_length_1525_cov_20.232118	1014	1090	342	1	76	0.0131579
NODE_2213_length_1525_cov_20.232118	1014	1090	344	3	76	0.0394737
NODE_2213_length_1525_cov_20.232118	1014	1090	346	1	76	0.0131579
NODE_2213_length_1525_cov_20.232118	1014	1090	349	1	76	0.0131579
NODE_2213_length_1525_cov_20.232118	1014	1090	350	1	76	0.0131579
NODE_2213_length_1525_cov_20.232118	1014	1090	352	1	76	0.0131579
NODE_2213_length_1525_cov_20.232118	1014	1090	354	1	76	0.0131579
NODE_2213_length_1525_cov_20.232118	1014	1090	355	1	76	0.0131579
NODE_2213_length_1525_cov_20.232118	1014	1090	356	1	76	0.0131579
NODE_2213_length_1525_cov_20.232118	1014	1090	357	1	76	0.0131579
NODE_2213_length_1525_cov_20.232118	1014	1090	358	2	76	0.0263158
NODE_2213_length_1525_cov_20.232118	1014	1090	360	1	76	0.0131579
NODE_2213_length_1525_cov_20.232118	1014	1090	363	1	76	0.0131579
NODE_2213_length_1525_cov_20.232118	1014	1090	364	1	76	0.0131579
NODE_2213_length_1525_cov_20.232118	1014	1090	365	1	76	0.0131579
NODE_2213_length_1525_cov_20.232118	1014	1090	366	1	76	0.0131579
NODE_2213_length_1525_cov_20.232118	1014	1090	371	1	76	0.0131579
NODE_2213_length_1525_cov_20.232118	1014	1090	373	1	76	0.0131579
NODE_2213_length_1525_cov_20.232118	1014	1090	375	1	76	0.0131579
NODE_2213_length_1525_cov_20.232118	1014	1090	376	1	76	0.0131579
NODE_2213_length_1525_cov_20.232118	1014	1090	377	4	76	0.0526316
NODE_2213_length_1525_cov_20.232118	1014	1090	379	1	76	0.0131579
NODE_2213_length_1525_cov_20.232118	1014	1090	382	1	76	0.0131579
NODE_2213_length_1525_cov_20.232118	1014	1090	384	2	76	0.0263158
NODE_2213_length_1525_cov_20.232118	1014	1090	385	1	76	0.0131579
NODE_2213_length_1525_cov_20.232118	1014	1090	386	4	76	0.0526316
NODE_2213_length_1525_cov_20.232118	1014	1090	387	2	76	0.0263158
NODE_2213_length_1525_cov_20.232118	1014	1090	388	1	76	0.0131579
NODE_2213_length_1525_cov_20.232118	1014	1090	389	1	76	0.0131579
NODE_2213_length_1525_cov_20.232118	1014	1090	393	2	76	0.0263158
NODE_2213_length_1525_cov_20.232118	1014	1090	394	2	76	0.0263158
NODE_2213_length_1525_cov_20.232118	1014	1090	395	1	76	0.0131579
NODE_2213_length_1525_cov_20.232118	1014	1090	396	1	76	0.0131579
NODE_2213_length_1525_cov_20.232118	1014	1090	398	1	76	0.0131579
NODE_2213_length_1525_cov_20.232118	1014	1090	399	1	76	0.0131579
NODE_2213_length_1525_cov_20.232118	1014	1090	400	1	76	0.0131579
NODE_2213_length_1525_cov_20.232118	1014	1090	404	4	76	0.0526316
NODE_2213_length_1525_cov_20.232118	1014	1090	405	1	76	0.0131579
NODE_2213_length_1525_cov_20.232118	1014	1090	406	1	76	0.0131579
NODE_2213_length_1525_cov_20.232118	1014	1090	408	1	76	0.0131579
NODE_2213_length_1525_cov_20.232118	1014	1090	418	1	76	0.0131579
NODE_2213_length_1525_cov_20.232118	1014	1090	419	1	76	0.0131579
NODE_2213_length_1525_cov_20.232118	1014	1090	422	2	76	0.0263158
NODE_2213_length_1525_cov_20.232118	1014	1090	424	1	76	0.0131579
NODE_2213_length_1525_cov_20.232118	1014	1090	425	2	76	0.0263158
NODE_2213_length_1525_cov_20.232118	1014	1090	427	2	76	0.0263158
NODE_2213_length_1525_cov_20.232118	1014	1090	428	1	76	0.0131579
NODE_2213_length_1525_cov_20.232118	1014	1090	429	1	76	0.0131579
NODE_2213_length_1525_cov_20.232118	1014	1090	433	2	76	0.0263158
NODE_2213_length_1525_cov_20.232118	1014	1090	434	1	76	0.0131579
NODE_2213_length_1525_cov_20.232118	1014	1090	436	1	76	0.0131579
NODE_2213_length_1525_cov_20.232118	1281	1338	0	57	57	1.0000000
NODE_2214_length_1525_cov_11.421459	804	884	0	80	80	1.0000000
NODE_2214_length_1525_cov_11.421459	857	937	0	80	80	1.0000000
NODE_2217_length_1524_cov_130.874386	171	243	571	1	72	0.0138889
NODE_2217_length_1524_cov_130.874386	171	243	577	1	72	0.0138889
NODE_2217_length_1524_cov_130.874386	171	243	579	1	72	0.0138889
NODE_2217_length_1524_cov_130.874386	171	243	588	1	72	0.0138889
NODE_2217_length_1524_cov_130.874386	171	243	591	1	72	0.0138889
NODE_2217_length_1524_cov_130.874386	171	243	606	1	72	0.0138889
NODE_2217_length_1524_cov_130.874386	171	243	619	1	72	0.0138889
NODE_2217_length_1524_cov_130.874386	171	243	623	1	72	0.0138889
NODE_2217_length_1524_cov_130.874386	171	243	625	1	72	0.0138889
NODE_2217_length_1524_cov_130.874386	171	243	629	1	72	0.0138889
NODE_2217_length_1524_cov_130.874386	171	243	635	1	72	0.0138889
NODE_2217_length_1524_cov_130.874386	171	243	656	1	72	0.0138889
NODE_2217_length_1524_cov_130.874386	171	243	658	1	72	0.0138889
NODE_2217_length_1524_cov_130.874386	171	243	673	1	72	0.0138889
NODE_2217_length_1524_cov_130.874386	171	243	681	1	72	0.0138889
NODE_2217_length_1524_cov_130.874386	171	243	687	1	72	0.0138889
NODE_2217_length_1524_cov_130.874386	171	243	694	1	72	0.0138889
NODE_2217_length_1524_cov_130.874386	171	243	698	1	72	0.0138889
NODE_2217_length_1524_cov_130.874386	171	243	710	1	72	0.0138889
NODE_2217_length_1524_cov_130.874386	171	243	729	1	72	0.0138889
NODE_2217_length_1524_cov_130.874386	171	243	735	1	72	0.0138889
NODE_2217_length_1524_cov_130.874386	171	243	762	1	72	0.0138889
NODE_2217_length_1524_cov_130.874386	171	243	777	1	72	0.0138889
NODE_2217_length_1524_cov_130.874386	171	243	796	1	72	0.0138889
NODE_2217_length_1524_cov_130.874386	171	243	799	1	72	0.0138889
NODE_2217_length_1524_cov_130.874386	171	243	812	1	72	0.0138889
NODE_2217_length_1524_cov_130.874386	171	243	819	1	72	0.0138889
NODE_2217_length_1524_cov_130.874386	171	243	836	1	72	0.0138889
NODE_2217_length_1524_cov_130.874386	171	243	848	1	72	0.0138889
NODE_2217_length_1524_cov_130.874386	171	243	868	1	72	0.0138889
NODE_2217_length_1524_cov_130.874386	171	243	872	1	72	0.0138889
NODE_2217_length_1524_cov_130.874386	171	243	874	1	72	0.0138889
NODE_2217_length_1524_cov_130.874386	171	243	880	2	72	0.0277778
NODE_2217_length_1524_cov_130.874386	171	243	882	1	72	0.0138889
NODE_2217_length_1524_cov_130.874386	171	243	884	1	72	0.0138889
NODE_2217_length_1524_cov_130.874386	171	243	888	3	72	0.0416667
NODE_2217_length_1524_cov_130.874386	171	243	889	1	72	0.0138889
NODE_2217_length_1524_cov_130.874386	171	243	891	2	72	0.0277778
NODE_2217_length_1524_cov_130.874386	171	243	894	1	72	0.0138889
NODE_2217_length_1524_cov_130.874386	171	243	895	2	72	0.0277778
NODE_2217_length_1524_cov_130.874386	171	243	897	1	72	0.0138889
NODE_2217_length_1524_cov_130.874386	171	243	898	2	72	0.0277778
NODE_2217_length_1524_cov_130.874386	171	243	899	1	72	0.0138889
NODE_2217_length_1524_cov_130.874386	171	243	900	1	72	0.0138889
NODE_2217_length_1524_cov_130.874386	171	243	901	1	72	0.0138889
NODE_2217_length_1524_cov_130.874386	171	243	902	1	72	0.0138889
NODE_2217_length_1524_cov_130.874386	171	243	903	1	72	0.0138889
NODE_2217_length_1524_cov_130.874386	171	243	904	2	72	0.0277778
NODE_2217_length_1524_cov_130.874386	171	243	905	1	72	0.0138889
NODE_2217_length_1524_cov_130.874386	171	243	907	3	72	0.0416667
NODE_2217_length_1524_cov_130.874386	171	243	909	1	72	0.0138889
NODE_2217_length_1524_cov_130.874386	171	243	912	1	72	0.0138889
NODE_2217_length_1524_cov_130.874386	171	243	914	3	72	0.0416667
NODE_2217_length_1524_cov_130.874386	171	243	915	2	72	0.0277778
NODE_2217_length_1524_cov_130.874386	171	243	916	2	72	0.0277778
NODE_2217_length_1524_cov_130.874386	171	243	919	1	72	0.0138889
NODE_2217_length_1524_cov_130.874386	171	243	923	1	72	0.0138889
NODE_2217_length_1524_cov_130.874386	171	243	924	1	72	0.0138889
NODE_2217_length_1524_cov_130.874386	171	243	925	1	72	0.0138889
NODE_2217_length_1524_cov_130.874386	191	247	735	1	56	0.0178571
NODE_2217_length_1524_cov_130.874386	191	247	762	1	56	0.0178571
NODE_2217_length_1524_cov_130.874386	191	247	777	1	56	0.0178571
NODE_2217_length_1524_cov_130.874386	191	247	796	1	56	0.0178571
NODE_2217_length_1524_cov_130.874386	191	247	799	1	56	0.0178571
NODE_2217_length_1524_cov_130.874386	191	247	812	1	56	0.0178571
NODE_2217_length_1524_cov_130.874386	191	247	819	1	56	0.0178571
NODE_2217_length_1524_cov_130.874386	191	247	836	1	56	0.0178571
NODE_2217_length_1524_cov_130.874386	191	247	848	1	56	0.0178571
NODE_2217_length_1524_cov_130.874386	191	247	868	1	56	0.0178571
NODE_2217_length_1524_cov_130.874386	191	247	872	1	56	0.0178571
NODE_2217_length_1524_cov_130.874386	191	247	874	1	56	0.0178571
NODE_2217_length_1524_cov_130.874386	191	247	879	1	56	0.0178571
NODE_2217_length_1524_cov_130.874386	191	247	880	2	56	0.0357143
NODE_2217_length_1524_cov_130.874386	191	247	882	1	56	0.0178571
NODE_2217_length_1524_cov_130.874386	191	247	884	1	56	0.0178571
NODE_2217_length_1524_cov_130.874386	191	247	886	1	56	0.0178571
NODE_2217_length_1524_cov_130.874386	191	247	888	4	56	0.0714286
NODE_2217_length_1524_cov_130.874386	191	247	889	1	56	0.0178571
NODE_2217_length_1524_cov_130.874386	191	247	891	3	56	0.0535714
NODE_2217_length_1524_cov_130.874386	191	247	894	1	56	0.0178571
NODE_2217_length_1524_cov_130.874386	191	247	895	2	56	0.0357143
NODE_2217_length_1524_cov_130.874386	191	247	897	1	56	0.0178571
NODE_2217_length_1524_cov_130.874386	191	247	898	2	56	0.0357143
NODE_2217_length_1524_cov_130.874386	191	247	899	1	56	0.0178571
NODE_2217_length_1524_cov_130.874386	191	247	900	1	56	0.0178571
NODE_2217_length_1524_cov_130.874386	191	247	901	1	56	0.0178571
NODE_2217_length_1524_cov_130.874386	191	247	902	1	56	0.0178571
NODE_2217_length_1524_cov_130.874386	191	247	903	1	56	0.0178571
NODE_2217_length_1524_cov_130.874386	191	247	904	2	56	0.0357143
NODE_2217_length_1524_cov_130.874386	191	247	905	1	56	0.0178571
NODE_2217_length_1524_cov_130.874386	191	247	907	3	56	0.0535714
NODE_2217_length_1524_cov_130.874386	191	247	909	1	56	0.0178571
NODE_2217_length_1524_cov_130.874386	191	247	912	1	56	0.0178571
NODE_2217_length_1524_cov_130.874386	191	247	914	3	56	0.0535714
NODE_2217_length_1524_cov_130.874386	191	247	915	2	56	0.0357143
NODE_2217_length_1524_cov_130.874386	191	247	916	2	56	0.0357143
NODE_2217_length_1524_cov_130.874386	191	247	919	1	56	0.0178571
NODE_2217_length_1524_cov_130.874386	191	247	923	1	56	0.0178571
NODE_2217_length_1524_cov_130.874386	191	247	924	1	56	0.0178571
NODE_2217_length_1524_cov_130.874386	191	247	925	1	56	0.0178571
NODE_2217_length_1524_cov_130.874386	219	296	509	1	77	0.0129870
NODE_2217_length_1524_cov_130.874386	219	296	517	1	77	0.0129870
NODE_2217_length_1524_cov_130.874386	219	296	524	1	77	0.0129870
NODE_2217_length_1524_cov_130.874386	219	296	551	1	77	0.0129870
NODE_2217_length_1524_cov_130.874386	219	296	564	1	77	0.0129870
NODE_2217_length_1524_cov_130.874386	219	296	595	1	77	0.0129870
NODE_2217_length_1524_cov_130.874386	219	296	606	2	77	0.0259740
NODE_2217_length_1524_cov_130.874386	219	296	607	1	77	0.0129870
NODE_2217_length_1524_cov_130.874386	219	296	612	1	77	0.0129870
NODE_2217_length_1524_cov_130.874386	219	296	626	1	77	0.0129870
NODE_2217_length_1524_cov_130.874386	219	296	642	1	77	0.0129870
NODE_2217_length_1524_cov_130.874386	219	296	650	1	77	0.0129870
NODE_2217_length_1524_cov_130.874386	219	296	653	1	77	0.0129870
NODE_2217_length_1524_cov_130.874386	219	296	661	1	77	0.0129870
NODE_2217_length_1524_cov_130.874386	219	296	671	1	77	0.0129870
NODE_2217_length_1524_cov_130.874386	219	296	685	1	77	0.0129870
NODE_2217_length_1524_cov_130.874386	219	296	686	1	77	0.0129870
NODE_2217_length_1524_cov_130.874386	219	296	698	1	77	0.0129870
NODE_2217_length_1524_cov_130.874386	219	296	707	1	77	0.0129870
NODE_2217_length_1524_cov_130.874386	219	296	720	1	77	0.0129870
NODE_2217_length_1524_cov_130.874386	219	296	723	1	77	0.0129870
NODE_2217_length_1524_cov_130.874386	219	296	728	1	77	0.0129870
NODE_2217_length_1524_cov_130.874386	219	296	729	1	77	0.0129870
NODE_2217_length_1524_cov_130.874386	219	296	730	1	77	0.0129870
NODE_2217_length_1524_cov_130.874386	219	296	737	1	77	0.0129870
NODE_2217_length_1524_cov_130.874386	219	296	740	1	77	0.0129870
NODE_2217_length_1524_cov_130.874386	219	296	751	1	77	0.0129870
NODE_2217_length_1524_cov_130.874386	219	296	756	1	77	0.0129870
NODE_2217_length_1524_cov_130.874386	219	296	757	1	77	0.0129870
NODE_2217_length_1524_cov_130.874386	219	296	761	1	77	0.0129870
NODE_2217_length_1524_cov_130.874386	219	296	762	2	77	0.0259740
NODE_2217_length_1524_cov_130.874386	219	296	772	1	77	0.0129870
NODE_2217_length_1524_cov_130.874386	219	296	774	1	77	0.0129870
NODE_2217_length_1524_cov_130.874386	219	296	785	1	77	0.0129870
NODE_2217_length_1524_cov_130.874386	219	296	788	1	77	0.0129870
NODE_2217_length_1524_cov_130.874386	219	296	795	1	77	0.0129870
NODE_2217_length_1524_cov_130.874386	219	296	808	1	77	0.0129870
NODE_2217_length_1524_cov_130.874386	219	296	809	1	77	0.0129870
NODE_2217_length_1524_cov_130.874386	219	296	810	1	77	0.0129870
NODE_2217_length_1524_cov_130.874386	219	296	831	1	77	0.0129870
NODE_2217_length_1524_cov_130.874386	219	296	841	1	77	0.0129870
NODE_2217_length_1524_cov_130.874386	219	296	848	1	77	0.0129870
NODE_2217_length_1524_cov_130.874386	219	296	850	1	77	0.0129870
NODE_2217_length_1524_cov_130.874386	219	296	852	1	77	0.0129870
NODE_2217_length_1524_cov_130.874386	219	296	855	1	77	0.0129870
NODE_2217_length_1524_cov_130.874386	219	296	859	1	77	0.0129870
NODE_2217_length_1524_cov_130.874386	219	296	871	1	77	0.0129870
NODE_2217_length_1524_cov_130.874386	219	296	879	1	77	0.0129870
NODE_2217_length_1524_cov_130.874386	219	296	880	2	77	0.0259740
NODE_2217_length_1524_cov_130.874386	219	296	884	1	77	0.0129870
NODE_2217_length_1524_cov_130.874386	219	296	886	1	77	0.0129870
NODE_2217_length_1524_cov_130.874386	219	296	888	3	77	0.0389610
NODE_2217_length_1524_cov_130.874386	219	296	889	1	77	0.0129870
NODE_2217_length_1524_cov_130.874386	219	296	891	3	77	0.0389610
NODE_2217_length_1524_cov_130.874386	219	296	894	1	77	0.0129870
NODE_2217_length_1524_cov_130.874386	219	296	895	2	77	0.0259740
NODE_2217_length_1524_cov_130.874386	219	296	899	1	77	0.0129870
NODE_2217_length_1524_cov_130.874386	219	296	900	1	77	0.0129870
NODE_2217_length_1524_cov_130.874386	219	296	902	1	77	0.0129870
NODE_2217_length_1524_cov_130.874386	219	296	903	1	77	0.0129870
NODE_2217_length_1524_cov_130.874386	219	296	904	1	77	0.0129870
NODE_2217_length_1524_cov_130.874386	219	296	905	1	77	0.0129870
NODE_2217_length_1524_cov_130.874386	219	296	907	1	77	0.0129870
NODE_2217_length_1524_cov_130.874386	219	296	914	2	77	0.0259740
NODE_2217_length_1524_cov_130.874386	219	296	915	2	77	0.0259740
NODE_2217_length_1524_cov_130.874386	219	296	916	1	77	0.0129870
NODE_2217_length_1524_cov_130.874386	219	296	919	1	77	0.0129870
NODE_2217_length_1524_cov_130.874386	253	333	268	1	80	0.0125000
NODE_2217_length_1524_cov_130.874386	253	333	270	1	80	0.0125000
NODE_2217_length_1524_cov_130.874386	253	333	274	1	80	0.0125000
NODE_2217_length_1524_cov_130.874386	253	333	281	1	80	0.0125000
NODE_2217_length_1524_cov_130.874386	253	333	283	1	80	0.0125000
NODE_2217_length_1524_cov_130.874386	253	333	294	1	80	0.0125000
NODE_2217_length_1524_cov_130.874386	253	333	303	1	80	0.0125000
NODE_2217_length_1524_cov_130.874386	253	333	304	1	80	0.0125000
NODE_2217_length_1524_cov_130.874386	253	333	308	1	80	0.0125000
NODE_2217_length_1524_cov_130.874386	253	333	314	1	80	0.0125000
NODE_2217_length_1524_cov_130.874386	253	333	316	2	80	0.0250000
NODE_2217_length_1524_cov_130.874386	253	333	319	1	80	0.0125000
NODE_2217_length_1524_cov_130.874386	253	333	321	1	80	0.0125000
NODE_2217_length_1524_cov_130.874386	253	333	324	1	80	0.0125000
NODE_2217_length_1524_cov_130.874386	253	333	329	1	80	0.0125000
NODE_2217_length_1524_cov_130.874386	253	333	332	1	80	0.0125000
NODE_2217_length_1524_cov_130.874386	253	333	340	1	80	0.0125000
NODE_2217_length_1524_cov_130.874386	253	333	350	2	80	0.0250000
NODE_2217_length_1524_cov_130.874386	253	333	358	1	80	0.0125000
NODE_2217_length_1524_cov_130.874386	253	333	370	1	80	0.0125000
NODE_2217_length_1524_cov_130.874386	253	333	387	1	80	0.0125000
NODE_2217_length_1524_cov_130.874386	253	333	394	1	80	0.0125000
NODE_2217_length_1524_cov_130.874386	253	333	400	1	80	0.0125000
NODE_2217_length_1524_cov_130.874386	253	333	414	1	80	0.0125000
NODE_2217_length_1524_cov_130.874386	253	333	425	1	80	0.0125000
NODE_2217_length_1524_cov_130.874386	253	333	433	1	80	0.0125000
NODE_2217_length_1524_cov_130.874386	253	333	441	1	80	0.0125000
NODE_2217_length_1524_cov_130.874386	253	333	458	1	80	0.0125000
NODE_2217_length_1524_cov_130.874386	253	333	461	1	80	0.0125000
NODE_2217_length_1524_cov_130.874386	253	333	471	1	80	0.0125000
NODE_2217_length_1524_cov_130.874386	253	333	478	2	80	0.0250000
NODE_2217_length_1524_cov_130.874386	253	333	491	1	80	0.0125000
NODE_2217_length_1524_cov_130.874386	253	333	492	1	80	0.0125000
NODE_2217_length_1524_cov_130.874386	253	333	496	1	80	0.0125000
NODE_2217_length_1524_cov_130.874386	253	333	509	1	80	0.0125000
NODE_2217_length_1524_cov_130.874386	253	333	517	1	80	0.0125000
NODE_2217_length_1524_cov_130.874386	253	333	524	1	80	0.0125000
NODE_2217_length_1524_cov_130.874386	253	333	551	1	80	0.0125000
NODE_2217_length_1524_cov_130.874386	253	333	564	1	80	0.0125000
NODE_2217_length_1524_cov_130.874386	253	333	595	1	80	0.0125000
NODE_2217_length_1524_cov_130.874386	253	333	606	2	80	0.0250000
NODE_2217_length_1524_cov_130.874386	253	333	607	1	80	0.0125000
NODE_2217_length_1524_cov_130.874386	253	333	612	1	80	0.0125000
NODE_2217_length_1524_cov_130.874386	253	333	626	1	80	0.0125000
NODE_2217_length_1524_cov_130.874386	253	333	642	1	80	0.0125000
NODE_2217_length_1524_cov_130.874386	253	333	650	1	80	0.0125000
NODE_2217_length_1524_cov_130.874386	253	333	653	1	80	0.0125000
NODE_2217_length_1524_cov_130.874386	253	333	661	1	80	0.0125000
NODE_2217_length_1524_cov_130.874386	253	333	671	1	80	0.0125000
NODE_2217_length_1524_cov_130.874386	253	333	685	1	80	0.0125000
NODE_2217_length_1524_cov_130.874386	253	333	686	1	80	0.0125000
NODE_2217_length_1524_cov_130.874386	253	333	698	1	80	0.0125000
NODE_2217_length_1524_cov_130.874386	253	333	707	1	80	0.0125000
NODE_2217_length_1524_cov_130.874386	253	333	720	1	80	0.0125000
NODE_2217_length_1524_cov_130.874386	253	333	723	1	80	0.0125000
NODE_2217_length_1524_cov_130.874386	253	333	728	1	80	0.0125000
NODE_2217_length_1524_cov_130.874386	253	333	729	1	80	0.0125000
NODE_2217_length_1524_cov_130.874386	253	333	730	1	80	0.0125000
NODE_2217_length_1524_cov_130.874386	253	333	737	1	80	0.0125000
NODE_2217_length_1524_cov_130.874386	253	333	740	1	80	0.0125000
NODE_2217_length_1524_cov_130.874386	253	333	751	1	80	0.0125000
NODE_2217_length_1524_cov_130.874386	253	333	756	1	80	0.0125000
NODE_2217_length_1524_cov_130.874386	253	333	757	1	80	0.0125000
NODE_2217_length_1524_cov_130.874386	253	333	761	1	80	0.0125000
NODE_2217_length_1524_cov_130.874386	253	333	762	2	80	0.0250000
NODE_2217_length_1524_cov_130.874386	253	333	772	1	80	0.0125000
NODE_2217_length_1524_cov_130.874386	253	333	774	1	80	0.0125000
NODE_2217_length_1524_cov_130.874386	253	333	785	1	80	0.0125000
NODE_2217_length_1524_cov_130.874386	253	333	788	1	80	0.0125000
NODE_2217_length_1524_cov_130.874386	253	333	795	1	80	0.0125000
NODE_2217_length_1524_cov_130.874386	253	333	808	1	80	0.0125000
NODE_2217_length_1524_cov_130.874386	253	333	809	1	80	0.0125000
NODE_2217_length_1524_cov_130.874386	253	333	810	1	80	0.0125000
NODE_2217_length_1524_cov_130.874386	253	333	831	1	80	0.0125000
NODE_2217_length_1524_cov_130.874386	253	333	841	1	80	0.0125000
NODE_2217_length_1524_cov_130.874386	306	386	96	2	80	0.0250000
NODE_2217_length_1524_cov_130.874386	306	386	99	2	80	0.0250000
NODE_2217_length_1524_cov_130.874386	306	386	109	2	80	0.0250000
NODE_2217_length_1524_cov_130.874386	306	386	110	1	80	0.0125000
NODE_2217_length_1524_cov_130.874386	306	386	113	1	80	0.0125000
NODE_2217_length_1524_cov_130.874386	306	386	122	2	80	0.0250000
NODE_2217_length_1524_cov_130.874386	306	386	123	1	80	0.0125000
NODE_2217_length_1524_cov_130.874386	306	386	128	1	80	0.0125000
NODE_2217_length_1524_cov_130.874386	306	386	132	1	80	0.0125000
NODE_2217_length_1524_cov_130.874386	306	386	137	1	80	0.0125000
NODE_2217_length_1524_cov_130.874386	306	386	140	1	80	0.0125000
NODE_2217_length_1524_cov_130.874386	306	386	143	1	80	0.0125000
NODE_2217_length_1524_cov_130.874386	306	386	145	2	80	0.0250000
NODE_2217_length_1524_cov_130.874386	306	386	146	3	80	0.0375000
NODE_2217_length_1524_cov_130.874386	306	386	147	2	80	0.0250000
NODE_2217_length_1524_cov_130.874386	306	386	150	1	80	0.0125000
NODE_2217_length_1524_cov_130.874386	306	386	154	1	80	0.0125000
NODE_2217_length_1524_cov_130.874386	306	386	159	2	80	0.0250000
NODE_2217_length_1524_cov_130.874386	306	386	163	1	80	0.0125000
NODE_2217_length_1524_cov_130.874386	306	386	165	1	80	0.0125000
NODE_2217_length_1524_cov_130.874386	306	386	170	1	80	0.0125000
NODE_2217_length_1524_cov_130.874386	306	386	177	1	80	0.0125000
NODE_2217_length_1524_cov_130.874386	306	386	185	1	80	0.0125000
NODE_2217_length_1524_cov_130.874386	306	386	194	1	80	0.0125000
NODE_2217_length_1524_cov_130.874386	306	386	197	2	80	0.0250000
NODE_2217_length_1524_cov_130.874386	306	386	204	2	80	0.0250000
NODE_2217_length_1524_cov_130.874386	306	386	209	1	80	0.0125000
NODE_2217_length_1524_cov_130.874386	306	386	211	1	80	0.0125000
NODE_2217_length_1524_cov_130.874386	306	386	214	1	80	0.0125000
NODE_2217_length_1524_cov_130.874386	306	386	221	1	80	0.0125000
NODE_2217_length_1524_cov_130.874386	306	386	224	1	80	0.0125000
NODE_2217_length_1524_cov_130.874386	306	386	230	1	80	0.0125000
NODE_2217_length_1524_cov_130.874386	306	386	233	2	80	0.0250000
NODE_2217_length_1524_cov_130.874386	306	386	235	1	80	0.0125000
NODE_2217_length_1524_cov_130.874386	306	386	238	1	80	0.0125000
NODE_2217_length_1524_cov_130.874386	306	386	239	2	80	0.0250000
NODE_2217_length_1524_cov_130.874386	306	386	251	2	80	0.0250000
NODE_2217_length_1524_cov_130.874386	306	386	260	1	80	0.0125000
NODE_2217_length_1524_cov_130.874386	306	386	268	2	80	0.0250000
NODE_2217_length_1524_cov_130.874386	306	386	270	1	80	0.0125000
NODE_2217_length_1524_cov_130.874386	306	386	274	1	80	0.0125000
NODE_2217_length_1524_cov_130.874386	306	386	281	1	80	0.0125000
NODE_2217_length_1524_cov_130.874386	306	386	283	1	80	0.0125000
NODE_2217_length_1524_cov_130.874386	306	386	294	1	80	0.0125000
NODE_2217_length_1524_cov_130.874386	306	386	303	1	80	0.0125000
NODE_2217_length_1524_cov_130.874386	306	386	304	1	80	0.0125000
NODE_2217_length_1524_cov_130.874386	306	386	308	1	80	0.0125000
NODE_2217_length_1524_cov_130.874386	306	386	314	1	80	0.0125000
NODE_2217_length_1524_cov_130.874386	306	386	316	2	80	0.0250000
NODE_2217_length_1524_cov_130.874386	306	386	319	1	80	0.0125000
NODE_2217_length_1524_cov_130.874386	306	386	321	1	80	0.0125000
NODE_2217_length_1524_cov_130.874386	306	386	324	1	80	0.0125000
NODE_2217_length_1524_cov_130.874386	306	386	329	1	80	0.0125000
NODE_2217_length_1524_cov_130.874386	306	386	332	1	80	0.0125000
NODE_2217_length_1524_cov_130.874386	306	386	340	1	80	0.0125000
NODE_2217_length_1524_cov_130.874386	306	386	350	2	80	0.0250000
NODE_2217_length_1524_cov_130.874386	306	386	358	1	80	0.0125000
NODE_2217_length_1524_cov_130.874386	306	386	370	1	80	0.0125000
NODE_2217_length_1524_cov_130.874386	306	386	387	1	80	0.0125000
NODE_2217_length_1524_cov_130.874386	306	386	394	1	80	0.0125000
NODE_2217_length_1524_cov_130.874386	306	386	400	1	80	0.0125000
NODE_2217_length_1524_cov_130.874386	306	386	414	1	80	0.0125000
NODE_2217_length_1524_cov_130.874386	306	386	425	1	80	0.0125000
NODE_2219_length_1523_cov_24.115169	366	446	0	80	80	1.0000000
NODE_2219_length_1523_cov_24.115169	419	499	0	80	80	1.0000000
NODE_2219_length_1523_cov_24.115169	495	575	0	80	80	1.0000000
NODE_2219_length_1523_cov_24.115169	548	628	0	80	80	1.0000000
NODE_2223_length_1522_cov_13.278988	361	441	0	16	80	0.2000000
NODE_2223_length_1522_cov_13.278988	361	441	4	64	80	0.8000000
NODE_2223_length_1522_cov_13.278988	414	494	0	22	80	0.2750000
NODE_2223_length_1522_cov_13.278988	414	494	4	58	80	0.7250000
NODE_2225_length_1521_cov_20.965541	772	852	0	80	80	1.0000000
NODE_2225_length_1521_cov_20.965541	825	905	0	80	80	1.0000000
NODE_2226_length_1521_cov_15.381153	907	987	0	61	80	0.7625000
NODE_2226_length_1521_cov_15.381153	907	987	4	19	80	0.2375000
NODE_2226_length_1521_cov_15.381153	960	1040	0	8	80	0.1000000
NODE_2226_length_1521_cov_15.381153	960	1040	4	72	80	0.9000000
NODE_2226_length_1521_cov_15.381153	988	1040	4	52	52	1.0000000
NODE_2227_length_1521_cov_7.682138	525	605	0	80	80	1.0000000
NODE_2227_length_1521_cov_7.682138	578	658	0	80	80	1.0000000
NODE_2236_length_1519_cov_20.792958	714	794	0	80	80	1.0000000
NODE_2236_length_1519_cov_20.792958	767	847	0	80	80	1.0000000
NODE_2239_length_1517_cov_24.074048	413	450	0	37	37	1.0000000
NODE_2239_length_1517_cov_24.074048	842	922	0	44	80	0.5500000
NODE_2239_length_1517_cov_24.074048	842	922	2	36	80	0.4500000
NODE_2239_length_1517_cov_24.074048	895	975	2	69	80	0.8625000
NODE_2239_length_1517_cov_24.074048	895	975	4	11	80	0.1375000
NODE_2240_length_1517_cov_22.897743	383	463	0	2	80	0.0250000
NODE_2240_length_1517_cov_22.897743	383	463	11	2	80	0.0250000
NODE_2240_length_1517_cov_22.897743	383	463	12	76	80	0.9500000
NODE_2240_length_1517_cov_22.897743	436	516	0	39	80	0.4875000
NODE_2240_length_1517_cov_22.897743	436	516	12	41	80	0.5125000
NODE_2241_length_1517_cov_11.781382	381	461	7	50	80	0.6250000
NODE_2241_length_1517_cov_11.781382	381	461	8	30	80	0.3750000
NODE_2241_length_1517_cov_11.781382	434	514	0	36	80	0.4500000
NODE_2241_length_1517_cov_11.781382	434	514	6	14	80	0.1750000
NODE_2241_length_1517_cov_11.781382	434	514	7	30	80	0.3750000
NODE_2243_length_1517_cov_4.944993	393	473	0	80	80	1.0000000
NODE_2243_length_1517_cov_4.944993	446	526	0	80	80	1.0000000
NODE_2247_length_1516_cov_11.177135	230	310	0	80	80	1.0000000
NODE_2247_length_1516_cov_11.177135	283	363	0	80	80	1.0000000
NODE_2248_length_1516_cov_8.608327	580	660	0	80	80	1.0000000
NODE_2248_length_1516_cov_8.608327	633	713	0	80	80	1.0000000
NODE_2250_length_1515_cov_16.990819	333	413	27	9	80	0.1125000
NODE_2250_length_1515_cov_16.990819	333	413	29	24	80	0.3000000
NODE_2250_length_1515_cov_16.990819	333	413	31	1	80	0.0125000
NODE_2250_length_1515_cov_16.990819	333	413	34	3	80	0.0375000
NODE_2250_length_1515_cov_16.990819	333	413	35	1	80	0.0125000
NODE_2250_length_1515_cov_16.990819	333	413	36	8	80	0.1000000
NODE_2250_length_1515_cov_16.990819	333	413	37	2	80	0.0250000
NODE_2250_length_1515_cov_16.990819	333	413	38	1	80	0.0125000
NODE_2250_length_1515_cov_16.990819	333	413	40	1	80	0.0125000
NODE_2250_length_1515_cov_16.990819	333	413	43	1	80	0.0125000
NODE_2250_length_1515_cov_16.990819	333	413	44	2	80	0.0250000
NODE_2250_length_1515_cov_16.990819	333	413	46	8	80	0.1000000
NODE_2250_length_1515_cov_16.990819	333	413	47	1	80	0.0125000
NODE_2250_length_1515_cov_16.990819	333	413	48	8	80	0.1000000
NODE_2250_length_1515_cov_16.990819	333	413	49	1	80	0.0125000
NODE_2250_length_1515_cov_16.990819	333	413	50	1	80	0.0125000
NODE_2250_length_1515_cov_16.990819	333	413	51	1	80	0.0125000
NODE_2250_length_1515_cov_16.990819	333	413	54	1	80	0.0125000
NODE_2250_length_1515_cov_16.990819	333	413	58	4	80	0.0500000
NODE_2250_length_1515_cov_16.990819	333	413	60	2	80	0.0250000
NODE_2250_length_1515_cov_16.990819	386	448	12	3	62	0.0483871
NODE_2250_length_1515_cov_16.990819	386	448	16	5	62	0.0806452
NODE_2250_length_1515_cov_16.990819	386	448	17	2	62	0.0322581
NODE_2250_length_1515_cov_16.990819	386	448	18	7	62	0.1129032
NODE_2250_length_1515_cov_16.990819	386	448	20	9	62	0.1451613
NODE_2250_length_1515_cov_16.990819	386	448	23	6	62	0.0967742
NODE_2250_length_1515_cov_16.990819	386	448	25	3	62	0.0483871
NODE_2250_length_1515_cov_16.990819	386	448	27	9	62	0.1451613
NODE_2250_length_1515_cov_16.990819	386	448	29	18	62	0.2903226
NODE_2258_length_1512_cov_5.111819	506	560	0	54	54	1.0000000
NODE_2258_length_1512_cov_5.111819	677	698	0	21	21	1.0000000
NODE_2258_length_1512_cov_5.111819	677	698	0	21	21	1.0000000
NODE_2258_length_1512_cov_5.111819	1057	1137	2	80	80	1.0000000
NODE_2258_length_1512_cov_5.111819	1110	1190	0	46	80	0.5750000
NODE_2258_length_1512_cov_5.111819	1110	1190	2	34	80	0.4250000
NODE_2258_length_1512_cov_5.111819	1144	1190	0	46	46	1.0000000
NODE_2259_length_1512_cov_4.251946	132	204	0	72	72	1.0000000
NODE_2262_length_1511_cov_30.963173	787	867	0	80	80	1.0000000
NODE_2262_length_1511_cov_30.963173	840	920	0	80	80	1.0000000
NODE_2262_length_1511_cov_30.963173	916	996	0	21	80	0.2625000
NODE_2262_length_1511_cov_30.963173	916	996	2	59	80	0.7375000
NODE_2262_length_1511_cov_30.963173	969	1059	0	25	90	0.2777778
NODE_2262_length_1511_cov_30.963173	969	1059	2	65	90	0.7222222
NODE_2265_length_1510_cov_24.184975	434	514	0	38	80	0.4750000
NODE_2265_length_1510_cov_24.184975	434	514	4	42	80	0.5250000
NODE_2265_length_1510_cov_24.184975	487	567	0	10	80	0.1250000
NODE_2265_length_1510_cov_24.184975	487	567	4	70	80	0.8750000
NODE_2265_length_1510_cov_24.184975	563	643	0	80	80	1.0000000
NODE_2265_length_1510_cov_24.184975	616	696	0	80	80	1.0000000
NODE_2269_length_1509_cov_51.836170	655	735	0	80	80	1.0000000
NODE_2269_length_1509_cov_51.836170	708	788	0	80	80	1.0000000
NODE_2269_length_1509_cov_51.836170	784	864	0	80	80	1.0000000
NODE_2269_length_1509_cov_51.836170	837	917	0	80	80	1.0000000
NODE_2270_length_1509_cov_16.010638	497	577	0	49	80	0.6125000
NODE_2270_length_1509_cov_16.010638	497	577	4	31	80	0.3875000
NODE_2270_length_1509_cov_16.010638	550	630	4	80	80	1.0000000
NODE_2270_length_1509_cov_16.010638	626	706	0	34	80	0.4250000
NODE_2270_length_1509_cov_16.010638	626	706	4	46	80	0.5750000
NODE_2270_length_1509_cov_16.010638	679	759	0	80	80	1.0000000
NODE_2271_length_1509_cov_8.883688	252	332	0	80	80	1.0000000
NODE_2271_length_1509_cov_8.883688	305	385	0	30	80	0.3750000
NODE_2271_length_1509_cov_8.883688	305	385	2	50	80	0.6250000
NODE_2271_length_1509_cov_8.883688	327	385	0	8	58	0.1379310
NODE_2271_length_1509_cov_8.883688	327	385	2	50	58	0.8620690
NODE_2271_length_1509_cov_8.883688	381	461	2	7	80	0.0875000
NODE_2271_length_1509_cov_8.883688	381	461	4	57	80	0.7125000
NODE_2271_length_1509_cov_8.883688	381	461	6	16	80	0.2000000
NODE_2271_length_1509_cov_8.883688	434	514	0	20	80	0.2500000
NODE_2271_length_1509_cov_8.883688	434	514	4	60	80	0.7500000
NODE_2272_length_1509_cov_5.826950	1029	1109	0	35	80	0.4375000
NODE_2272_length_1509_cov_5.826950	1029	1109	2	45	80	0.5625000
NODE_2272_length_1509_cov_5.826950	1082	1162	0	28	80	0.3500000
NODE_2272_length_1509_cov_5.826950	1082	1162	2	52	80	0.6500000
NODE_2277_length_1508_cov_24.176011	765	845	0	80	80	1.0000000
NODE_2277_length_1508_cov_24.176011	818	898	0	80	80	1.0000000
NODE_2290_length_1504_cov_17.449822	596	676	0	80	80	1.0000000
NODE_2290_length_1504_cov_17.449822	649	729	0	80	80	1.0000000
NODE_2293_length_1502_cov_42.989309	559	639	0	44	80	0.5500000
NODE_2293_length_1502_cov_42.989309	559	639	2	36	80	0.4500000
NODE_2293_length_1502_cov_42.989309	612	692	0	3	80	0.0375000
NODE_2293_length_1502_cov_42.989309	612	692	2	77	80	0.9625000
NODE_2294_length_1501_cov_22.828816	421	500	0	48	79	0.6075949
NODE_2294_length_1501_cov_22.828816	421	500	2	1	79	0.0126582
NODE_2294_length_1501_cov_22.828816	421	500	3	24	79	0.3037975
NODE_2294_length_1501_cov_22.828816	421	500	4	6	79	0.0759494
NODE_2294_length_1501_cov_22.828816	473	553	3	21	80	0.2625000
NODE_2294_length_1501_cov_22.828816	473	553	4	9	80	0.1125000
NODE_2294_length_1501_cov_22.828816	473	553	10	50	80	0.6250000
NODE_2294_length_1501_cov_22.828816	549	629	2	42	80	0.5250000
NODE_2294_length_1501_cov_22.828816	549	629	6	11	80	0.1375000
NODE_2294_length_1501_cov_22.828816	549	629	8	5	80	0.0625000
NODE_2294_length_1501_cov_22.828816	549	629	10	22	80	0.2750000
NODE_2294_length_1501_cov_22.828816	602	682	2	80	80	1.0000000
NODE_2295_length_1501_cov_14.422254	973	1053	0	80	80	1.0000000
NODE_2295_length_1501_cov_14.422254	1026	1106	0	80	80	1.0000000
NODE_2296_length_1501_cov_14.060628	225	305	0	80	80	1.0000000
NODE_2296_length_1501_cov_14.060628	278	358	0	80	80	1.0000000
NODE_2296_length_1501_cov_14.060628	986	1066	0	80	80	1.0000000
NODE_2296_length_1501_cov_14.060628	1039	1119	0	80	80	1.0000000
NODE_2300_length_1500_cov_40.056388	619	699	0	80	80	1.0000000
NODE_2300_length_1500_cov_40.056388	672	752	0	80	80	1.0000000
NODE_2305_length_1497_cov_38.344063	1401	1481	99	1	80	0.0125000
NODE_2305_length_1497_cov_38.344063	1401	1481	103	2	80	0.0250000
NODE_2305_length_1497_cov_38.344063	1401	1481	104	2	80	0.0250000
NODE_2305_length_1497_cov_38.344063	1401	1481	110	1	80	0.0125000
NODE_2305_length_1497_cov_38.344063	1401	1481	114	1	80	0.0125000
NODE_2305_length_1497_cov_38.344063	1401	1481	119	1	80	0.0125000
NODE_2305_length_1497_cov_38.344063	1401	1481	120	1	80	0.0125000
NODE_2305_length_1497_cov_38.344063	1401	1481	124	2	80	0.0250000
NODE_2305_length_1497_cov_38.344063	1401	1481	127	2	80	0.0250000
NODE_2305_length_1497_cov_38.344063	1401	1481	128	3	80	0.0375000
NODE_2305_length_1497_cov_38.344063	1401	1481	130	3	80	0.0375000
NODE_2305_length_1497_cov_38.344063	1401	1481	132	3	80	0.0375000
NODE_2305_length_1497_cov_38.344063	1401	1481	134	3	80	0.0375000
NODE_2305_length_1497_cov_38.344063	1401	1481	135	2	80	0.0250000
NODE_2305_length_1497_cov_38.344063	1401	1481	138	13	80	0.1625000
NODE_2305_length_1497_cov_38.344063	1401	1481	146	2	80	0.0250000
NODE_2305_length_1497_cov_38.344063	1401	1481	148	3	80	0.0375000
NODE_2305_length_1497_cov_38.344063	1401	1481	149	2	80	0.0250000
NODE_2305_length_1497_cov_38.344063	1401	1481	151	5	80	0.0625000
NODE_2305_length_1497_cov_38.344063	1401	1481	152	5	80	0.0625000
NODE_2305_length_1497_cov_38.344063	1401	1481	153	3	80	0.0375000
NODE_2305_length_1497_cov_38.344063	1401	1481	154	1	80	0.0125000
NODE_2305_length_1497_cov_38.344063	1401	1481	158	1	80	0.0125000
NODE_2305_length_1497_cov_38.344063	1401	1481	160	1	80	0.0125000
NODE_2305_length_1497_cov_38.344063	1401	1481	165	2	80	0.0250000
NODE_2305_length_1497_cov_38.344063	1401	1481	167	2	80	0.0250000
NODE_2305_length_1497_cov_38.344063	1401	1481	169	2	80	0.0250000
NODE_2305_length_1497_cov_38.344063	1401	1481	174	1	80	0.0125000
NODE_2305_length_1497_cov_38.344063	1401	1481	176	2	80	0.0250000
NODE_2305_length_1497_cov_38.344063	1401	1481	177	4	80	0.0500000
NODE_2305_length_1497_cov_38.344063	1401	1481	179	1	80	0.0125000
NODE_2305_length_1497_cov_38.344063	1401	1481	187	2	80	0.0250000
NODE_2305_length_1497_cov_38.344063	1401	1481	188	1	80	0.0125000
NODE_2308_length_1496_cov_3.936292	0	44	0	44	44	1.0000000
NODE_2308_length_1496_cov_3.936292	17	97	0	80	80	1.0000000
NODE_2311_length_1496_cov_1.103794	405	428	8	10	23	0.4347826
NODE_2311_length_1496_cov_1.103794	405	428	10	13	23	0.5652174
NODE_2313_length_1494_cov_65.437276	460	540	0	73	80	0.9125000
NODE_2313_length_1494_cov_65.437276	460	540	2	7	80	0.0875000
NODE_2313_length_1494_cov_65.437276	513	594	0	81	81	1.0000000
NODE_2313_length_1494_cov_65.437276	787	854	0	62	67	0.9253731
NODE_2313_length_1494_cov_65.437276	787	854	2	5	67	0.0746269
NODE_2313_length_1494_cov_65.437276	827	907	0	22	80	0.2750000
NODE_2313_length_1494_cov_65.437276	827	907	2	58	80	0.7250000
NODE_2316_length_1493_cov_100.467719	947	1028	218	1	81	0.0123457
NODE_2316_length_1493_cov_100.467719	947	1028	220	1	81	0.0123457
NODE_2316_length_1493_cov_100.467719	947	1028	221	2	81	0.0246914
NODE_2316_length_1493_cov_100.467719	947	1028	235	1	81	0.0123457
NODE_2316_length_1493_cov_100.467719	947	1028	238	3	81	0.0370370
NODE_2316_length_1493_cov_100.467719	947	1028	240	1	81	0.0123457
NODE_2316_length_1493_cov_100.467719	947	1028	242	1	81	0.0123457
NODE_2316_length_1493_cov_100.467719	947	1028	243	1	81	0.0123457
NODE_2316_length_1493_cov_100.467719	947	1028	255	1	81	0.0123457
NODE_2316_length_1493_cov_100.467719	947	1028	259	1	81	0.0123457
NODE_2316_length_1493_cov_100.467719	947	1028	263	1	81	0.0123457
NODE_2316_length_1493_cov_100.467719	947	1028	265	1	81	0.0123457
NODE_2316_length_1493_cov_100.467719	947	1028	267	1	81	0.0123457
NODE_2316_length_1493_cov_100.467719	947	1028	281	1	81	0.0123457
NODE_2316_length_1493_cov_100.467719	947	1028	282	1	81	0.0123457
NODE_2316_length_1493_cov_100.467719	947	1028	283	3	81	0.0370370
NODE_2316_length_1493_cov_100.467719	947	1028	289	1	81	0.0123457
NODE_2316_length_1493_cov_100.467719	947	1028	290	1	81	0.0123457
NODE_2316_length_1493_cov_100.467719	947	1028	293	1	81	0.0123457
NODE_2316_length_1493_cov_100.467719	947	1028	295	1	81	0.0123457
NODE_2316_length_1493_cov_100.467719	947	1028	299	1	81	0.0123457
NODE_2316_length_1493_cov_100.467719	947	1028	300	1	81	0.0123457
NODE_2316_length_1493_cov_100.467719	947	1028	303	1	81	0.0123457
NODE_2316_length_1493_cov_100.467719	947	1028	306	1	81	0.0123457
NODE_2316_length_1493_cov_100.467719	947	1028	309	1	81	0.0123457
NODE_2316_length_1493_cov_100.467719	947	1028	315	1	81	0.0123457
NODE_2316_length_1493_cov_100.467719	947	1028	316	1	81	0.0123457
NODE_2316_length_1493_cov_100.467719	947	1028	324	1	81	0.0123457
NODE_2316_length_1493_cov_100.467719	947	1028	327	1	81	0.0123457
NODE_2316_length_1493_cov_100.467719	947	1028	328	1	81	0.0123457
NODE_2316_length_1493_cov_100.467719	947	1028	331	1	81	0.0123457
NODE_2316_length_1493_cov_100.467719	947	1028	336	2	81	0.0246914
NODE_2316_length_1493_cov_100.467719	947	1028	337	1	81	0.0123457
NODE_2316_length_1493_cov_100.467719	947	1028	339	1	81	0.0123457
NODE_2316_length_1493_cov_100.467719	947	1028	340	1	81	0.0123457
NODE_2316_length_1493_cov_100.467719	947	1028	344	1	81	0.0123457
NODE_2316_length_1493_cov_100.467719	947	1028	349	1	81	0.0123457
NODE_2316_length_1493_cov_100.467719	947	1028	351	1	81	0.0123457
NODE_2316_length_1493_cov_100.467719	947	1028	352	3	81	0.0370370
NODE_2316_length_1493_cov_100.467719	947	1028	363	1	81	0.0123457
NODE_2316_length_1493_cov_100.467719	947	1028	368	2	81	0.0246914
NODE_2316_length_1493_cov_100.467719	947	1028	381	2	81	0.0246914
NODE_2316_length_1493_cov_100.467719	947	1028	382	1	81	0.0123457
NODE_2316_length_1493_cov_100.467719	947	1028	392	2	81	0.0246914
NODE_2316_length_1493_cov_100.467719	947	1028	400	1	81	0.0123457
NODE_2316_length_1493_cov_100.467719	947	1028	403	1	81	0.0123457
NODE_2316_length_1493_cov_100.467719	947	1028	407	1	81	0.0123457
NODE_2316_length_1493_cov_100.467719	947	1028	413	1	81	0.0123457
NODE_2316_length_1493_cov_100.467719	947	1028	414	1	81	0.0123457
NODE_2316_length_1493_cov_100.467719	947	1028	415	1	81	0.0123457
NODE_2316_length_1493_cov_100.467719	947	1028	418	1	81	0.0123457
NODE_2316_length_1493_cov_100.467719	947	1028	421	1	81	0.0123457
NODE_2316_length_1493_cov_100.467719	947	1028	424	1	81	0.0123457
NODE_2316_length_1493_cov_100.467719	947	1028	427	1	81	0.0123457
NODE_2316_length_1493_cov_100.467719	947	1028	432	1	81	0.0123457
NODE_2316_length_1493_cov_100.467719	947	1028	435	1	81	0.0123457
NODE_2316_length_1493_cov_100.467719	947	1028	441	1	81	0.0123457
NODE_2316_length_1493_cov_100.467719	947	1028	448	1	81	0.0123457
NODE_2316_length_1493_cov_100.467719	947	1028	450	1	81	0.0123457
NODE_2316_length_1493_cov_100.467719	947	1028	451	1	81	0.0123457
NODE_2316_length_1493_cov_100.467719	947	1028	466	2	81	0.0246914
NODE_2316_length_1493_cov_100.467719	947	1028	468	1	81	0.0123457
NODE_2316_length_1493_cov_100.467719	947	1028	472	1	81	0.0123457
NODE_2316_length_1493_cov_100.467719	947	1028	474	1	81	0.0123457
NODE_2316_length_1493_cov_100.467719	947	1028	488	1	81	0.0123457
NODE_2316_length_1493_cov_100.467719	947	1028	504	1	81	0.0123457
NODE_2316_length_1493_cov_100.467719	947	1028	513	1	81	0.0123457
NODE_2316_length_1493_cov_100.467719	947	1028	515	1	81	0.0123457
NODE_2316_length_1493_cov_100.467719	947	1028	516	1	81	0.0123457
NODE_2316_length_1493_cov_100.467719	1001	1071	392	1	70	0.0142857
NODE_2316_length_1493_cov_100.467719	1001	1071	400	1	70	0.0142857
NODE_2316_length_1493_cov_100.467719	1001	1071	403	1	70	0.0142857
NODE_2316_length_1493_cov_100.467719	1001	1071	407	1	70	0.0142857
NODE_2316_length_1493_cov_100.467719	1001	1071	413	1	70	0.0142857
NODE_2316_length_1493_cov_100.467719	1001	1071	414	1	70	0.0142857
NODE_2316_length_1493_cov_100.467719	1001	1071	415	1	70	0.0142857
NODE_2316_length_1493_cov_100.467719	1001	1071	418	1	70	0.0142857
NODE_2316_length_1493_cov_100.467719	1001	1071	421	1	70	0.0142857
NODE_2316_length_1493_cov_100.467719	1001	1071	424	1	70	0.0142857
NODE_2316_length_1493_cov_100.467719	1001	1071	427	1	70	0.0142857
NODE_2316_length_1493_cov_100.467719	1001	1071	432	1	70	0.0142857
NODE_2316_length_1493_cov_100.467719	1001	1071	435	1	70	0.0142857
NODE_2316_length_1493_cov_100.467719	1001	1071	441	1	70	0.0142857
NODE_2316_length_1493_cov_100.467719	1001	1071	448	1	70	0.0142857
NODE_2316_length_1493_cov_100.467719	1001	1071	450	1	70	0.0142857
NODE_2316_length_1493_cov_100.467719	1001	1071	451	1	70	0.0142857
NODE_2316_length_1493_cov_100.467719	1001	1071	466	2	70	0.0285714
NODE_2316_length_1493_cov_100.467719	1001	1071	468	1	70	0.0142857
NODE_2316_length_1493_cov_100.467719	1001	1071	472	1	70	0.0142857
NODE_2316_length_1493_cov_100.467719	1001	1071	474	1	70	0.0142857
NODE_2316_length_1493_cov_100.467719	1001	1071	488	1	70	0.0142857
NODE_2316_length_1493_cov_100.467719	1001	1071	504	1	70	0.0142857
NODE_2316_length_1493_cov_100.467719	1001	1071	511	1	70	0.0142857
NODE_2316_length_1493_cov_100.467719	1001	1071	513	1	70	0.0142857
NODE_2316_length_1493_cov_100.467719	1001	1071	515	1	70	0.0142857
NODE_2316_length_1493_cov_100.467719	1001	1071	516	1	70	0.0142857
NODE_2316_length_1493_cov_100.467719	1001	1071	529	1	70	0.0142857
NODE_2316_length_1493_cov_100.467719	1001	1071	547	1	70	0.0142857
NODE_2316_length_1493_cov_100.467719	1001	1071	552	1	70	0.0142857
NODE_2316_length_1493_cov_100.467719	1001	1071	553	1	70	0.0142857
NODE_2316_length_1493_cov_100.467719	1001	1071	560	2	70	0.0285714
NODE_2316_length_1493_cov_100.467719	1001	1071	565	1	70	0.0142857
NODE_2316_length_1493_cov_100.467719	1001	1071	572	1	70	0.0142857
NODE_2316_length_1493_cov_100.467719	1001	1071	581	1	70	0.0142857
NODE_2316_length_1493_cov_100.467719	1001	1071	588	1	70	0.0142857
NODE_2316_length_1493_cov_100.467719	1001	1071	590	1	70	0.0142857
NODE_2316_length_1493_cov_100.467719	1001	1071	591	1	70	0.0142857
NODE_2316_length_1493_cov_100.467719	1001	1071	592	1	70	0.0142857
NODE_2316_length_1493_cov_100.467719	1001	1071	594	1	70	0.0142857
NODE_2316_length_1493_cov_100.467719	1001	1071	600	1	70	0.0142857
NODE_2316_length_1493_cov_100.467719	1001	1071	617	1	70	0.0142857
NODE_2316_length_1493_cov_100.467719	1001	1071	633	1	70	0.0142857
NODE_2316_length_1493_cov_100.467719	1001	1071	638	1	70	0.0142857
NODE_2316_length_1493_cov_100.467719	1001	1071	658	1	70	0.0142857
NODE_2316_length_1493_cov_100.467719	1001	1071	683	1	70	0.0142857
NODE_2316_length_1493_cov_100.467719	1001	1071	700	1	70	0.0142857
NODE_2316_length_1493_cov_100.467719	1001	1071	706	1	70	0.0142857
NODE_2316_length_1493_cov_100.467719	1001	1071	725	1	70	0.0142857
NODE_2316_length_1493_cov_100.467719	1001	1071	726	1	70	0.0142857
NODE_2316_length_1493_cov_100.467719	1001	1071	727	1	70	0.0142857
NODE_2316_length_1493_cov_100.467719	1001	1071	729	1	70	0.0142857
NODE_2316_length_1493_cov_100.467719	1001	1071	730	1	70	0.0142857
NODE_2316_length_1493_cov_100.467719	1001	1071	731	1	70	0.0142857
NODE_2316_length_1493_cov_100.467719	1001	1071	733	2	70	0.0285714
NODE_2316_length_1493_cov_100.467719	1001	1071	736	1	70	0.0142857
NODE_2316_length_1493_cov_100.467719	1001	1071	741	1	70	0.0142857
NODE_2316_length_1493_cov_100.467719	1001	1071	754	1	70	0.0142857
NODE_2316_length_1493_cov_100.467719	1001	1071	756	1	70	0.0142857
NODE_2316_length_1493_cov_100.467719	1001	1071	773	1	70	0.0142857
NODE_2316_length_1493_cov_100.467719	1001	1071	786	2	70	0.0285714
NODE_2316_length_1493_cov_100.467719	1001	1071	791	1	70	0.0142857
NODE_2316_length_1493_cov_100.467719	1001	1071	792	1	70	0.0142857
NODE_2316_length_1493_cov_100.467719	1001	1071	794	1	70	0.0142857
NODE_2316_length_1493_cov_100.467719	1001	1071	795	1	70	0.0142857
NODE_2316_length_1493_cov_100.467719	1001	1071	796	1	70	0.0142857
NODE_2316_length_1493_cov_100.467719	1077	1157	814	1	80	0.0125000
NODE_2316_length_1493_cov_100.467719	1077	1157	822	1	80	0.0125000
NODE_2316_length_1493_cov_100.467719	1077	1157	827	1	80	0.0125000
NODE_2316_length_1493_cov_100.467719	1077	1157	836	1	80	0.0125000
NODE_2316_length_1493_cov_100.467719	1077	1157	858	1	80	0.0125000
NODE_2316_length_1493_cov_100.467719	1077	1157	881	1	80	0.0125000
NODE_2316_length_1493_cov_100.467719	1077	1157	910	1	80	0.0125000
NODE_2316_length_1493_cov_100.467719	1077	1157	917	2	80	0.0250000
NODE_2316_length_1493_cov_100.467719	1077	1157	936	1	80	0.0125000
NODE_2316_length_1493_cov_100.467719	1077	1157	939	1	80	0.0125000
NODE_2316_length_1493_cov_100.467719	1077	1157	942	1	80	0.0125000
NODE_2316_length_1493_cov_100.467719	1077	1157	948	2	80	0.0250000
NODE_2316_length_1493_cov_100.467719	1077	1157	954	1	80	0.0125000
NODE_2316_length_1493_cov_100.467719	1077	1157	964	1	80	0.0125000
NODE_2316_length_1493_cov_100.467719	1077	1157	980	1	80	0.0125000
NODE_2316_length_1493_cov_100.467719	1077	1157	985	2	80	0.0250000
NODE_2316_length_1493_cov_100.467719	1077	1157	986	1	80	0.0125000
NODE_2316_length_1493_cov_100.467719	1077	1157	989	1	80	0.0125000
NODE_2316_length_1493_cov_100.467719	1077	1157	996	1	80	0.0125000
NODE_2316_length_1493_cov_100.467719	1077	1157	1009	1	80	0.0125000
NODE_2316_length_1493_cov_100.467719	1077	1157	1023	1	80	0.0125000
NODE_2316_length_1493_cov_100.467719	1077	1157	1026	1	80	0.0125000
NODE_2316_length_1493_cov_100.467719	1077	1157	1036	1	80	0.0125000
NODE_2316_length_1493_cov_100.467719	1077	1157	1042	1	80	0.0125000
NODE_2316_length_1493_cov_100.467719	1077	1157	1065	1	80	0.0125000
NODE_2316_length_1493_cov_100.467719	1077	1157	1067	1	80	0.0125000
NODE_2316_length_1493_cov_100.467719	1077	1157	1076	1	80	0.0125000
NODE_2316_length_1493_cov_100.467719	1077	1157	1078	1	80	0.0125000
NODE_2316_length_1493_cov_100.467719	1077	1157	1084	1	80	0.0125000
NODE_2316_length_1493_cov_100.467719	1077	1157	1090	1	80	0.0125000
NODE_2316_length_1493_cov_100.467719	1077	1157	1100	1	80	0.0125000
NODE_2316_length_1493_cov_100.467719	1077	1157	1101	1	80	0.0125000
NODE_2316_length_1493_cov_100.467719	1077	1157	1102	1	80	0.0125000
NODE_2316_length_1493_cov_100.467719	1077	1157	1103	1	80	0.0125000
NODE_2316_length_1493_cov_100.467719	1077	1157	1105	2	80	0.0250000
NODE_2316_length_1493_cov_100.467719	1077	1157	1131	1	80	0.0125000
NODE_2316_length_1493_cov_100.467719	1077	1157	1153	2	80	0.0250000
NODE_2316_length_1493_cov_100.467719	1077	1157	1155	1	80	0.0125000
NODE_2316_length_1493_cov_100.467719	1077	1157	1157	1	80	0.0125000
NODE_2316_length_1493_cov_100.467719	1077	1157	1160	1	80	0.0125000
NODE_2316_length_1493_cov_100.467719	1077	1157	1163	1	80	0.0125000
NODE_2316_length_1493_cov_100.467719	1077	1157	1168	1	80	0.0125000
NODE_2316_length_1493_cov_100.467719	1077	1157	1170	1	80	0.0125000
NODE_2316_length_1493_cov_100.467719	1077	1157	1178	1	80	0.0125000
NODE_2316_length_1493_cov_100.467719	1077	1157	1195	1	80	0.0125000
NODE_2316_length_1493_cov_100.467719	1077	1157	1199	1	80	0.0125000
NODE_2316_length_1493_cov_100.467719	1077	1157	1227	1	80	0.0125000
NODE_2316_length_1493_cov_100.467719	1077	1157	1236	1	80	0.0125000
NODE_2316_length_1493_cov_100.467719	1077	1157	1246	1	80	0.0125000
NODE_2316_length_1493_cov_100.467719	1077	1157	1262	1	80	0.0125000
NODE_2316_length_1493_cov_100.467719	1077	1157	1265	1	80	0.0125000
NODE_2316_length_1493_cov_100.467719	1077	1157	1266	1	80	0.0125000
NODE_2316_length_1493_cov_100.467719	1077	1157	1275	1	80	0.0125000
NODE_2316_length_1493_cov_100.467719	1077	1157	1284	1	80	0.0125000
NODE_2316_length_1493_cov_100.467719	1077	1157	1291	2	80	0.0250000
NODE_2316_length_1493_cov_100.467719	1077	1157	1292	1	80	0.0125000
NODE_2316_length_1493_cov_100.467719	1077	1157	1299	1	80	0.0125000
NODE_2316_length_1493_cov_100.467719	1077	1157	1316	1	80	0.0125000
NODE_2316_length_1493_cov_100.467719	1077	1157	1318	2	80	0.0250000
NODE_2316_length_1493_cov_100.467719	1077	1157	1328	1	80	0.0125000
NODE_2316_length_1493_cov_100.467719	1077	1157	1339	1	80	0.0125000
NODE_2316_length_1493_cov_100.467719	1077	1157	1340	1	80	0.0125000
NODE_2316_length_1493_cov_100.467719	1077	1157	1343	1	80	0.0125000
NODE_2316_length_1493_cov_100.467719	1077	1157	1347	1	80	0.0125000
NODE_2316_length_1493_cov_100.467719	1077	1157	1354	1	80	0.0125000
NODE_2316_length_1493_cov_100.467719	1077	1157	1361	1	80	0.0125000
NODE_2316_length_1493_cov_100.467719	1077	1157	1362	1	80	0.0125000
NODE_2316_length_1493_cov_100.467719	1077	1157	1365	2	80	0.0250000
NODE_2316_length_1493_cov_100.467719	1077	1157	1371	1	80	0.0125000
NODE_2316_length_1493_cov_100.467719	1077	1157	1379	1	80	0.0125000
NODE_2316_length_1493_cov_100.467719	1077	1157	1382	1	80	0.0125000
NODE_2316_length_1493_cov_100.467719	1077	1157	1383	1	80	0.0125000
NODE_2316_length_1493_cov_100.467719	1130	1210	1216	1	80	0.0125000
NODE_2316_length_1493_cov_100.467719	1130	1210	1246	1	80	0.0125000
NODE_2316_length_1493_cov_100.467719	1130	1210	1255	1	80	0.0125000
NODE_2316_length_1493_cov_100.467719	1130	1210	1262	3	80	0.0375000
NODE_2316_length_1493_cov_100.467719	1130	1210	1265	1	80	0.0125000
NODE_2316_length_1493_cov_100.467719	1130	1210	1266	2	80	0.0250000
NODE_2316_length_1493_cov_100.467719	1130	1210	1267	1	80	0.0125000
NODE_2316_length_1493_cov_100.467719	1130	1210	1272	1	80	0.0125000
NODE_2316_length_1493_cov_100.467719	1130	1210	1275	2	80	0.0250000
NODE_2316_length_1493_cov_100.467719	1130	1210	1282	1	80	0.0125000
NODE_2316_length_1493_cov_100.467719	1130	1210	1283	1	80	0.0125000
NODE_2316_length_1493_cov_100.467719	1130	1210	1284	2	80	0.0250000
NODE_2316_length_1493_cov_100.467719	1130	1210	1291	2	80	0.0250000
NODE_2316_length_1493_cov_100.467719	1130	1210	1292	1	80	0.0125000
NODE_2316_length_1493_cov_100.467719	1130	1210	1298	1	80	0.0125000
NODE_2316_length_1493_cov_100.467719	1130	1210	1299	1	80	0.0125000
NODE_2316_length_1493_cov_100.467719	1130	1210	1316	1	80	0.0125000
NODE_2316_length_1493_cov_100.467719	1130	1210	1318	2	80	0.0250000
NODE_2316_length_1493_cov_100.467719	1130	1210	1328	1	80	0.0125000
NODE_2316_length_1493_cov_100.467719	1130	1210	1339	1	80	0.0125000
NODE_2316_length_1493_cov_100.467719	1130	1210	1340	2	80	0.0250000
NODE_2316_length_1493_cov_100.467719	1130	1210	1343	1	80	0.0125000
NODE_2316_length_1493_cov_100.467719	1130	1210	1347	1	80	0.0125000
NODE_2316_length_1493_cov_100.467719	1130	1210	1354	2	80	0.0250000
NODE_2316_length_1493_cov_100.467719	1130	1210	1356	1	80	0.0125000
NODE_2316_length_1493_cov_100.467719	1130	1210	1360	1	80	0.0125000
NODE_2316_length_1493_cov_100.467719	1130	1210	1361	2	80	0.0250000
NODE_2316_length_1493_cov_100.467719	1130	1210	1362	1	80	0.0125000
NODE_2316_length_1493_cov_100.467719	1130	1210	1365	3	80	0.0375000
NODE_2316_length_1493_cov_100.467719	1130	1210	1366	2	80	0.0250000
NODE_2316_length_1493_cov_100.467719	1130	1210	1367	1	80	0.0125000
NODE_2316_length_1493_cov_100.467719	1130	1210	1368	1	80	0.0125000
NODE_2316_length_1493_cov_100.467719	1130	1210	1369	1	80	0.0125000
NODE_2316_length_1493_cov_100.467719	1130	1210	1371	1	80	0.0125000
NODE_2316_length_1493_cov_100.467719	1130	1210	1377	1	80	0.0125000
NODE_2316_length_1493_cov_100.467719	1130	1210	1379	2	80	0.0250000
NODE_2316_length_1493_cov_100.467719	1130	1210	1382	1	80	0.0125000
NODE_2316_length_1493_cov_100.467719	1130	1210	1383	3	80	0.0375000
NODE_2316_length_1493_cov_100.467719	1130	1210	1385	2	80	0.0250000
NODE_2316_length_1493_cov_100.467719	1130	1210	1386	1	80	0.0125000
NODE_2316_length_1493_cov_100.467719	1130	1210	1393	3	80	0.0375000
NODE_2316_length_1493_cov_100.467719	1130	1210	1395	1	80	0.0125000
NODE_2316_length_1493_cov_100.467719	1130	1210	1396	1	80	0.0125000
NODE_2316_length_1493_cov_100.467719	1130	1210	1399	1	80	0.0125000
NODE_2316_length_1493_cov_100.467719	1130	1210	1401	1	80	0.0125000
NODE_2316_length_1493_cov_100.467719	1130	1210	1402	1	80	0.0125000
NODE_2316_length_1493_cov_100.467719	1130	1210	1403	1	80	0.0125000
NODE_2316_length_1493_cov_100.467719	1130	1210	1404	1	80	0.0125000
NODE_2316_length_1493_cov_100.467719	1130	1210	1421	2	80	0.0250000
NODE_2316_length_1493_cov_100.467719	1130	1210	1424	1	80	0.0125000
NODE_2316_length_1493_cov_100.467719	1130	1210	1428	1	80	0.0125000
NODE_2316_length_1493_cov_100.467719	1130	1210	1431	1	80	0.0125000
NODE_2316_length_1493_cov_100.467719	1130	1210	1433	1	80	0.0125000
NODE_2316_length_1493_cov_100.467719	1130	1210	1444	1	80	0.0125000
NODE_2316_length_1493_cov_100.467719	1130	1210	1445	1	80	0.0125000
NODE_2316_length_1493_cov_100.467719	1130	1210	1448	2	80	0.0250000
NODE_2316_length_1493_cov_100.467719	1130	1210	1458	1	80	0.0125000
NODE_2316_length_1493_cov_100.467719	1130	1210	1460	1	80	0.0125000
NODE_2316_length_1493_cov_100.467719	1130	1210	1469	1	80	0.0125000
NODE_2321_length_1493_cov_1.138451	1341	1420	2	19	79	0.2405063
NODE_2321_length_1493_cov_1.138451	1341	1420	4	19	79	0.2405063
NODE_2321_length_1493_cov_1.138451	1341	1420	6	5	79	0.0632911
NODE_2321_length_1493_cov_1.138451	1341	1420	10	36	79	0.4556962
NODE_2321_length_1493_cov_1.138451	1341	1420	2	19	79	0.2405063
NODE_2321_length_1493_cov_1.138451	1341	1420	4	19	79	0.2405063
NODE_2321_length_1493_cov_1.138451	1341	1420	6	5	79	0.0632911
NODE_2321_length_1493_cov_1.138451	1341	1420	10	36	79	0.4556962
NODE_2321_length_1493_cov_1.138451	1393	1459	6	2	66	0.0303030
NODE_2321_length_1493_cov_1.138451	1393	1459	8	19	66	0.2878788
NODE_2321_length_1493_cov_1.138451	1393	1459	10	45	66	0.6818182
NODE_2332_length_1490_cov_5.726096	233	295	6	58	62	0.9354839
NODE_2332_length_1490_cov_5.726096	233	295	7	1	62	0.0161290
NODE_2332_length_1490_cov_5.726096	233	295	8	3	62	0.0483871
NODE_2332_length_1490_cov_5.726096	1065	1149	0	84	84	1.0000000
NODE_2333_length_1490_cov_4.687275	318	399	0	81	81	1.0000000
NODE_2333_length_1490_cov_4.687275	372	452	0	80	80	1.0000000
NODE_2338_length_1488_cov_3.734341	1141	1221	0	80	80	1.0000000
NODE_2340_length_1487_cov_19.332133	673	753	0	80	80	1.0000000
NODE_2340_length_1487_cov_19.332133	726	806	0	80	80	1.0000000
NODE_2348_length_1484_cov_38.342960	706	786	0	80	80	1.0000000
NODE_2348_length_1484_cov_38.342960	759	839	0	80	80	1.0000000
NODE_2349_length_1484_cov_21.260650	348	428	0	80	80	1.0000000
NODE_2349_length_1484_cov_21.260650	401	481	0	80	80	1.0000000
NODE_2349_length_1484_cov_21.260650	978	1058	0	27	80	0.3375000
NODE_2349_length_1484_cov_21.260650	978	1058	2	53	80	0.6625000
NODE_2349_length_1484_cov_21.260650	1031	1111	0	15	80	0.1875000
NODE_2349_length_1484_cov_21.260650	1031	1111	2	65	80	0.8125000
NODE_2350_length_1484_cov_19.243321	952	1032	2	31	80	0.3875000
NODE_2350_length_1484_cov_19.243321	952	1032	4	49	80	0.6125000
NODE_2350_length_1484_cov_19.243321	1005	1085	0	11	80	0.1375000
NODE_2350_length_1484_cov_19.243321	1005	1085	2	53	80	0.6625000
NODE_2350_length_1484_cov_19.243321	1005	1085	4	16	80	0.2000000
NODE_2351_length_1484_cov_9.085199	314	394	0	80	80	1.0000000
NODE_2351_length_1484_cov_9.085199	367	447	0	43	80	0.5375000
NODE_2351_length_1484_cov_9.085199	367	447	2	37	80	0.4625000
NODE_2353_length_1483_cov_21.207370	555	635	2	52	80	0.6500000
NODE_2353_length_1483_cov_21.207370	555	635	4	28	80	0.3500000
NODE_2353_length_1483_cov_21.207370	608	688	4	80	80	1.0000000
NODE_2359_length_1482_cov_20.177874	430	510	0	28	80	0.3500000
NODE_2359_length_1482_cov_20.177874	430	510	2	48	80	0.6000000
NODE_2359_length_1482_cov_20.177874	430	510	4	4	80	0.0500000
NODE_2359_length_1482_cov_20.177874	483	563	2	37	80	0.4625000
NODE_2359_length_1482_cov_20.177874	483	563	4	43	80	0.5375000
NODE_2359_length_1482_cov_20.177874	559	639	0	53	80	0.6625000
NODE_2359_length_1482_cov_20.177874	559	639	2	27	80	0.3375000
NODE_2359_length_1482_cov_20.177874	612	692	0	80	80	1.0000000
NODE_2360_length_1482_cov_13.644252	1000	1080	0	30	80	0.3750000
NODE_2360_length_1482_cov_13.644252	1000	1080	4	50	80	0.6250000
NODE_2360_length_1482_cov_13.644252	1053	1133	0	26	80	0.3250000
NODE_2360_length_1482_cov_13.644252	1053	1133	4	54	80	0.6750000
NODE_2361_length_1482_cov_6.157628	525	605	0	80	80	1.0000000
NODE_2361_length_1482_cov_6.157628	578	658	0	80	80	1.0000000
NODE_2361_length_1482_cov_6.157628	1306	1388	30	2	82	0.0243902
NODE_2361_length_1482_cov_6.157628	1306	1388	34	1	82	0.0121951
NODE_2361_length_1482_cov_6.157628	1306	1388	36	2	82	0.0243902
NODE_2361_length_1482_cov_6.157628	1306	1388	38	1	82	0.0121951
NODE_2361_length_1482_cov_6.157628	1306	1388	40	4	82	0.0487805
NODE_2361_length_1482_cov_6.157628	1306	1388	42	3	82	0.0365854
NODE_2361_length_1482_cov_6.157628	1306	1388	43	1	82	0.0121951
NODE_2361_length_1482_cov_6.157628	1306	1388	44	3	82	0.0365854
NODE_2361_length_1482_cov_6.157628	1306	1388	46	8	82	0.0975610
NODE_2361_length_1482_cov_6.157628	1306	1388	50	7	82	0.0853659
NODE_2361_length_1482_cov_6.157628	1306	1388	54	20	82	0.2439024
NODE_2361_length_1482_cov_6.157628	1306	1388	56	20	82	0.2439024
NODE_2361_length_1482_cov_6.157628	1306	1388	58	10	82	0.1219512
NODE_2364_length_1481_cov_19.238784	480	560	0	80	80	1.0000000
NODE_2364_length_1481_cov_19.238784	533	613	0	80	80	1.0000000
NODE_2365_length_1481_cov_18.139653	706	786	0	14	80	0.1750000
NODE_2365_length_1481_cov_18.139653	706	786	2	27	80	0.3375000
NODE_2365_length_1481_cov_18.139653	706	786	6	39	80	0.4875000
NODE_2365_length_1481_cov_18.139653	759	839	4	22	80	0.2750000
NODE_2365_length_1481_cov_18.139653	759	839	6	58	80	0.7250000
NODE_2367_length_1480_cov_27.552498	762	842	0	63	80	0.7875000
NODE_2367_length_1480_cov_27.552498	762	842	4	17	80	0.2125000
NODE_2367_length_1480_cov_27.552498	815	895	0	10	80	0.1250000
NODE_2367_length_1480_cov_27.552498	815	895	4	70	80	0.8750000
NODE_2367_length_1480_cov_27.552498	891	971	0	2	80	0.0250000
NODE_2367_length_1480_cov_27.552498	891	971	4	78	80	0.9750000
NODE_2367_length_1480_cov_27.552498	944	1024	0	55	80	0.6875000
NODE_2367_length_1480_cov_27.552498	944	1024	4	25	80	0.3125000
NODE_2367_length_1480_cov_27.552498	1171	1222	5	4	51	0.0784314
NODE_2367_length_1480_cov_27.552498	1171	1222	7	7	51	0.1372549
NODE_2367_length_1480_cov_27.552498	1171	1222	9	3	51	0.0588235
NODE_2367_length_1480_cov_27.552498	1171	1222	11	4	51	0.0784314
NODE_2367_length_1480_cov_27.552498	1171	1222	13	5	51	0.0980392
NODE_2367_length_1480_cov_27.552498	1171	1222	17	2	51	0.0392157
NODE_2367_length_1480_cov_27.552498	1171	1222	19	3	51	0.0588235
NODE_2367_length_1480_cov_27.552498	1171	1222	31	1	51	0.0196078
NODE_2367_length_1480_cov_27.552498	1171	1222	35	4	51	0.0784314
NODE_2367_length_1480_cov_27.552498	1171	1222	39	5	51	0.0980392
NODE_2367_length_1480_cov_27.552498	1171	1222	44	2	51	0.0392157
NODE_2367_length_1480_cov_27.552498	1171	1222	46	5	51	0.0980392
NODE_2367_length_1480_cov_27.552498	1171	1222	50	3	51	0.0588235
NODE_2367_length_1480_cov_27.552498	1171	1222	52	3	51	0.0588235
NODE_2369_length_1480_cov_12.535844	466	546	0	80	80	1.0000000
NODE_2369_length_1480_cov_12.535844	519	599	0	65	80	0.8125000
NODE_2369_length_1480_cov_12.535844	519	599	2	15	80	0.1875000
NODE_2373_length_1479_cov_17.035507	708	788	0	80	80	1.0000000
NODE_2373_length_1479_cov_17.035507	761	841	0	80	80	1.0000000
NODE_2373_length_1479_cov_17.035507	837	917	0	80	80	1.0000000
NODE_2373_length_1479_cov_17.035507	890	970	0	80	80	1.0000000
NODE_2374_length_1479_cov_16.448551	908	988	2	80	80	1.0000000
NODE_2374_length_1479_cov_16.448551	961	1041	0	4	80	0.0500000
NODE_2374_length_1479_cov_16.448551	961	1041	1	1	80	0.0125000
NODE_2374_length_1479_cov_16.448551	961	1041	2	75	80	0.9375000
NODE_2375_length_1479_cov_5.285507	123	185	29	3	62	0.0483871
NODE_2375_length_1479_cov_5.285507	123	185	31	3	62	0.0483871
NODE_2375_length_1479_cov_5.285507	123	185	35	5	62	0.0806452
NODE_2375_length_1479_cov_5.285507	123	185	36	4	62	0.0645161
NODE_2375_length_1479_cov_5.285507	123	185	40	1	62	0.0161290
NODE_2375_length_1479_cov_5.285507	123	185	43	3	62	0.0483871
NODE_2375_length_1479_cov_5.285507	123	185	45	2	62	0.0322581
NODE_2375_length_1479_cov_5.285507	123	185	49	1	62	0.0161290
NODE_2375_length_1479_cov_5.285507	123	185	52	1	62	0.0161290
NODE_2375_length_1479_cov_5.285507	123	185	55	3	62	0.0483871
NODE_2375_length_1479_cov_5.285507	123	185	57	1	62	0.0161290
NODE_2375_length_1479_cov_5.285507	123	185	59	1	62	0.0161290
NODE_2375_length_1479_cov_5.285507	123	185	60	2	62	0.0322581
NODE_2375_length_1479_cov_5.285507	123	185	64	1	62	0.0161290
NODE_2375_length_1479_cov_5.285507	123	185	66	1	62	0.0161290
NODE_2375_length_1479_cov_5.285507	123	185	72	2	62	0.0322581
NODE_2375_length_1479_cov_5.285507	123	185	74	2	62	0.0322581
NODE_2375_length_1479_cov_5.285507	123	185	75	1	62	0.0161290
NODE_2375_length_1479_cov_5.285507	123	185	90	2	62	0.0322581
NODE_2375_length_1479_cov_5.285507	123	185	93	1	62	0.0161290
NODE_2375_length_1479_cov_5.285507	123	185	96	4	62	0.0645161
NODE_2375_length_1479_cov_5.285507	123	185	100	5	62	0.0806452
NODE_2375_length_1479_cov_5.285507	123	185	103	3	62	0.0483871
NODE_2375_length_1479_cov_5.285507	123	185	105	1	62	0.0161290
NODE_2375_length_1479_cov_5.285507	123	185	107	2	62	0.0322581
NODE_2375_length_1479_cov_5.285507	123	185	108	4	62	0.0645161
NODE_2375_length_1479_cov_5.285507	123	185	110	1	62	0.0161290
NODE_2375_length_1479_cov_5.285507	123	185	112	2	62	0.0322581
NODE_2376_length_1479_cov_2.018841	881	967	0	74	86	0.8604651
NODE_2376_length_1479_cov_2.018841	881	967	1	9	86	0.1046512
NODE_2376_length_1479_cov_2.018841	881	967	2	3	86	0.0348837
NODE_2377_length_1478_cov_32.050761	411	491	0	80	80	1.0000000
NODE_2377_length_1478_cov_32.050761	464	544	0	75	80	0.9375000
NODE_2377_length_1478_cov_32.050761	464	544	4	5	80	0.0625000
NODE_2377_length_1478_cov_32.050761	540	620	4	80	80	1.0000000
NODE_2377_length_1478_cov_32.050761	593	673	0	12	80	0.1500000
NODE_2377_length_1478_cov_32.050761	593	673	4	68	80	0.8500000
NODE_2378_length_1478_cov_27.414793	817	897	0	58	80	0.7250000
NODE_2378_length_1478_cov_27.414793	817	897	2	22	80	0.2750000
NODE_2378_length_1478_cov_27.414793	870	950	0	5	80	0.0625000
NODE_2378_length_1478_cov_27.414793	870	950	2	75	80	0.9375000
NODE_2379_length_1478_cov_23.472081	1212	1241	95	3	29	0.1034483
NODE_2379_length_1478_cov_23.472081	1212	1241	99	4	29	0.1379310
NODE_2379_length_1478_cov_23.472081	1212	1241	101	3	29	0.1034483
NODE_2379_length_1478_cov_23.472081	1212	1241	102	1	29	0.0344828
NODE_2379_length_1478_cov_23.472081	1212	1241	105	3	29	0.1034483
NODE_2379_length_1478_cov_23.472081	1212	1241	107	3	29	0.1034483
NODE_2379_length_1478_cov_23.472081	1212	1241	109	4	29	0.1379310
NODE_2379_length_1478_cov_23.472081	1212	1241	111	4	29	0.1379310
NODE_2379_length_1478_cov_23.472081	1212	1241	114	4	29	0.1379310
NODE_2380_length_1478_cov_10.746193	678	758	1	44	80	0.5500000
NODE_2380_length_1478_cov_10.746193	678	758	2	36	80	0.4500000
NODE_2380_length_1478_cov_10.746193	731	811	1	19	80	0.2375000
NODE_2380_length_1478_cov_10.746193	731	811	2	61	80	0.7625000
NODE_2380_length_1478_cov_10.746193	807	892	0	20	85	0.2352941
NODE_2380_length_1478_cov_10.746193	807	892	1	65	85	0.7647059
NODE_2380_length_1478_cov_10.746193	860	945	0	73	85	0.8588235
NODE_2380_length_1478_cov_10.746193	860	945	1	12	85	0.1411765
NODE_2384_length_1476_cov_6.522150	791	871	4	80	80	1.0000000
NODE_2384_length_1476_cov_6.522150	844	924	1	15	80	0.1875000
NODE_2384_length_1476_cov_6.522150	844	924	2	12	80	0.1500000
NODE_2384_length_1476_cov_6.522150	844	924	3	5	80	0.0625000
NODE_2384_length_1476_cov_6.522150	844	924	4	48	80	0.6000000
NODE_2392_length_1474_cov_11.209455	515	595	0	80	80	1.0000000
NODE_2392_length_1474_cov_11.209455	568	648	0	80	80	1.0000000
NODE_2397_length_1472_cov_22.159505	428	508	2	15	80	0.1875000
NODE_2397_length_1472_cov_22.159505	428	508	4	13	80	0.1625000
NODE_2397_length_1472_cov_22.159505	428	508	6	9	80	0.1125000
NODE_2397_length_1472_cov_22.159505	428	508	10	28	80	0.3500000
NODE_2397_length_1472_cov_22.159505	428	508	12	15	80	0.1875000
NODE_2397_length_1472_cov_22.159505	428	508	2	15	80	0.1875000
NODE_2397_length_1472_cov_22.159505	428	508	4	13	80	0.1625000
NODE_2397_length_1472_cov_22.159505	428	508	6	9	80	0.1125000
NODE_2397_length_1472_cov_22.159505	428	508	10	28	80	0.3500000
NODE_2397_length_1472_cov_22.159505	428	508	12	15	80	0.1875000
NODE_2397_length_1472_cov_22.159505	481	561	2	52	80	0.6500000
NODE_2397_length_1472_cov_22.159505	481	561	4	12	80	0.1500000
NODE_2397_length_1472_cov_22.159505	481	561	10	1	80	0.0125000
NODE_2397_length_1472_cov_22.159505	481	561	16	10	80	0.1250000
NODE_2397_length_1472_cov_22.159505	481	561	20	1	80	0.0125000
NODE_2397_length_1472_cov_22.159505	481	561	22	4	80	0.0500000
NODE_2397_length_1472_cov_22.159505	913	993	0	80	80	1.0000000
NODE_2397_length_1472_cov_22.159505	966	1046	0	27	80	0.3375000
NODE_2397_length_1472_cov_22.159505	966	1046	2	53	80	0.6625000
NODE_2397_length_1472_cov_22.159505	1042	1122	0	58	80	0.7250000
NODE_2397_length_1472_cov_22.159505	1042	1122	2	22	80	0.2750000
NODE_2397_length_1472_cov_22.159505	1095	1175	0	80	80	1.0000000
NODE_2398_length_1472_cov_22.018208	523	590	0	67	67	1.0000000
NODE_2398_length_1472_cov_22.018208	563	643	0	80	80	1.0000000
NODE_2398_length_1472_cov_22.018208	639	719	0	80	80	1.0000000
NODE_2398_length_1472_cov_22.018208	692	772	0	80	80	1.0000000
NODE_2404_length_1470_cov_7.042305	5	57	9	4	52	0.0769231
NODE_2404_length_1470_cov_7.042305	5	57	11	11	52	0.2115385
NODE_2404_length_1470_cov_7.042305	5	57	13	4	52	0.0769231
NODE_2404_length_1470_cov_7.042305	5	57	16	1	52	0.0192308
NODE_2404_length_1470_cov_7.042305	5	57	21	2	52	0.0384615
NODE_2404_length_1470_cov_7.042305	5	57	22	30	52	0.5769231
NODE_2405_length_1470_cov_2.185266	199	245	4	4	46	0.0869565
NODE_2405_length_1470_cov_2.185266	199	245	6	42	46	0.9130435
NODE_2407_length_1469_cov_5.683942	834	914	0	80	80	1.0000000
NODE_2407_length_1469_cov_5.683942	887	967	0	80	80	1.0000000
NODE_2410_length_1467_cov_31.231725	1048	1131	0	83	83	1.0000000
NODE_2411_length_1467_cov_19.731725	485	565	0	80	80	1.0000000
NODE_2411_length_1467_cov_19.731725	538	618	0	80	80	1.0000000
NODE_2412_length_1467_cov_11.807749	180	242	16	11	62	0.1774193
NODE_2412_length_1467_cov_11.807749	180	242	22	2	62	0.0322581
NODE_2412_length_1467_cov_11.807749	180	242	24	1	62	0.0161290
NODE_2412_length_1467_cov_11.807749	180	242	26	1	62	0.0161290
NODE_2412_length_1467_cov_11.807749	180	242	28	16	62	0.2580645
NODE_2412_length_1467_cov_11.807749	180	242	30	14	62	0.2258064
NODE_2412_length_1467_cov_11.807749	180	242	32	17	62	0.2741936
NODE_2412_length_1467_cov_11.807749	264	293	16	1	29	0.0344828
NODE_2412_length_1467_cov_11.807749	264	293	18	2	29	0.0689655
NODE_2412_length_1467_cov_11.807749	264	293	20	7	29	0.2413793
NODE_2412_length_1467_cov_11.807749	264	293	24	4	29	0.1379310
NODE_2412_length_1467_cov_11.807749	264	293	28	12	29	0.4137931
NODE_2412_length_1467_cov_11.807749	264	293	30	3	29	0.1034483
NODE_2412_length_1467_cov_11.807749	930	1010	0	28	80	0.3500000
NODE_2412_length_1467_cov_11.807749	930	1010	2	52	80	0.6500000
NODE_2412_length_1467_cov_11.807749	983	1063	0	25	80	0.3125000
NODE_2412_length_1467_cov_11.807749	983	1063	2	55	80	0.6875000
NODE_2414_length_1466_cov_41.326993	664	744	0	20	80	0.2500000
NODE_2414_length_1466_cov_41.326993	664	744	2	60	80	0.7500000
NODE_2414_length_1466_cov_41.326993	717	797	0	23	80	0.2875000
NODE_2414_length_1466_cov_41.326993	717	797	2	57	80	0.7125000
NODE_2414_length_1466_cov_41.326993	793	873	0	46	80	0.5750000
NODE_2414_length_1466_cov_41.326993	793	873	2	34	80	0.4250000
NODE_2414_length_1466_cov_41.326993	846	926	0	2	80	0.0250000
NODE_2414_length_1466_cov_41.326993	846	926	2	78	80	0.9750000
NODE_2420_length_1464_cov_6.726740	137	204	6	8	67	0.1194030
NODE_2420_length_1464_cov_6.726740	137	204	8	12	67	0.1791045
NODE_2420_length_1464_cov_6.726740	137	204	10	31	67	0.4626866
NODE_2420_length_1464_cov_6.726740	137	204	12	16	67	0.2388060
NODE_2422_length_1464_cov_2.198535	1301	1363	10	1	62	0.0161290
NODE_2422_length_1464_cov_2.198535	1301	1363	16	1	62	0.0161290
NODE_2422_length_1464_cov_2.198535	1301	1363	17	4	62	0.0645161
NODE_2422_length_1464_cov_2.198535	1301	1363	18	5	62	0.0806452
NODE_2422_length_1464_cov_2.198535	1301	1363	21	1	62	0.0161290
NODE_2422_length_1464_cov_2.198535	1301	1363	22	1	62	0.0161290
NODE_2422_length_1464_cov_2.198535	1301	1363	24	1	62	0.0161290
NODE_2422_length_1464_cov_2.198535	1301	1363	28	1	62	0.0161290
NODE_2422_length_1464_cov_2.198535	1301	1363	30	2	62	0.0322581
NODE_2422_length_1464_cov_2.198535	1301	1363	31	3	62	0.0483871
NODE_2422_length_1464_cov_2.198535	1301	1363	32	1	62	0.0161290
NODE_2422_length_1464_cov_2.198535	1301	1363	37	2	62	0.0322581
NODE_2422_length_1464_cov_2.198535	1301	1363	41	1	62	0.0161290
NODE_2422_length_1464_cov_2.198535	1301	1363	43	2	62	0.0322581
NODE_2422_length_1464_cov_2.198535	1301	1363	45	6	62	0.0967742
NODE_2422_length_1464_cov_2.198535	1301	1363	47	1	62	0.0161290
NODE_2422_length_1464_cov_2.198535	1301	1363	51	1	62	0.0161290
NODE_2422_length_1464_cov_2.198535	1301	1363	52	4	62	0.0645161
NODE_2422_length_1464_cov_2.198535	1301	1363	54	24	62	0.3870968
NODE_2425_length_1463_cov_15.345308	314	394	0	80	80	1.0000000
NODE_2425_length_1463_cov_15.345308	367	447	0	80	80	1.0000000
NODE_2427_length_1462_cov_18.082172	418	498	0	12	80	0.1500000
NODE_2427_length_1462_cov_18.082172	418	498	2	40	80	0.5000000
NODE_2427_length_1462_cov_18.082172	418	498	4	28	80	0.3500000
NODE_2427_length_1462_cov_18.082172	471	551	0	9	80	0.1125000
NODE_2427_length_1462_cov_18.082172	471	551	2	17	80	0.2125000
NODE_2427_length_1462_cov_18.082172	471	551	4	54	80	0.6750000
NODE_2427_length_1462_cov_18.082172	1036	1116	6	80	80	1.0000000
NODE_2427_length_1462_cov_18.082172	1089	1169	0	40	80	0.5000000
NODE_2427_length_1462_cov_18.082172	1089	1169	6	40	80	0.5000000
NODE_2428_length_1462_cov_1.792370	1247	1319	0	72	72	1.0000000
NODE_2428_length_1462_cov_1.792370	1305	1374	0	69	69	1.0000000
NODE_2433_length_1460_cov_23.927994	852	932	1	8	80	0.1000000
NODE_2433_length_1460_cov_23.927994	852	932	2	72	80	0.9000000
NODE_2433_length_1460_cov_23.927994	905	985	1	50	80	0.6250000
NODE_2433_length_1460_cov_23.927994	905	985	2	30	80	0.3750000
NODE_2436_length_1459_cov_43.600000	535	615	0	6	80	0.0750000
NODE_2436_length_1459_cov_43.600000	535	615	5	39	80	0.4875000
NODE_2436_length_1459_cov_43.600000	535	615	6	35	80	0.4375000
NODE_2436_length_1459_cov_43.600000	588	668	0	59	80	0.7375000
NODE_2436_length_1459_cov_43.600000	588	668	5	2	80	0.0250000
NODE_2436_length_1459_cov_43.600000	588	668	6	19	80	0.2375000
NODE_2436_length_1459_cov_43.600000	664	744	0	80	80	1.0000000
NODE_2436_length_1459_cov_43.600000	717	797	0	80	80	1.0000000
NODE_2437_length_1459_cov_32.276471	865	945	0	80	80	1.0000000
NODE_2437_length_1459_cov_32.276471	918	998	0	80	80	1.0000000
NODE_2437_length_1459_cov_32.276471	994	1074	0	80	80	1.0000000
NODE_2437_length_1459_cov_32.276471	1047	1127	0	80	80	1.0000000
NODE_2441_length_1458_cov_2.184695	1361	1441	1	5	80	0.0625000
NODE_2441_length_1458_cov_2.184695	1361	1441	3	10	80	0.1250000
NODE_2441_length_1458_cov_2.184695	1361	1441	4	41	80	0.5125000
NODE_2441_length_1458_cov_2.184695	1361	1441	6	1	80	0.0125000
NODE_2441_length_1458_cov_2.184695	1361	1441	8	23	80	0.2875000
NODE_2442_length_1457_cov_19.687040	834	914	0	15	80	0.1875000
NODE_2442_length_1457_cov_19.687040	834	914	2	19	80	0.2375000
NODE_2442_length_1457_cov_19.687040	834	914	4	22	80	0.2750000
NODE_2442_length_1457_cov_19.687040	834	914	6	24	80	0.3000000
NODE_2442_length_1457_cov_19.687040	887	967	0	68	80	0.8500000
NODE_2442_length_1457_cov_19.687040	887	967	2	12	80	0.1500000
NODE_2442_length_1457_cov_19.687040	963	1043	0	36	80	0.4500000
NODE_2442_length_1457_cov_19.687040	963	1043	8	15	80	0.1875000
NODE_2442_length_1457_cov_19.687040	963	1043	10	29	80	0.3625000
NODE_2442_length_1457_cov_19.687040	1016	1096	10	80	80	1.0000000
NODE_2444_length_1457_cov_14.944772	754	834	0	74	80	0.9250000
NODE_2444_length_1457_cov_14.944772	754	834	4	2	80	0.0250000
NODE_2444_length_1457_cov_14.944772	754	834	6	4	80	0.0500000
NODE_2444_length_1457_cov_14.944772	807	887	0	21	80	0.2625000
NODE_2444_length_1457_cov_14.944772	807	887	4	2	80	0.0250000
NODE_2444_length_1457_cov_14.944772	807	887	6	35	80	0.4375000
NODE_2444_length_1457_cov_14.944772	807	887	8	22	80	0.2750000
NODE_2445_length_1457_cov_10.168630	827	907	0	9	80	0.1125000
NODE_2445_length_1457_cov_10.168630	827	907	4	36	80	0.4500000
NODE_2445_length_1457_cov_10.168630	827	907	6	35	80	0.4375000
NODE_2445_length_1457_cov_10.168630	880	960	0	1	80	0.0125000
NODE_2445_length_1457_cov_10.168630	880	960	4	28	80	0.3500000
NODE_2445_length_1457_cov_10.168630	880	960	6	51	80	0.6375000
NODE_2445_length_1457_cov_10.168630	956	1036	0	77	80	0.9625000
NODE_2445_length_1457_cov_10.168630	956	1036	4	3	80	0.0375000
NODE_2445_length_1457_cov_10.168630	1009	1089	0	80	80	1.0000000
NODE_2448_length_1456_cov_13.675755	557	637	0	80	80	1.0000000
NODE_2448_length_1456_cov_13.675755	610	690	0	80	80	1.0000000
NODE_2449_length_1456_cov_11.109064	951	1031	0	33	80	0.4125000
NODE_2449_length_1456_cov_11.109064	951	1031	2	47	80	0.5875000
NODE_2449_length_1456_cov_11.109064	1004	1084	2	80	80	1.0000000
NODE_2452_length_1456_cov_3.137067	374	410	12	8	36	0.2222222
NODE_2452_length_1456_cov_3.137067	374	410	14	26	36	0.7222222
NODE_2452_length_1456_cov_3.137067	374	410	16	2	36	0.0555556
NODE_2454_length_1456_cov_1.889462	35	99	0	64	64	1.0000000
NODE_2456_length_1455_cov_60.874631	369	449	0	80	80	1.0000000
NODE_2456_length_1455_cov_60.874631	422	502	0	80	80	1.0000000
NODE_2456_length_1455_cov_60.874631	498	578	0	80	80	1.0000000
NODE_2456_length_1455_cov_60.874631	551	631	0	80	80	1.0000000
NODE_2458_length_1455_cov_35.253687	615	695	7	26	80	0.3250000
NODE_2458_length_1455_cov_35.253687	615	695	8	54	80	0.6750000
NODE_2458_length_1455_cov_35.253687	668	748	0	34	80	0.4250000
NODE_2458_length_1455_cov_35.253687	668	748	6	16	80	0.2000000
NODE_2458_length_1455_cov_35.253687	668	748	7	29	80	0.3625000
NODE_2458_length_1455_cov_35.253687	668	748	8	1	80	0.0125000
NODE_2458_length_1455_cov_35.253687	744	824	0	14	80	0.1750000
NODE_2458_length_1455_cov_35.253687	744	824	2	10	80	0.1250000
NODE_2458_length_1455_cov_35.253687	744	824	4	56	80	0.7000000
NODE_2458_length_1455_cov_35.253687	797	877	0	26	80	0.3250000
NODE_2458_length_1455_cov_35.253687	797	877	2	11	80	0.1375000
NODE_2458_length_1455_cov_35.253687	797	877	4	43	80	0.5375000
NODE_2465_length_1452_cov_7.101256	976	1056	0	80	80	1.0000000
NODE_2465_length_1452_cov_7.101256	1029	1109	0	80	80	1.0000000
NODE_2465_length_1452_cov_7.101256	1105	1185	0	80	80	1.0000000
NODE_2465_length_1452_cov_7.101256	1158	1238	0	80	80	1.0000000
NODE_2470_length_1451_cov_23.880178	439	520	8	1	81	0.0123457
NODE_2470_length_1451_cov_23.880178	439	520	10	15	81	0.1851852
NODE_2470_length_1451_cov_23.880178	439	520	14	20	81	0.2469136
NODE_2470_length_1451_cov_23.880178	439	520	16	11	81	0.1358025
NODE_2470_length_1451_cov_23.880178	439	520	18	15	81	0.1851852
NODE_2470_length_1451_cov_23.880178	439	520	20	19	81	0.2345679
NODE_2470_length_1451_cov_23.880178	493	573	13	12	80	0.1500000
NODE_2470_length_1451_cov_23.880178	493	573	14	19	80	0.2375000
NODE_2470_length_1451_cov_23.880178	493	573	15	3	80	0.0375000
NODE_2470_length_1451_cov_23.880178	493	573	16	5	80	0.0625000
NODE_2470_length_1451_cov_23.880178	493	573	17	4	80	0.0500000
NODE_2470_length_1451_cov_23.880178	493	573	18	29	80	0.3625000
NODE_2470_length_1451_cov_23.880178	493	573	20	8	80	0.1000000
NODE_2471_length_1451_cov_16.249260	422	502	2	57	80	0.7125000
NODE_2471_length_1451_cov_16.249260	422	502	4	6	80	0.0750000
NODE_2471_length_1451_cov_16.249260	422	502	6	17	80	0.2125000
NODE_2471_length_1451_cov_16.249260	475	555	2	4	80	0.0500000
NODE_2471_length_1451_cov_16.249260	475	555	4	59	80	0.7375000
NODE_2471_length_1451_cov_16.249260	475	555	6	17	80	0.2125000
NODE_2472_length_1451_cov_8.663462	908	988	0	80	80	1.0000000
NODE_2472_length_1451_cov_8.663462	961	1040	0	79	79	1.0000000
NODE_2474_length_1451_cov_5.219675	897	977	0	80	80	1.0000000
NODE_2474_length_1451_cov_5.219675	950	1030	0	80	80	1.0000000
NODE_2477_length_1450_cov_20.371577	611	691	0	80	80	1.0000000
NODE_2477_length_1450_cov_20.371577	664	744	0	80	80	1.0000000
NODE_2482_length_1449_cov_24.665926	432	512	0	80	80	1.0000000
NODE_2482_length_1449_cov_24.665926	485	565	0	80	80	1.0000000
NODE_2482_length_1449_cov_24.665926	561	643	0	82	82	1.0000000
NODE_2482_length_1449_cov_24.665926	616	696	0	80	80	1.0000000
NODE_2485_length_1448_cov_20.587102	904	984	2	47	80	0.5875000
NODE_2485_length_1448_cov_20.587102	904	984	4	33	80	0.4125000
NODE_2485_length_1448_cov_20.587102	957	1037	2	49	80	0.6125000
NODE_2485_length_1448_cov_20.587102	957	1037	4	31	80	0.3875000
NODE_2487_length_1448_cov_8.693847	537	617	0	63	80	0.7875000
NODE_2487_length_1448_cov_8.693847	537	617	2	2	80	0.0250000
NODE_2487_length_1448_cov_8.693847	537	617	4	15	80	0.1875000
NODE_2487_length_1448_cov_8.693847	590	670	0	10	80	0.1250000
NODE_2487_length_1448_cov_8.693847	590	670	2	2	80	0.0250000
NODE_2487_length_1448_cov_8.693847	590	670	4	68	80	0.8500000
NODE_2488_length_1447_cov_21.391691	519	599	0	80	80	1.0000000
NODE_2488_length_1447_cov_21.391691	572	652	0	80	80	1.0000000
NODE_2488_length_1447_cov_21.391691	648	728	0	35	80	0.4375000
NODE_2488_length_1447_cov_21.391691	648	728	4	45	80	0.5625000
NODE_2488_length_1447_cov_21.391691	701	781	2	12	80	0.1500000
NODE_2488_length_1447_cov_21.391691	701	781	4	49	80	0.6125000
NODE_2488_length_1447_cov_21.391691	701	781	6	19	80	0.2375000
NODE_2491_length_1447_cov_2.262611	1268	1325	27	5	57	0.0877193
NODE_2491_length_1447_cov_2.262611	1268	1325	29	1	57	0.0175439
NODE_2491_length_1447_cov_2.262611	1268	1325	32	1	57	0.0175439
NODE_2491_length_1447_cov_2.262611	1268	1325	42	1	57	0.0175439
NODE_2491_length_1447_cov_2.262611	1268	1325	46	1	57	0.0175439
NODE_2491_length_1447_cov_2.262611	1268	1325	50	1	57	0.0175439
NODE_2491_length_1447_cov_2.262611	1268	1325	52	3	57	0.0526316
NODE_2491_length_1447_cov_2.262611	1268	1325	56	5	57	0.0877193
NODE_2491_length_1447_cov_2.262611	1268	1325	66	1	57	0.0175439
NODE_2491_length_1447_cov_2.262611	1268	1325	68	1	57	0.0175439
NODE_2491_length_1447_cov_2.262611	1268	1325	76	1	57	0.0175439
NODE_2491_length_1447_cov_2.262611	1268	1325	77	1	57	0.0175439
NODE_2491_length_1447_cov_2.262611	1268	1325	78	1	57	0.0175439
NODE_2491_length_1447_cov_2.262611	1268	1325	80	5	57	0.0877193
NODE_2491_length_1447_cov_2.262611	1268	1325	82	1	57	0.0175439
NODE_2491_length_1447_cov_2.262611	1268	1325	87	1	57	0.0175439
NODE_2491_length_1447_cov_2.262611	1268	1325	93	1	57	0.0175439
NODE_2491_length_1447_cov_2.262611	1268	1325	104	4	57	0.0701754
NODE_2491_length_1447_cov_2.262611	1268	1325	110	1	57	0.0175439
NODE_2491_length_1447_cov_2.262611	1268	1325	112	3	57	0.0526316
NODE_2491_length_1447_cov_2.262611	1268	1325	114	1	57	0.0175439
NODE_2491_length_1447_cov_2.262611	1268	1325	115	2	57	0.0350877
NODE_2491_length_1447_cov_2.262611	1268	1325	121	1	57	0.0175439
NODE_2491_length_1447_cov_2.262611	1268	1325	128	1	57	0.0175439
NODE_2491_length_1447_cov_2.262611	1268	1325	131	2	57	0.0350877
NODE_2491_length_1447_cov_2.262611	1268	1325	132	3	57	0.0526316
NODE_2491_length_1447_cov_2.262611	1268	1325	134	8	57	0.1403509
NODE_2491_length_1447_cov_2.262611	1321	1378	126	3	57	0.0526316
NODE_2491_length_1447_cov_2.262611	1321	1378	128	2	57	0.0350877
NODE_2491_length_1447_cov_2.262611	1321	1378	130	3	57	0.0526316
NODE_2491_length_1447_cov_2.262611	1321	1378	132	5	57	0.0877193
NODE_2491_length_1447_cov_2.262611	1321	1378	134	24	57	0.4210526
NODE_2491_length_1447_cov_2.262611	1321	1378	135	1	57	0.0175439
NODE_2491_length_1447_cov_2.262611	1321	1378	136	19	57	0.3333333
NODE_2494_length_1445_cov_22.052006	759	839	0	80	80	1.0000000
NODE_2494_length_1445_cov_22.052006	812	892	0	80	80	1.0000000
NODE_2494_length_1445_cov_22.052006	888	968	0	53	80	0.6625000
NODE_2494_length_1445_cov_22.052006	888	968	2	27	80	0.3375000
NODE_2494_length_1445_cov_22.052006	941	1021	0	16	80	0.2000000
NODE_2494_length_1445_cov_22.052006	941	1021	2	64	80	0.8000000
NODE_2495_length_1445_cov_13.378900	584	664	0	80	80	1.0000000
NODE_2495_length_1445_cov_13.378900	637	717	0	80	80	1.0000000
NODE_2501_length_1443_cov_7.628720	480	560	2	39	80	0.4875000
NODE_2501_length_1443_cov_7.628720	480	560	4	41	80	0.5125000
NODE_2501_length_1443_cov_7.628720	533	613	2	51	80	0.6375000
NODE_2501_length_1443_cov_7.628720	533	613	4	29	80	0.3625000
NODE_2501_length_1443_cov_7.628720	609	689	2	25	80	0.3125000
NODE_2501_length_1443_cov_7.628720	609	689	4	52	80	0.6500000
NODE_2501_length_1443_cov_7.628720	609	689	6	3	80	0.0375000
NODE_2501_length_1443_cov_7.628720	662	742	0	20	80	0.2500000
NODE_2501_length_1443_cov_7.628720	662	742	4	60	80	0.7500000
NODE_2502_length_1443_cov_4.843006	924	1004	0	54	80	0.6750000
NODE_2502_length_1443_cov_4.843006	924	1004	2	26	80	0.3250000
NODE_2502_length_1443_cov_4.843006	977	1057	0	20	80	0.2500000
NODE_2502_length_1443_cov_4.843006	977	1057	2	60	80	0.7500000
NODE_2508_length_1442_cov_24.551750	427	507	0	63	80	0.7875000
NODE_2508_length_1442_cov_24.551750	427	507	2	17	80	0.2125000
NODE_2508_length_1442_cov_24.551750	480	560	0	80	80	1.0000000
NODE_2508_length_1442_cov_24.551750	556	636	0	45	80	0.5625000
NODE_2508_length_1442_cov_24.551750	556	636	4	35	80	0.4375000
NODE_2508_length_1442_cov_24.551750	609	689	4	80	80	1.0000000
NODE_2509_length_1442_cov_24.032762	424	504	0	29	80	0.3625000
NODE_2509_length_1442_cov_24.032762	424	504	4	51	80	0.6375000
NODE_2509_length_1442_cov_24.032762	477	557	4	80	80	1.0000000
NODE_2511_length_1441_cov_16.528316	963	1043	4	15	80	0.1875000
NODE_2511_length_1441_cov_16.528316	963	1043	6	2	80	0.0250000
NODE_2511_length_1441_cov_16.528316	963	1043	8	32	80	0.4000000
NODE_2511_length_1441_cov_16.528316	963	1043	10	12	80	0.1500000
NODE_2511_length_1441_cov_16.528316	963	1043	12	8	80	0.1000000
NODE_2511_length_1441_cov_16.528316	963	1043	16	11	80	0.1375000
NODE_2511_length_1441_cov_16.528316	1016	1096	4	6	80	0.0750000
NODE_2511_length_1441_cov_16.528316	1016	1096	10	8	80	0.1000000
NODE_2511_length_1441_cov_16.528316	1016	1096	12	55	80	0.6875000
NODE_2511_length_1441_cov_16.528316	1016	1096	16	11	80	0.1375000
NODE_2512_length_1441_cov_3.781669	80	156	0	2	76	0.0263158
NODE_2512_length_1441_cov_3.781669	80	156	4	74	76	0.9736842
NODE_2512_length_1441_cov_3.781669	129	209	4	80	80	1.0000000
NODE_2515_length_1440_cov_34.523490	446	526	0	54	80	0.6750000
NODE_2515_length_1440_cov_34.523490	446	526	10	26	80	0.3250000
NODE_2515_length_1440_cov_34.523490	499	576	0	1	77	0.0129870
NODE_2515_length_1440_cov_34.523490	499	576	10	76	77	0.9870130
NODE_2515_length_1440_cov_34.523490	576	654	10	27	78	0.3461539
NODE_2515_length_1440_cov_34.523490	576	654	12	19	78	0.2435897
NODE_2515_length_1440_cov_34.523490	576	654	14	12	78	0.1538462
NODE_2515_length_1440_cov_34.523490	576	654	16	10	78	0.1282051
NODE_2515_length_1440_cov_34.523490	576	654	20	10	78	0.1282051
NODE_2515_length_1440_cov_34.523490	627	707	6	9	80	0.1125000
NODE_2515_length_1440_cov_34.523490	627	707	8	9	80	0.1125000
NODE_2515_length_1440_cov_34.523490	627	707	10	45	80	0.5625000
NODE_2515_length_1440_cov_34.523490	627	707	16	7	80	0.0875000
NODE_2515_length_1440_cov_34.523490	627	707	20	10	80	0.1250000
NODE_2516_length_1440_cov_20.372110	776	856	0	80	80	1.0000000
NODE_2516_length_1440_cov_20.372110	829	909	0	80	80	1.0000000
NODE_2516_length_1440_cov_20.372110	905	985	0	80	80	1.0000000
NODE_2516_length_1440_cov_20.372110	958	1038	0	80	80	1.0000000
NODE_2517_length_1440_cov_14.476510	586	615	3	29	29	1.0000000
NODE_2517_length_1440_cov_14.476510	666	695	1	28	29	0.9655172
NODE_2517_length_1440_cov_14.476510	666	695	3	1	29	0.0344828
NODE_2517_length_1440_cov_14.476510	1295	1359	442	1	64	0.0156250
NODE_2517_length_1440_cov_14.476510	1295	1359	447	1	64	0.0156250
NODE_2517_length_1440_cov_14.476510	1295	1359	449	1	64	0.0156250
NODE_2517_length_1440_cov_14.476510	1295	1359	451	2	64	0.0312500
NODE_2517_length_1440_cov_14.476510	1295	1359	452	1	64	0.0156250
NODE_2517_length_1440_cov_14.476510	1295	1359	453	1	64	0.0156250
NODE_2517_length_1440_cov_14.476510	1295	1359	459	1	64	0.0156250
NODE_2517_length_1440_cov_14.476510	1295	1359	462	1	64	0.0156250
NODE_2517_length_1440_cov_14.476510	1295	1359	464	6	64	0.0937500
NODE_2517_length_1440_cov_14.476510	1295	1359	465	1	64	0.0156250
NODE_2517_length_1440_cov_14.476510	1295	1359	467	2	64	0.0312500
NODE_2517_length_1440_cov_14.476510	1295	1359	480	1	64	0.0156250
NODE_2517_length_1440_cov_14.476510	1295	1359	482	3	64	0.0468750
NODE_2517_length_1440_cov_14.476510	1295	1359	484	2	64	0.0312500
NODE_2517_length_1440_cov_14.476510	1295	1359	485	3	64	0.0468750
NODE_2517_length_1440_cov_14.476510	1295	1359	487	2	64	0.0312500
NODE_2517_length_1440_cov_14.476510	1295	1359	488	3	64	0.0468750
NODE_2517_length_1440_cov_14.476510	1295	1359	489	2	64	0.0312500
NODE_2517_length_1440_cov_14.476510	1295	1359	494	1	64	0.0156250
NODE_2517_length_1440_cov_14.476510	1295	1359	496	2	64	0.0312500
NODE_2517_length_1440_cov_14.476510	1295	1359	497	4	64	0.0625000
NODE_2517_length_1440_cov_14.476510	1295	1359	498	3	64	0.0468750
NODE_2517_length_1440_cov_14.476510	1295	1359	499	4	64	0.0625000
NODE_2517_length_1440_cov_14.476510	1295	1359	500	3	64	0.0468750
NODE_2517_length_1440_cov_14.476510	1295	1359	502	1	64	0.0156250
NODE_2517_length_1440_cov_14.476510	1295	1359	504	4	64	0.0625000
NODE_2517_length_1440_cov_14.476510	1295	1359	505	1	64	0.0156250
NODE_2517_length_1440_cov_14.476510	1295	1359	506	5	64	0.0781250
NODE_2517_length_1440_cov_14.476510	1295	1359	507	2	64	0.0312500
NODE_2518_length_1440_cov_9.049217	384	464	0	80	80	1.0000000
NODE_2518_length_1440_cov_9.049217	437	517	0	80	80	1.0000000
NODE_2520_length_1439_cov_11.784328	898	978	0	80	80	1.0000000
NODE_2520_length_1439_cov_11.784328	951	1031	0	80	80	1.0000000
NODE_2525_length_1438_cov_41.481703	671	751	0	80	80	1.0000000
NODE_2525_length_1438_cov_41.481703	724	804	0	80	80	1.0000000
NODE_2529_length_1437_cov_14.449178	815	895	2	80	80	1.0000000
NODE_2529_length_1437_cov_14.449178	868	948	0	53	80	0.6625000
NODE_2529_length_1437_cov_14.449178	868	948	2	27	80	0.3375000
NODE_2529_length_1437_cov_14.449178	944	1024	0	80	80	1.0000000
NODE_2529_length_1437_cov_14.449178	997	1077	0	80	80	1.0000000
NODE_2532_length_1436_cov_96.256545	1145	1225	0	65	80	0.8125000
NODE_2532_length_1436_cov_96.256545	1145	1225	5	1	80	0.0125000
NODE_2532_length_1436_cov_96.256545	1145	1225	6	14	80	0.1750000
NODE_2532_length_1436_cov_96.256545	1198	1278	0	12	80	0.1500000
NODE_2532_length_1436_cov_96.256545	1198	1278	5	1	80	0.0125000
NODE_2532_length_1436_cov_96.256545	1198	1278	6	67	80	0.8375000
NODE_2532_length_1436_cov_96.256545	1274	1354	6	80	80	1.0000000
NODE_2532_length_1436_cov_96.256545	1327	1407	0	51	80	0.6375000
NODE_2532_length_1436_cov_96.256545	1327	1407	5	1	80	0.0125000
NODE_2532_length_1436_cov_96.256545	1327	1407	6	28	80	0.3500000
NODE_2536_length_1435_cov_21.468563	783	863	0	11	80	0.1375000
NODE_2536_length_1435_cov_21.468563	783	863	2	15	80	0.1875000
NODE_2536_length_1435_cov_21.468563	783	863	4	9	80	0.1125000
NODE_2536_length_1435_cov_21.468563	783	863	6	1	80	0.0125000
NODE_2536_length_1435_cov_21.468563	783	863	7	31	80	0.3875000
NODE_2536_length_1435_cov_21.468563	783	863	10	13	80	0.1625000
NODE_2536_length_1435_cov_21.468563	836	916	6	19	80	0.2375000
NODE_2536_length_1435_cov_21.468563	836	916	7	14	80	0.1750000
NODE_2536_length_1435_cov_21.468563	836	916	8	3	80	0.0375000
NODE_2536_length_1435_cov_21.468563	836	916	10	44	80	0.5500000
NODE_2536_length_1435_cov_21.468563	912	992	6	3	80	0.0375000
NODE_2536_length_1435_cov_21.468563	912	992	8	20	80	0.2500000
NODE_2536_length_1435_cov_21.468563	912	992	12	12	80	0.1500000
NODE_2536_length_1435_cov_21.468563	912	992	14	19	80	0.2375000
NODE_2536_length_1435_cov_21.468563	912	992	15	4	80	0.0500000
NODE_2536_length_1435_cov_21.468563	912	992	18	22	80	0.2750000
NODE_2536_length_1435_cov_21.468563	965	1045	6	21	80	0.2625000
NODE_2536_length_1435_cov_21.468563	965	1045	8	1	80	0.0125000
NODE_2536_length_1435_cov_21.468563	965	1045	9	23	80	0.2875000
NODE_2536_length_1435_cov_21.468563	965	1045	12	9	80	0.1125000
NODE_2536_length_1435_cov_21.468563	965	1045	14	19	80	0.2375000
NODE_2536_length_1435_cov_21.468563	965	1045	15	4	80	0.0500000
NODE_2536_length_1435_cov_21.468563	965	1045	18	3	80	0.0375000
NODE_2537_length_1435_cov_18.593563	1123	1203	8	42	80	0.5250000
NODE_2537_length_1435_cov_18.593563	1123	1203	10	7	80	0.0875000
NODE_2537_length_1435_cov_18.593563	1123	1203	12	17	80	0.2125000
NODE_2537_length_1435_cov_18.593563	1123	1203	13	1	80	0.0125000
NODE_2537_length_1435_cov_18.593563	1123	1203	15	7	80	0.0875000
NODE_2537_length_1435_cov_18.593563	1123	1203	16	6	80	0.0750000
NODE_2537_length_1435_cov_18.593563	1176	1256	0	47	80	0.5875000
NODE_2537_length_1435_cov_18.593563	1176	1256	8	33	80	0.4125000
NODE_2538_length_1435_cov_5.828593	299	379	4	80	80	1.0000000
NODE_2538_length_1435_cov_5.828593	352	432	0	44	80	0.5500000
NODE_2538_length_1435_cov_5.828593	352	432	4	36	80	0.4500000
NODE_2540_length_1434_cov_17.610487	1023	1103	0	80	80	1.0000000
NODE_2540_length_1434_cov_17.610487	1076	1156	0	80	80	1.0000000
NODE_2540_length_1434_cov_17.610487	1152	1232	0	46	80	0.5750000
NODE_2540_length_1434_cov_17.610487	1152	1232	2	34	80	0.4250000
NODE_2540_length_1434_cov_17.610487	1205	1285	0	23	80	0.2875000
NODE_2540_length_1434_cov_17.610487	1205	1285	2	57	80	0.7125000
NODE_2541_length_1434_cov_9.845693	846	926	0	1	80	0.0125000
NODE_2541_length_1434_cov_9.845693	846	926	6	30	80	0.3750000
NODE_2541_length_1434_cov_9.845693	846	926	8	49	80	0.6125000
NODE_2541_length_1434_cov_9.845693	899	978	0	53	79	0.6708861
NODE_2541_length_1434_cov_9.845693	899	978	6	26	79	0.3291139
NODE_2544_length_1433_cov_36.452774	538	618	0	38	80	0.4750000
NODE_2544_length_1433_cov_36.452774	538	618	2	42	80	0.5250000
NODE_2544_length_1433_cov_36.452774	591	671	0	80	80	1.0000000
NODE_2544_length_1433_cov_36.452774	667	747	0	80	80	1.0000000
NODE_2544_length_1433_cov_36.452774	720	800	0	80	80	1.0000000
NODE_2550_length_1431_cov_7.409159	513	593	0	80	80	1.0000000
NODE_2550_length_1431_cov_7.409159	566	646	0	80	80	1.0000000
NODE_2551_length_1431_cov_6.721471	1074	1154	0	67	80	0.8375000
NODE_2551_length_1431_cov_6.721471	1074	1154	2	13	80	0.1625000
NODE_2551_length_1431_cov_6.721471	1127	1207	0	14	80	0.1750000
NODE_2551_length_1431_cov_6.721471	1127	1207	2	66	80	0.8250000
NODE_2552_length_1430_cov_32.643877	753	833	0	80	80	1.0000000
NODE_2552_length_1430_cov_32.643877	806	886	0	80	80	1.0000000
NODE_2552_length_1430_cov_32.643877	882	962	0	80	80	1.0000000
NODE_2552_length_1430_cov_32.643877	935	1016	0	81	81	1.0000000
NODE_2557_length_1428_cov_5.895410	340	416	0	12	76	0.1578947
NODE_2557_length_1428_cov_5.895410	340	416	2	64	76	0.8421053
NODE_2557_length_1428_cov_5.895410	393	476	2	83	83	1.0000000
NODE_2560_length_1427_cov_38.919428	707	787	0	18	80	0.2250000
NODE_2560_length_1427_cov_38.919428	707	787	2	19	80	0.2375000
NODE_2560_length_1427_cov_38.919428	707	787	4	43	80	0.5375000
NODE_2560_length_1427_cov_38.919428	760	840	0	8	80	0.1000000
NODE_2560_length_1427_cov_38.919428	760	840	2	72	80	0.9000000
NODE_2560_length_1427_cov_38.919428	836	916	0	13	80	0.1625000
NODE_2560_length_1427_cov_38.919428	836	916	2	13	80	0.1625000
NODE_2560_length_1427_cov_38.919428	836	916	4	54	80	0.6750000
NODE_2560_length_1427_cov_38.919428	889	969	4	80	80	1.0000000
NODE_2561_length_1427_cov_19.442771	808	888	0	80	80	1.0000000
NODE_2561_length_1427_cov_19.442771	861	941	0	34	80	0.4250000
NODE_2561_length_1427_cov_19.442771	861	941	4	20	80	0.2500000
NODE_2561_length_1427_cov_19.442771	861	941	9	1	80	0.0125000
NODE_2561_length_1427_cov_19.442771	861	941	10	25	80	0.3125000
NODE_2561_length_1427_cov_19.442771	937	1017	10	80	80	1.0000000
NODE_2561_length_1427_cov_19.442771	990	1070	0	16	80	0.2000000
NODE_2561_length_1427_cov_19.442771	990	1070	6	32	80	0.4000000
NODE_2561_length_1427_cov_19.442771	990	1070	10	32	80	0.4000000
NODE_2562_length_1427_cov_10.490964	728	808	0	80	80	1.0000000
NODE_2562_length_1427_cov_10.490964	781	861	0	80	80	1.0000000
NODE_2562_length_1427_cov_10.490964	857	937	0	68	80	0.8500000
NODE_2562_length_1427_cov_10.490964	857	937	1	12	80	0.1500000
NODE_2562_length_1427_cov_10.490964	910	990	0	15	80	0.1875000
NODE_2562_length_1427_cov_10.490964	910	990	1	17	80	0.2125000
NODE_2562_length_1427_cov_10.490964	910	990	2	48	80	0.6000000
NODE_2563_length_1427_cov_9.929217	646	726	2	47	80	0.5875000
NODE_2563_length_1427_cov_9.929217	646	726	4	33	80	0.4125000
NODE_2563_length_1427_cov_9.929217	699	779	4	80	80	1.0000000
NODE_2563_length_1427_cov_9.929217	775	855	4	36	80	0.4500000
NODE_2563_length_1427_cov_9.929217	775	855	8	43	80	0.5375000
NODE_2563_length_1427_cov_9.929217	775	855	12	1	80	0.0125000
NODE_2563_length_1427_cov_9.929217	828	908	8	80	80	1.0000000
NODE_2563_length_1427_cov_9.929217	1248	1324	0	60	76	0.7894737
NODE_2563_length_1427_cov_9.929217	1248	1324	2	16	76	0.2105263
NODE_2563_length_1427_cov_9.929217	1301	1376	0	7	75	0.0933333
NODE_2563_length_1427_cov_9.929217	1301	1376	2	68	75	0.9066667
NODE_2564_length_1427_cov_3.122741	1336	1399	1	63	63	1.0000000
NODE_2570_length_1426_cov_36.580256	422	502	0	80	80	1.0000000
NODE_2570_length_1426_cov_36.580256	475	555	0	74	80	0.9250000
NODE_2570_length_1426_cov_36.580256	475	555	4	6	80	0.0750000
NODE_2570_length_1426_cov_36.580256	551	631	4	24	80	0.3000000
NODE_2570_length_1426_cov_36.580256	551	631	19	12	80	0.1500000
NODE_2570_length_1426_cov_36.580256	551	631	20	44	80	0.5500000
NODE_2570_length_1426_cov_36.580256	604	684	14	6	80	0.0750000
NODE_2570_length_1426_cov_36.580256	604	684	18	12	80	0.1500000
NODE_2570_length_1426_cov_36.580256	604	684	19	47	80	0.5875000
NODE_2570_length_1426_cov_36.580256	604	684	20	15	80	0.1875000
NODE_2574_length_1425_cov_25.524133	561	641	0	35	80	0.4375000
NODE_2574_length_1425_cov_25.524133	561	641	4	45	80	0.5625000
NODE_2574_length_1425_cov_25.524133	614	694	4	80	80	1.0000000
NODE_2575_length_1425_cov_10.175716	361	441	0	80	80	1.0000000
NODE_2575_length_1425_cov_10.175716	414	494	0	80	80	1.0000000
NODE_2587_length_1423_cov_31.158610	862	942	0	53	80	0.6625000
NODE_2587_length_1423_cov_31.158610	862	942	2	6	80	0.0750000
NODE_2587_length_1423_cov_31.158610	862	942	4	21	80	0.2625000
NODE_2587_length_1423_cov_31.158610	915	995	2	17	80	0.2125000
NODE_2587_length_1423_cov_31.158610	915	995	4	63	80	0.7875000
NODE_2588_length_1423_cov_30.731873	764	844	2	80	80	1.0000000
NODE_2588_length_1423_cov_30.731873	817	897	0	39	80	0.4875000
NODE_2588_length_1423_cov_30.731873	817	897	2	41	80	0.5125000
NODE_2596_length_1421_cov_8.285930	136	212	261	1	76	0.0131579
NODE_2596_length_1421_cov_8.285930	136	212	265	1	76	0.0131579
NODE_2596_length_1421_cov_8.285930	136	212	269	3	76	0.0394737
NODE_2596_length_1421_cov_8.285930	136	212	270	1	76	0.0131579
NODE_2596_length_1421_cov_8.285930	136	212	272	1	76	0.0131579
NODE_2596_length_1421_cov_8.285930	136	212	280	1	76	0.0131579
NODE_2596_length_1421_cov_8.285930	136	212	282	2	76	0.0263158
NODE_2596_length_1421_cov_8.285930	136	212	284	4	76	0.0526316
NODE_2596_length_1421_cov_8.285930	136	212	288	2	76	0.0263158
NODE_2596_length_1421_cov_8.285930	136	212	290	1	76	0.0131579
NODE_2596_length_1421_cov_8.285930	136	212	292	2	76	0.0263158
NODE_2596_length_1421_cov_8.285930	136	212	296	1	76	0.0131579
NODE_2596_length_1421_cov_8.285930	136	212	302	1	76	0.0131579
NODE_2596_length_1421_cov_8.285930	136	212	304	1	76	0.0131579
NODE_2596_length_1421_cov_8.285930	136	212	305	1	76	0.0131579
NODE_2596_length_1421_cov_8.285930	136	212	307	1	76	0.0131579
NODE_2596_length_1421_cov_8.285930	136	212	308	1	76	0.0131579
NODE_2596_length_1421_cov_8.285930	136	212	312	1	76	0.0131579
NODE_2596_length_1421_cov_8.285930	136	212	313	1	76	0.0131579
NODE_2596_length_1421_cov_8.285930	136	212	316	1	76	0.0131579
NODE_2596_length_1421_cov_8.285930	136	212	317	1	76	0.0131579
NODE_2596_length_1421_cov_8.285930	136	212	323	1	76	0.0131579
NODE_2596_length_1421_cov_8.285930	136	212	331	1	76	0.0131579
NODE_2596_length_1421_cov_8.285930	136	212	348	1	76	0.0131579
NODE_2596_length_1421_cov_8.285930	136	212	361	1	76	0.0131579
NODE_2596_length_1421_cov_8.285930	136	212	364	1	76	0.0131579
NODE_2596_length_1421_cov_8.285930	136	212	369	1	76	0.0131579
NODE_2596_length_1421_cov_8.285930	136	212	371	1	76	0.0131579
NODE_2596_length_1421_cov_8.285930	136	212	372	1	76	0.0131579
NODE_2596_length_1421_cov_8.285930	136	212	375	3	76	0.0394737
NODE_2596_length_1421_cov_8.285930	136	212	376	1	76	0.0131579
NODE_2596_length_1421_cov_8.285930	136	212	379	1	76	0.0131579
NODE_2596_length_1421_cov_8.285930	136	212	384	1	76	0.0131579
NODE_2596_length_1421_cov_8.285930	136	212	390	1	76	0.0131579
NODE_2596_length_1421_cov_8.285930	136	212	392	1	76	0.0131579
NODE_2596_length_1421_cov_8.285930	136	212	394	1	76	0.0131579
NODE_2596_length_1421_cov_8.285930	136	212	402	1	76	0.0131579
NODE_2596_length_1421_cov_8.285930	136	212	404	2	76	0.0263158
NODE_2596_length_1421_cov_8.285930	136	212	405	1	76	0.0131579
NODE_2596_length_1421_cov_8.285930	136	212	406	1	76	0.0131579
NODE_2596_length_1421_cov_8.285930	136	212	407	2	76	0.0263158
NODE_2596_length_1421_cov_8.285930	136	212	409	1	76	0.0131579
NODE_2596_length_1421_cov_8.285930	136	212	414	3	76	0.0394737
NODE_2596_length_1421_cov_8.285930	136	212	416	1	76	0.0131579
NODE_2596_length_1421_cov_8.285930	136	212	419	2	76	0.0263158
NODE_2596_length_1421_cov_8.285930	136	212	420	1	76	0.0131579
NODE_2596_length_1421_cov_8.285930	136	212	421	4	76	0.0526316
NODE_2596_length_1421_cov_8.285930	136	212	422	3	76	0.0394737
NODE_2596_length_1421_cov_8.285930	136	212	423	1	76	0.0131579
NODE_2596_length_1421_cov_8.285930	136	212	425	1	76	0.0131579
NODE_2596_length_1421_cov_8.285930	136	212	427	1	76	0.0131579
NODE_2596_length_1421_cov_8.285930	136	212	429	3	76	0.0394737
NODE_2596_length_1421_cov_8.285930	136	212	433	1	76	0.0131579
NODE_2596_length_1421_cov_8.285930	136	212	434	1	76	0.0131579
NODE_2598_length_1421_cov_2.574130	22	102	6	21	80	0.2625000
NODE_2598_length_1421_cov_2.574130	22	102	8	1	80	0.0125000
NODE_2598_length_1421_cov_2.574130	22	102	10	2	80	0.0250000
NODE_2598_length_1421_cov_2.574130	22	102	12	56	80	0.7000000
NODE_2598_length_1421_cov_2.574130	75	132	4	19	57	0.3333333
NODE_2598_length_1421_cov_2.574130	75	132	6	6	57	0.1052632
NODE_2598_length_1421_cov_2.574130	75	132	8	3	57	0.0526316
NODE_2598_length_1421_cov_2.574130	75	132	10	1	57	0.0175439
NODE_2598_length_1421_cov_2.574130	75	132	12	28	57	0.4912281
NODE_2599_length_1420_cov_256.442846	60	140	0	3	80	0.0375000
NODE_2599_length_1420_cov_256.442846	60	140	2	8	80	0.1000000
NODE_2599_length_1420_cov_256.442846	60	140	6	13	80	0.1625000
NODE_2599_length_1420_cov_256.442846	60	140	10	9	80	0.1125000
NODE_2599_length_1420_cov_256.442846	60	140	14	23	80	0.2875000
NODE_2599_length_1420_cov_256.442846	60	140	18	24	80	0.3000000
NODE_2599_length_1420_cov_256.442846	1294	1360	0	4	66	0.0606061
NODE_2599_length_1420_cov_256.442846	1294	1360	4	2	66	0.0303030
NODE_2599_length_1420_cov_256.442846	1294	1360	6	60	66	0.9090909
NODE_2600_length_1420_cov_7.547313	628	708	0	80	80	1.0000000
NODE_2600_length_1420_cov_7.547313	681	761	0	80	80	1.0000000
NODE_2602_length_1420_cov_2.051476	972	1039	0	4	67	0.0597015
NODE_2602_length_1420_cov_2.051476	972	1039	2	63	67	0.9402985
NODE_2604_length_1419_cov_46.997727	1230	1305	0	16	75	0.2133333
NODE_2604_length_1419_cov_46.997727	1230	1305	1	10	75	0.1333333
NODE_2604_length_1419_cov_46.997727	1230	1305	2	49	75	0.6533333
NODE_2604_length_1419_cov_46.997727	1278	1332	2	54	54	1.0000000
NODE_2609_length_1418_cov_11.373010	432	512	0	80	80	1.0000000
NODE_2609_length_1418_cov_11.373010	485	556	0	71	71	1.0000000
NODE_2615_length_1417_cov_12.477997	354	399	0	45	45	1.0000000
NODE_2616_length_1417_cov_11.120637	794	874	0	80	80	1.0000000
NODE_2616_length_1417_cov_11.120637	847	927	0	80	80	1.0000000
NODE_2625_length_1415_cov_51.375380	423	503	0	80	80	1.0000000
NODE_2625_length_1415_cov_51.375380	476	556	0	67	80	0.8375000
NODE_2625_length_1415_cov_51.375380	476	556	2	13	80	0.1625000
NODE_2625_length_1415_cov_51.375380	552	632	2	80	80	1.0000000
NODE_2625_length_1415_cov_51.375380	605	683	0	36	78	0.4615385
NODE_2625_length_1415_cov_51.375380	605	683	2	42	78	0.5384616
NODE_2626_length_1415_cov_38.272036	513	593	0	80	80	1.0000000
NODE_2626_length_1415_cov_38.272036	566	646	0	30	80	0.3750000
NODE_2626_length_1415_cov_38.272036	566	646	6	5	80	0.0625000
NODE_2626_length_1415_cov_38.272036	566	646	8	26	80	0.3250000
NODE_2626_length_1415_cov_38.272036	566	646	10	19	80	0.2375000
NODE_2627_length_1415_cov_17.232523	642	722	0	80	80	1.0000000
NODE_2627_length_1415_cov_17.232523	695	775	0	80	80	1.0000000
NODE_2629_length_1414_cov_5.307985	1026	1106	2	16	80	0.2000000
NODE_2629_length_1414_cov_5.307985	1026	1106	4	64	80	0.8000000
NODE_2629_length_1414_cov_5.307985	1079	1159	0	48	80	0.6000000
NODE_2629_length_1414_cov_5.307985	1079	1159	2	17	80	0.2125000
NODE_2629_length_1414_cov_5.307985	1079	1159	4	15	80	0.1875000
NODE_2637_length_1412_cov_17.723534	875	955	0	80	80	1.0000000
NODE_2637_length_1412_cov_17.723534	928	1008	0	80	80	1.0000000
NODE_2641_length_1411_cov_34.004573	516	596	0	80	80	1.0000000
NODE_2641_length_1411_cov_34.004573	569	649	0	80	80	1.0000000
NODE_2641_length_1411_cov_34.004573	645	725	0	80	80	1.0000000
NODE_2641_length_1411_cov_34.004573	698	778	0	80	80	1.0000000
NODE_2643_length_1409_cov_25.380153	828	908	0	80	80	1.0000000
NODE_2643_length_1409_cov_25.380153	881	961	0	80	80	1.0000000
NODE_2644_length_1409_cov_13.028244	349	405	2	15	56	0.2678571
NODE_2644_length_1409_cov_13.028244	349	405	4	41	56	0.7321429
NODE_2644_length_1409_cov_13.028244	416	482	0	66	66	1.0000000
NODE_2648_length_1408_cov_6.261268	492	572	0	80	80	1.0000000
NODE_2648_length_1408_cov_6.261268	545	625	0	43	80	0.5375000
NODE_2648_length_1408_cov_6.261268	545	625	2	37	80	0.4625000
NODE_2652_length_1407_cov_27.711009	772	852	0	80	80	1.0000000
NODE_2652_length_1407_cov_27.711009	825	905	0	80	80	1.0000000
NODE_2653_length_1407_cov_24.387615	586	666	0	28	80	0.3500000
NODE_2653_length_1407_cov_24.387615	586	666	2	52	80	0.6500000
NODE_2653_length_1407_cov_24.387615	639	719	0	74	80	0.9250000
NODE_2653_length_1407_cov_24.387615	639	719	4	6	80	0.0750000
NODE_2653_length_1407_cov_24.387615	715	795	0	8	80	0.1000000
NODE_2653_length_1407_cov_24.387615	715	795	4	5	80	0.0625000
NODE_2653_length_1407_cov_24.387615	715	795	6	4	80	0.0500000
NODE_2653_length_1407_cov_24.387615	715	795	10	63	80	0.7875000
NODE_2653_length_1407_cov_24.387615	768	848	0	61	80	0.7625000
NODE_2653_length_1407_cov_24.387615	768	848	6	4	80	0.0500000
NODE_2653_length_1407_cov_24.387615	768	848	10	15	80	0.1875000
NODE_2654_length_1407_cov_19.022936	551	629	0	1	78	0.0128205
NODE_2654_length_1407_cov_19.022936	551	629	4	77	78	0.9871795
NODE_2654_length_1407_cov_19.022936	602	665	0	10	63	0.1587302
NODE_2654_length_1407_cov_19.022936	602	665	4	53	63	0.8412699
NODE_2655_length_1407_cov_11.266820	813	893	0	80	80	1.0000000
NODE_2655_length_1407_cov_11.266820	866	946	0	80	80	1.0000000
NODE_2655_length_1407_cov_11.266820	942	1022	0	80	80	1.0000000
NODE_2655_length_1407_cov_11.266820	995	1075	0	80	80	1.0000000
NODE_2657_length_1406_cov_7.247896	761	841	2	80	80	1.0000000
NODE_2657_length_1406_cov_7.247896	814	894	0	19	80	0.2375000
NODE_2657_length_1406_cov_7.247896	814	894	2	61	80	0.7625000
NODE_2659_length_1404_cov_23.406130	826	906	0	80	80	1.0000000
NODE_2659_length_1404_cov_23.406130	879	959	0	50	80	0.6250000
NODE_2659_length_1404_cov_23.406130	879	959	4	30	80	0.3750000
NODE_2659_length_1404_cov_23.406130	955	1035	4	57	80	0.7125000
NODE_2659_length_1404_cov_23.406130	955	1035	8	23	80	0.2875000
NODE_2659_length_1404_cov_23.406130	1008	1088	0	3	80	0.0375000
NODE_2659_length_1404_cov_23.406130	1008	1088	4	48	80	0.6000000
NODE_2659_length_1404_cov_23.406130	1008	1088	8	29	80	0.3625000
NODE_2666_length_1403_cov_14.331288	325	405	0	80	80	1.0000000
NODE_2666_length_1403_cov_14.331288	378	458	0	62	80	0.7750000
NODE_2666_length_1403_cov_14.331288	378	458	4	18	80	0.2250000
NODE_2666_length_1403_cov_14.331288	454	534	4	80	80	1.0000000
NODE_2666_length_1403_cov_14.331288	454	534	4	80	80	1.0000000
NODE_2666_length_1403_cov_14.331288	454	524	4	70	70	1.0000000
NODE_2666_length_1403_cov_14.331288	507	587	0	21	80	0.2625000
NODE_2666_length_1403_cov_14.331288	507	587	2	1	80	0.0125000
NODE_2666_length_1403_cov_14.331288	507	587	4	58	80	0.7250000
NODE_2666_length_1403_cov_14.331288	507	579	0	15	72	0.2083333
NODE_2666_length_1403_cov_14.331288	507	579	4	57	72	0.7916667
NODE_2668_length_1402_cov_29.095165	610	690	0	13	80	0.1625000
NODE_2668_length_1402_cov_29.095165	610	690	3	1	80	0.0125000
NODE_2668_length_1402_cov_29.095165	610	690	4	66	80	0.8250000
NODE_2668_length_1402_cov_29.095165	663	743	0	39	80	0.4875000
NODE_2668_length_1402_cov_29.095165	663	743	4	41	80	0.5125000
NODE_2669_length_1402_cov_23.411358	528	608	0	14	80	0.1750000
NODE_2669_length_1402_cov_23.411358	528	608	2	66	80	0.8250000
NODE_2669_length_1402_cov_23.411358	581	661	0	60	80	0.7500000
NODE_2669_length_1402_cov_23.411358	581	661	2	13	80	0.1625000
NODE_2669_length_1402_cov_23.411358	581	661	3	2	80	0.0250000
NODE_2669_length_1402_cov_23.411358	581	661	4	5	80	0.0625000
NODE_2669_length_1402_cov_23.411358	657	737	4	4	80	0.0500000
NODE_2669_length_1402_cov_23.411358	657	737	6	76	80	0.9500000
NODE_2669_length_1402_cov_23.411358	710	790	0	10	80	0.1250000
NODE_2669_length_1402_cov_23.411358	710	790	4	35	80	0.4375000
NODE_2669_length_1402_cov_23.411358	710	790	6	35	80	0.4375000
NODE_2670_length_1402_cov_11.732924	661	741	0	80	80	1.0000000
NODE_2670_length_1402_cov_11.732924	714	794	0	80	80	1.0000000
NODE_2671_length_1402_cov_9.929394	766	846	0	80	80	1.0000000
NODE_2671_length_1402_cov_9.929394	819	899	0	80	80	1.0000000
NODE_2677_length_1401_cov_35.754992	825	905	4	25	80	0.3125000
NODE_2677_length_1401_cov_35.754992	825	905	6	55	80	0.6875000
NODE_2677_length_1401_cov_35.754992	878	958	0	41	80	0.5125000
NODE_2677_length_1401_cov_35.754992	878	958	4	37	80	0.4625000
NODE_2677_length_1401_cov_35.754992	878	958	6	2	80	0.0250000
NODE_2678_length_1401_cov_10.811828	539	619	0	8	80	0.1000000
NODE_2678_length_1401_cov_10.811828	539	619	2	72	80	0.9000000
NODE_2678_length_1401_cov_10.811828	592	672	0	12	80	0.1500000
NODE_2678_length_1401_cov_10.811828	592	672	2	68	80	0.8500000
NODE_2679_length_1401_cov_5.438556	241	321	0	80	80	1.0000000
NODE_2679_length_1401_cov_5.438556	294	374	0	80	80	1.0000000
NODE_2683_length_1400_cov_16.680246	813	893	0	71	80	0.8875000
NODE_2683_length_1400_cov_16.680246	813	893	2	9	80	0.1125000
NODE_2683_length_1400_cov_16.680246	866	946	0	18	80	0.2250000
NODE_2683_length_1400_cov_16.680246	866	946	2	62	80	0.7750000
NODE_2684_length_1400_cov_8.166795	53	133	0	4	80	0.0500000
NODE_2684_length_1400_cov_8.166795	53	133	2	76	80	0.9500000
NODE_2684_length_1400_cov_8.166795	106	186	0	36	80	0.4500000
NODE_2684_length_1400_cov_8.166795	106	186	2	44	80	0.5500000
NODE_2694_length_1397_cov_25.549307	869	918	11	29	49	0.5918368
NODE_2694_length_1397_cov_25.549307	869	918	14	10	49	0.2040816
NODE_2694_length_1397_cov_25.549307	869	918	18	10	49	0.2040816
NODE_2694_length_1397_cov_25.549307	891	971	11	7	80	0.0875000
NODE_2694_length_1397_cov_25.549307	891	971	14	41	80	0.5125000
NODE_2694_length_1397_cov_25.549307	891	971	15	22	80	0.2750000
NODE_2694_length_1397_cov_25.549307	891	971	18	10	80	0.1250000
NODE_2695_length_1397_cov_14.395223	672	752	0	80	80	1.0000000
NODE_2695_length_1397_cov_14.395223	725	805	0	80	80	1.0000000
NODE_2695_length_1397_cov_14.395223	801	881	0	80	80	1.0000000
NODE_2695_length_1397_cov_14.395223	854	934	0	80	80	1.0000000
NODE_2699_length_1396_cov_21.656130	825	905	0	80	80	1.0000000
NODE_2699_length_1396_cov_21.656130	878	958	0	80	80	1.0000000
NODE_2700_length_1396_cov_18.108712	560	640	2	10	80	0.1250000
NODE_2700_length_1396_cov_18.108712	560	640	9	38	80	0.4750000
NODE_2700_length_1396_cov_18.108712	560	640	11	4	80	0.0500000
NODE_2700_length_1396_cov_18.108712	560	640	15	10	80	0.1250000
NODE_2700_length_1396_cov_18.108712	560	640	16	1	80	0.0125000
NODE_2700_length_1396_cov_18.108712	560	640	17	17	80	0.2125000
NODE_2700_length_1396_cov_18.108712	613	693	13	37	80	0.4625000
NODE_2700_length_1396_cov_18.108712	613	693	15	26	80	0.3250000
NODE_2700_length_1396_cov_18.108712	613	693	16	1	80	0.0125000
NODE_2700_length_1396_cov_18.108712	613	693	17	16	80	0.2000000
NODE_2701_length_1396_cov_16.208944	136	198	2	6	62	0.0967742
NODE_2701_length_1396_cov_16.208944	136	198	3	15	62	0.2419355
NODE_2701_length_1396_cov_16.208944	136	198	4	13	62	0.2096774
NODE_2701_length_1396_cov_16.208944	136	198	6	2	62	0.0322581
NODE_2701_length_1396_cov_16.208944	136	198	8	9	62	0.1451613
NODE_2701_length_1396_cov_16.208944	136	198	10	4	62	0.0645161
NODE_2701_length_1396_cov_16.208944	136	198	13	13	62	0.2096774
NODE_2701_length_1396_cov_16.208944	848	928	2	1	80	0.0125000
NODE_2701_length_1396_cov_16.208944	848	928	4	79	80	0.9875000
NODE_2701_length_1396_cov_16.208944	901	981	0	7	80	0.0875000
NODE_2701_length_1396_cov_16.208944	901	981	2	47	80	0.5875000
NODE_2701_length_1396_cov_16.208944	901	981	4	26	80	0.3250000
NODE_2701_length_1396_cov_16.208944	977	1057	0	24	80	0.3000000
NODE_2701_length_1396_cov_16.208944	977	1057	4	56	80	0.7000000
NODE_2701_length_1396_cov_16.208944	1030	1110	0	29	80	0.3625000
NODE_2701_length_1396_cov_16.208944	1030	1110	4	51	80	0.6375000
NODE_2702_length_1396_cov_9.196608	428	508	0	80	80	1.0000000
NODE_2702_length_1396_cov_9.196608	481	561	0	80	80	1.0000000
NODE_2712_length_1394_cov_29.602317	349	415	0	16	66	0.2424242
NODE_2712_length_1394_cov_29.602317	349	415	2	49	66	0.7424242
NODE_2712_length_1394_cov_29.602317	349	415	4	1	66	0.0151515
NODE_2712_length_1394_cov_29.602317	349	416	0	17	67	0.2537313
NODE_2712_length_1394_cov_29.602317	349	416	2	49	67	0.7313433
NODE_2712_length_1394_cov_29.602317	349	416	4	1	67	0.0149254
NODE_2712_length_1394_cov_29.602317	1117	1197	1	9	80	0.1125000
NODE_2712_length_1394_cov_29.602317	1117	1197	2	71	80	0.8875000
NODE_2712_length_1394_cov_29.602317	1170	1250	2	80	80	1.0000000
NODE_2713_length_1394_cov_6.291892	313	393	0	80	80	1.0000000
NODE_2713_length_1394_cov_6.291892	366	446	0	79	80	0.9875000
NODE_2713_length_1394_cov_6.291892	366	446	2	1	80	0.0125000
NODE_2716_length_1393_cov_14.635240	1286	1339	8	28	53	0.5283019
NODE_2716_length_1393_cov_14.635240	1286	1339	10	24	53	0.4528302
NODE_2716_length_1393_cov_14.635240	1286	1339	12	1	53	0.0188679
NODE_2717_length_1393_cov_12.032457	737	817	0	80	80	1.0000000
NODE_2717_length_1393_cov_12.032457	790	870	0	80	80	1.0000000
NODE_2720_length_1392_cov_5.898685	270	350	0	46	80	0.5750000
NODE_2720_length_1392_cov_5.898685	270	350	4	34	80	0.4250000
NODE_2720_length_1392_cov_5.898685	323	399	0	6	76	0.0789474
NODE_2720_length_1392_cov_5.898685	323	399	4	70	76	0.9210526
NODE_2723_length_1391_cov_35.921827	415	495	0	80	80	1.0000000
NODE_2723_length_1391_cov_35.921827	468	548	0	41	80	0.5125000
NODE_2723_length_1391_cov_35.921827	468	548	4	39	80	0.4875000
NODE_2723_length_1391_cov_35.921827	544	624	0	28	80	0.3500000
NODE_2723_length_1391_cov_35.921827	544	624	4	52	80	0.6500000
NODE_2723_length_1391_cov_35.921827	597	677	0	80	80	1.0000000
NODE_2729_length_1390_cov_16.326878	550	630	0	15	80	0.1875000
NODE_2729_length_1390_cov_16.326878	550	630	13	1	80	0.0125000
NODE_2729_length_1390_cov_16.326878	550	630	14	64	80	0.8000000
NODE_2729_length_1390_cov_16.326878	603	683	14	80	80	1.0000000
NODE_2731_length_1389_cov_29.772093	780	860	0	41	80	0.5125000
NODE_2731_length_1389_cov_29.772093	780	860	3	3	80	0.0375000
NODE_2731_length_1389_cov_29.772093	780	860	6	30	80	0.3750000
NODE_2731_length_1389_cov_29.772093	780	860	8	6	80	0.0750000
NODE_2731_length_1389_cov_29.772093	833	913	6	21	80	0.2625000
NODE_2731_length_1389_cov_29.772093	833	913	8	19	80	0.2375000
NODE_2731_length_1389_cov_29.772093	833	913	10	40	80	0.5000000
NODE_2732_length_1389_cov_12.858140	821	901	4	80	80	1.0000000
NODE_2732_length_1389_cov_12.858140	874	954	4	80	80	1.0000000
NODE_2735_length_1388_cov_14.641583	529	610	0	33	81	0.4074074
NODE_2735_length_1388_cov_14.641583	529	610	4	14	81	0.1728395
NODE_2735_length_1388_cov_14.641583	529	610	6	2	81	0.0246914
NODE_2735_length_1388_cov_14.641583	529	610	7	32	81	0.3950617
NODE_2735_length_1388_cov_14.641583	583	660	7	40	77	0.5194805
NODE_2735_length_1388_cov_14.641583	583	660	8	37	77	0.4805195
NODE_2736_length_1388_cov_5.168348	427	499	30	5	72	0.0694444
NODE_2736_length_1388_cov_5.168348	427	499	32	3	72	0.0416667
NODE_2736_length_1388_cov_5.168348	427	499	34	2	72	0.0277778
NODE_2736_length_1388_cov_5.168348	427	499	38	12	72	0.1666667
NODE_2736_length_1388_cov_5.168348	427	499	42	10	72	0.1388889
NODE_2736_length_1388_cov_5.168348	427	499	44	5	72	0.0694444
NODE_2736_length_1388_cov_5.168348	427	499	45	1	72	0.0138889
NODE_2736_length_1388_cov_5.168348	427	499	47	3	72	0.0416667
NODE_2736_length_1388_cov_5.168348	427	499	49	16	72	0.2222222
NODE_2736_length_1388_cov_5.168348	427	499	50	6	72	0.0833333
NODE_2736_length_1388_cov_5.168348	427	499	51	9	72	0.1250000
NODE_2742_length_1386_cov_55.384615	559	639	0	80	80	1.0000000
NODE_2742_length_1386_cov_55.384615	612	692	0	55	80	0.6875000
NODE_2742_length_1386_cov_55.384615	612	692	4	25	80	0.3125000
NODE_2742_length_1386_cov_55.384615	688	768	4	63	80	0.7875000
NODE_2742_length_1386_cov_55.384615	688	768	8	17	80	0.2125000
NODE_2742_length_1386_cov_55.384615	741	821	4	65	80	0.8125000
NODE_2742_length_1386_cov_55.384615	741	821	8	15	80	0.1875000
NODE_2744_length_1386_cov_13.181041	549	629	0	80	80	1.0000000
NODE_2744_length_1386_cov_13.181041	602	682	0	80	80	1.0000000
NODE_2748_length_1385_cov_41.636081	968	1048	0	80	80	1.0000000
NODE_2748_length_1385_cov_41.636081	1021	1101	0	80	80	1.0000000
NODE_2749_length_1385_cov_38.877138	707	787	2	45	80	0.5625000
NODE_2749_length_1385_cov_38.877138	707	787	4	35	80	0.4375000
NODE_2749_length_1385_cov_38.877138	760	840	2	44	80	0.5500000
NODE_2749_length_1385_cov_38.877138	760	840	4	36	80	0.4500000
NODE_2749_length_1385_cov_38.877138	836	916	0	43	80	0.5375000
NODE_2749_length_1385_cov_38.877138	836	916	2	28	80	0.3500000
NODE_2749_length_1385_cov_38.877138	836	916	4	9	80	0.1125000
NODE_2749_length_1385_cov_38.877138	889	969	0	80	80	1.0000000
NODE_2751_length_1385_cov_4.608865	844	904	2	15	60	0.2500000
NODE_2751_length_1385_cov_4.608865	844	904	4	33	60	0.5500000
NODE_2751_length_1385_cov_4.608865	844	904	6	12	60	0.2000000
NODE_2758_length_1384_cov_10.574319	865	922	0	57	57	1.0000000
NODE_2758_length_1384_cov_10.574319	933	1013	0	39	80	0.4875000
NODE_2758_length_1384_cov_10.574319	933	1013	2	23	80	0.2875000
NODE_2758_length_1384_cov_10.574319	933	1013	4	18	80	0.2250000
NODE_2758_length_1384_cov_10.574319	986	1066	2	9	80	0.1125000
NODE_2758_length_1384_cov_10.574319	986	1066	4	71	80	0.8875000
NODE_2759_length_1383_cov_10.710280	414	493	0	79	79	1.0000000
NODE_2759_length_1383_cov_10.710280	466	546	0	80	80	1.0000000
NODE_2763_length_1382_cov_12.521434	837	917	0	80	80	1.0000000
NODE_2763_length_1382_cov_12.521434	890	970	0	80	80	1.0000000
NODE_2764_length_1382_cov_5.074045	1028	1108	0	80	80	1.0000000
NODE_2764_length_1382_cov_5.074045	1081	1161	0	80	80	1.0000000
NODE_2771_length_1381_cov_7.796412	307	387	0	80	80	1.0000000
NODE_2771_length_1381_cov_7.796412	360	440	0	80	80	1.0000000
NODE_2775_length_1380_cov_12.804059	835	915	0	80	80	1.0000000
NODE_2775_length_1380_cov_12.804059	888	968	0	80	80	1.0000000
NODE_2782_length_1378_cov_25.362002	368	448	4	80	80	1.0000000
NODE_2782_length_1378_cov_25.362002	421	501	4	80	80	1.0000000
NODE_2782_length_1378_cov_25.362002	497	577	0	68	80	0.8500000
NODE_2782_length_1378_cov_25.362002	497	577	4	12	80	0.1500000
NODE_2782_length_1378_cov_25.362002	550	630	0	80	80	1.0000000
NODE_2783_length_1378_cov_20.508210	318	338	16	2	20	0.1000000
NODE_2783_length_1378_cov_20.508210	318	338	17	3	20	0.1500000
NODE_2783_length_1378_cov_20.508210	318	338	30	1	20	0.0500000
NODE_2783_length_1378_cov_20.508210	318	338	33	4	20	0.2000000
NODE_2783_length_1378_cov_20.508210	318	338	35	3	20	0.1500000
NODE_2783_length_1378_cov_20.508210	318	338	36	3	20	0.1500000
NODE_2783_length_1378_cov_20.508210	318	338	38	4	20	0.2000000
NODE_2783_length_1378_cov_20.508210	318	391	16	2	73	0.0273973
NODE_2783_length_1378_cov_20.508210	318	391	17	3	73	0.0410959
NODE_2783_length_1378_cov_20.508210	318	391	30	1	73	0.0136986
NODE_2783_length_1378_cov_20.508210	318	391	33	4	73	0.0547945
NODE_2783_length_1378_cov_20.508210	318	391	35	3	73	0.0410959
NODE_2783_length_1378_cov_20.508210	318	391	36	3	73	0.0410959
NODE_2783_length_1378_cov_20.508210	318	391	38	8	73	0.1095890
NODE_2783_length_1378_cov_20.508210	318	391	39	3	73	0.0410959
NODE_2783_length_1378_cov_20.508210	318	391	41	1	73	0.0136986
NODE_2783_length_1378_cov_20.508210	318	391	44	6	73	0.0821918
NODE_2783_length_1378_cov_20.508210	318	391	45	1	73	0.0136986
NODE_2783_length_1378_cov_20.508210	318	391	49	10	73	0.1369863
NODE_2783_length_1378_cov_20.508210	318	391	50	2	73	0.0273973
NODE_2783_length_1378_cov_20.508210	318	391	52	9	73	0.1232877
NODE_2783_length_1378_cov_20.508210	318	391	53	6	73	0.0821918
NODE_2783_length_1378_cov_20.508210	318	391	54	6	73	0.0821918
NODE_2783_length_1378_cov_20.508210	318	391	57	1	73	0.0136986
NODE_2783_length_1378_cov_20.508210	318	391	58	2	73	0.0273973
NODE_2783_length_1378_cov_20.508210	318	391	60	2	73	0.0273973
NODE_2785_length_1377_cov_103.832551	1259	1299	315	1	40	0.0250000
NODE_2785_length_1377_cov_103.832551	1259	1299	320	1	40	0.0250000
NODE_2785_length_1377_cov_103.832551	1259	1299	323	1	40	0.0250000
NODE_2785_length_1377_cov_103.832551	1259	1299	325	1	40	0.0250000
NODE_2785_length_1377_cov_103.832551	1259	1299	328	1	40	0.0250000
NODE_2785_length_1377_cov_103.832551	1259	1299	330	1	40	0.0250000
NODE_2785_length_1377_cov_103.832551	1259	1299	333	1	40	0.0250000
NODE_2785_length_1377_cov_103.832551	1259	1299	338	2	40	0.0500000
NODE_2785_length_1377_cov_103.832551	1259	1299	342	1	40	0.0250000
NODE_2785_length_1377_cov_103.832551	1259	1299	346	1	40	0.0250000
NODE_2785_length_1377_cov_103.832551	1259	1299	348	1	40	0.0250000
NODE_2785_length_1377_cov_103.832551	1259	1299	356	3	40	0.0750000
NODE_2785_length_1377_cov_103.832551	1259	1299	359	1	40	0.0250000
NODE_2785_length_1377_cov_103.832551	1259	1299	361	1	40	0.0250000
NODE_2785_length_1377_cov_103.832551	1259	1299	369	1	40	0.0250000
NODE_2785_length_1377_cov_103.832551	1259	1299	376	1	40	0.0250000
NODE_2785_length_1377_cov_103.832551	1259	1299	380	1	40	0.0250000
NODE_2785_length_1377_cov_103.832551	1259	1299	384	2	40	0.0500000
NODE_2785_length_1377_cov_103.832551	1259	1299	385	1	40	0.0250000
NODE_2785_length_1377_cov_103.832551	1259	1299	387	1	40	0.0250000
NODE_2785_length_1377_cov_103.832551	1259	1299	390	1	40	0.0250000
NODE_2785_length_1377_cov_103.832551	1259	1299	392	1	40	0.0250000
NODE_2785_length_1377_cov_103.832551	1259	1299	393	2	40	0.0500000
NODE_2785_length_1377_cov_103.832551	1259	1299	395	1	40	0.0250000
NODE_2785_length_1377_cov_103.832551	1259	1299	396	1	40	0.0250000
NODE_2785_length_1377_cov_103.832551	1259	1299	398	1	40	0.0250000
NODE_2785_length_1377_cov_103.832551	1259	1299	399	1	40	0.0250000
NODE_2785_length_1377_cov_103.832551	1259	1299	400	2	40	0.0500000
NODE_2785_length_1377_cov_103.832551	1259	1299	404	1	40	0.0250000
NODE_2785_length_1377_cov_103.832551	1259	1299	408	1	40	0.0250000
NODE_2785_length_1377_cov_103.832551	1259	1299	412	1	40	0.0250000
NODE_2785_length_1377_cov_103.832551	1259	1299	413	1	40	0.0250000
NODE_2785_length_1377_cov_103.832551	1259	1299	415	1	40	0.0250000
NODE_2785_length_1377_cov_103.832551	1259	1299	416	1	40	0.0250000
NODE_2788_length_1376_cov_7.967110	904	984	0	80	80	1.0000000
NODE_2788_length_1376_cov_7.967110	957	1037	0	80	80	1.0000000
NODE_2798_length_1373_cov_52.691523	524	606	0	82	82	1.0000000
NODE_2798_length_1373_cov_52.691523	579	659	0	80	80	1.0000000
NODE_2799_length_1373_cov_20.880691	987	1067	4	80	80	1.0000000
NODE_2799_length_1373_cov_20.880691	1116	1195	1	3	79	0.0379747
NODE_2799_length_1373_cov_20.880691	1116	1195	2	20	79	0.2531646
NODE_2799_length_1373_cov_20.880691	1116	1195	4	19	79	0.2405063
NODE_2799_length_1373_cov_20.880691	1116	1195	8	20	79	0.2531646
NODE_2799_length_1373_cov_20.880691	1116	1195	12	17	79	0.2151899
NODE_2799_length_1373_cov_20.880691	1168	1248	8	10	80	0.1250000
NODE_2799_length_1373_cov_20.880691	1168	1248	11	9	80	0.1125000
NODE_2799_length_1373_cov_20.880691	1168	1248	12	49	80	0.6125000
NODE_2799_length_1373_cov_20.880691	1168	1248	15	12	80	0.1500000
NODE_2800_length_1373_cov_12.694662	94	167	10	28	73	0.3835616
NODE_2800_length_1373_cov_12.694662	94	167	12	1	73	0.0136986
NODE_2800_length_1373_cov_12.694662	94	167	14	1	73	0.0136986
NODE_2800_length_1373_cov_12.694662	94	167	18	1	73	0.0136986
NODE_2800_length_1373_cov_12.694662	94	167	19	1	73	0.0136986
NODE_2800_length_1373_cov_12.694662	94	167	20	7	73	0.0958904
NODE_2800_length_1373_cov_12.694662	94	167	22	1	73	0.0136986
NODE_2800_length_1373_cov_12.694662	94	167	24	7	73	0.0958904
NODE_2800_length_1373_cov_12.694662	94	167	26	8	73	0.1095890
NODE_2800_length_1373_cov_12.694662	94	167	33	3	73	0.0410959
NODE_2800_length_1373_cov_12.694662	94	167	34	7	73	0.0958904
NODE_2800_length_1373_cov_12.694662	94	167	35	1	73	0.0136986
NODE_2800_length_1373_cov_12.694662	94	167	36	2	73	0.0273973
NODE_2800_length_1373_cov_12.694662	94	167	37	4	73	0.0547945
NODE_2800_length_1373_cov_12.694662	94	167	39	1	73	0.0136986
NODE_2800_length_1373_cov_12.694662	140	224	24	1	84	0.0119048
NODE_2800_length_1373_cov_12.694662	140	224	26	8	84	0.0952381
NODE_2800_length_1373_cov_12.694662	140	224	33	3	84	0.0357143
NODE_2800_length_1373_cov_12.694662	140	224	34	7	84	0.0833333
NODE_2800_length_1373_cov_12.694662	140	224	35	1	84	0.0119048
NODE_2800_length_1373_cov_12.694662	140	224	36	2	84	0.0238095
NODE_2800_length_1373_cov_12.694662	140	224	37	4	84	0.0476190
NODE_2800_length_1373_cov_12.694662	140	224	39	7	84	0.0833333
NODE_2800_length_1373_cov_12.694662	140	224	40	12	84	0.1428571
NODE_2800_length_1373_cov_12.694662	140	224	41	1	84	0.0119048
NODE_2800_length_1373_cov_12.694662	140	224	43	6	84	0.0714286
NODE_2800_length_1373_cov_12.694662	140	224	45	6	84	0.0714286
NODE_2800_length_1373_cov_12.694662	140	224	47	7	84	0.0833333
NODE_2800_length_1373_cov_12.694662	140	224	48	1	84	0.0119048
NODE_2800_length_1373_cov_12.694662	140	224	49	5	84	0.0595238
NODE_2800_length_1373_cov_12.694662	140	224	53	1	84	0.0119048
NODE_2800_length_1373_cov_12.694662	140	224	56	8	84	0.0952381
NODE_2800_length_1373_cov_12.694662	140	224	57	4	84	0.0476190
NODE_2800_length_1373_cov_12.694662	1214	1286	10	7	72	0.0972222
NODE_2800_length_1373_cov_12.694662	1214	1286	12	1	72	0.0138889
NODE_2800_length_1373_cov_12.694662	1214	1286	13	1	72	0.0138889
NODE_2800_length_1373_cov_12.694662	1214	1286	16	15	72	0.2083333
NODE_2800_length_1373_cov_12.694662	1214	1286	18	8	72	0.1111111
NODE_2800_length_1373_cov_12.694662	1214	1286	23	1	72	0.0138889
NODE_2800_length_1373_cov_12.694662	1214	1286	24	39	72	0.5416667
NODE_2800_length_1373_cov_12.694662	1267	1339	12	10	72	0.1388889
NODE_2800_length_1373_cov_12.694662	1267	1339	14	5	72	0.0694444
NODE_2800_length_1373_cov_12.694662	1267	1339	16	53	72	0.7361111
NODE_2800_length_1373_cov_12.694662	1267	1339	18	4	72	0.0555556
NODE_2801_length_1372_cov_25.408484	665	745	6	17	80	0.2125000
NODE_2801_length_1372_cov_25.408484	665	745	12	6	80	0.0750000
NODE_2801_length_1372_cov_25.408484	665	745	14	11	80	0.1375000
NODE_2801_length_1372_cov_25.408484	665	745	16	12	80	0.1500000
NODE_2801_length_1372_cov_25.408484	665	745	20	34	80	0.4250000
NODE_2801_length_1372_cov_25.408484	718	798	0	25	80	0.3125000
NODE_2801_length_1372_cov_25.408484	718	798	2	11	80	0.1375000
NODE_2801_length_1372_cov_25.408484	718	798	6	34	80	0.4250000
NODE_2801_length_1372_cov_25.408484	718	798	12	6	80	0.0750000
NODE_2801_length_1372_cov_25.408484	718	798	16	4	80	0.0500000
NODE_2802_length_1372_cov_17.123331	647	727	0	80	80	1.0000000
NODE_2802_length_1372_cov_17.123331	700	780	0	80	80	1.0000000
NODE_2802_length_1372_cov_17.123331	776	856	0	22	80	0.2750000
NODE_2802_length_1372_cov_17.123331	776	856	2	58	80	0.7250000
NODE_2802_length_1372_cov_17.123331	829	909	2	80	80	1.0000000
NODE_2803_length_1372_cov_14.418696	211	291	0	80	80	1.0000000
NODE_2803_length_1372_cov_14.418696	264	344	0	80	80	1.0000000
NODE_2806_length_1371_cov_39.366352	715	795	0	42	80	0.5250000
NODE_2806_length_1371_cov_39.366352	715	795	8	15	80	0.1875000
NODE_2806_length_1371_cov_39.366352	715	795	14	23	80	0.2875000
NODE_2806_length_1371_cov_39.366352	768	848	8	4	80	0.0500000
NODE_2806_length_1371_cov_39.366352	768	848	14	76	80	0.9500000
NODE_2807_length_1371_cov_36.961478	371	455	2	18	84	0.2142857
NODE_2807_length_1371_cov_36.961478	371	455	4	66	84	0.7857143
NODE_2807_length_1371_cov_36.961478	424	508	0	31	84	0.3690476
NODE_2807_length_1371_cov_36.961478	424	508	2	39	84	0.4642857
NODE_2807_length_1371_cov_36.961478	424	508	4	14	84	0.1666667
NODE_2807_length_1371_cov_36.961478	504	584	0	80	80	1.0000000
NODE_2807_length_1371_cov_36.961478	557	637	0	80	80	1.0000000
NODE_2808_length_1371_cov_16.944182	459	539	0	3	80	0.0375000
NODE_2808_length_1371_cov_16.944182	459	539	1	31	80	0.3875000
NODE_2808_length_1371_cov_16.944182	459	539	2	46	80	0.5750000
NODE_2808_length_1371_cov_16.944182	512	592	2	80	80	1.0000000
NODE_2808_length_1371_cov_16.944182	588	668	0	25	80	0.3125000
NODE_2808_length_1371_cov_16.944182	588	668	1	31	80	0.3875000
NODE_2808_length_1371_cov_16.944182	588	668	2	24	80	0.3000000
NODE_2808_length_1371_cov_16.944182	641	721	0	78	80	0.9750000
NODE_2808_length_1371_cov_16.944182	641	721	1	2	80	0.0250000
NODE_2812_length_1370_cov_11.627065	502	582	0	80	80	1.0000000
NODE_2812_length_1370_cov_11.627065	555	635	0	80	80	1.0000000
NODE_2812_length_1370_cov_11.627065	631	711	0	80	80	1.0000000
NODE_2812_length_1370_cov_11.627065	684	764	0	80	80	1.0000000
NODE_2813_length_1369_cov_27.937795	597	677	0	42	80	0.5250000
NODE_2813_length_1369_cov_27.937795	597	677	3	1	80	0.0125000
NODE_2813_length_1369_cov_27.937795	597	677	5	37	80	0.4625000
NODE_2813_length_1369_cov_27.937795	650	730	5	36	80	0.4500000
NODE_2813_length_1369_cov_27.937795	650	730	6	44	80	0.5500000
NODE_2820_length_1368_cov_35.148148	546	626	0	28	80	0.3500000
NODE_2820_length_1368_cov_35.148148	546	626	2	52	80	0.6500000
NODE_2820_length_1368_cov_35.148148	599	679	0	33	80	0.4125000
NODE_2820_length_1368_cov_35.148148	599	679	2	47	80	0.5875000
NODE_2821_length_1368_cov_27.847912	486	559	0	73	73	1.0000000
NODE_2821_length_1368_cov_27.847912	532	612	0	80	80	1.0000000
NODE_2821_length_1368_cov_27.847912	608	688	0	80	80	1.0000000
NODE_2821_length_1368_cov_27.847912	661	741	0	80	80	1.0000000
NODE_2822_length_1368_cov_26.832151	458	538	0	80	80	1.0000000
NODE_2822_length_1368_cov_26.832151	511	591	0	80	80	1.0000000
NODE_2822_length_1368_cov_26.832151	587	667	0	80	80	1.0000000
NODE_2822_length_1368_cov_26.832151	640	720	0	80	80	1.0000000
NODE_2823_length_1368_cov_18.205674	603	683	0	1	80	0.0125000
NODE_2823_length_1368_cov_18.205674	603	683	2	79	80	0.9875000
NODE_2823_length_1368_cov_18.205674	656	736	0	14	80	0.1750000
NODE_2823_length_1368_cov_18.205674	656	736	2	66	80	0.8250000
NODE_2826_length_1367_cov_576.769716	799	879	601	1	80	0.0125000
NODE_2826_length_1367_cov_576.769716	799	879	602	1	80	0.0125000
NODE_2826_length_1367_cov_576.769716	799	879	604	2	80	0.0250000
NODE_2826_length_1367_cov_576.769716	799	879	605	1	80	0.0125000
NODE_2826_length_1367_cov_576.769716	799	879	606	1	80	0.0125000
NODE_2826_length_1367_cov_576.769716	799	879	607	1	80	0.0125000
NODE_2826_length_1367_cov_576.769716	799	879	608	1	80	0.0125000
NODE_2826_length_1367_cov_576.769716	799	879	610	1	80	0.0125000
NODE_2826_length_1367_cov_576.769716	799	879	611	3	80	0.0375000
NODE_2826_length_1367_cov_576.769716	799	879	614	2	80	0.0250000
NODE_2826_length_1367_cov_576.769716	799	879	615	1	80	0.0125000
NODE_2826_length_1367_cov_576.769716	799	879	616	2	80	0.0250000
NODE_2826_length_1367_cov_576.769716	799	879	618	1	80	0.0125000
NODE_2826_length_1367_cov_576.769716	799	879	619	1	80	0.0125000
NODE_2826_length_1367_cov_576.769716	799	879	620	1	80	0.0125000
NODE_2826_length_1367_cov_576.769716	799	879	621	1	80	0.0125000
NODE_2826_length_1367_cov_576.769716	799	879	622	1	80	0.0125000
NODE_2826_length_1367_cov_576.769716	799	879	623	1	80	0.0125000
NODE_2826_length_1367_cov_576.769716	799	879	625	2	80	0.0250000
NODE_2826_length_1367_cov_576.769716	799	879	627	2	80	0.0250000
NODE_2826_length_1367_cov_576.769716	799	879	629	1	80	0.0125000
NODE_2826_length_1367_cov_576.769716	799	879	634	1	80	0.0125000
NODE_2826_length_1367_cov_576.769716	799	879	645	1	80	0.0125000
NODE_2826_length_1367_cov_576.769716	799	879	647	1	80	0.0125000
NODE_2826_length_1367_cov_576.769716	799	879	663	1	80	0.0125000
NODE_2826_length_1367_cov_576.769716	799	879	666	1	80	0.0125000
NODE_2826_length_1367_cov_576.769716	799	879	671	1	80	0.0125000
NODE_2826_length_1367_cov_576.769716	799	879	675	1	80	0.0125000
NODE_2826_length_1367_cov_576.769716	799	879	676	1	80	0.0125000
NODE_2826_length_1367_cov_576.769716	799	879	678	1	80	0.0125000
NODE_2826_length_1367_cov_576.769716	799	879	688	1	80	0.0125000
NODE_2826_length_1367_cov_576.769716	799	879	721	1	80	0.0125000
NODE_2826_length_1367_cov_576.769716	799	879	738	1	80	0.0125000
NODE_2826_length_1367_cov_576.769716	799	879	743	1	80	0.0125000
NODE_2826_length_1367_cov_576.769716	799	879	790	1	80	0.0125000
NODE_2826_length_1367_cov_576.769716	799	879	804	1	80	0.0125000
NODE_2826_length_1367_cov_576.769716	799	879	828	2	80	0.0250000
NODE_2826_length_1367_cov_576.769716	799	879	832	1	80	0.0125000
NODE_2826_length_1367_cov_576.769716	799	879	833	1	80	0.0125000
NODE_2826_length_1367_cov_576.769716	799	879	834	1	80	0.0125000
NODE_2826_length_1367_cov_576.769716	799	879	836	1	80	0.0125000
NODE_2826_length_1367_cov_576.769716	799	879	855	1	80	0.0125000
NODE_2826_length_1367_cov_576.769716	799	879	875	1	80	0.0125000
NODE_2826_length_1367_cov_576.769716	799	879	936	1	80	0.0125000
NODE_2826_length_1367_cov_576.769716	799	879	954	1	80	0.0125000
NODE_2826_length_1367_cov_576.769716	799	879	958	1	80	0.0125000
NODE_2826_length_1367_cov_576.769716	799	879	997	1	80	0.0125000
NODE_2826_length_1367_cov_576.769716	799	879	1139	1	80	0.0125000
NODE_2826_length_1367_cov_576.769716	799	879	1147	1	80	0.0125000
NODE_2826_length_1367_cov_576.769716	799	879	1152	1	80	0.0125000
NODE_2826_length_1367_cov_576.769716	799	879	1158	1	80	0.0125000
NODE_2826_length_1367_cov_576.769716	799	879	1188	1	80	0.0125000
NODE_2826_length_1367_cov_576.769716	799	879	1208	1	80	0.0125000
NODE_2826_length_1367_cov_576.769716	799	879	1223	2	80	0.0250000
NODE_2826_length_1367_cov_576.769716	799	879	1247	1	80	0.0125000
NODE_2826_length_1367_cov_576.769716	799	879	1320	1	80	0.0125000
NODE_2826_length_1367_cov_576.769716	799	879	1380	1	80	0.0125000
NODE_2826_length_1367_cov_576.769716	799	879	1416	1	80	0.0125000
NODE_2826_length_1367_cov_576.769716	799	879	1418	1	80	0.0125000
NODE_2826_length_1367_cov_576.769716	799	879	1462	1	80	0.0125000
NODE_2826_length_1367_cov_576.769716	799	879	1507	1	80	0.0125000
NODE_2826_length_1367_cov_576.769716	799	879	1588	1	80	0.0125000
NODE_2826_length_1367_cov_576.769716	799	879	1609	1	80	0.0125000
NODE_2826_length_1367_cov_576.769716	799	879	1623	1	80	0.0125000
NODE_2826_length_1367_cov_576.769716	799	879	1639	1	80	0.0125000
NODE_2826_length_1367_cov_576.769716	799	879	1707	1	80	0.0125000
NODE_2826_length_1367_cov_576.769716	799	879	1741	1	80	0.0125000
NODE_2826_length_1367_cov_576.769716	799	879	1744	2	80	0.0250000
NODE_2826_length_1367_cov_576.769716	799	879	1758	1	80	0.0125000
NODE_2826_length_1367_cov_576.769716	799	879	1759	1	80	0.0125000
NODE_2826_length_1367_cov_576.769716	852	932	958	1	80	0.0125000
NODE_2826_length_1367_cov_576.769716	852	932	997	1	80	0.0125000
NODE_2826_length_1367_cov_576.769716	852	932	1139	1	80	0.0125000
NODE_2826_length_1367_cov_576.769716	852	932	1147	1	80	0.0125000
NODE_2826_length_1367_cov_576.769716	852	932	1152	1	80	0.0125000
NODE_2826_length_1367_cov_576.769716	852	932	1158	1	80	0.0125000
NODE_2826_length_1367_cov_576.769716	852	932	1188	1	80	0.0125000
NODE_2826_length_1367_cov_576.769716	852	932	1208	1	80	0.0125000
NODE_2826_length_1367_cov_576.769716	852	932	1223	2	80	0.0250000
NODE_2826_length_1367_cov_576.769716	852	932	1247	1	80	0.0125000
NODE_2826_length_1367_cov_576.769716	852	932	1320	1	80	0.0125000
NODE_2826_length_1367_cov_576.769716	852	932	1380	1	80	0.0125000
NODE_2826_length_1367_cov_576.769716	852	932	1416	1	80	0.0125000
NODE_2826_length_1367_cov_576.769716	852	932	1418	1	80	0.0125000
NODE_2826_length_1367_cov_576.769716	852	932	1462	1	80	0.0125000
NODE_2826_length_1367_cov_576.769716	852	932	1507	1	80	0.0125000
NODE_2826_length_1367_cov_576.769716	852	932	1588	1	80	0.0125000
NODE_2826_length_1367_cov_576.769716	852	932	1609	1	80	0.0125000
NODE_2826_length_1367_cov_576.769716	852	932	1623	1	80	0.0125000
NODE_2826_length_1367_cov_576.769716	852	932	1639	1	80	0.0125000
NODE_2826_length_1367_cov_576.769716	852	932	1707	1	80	0.0125000
NODE_2826_length_1367_cov_576.769716	852	932	1741	1	80	0.0125000
NODE_2826_length_1367_cov_576.769716	852	932	1744	2	80	0.0250000
NODE_2826_length_1367_cov_576.769716	852	932	1758	1	80	0.0125000
NODE_2826_length_1367_cov_576.769716	852	932	1759	1	80	0.0125000
NODE_2826_length_1367_cov_576.769716	852	932	1768	1	80	0.0125000
NODE_2826_length_1367_cov_576.769716	852	932	1772	1	80	0.0125000
NODE_2826_length_1367_cov_576.769716	852	932	1781	1	80	0.0125000
NODE_2826_length_1367_cov_576.769716	852	932	1801	1	80	0.0125000
NODE_2826_length_1367_cov_576.769716	852	932	1802	1	80	0.0125000
NODE_2826_length_1367_cov_576.769716	852	932	1820	1	80	0.0125000
NODE_2826_length_1367_cov_576.769716	852	932	1836	1	80	0.0125000
NODE_2826_length_1367_cov_576.769716	852	932	1837	2	80	0.0250000
NODE_2826_length_1367_cov_576.769716	852	932	1866	1	80	0.0125000
NODE_2826_length_1367_cov_576.769716	852	932	1879	1	80	0.0125000
NODE_2826_length_1367_cov_576.769716	852	932	1882	1	80	0.0125000
NODE_2826_length_1367_cov_576.769716	852	932	1915	1	80	0.0125000
NODE_2826_length_1367_cov_576.769716	852	932	1945	2	80	0.0250000
NODE_2826_length_1367_cov_576.769716	852	932	1949	1	80	0.0125000
NODE_2826_length_1367_cov_576.769716	852	932	1950	1	80	0.0125000
NODE_2826_length_1367_cov_576.769716	852	932	1962	1	80	0.0125000
NODE_2826_length_1367_cov_576.769716	852	932	1968	1	80	0.0125000
NODE_2826_length_1367_cov_576.769716	852	932	1969	3	80	0.0375000
NODE_2826_length_1367_cov_576.769716	852	932	1973	1	80	0.0125000
NODE_2826_length_1367_cov_576.769716	852	932	1974	6	80	0.0750000
NODE_2826_length_1367_cov_576.769716	852	932	1976	1	80	0.0125000
NODE_2826_length_1367_cov_576.769716	852	932	1978	2	80	0.0250000
NODE_2826_length_1367_cov_576.769716	852	932	1980	3	80	0.0375000
NODE_2826_length_1367_cov_576.769716	852	932	1982	2	80	0.0250000
NODE_2826_length_1367_cov_576.769716	852	932	1983	1	80	0.0125000
NODE_2826_length_1367_cov_576.769716	852	932	1984	1	80	0.0125000
NODE_2826_length_1367_cov_576.769716	852	932	1985	2	80	0.0250000
NODE_2826_length_1367_cov_576.769716	852	932	1987	1	80	0.0125000
NODE_2826_length_1367_cov_576.769716	852	932	1988	1	80	0.0125000
NODE_2826_length_1367_cov_576.769716	852	932	1989	1	80	0.0125000
NODE_2826_length_1367_cov_576.769716	852	932	1990	1	80	0.0125000
NODE_2826_length_1367_cov_576.769716	852	932	1991	1	80	0.0125000
NODE_2826_length_1367_cov_576.769716	852	932	1994	3	80	0.0375000
NODE_2826_length_1367_cov_576.769716	852	932	1995	2	80	0.0250000
NODE_2826_length_1367_cov_576.769716	852	932	1997	1	80	0.0125000
NODE_2826_length_1367_cov_576.769716	852	932	1998	1	80	0.0125000
NODE_2826_length_1367_cov_576.769716	900	980	1472	1	80	0.0125000
NODE_2826_length_1367_cov_576.769716	900	980	1507	1	80	0.0125000
NODE_2826_length_1367_cov_576.769716	900	980	1575	1	80	0.0125000
NODE_2826_length_1367_cov_576.769716	900	980	1582	1	80	0.0125000
NODE_2826_length_1367_cov_576.769716	900	980	1601	1	80	0.0125000
NODE_2826_length_1367_cov_576.769716	900	980	1611	1	80	0.0125000
NODE_2826_length_1367_cov_576.769716	900	980	1627	1	80	0.0125000
NODE_2826_length_1367_cov_576.769716	900	980	1649	1	80	0.0125000
NODE_2826_length_1367_cov_576.769716	900	980	1676	1	80	0.0125000
NODE_2826_length_1367_cov_576.769716	900	980	1704	1	80	0.0125000
NODE_2826_length_1367_cov_576.769716	900	980	1707	1	80	0.0125000
NODE_2826_length_1367_cov_576.769716	900	980	1731	1	80	0.0125000
NODE_2826_length_1367_cov_576.769716	900	980	1739	1	80	0.0125000
NODE_2826_length_1367_cov_576.769716	900	980	1758	1	80	0.0125000
NODE_2826_length_1367_cov_576.769716	900	980	1761	2	80	0.0250000
NODE_2826_length_1367_cov_576.769716	900	980	1762	3	80	0.0375000
NODE_2826_length_1367_cov_576.769716	900	980	1786	1	80	0.0125000
NODE_2826_length_1367_cov_576.769716	900	980	1794	1	80	0.0125000
NODE_2826_length_1367_cov_576.769716	900	980	1798	1	80	0.0125000
NODE_2826_length_1367_cov_576.769716	900	980	1804	1	80	0.0125000
NODE_2826_length_1367_cov_576.769716	900	980	1811	1	80	0.0125000
NODE_2826_length_1367_cov_576.769716	900	980	1816	1	80	0.0125000
NODE_2826_length_1367_cov_576.769716	900	980	1819	1	80	0.0125000
NODE_2826_length_1367_cov_576.769716	900	980	1833	1	80	0.0125000
NODE_2826_length_1367_cov_576.769716	900	980	1853	2	80	0.0250000
NODE_2826_length_1367_cov_576.769716	900	980	1862	1	80	0.0125000
NODE_2826_length_1367_cov_576.769716	900	980	1864	1	80	0.0125000
NODE_2826_length_1367_cov_576.769716	900	980	1866	1	80	0.0125000
NODE_2826_length_1367_cov_576.769716	900	980	1868	1	80	0.0125000
NODE_2826_length_1367_cov_576.769716	900	980	1881	1	80	0.0125000
NODE_2826_length_1367_cov_576.769716	900	980	1884	1	80	0.0125000
NODE_2826_length_1367_cov_576.769716	900	980	1890	1	80	0.0125000
NODE_2826_length_1367_cov_576.769716	900	980	1906	1	80	0.0125000
NODE_2826_length_1367_cov_576.769716	900	980	1911	1	80	0.0125000
NODE_2826_length_1367_cov_576.769716	900	980	1912	1	80	0.0125000
NODE_2826_length_1367_cov_576.769716	900	980	1917	2	80	0.0250000
NODE_2826_length_1367_cov_576.769716	900	980	1918	1	80	0.0125000
NODE_2826_length_1367_cov_576.769716	900	980	1919	2	80	0.0250000
NODE_2826_length_1367_cov_576.769716	900	980	1922	1	80	0.0125000
NODE_2826_length_1367_cov_576.769716	900	980	1923	1	80	0.0125000
NODE_2826_length_1367_cov_576.769716	900	980	1935	1	80	0.0125000
NODE_2826_length_1367_cov_576.769716	900	980	1938	1	80	0.0125000
NODE_2826_length_1367_cov_576.769716	900	980	1945	2	80	0.0250000
NODE_2826_length_1367_cov_576.769716	900	980	1949	1	80	0.0125000
NODE_2826_length_1367_cov_576.769716	900	980	1969	1	80	0.0125000
NODE_2826_length_1367_cov_576.769716	900	980	1974	4	80	0.0500000
NODE_2826_length_1367_cov_576.769716	900	980	1976	1	80	0.0125000
NODE_2826_length_1367_cov_576.769716	900	980	1978	2	80	0.0250000
NODE_2826_length_1367_cov_576.769716	900	980	1980	3	80	0.0375000
NODE_2826_length_1367_cov_576.769716	900	980	1982	2	80	0.0250000
NODE_2826_length_1367_cov_576.769716	900	980	1983	1	80	0.0125000
NODE_2826_length_1367_cov_576.769716	900	980	1984	1	80	0.0125000
NODE_2826_length_1367_cov_576.769716	900	980	1985	2	80	0.0250000
NODE_2826_length_1367_cov_576.769716	900	980	1987	1	80	0.0125000
NODE_2826_length_1367_cov_576.769716	900	980	1988	1	80	0.0125000
NODE_2826_length_1367_cov_576.769716	900	980	1989	1	80	0.0125000
NODE_2826_length_1367_cov_576.769716	900	980	1990	1	80	0.0125000
NODE_2826_length_1367_cov_576.769716	900	980	1991	1	80	0.0125000
NODE_2826_length_1367_cov_576.769716	900	980	1994	3	80	0.0375000
NODE_2826_length_1367_cov_576.769716	900	980	1995	2	80	0.0250000
NODE_2826_length_1367_cov_576.769716	900	980	1997	1	80	0.0125000
NODE_2826_length_1367_cov_576.769716	900	980	1998	1	80	0.0125000
NODE_2826_length_1367_cov_576.769716	905	927	1974	1	22	0.0454545
NODE_2826_length_1367_cov_576.769716	905	927	1976	1	22	0.0454545
NODE_2826_length_1367_cov_576.769716	905	927	1980	2	22	0.0909091
NODE_2826_length_1367_cov_576.769716	905	927	1982	2	22	0.0909091
NODE_2826_length_1367_cov_576.769716	905	927	1983	1	22	0.0454545
NODE_2826_length_1367_cov_576.769716	905	927	1984	1	22	0.0454545
NODE_2826_length_1367_cov_576.769716	905	927	1985	2	22	0.0909091
NODE_2826_length_1367_cov_576.769716	905	927	1987	1	22	0.0454545
NODE_2826_length_1367_cov_576.769716	905	927	1988	1	22	0.0454545
NODE_2826_length_1367_cov_576.769716	905	927	1989	1	22	0.0454545
NODE_2826_length_1367_cov_576.769716	905	927	1990	1	22	0.0454545
NODE_2826_length_1367_cov_576.769716	905	927	1991	1	22	0.0454545
NODE_2826_length_1367_cov_576.769716	905	927	1994	3	22	0.1363636
NODE_2826_length_1367_cov_576.769716	905	927	1995	2	22	0.0909091
NODE_2826_length_1367_cov_576.769716	905	927	1997	1	22	0.0454545
NODE_2826_length_1367_cov_576.769716	905	927	1998	1	22	0.0454545
NODE_2826_length_1367_cov_576.769716	1051	1131	75	1	80	0.0125000
NODE_2826_length_1367_cov_576.769716	1051	1131	78	4	80	0.0500000
NODE_2826_length_1367_cov_576.769716	1051	1131	79	4	80	0.0500000
NODE_2826_length_1367_cov_576.769716	1051	1131	80	2	80	0.0250000
NODE_2826_length_1367_cov_576.769716	1051	1131	82	2	80	0.0250000
NODE_2826_length_1367_cov_576.769716	1051	1131	85	4	80	0.0500000
NODE_2826_length_1367_cov_576.769716	1051	1131	87	4	80	0.0500000
NODE_2826_length_1367_cov_576.769716	1051	1131	91	1	80	0.0125000
NODE_2826_length_1367_cov_576.769716	1051	1131	92	1	80	0.0125000
NODE_2826_length_1367_cov_576.769716	1051	1131	94	2	80	0.0250000
NODE_2826_length_1367_cov_576.769716	1051	1131	97	1	80	0.0125000
NODE_2826_length_1367_cov_576.769716	1051	1131	98	1	80	0.0125000
NODE_2826_length_1367_cov_576.769716	1051	1131	99	1	80	0.0125000
NODE_2826_length_1367_cov_576.769716	1051	1131	101	1	80	0.0125000
NODE_2826_length_1367_cov_576.769716	1051	1131	103	3	80	0.0375000
NODE_2826_length_1367_cov_576.769716	1051	1131	104	2	80	0.0250000
NODE_2826_length_1367_cov_576.769716	1051	1131	105	1	80	0.0125000
NODE_2826_length_1367_cov_576.769716	1051	1131	106	2	80	0.0250000
NODE_2826_length_1367_cov_576.769716	1051	1131	109	1	80	0.0125000
NODE_2826_length_1367_cov_576.769716	1051	1131	112	1	80	0.0125000
NODE_2826_length_1367_cov_576.769716	1051	1131	113	2	80	0.0250000
NODE_2826_length_1367_cov_576.769716	1051	1131	116	1	80	0.0125000
NODE_2826_length_1367_cov_576.769716	1051	1131	122	2	80	0.0250000
NODE_2826_length_1367_cov_576.769716	1051	1131	141	1	80	0.0125000
NODE_2826_length_1367_cov_576.769716	1051	1131	152	2	80	0.0250000
NODE_2826_length_1367_cov_576.769716	1051	1131	153	2	80	0.0250000
NODE_2826_length_1367_cov_576.769716	1051	1131	161	1	80	0.0125000
NODE_2826_length_1367_cov_576.769716	1051	1131	165	1	80	0.0125000
NODE_2826_length_1367_cov_576.769716	1051	1131	166	3	80	0.0375000
NODE_2826_length_1367_cov_576.769716	1051	1131	167	2	80	0.0250000
NODE_2826_length_1367_cov_576.769716	1051	1131	172	1	80	0.0125000
NODE_2826_length_1367_cov_576.769716	1051	1131	174	1	80	0.0125000
NODE_2826_length_1367_cov_576.769716	1051	1131	175	2	80	0.0250000
NODE_2826_length_1367_cov_576.769716	1051	1131	176	1	80	0.0125000
NODE_2826_length_1367_cov_576.769716	1051	1131	177	1	80	0.0125000
NODE_2826_length_1367_cov_576.769716	1051	1131	178	3	80	0.0375000
NODE_2826_length_1367_cov_576.769716	1051	1131	179	1	80	0.0125000
NODE_2826_length_1367_cov_576.769716	1051	1131	184	1	80	0.0125000
NODE_2826_length_1367_cov_576.769716	1051	1131	186	1	80	0.0125000
NODE_2826_length_1367_cov_576.769716	1051	1131	192	1	80	0.0125000
NODE_2826_length_1367_cov_576.769716	1051	1131	200	1	80	0.0125000
NODE_2826_length_1367_cov_576.769716	1051	1131	204	1	80	0.0125000
NODE_2826_length_1367_cov_576.769716	1051	1131	206	2	80	0.0250000
NODE_2826_length_1367_cov_576.769716	1051	1131	209	1	80	0.0125000
NODE_2826_length_1367_cov_576.769716	1051	1131	213	1	80	0.0125000
NODE_2826_length_1367_cov_576.769716	1051	1131	215	1	80	0.0125000
NODE_2826_length_1367_cov_576.769716	1051	1131	222	1	80	0.0125000
NODE_2826_length_1367_cov_576.769716	1051	1131	223	2	80	0.0250000
NODE_2826_length_1367_cov_576.769716	1051	1131	224	1	80	0.0125000
NODE_2826_length_1367_cov_576.769716	1104	1184	166	1	80	0.0125000
NODE_2826_length_1367_cov_576.769716	1104	1184	167	2	80	0.0250000
NODE_2826_length_1367_cov_576.769716	1104	1184	172	1	80	0.0125000
NODE_2826_length_1367_cov_576.769716	1104	1184	174	1	80	0.0125000
NODE_2826_length_1367_cov_576.769716	1104	1184	175	2	80	0.0250000
NODE_2826_length_1367_cov_576.769716	1104	1184	176	1	80	0.0125000
NODE_2826_length_1367_cov_576.769716	1104	1184	177	1	80	0.0125000
NODE_2826_length_1367_cov_576.769716	1104	1184	178	3	80	0.0375000
NODE_2826_length_1367_cov_576.769716	1104	1184	179	1	80	0.0125000
NODE_2826_length_1367_cov_576.769716	1104	1184	184	1	80	0.0125000
NODE_2826_length_1367_cov_576.769716	1104	1184	186	1	80	0.0125000
NODE_2826_length_1367_cov_576.769716	1104	1184	192	1	80	0.0125000
NODE_2826_length_1367_cov_576.769716	1104	1184	200	1	80	0.0125000
NODE_2826_length_1367_cov_576.769716	1104	1184	204	1	80	0.0125000
NODE_2826_length_1367_cov_576.769716	1104	1184	206	2	80	0.0250000
NODE_2826_length_1367_cov_576.769716	1104	1184	209	1	80	0.0125000
NODE_2826_length_1367_cov_576.769716	1104	1184	213	1	80	0.0125000
NODE_2826_length_1367_cov_576.769716	1104	1184	215	1	80	0.0125000
NODE_2826_length_1367_cov_576.769716	1104	1184	222	1	80	0.0125000
NODE_2826_length_1367_cov_576.769716	1104	1184	223	2	80	0.0250000
NODE_2826_length_1367_cov_576.769716	1104	1184	224	1	80	0.0125000
NODE_2826_length_1367_cov_576.769716	1104	1184	226	1	80	0.0125000
NODE_2826_length_1367_cov_576.769716	1104	1184	227	3	80	0.0375000
NODE_2826_length_1367_cov_576.769716	1104	1184	231	1	80	0.0125000
NODE_2826_length_1367_cov_576.769716	1104	1184	232	1	80	0.0125000
NODE_2826_length_1367_cov_576.769716	1104	1184	236	1	80	0.0125000
NODE_2826_length_1367_cov_576.769716	1104	1184	238	2	80	0.0250000
NODE_2826_length_1367_cov_576.769716	1104	1184	242	1	80	0.0125000
NODE_2826_length_1367_cov_576.769716	1104	1184	244	1	80	0.0125000
NODE_2826_length_1367_cov_576.769716	1104	1184	245	2	80	0.0250000
NODE_2826_length_1367_cov_576.769716	1104	1184	250	1	80	0.0125000
NODE_2826_length_1367_cov_576.769716	1104	1184	254	1	80	0.0125000
NODE_2826_length_1367_cov_576.769716	1104	1184	255	1	80	0.0125000
NODE_2826_length_1367_cov_576.769716	1104	1184	260	1	80	0.0125000
NODE_2826_length_1367_cov_576.769716	1104	1184	265	1	80	0.0125000
NODE_2826_length_1367_cov_576.769716	1104	1184	266	1	80	0.0125000
NODE_2826_length_1367_cov_576.769716	1104	1184	269	1	80	0.0125000
NODE_2826_length_1367_cov_576.769716	1104	1184	276	1	80	0.0125000
NODE_2826_length_1367_cov_576.769716	1104	1184	283	1	80	0.0125000
NODE_2826_length_1367_cov_576.769716	1104	1184	286	1	80	0.0125000
NODE_2826_length_1367_cov_576.769716	1104	1184	287	1	80	0.0125000
NODE_2826_length_1367_cov_576.769716	1104	1184	288	1	80	0.0125000
NODE_2826_length_1367_cov_576.769716	1104	1184	290	2	80	0.0250000
NODE_2826_length_1367_cov_576.769716	1104	1184	296	1	80	0.0125000
NODE_2826_length_1367_cov_576.769716	1104	1184	300	1	80	0.0125000
NODE_2826_length_1367_cov_576.769716	1104	1184	301	2	80	0.0250000
NODE_2826_length_1367_cov_576.769716	1104	1184	302	1	80	0.0125000
NODE_2826_length_1367_cov_576.769716	1104	1184	315	1	80	0.0125000
NODE_2826_length_1367_cov_576.769716	1104	1184	318	1	80	0.0125000
NODE_2826_length_1367_cov_576.769716	1104	1184	323	2	80	0.0250000
NODE_2826_length_1367_cov_576.769716	1104	1184	326	1	80	0.0125000
NODE_2826_length_1367_cov_576.769716	1104	1184	329	1	80	0.0125000
NODE_2826_length_1367_cov_576.769716	1104	1184	334	1	80	0.0125000
NODE_2826_length_1367_cov_576.769716	1104	1184	339	1	80	0.0125000
NODE_2826_length_1367_cov_576.769716	1104	1184	343	1	80	0.0125000
NODE_2826_length_1367_cov_576.769716	1104	1184	344	1	80	0.0125000
NODE_2826_length_1367_cov_576.769716	1104	1184	346	2	80	0.0250000
NODE_2826_length_1367_cov_576.769716	1104	1184	351	1	80	0.0125000
NODE_2826_length_1367_cov_576.769716	1104	1184	356	1	80	0.0125000
NODE_2826_length_1367_cov_576.769716	1104	1184	357	3	80	0.0375000
NODE_2826_length_1367_cov_576.769716	1104	1184	358	2	80	0.0250000
NODE_2826_length_1367_cov_576.769716	1104	1184	359	1	80	0.0125000
NODE_2826_length_1367_cov_576.769716	1104	1184	361	1	80	0.0125000
NODE_2827_length_1367_cov_152.824921	513	593	0	1	80	0.0125000
NODE_2827_length_1367_cov_152.824921	513	593	2	37	80	0.4625000
NODE_2827_length_1367_cov_152.824921	513	593	4	42	80	0.5250000
NODE_2827_length_1367_cov_152.824921	566	646	2	14	80	0.1750000
NODE_2827_length_1367_cov_152.824921	566	646	4	17	80	0.2125000
NODE_2827_length_1367_cov_152.824921	566	646	8	13	80	0.1625000
NODE_2827_length_1367_cov_152.824921	566	646	10	10	80	0.1250000
NODE_2827_length_1367_cov_152.824921	566	646	25	26	80	0.3250000
NODE_2827_length_1367_cov_152.824921	642	722	0	4	80	0.0500000
NODE_2827_length_1367_cov_152.824921	642	722	10	3	80	0.0375000
NODE_2827_length_1367_cov_152.824921	642	722	25	18	80	0.2250000
NODE_2827_length_1367_cov_152.824921	642	722	26	7	80	0.0875000
NODE_2827_length_1367_cov_152.824921	642	722	28	2	80	0.0250000
NODE_2827_length_1367_cov_152.824921	642	722	29	2	80	0.0250000
NODE_2827_length_1367_cov_152.824921	642	722	31	2	80	0.0250000
NODE_2827_length_1367_cov_152.824921	642	722	32	1	80	0.0125000
NODE_2827_length_1367_cov_152.824921	642	722	33	1	80	0.0125000
NODE_2827_length_1367_cov_152.824921	642	722	34	4	80	0.0500000
NODE_2827_length_1367_cov_152.824921	642	722	35	4	80	0.0500000
NODE_2827_length_1367_cov_152.824921	642	722	36	32	80	0.4000000
NODE_2827_length_1367_cov_152.824921	695	775	0	57	80	0.7125000
NODE_2827_length_1367_cov_152.824921	695	775	10	3	80	0.0375000
NODE_2827_length_1367_cov_152.824921	695	775	36	20	80	0.2500000
NODE_2829_length_1367_cov_2.947161	250	326	0	47	76	0.6184211
NODE_2829_length_1367_cov_2.947161	250	326	2	29	76	0.3815790
NODE_2831_length_1366_cov_82.742699	198	278	2	12	80	0.1500000
NODE_2831_length_1366_cov_82.742699	198	278	3	56	80	0.7000000
NODE_2831_length_1366_cov_82.742699	198	278	4	12	80	0.1500000
NODE_2831_length_1366_cov_82.742699	251	331	2	23	80	0.2875000
NODE_2831_length_1366_cov_82.742699	251	331	3	20	80	0.2500000
NODE_2831_length_1366_cov_82.742699	251	331	4	37	80	0.4625000
NODE_2832_length_1366_cov_36.659037	577	657	0	80	80	1.0000000
NODE_2832_length_1366_cov_36.659037	630	710	0	80	80	1.0000000
NODE_2834_length_1366_cov_2.320442	47	116	4	1	69	0.0144928
NODE_2834_length_1366_cov_2.320442	47	116	6	1	69	0.0144928
NODE_2834_length_1366_cov_2.320442	47	116	10	3	69	0.0434783
NODE_2834_length_1366_cov_2.320442	47	116	12	64	69	0.9275362
NODE_2834_length_1366_cov_2.320442	1122	1202	2	14	80	0.1750000
NODE_2834_length_1366_cov_2.320442	1122	1202	3	1	80	0.0125000
NODE_2834_length_1366_cov_2.320442	1122	1202	6	16	80	0.2000000
NODE_2834_length_1366_cov_2.320442	1122	1202	7	8	80	0.1000000
NODE_2834_length_1366_cov_2.320442	1122	1202	8	1	80	0.0125000
NODE_2834_length_1366_cov_2.320442	1122	1202	9	5	80	0.0625000
NODE_2834_length_1366_cov_2.320442	1122	1202	10	21	80	0.2625000
NODE_2834_length_1366_cov_2.320442	1122	1202	14	14	80	0.1750000
NODE_2834_length_1366_cov_2.320442	1175	1255	2	14	80	0.1750000
NODE_2834_length_1366_cov_2.320442	1175	1255	3	1	80	0.0125000
NODE_2834_length_1366_cov_2.320442	1175	1255	6	13	80	0.1625000
NODE_2834_length_1366_cov_2.320442	1175	1255	8	5	80	0.0625000
NODE_2834_length_1366_cov_2.320442	1175	1255	9	1	80	0.0125000
NODE_2834_length_1366_cov_2.320442	1175	1255	15	1	80	0.0125000
NODE_2834_length_1366_cov_2.320442	1175	1255	21	3	80	0.0375000
NODE_2834_length_1366_cov_2.320442	1175	1255	27	1	80	0.0125000
NODE_2834_length_1366_cov_2.320442	1175	1255	29	1	80	0.0125000
NODE_2834_length_1366_cov_2.320442	1175	1255	30	1	80	0.0125000
NODE_2834_length_1366_cov_2.320442	1175	1255	33	7	80	0.0875000
NODE_2834_length_1366_cov_2.320442	1175	1255	35	2	80	0.0250000
NODE_2834_length_1366_cov_2.320442	1175	1255	36	3	80	0.0375000
NODE_2834_length_1366_cov_2.320442	1175	1255	38	8	80	0.1000000
NODE_2834_length_1366_cov_2.320442	1175	1255	42	6	80	0.0750000
NODE_2834_length_1366_cov_2.320442	1175	1255	48	3	80	0.0375000
NODE_2834_length_1366_cov_2.320442	1175	1255	50	4	80	0.0500000
NODE_2834_length_1366_cov_2.320442	1175	1255	52	1	80	0.0125000
NODE_2834_length_1366_cov_2.320442	1175	1255	54	5	80	0.0625000
NODE_2834_length_1366_cov_2.320442	1251	1331	42	3	80	0.0375000
NODE_2834_length_1366_cov_2.320442	1251	1331	44	5	80	0.0625000
NODE_2834_length_1366_cov_2.320442	1251	1331	47	3	80	0.0375000
NODE_2834_length_1366_cov_2.320442	1251	1331	49	4	80	0.0500000
NODE_2834_length_1366_cov_2.320442	1251	1331	51	1	80	0.0125000
NODE_2834_length_1366_cov_2.320442	1251	1331	54	4	80	0.0500000
NODE_2834_length_1366_cov_2.320442	1251	1331	55	6	80	0.0750000
NODE_2834_length_1366_cov_2.320442	1251	1331	56	10	80	0.1250000
NODE_2834_length_1366_cov_2.320442	1251	1331	58	7	80	0.0875000
NODE_2834_length_1366_cov_2.320442	1251	1331	60	37	80	0.4625000
NODE_2835_length_1365_cov_25.540284	432	509	0	37	77	0.4805195
NODE_2835_length_1365_cov_25.540284	432	509	2	40	77	0.5194805
NODE_2835_length_1365_cov_25.540284	482	562	0	11	80	0.1375000
NODE_2835_length_1365_cov_25.540284	482	562	2	69	80	0.8625000
NODE_2835_length_1365_cov_25.540284	558	635	0	54	77	0.7012987
NODE_2835_length_1365_cov_25.540284	558	635	2	23	77	0.2987013
NODE_2835_length_1365_cov_25.540284	625	688	0	1	63	0.0158730
NODE_2835_length_1365_cov_25.540284	625	688	2	62	63	0.9841270
NODE_2838_length_1364_cov_15.222134	120	191	25	1	71	0.0140845
NODE_2838_length_1364_cov_15.222134	120	191	26	5	71	0.0704225
NODE_2838_length_1364_cov_15.222134	120	191	29	1	71	0.0140845
NODE_2838_length_1364_cov_15.222134	120	191	30	3	71	0.0422535
NODE_2838_length_1364_cov_15.222134	120	191	31	1	71	0.0140845
NODE_2838_length_1364_cov_15.222134	120	191	41	2	71	0.0281690
NODE_2838_length_1364_cov_15.222134	120	191	43	5	71	0.0704225
NODE_2838_length_1364_cov_15.222134	120	191	45	1	71	0.0140845
NODE_2838_length_1364_cov_15.222134	120	191	46	2	71	0.0281690
NODE_2838_length_1364_cov_15.222134	120	191	48	1	71	0.0140845
NODE_2838_length_1364_cov_15.222134	120	191	53	1	71	0.0140845
NODE_2838_length_1364_cov_15.222134	120	191	58	1	71	0.0140845
NODE_2838_length_1364_cov_15.222134	120	191	63	1	71	0.0140845
NODE_2838_length_1364_cov_15.222134	120	191	66	1	71	0.0140845
NODE_2838_length_1364_cov_15.222134	120	191	73	3	71	0.0422535
NODE_2838_length_1364_cov_15.222134	120	191	76	1	71	0.0140845
NODE_2838_length_1364_cov_15.222134	120	191	78	1	71	0.0140845
NODE_2838_length_1364_cov_15.222134	120	191	80	1	71	0.0140845
NODE_2838_length_1364_cov_15.222134	120	191	83	2	71	0.0281690
NODE_2838_length_1364_cov_15.222134	120	191	85	2	71	0.0281690
NODE_2838_length_1364_cov_15.222134	120	191	89	3	71	0.0422535
NODE_2838_length_1364_cov_15.222134	120	191	93	2	71	0.0281690
NODE_2838_length_1364_cov_15.222134	120	191	97	1	71	0.0140845
NODE_2838_length_1364_cov_15.222134	120	191	98	2	71	0.0281690
NODE_2838_length_1364_cov_15.222134	120	191	102	1	71	0.0140845
NODE_2838_length_1364_cov_15.222134	120	191	108	2	71	0.0281690
NODE_2838_length_1364_cov_15.222134	120	191	109	1	71	0.0140845
NODE_2838_length_1364_cov_15.222134	120	191	116	1	71	0.0140845
NODE_2838_length_1364_cov_15.222134	120	191	119	1	71	0.0140845
NODE_2838_length_1364_cov_15.222134	120	191	131	1	71	0.0140845
NODE_2838_length_1364_cov_15.222134	120	191	132	6	71	0.0845070
NODE_2838_length_1364_cov_15.222134	120	191	133	1	71	0.0140845
NODE_2838_length_1364_cov_15.222134	120	191	134	4	71	0.0563380
NODE_2838_length_1364_cov_15.222134	120	191	136	1	71	0.0140845
NODE_2838_length_1364_cov_15.222134	120	191	137	2	71	0.0281690
NODE_2838_length_1364_cov_15.222134	120	191	138	2	71	0.0281690
NODE_2838_length_1364_cov_15.222134	120	191	139	4	71	0.0563380
NODE_2839_length_1364_cov_7.456917	843	923	0	80	80	1.0000000
NODE_2839_length_1364_cov_7.456917	896	976	0	80	80	1.0000000
NODE_2840_length_1364_cov_5.055336	239	290	0	51	51	1.0000000
NODE_2840_length_1364_cov_5.055336	263	343	0	80	80	1.0000000
NODE_2846_length_1363_cov_19.442247	615	695	0	80	80	1.0000000
NODE_2846_length_1363_cov_19.442247	668	748	0	80	80	1.0000000
NODE_2847_length_1363_cov_13.575949	619	699	0	80	80	1.0000000
NODE_2847_length_1363_cov_13.575949	672	752	0	80	80	1.0000000
NODE_2850_length_1362_cov_15.796516	898	978	3	15	80	0.1875000
NODE_2850_length_1362_cov_15.796516	898	978	5	5	80	0.0625000
NODE_2850_length_1362_cov_15.796516	898	978	6	60	80	0.7500000
NODE_2850_length_1362_cov_15.796516	951	1031	0	10	80	0.1250000
NODE_2850_length_1362_cov_15.796516	951	1031	2	2	80	0.0250000
NODE_2850_length_1362_cov_15.796516	951	1031	5	31	80	0.3875000
NODE_2850_length_1362_cov_15.796516	951	1031	6	37	80	0.4625000
NODE_2855_length_1361_cov_24.574485	528	608	2	65	80	0.8125000
NODE_2855_length_1361_cov_24.574485	528	608	4	15	80	0.1875000
NODE_2855_length_1361_cov_24.574485	581	661	0	31	80	0.3875000
NODE_2855_length_1361_cov_24.574485	581	661	2	46	80	0.5750000
NODE_2855_length_1361_cov_24.574485	581	661	4	3	80	0.0375000
NODE_2856_length_1361_cov_20.148970	866	946	0	80	80	1.0000000
NODE_2856_length_1361_cov_20.148970	919	999	0	80	80	1.0000000
NODE_2858_length_1361_cov_10.530903	1139	1219	3	44	80	0.5500000
NODE_2858_length_1361_cov_10.530903	1139	1219	4	2	80	0.0250000
NODE_2858_length_1361_cov_10.530903	1139	1219	8	5	80	0.0625000
NODE_2858_length_1361_cov_10.530903	1139	1219	11	29	80	0.3625000
NODE_2858_length_1361_cov_10.530903	1139	1219	3	44	80	0.5500000
NODE_2858_length_1361_cov_10.530903	1139	1219	4	2	80	0.0250000
NODE_2858_length_1361_cov_10.530903	1139	1219	8	5	80	0.0625000
NODE_2858_length_1361_cov_10.530903	1139	1219	11	29	80	0.3625000
NODE_2858_length_1361_cov_10.530903	1192	1277	0	18	85	0.2117647
NODE_2858_length_1361_cov_10.530903	1192	1277	3	67	85	0.7882353
NODE_2858_length_1361_cov_10.530903	1273	1353	0	80	80	1.0000000
NODE_2858_length_1361_cov_10.530903	1273	1353	0	80	80	1.0000000
NODE_2858_length_1361_cov_10.530903	1273	1353	0	80	80	1.0000000
NODE_2858_length_1361_cov_10.530903	1273	1353	0	80	80	1.0000000
NODE_2858_length_1361_cov_10.530903	1273	1353	0	80	80	1.0000000
NODE_2858_length_1361_cov_10.530903	1273	1353	0	80	80	1.0000000
NODE_2859_length_1360_cov_42.789056	351	431	0	52	80	0.6500000
NODE_2859_length_1360_cov_42.789056	351	431	2	28	80	0.3500000
NODE_2859_length_1360_cov_42.789056	404	484	2	80	80	1.0000000
NODE_2860_length_1360_cov_26.407613	531	611	2	80	80	1.0000000
NODE_2860_length_1360_cov_26.407613	584	669	0	42	85	0.4941176
NODE_2860_length_1360_cov_26.407613	584	669	2	43	85	0.5058824
NODE_2861_length_1360_cov_16.182395	796	876	0	80	80	1.0000000
NODE_2861_length_1360_cov_16.182395	849	929	0	80	80	1.0000000
NODE_2861_length_1360_cov_16.182395	925	1005	0	80	80	1.0000000
NODE_2861_length_1360_cov_16.182395	978	1058	0	80	80	1.0000000
NODE_2862_length_1360_cov_12.763680	582	662	0	80	80	1.0000000
NODE_2862_length_1360_cov_12.763680	635	715	0	80	80	1.0000000
NODE_2866_length_1359_cov_41.324603	674	754	0	80	80	1.0000000
NODE_2866_length_1359_cov_41.324603	727	807	0	80	80	1.0000000
NODE_2866_length_1359_cov_41.324603	803	883	0	80	80	1.0000000
NODE_2866_length_1359_cov_41.324603	856	936	0	80	80	1.0000000
NODE_2871_length_1358_cov_23.427323	292	372	0	80	80	1.0000000
NODE_2871_length_1358_cov_23.427323	345	425	0	80	80	1.0000000
NODE_2872_length_1358_cov_19.489277	411	491	0	20	80	0.2500000
NODE_2872_length_1358_cov_19.489277	411	491	2	60	80	0.7500000
NODE_2872_length_1358_cov_19.489277	464	544	0	10	80	0.1250000
NODE_2872_length_1358_cov_19.489277	464	544	2	52	80	0.6500000
NODE_2872_length_1358_cov_19.489277	464	544	4	18	80	0.2250000
NODE_2875_length_1357_cov_15.962639	732	812	0	44	80	0.5500000
NODE_2875_length_1357_cov_15.962639	732	812	2	36	80	0.4500000
NODE_2875_length_1357_cov_15.962639	785	865	0	80	80	1.0000000
NODE_2879_length_1354_cov_9.854980	735	815	0	80	80	1.0000000
NODE_2879_length_1354_cov_9.854980	788	868	0	80	80	1.0000000
NODE_2882_length_1353_cov_32.982456	708	788	33	10	80	0.1250000
NODE_2882_length_1353_cov_32.982456	708	788	34	11	80	0.1375000
NODE_2882_length_1353_cov_32.982456	708	788	35	9	80	0.1125000
NODE_2882_length_1353_cov_32.982456	708	788	36	14	80	0.1750000
NODE_2882_length_1353_cov_32.982456	708	788	38	36	80	0.4500000
NODE_2882_length_1353_cov_32.982456	761	841	2	13	80	0.1625000
NODE_2882_length_1353_cov_32.982456	761	841	18	2	80	0.0250000
NODE_2882_length_1353_cov_32.982456	761	841	33	10	80	0.1250000
NODE_2882_length_1353_cov_32.982456	761	841	34	8	80	0.1000000
NODE_2882_length_1353_cov_32.982456	761	841	35	47	80	0.5875000
NODE_2883_length_1353_cov_21.775120	493	573	1	76	80	0.9500000
NODE_2883_length_1353_cov_21.775120	493	573	2	4	80	0.0500000
NODE_2883_length_1353_cov_21.775120	546	626	1	36	80	0.4500000
NODE_2883_length_1353_cov_21.775120	546	626	2	12	80	0.1500000
NODE_2883_length_1353_cov_21.775120	546	626	3	32	80	0.4000000
NODE_2884_length_1353_cov_18.201754	696	776	4	40	80	0.5000000
NODE_2884_length_1353_cov_18.201754	696	776	6	40	80	0.5000000
NODE_2884_length_1353_cov_18.201754	749	829	0	4	80	0.0500000
NODE_2884_length_1353_cov_18.201754	749	829	2	48	80	0.6000000
NODE_2884_length_1353_cov_18.201754	749	829	6	28	80	0.3500000
NODE_2888_length_1352_cov_26.942538	455	535	0	80	80	1.0000000
NODE_2888_length_1352_cov_26.942538	508	588	0	80	80	1.0000000
NODE_2889_length_1352_cov_17.189944	717	797	0	6	80	0.0750000
NODE_2889_length_1352_cov_17.189944	717	797	2	74	80	0.9250000
NODE_2889_length_1352_cov_17.189944	770	850	0	59	80	0.7375000
NODE_2889_length_1352_cov_17.189944	770	850	2	21	80	0.2625000
NODE_2890_length_1352_cov_15.752594	640	720	0	80	80	1.0000000
NODE_2890_length_1352_cov_15.752594	693	773	0	80	80	1.0000000
NODE_2891_length_1352_cov_10.699920	237	317	4	27	80	0.3375000
NODE_2891_length_1352_cov_10.699920	237	317	10	1	80	0.0125000
NODE_2891_length_1352_cov_10.699920	237	317	12	13	80	0.1625000
NODE_2891_length_1352_cov_10.699920	237	317	14	39	80	0.4875000
NODE_2891_length_1352_cov_10.699920	290	370	10	54	80	0.6750000
NODE_2891_length_1352_cov_10.699920	290	370	12	13	80	0.1625000
NODE_2891_length_1352_cov_10.699920	290	370	14	13	80	0.1625000
NODE_2894_length_1351_cov_32.325879	561	641	0	25	80	0.3125000
NODE_2894_length_1351_cov_32.325879	561	641	2	55	80	0.6875000
NODE_2894_length_1351_cov_32.325879	614	694	0	11	80	0.1375000
NODE_2894_length_1351_cov_32.325879	614	694	2	69	80	0.8625000
NODE_2895_length_1351_cov_16.861022	97	162	27	1	65	0.0153846
NODE_2895_length_1351_cov_16.861022	97	162	29	1	65	0.0153846
NODE_2895_length_1351_cov_16.861022	97	162	31	1	65	0.0153846
NODE_2895_length_1351_cov_16.861022	97	162	33	2	65	0.0307692
NODE_2895_length_1351_cov_16.861022	97	162	42	1	65	0.0153846
NODE_2895_length_1351_cov_16.861022	97	162	53	1	65	0.0153846
NODE_2895_length_1351_cov_16.861022	97	162	55	1	65	0.0153846
NODE_2895_length_1351_cov_16.861022	97	162	57	1	65	0.0153846
NODE_2895_length_1351_cov_16.861022	97	162	59	1	65	0.0153846
NODE_2895_length_1351_cov_16.861022	97	162	61	1	65	0.0153846
NODE_2895_length_1351_cov_16.861022	97	162	69	1	65	0.0153846
NODE_2895_length_1351_cov_16.861022	97	162	73	1	65	0.0153846
NODE_2895_length_1351_cov_16.861022	97	162	78	3	65	0.0461538
NODE_2895_length_1351_cov_16.861022	97	162	80	11	65	0.1692308
NODE_2895_length_1351_cov_16.861022	97	162	82	38	65	0.5846154
NODE_2896_length_1351_cov_9.894569	331	411	0	27	80	0.3375000
NODE_2896_length_1351_cov_9.894569	331	411	6	53	80	0.6625000
NODE_2896_length_1351_cov_9.894569	384	464	0	8	80	0.1000000
NODE_2896_length_1351_cov_9.894569	384	464	5	1	80	0.0125000
NODE_2896_length_1351_cov_9.894569	384	464	6	71	80	0.8875000
NODE_2897_length_1351_cov_8.699681	1055	1137	0	75	82	0.9146342
NODE_2897_length_1351_cov_8.699681	1055	1137	8	2	82	0.0243902
NODE_2897_length_1351_cov_8.699681	1055	1137	10	5	82	0.0609756
NODE_2897_length_1351_cov_8.699681	1110	1175	0	65	65	1.0000000
NODE_2898_length_1351_cov_2.931310	68	148	39	2	80	0.0250000
NODE_2898_length_1351_cov_2.931310	68	148	40	2	80	0.0250000
NODE_2898_length_1351_cov_2.931310	68	148	41	3	80	0.0375000
NODE_2898_length_1351_cov_2.931310	68	148	45	2	80	0.0250000
NODE_2898_length_1351_cov_2.931310	68	148	46	5	80	0.0625000
NODE_2898_length_1351_cov_2.931310	68	148	48	6	80	0.0750000
NODE_2898_length_1351_cov_2.931310	68	148	50	1	80	0.0125000
NODE_2898_length_1351_cov_2.931310	68	148	52	5	80	0.0625000
NODE_2898_length_1351_cov_2.931310	68	148	56	4	80	0.0500000
NODE_2898_length_1351_cov_2.931310	68	148	58	8	80	0.1000000
NODE_2898_length_1351_cov_2.931310	68	148	59	1	80	0.0125000
NODE_2898_length_1351_cov_2.931310	68	148	61	2	80	0.0250000
NODE_2898_length_1351_cov_2.931310	68	148	62	1	80	0.0125000
NODE_2898_length_1351_cov_2.931310	68	148	63	3	80	0.0375000
NODE_2898_length_1351_cov_2.931310	68	148	64	6	80	0.0750000
NODE_2898_length_1351_cov_2.931310	68	148	65	2	80	0.0250000
NODE_2898_length_1351_cov_2.931310	68	148	66	4	80	0.0500000
NODE_2898_length_1351_cov_2.931310	68	148	67	5	80	0.0625000
NODE_2898_length_1351_cov_2.931310	68	148	68	1	80	0.0125000
NODE_2898_length_1351_cov_2.931310	68	148	69	1	80	0.0125000
NODE_2898_length_1351_cov_2.931310	68	148	73	4	80	0.0500000
NODE_2898_length_1351_cov_2.931310	68	148	75	2	80	0.0250000
NODE_2898_length_1351_cov_2.931310	68	148	77	4	80	0.0500000
NODE_2898_length_1351_cov_2.931310	68	148	81	5	80	0.0625000
NODE_2898_length_1351_cov_2.931310	68	148	83	1	80	0.0125000
NODE_2898_length_1351_cov_2.931310	495	528	0	33	33	1.0000000
NODE_2899_length_1350_cov_18.274181	424	504	0	80	80	1.0000000
NODE_2899_length_1350_cov_18.274181	477	557	0	80	80	1.0000000
NODE_2899_length_1350_cov_18.274181	553	633	0	80	80	1.0000000
NODE_2899_length_1350_cov_18.274181	606	686	0	80	80	1.0000000
NODE_2900_length_1350_cov_8.053557	737	817	0	51	80	0.6375000
NODE_2900_length_1350_cov_8.053557	737	817	2	29	80	0.3625000
NODE_2900_length_1350_cov_8.053557	790	870	2	80	80	1.0000000
NODE_2903_length_1349_cov_23.782400	839	919	0	80	80	1.0000000
NODE_2903_length_1349_cov_23.782400	892	972	0	80	80	1.0000000
NODE_2903_length_1349_cov_23.782400	968	1048	0	80	80	1.0000000
NODE_2903_length_1349_cov_23.782400	1021	1101	0	80	80	1.0000000
NODE_2904_length_1349_cov_17.776800	811	891	0	80	80	1.0000000
NODE_2904_length_1349_cov_17.776800	864	944	0	30	80	0.3750000
NODE_2904_length_1349_cov_17.776800	864	944	12	50	80	0.6250000
NODE_2905_length_1349_cov_16.468800	828	908	0	38	80	0.4750000
NODE_2905_length_1349_cov_16.468800	828	908	2	42	80	0.5250000
NODE_2905_length_1349_cov_16.468800	881	961	0	22	80	0.2750000
NODE_2905_length_1349_cov_16.468800	881	961	2	58	80	0.7250000
NODE_2908_length_1348_cov_22.731785	468	548	0	80	80	1.0000000
NODE_2908_length_1348_cov_22.731785	521	601	0	80	80	1.0000000
NODE_2909_length_1348_cov_20.778223	517	597	6	80	80	1.0000000
NODE_2909_length_1348_cov_20.778223	570	650	0	39	80	0.4875000
NODE_2909_length_1348_cov_20.778223	570	650	6	41	80	0.5125000
NODE_2910_length_1348_cov_11.180144	673	753	2	2	80	0.0250000
NODE_2910_length_1348_cov_11.180144	673	753	4	55	80	0.6875000
NODE_2910_length_1348_cov_11.180144	673	753	6	23	80	0.2875000
NODE_2910_length_1348_cov_11.180144	726	806	2	4	80	0.0500000
NODE_2910_length_1348_cov_11.180144	726	806	3	17	80	0.2125000
NODE_2910_length_1348_cov_11.180144	726	806	4	4	80	0.0500000
NODE_2910_length_1348_cov_11.180144	726	806	5	8	80	0.1000000
NODE_2910_length_1348_cov_11.180144	726	806	6	47	80	0.5875000
NODE_2916_length_1347_cov_45.906250	683	763	0	34	80	0.4250000
NODE_2916_length_1347_cov_45.906250	683	763	2	11	80	0.1375000
NODE_2916_length_1347_cov_45.906250	683	763	4	10	80	0.1250000
NODE_2916_length_1347_cov_45.906250	683	763	5	25	80	0.3125000
NODE_2916_length_1347_cov_45.906250	736	816	0	80	80	1.0000000
NODE_2916_length_1347_cov_45.906250	812	892	0	59	80	0.7375000
NODE_2916_length_1347_cov_45.906250	812	892	2	21	80	0.2625000
NODE_2916_length_1347_cov_45.906250	865	945	0	6	80	0.0750000
NODE_2916_length_1347_cov_45.906250	865	945	2	74	80	0.9250000
NODE_2917_length_1347_cov_41.643429	439	519	8	20	80	0.2500000
NODE_2917_length_1347_cov_41.643429	439	519	9	36	80	0.4500000
NODE_2917_length_1347_cov_41.643429	439	519	11	24	80	0.3000000
NODE_2917_length_1347_cov_41.643429	492	572	3	6	80	0.0750000
NODE_2917_length_1347_cov_41.643429	492	572	4	6	80	0.0750000
NODE_2917_length_1347_cov_41.643429	492	572	5	17	80	0.2125000
NODE_2917_length_1347_cov_41.643429	492	572	7	19	80	0.2375000
NODE_2917_length_1347_cov_41.643429	492	572	8	25	80	0.3125000
NODE_2917_length_1347_cov_41.643429	492	572	11	7	80	0.0875000
NODE_2918_length_1347_cov_19.941506	458	538	0	80	80	1.0000000
NODE_2918_length_1347_cov_19.941506	511	591	0	80	80	1.0000000
NODE_2918_length_1347_cov_19.941506	587	667	0	80	80	1.0000000
NODE_2918_length_1347_cov_19.941506	640	720	0	80	80	1.0000000
NODE_2919_length_1347_cov_16.520833	713	793	8	7	80	0.0875000
NODE_2919_length_1347_cov_16.520833	713	793	10	19	80	0.2375000
NODE_2919_length_1347_cov_16.520833	713	793	12	25	80	0.3125000
NODE_2919_length_1347_cov_16.520833	713	793	15	1	80	0.0125000
NODE_2919_length_1347_cov_16.520833	713	793	16	7	80	0.0875000
NODE_2919_length_1347_cov_16.520833	713	793	18	21	80	0.2625000
NODE_2919_length_1347_cov_16.520833	766	846	2	28	80	0.3500000
NODE_2919_length_1347_cov_16.520833	766	846	6	23	80	0.2875000
NODE_2919_length_1347_cov_16.520833	766	846	8	9	80	0.1125000
NODE_2919_length_1347_cov_16.520833	766	846	10	19	80	0.2375000
NODE_2919_length_1347_cov_16.520833	766	846	12	1	80	0.0125000
NODE_2920_length_1347_cov_15.967147	638	718	2	4	80	0.0500000
NODE_2920_length_1347_cov_15.967147	638	718	8	1	80	0.0125000
NODE_2920_length_1347_cov_15.967147	638	718	9	2	80	0.0250000
NODE_2920_length_1347_cov_15.967147	638	718	10	5	80	0.0625000
NODE_2920_length_1347_cov_15.967147	638	718	12	34	80	0.4250000
NODE_2920_length_1347_cov_15.967147	638	718	16	34	80	0.4250000
NODE_2920_length_1347_cov_15.967147	691	771	8	23	80	0.2875000
NODE_2920_length_1347_cov_15.967147	691	771	16	57	80	0.7125000
NODE_2925_length_1346_cov_13.112269	429	509	2	80	80	1.0000000
NODE_2925_length_1346_cov_13.112269	482	562	0	51	80	0.6375000
NODE_2925_length_1346_cov_13.112269	482	562	2	29	80	0.3625000
NODE_2928_length_1345_cov_32.099518	629	709	6	80	80	1.0000000
NODE_2928_length_1345_cov_32.099518	682	762	0	11	80	0.1375000
NODE_2928_length_1345_cov_32.099518	682	762	3	15	80	0.1875000
NODE_2928_length_1345_cov_32.099518	682	762	6	54	80	0.6750000
NODE_2929_length_1345_cov_19.837881	723	803	0	69	80	0.8625000
NODE_2929_length_1345_cov_19.837881	723	803	2	11	80	0.1375000
NODE_2929_length_1345_cov_19.837881	776	856	0	16	80	0.2000000
NODE_2929_length_1345_cov_19.837881	776	856	2	64	80	0.8000000
NODE_2930_length_1345_cov_14.262440	361	441	0	80	80	1.0000000
NODE_2930_length_1345_cov_14.262440	414	494	0	80	80	1.0000000
NODE_2930_length_1345_cov_14.262440	490	570	0	80	80	1.0000000
NODE_2930_length_1345_cov_14.262440	543	623	0	80	80	1.0000000
NODE_2931_length_1345_cov_14.103531	950	1030	0	80	80	1.0000000
NODE_2931_length_1345_cov_14.103531	1003	1083	0	80	80	1.0000000
NODE_2934_length_1344_cov_15.013655	345	425	0	58	80	0.7250000
NODE_2934_length_1344_cov_15.013655	345	425	1	6	80	0.0750000
NODE_2934_length_1344_cov_15.013655	345	425	2	16	80	0.2000000
NODE_2934_length_1344_cov_15.013655	398	478	0	5	80	0.0625000
NODE_2934_length_1344_cov_15.013655	398	478	1	6	80	0.0750000
NODE_2934_length_1344_cov_15.013655	398	478	2	33	80	0.4125000
NODE_2934_length_1344_cov_15.013655	398	478	4	36	80	0.4500000
NODE_2935_length_1344_cov_11.383133	519	599	2	1	80	0.0125000
NODE_2935_length_1344_cov_11.383133	519	599	4	25	80	0.3125000
NODE_2935_length_1344_cov_11.383133	519	599	6	15	80	0.1875000
NODE_2935_length_1344_cov_11.383133	519	599	8	39	80	0.4875000
NODE_2935_length_1344_cov_11.383133	572	652	4	44	80	0.5500000
NODE_2935_length_1344_cov_11.383133	572	652	6	3	80	0.0375000
NODE_2935_length_1344_cov_11.383133	572	652	8	33	80	0.4125000
NODE_2935_length_1344_cov_11.383133	648	728	0	60	80	0.7500000
NODE_2935_length_1344_cov_11.383133	648	728	2	16	80	0.2000000
NODE_2935_length_1344_cov_11.383133	648	728	4	4	80	0.0500000
NODE_2935_length_1344_cov_11.383133	701	781	0	80	80	1.0000000
NODE_2936_length_1344_cov_10.924498	529	609	0	29	80	0.3625000
NODE_2936_length_1344_cov_10.924498	529	609	2	51	80	0.6375000
NODE_2936_length_1344_cov_10.924498	582	662	0	22	80	0.2750000
NODE_2936_length_1344_cov_10.924498	582	662	2	58	80	0.7250000
NODE_2937_length_1344_cov_5.531727	920	975	0	55	55	1.0000000
NODE_2942_length_1343_cov_36.005627	150	230	45	1	80	0.0125000
NODE_2942_length_1343_cov_36.005627	150	230	51	2	80	0.0250000
NODE_2942_length_1343_cov_36.005627	150	230	52	5	80	0.0625000
NODE_2942_length_1343_cov_36.005627	150	230	54	2	80	0.0250000
NODE_2942_length_1343_cov_36.005627	150	230	56	1	80	0.0125000
NODE_2942_length_1343_cov_36.005627	150	230	60	3	80	0.0375000
NODE_2942_length_1343_cov_36.005627	150	230	62	10	80	0.1250000
NODE_2942_length_1343_cov_36.005627	150	230	66	2	80	0.0250000
NODE_2942_length_1343_cov_36.005627	150	230	68	1	80	0.0125000
NODE_2942_length_1343_cov_36.005627	150	230	70	2	80	0.0250000
NODE_2942_length_1343_cov_36.005627	150	230	72	1	80	0.0125000
NODE_2942_length_1343_cov_36.005627	150	230	75	1	80	0.0125000
NODE_2942_length_1343_cov_36.005627	150	230	77	3	80	0.0375000
NODE_2942_length_1343_cov_36.005627	150	230	81	3	80	0.0375000
NODE_2942_length_1343_cov_36.005627	150	230	83	4	80	0.0500000
NODE_2942_length_1343_cov_36.005627	150	230	85	2	80	0.0250000
NODE_2942_length_1343_cov_36.005627	150	230	86	1	80	0.0125000
NODE_2942_length_1343_cov_36.005627	150	230	87	1	80	0.0125000
NODE_2942_length_1343_cov_36.005627	150	230	89	2	80	0.0250000
NODE_2942_length_1343_cov_36.005627	150	230	91	1	80	0.0125000
NODE_2942_length_1343_cov_36.005627	150	230	93	3	80	0.0375000
NODE_2942_length_1343_cov_36.005627	150	230	95	6	80	0.0750000
NODE_2942_length_1343_cov_36.005627	150	230	96	17	80	0.2125000
NODE_2942_length_1343_cov_36.005627	150	230	98	5	80	0.0625000
NODE_2942_length_1343_cov_36.005627	150	230	100	1	80	0.0125000
NODE_2942_length_1343_cov_36.005627	286	366	0	80	80	1.0000000
NODE_2942_length_1343_cov_36.005627	339	419	0	80	80	1.0000000
NODE_2942_length_1343_cov_36.005627	415	495	0	80	80	1.0000000
NODE_2942_length_1343_cov_36.005627	468	548	0	80	80	1.0000000
NODE_2943_length_1343_cov_26.826367	782	862	0	80	80	1.0000000
NODE_2943_length_1343_cov_26.826367	835	915	0	80	80	1.0000000
NODE_2944_length_1343_cov_19.353698	799	879	0	80	80	1.0000000
NODE_2944_length_1343_cov_19.353698	852	932	0	80	80	1.0000000
NODE_2944_length_1343_cov_19.353698	928	1008	0	80	80	1.0000000
NODE_2944_length_1343_cov_19.353698	981	1061	0	80	80	1.0000000
NODE_2945_length_1343_cov_15.717846	745	825	2	80	80	1.0000000
NODE_2945_length_1343_cov_15.717846	798	878	2	56	80	0.7000000
NODE_2945_length_1343_cov_15.717846	798	878	4	24	80	0.3000000
NODE_2949_length_1342_cov_30.491553	456	536	0	4	80	0.0500000
NODE_2949_length_1342_cov_30.491553	456	536	2	76	80	0.9500000
NODE_2949_length_1342_cov_30.491553	509	589	0	57	80	0.7125000
NODE_2949_length_1342_cov_30.491553	509	589	2	23	80	0.2875000
NODE_2949_length_1342_cov_30.491553	585	665	0	80	80	1.0000000
NODE_2949_length_1342_cov_30.491553	638	718	0	80	80	1.0000000
NODE_2950_length_1342_cov_26.796460	538	618	0	80	80	1.0000000
NODE_2950_length_1342_cov_26.796460	591	671	0	80	80	1.0000000
NODE_2950_length_1342_cov_26.796460	667	747	0	80	80	1.0000000
NODE_2950_length_1342_cov_26.796460	720	800	0	80	80	1.0000000
NODE_2951_length_1342_cov_22.769912	298	378	0	16	80	0.2000000
NODE_2951_length_1342_cov_22.769912	298	378	2	20	80	0.2500000
NODE_2951_length_1342_cov_22.769912	298	378	4	44	80	0.5500000
NODE_2951_length_1342_cov_22.769912	351	431	2	31	80	0.3875000
NODE_2951_length_1342_cov_22.769912	351	431	4	49	80	0.6125000
NODE_2951_length_1342_cov_22.769912	427	507	2	63	80	0.7875000
NODE_2951_length_1342_cov_22.769912	427	507	4	17	80	0.2125000
NODE_2951_length_1342_cov_22.769912	480	560	0	42	80	0.5250000
NODE_2951_length_1342_cov_22.769912	480	560	2	38	80	0.4750000
NODE_2953_length_1341_cov_22.449275	494	574	0	14	80	0.1750000
NODE_2953_length_1341_cov_22.449275	494	574	2	66	80	0.8250000
NODE_2953_length_1341_cov_22.449275	547	627	0	37	80	0.4625000
NODE_2953_length_1341_cov_22.449275	547	627	2	43	80	0.5375000
NODE_2953_length_1341_cov_22.449275	623	703	0	80	80	1.0000000
NODE_2953_length_1341_cov_22.449275	676	755	0	79	79	1.0000000
NODE_2954_length_1341_cov_14.497585	415	495	0	80	80	1.0000000
NODE_2954_length_1341_cov_14.497585	468	548	0	80	80	1.0000000
NODE_2954_length_1341_cov_14.497585	544	624	0	80	80	1.0000000
NODE_2954_length_1341_cov_14.497585	597	677	0	80	80	1.0000000
NODE_2960_length_1340_cov_9.460113	531	611	0	80	80	1.0000000
NODE_2960_length_1340_cov_9.460113	584	664	0	80	80	1.0000000
NODE_2961_length_1340_cov_6.511684	735	815	0	47	80	0.5875000
NODE_2961_length_1340_cov_6.511684	735	815	2	33	80	0.4125000
NODE_2961_length_1340_cov_6.511684	788	868	0	6	80	0.0750000
NODE_2961_length_1340_cov_6.511684	788	868	2	74	80	0.9250000
NODE_2966_length_1339_cov_22.725000	751	831	0	80	80	1.0000000
NODE_2966_length_1339_cov_22.725000	804	884	0	80	80	1.0000000
NODE_2967_length_1339_cov_9.322581	329	409	0	10	80	0.1250000
NODE_2967_length_1339_cov_9.322581	329	409	4	70	80	0.8750000
NODE_2967_length_1339_cov_9.322581	382	462	0	59	80	0.7375000
NODE_2967_length_1339_cov_9.322581	382	462	4	21	80	0.2625000
NODE_2970_length_1338_cov_31.740920	527	607	0	80	80	1.0000000
NODE_2970_length_1338_cov_31.740920	580	660	0	80	80	1.0000000
NODE_2970_length_1338_cov_31.740920	656	736	0	80	80	1.0000000
NODE_2970_length_1338_cov_31.740920	709	789	0	80	80	1.0000000
NODE_2971_length_1338_cov_21.254237	639	719	0	46	80	0.5750000
NODE_2971_length_1338_cov_21.254237	639	719	2	34	80	0.4250000
NODE_2971_length_1338_cov_21.254237	692	772	2	66	80	0.8250000
NODE_2971_length_1338_cov_21.254237	692	772	4	14	80	0.1750000
NODE_2974_length_1337_cov_32.307754	739	819	12	7	80	0.0875000
NODE_2974_length_1337_cov_32.307754	739	819	16	73	80	0.9125000
NODE_2974_length_1337_cov_32.307754	792	872	12	10	80	0.1250000
NODE_2974_length_1337_cov_32.307754	792	872	14	13	80	0.1625000
NODE_2974_length_1337_cov_32.307754	792	872	16	34	80	0.4250000
NODE_2974_length_1337_cov_32.307754	792	872	18	6	80	0.0750000
NODE_2974_length_1337_cov_32.307754	792	872	20	5	80	0.0625000
NODE_2974_length_1337_cov_32.307754	792	872	22	12	80	0.1500000
NODE_2975_length_1337_cov_30.412763	465	545	0	14	80	0.1750000
NODE_2975_length_1337_cov_30.412763	465	545	8	66	80	0.8250000
NODE_2975_length_1337_cov_30.412763	518	598	0	13	80	0.1625000
NODE_2975_length_1337_cov_30.412763	518	598	4	1	80	0.0125000
NODE_2975_length_1337_cov_30.412763	518	598	8	52	80	0.6500000
NODE_2975_length_1337_cov_30.412763	518	598	15	4	80	0.0500000
NODE_2975_length_1337_cov_30.412763	518	598	17	8	80	0.1000000
NODE_2975_length_1337_cov_30.412763	518	598	18	2	80	0.0250000
NODE_2976_length_1337_cov_12.760905	560	640	0	80	80	1.0000000
NODE_2976_length_1337_cov_12.760905	613	693	0	80	80	1.0000000
NODE_2977_length_1337_cov_9.463651	724	804	0	35	80	0.4375000
NODE_2977_length_1337_cov_9.463651	724	804	2	45	80	0.5625000
NODE_2977_length_1337_cov_9.463651	777	857	0	80	80	1.0000000
NODE_2979_length_1337_cov_4.540388	216	296	0	80	80	1.0000000
NODE_2979_length_1337_cov_4.540388	272	349	0	77	77	1.0000000
NODE_2981_length_1336_cov_28.161681	394	474	0	80	80	1.0000000
NODE_2981_length_1336_cov_28.161681	447	527	0	80	80	1.0000000
NODE_2981_length_1336_cov_28.161681	523	603	0	80	80	1.0000000
NODE_2981_length_1336_cov_28.161681	576	656	0	80	80	1.0000000
NODE_2982_length_1336_cov_7.860954	17	98	0	7	81	0.0864198
NODE_2982_length_1336_cov_7.860954	17	98	2	44	81	0.5432099
NODE_2982_length_1336_cov_7.860954	17	98	3	30	81	0.3703704
NODE_2984_length_1336_cov_1.689572	1229	1289	0	60	60	1.0000000
NODE_2984_length_1336_cov_1.689572	1262	1336	0	74	74	1.0000000
NODE_2985_length_1335_cov_19.547735	530	607	2	12	77	0.1558442
NODE_2985_length_1335_cov_19.547735	530	607	4	65	77	0.8441558
NODE_2985_length_1335_cov_19.547735	582	660	0	48	78	0.6153846
NODE_2985_length_1335_cov_19.547735	582	660	2	8	78	0.1025641
NODE_2985_length_1335_cov_19.547735	582	660	4	22	78	0.2820513
NODE_2985_length_1335_cov_19.547735	656	736	0	9	80	0.1125000
NODE_2985_length_1335_cov_19.547735	656	736	2	71	80	0.8875000
NODE_2985_length_1335_cov_19.547735	709	789	0	9	80	0.1125000
NODE_2985_length_1335_cov_19.547735	709	789	2	71	80	0.8875000
NODE_2986_length_1335_cov_15.383495	419	499	0	16	80	0.2000000
NODE_2986_length_1335_cov_15.383495	419	499	2	25	80	0.3125000
NODE_2986_length_1335_cov_15.383495	419	499	4	39	80	0.4875000
NODE_2986_length_1335_cov_15.383495	472	552	4	80	80	1.0000000
NODE_2986_length_1335_cov_15.383495	548	628	0	18	80	0.2250000
NODE_2986_length_1335_cov_15.383495	548	628	2	25	80	0.3125000
NODE_2986_length_1335_cov_15.383495	548	628	4	37	80	0.4625000
NODE_2986_length_1335_cov_15.383495	601	681	0	24	80	0.3000000
NODE_2986_length_1335_cov_15.383495	601	681	2	56	80	0.7000000
NODE_2991_length_1333_cov_27.372771	493	573	0	22	80	0.2750000
NODE_2991_length_1333_cov_27.372771	493	573	2	58	80	0.7250000
NODE_2991_length_1333_cov_27.372771	546	626	0	75	80	0.9375000
NODE_2991_length_1333_cov_27.372771	546	626	2	5	80	0.0625000
NODE_2996_length_1332_cov_18.978913	648	728	2	7	80	0.0875000
NODE_2996_length_1332_cov_18.978913	648	728	4	12	80	0.1500000
NODE_2996_length_1332_cov_18.978913	648	728	6	61	80	0.7625000
NODE_2996_length_1332_cov_18.978913	701	781	0	43	80	0.5375000
NODE_2996_length_1332_cov_18.978913	701	781	2	17	80	0.2125000
NODE_2996_length_1332_cov_18.978913	701	781	4	7	80	0.0875000
NODE_2996_length_1332_cov_18.978913	701	781	6	13	80	0.1625000
NODE_2996_length_1332_cov_18.978913	777	857	0	80	80	1.0000000
NODE_2996_length_1332_cov_18.978913	830	910	0	40	80	0.5000000
NODE_2996_length_1332_cov_18.978913	830	910	2	40	80	0.5000000
NODE_2997_length_1332_cov_3.112733	87	151	2	42	64	0.6562500
NODE_2997_length_1332_cov_3.112733	87	151	4	9	64	0.1406250
NODE_2997_length_1332_cov_3.112733	87	151	8	1	64	0.0156250
NODE_2997_length_1332_cov_3.112733	87	151	9	5	64	0.0781250
NODE_2997_length_1332_cov_3.112733	87	151	10	3	64	0.0468750
NODE_2997_length_1332_cov_3.112733	87	151	12	4	64	0.0625000
NODE_3000_length_1331_cov_16.831981	392	472	0	80	80	1.0000000
NODE_3000_length_1331_cov_16.831981	445	525	0	45	80	0.5625000
NODE_3000_length_1331_cov_16.831981	445	525	2	14	80	0.1750000
NODE_3000_length_1331_cov_16.831981	445	525	3	21	80	0.2625000
NODE_3000_length_1331_cov_16.831981	521	601	0	49	80	0.6125000
NODE_3000_length_1331_cov_16.831981	521	601	3	31	80	0.3875000
NODE_3000_length_1331_cov_16.831981	574	654	0	80	80	1.0000000
NODE_3001_length_1331_cov_12.841721	871	951	2	7	80	0.0875000
NODE_3001_length_1331_cov_12.841721	871	951	4	36	80	0.4500000
NODE_3001_length_1331_cov_12.841721	871	951	6	37	80	0.4625000
NODE_3001_length_1331_cov_12.841721	924	1004	4	27	80	0.3375000
NODE_3001_length_1331_cov_12.841721	924	1004	6	53	80	0.6625000
NODE_3004_length_1331_cov_2.090097	0	76	0	76	76	1.0000000
NODE_3004_length_1331_cov_2.090097	49	98	0	49	49	1.0000000
NODE_3007_length_1330_cov_48.993501	278	358	4	80	80	1.0000000
NODE_3007_length_1330_cov_48.993501	331	411	0	48	80	0.6000000
NODE_3007_length_1330_cov_48.993501	331	411	4	32	80	0.4000000
NODE_3007_length_1330_cov_48.993501	742	822	0	80	80	1.0000000
NODE_3007_length_1330_cov_48.993501	795	875	0	80	80	1.0000000
NODE_3008_length_1330_cov_11.037368	407	487	0	80	80	1.0000000
NODE_3008_length_1330_cov_11.037368	460	540	0	80	80	1.0000000
NODE_3008_length_1330_cov_11.037368	536	617	0	81	81	1.0000000
NODE_3008_length_1330_cov_11.037368	590	670	0	80	80	1.0000000
NODE_3009_length_1330_cov_9.026807	551	631	0	80	80	1.0000000
NODE_3009_length_1330_cov_9.026807	604	684	0	80	80	1.0000000
NODE_3011_length_1329_cov_17.036585	691	771	0	33	80	0.4125000
NODE_3011_length_1329_cov_17.036585	691	771	2	47	80	0.5875000
NODE_3011_length_1329_cov_17.036585	744	824	0	80	80	1.0000000
NODE_3011_length_1329_cov_17.036585	820	900	0	80	80	1.0000000
NODE_3011_length_1329_cov_17.036585	873	953	0	80	80	1.0000000
NODE_3012_length_1329_cov_16.341463	428	476	19	1	48	0.0208333
NODE_3012_length_1329_cov_16.341463	428	476	21	1	48	0.0208333
NODE_3012_length_1329_cov_16.341463	428	476	22	1	48	0.0208333
NODE_3012_length_1329_cov_16.341463	428	476	24	3	48	0.0625000
NODE_3012_length_1329_cov_16.341463	428	476	25	2	48	0.0416667
NODE_3012_length_1329_cov_16.341463	428	476	28	3	48	0.0625000
NODE_3012_length_1329_cov_16.341463	428	476	29	1	48	0.0208333
NODE_3012_length_1329_cov_16.341463	428	476	31	3	48	0.0625000
NODE_3012_length_1329_cov_16.341463	428	476	37	1	48	0.0208333
NODE_3012_length_1329_cov_16.341463	428	476	39	2	48	0.0416667
NODE_3012_length_1329_cov_16.341463	428	476	43	3	48	0.0625000
NODE_3012_length_1329_cov_16.341463	428	476	45	2	48	0.0416667
NODE_3012_length_1329_cov_16.341463	428	476	46	1	48	0.0208333
NODE_3012_length_1329_cov_16.341463	428	476	51	2	48	0.0416667
NODE_3012_length_1329_cov_16.341463	428	476	52	6	48	0.1250000
NODE_3012_length_1329_cov_16.341463	428	476	54	2	48	0.0416667
NODE_3012_length_1329_cov_16.341463	428	476	55	4	48	0.0833333
NODE_3012_length_1329_cov_16.341463	428	476	56	1	48	0.0208333
NODE_3012_length_1329_cov_16.341463	428	476	58	1	48	0.0208333
NODE_3012_length_1329_cov_16.341463	428	476	59	1	48	0.0208333
NODE_3012_length_1329_cov_16.341463	428	476	62	1	48	0.0208333
NODE_3012_length_1329_cov_16.341463	428	476	64	1	48	0.0208333
NODE_3012_length_1329_cov_16.341463	428	476	67	1	48	0.0208333
NODE_3012_length_1329_cov_16.341463	428	476	69	2	48	0.0416667
NODE_3012_length_1329_cov_16.341463	428	476	75	2	48	0.0416667
NODE_3013_length_1329_cov_5.620325	888	955	8	1	67	0.0149254
NODE_3013_length_1329_cov_5.620325	888	955	10	41	67	0.6119403
NODE_3013_length_1329_cov_5.620325	888	955	11	15	67	0.2238806
NODE_3013_length_1329_cov_5.620325	888	955	12	2	67	0.0298507
NODE_3013_length_1329_cov_5.620325	888	955	14	8	67	0.1194030
NODE_3013_length_1329_cov_5.620325	941	999	10	58	58	1.0000000
NODE_3017_length_1328_cov_12.954434	794	874	0	28	80	0.3500000
NODE_3017_length_1328_cov_12.954434	794	874	2	52	80	0.6500000
NODE_3017_length_1328_cov_12.954434	847	927	2	80	80	1.0000000
NODE_3018_length_1328_cov_8.810415	762	842	0	80	80	1.0000000
NODE_3018_length_1328_cov_8.810415	815	895	0	80	80	1.0000000
NODE_3021_length_1327_cov_15.938925	260	340	0	80	80	1.0000000
NODE_3021_length_1327_cov_15.938925	313	393	0	80	80	1.0000000
NODE_3022_length_1327_cov_7.274430	159	235	0	76	76	1.0000000
NODE_3022_length_1327_cov_7.274430	774	854	0	80	80	1.0000000
NODE_3022_length_1327_cov_7.274430	827	890	0	63	63	1.0000000
NODE_3023_length_1327_cov_6.486156	896	976	0	80	80	1.0000000
NODE_3023_length_1327_cov_6.486156	949	1029	0	80	80	1.0000000
NODE_3029_length_1326_cov_32.382233	571	651	0	80	80	1.0000000
NODE_3029_length_1326_cov_32.382233	624	704	0	80	80	1.0000000
NODE_3030_length_1326_cov_30.614507	760	840	6	6	80	0.0750000
NODE_3030_length_1326_cov_30.614507	760	840	10	7	80	0.0875000
NODE_3030_length_1326_cov_30.614507	760	840	12	7	80	0.0875000
NODE_3030_length_1326_cov_30.614507	760	840	16	31	80	0.3875000
NODE_3030_length_1326_cov_30.614507	760	840	17	11	80	0.1375000
NODE_3030_length_1326_cov_30.614507	760	840	19	3	80	0.0375000
NODE_3030_length_1326_cov_30.614507	760	840	21	15	80	0.1875000
NODE_3030_length_1326_cov_30.614507	813	893	6	4	80	0.0500000
NODE_3030_length_1326_cov_30.614507	813	893	10	6	80	0.0750000
NODE_3030_length_1326_cov_30.614507	813	893	11	6	80	0.0750000
NODE_3030_length_1326_cov_30.614507	813	893	12	33	80	0.4125000
NODE_3030_length_1326_cov_30.614507	813	893	13	2	80	0.0250000
NODE_3030_length_1326_cov_30.614507	813	893	17	13	80	0.1625000
NODE_3030_length_1326_cov_30.614507	813	893	19	3	80	0.0375000
NODE_3030_length_1326_cov_30.614507	813	893	21	13	80	0.1625000
NODE_3031_length_1326_cov_30.304808	488	568	0	21	80	0.2625000
NODE_3031_length_1326_cov_30.304808	488	568	2	59	80	0.7375000
NODE_3031_length_1326_cov_30.304808	541	621	0	30	80	0.3750000
NODE_3031_length_1326_cov_30.304808	541	621	2	50	80	0.6250000
NODE_3031_length_1326_cov_30.304808	617	697	0	32	80	0.4000000
NODE_3031_length_1326_cov_30.304808	617	697	4	48	80	0.6000000
NODE_3031_length_1326_cov_30.304808	670	750	4	80	80	1.0000000
NODE_3032_length_1326_cov_10.913610	238	318	0	80	80	1.0000000
NODE_3032_length_1326_cov_10.913610	291	371	0	80	80	1.0000000
NODE_3036_length_1325_cov_38.136215	0	46	0	46	46	1.0000000
NODE_3036_length_1325_cov_38.136215	19	99	0	80	80	1.0000000
NODE_3036_length_1325_cov_38.136215	948	1022	18	6	74	0.0810811
NODE_3036_length_1325_cov_38.136215	948	1022	19	6	74	0.0810811
NODE_3036_length_1325_cov_38.136215	948	1022	20	1	74	0.0135135
NODE_3036_length_1325_cov_38.136215	948	1022	21	1	74	0.0135135
NODE_3036_length_1325_cov_38.136215	948	1022	22	8	74	0.1081081
NODE_3036_length_1325_cov_38.136215	948	1022	26	1	74	0.0135135
NODE_3036_length_1325_cov_38.136215	948	1022	28	1	74	0.0135135
NODE_3036_length_1325_cov_38.136215	948	1022	30	1	74	0.0135135
NODE_3036_length_1325_cov_38.136215	948	1022	31	4	74	0.0540541
NODE_3036_length_1325_cov_38.136215	948	1022	35	2	74	0.0270270
NODE_3036_length_1325_cov_38.136215	948	1022	36	5	74	0.0675676
NODE_3036_length_1325_cov_38.136215	948	1022	39	1	74	0.0135135
NODE_3036_length_1325_cov_38.136215	948	1022	40	2	74	0.0270270
NODE_3036_length_1325_cov_38.136215	948	1022	42	4	74	0.0540541
NODE_3036_length_1325_cov_38.136215	948	1022	44	1	74	0.0135135
NODE_3036_length_1325_cov_38.136215	948	1022	46	9	74	0.1216216
NODE_3036_length_1325_cov_38.136215	948	1022	49	3	74	0.0405405
NODE_3036_length_1325_cov_38.136215	948	1022	51	3	74	0.0405405
NODE_3036_length_1325_cov_38.136215	948	1022	55	3	74	0.0405405
NODE_3036_length_1325_cov_38.136215	948	1022	56	1	74	0.0135135
NODE_3036_length_1325_cov_38.136215	948	1022	58	4	74	0.0540541
NODE_3036_length_1325_cov_38.136215	948	1022	59	2	74	0.0270270
NODE_3036_length_1325_cov_38.136215	948	1022	66	1	74	0.0135135
NODE_3036_length_1325_cov_38.136215	948	1022	70	2	74	0.0270270
NODE_3036_length_1325_cov_38.136215	948	1022	72	2	74	0.0270270
NODE_3036_length_1325_cov_38.136215	1001	1063	49	3	62	0.0483871
NODE_3036_length_1325_cov_38.136215	1001	1063	51	3	62	0.0483871
NODE_3036_length_1325_cov_38.136215	1001	1063	55	3	62	0.0483871
NODE_3036_length_1325_cov_38.136215	1001	1063	56	1	62	0.0161290
NODE_3036_length_1325_cov_38.136215	1001	1063	58	4	62	0.0645161
NODE_3036_length_1325_cov_38.136215	1001	1063	59	2	62	0.0322581
NODE_3036_length_1325_cov_38.136215	1001	1063	66	1	62	0.0161290
NODE_3036_length_1325_cov_38.136215	1001	1063	69	4	62	0.0645161
NODE_3036_length_1325_cov_38.136215	1001	1063	70	7	62	0.1129032
NODE_3036_length_1325_cov_38.136215	1001	1063	71	5	62	0.0806452
NODE_3036_length_1325_cov_38.136215	1001	1063	72	4	62	0.0645161
NODE_3036_length_1325_cov_38.136215	1001	1063	73	5	62	0.0806452
NODE_3036_length_1325_cov_38.136215	1001	1063	77	1	62	0.0161290
NODE_3036_length_1325_cov_38.136215	1001	1063	80	2	62	0.0322581
NODE_3036_length_1325_cov_38.136215	1001	1063	81	1	62	0.0161290
NODE_3036_length_1325_cov_38.136215	1001	1063	82	1	62	0.0161290
NODE_3036_length_1325_cov_38.136215	1001	1063	83	1	62	0.0161290
NODE_3036_length_1325_cov_38.136215	1001	1063	84	4	62	0.0645161
NODE_3036_length_1325_cov_38.136215	1001	1063	86	2	62	0.0322581
NODE_3036_length_1325_cov_38.136215	1001	1063	87	3	62	0.0483871
NODE_3036_length_1325_cov_38.136215	1001	1063	88	3	62	0.0483871
NODE_3036_length_1325_cov_38.136215	1001	1063	90	2	62	0.0322581
NODE_3037_length_1325_cov_29.201468	613	693	0	26	80	0.3250000
NODE_3037_length_1325_cov_29.201468	613	693	2	25	80	0.3125000
NODE_3037_length_1325_cov_29.201468	613	693	4	29	80	0.3625000
NODE_3037_length_1325_cov_29.201468	666	746	0	2	80	0.0250000
NODE_3037_length_1325_cov_29.201468	666	746	2	19	80	0.2375000
NODE_3037_length_1325_cov_29.201468	666	746	4	59	80	0.7375000
NODE_3038_length_1325_cov_11.902121	697	777	0	80	80	1.0000000
NODE_3038_length_1325_cov_11.902121	750	830	0	80	80	1.0000000
NODE_3039_length_1325_cov_7.876835	645	725	2	80	80	1.0000000
NODE_3039_length_1325_cov_7.876835	698	778	0	40	80	0.5000000
NODE_3039_length_1325_cov_7.876835	698	778	2	40	80	0.5000000
NODE_3040_length_1325_cov_3.774062	1157	1218	0	7	61	0.1147541
NODE_3040_length_1325_cov_3.774062	1157	1218	2	53	61	0.8688524
NODE_3040_length_1325_cov_3.774062	1157	1218	4	1	61	0.0163934
NODE_3040_length_1325_cov_3.774062	1191	1271	2	80	80	1.0000000
NODE_3041_length_1325_cov_2.896411	0	58	0	4	58	0.0689655
NODE_3041_length_1325_cov_2.896411	0	58	2	4	58	0.0689655
NODE_3041_length_1325_cov_2.896411	0	58	4	50	58	0.8620690
NODE_3041_length_1325_cov_2.896411	8	67	4	54	59	0.9152542
NODE_3041_length_1325_cov_2.896411	8	67	9	1	59	0.0169492
NODE_3041_length_1325_cov_2.896411	8	67	10	2	59	0.0338983
NODE_3041_length_1325_cov_2.896411	8	67	12	2	59	0.0338983
NODE_3046_length_1324_cov_30.340408	939	1019	6	19	80	0.2375000
NODE_3046_length_1324_cov_30.340408	939	1019	12	61	80	0.7625000
NODE_3046_length_1324_cov_30.340408	992	1072	0	48	80	0.6000000
NODE_3046_length_1324_cov_30.340408	992	1072	6	22	80	0.2750000
NODE_3046_length_1324_cov_30.340408	992	1072	12	10	80	0.1250000
NODE_3047_length_1324_cov_7.391020	742	822	0	37	80	0.4625000
NODE_3047_length_1324_cov_7.391020	742	822	2	1	80	0.0125000
NODE_3047_length_1324_cov_7.391020	742	822	3	14	80	0.1750000
NODE_3047_length_1324_cov_7.391020	742	822	4	28	80	0.3500000
NODE_3047_length_1324_cov_7.391020	795	875	4	35	80	0.4375000
NODE_3047_length_1324_cov_7.391020	795	875	6	45	80	0.5625000
NODE_3053_length_1323_cov_30.600490	392	472	4	80	80	1.0000000
NODE_3053_length_1323_cov_30.600490	445	525	0	41	80	0.5125000
NODE_3053_length_1323_cov_30.600490	445	525	2	3	80	0.0375000
NODE_3053_length_1323_cov_30.600490	445	525	4	36	80	0.4500000
NODE_3053_length_1323_cov_30.600490	521	601	0	39	80	0.4875000
NODE_3053_length_1323_cov_30.600490	521	601	2	21	80	0.2625000
NODE_3053_length_1323_cov_30.600490	521	601	4	20	80	0.2500000
NODE_3053_length_1323_cov_30.600490	574	654	2	15	80	0.1875000
NODE_3053_length_1323_cov_30.600490	574	654	4	65	80	0.8125000
NODE_3054_length_1323_cov_20.888889	758	838	0	4	80	0.0500000
NODE_3054_length_1323_cov_20.888889	758	838	1	5	80	0.0625000
NODE_3054_length_1323_cov_20.888889	758	838	2	71	80	0.8875000
NODE_3054_length_1323_cov_20.888889	811	891	0	57	80	0.7125000
NODE_3054_length_1323_cov_20.888889	811	891	1	5	80	0.0625000
NODE_3054_length_1323_cov_20.888889	811	891	2	18	80	0.2250000
NODE_3061_length_1322_cov_8.988553	287	368	0	81	81	1.0000000
NODE_3061_length_1322_cov_8.988553	341	421	0	80	80	1.0000000
NODE_3061_length_1322_cov_8.988553	417	497	0	80	80	1.0000000
NODE_3061_length_1322_cov_8.988553	470	550	0	80	80	1.0000000
NODE_3068_length_1321_cov_57.885434	359	439	0	74	80	0.9250000
NODE_3068_length_1321_cov_57.885434	359	439	5	6	80	0.0750000
NODE_3068_length_1321_cov_57.885434	412	492	0	21	80	0.2625000
NODE_3068_length_1321_cov_57.885434	412	492	5	35	80	0.4375000
NODE_3068_length_1321_cov_57.885434	412	492	9	15	80	0.1875000
NODE_3068_length_1321_cov_57.885434	412	492	10	3	80	0.0375000
NODE_3068_length_1321_cov_57.885434	412	492	14	1	80	0.0125000
NODE_3068_length_1321_cov_57.885434	412	492	15	5	80	0.0625000
NODE_3068_length_1321_cov_57.885434	488	568	15	80	80	1.0000000
NODE_3068_length_1321_cov_57.885434	541	621	0	3	80	0.0375000
NODE_3068_length_1321_cov_57.885434	541	621	5	35	80	0.4375000
NODE_3068_length_1321_cov_57.885434	541	621	9	7	80	0.0875000
NODE_3068_length_1321_cov_57.885434	541	621	14	1	80	0.0125000
NODE_3068_length_1321_cov_57.885434	541	621	15	34	80	0.4250000
NODE_3071_length_1320_cov_70.753481	432	512	0	45	80	0.5625000
NODE_3071_length_1320_cov_70.753481	432	512	2	35	80	0.4375000
NODE_3071_length_1320_cov_70.753481	485	565	2	80	80	1.0000000
NODE_3071_length_1320_cov_70.753481	561	641	0	29	80	0.3625000
NODE_3071_length_1320_cov_70.753481	561	641	2	51	80	0.6375000
NODE_3071_length_1320_cov_70.753481	614	694	0	80	80	1.0000000
NODE_3072_length_1320_cov_39.149058	715	795	1	2	80	0.0250000
NODE_3072_length_1320_cov_39.149058	715	795	2	78	80	0.9750000
NODE_3072_length_1320_cov_39.149058	768	848	0	41	80	0.5125000
NODE_3072_length_1320_cov_39.149058	768	848	1	14	80	0.1750000
NODE_3072_length_1320_cov_39.149058	768	848	2	25	80	0.3125000
NODE_3072_length_1320_cov_39.149058	844	924	0	80	80	1.0000000
NODE_3072_length_1320_cov_39.149058	897	977	0	80	80	1.0000000
NODE_3073_length_1320_cov_19.175266	707	783	0	76	76	1.0000000
NODE_3073_length_1320_cov_19.175266	760	840	0	80	80	1.0000000
NODE_3074_length_1320_cov_11.224406	860	940	0	80	80	1.0000000
NODE_3074_length_1320_cov_11.224406	913	993	0	80	80	1.0000000
NODE_3075_length_1320_cov_11.036036	760	840	0	80	80	1.0000000
NODE_3075_length_1320_cov_11.036036	813	893	0	80	80	1.0000000
NODE_3076_length_1320_cov_8.357084	800	880	0	80	80	1.0000000
NODE_3076_length_1320_cov_8.357084	853	933	0	80	80	1.0000000
NODE_3080_length_1319_cov_27.098361	630	710	1	29	80	0.3625000
NODE_3080_length_1319_cov_27.098361	630	710	3	51	80	0.6375000
NODE_3080_length_1319_cov_27.098361	683	763	0	48	80	0.6000000
NODE_3080_length_1319_cov_27.098361	683	763	1	32	80	0.4000000
NODE_3081_length_1319_cov_22.992623	490	570	0	2	80	0.0250000
NODE_3081_length_1319_cov_22.992623	490	570	4	78	80	0.9750000
NODE_3081_length_1319_cov_22.992623	543	623	0	40	80	0.5000000
NODE_3081_length_1319_cov_22.992623	543	623	4	40	80	0.5000000
NODE_3086_length_1318_cov_13.624282	642	722	0	80	80	1.0000000
NODE_3086_length_1318_cov_13.624282	695	775	0	80	80	1.0000000
NODE_3086_length_1318_cov_13.624282	771	851	0	53	80	0.6625000
NODE_3086_length_1318_cov_13.624282	771	851	6	27	80	0.3375000
NODE_3086_length_1318_cov_13.624282	824	904	6	80	80	1.0000000
NODE_3089_length_1317_cov_162.041872	66	143	10	4	77	0.0519481
NODE_3089_length_1317_cov_162.041872	66	143	12	6	77	0.0779221
NODE_3089_length_1317_cov_162.041872	66	143	14	2	77	0.0259740
NODE_3089_length_1317_cov_162.041872	66	143	15	1	77	0.0129870
NODE_3089_length_1317_cov_162.041872	66	143	18	19	77	0.2467532
NODE_3089_length_1317_cov_162.041872	66	143	20	42	77	0.5454546
NODE_3089_length_1317_cov_162.041872	66	143	59	1	77	0.0129870
NODE_3089_length_1317_cov_162.041872	66	143	68	1	77	0.0129870
NODE_3089_length_1317_cov_162.041872	66	143	90	1	77	0.0129870
NODE_3090_length_1317_cov_19.736453	675	755	0	23	80	0.2875000
NODE_3090_length_1317_cov_19.736453	675	755	4	26	80	0.3250000
NODE_3090_length_1317_cov_19.736453	675	755	6	15	80	0.1875000
NODE_3090_length_1317_cov_19.736453	675	755	8	16	80	0.2000000
NODE_3090_length_1317_cov_19.736453	728	808	4	9	80	0.1125000
NODE_3090_length_1317_cov_19.736453	728	808	6	11	80	0.1375000
NODE_3090_length_1317_cov_19.736453	728	808	8	60	80	0.7500000
NODE_3090_length_1317_cov_19.736453	804	884	0	27	80	0.3375000
NODE_3090_length_1317_cov_19.736453	804	884	2	27	80	0.3375000
NODE_3090_length_1317_cov_19.736453	804	884	4	10	80	0.1250000
NODE_3090_length_1317_cov_19.736453	804	884	6	1	80	0.0125000
NODE_3090_length_1317_cov_19.736453	804	884	7	3	80	0.0375000
NODE_3090_length_1317_cov_19.736453	804	884	10	1	80	0.0125000
NODE_3090_length_1317_cov_19.736453	804	884	11	11	80	0.1375000
NODE_3090_length_1317_cov_19.736453	857	937	0	11	80	0.1375000
NODE_3090_length_1317_cov_19.736453	857	937	6	1	80	0.0125000
NODE_3090_length_1317_cov_19.736453	857	937	7	3	80	0.0375000
NODE_3090_length_1317_cov_19.736453	857	937	10	1	80	0.0125000
NODE_3090_length_1317_cov_19.736453	857	937	11	37	80	0.4625000
NODE_3090_length_1317_cov_19.736453	857	937	12	27	80	0.3375000
NODE_3092_length_1317_cov_2.203612	779	859	6	34	80	0.4250000
NODE_3092_length_1317_cov_2.203612	779	859	8	31	80	0.3875000
NODE_3092_length_1317_cov_2.203612	779	859	10	15	80	0.1875000
NODE_3095_length_1316_cov_25.377157	557	637	0	55	80	0.6875000
NODE_3095_length_1316_cov_25.377157	557	637	2	25	80	0.3125000
NODE_3095_length_1316_cov_25.377157	610	690	0	2	80	0.0250000
NODE_3095_length_1316_cov_25.377157	610	690	2	78	80	0.9750000
NODE_3096_length_1316_cov_15.891537	446	526	0	80	80	1.0000000
NODE_3096_length_1316_cov_15.891537	499	579	0	80	80	1.0000000
NODE_3096_length_1316_cov_15.891537	575	655	0	80	80	1.0000000
NODE_3096_length_1316_cov_15.891537	628	708	0	80	80	1.0000000
NODE_3101_length_1315_cov_24.136513	592	672	0	30	80	0.3750000
NODE_3101_length_1315_cov_24.136513	592	672	4	1	80	0.0125000
NODE_3101_length_1315_cov_24.136513	592	672	5	49	80	0.6125000
NODE_3101_length_1315_cov_24.136513	645	725	0	80	80	1.0000000
NODE_3105_length_1314_cov_38.391770	647	727	0	34	80	0.4250000
NODE_3105_length_1314_cov_38.391770	647	727	2	46	80	0.5750000
NODE_3105_length_1314_cov_38.391770	700	780	0	30	80	0.3750000
NODE_3105_length_1314_cov_38.391770	700	780	2	28	80	0.3500000
NODE_3105_length_1314_cov_38.391770	700	780	4	22	80	0.2750000
NODE_3105_length_1314_cov_38.391770	776	856	0	17	80	0.2125000
NODE_3105_length_1314_cov_38.391770	776	856	2	50	80	0.6250000
NODE_3105_length_1314_cov_38.391770	776	856	4	13	80	0.1625000
NODE_3105_length_1314_cov_38.391770	829	909	0	70	80	0.8750000
NODE_3105_length_1314_cov_38.391770	829	909	2	10	80	0.1250000
NODE_3106_length_1314_cov_30.167078	736	816	0	51	80	0.6375000
NODE_3106_length_1314_cov_30.167078	736	816	6	29	80	0.3625000
NODE_3106_length_1314_cov_30.167078	789	869	6	80	80	1.0000000
NODE_3107_length_1314_cov_11.221399	523	603	0	80	80	1.0000000
NODE_3107_length_1314_cov_11.221399	576	656	0	80	80	1.0000000
NODE_3114_length_1313_cov_29.315486	463	543	0	6	80	0.0750000
NODE_3114_length_1313_cov_29.315486	463	543	2	74	80	0.9250000
NODE_3114_length_1313_cov_29.315486	516	596	0	14	80	0.1750000
NODE_3114_length_1313_cov_29.315486	516	596	2	66	80	0.8250000
NODE_3115_length_1313_cov_25.144975	709	789	1	80	80	1.0000000
NODE_3115_length_1313_cov_25.144975	762	842	0	31	80	0.3875000
NODE_3115_length_1313_cov_25.144975	762	842	1	49	80	0.6125000
NODE_3115_length_1313_cov_25.144975	838	918	0	80	80	1.0000000
NODE_3115_length_1313_cov_25.144975	891	971	0	80	80	1.0000000
NODE_3118_length_1312_cov_20.378401	138	218	0	80	80	1.0000000
NODE_3118_length_1312_cov_20.378401	191	271	0	80	80	1.0000000
NODE_3121_length_1311_cov_38.468647	584	664	2	13	80	0.1625000
NODE_3121_length_1311_cov_38.468647	584	664	4	67	80	0.8375000
NODE_3121_length_1311_cov_38.468647	637	717	0	37	80	0.4625000
NODE_3121_length_1311_cov_38.468647	637	717	2	29	80	0.3625000
NODE_3121_length_1311_cov_38.468647	637	717	4	14	80	0.1750000
NODE_3121_length_1311_cov_38.468647	713	793	0	45	80	0.5625000
NODE_3121_length_1311_cov_38.468647	713	793	1	1	80	0.0125000
NODE_3121_length_1311_cov_38.468647	713	793	2	28	80	0.3500000
NODE_3121_length_1311_cov_38.468647	713	793	8	6	80	0.0750000
NODE_3121_length_1311_cov_38.468647	766	846	2	21	80	0.2625000
NODE_3121_length_1311_cov_38.468647	766	846	8	59	80	0.7375000
NODE_3125_length_1310_cov_37.739884	679	759	0	76	80	0.9500000
NODE_3125_length_1310_cov_37.739884	679	759	2	4	80	0.0500000
NODE_3125_length_1310_cov_37.739884	683	763	0	72	80	0.9000000
NODE_3125_length_1310_cov_37.739884	683	763	2	8	80	0.1000000
NODE_3125_length_1310_cov_37.739884	732	816	0	23	84	0.2738095
NODE_3125_length_1310_cov_37.739884	732	816	2	61	84	0.7261904
NODE_3125_length_1310_cov_37.739884	736	816	0	19	80	0.2375000
NODE_3125_length_1310_cov_37.739884	736	816	2	61	80	0.7625000
NODE_3125_length_1310_cov_37.739884	812	892	0	53	80	0.6625000
NODE_3125_length_1310_cov_37.739884	812	892	1	11	80	0.1375000
NODE_3125_length_1310_cov_37.739884	812	892	2	16	80	0.2000000
NODE_3125_length_1310_cov_37.739884	865	945	0	16	80	0.2000000
NODE_3125_length_1310_cov_37.739884	865	945	1	50	80	0.6250000
NODE_3125_length_1310_cov_37.739884	865	945	2	14	80	0.1750000
NODE_3126_length_1310_cov_12.245252	615	695	0	80	80	1.0000000
NODE_3126_length_1310_cov_12.245252	668	748	0	80	80	1.0000000
NODE_3127_length_1310_cov_10.184971	422	502	0	80	80	1.0000000
NODE_3127_length_1310_cov_10.184971	475	555	0	80	80	1.0000000
NODE_3128_length_1310_cov_3.186623	876	956	0	80	80	1.0000000
NODE_3128_length_1310_cov_3.186623	929	1009	0	80	80	1.0000000
NODE_3131_length_1310_cov_0.757225	1255	1310	2	3	55	0.0545455
NODE_3131_length_1310_cov_0.757225	1255	1310	4	19	55	0.3454545
NODE_3131_length_1310_cov_0.757225	1255	1310	5	1	55	0.0181818
NODE_3131_length_1310_cov_0.757225	1255	1310	6	32	55	0.5818182
NODE_3132_length_1309_cov_34.942149	474	554	0	47	80	0.5875000
NODE_3132_length_1309_cov_34.942149	474	554	6	33	80	0.4125000
NODE_3132_length_1309_cov_34.942149	527	607	0	4	80	0.0500000
NODE_3132_length_1309_cov_34.942149	527	607	6	76	80	0.9500000
NODE_3132_length_1309_cov_34.942149	603	683	0	80	80	1.0000000
NODE_3132_length_1309_cov_34.942149	656	736	0	80	80	1.0000000
NODE_3133_length_1309_cov_10.571074	839	921	0	45	82	0.5487805
NODE_3133_length_1309_cov_10.571074	839	921	2	37	82	0.4512195
NODE_3133_length_1309_cov_10.571074	894	974	0	2	80	0.0250000
NODE_3133_length_1309_cov_10.571074	894	974	2	78	80	0.9750000
NODE_3135_length_1308_cov_43.461538	330	410	0	80	80	1.0000000
NODE_3135_length_1308_cov_43.461538	383	463	0	80	80	1.0000000
NODE_3145_length_1307_cov_11.290563	595	673	0	32	78	0.4102564
NODE_3145_length_1307_cov_11.290563	595	673	2	46	78	0.5897436
NODE_3145_length_1307_cov_11.290563	646	726	2	80	80	1.0000000
NODE_3146_length_1307_cov_8.653146	430	510	0	80	80	1.0000000
NODE_3146_length_1307_cov_8.653146	483	563	0	80	80	1.0000000
NODE_3153_length_1306_cov_26.813587	369	449	0	80	80	1.0000000
NODE_3153_length_1306_cov_26.813587	422	502	0	80	80	1.0000000
NODE_3153_length_1306_cov_26.813587	498	578	0	80	80	1.0000000
NODE_3153_length_1306_cov_26.813587	551	631	0	56	80	0.7000000
NODE_3153_length_1306_cov_26.813587	551	631	2	24	80	0.3000000
NODE_3154_length_1306_cov_24.904722	634	714	0	80	80	1.0000000
NODE_3154_length_1306_cov_24.904722	687	767	0	80	80	1.0000000
NODE_3155_length_1306_cov_18.274234	388	468	0	12	80	0.1500000
NODE_3155_length_1306_cov_18.274234	388	468	8	68	80	0.8500000
NODE_3155_length_1306_cov_18.274234	441	521	8	80	80	1.0000000
NODE_3156_length_1306_cov_15.176471	1214	1294	0	41	80	0.5125000
NODE_3156_length_1306_cov_15.176471	1214	1294	2	39	80	0.4875000
NODE_3157_length_1306_cov_12.699254	458	538	0	80	80	1.0000000
NODE_3157_length_1306_cov_12.699254	511	591	0	80	80	1.0000000
NODE_3158_length_1306_cov_9.958575	630	710	0	61	80	0.7625000
NODE_3158_length_1306_cov_9.958575	630	710	2	19	80	0.2375000
NODE_3158_length_1306_cov_9.958575	683	764	0	81	81	1.0000000
NODE_3159_length_1306_cov_2.739851	1206	1246	0	40	40	1.0000000
NODE_3168_length_1304_cov_28.444813	511	591	0	17	80	0.2125000
NODE_3168_length_1304_cov_28.444813	511	591	2	63	80	0.7875000
NODE_3168_length_1304_cov_28.444813	564	644	2	80	80	1.0000000
NODE_3168_length_1304_cov_28.444813	640	720	0	42	80	0.5250000
NODE_3168_length_1304_cov_28.444813	640	720	2	17	80	0.2125000
NODE_3168_length_1304_cov_28.444813	640	720	7	1	80	0.0125000
NODE_3168_length_1304_cov_28.444813	640	720	8	20	80	0.2500000
NODE_3168_length_1304_cov_28.444813	693	773	0	6	80	0.0750000
NODE_3168_length_1304_cov_28.444813	693	773	7	5	80	0.0625000
NODE_3168_length_1304_cov_28.444813	693	773	8	69	80	0.8625000
NODE_3169_length_1304_cov_27.137759	575	655	0	80	80	1.0000000
NODE_3169_length_1304_cov_27.137759	628	708	0	80	80	1.0000000
NODE_3169_length_1304_cov_27.137759	704	784	0	19	80	0.2375000
NODE_3169_length_1304_cov_27.137759	704	784	2	61	80	0.7625000
NODE_3169_length_1304_cov_27.137759	757	837	2	80	80	1.0000000
NODE_3171_length_1303_cov_36.546512	458	538	0	49	80	0.6125000
NODE_3171_length_1303_cov_36.546512	458	538	2	31	80	0.3875000
NODE_3171_length_1303_cov_36.546512	511	591	0	4	80	0.0500000
NODE_3171_length_1303_cov_36.546512	511	591	2	76	80	0.9500000
NODE_3171_length_1303_cov_36.546512	587	667	0	80	80	1.0000000
NODE_3171_length_1303_cov_36.546512	640	720	0	80	80	1.0000000
NODE_3174_length_1302_cov_22.265170	747	827	0	19	80	0.2375000
NODE_3174_length_1302_cov_22.265170	747	827	2	61	80	0.7625000
NODE_3174_length_1302_cov_22.265170	800	880	0	17	80	0.2125000
NODE_3174_length_1302_cov_22.265170	800	880	2	63	80	0.7875000
NODE_3175_length_1302_cov_16.199501	480	560	0	80	80	1.0000000
NODE_3175_length_1302_cov_16.199501	533	613	0	80	80	1.0000000
NODE_3176_length_1302_cov_6.953450	687	767	0	80	80	1.0000000
NODE_3176_length_1302_cov_6.953450	740	820	0	80	80	1.0000000
NODE_3179_length_1301_cov_31.711314	401	481	0	59	80	0.7375000
NODE_3179_length_1301_cov_31.711314	401	481	2	21	80	0.2625000
NODE_3179_length_1301_cov_31.711314	454	534	0	22	80	0.2750000
NODE_3179_length_1301_cov_31.711314	454	534	2	58	80	0.7250000
NODE_3181_length_1301_cov_5.529950	246	326	0	80	80	1.0000000
NODE_3181_length_1301_cov_5.529950	299	379	0	80	80	1.0000000
NODE_3186_length_1300_cov_39.109908	602	682	0	80	80	1.0000000
NODE_3186_length_1300_cov_39.109908	655	735	0	47	80	0.5875000
NODE_3186_length_1300_cov_39.109908	655	735	2	33	80	0.4125000
NODE_3187_length_1300_cov_34.360533	586	666	2	12	80	0.1500000
NODE_3187_length_1300_cov_34.360533	586	666	6	34	80	0.4250000
NODE_3187_length_1300_cov_34.360533	586	666	8	34	80	0.4250000
NODE_3187_length_1300_cov_34.360533	639	719	0	14	80	0.1750000
NODE_3187_length_1300_cov_34.360533	639	719	2	13	80	0.1625000
NODE_3187_length_1300_cov_34.360533	639	719	4	1	80	0.0125000
NODE_3187_length_1300_cov_34.360533	639	719	8	52	80	0.6500000
NODE_3188_length_1300_cov_4.659450	454	535	0	42	81	0.5185185
NODE_3188_length_1300_cov_4.659450	454	535	2	39	81	0.4814815
NODE_3188_length_1300_cov_4.659450	508	588	2	80	80	1.0000000
NODE_3189_length_1299_cov_29.071667	452	532	0	36	80	0.4500000
NODE_3189_length_1299_cov_29.071667	452	532	2	44	80	0.5500000
NODE_3190_length_1299_cov_23.600833	818	898	4	80	80	1.0000000
NODE_3190_length_1299_cov_23.600833	871	951	0	46	80	0.5750000
NODE_3190_length_1299_cov_23.600833	871	951	4	34	80	0.4250000
NODE_3191_length_1299_cov_23.169167	625	705	0	80	80	1.0000000
NODE_3191_length_1299_cov_23.169167	678	758	0	80	80	1.0000000
NODE_3191_length_1299_cov_23.169167	754	834	0	80	80	1.0000000
NODE_3191_length_1299_cov_23.169167	807	887	0	80	80	1.0000000
NODE_3192_length_1299_cov_19.315000	306	386	0	80	80	1.0000000
NODE_3192_length_1299_cov_19.315000	359	439	0	80	80	1.0000000
NODE_3192_length_1299_cov_19.315000	435	515	0	80	80	1.0000000
NODE_3192_length_1299_cov_19.315000	488	568	0	80	80	1.0000000
NODE_3193_length_1299_cov_13.691667	540	620	0	16	80	0.2000000
NODE_3193_length_1299_cov_13.691667	540	620	3	25	80	0.3125000
NODE_3193_length_1299_cov_13.691667	540	620	4	39	80	0.4875000
NODE_3193_length_1299_cov_13.691667	593	673	3	75	80	0.9375000
NODE_3193_length_1299_cov_13.691667	593	673	4	5	80	0.0625000
NODE_3195_length_1298_cov_58.277731	679	759	0	80	80	1.0000000
NODE_3195_length_1298_cov_58.277731	732	812	0	80	80	1.0000000
NODE_3195_length_1298_cov_58.277731	808	888	0	80	80	1.0000000
NODE_3195_length_1298_cov_58.277731	861	941	0	80	80	1.0000000
NODE_3196_length_1298_cov_31.319433	375	455	0	80	80	1.0000000
NODE_3196_length_1298_cov_31.319433	428	508	0	80	80	1.0000000
NODE_3196_length_1298_cov_31.319433	504	584	0	80	80	1.0000000
NODE_3196_length_1298_cov_31.319433	557	637	0	48	80	0.6000000
NODE_3196_length_1298_cov_31.319433	557	637	2	32	80	0.4000000
NODE_3197_length_1298_cov_2.158465	294	360	0	66	66	1.0000000
NODE_3201_length_1296_cov_34.778613	620	700	2	80	80	1.0000000
NODE_3201_length_1296_cov_34.778613	673	753	0	6	80	0.0750000
NODE_3201_length_1296_cov_34.778613	673	753	1	44	80	0.5500000
NODE_3201_length_1296_cov_34.778613	673	753	2	30	80	0.3750000
NODE_3202_length_1296_cov_28.726817	671	751	0	80	80	1.0000000
NODE_3202_length_1296_cov_28.726817	724	804	0	80	80	1.0000000
NODE_3202_length_1296_cov_28.726817	800	880	0	80	80	1.0000000
NODE_3202_length_1296_cov_28.726817	853	933	0	80	80	1.0000000
NODE_3205_length_1295_cov_10.661371	818	898	0	80	80	1.0000000
NODE_3205_length_1295_cov_10.661371	871	951	0	80	80	1.0000000
NODE_3211_length_1294_cov_15.098745	353	433	0	48	80	0.6000000
NODE_3211_length_1294_cov_15.098745	353	433	2	32	80	0.4000000
NODE_3211_length_1294_cov_15.098745	406	486	0	8	80	0.1000000
NODE_3211_length_1294_cov_15.098745	406	486	2	72	80	0.9000000
NODE_3216_length_1293_cov_26.580402	595	675	0	50	80	0.6250000
NODE_3216_length_1293_cov_26.580402	595	675	2	30	80	0.3750000
NODE_3216_length_1293_cov_26.580402	648	728	2	80	80	1.0000000
NODE_3216_length_1293_cov_26.580402	724	804	0	59	80	0.7375000
NODE_3216_length_1293_cov_26.580402	724	804	2	21	80	0.2625000
NODE_3216_length_1293_cov_26.580402	777	857	0	80	80	1.0000000
NODE_3217_length_1293_cov_9.252094	1187	1207	0	20	20	1.0000000
NODE_3220_length_1293_cov_2.118090	1131	1195	0	64	64	1.0000000
NODE_3220_length_1293_cov_2.118090	1184	1248	0	64	64	1.0000000
NODE_3224_length_1292_cov_50.158424	402	482	0	38	80	0.4750000
NODE_3224_length_1292_cov_50.158424	402	482	2	42	80	0.5250000
NODE_3224_length_1292_cov_50.158424	455	535	0	80	80	1.0000000
NODE_3224_length_1292_cov_50.158424	531	611	0	62	80	0.7750000
NODE_3224_length_1292_cov_50.158424	531	611	2	18	80	0.2250000
NODE_3224_length_1292_cov_50.158424	584	664	0	9	80	0.1125000
NODE_3224_length_1292_cov_50.158424	584	664	2	71	80	0.8875000
NODE_3225_length_1292_cov_36.535624	670	750	0	80	80	1.0000000
NODE_3225_length_1292_cov_36.535624	723	803	0	80	80	1.0000000
NODE_3226_length_1292_cov_24.523889	420	500	0	15	80	0.1875000
NODE_3226_length_1292_cov_24.523889	420	500	6	65	80	0.8125000
NODE_3226_length_1292_cov_24.523889	473	553	0	1	80	0.0125000
NODE_3226_length_1292_cov_24.523889	473	553	6	79	80	0.9875000
NODE_3232_length_1291_cov_8.734060	623	703	0	80	80	1.0000000
NODE_3232_length_1291_cov_8.734060	676	756	0	80	80	1.0000000
NODE_3233_length_1291_cov_8.625839	756	836	2	10	80	0.1250000
NODE_3233_length_1291_cov_8.625839	756	836	4	62	80	0.7750000
NODE_3233_length_1291_cov_8.625839	756	836	6	8	80	0.1000000
NODE_3233_length_1291_cov_8.625839	809	889	0	27	80	0.3375000
NODE_3233_length_1291_cov_8.625839	809	889	2	19	80	0.2375000
NODE_3233_length_1291_cov_8.625839	809	889	4	28	80	0.3500000
NODE_3233_length_1291_cov_8.625839	809	889	6	6	80	0.0750000
NODE_3236_length_1290_cov_24.120067	497	577	0	28	80	0.3500000
NODE_3236_length_1290_cov_24.120067	497	577	8	52	80	0.6500000
NODE_3236_length_1290_cov_24.120067	550	630	4	10	80	0.1250000
NODE_3236_length_1290_cov_24.120067	550	630	8	33	80	0.4125000
NODE_3236_length_1290_cov_24.120067	550	630	11	1	80	0.0125000
NODE_3236_length_1290_cov_24.120067	550	630	12	36	80	0.4500000
NODE_3236_length_1290_cov_24.120067	626	706	0	17	80	0.2125000
NODE_3236_length_1290_cov_24.120067	626	706	4	63	80	0.7875000
NODE_3236_length_1290_cov_24.120067	679	759	0	9	80	0.1125000
NODE_3236_length_1290_cov_24.120067	679	759	4	71	80	0.8875000
NODE_3237_length_1290_cov_18.874895	671	751	0	57	80	0.7125000
NODE_3237_length_1290_cov_18.874895	671	751	2	23	80	0.2875000
NODE_3237_length_1290_cov_18.874895	724	804	0	80	80	1.0000000
NODE_3238_length_1290_cov_11.627204	573	653	0	10	80	0.1250000
NODE_3238_length_1290_cov_11.627204	573	653	4	33	80	0.4125000
NODE_3238_length_1290_cov_11.627204	573	653	8	37	80	0.4625000
NODE_3238_length_1290_cov_11.627204	626	706	4	22	80	0.2750000
NODE_3238_length_1290_cov_11.627204	626	706	5	1	80	0.0125000
NODE_3238_length_1290_cov_11.627204	626	706	6	19	80	0.2375000
NODE_3238_length_1290_cov_11.627204	626	706	8	38	80	0.4750000
NODE_3239_length_1290_cov_11.215785	373	453	0	64	80	0.8000000
NODE_3239_length_1290_cov_11.215785	373	453	2	16	80	0.2000000
NODE_3239_length_1290_cov_11.215785	426	506	0	11	80	0.1375000
NODE_3239_length_1290_cov_11.215785	426	506	2	69	80	0.8625000
NODE_3240_length_1290_cov_8.752309	788	868	0	80	80	1.0000000
NODE_3240_length_1290_cov_8.752309	841	921	0	80	80	1.0000000
NODE_3242_length_1289_cov_47.476471	919	999	23	7	80	0.0875000
NODE_3242_length_1289_cov_47.476471	919	999	25	2	80	0.0250000
NODE_3242_length_1289_cov_47.476471	919	999	27	11	80	0.1375000
NODE_3242_length_1289_cov_47.476471	919	999	29	7	80	0.0875000
NODE_3242_length_1289_cov_47.476471	919	999	41	1	80	0.0125000
NODE_3242_length_1289_cov_47.476471	919	999	43	52	80	0.6500000
NODE_3242_length_1289_cov_47.476471	972	1052	6	37	80	0.4625000
NODE_3242_length_1289_cov_47.476471	972	1052	23	7	80	0.0875000
NODE_3242_length_1289_cov_47.476471	972	1052	25	2	80	0.0250000
NODE_3242_length_1289_cov_47.476471	972	1052	26	1	80	0.0125000
NODE_3242_length_1289_cov_47.476471	972	1052	27	26	80	0.3250000
NODE_3242_length_1289_cov_47.476471	972	1052	29	7	80	0.0875000
NODE_3243_length_1289_cov_18.497479	688	768	0	80	80	1.0000000
NODE_3243_length_1289_cov_18.497479	741	821	0	80	80	1.0000000
NODE_3243_length_1289_cov_18.497479	817	893	0	76	76	1.0000000
NODE_3243_length_1289_cov_18.497479	878	958	0	80	80	1.0000000
NODE_3244_length_1289_cov_11.692437	574	654	0	80	80	1.0000000
NODE_3244_length_1289_cov_11.692437	627	707	0	80	80	1.0000000
NODE_3244_length_1289_cov_11.692437	703	783	0	80	80	1.0000000
NODE_3244_length_1289_cov_11.692437	756	836	0	80	80	1.0000000
NODE_3249_length_1288_cov_29.369218	711	791	0	80	80	1.0000000
NODE_3249_length_1288_cov_29.369218	764	844	0	80	80	1.0000000
NODE_3250_length_1288_cov_6.207738	735	815	0	59	80	0.7375000
NODE_3250_length_1288_cov_6.207738	735	815	2	21	80	0.2625000
NODE_3250_length_1288_cov_6.207738	788	868	0	6	80	0.0750000
NODE_3250_length_1288_cov_6.207738	788	868	2	74	80	0.9250000
NODE_3255_length_1288_cov_1.731707	1017	1095	6	24	78	0.3076923
NODE_3255_length_1288_cov_1.731707	1017	1095	7	26	78	0.3333333
NODE_3255_length_1288_cov_1.731707	1017	1095	8	18	78	0.2307692
NODE_3255_length_1288_cov_1.731707	1017	1095	9	10	78	0.1282051
NODE_3261_length_1287_cov_29.186027	730	810	0	80	80	1.0000000
NODE_3261_length_1287_cov_29.186027	783	863	0	80	80	1.0000000
NODE_3262_length_1287_cov_22.747475	168	248	0	18	80	0.2250000
NODE_3262_length_1287_cov_22.747475	168	248	2	62	80	0.7750000
NODE_3262_length_1287_cov_22.747475	221	301	0	71	80	0.8875000
NODE_3262_length_1287_cov_22.747475	221	301	2	9	80	0.1125000
NODE_3263_length_1287_cov_19.478956	575	655	0	80	80	1.0000000
NODE_3263_length_1287_cov_19.478956	628	708	0	80	80	1.0000000
NODE_3266_length_1286_cov_27.128054	428	508	0	80	80	1.0000000
NODE_3266_length_1286_cov_27.128054	481	561	0	80	80	1.0000000
NODE_3266_length_1286_cov_27.128054	557	637	0	80	80	1.0000000
NODE_3266_length_1286_cov_27.128054	610	690	0	80	80	1.0000000
NODE_3267_length_1286_cov_12.192081	647	727	0	80	80	1.0000000
NODE_3267_length_1286_cov_12.192081	700	780	0	80	80	1.0000000
NODE_3267_length_1286_cov_12.192081	776	856	0	7	80	0.0875000
NODE_3267_length_1286_cov_12.192081	776	856	2	73	80	0.9125000
NODE_3267_length_1286_cov_12.192081	829	909	0	53	80	0.6625000
NODE_3267_length_1286_cov_12.192081	829	909	2	27	80	0.3375000
NODE_3268_length_1286_cov_8.338669	577	657	0	80	80	1.0000000
NODE_3268_length_1286_cov_8.338669	630	710	0	80	80	1.0000000
NODE_3273_length_1285_cov_40.282462	751	831	6	80	80	1.0000000
NODE_3273_length_1285_cov_40.282462	804	884	3	30	80	0.3750000
NODE_3273_length_1285_cov_40.282462	804	884	6	50	80	0.6250000
NODE_3274_length_1285_cov_15.422428	647	727	0	80	80	1.0000000
NODE_3274_length_1285_cov_15.422428	700	780	0	80	80	1.0000000
NODE_3275_length_1285_cov_6.620573	589	669	0	80	80	1.0000000
NODE_3275_length_1285_cov_6.620573	642	722	0	45	80	0.5625000
NODE_3275_length_1285_cov_6.620573	642	722	2	35	80	0.4375000
NODE_3279_length_1284_cov_5.637975	294	374	0	80	80	1.0000000
NODE_3279_length_1284_cov_5.637975	347	427	0	80	80	1.0000000
NODE_3283_length_1283_cov_10.070101	408	488	5	5	80	0.0625000
NODE_3283_length_1283_cov_10.070101	408	488	6	75	80	0.9375000
NODE_3283_length_1283_cov_10.070101	461	541	1	23	80	0.2875000
NODE_3283_length_1283_cov_10.070101	461	541	2	20	80	0.2500000
NODE_3283_length_1283_cov_10.070101	461	541	6	37	80	0.4625000
NODE_3288_length_1282_cov_37.786137	649	729	0	80	80	1.0000000
NODE_3288_length_1282_cov_37.786137	702	782	0	80	80	1.0000000
NODE_3288_length_1282_cov_37.786137	778	858	0	7	80	0.0875000
NODE_3288_length_1282_cov_37.786137	778	858	4	73	80	0.9125000
NODE_3288_length_1282_cov_37.786137	831	911	4	34	80	0.4250000
NODE_3288_length_1282_cov_37.786137	831	911	6	1	80	0.0125000
NODE_3288_length_1282_cov_37.786137	831	911	10	45	80	0.5625000
NODE_3289_length_1282_cov_25.900254	85	167	10	9	82	0.1097561
NODE_3289_length_1282_cov_25.900254	85	167	12	8	82	0.0975610
NODE_3289_length_1282_cov_25.900254	85	167	14	1	82	0.0121951
NODE_3289_length_1282_cov_25.900254	85	167	16	1	82	0.0121951
NODE_3289_length_1282_cov_25.900254	85	167	18	17	82	0.2073171
NODE_3289_length_1282_cov_25.900254	85	167	20	2	82	0.0243902
NODE_3289_length_1282_cov_25.900254	85	167	22	3	82	0.0365854
NODE_3289_length_1282_cov_25.900254	85	167	24	2	82	0.0243902
NODE_3289_length_1282_cov_25.900254	85	167	31	1	82	0.0121951
NODE_3289_length_1282_cov_25.900254	85	167	32	12	82	0.1463415
NODE_3289_length_1282_cov_25.900254	85	167	33	2	82	0.0243902
NODE_3289_length_1282_cov_25.900254	85	167	34	24	82	0.2926829
NODE_3289_length_1282_cov_25.900254	140	183	4	3	43	0.0697674
NODE_3289_length_1282_cov_25.900254	140	183	5	1	43	0.0232558
NODE_3289_length_1282_cov_25.900254	140	183	6	1	43	0.0232558
NODE_3289_length_1282_cov_25.900254	140	183	8	7	43	0.1627907
NODE_3289_length_1282_cov_25.900254	140	183	10	13	43	0.3023256
NODE_3289_length_1282_cov_25.900254	140	183	12	8	43	0.1860465
NODE_3289_length_1282_cov_25.900254	140	183	14	1	43	0.0232558
NODE_3289_length_1282_cov_25.900254	140	183	16	1	43	0.0232558
NODE_3289_length_1282_cov_25.900254	140	183	18	8	43	0.1860465
NODE_3289_length_1282_cov_25.900254	1006	1086	24	4	80	0.0500000
NODE_3289_length_1282_cov_25.900254	1006	1086	25	17	80	0.2125000
NODE_3289_length_1282_cov_25.900254	1006	1086	26	4	80	0.0500000
NODE_3289_length_1282_cov_25.900254	1006	1086	27	10	80	0.1250000
NODE_3289_length_1282_cov_25.900254	1006	1086	28	3	80	0.0375000
NODE_3289_length_1282_cov_25.900254	1006	1086	29	3	80	0.0375000
NODE_3289_length_1282_cov_25.900254	1006	1086	32	1	80	0.0125000
NODE_3289_length_1282_cov_25.900254	1006	1086	38	2	80	0.0250000
NODE_3289_length_1282_cov_25.900254	1006	1086	40	1	80	0.0125000
NODE_3289_length_1282_cov_25.900254	1006	1086	45	1	80	0.0125000
NODE_3289_length_1282_cov_25.900254	1006	1086	46	3	80	0.0375000
NODE_3289_length_1282_cov_25.900254	1006	1086	49	2	80	0.0250000
NODE_3289_length_1282_cov_25.900254	1006	1086	55	1	80	0.0125000
NODE_3289_length_1282_cov_25.900254	1006	1086	56	5	80	0.0625000
NODE_3289_length_1282_cov_25.900254	1006	1086	58	1	80	0.0125000
NODE_3289_length_1282_cov_25.900254	1006	1086	59	1	80	0.0125000
NODE_3289_length_1282_cov_25.900254	1006	1086	61	4	80	0.0500000
NODE_3289_length_1282_cov_25.900254	1006	1086	64	1	80	0.0125000
NODE_3289_length_1282_cov_25.900254	1006	1086	65	1	80	0.0125000
NODE_3289_length_1282_cov_25.900254	1006	1086	66	3	80	0.0375000
NODE_3289_length_1282_cov_25.900254	1006	1086	68	1	80	0.0125000
NODE_3289_length_1282_cov_25.900254	1006	1086	70	1	80	0.0125000
NODE_3289_length_1282_cov_25.900254	1006	1086	75	2	80	0.0250000
NODE_3289_length_1282_cov_25.900254	1006	1086	76	1	80	0.0125000
NODE_3289_length_1282_cov_25.900254	1006	1086	78	4	80	0.0500000
NODE_3289_length_1282_cov_25.900254	1006	1086	81	1	80	0.0125000
NODE_3289_length_1282_cov_25.900254	1006	1086	85	2	80	0.0250000
NODE_3289_length_1282_cov_25.900254	1006	1086	24	4	80	0.0500000
NODE_3289_length_1282_cov_25.900254	1006	1086	25	17	80	0.2125000
NODE_3289_length_1282_cov_25.900254	1006	1086	26	4	80	0.0500000
NODE_3289_length_1282_cov_25.900254	1006	1086	27	10	80	0.1250000
NODE_3289_length_1282_cov_25.900254	1006	1086	28	3	80	0.0375000
NODE_3289_length_1282_cov_25.900254	1006	1086	29	3	80	0.0375000
NODE_3289_length_1282_cov_25.900254	1006	1086	32	1	80	0.0125000
NODE_3289_length_1282_cov_25.900254	1006	1086	38	2	80	0.0250000
NODE_3289_length_1282_cov_25.900254	1006	1086	40	1	80	0.0125000
NODE_3289_length_1282_cov_25.900254	1006	1086	45	1	80	0.0125000
NODE_3289_length_1282_cov_25.900254	1006	1086	46	3	80	0.0375000
NODE_3289_length_1282_cov_25.900254	1006	1086	49	2	80	0.0250000
NODE_3289_length_1282_cov_25.900254	1006	1086	55	1	80	0.0125000
NODE_3289_length_1282_cov_25.900254	1006	1086	56	5	80	0.0625000
NODE_3289_length_1282_cov_25.900254	1006	1086	58	1	80	0.0125000
NODE_3289_length_1282_cov_25.900254	1006	1086	59	1	80	0.0125000
NODE_3289_length_1282_cov_25.900254	1006	1086	61	4	80	0.0500000
NODE_3289_length_1282_cov_25.900254	1006	1086	64	1	80	0.0125000
NODE_3289_length_1282_cov_25.900254	1006	1086	65	1	80	0.0125000
NODE_3289_length_1282_cov_25.900254	1006	1086	66	3	80	0.0375000
NODE_3289_length_1282_cov_25.900254	1006	1086	68	1	80	0.0125000
NODE_3289_length_1282_cov_25.900254	1006	1086	70	1	80	0.0125000
NODE_3289_length_1282_cov_25.900254	1006	1086	75	2	80	0.0250000
NODE_3289_length_1282_cov_25.900254	1006	1086	76	1	80	0.0125000
NODE_3289_length_1282_cov_25.900254	1006	1086	78	4	80	0.0500000
NODE_3289_length_1282_cov_25.900254	1006	1086	81	1	80	0.0125000
NODE_3289_length_1282_cov_25.900254	1006	1086	85	2	80	0.0250000
NODE_3289_length_1282_cov_25.900254	1015	1086	25	13	71	0.1830986
NODE_3289_length_1282_cov_25.900254	1015	1086	26	3	71	0.0422535
NODE_3289_length_1282_cov_25.900254	1015	1086	27	10	71	0.1408451
NODE_3289_length_1282_cov_25.900254	1015	1086	28	3	71	0.0422535
NODE_3289_length_1282_cov_25.900254	1015	1086	29	3	71	0.0422535
NODE_3289_length_1282_cov_25.900254	1015	1086	32	1	71	0.0140845
NODE_3289_length_1282_cov_25.900254	1015	1086	38	2	71	0.0281690
NODE_3289_length_1282_cov_25.900254	1015	1086	40	1	71	0.0140845
NODE_3289_length_1282_cov_25.900254	1015	1086	45	1	71	0.0140845
NODE_3289_length_1282_cov_25.900254	1015	1086	46	3	71	0.0422535
NODE_3289_length_1282_cov_25.900254	1015	1086	49	2	71	0.0281690
NODE_3289_length_1282_cov_25.900254	1015	1086	55	1	71	0.0140845
NODE_3289_length_1282_cov_25.900254	1015	1086	56	5	71	0.0704225
NODE_3289_length_1282_cov_25.900254	1015	1086	58	1	71	0.0140845
NODE_3289_length_1282_cov_25.900254	1015	1086	59	1	71	0.0140845
NODE_3289_length_1282_cov_25.900254	1015	1086	61	4	71	0.0563380
NODE_3289_length_1282_cov_25.900254	1015	1086	64	1	71	0.0140845
NODE_3289_length_1282_cov_25.900254	1015	1086	65	1	71	0.0140845
NODE_3289_length_1282_cov_25.900254	1015	1086	66	3	71	0.0422535
NODE_3289_length_1282_cov_25.900254	1015	1086	68	1	71	0.0140845
NODE_3289_length_1282_cov_25.900254	1015	1086	70	1	71	0.0140845
NODE_3289_length_1282_cov_25.900254	1015	1086	75	2	71	0.0281690
NODE_3289_length_1282_cov_25.900254	1015	1086	76	1	71	0.0140845
NODE_3289_length_1282_cov_25.900254	1015	1086	78	4	71	0.0563380
NODE_3289_length_1282_cov_25.900254	1015	1086	81	1	71	0.0140845
NODE_3289_length_1282_cov_25.900254	1015	1086	85	2	71	0.0281690
NODE_3290_length_1282_cov_14.600169	429	477	0	48	48	1.0000000
NODE_3290_length_1282_cov_14.600169	708	788	0	80	80	1.0000000
NODE_3291_length_1282_cov_8.017751	343	420	2	77	77	1.0000000
NODE_3292_length_1282_cov_5.092984	239	319	0	49	80	0.6125000
NODE_3292_length_1282_cov_5.092984	239	319	4	31	80	0.3875000
NODE_3292_length_1282_cov_5.092984	292	372	4	80	80	1.0000000
NODE_3295_length_1281_cov_31.342640	470	550	1	38	80	0.4750000
NODE_3295_length_1281_cov_31.342640	470	550	2	42	80	0.5250000
NODE_3295_length_1281_cov_31.342640	523	603	1	69	80	0.8625000
NODE_3295_length_1281_cov_31.342640	523	603	2	11	80	0.1375000
NODE_3295_length_1281_cov_31.342640	599	679	0	37	80	0.4625000
NODE_3295_length_1281_cov_31.342640	599	679	1	43	80	0.5375000
NODE_3295_length_1281_cov_31.342640	652	732	0	80	80	1.0000000
NODE_3296_length_1281_cov_25.482234	474	554	0	80	80	1.0000000
NODE_3296_length_1281_cov_25.482234	527	607	0	80	80	1.0000000
NODE_3297_length_1281_cov_14.617597	809	887	0	78	78	1.0000000
NODE_3297_length_1281_cov_14.617597	860	940	0	80	80	1.0000000
NODE_3298_length_1281_cov_12.065144	655	735	0	27	80	0.3375000
NODE_3298_length_1281_cov_12.065144	655	735	2	44	80	0.5500000
NODE_3298_length_1281_cov_12.065144	655	735	8	8	80	0.1000000
NODE_3298_length_1281_cov_12.065144	655	735	10	1	80	0.0125000
NODE_3298_length_1281_cov_12.065144	708	788	0	18	80	0.2250000
NODE_3298_length_1281_cov_12.065144	708	788	8	8	80	0.1000000
NODE_3298_length_1281_cov_12.065144	708	788	10	54	80	0.6750000
NODE_3299_length_1281_cov_9.235195	408	488	0	80	80	1.0000000
NODE_3299_length_1281_cov_9.235195	461	541	0	80	80	1.0000000
NODE_3300_length_1281_cov_7.153976	469	549	0	80	80	1.0000000
NODE_3300_length_1281_cov_7.153976	522	602	0	80	80	1.0000000
NODE_3307_length_1280_cov_24.231160	418	498	0	29	80	0.3625000
NODE_3307_length_1280_cov_24.231160	418	498	2	51	80	0.6375000
NODE_3307_length_1280_cov_24.231160	471	551	2	76	80	0.9500000
NODE_3307_length_1280_cov_24.231160	471	551	6	4	80	0.0500000
NODE_3307_length_1280_cov_24.231160	547	627	4	53	80	0.6625000
NODE_3307_length_1280_cov_24.231160	547	627	6	27	80	0.3375000
NODE_3307_length_1280_cov_24.231160	600	680	0	16	80	0.2000000
NODE_3307_length_1280_cov_24.231160	600	680	4	64	80	0.8000000
NODE_3308_length_1280_cov_5.908552	1077	1138	19	1	61	0.0163934
NODE_3308_length_1280_cov_5.908552	1077	1138	33	6	61	0.0983607
NODE_3308_length_1280_cov_5.908552	1077	1138	39	1	61	0.0163934
NODE_3308_length_1280_cov_5.908552	1077	1138	43	2	61	0.0327869
NODE_3308_length_1280_cov_5.908552	1077	1138	52	2	61	0.0327869
NODE_3308_length_1280_cov_5.908552	1077	1138	57	3	61	0.0491803
NODE_3308_length_1280_cov_5.908552	1077	1138	59	2	61	0.0327869
NODE_3308_length_1280_cov_5.908552	1077	1138	62	2	61	0.0327869
NODE_3308_length_1280_cov_5.908552	1077	1138	63	1	61	0.0163934
NODE_3308_length_1280_cov_5.908552	1077	1138	67	1	61	0.0163934
NODE_3308_length_1280_cov_5.908552	1077	1138	72	3	61	0.0491803
NODE_3308_length_1280_cov_5.908552	1077	1138	74	1	61	0.0163934
NODE_3308_length_1280_cov_5.908552	1077	1138	76	1	61	0.0163934
NODE_3308_length_1280_cov_5.908552	1077	1138	77	1	61	0.0163934
NODE_3308_length_1280_cov_5.908552	1077	1138	78	1	61	0.0163934
NODE_3308_length_1280_cov_5.908552	1077	1138	81	2	61	0.0327869
NODE_3308_length_1280_cov_5.908552	1077	1138	85	1	61	0.0163934
NODE_3308_length_1280_cov_5.908552	1077	1138	93	1	61	0.0163934
NODE_3308_length_1280_cov_5.908552	1077	1138	94	4	61	0.0655738
NODE_3308_length_1280_cov_5.908552	1077	1138	100	5	61	0.0819672
NODE_3308_length_1280_cov_5.908552	1077	1138	102	1	61	0.0163934
NODE_3308_length_1280_cov_5.908552	1077	1138	104	1	61	0.0163934
NODE_3308_length_1280_cov_5.908552	1077	1138	106	1	61	0.0163934
NODE_3308_length_1280_cov_5.908552	1077	1138	111	1	61	0.0163934
NODE_3308_length_1280_cov_5.908552	1077	1138	113	1	61	0.0163934
NODE_3308_length_1280_cov_5.908552	1077	1138	124	1	61	0.0163934
NODE_3308_length_1280_cov_5.908552	1077	1138	126	2	61	0.0327869
NODE_3308_length_1280_cov_5.908552	1077	1138	130	5	61	0.0819672
NODE_3308_length_1280_cov_5.908552	1077	1138	131	1	61	0.0163934
NODE_3308_length_1280_cov_5.908552	1077	1138	132	1	61	0.0163934
NODE_3308_length_1280_cov_5.908552	1077	1138	133	2	61	0.0327869
NODE_3308_length_1280_cov_5.908552	1077	1138	139	1	61	0.0163934
NODE_3308_length_1280_cov_5.908552	1077	1138	141	1	61	0.0163934
NODE_3308_length_1280_cov_5.908552	1077	1138	143	1	61	0.0163934
NODE_3311_length_1279_cov_16.840678	749	829	0	28	80	0.3500000
NODE_3311_length_1279_cov_16.840678	749	829	2	52	80	0.6500000
NODE_3311_length_1279_cov_16.840678	802	882	0	80	80	1.0000000
NODE_3312_length_1279_cov_3.772881	951	981	4	10	30	0.3333333
NODE_3312_length_1279_cov_3.772881	951	981	5	10	30	0.3333333
NODE_3312_length_1279_cov_3.772881	951	981	6	10	30	0.3333333
NODE_3317_length_1278_cov_45.991518	411	491	0	80	80	1.0000000
NODE_3317_length_1278_cov_45.991518	464	530	0	66	66	1.0000000
NODE_3318_length_1278_cov_37.164546	447	527	0	69	80	0.8625000
NODE_3318_length_1278_cov_37.164546	447	527	2	11	80	0.1375000
NODE_3318_length_1278_cov_37.164546	500	580	0	16	80	0.2000000
NODE_3318_length_1278_cov_37.164546	500	580	2	64	80	0.8000000
NODE_3318_length_1278_cov_37.164546	576	656	0	12	80	0.1500000
NODE_3318_length_1278_cov_37.164546	576	656	2	19	80	0.2375000
NODE_3318_length_1278_cov_37.164546	576	656	4	1	80	0.0125000
NODE_3318_length_1278_cov_37.164546	576	656	5	48	80	0.6000000
NODE_3318_length_1278_cov_37.164546	629	709	5	50	80	0.6250000
NODE_3318_length_1278_cov_37.164546	629	709	6	30	80	0.3750000
NODE_3319_length_1278_cov_12.505513	522	602	0	80	80	1.0000000
NODE_3319_length_1278_cov_12.505513	575	655	0	80	80	1.0000000
NODE_3320_length_1278_cov_12.171332	212	292	0	48	80	0.6000000
NODE_3320_length_1278_cov_12.171332	212	292	2	15	80	0.1875000
NODE_3320_length_1278_cov_12.171332	212	292	4	11	80	0.1375000
NODE_3320_length_1278_cov_12.171332	212	292	6	6	80	0.0750000
NODE_3320_length_1278_cov_12.171332	265	344	2	10	79	0.1265823
NODE_3320_length_1278_cov_12.171332	265	344	4	13	79	0.1645570
NODE_3320_length_1278_cov_12.171332	265	344	6	56	79	0.7088608
NODE_3329_length_1277_cov_21.407470	667	717	0	38	50	0.7600000
NODE_3329_length_1277_cov_21.407470	667	717	1	1	50	0.0200000
NODE_3329_length_1277_cov_21.407470	667	717	2	11	50	0.2200000
NODE_3329_length_1277_cov_21.407470	690	770	0	15	80	0.1875000
NODE_3329_length_1277_cov_21.407470	690	770	1	1	80	0.0125000
NODE_3329_length_1277_cov_21.407470	690	770	2	64	80	0.8000000
NODE_3330_length_1277_cov_18.111205	834	914	0	80	80	1.0000000
NODE_3330_length_1277_cov_18.111205	887	967	0	80	80	1.0000000
NODE_3331_length_1277_cov_12.449066	276	356	0	80	80	1.0000000
NODE_3331_length_1277_cov_12.449066	329	409	0	80	80	1.0000000
NODE_3331_length_1277_cov_12.449066	405	485	0	80	80	1.0000000
NODE_3331_length_1277_cov_12.449066	458	538	0	80	80	1.0000000
NODE_3337_length_1276_cov_21.446899	526	606	0	80	80	1.0000000
NODE_3337_length_1276_cov_21.446899	579	659	0	80	80	1.0000000
NODE_3337_length_1276_cov_21.446899	655	735	0	80	80	1.0000000
NODE_3337_length_1276_cov_21.446899	708	788	0	80	80	1.0000000
NODE_3346_length_1275_cov_35.471939	632	712	0	80	80	1.0000000
NODE_3346_length_1275_cov_35.471939	685	765	0	80	80	1.0000000
NODE_3347_length_1275_cov_19.910714	361	441	4	74	80	0.9250000
NODE_3347_length_1275_cov_19.910714	361	441	12	6	80	0.0750000
NODE_3347_length_1275_cov_19.910714	414	494	4	21	80	0.2625000
NODE_3347_length_1275_cov_19.910714	414	494	8	49	80	0.6125000
NODE_3347_length_1275_cov_19.910714	414	494	11	1	80	0.0125000
NODE_3347_length_1275_cov_19.910714	414	494	12	9	80	0.1125000
NODE_3347_length_1275_cov_19.910714	879	949	20	1	70	0.0142857
NODE_3347_length_1275_cov_19.910714	879	949	22	65	70	0.9285714
NODE_3347_length_1275_cov_19.910714	879	949	24	4	70	0.0571429
NODE_3351_length_1274_cov_23.404255	427	507	0	80	80	1.0000000
NODE_3351_length_1274_cov_23.404255	480	560	0	80	80	1.0000000
NODE_3351_length_1274_cov_23.404255	556	636	0	33	80	0.4125000
NODE_3351_length_1274_cov_23.404255	556	636	8	47	80	0.5875000
NODE_3351_length_1274_cov_23.404255	609	689	8	80	80	1.0000000
NODE_3352_length_1274_cov_20.178723	545	625	0	32	80	0.4000000
NODE_3352_length_1274_cov_20.178723	545	625	4	30	80	0.3750000
NODE_3352_length_1274_cov_20.178723	545	625	6	18	80	0.2250000
NODE_3352_length_1274_cov_20.178723	598	678	0	9	80	0.1125000
NODE_3352_length_1274_cov_20.178723	598	678	6	71	80	0.8875000
NODE_3354_length_1274_cov_2.019574	841	907	0	66	66	1.0000000
NODE_3354_length_1274_cov_2.019574	894	961	0	13	67	0.1940299
NODE_3354_length_1274_cov_2.019574	894	961	4	21	67	0.3134328
NODE_3354_length_1274_cov_2.019574	894	961	6	33	67	0.4925373
NODE_3361_length_1273_cov_42.349233	337	417	0	80	80	1.0000000
NODE_3361_length_1273_cov_42.349233	390	470	0	80	80	1.0000000
NODE_3361_length_1273_cov_42.349233	466	546	0	4	80	0.0500000
NODE_3361_length_1273_cov_42.349233	466	546	4	76	80	0.9500000
NODE_3361_length_1273_cov_42.349233	519	599	0	27	80	0.3375000
NODE_3361_length_1273_cov_42.349233	519	599	4	53	80	0.6625000
NODE_3364_length_1273_cov_4.404600	407	487	0	3	80	0.0375000
NODE_3364_length_1273_cov_4.404600	407	487	2	77	80	0.9625000
NODE_3364_length_1273_cov_4.404600	460	540	0	56	80	0.7000000
NODE_3364_length_1273_cov_4.404600	460	540	2	24	80	0.3000000
NODE_3368_length_1272_cov_28.887468	588	668	0	80	80	1.0000000
NODE_3368_length_1272_cov_28.887468	641	721	0	80	80	1.0000000
NODE_3369_length_1272_cov_11.290708	366	447	14	30	81	0.3703704
NODE_3369_length_1272_cov_11.290708	366	447	16	3	81	0.0370370
NODE_3369_length_1272_cov_11.290708	366	447	18	48	81	0.5925926
NODE_3375_length_1270_cov_13.617421	365	445	0	80	80	1.0000000
NODE_3375_length_1270_cov_13.617421	396	473	0	77	77	1.0000000
NODE_3375_length_1270_cov_13.617421	418	498	0	80	80	1.0000000
NODE_3375_length_1270_cov_13.617421	449	473	0	24	24	1.0000000
NODE_3375_length_1270_cov_13.617421	465	498	0	33	33	1.0000000
NODE_3376_length_1270_cov_11.645602	294	374	0	80	80	1.0000000
NODE_3376_length_1270_cov_11.645602	347	427	0	80	80	1.0000000
NODE_3377_length_1270_cov_2.495303	74	131	16	2	57	0.0350877
NODE_3377_length_1270_cov_2.495303	74	131	20	1	57	0.0175439
NODE_3377_length_1270_cov_2.495303	74	131	21	19	57	0.3333333
NODE_3377_length_1270_cov_2.495303	74	131	23	1	57	0.0175439
NODE_3377_length_1270_cov_2.495303	74	131	26	4	57	0.0701754
NODE_3377_length_1270_cov_2.495303	74	131	31	3	57	0.0526316
NODE_3377_length_1270_cov_2.495303	74	131	32	3	57	0.0526316
NODE_3377_length_1270_cov_2.495303	74	131	34	5	57	0.0877193
NODE_3377_length_1270_cov_2.495303	74	131	36	4	57	0.0701754
NODE_3377_length_1270_cov_2.495303	74	131	38	15	57	0.2631579
NODE_3378_length_1269_cov_55.070940	492	569	6	4	77	0.0519481
NODE_3378_length_1269_cov_55.070940	492	569	9	1	77	0.0129870
NODE_3378_length_1269_cov_55.070940	492	569	10	72	77	0.9350649
NODE_3378_length_1269_cov_55.070940	545	625	1	34	80	0.4250000
NODE_3378_length_1269_cov_55.070940	545	625	5	5	80	0.0625000
NODE_3378_length_1269_cov_55.070940	545	625	10	38	80	0.4750000
NODE_3378_length_1269_cov_55.070940	545	625	11	3	80	0.0375000
NODE_3378_length_1269_cov_55.070940	621	701	0	29	80	0.3625000
NODE_3378_length_1269_cov_55.070940	621	701	1	5	80	0.0625000
NODE_3378_length_1269_cov_55.070940	621	701	2	46	80	0.5750000
NODE_3378_length_1269_cov_55.070940	674	754	0	80	80	1.0000000
NODE_3379_length_1269_cov_22.154701	1152	1216	16	64	64	1.0000000
NODE_3379_length_1269_cov_22.154701	1152	1216	16	64	64	1.0000000
NODE_3379_length_1269_cov_22.154701	1152	1216	16	64	64	1.0000000
NODE_3379_length_1269_cov_22.154701	1189	1269	8	4	80	0.0500000
NODE_3379_length_1269_cov_22.154701	1189	1269	10	4	80	0.0500000
NODE_3379_length_1269_cov_22.154701	1189	1269	16	72	80	0.9000000
NODE_3379_length_1269_cov_22.154701	1189	1269	8	4	80	0.0500000
NODE_3379_length_1269_cov_22.154701	1189	1269	10	4	80	0.0500000
NODE_3379_length_1269_cov_22.154701	1189	1269	16	72	80	0.9000000
NODE_3380_length_1269_cov_18.753846	317	398	10	1	81	0.0123457
NODE_3380_length_1269_cov_18.753846	317	398	13	24	81	0.2962963
NODE_3380_length_1269_cov_18.753846	317	398	14	10	81	0.1234568
NODE_3380_length_1269_cov_18.753846	317	398	17	23	81	0.2839506
NODE_3380_length_1269_cov_18.753846	317	398	19	23	81	0.2839506
NODE_3381_length_1269_cov_12.637607	580	660	0	80	80	1.0000000
NODE_3381_length_1269_cov_12.637607	633	713	0	80	80	1.0000000
NODE_3381_length_1269_cov_12.637607	709	729	0	20	20	1.0000000
NODE_3381_length_1269_cov_12.637607	709	789	0	59	80	0.7375000
NODE_3381_length_1269_cov_12.637607	709	789	2	21	80	0.2625000
NODE_3381_length_1269_cov_12.637607	762	842	0	6	80	0.0750000
NODE_3381_length_1269_cov_12.637607	762	842	2	31	80	0.3875000
NODE_3381_length_1269_cov_12.637607	762	842	4	43	80	0.5375000
NODE_3382_length_1269_cov_10.552137	765	845	0	61	80	0.7625000
NODE_3382_length_1269_cov_10.552137	765	845	2	19	80	0.2375000
NODE_3382_length_1269_cov_10.552137	818	898	0	8	80	0.1000000
NODE_3382_length_1269_cov_10.552137	818	898	2	72	80	0.9000000
NODE_3391_length_1268_cov_12.862275	300	350	32	1	50	0.0200000
NODE_3391_length_1268_cov_12.862275	300	350	38	1	50	0.0200000
NODE_3391_length_1268_cov_12.862275	300	350	46	1	50	0.0200000
NODE_3391_length_1268_cov_12.862275	300	350	52	4	50	0.0800000
NODE_3391_length_1268_cov_12.862275	300	350	55	1	50	0.0200000
NODE_3391_length_1268_cov_12.862275	300	350	57	4	50	0.0800000
NODE_3391_length_1268_cov_12.862275	300	350	60	1	50	0.0200000
NODE_3391_length_1268_cov_12.862275	300	350	62	1	50	0.0200000
NODE_3391_length_1268_cov_12.862275	300	350	66	1	50	0.0200000
NODE_3391_length_1268_cov_12.862275	300	350	67	1	50	0.0200000
NODE_3391_length_1268_cov_12.862275	300	350	70	3	50	0.0600000
NODE_3391_length_1268_cov_12.862275	300	350	72	1	50	0.0200000
NODE_3391_length_1268_cov_12.862275	300	350	74	2	50	0.0400000
NODE_3391_length_1268_cov_12.862275	300	350	80	2	50	0.0400000
NODE_3391_length_1268_cov_12.862275	300	350	82	2	50	0.0400000
NODE_3391_length_1268_cov_12.862275	300	350	84	1	50	0.0200000
NODE_3391_length_1268_cov_12.862275	300	350	85	1	50	0.0200000
NODE_3391_length_1268_cov_12.862275	300	350	87	3	50	0.0600000
NODE_3391_length_1268_cov_12.862275	300	350	89	2	50	0.0400000
NODE_3391_length_1268_cov_12.862275	300	350	91	1	50	0.0200000
NODE_3391_length_1268_cov_12.862275	300	350	93	1	50	0.0200000
NODE_3391_length_1268_cov_12.862275	300	350	95	2	50	0.0400000
NODE_3391_length_1268_cov_12.862275	300	350	108	1	50	0.0200000
NODE_3391_length_1268_cov_12.862275	300	350	110	2	50	0.0400000
NODE_3391_length_1268_cov_12.862275	300	350	112	2	50	0.0400000
NODE_3391_length_1268_cov_12.862275	300	350	114	2	50	0.0400000
NODE_3391_length_1268_cov_12.862275	300	350	116	2	50	0.0400000
NODE_3391_length_1268_cov_12.862275	300	350	122	2	50	0.0400000
NODE_3391_length_1268_cov_12.862275	300	350	124	2	50	0.0400000
NODE_3392_length_1268_cov_9.523524	265	345	0	14	80	0.1750000
NODE_3392_length_1268_cov_9.523524	265	345	6	66	80	0.8250000
NODE_3392_length_1268_cov_9.523524	318	398	6	80	80	1.0000000
NODE_3393_length_1267_cov_21.315068	299	379	0	80	80	1.0000000
NODE_3393_length_1267_cov_21.315068	352	432	0	80	80	1.0000000
NODE_3393_length_1267_cov_21.315068	698	778	2	21	80	0.2625000
NODE_3393_length_1267_cov_21.315068	698	778	4	59	80	0.7375000
NODE_3393_length_1267_cov_21.315068	751	831	0	33	80	0.4125000
NODE_3393_length_1267_cov_21.315068	751	831	1	1	80	0.0125000
NODE_3393_length_1267_cov_21.315068	751	831	2	40	80	0.5000000
NODE_3393_length_1267_cov_21.315068	751	831	4	6	80	0.0750000
NODE_3394_length_1267_cov_14.880137	606	686	0	14	80	0.1750000
NODE_3394_length_1267_cov_14.880137	606	686	2	66	80	0.8250000
NODE_3394_length_1267_cov_14.880137	659	739	0	8	80	0.1000000
NODE_3394_length_1267_cov_14.880137	659	739	2	72	80	0.9000000
NODE_3397_length_1266_cov_20.584404	357	437	0	80	80	1.0000000
NODE_3397_length_1266_cov_20.584404	410	490	0	80	80	1.0000000
NODE_3398_length_1266_cov_16.571551	359	435	0	76	76	1.0000000
NODE_3398_length_1266_cov_16.571551	408	488	0	80	80	1.0000000
NODE_3399_length_1266_cov_14.218509	517	595	0	78	78	1.0000000
NODE_3399_length_1266_cov_14.218509	568	648	0	80	80	1.0000000
NODE_3399_length_1266_cov_14.218509	644	724	0	80	80	1.0000000
NODE_3399_length_1266_cov_14.218509	697	777	0	80	80	1.0000000
NODE_3403_length_1265_cov_9.807890	429	509	0	2	80	0.0250000
NODE_3403_length_1265_cov_9.807890	429	509	8	78	80	0.9750000
NODE_3403_length_1265_cov_9.807890	482	562	8	80	80	1.0000000
NODE_3404_length_1265_cov_8.233276	160	207	4	34	47	0.7234042
NODE_3404_length_1265_cov_8.233276	160	207	6	13	47	0.2765957
NODE_3404_length_1265_cov_8.233276	1004	1058	4	54	54	1.0000000
NODE_3406_length_1265_cov_3.941681	503	583	0	56	80	0.7000000
NODE_3406_length_1265_cov_3.941681	503	583	1	18	80	0.2250000
NODE_3406_length_1265_cov_3.941681	503	583	2	6	80	0.0750000
NODE_3406_length_1265_cov_3.941681	556	636	0	80	80	1.0000000
NODE_3408_length_1264_cov_8.024034	290	370	0	80	80	1.0000000
NODE_3408_length_1264_cov_8.024034	343	423	0	80	80	1.0000000
NODE_3413_length_1263_cov_8.566151	698	778	0	11	80	0.1375000
NODE_3413_length_1263_cov_8.566151	698	778	2	69	80	0.8625000
NODE_3413_length_1263_cov_8.566151	751	831	0	61	80	0.7625000
NODE_3413_length_1263_cov_8.566151	751	831	2	19	80	0.2375000
NODE_3413_length_1263_cov_8.566151	833	910	0	77	77	1.0000000
NODE_3413_length_1263_cov_8.566151	883	963	0	80	80	1.0000000
NODE_3414_length_1263_cov_7.376289	1060	1140	0	80	80	1.0000000
NODE_3414_length_1263_cov_7.376289	1113	1213	0	100	100	1.0000000
NODE_3416_length_1263_cov_1.827320	227	307	0	80	80	1.0000000
NODE_3416_length_1263_cov_1.827320	280	360	0	80	80	1.0000000
NODE_3418_length_1262_cov_17.416165	404	484	0	74	80	0.9250000
NODE_3418_length_1262_cov_17.416165	404	484	2	6	80	0.0750000
NODE_3418_length_1262_cov_17.416165	457	537	0	21	80	0.2625000
NODE_3418_length_1262_cov_17.416165	457	537	2	59	80	0.7375000
NODE_3419_length_1262_cov_15.268272	648	728	0	12	80	0.1500000
NODE_3419_length_1262_cov_15.268272	648	728	2	68	80	0.8500000
NODE_3419_length_1262_cov_15.268272	701	781	0	61	80	0.7625000
NODE_3419_length_1262_cov_15.268272	701	781	2	19	80	0.2375000
NODE_3419_length_1262_cov_15.268272	777	857	0	4	80	0.0500000
NODE_3419_length_1262_cov_15.268272	777	857	2	29	80	0.3625000
NODE_3419_length_1262_cov_15.268272	777	857	4	47	80	0.5875000
NODE_3419_length_1262_cov_15.268272	830	910	0	22	80	0.2750000
NODE_3419_length_1262_cov_15.268272	830	910	2	45	80	0.5625000
NODE_3419_length_1262_cov_15.268272	830	910	4	13	80	0.1625000
NODE_3424_length_1261_cov_1.777969	272	318	2	46	46	1.0000000
NODE_3425_length_1260_cov_55.640827	499	579	4	12	80	0.1500000
NODE_3425_length_1260_cov_55.640827	499	579	6	27	80	0.3375000
NODE_3425_length_1260_cov_55.640827	499	579	10	41	80	0.5125000
NODE_3425_length_1260_cov_55.640827	552	632	4	12	80	0.1500000
NODE_3425_length_1260_cov_55.640827	552	632	6	64	80	0.8000000
NODE_3425_length_1260_cov_55.640827	552	632	10	4	80	0.0500000
NODE_3425_length_1260_cov_55.640827	628	708	0	67	80	0.8375000
NODE_3425_length_1260_cov_55.640827	628	708	2	9	80	0.1125000
NODE_3425_length_1260_cov_55.640827	628	708	6	4	80	0.0500000
NODE_3425_length_1260_cov_55.640827	681	761	0	80	80	1.0000000
NODE_3426_length_1260_cov_12.242894	427	507	0	80	80	1.0000000
NODE_3426_length_1260_cov_12.242894	480	560	0	80	80	1.0000000
NODE_3436_length_1259_cov_15.381897	509	589	1	14	80	0.1750000
NODE_3436_length_1259_cov_15.381897	509	589	3	4	80	0.0500000
NODE_3436_length_1259_cov_15.381897	509	589	4	62	80	0.7750000
NODE_3436_length_1259_cov_15.381897	562	642	1	27	80	0.3375000
NODE_3436_length_1259_cov_15.381897	562	642	2	40	80	0.5000000
NODE_3436_length_1259_cov_15.381897	562	642	3	4	80	0.0500000
NODE_3436_length_1259_cov_15.381897	562	642	4	9	80	0.1125000
NODE_3439_length_1258_cov_33.519413	608	688	0	65	80	0.8125000
NODE_3439_length_1258_cov_33.519413	608	688	2	15	80	0.1875000
NODE_3439_length_1258_cov_33.519413	661	741	0	12	80	0.1500000
NODE_3439_length_1258_cov_33.519413	661	741	2	16	80	0.2000000
NODE_3439_length_1258_cov_33.519413	661	741	4	52	80	0.6500000
NODE_3440_length_1258_cov_22.569456	583	663	0	80	80	1.0000000
NODE_3440_length_1258_cov_22.569456	636	716	0	80	80	1.0000000
NODE_3441_length_1258_cov_18.747196	308	388	0	80	80	1.0000000
NODE_3441_length_1258_cov_18.747196	361	441	0	80	80	1.0000000
NODE_3441_length_1258_cov_18.747196	437	517	0	76	80	0.9500000
NODE_3441_length_1258_cov_18.747196	437	517	2	4	80	0.0500000
NODE_3441_length_1258_cov_18.747196	490	570	0	23	80	0.2875000
NODE_3441_length_1258_cov_18.747196	490	570	2	57	80	0.7125000
NODE_3442_length_1258_cov_13.699741	332	412	0	71	80	0.8875000
NODE_3442_length_1258_cov_13.699741	332	412	2	1	80	0.0125000
NODE_3442_length_1258_cov_13.699741	332	412	3	8	80	0.1000000
NODE_3442_length_1258_cov_13.699741	385	465	0	80	80	1.0000000
NODE_3447_length_1257_cov_34.029361	567	647	0	80	80	1.0000000
NODE_3447_length_1257_cov_34.029361	620	700	0	80	80	1.0000000
NODE_3447_length_1257_cov_34.029361	696	776	0	80	80	1.0000000
NODE_3447_length_1257_cov_34.029361	749	829	0	80	80	1.0000000
NODE_3449_length_1257_cov_7.892919	317	397	0	36	80	0.4500000
NODE_3449_length_1257_cov_7.892919	317	397	3	1	80	0.0125000
NODE_3449_length_1257_cov_7.892919	317	397	4	43	80	0.5375000
NODE_3449_length_1257_cov_7.892919	370	450	0	15	80	0.1875000
NODE_3449_length_1257_cov_7.892919	370	450	4	65	80	0.8125000
NODE_3452_length_1256_cov_50.506482	389	469	0	27	80	0.3375000
NODE_3452_length_1256_cov_50.506482	389	469	4	53	80	0.6625000
NODE_3452_length_1256_cov_50.506482	442	522	4	80	80	1.0000000
NODE_3452_length_1256_cov_50.506482	518	598	0	28	80	0.3500000
NODE_3452_length_1256_cov_50.506482	518	598	2	46	80	0.5750000
NODE_3452_length_1256_cov_50.506482	518	598	4	6	80	0.0750000
NODE_3452_length_1256_cov_50.506482	571	651	2	74	80	0.9250000
NODE_3452_length_1256_cov_50.506482	571	651	4	6	80	0.0750000
NODE_3453_length_1256_cov_25.944685	754	834	0	63	80	0.7875000
NODE_3453_length_1256_cov_25.944685	754	834	4	17	80	0.2125000
NODE_3453_length_1256_cov_25.944685	807	887	0	10	80	0.1250000
NODE_3453_length_1256_cov_25.944685	807	887	4	70	80	0.8750000
NODE_3455_length_1256_cov_21.720830	713	793	0	80	80	1.0000000
NODE_3455_length_1256_cov_21.720830	766	846	0	80	80	1.0000000
NODE_3456_length_1256_cov_14.242005	595	675	0	80	80	1.0000000
NODE_3456_length_1256_cov_14.242005	648	728	0	80	80	1.0000000
NODE_3457_length_1256_cov_5.870354	879	959	0	80	80	1.0000000
NODE_3463_length_1255_cov_37.271626	458	538	0	39	80	0.4875000
NODE_3463_length_1255_cov_37.271626	458	538	10	41	80	0.5125000
NODE_3463_length_1255_cov_37.271626	511	591	0	2	80	0.0250000
NODE_3463_length_1255_cov_37.271626	511	591	4	5	80	0.0625000
NODE_3463_length_1255_cov_37.271626	511	591	10	73	80	0.9125000
NODE_3463_length_1255_cov_37.271626	587	667	4	56	80	0.7000000
NODE_3463_length_1255_cov_37.271626	587	667	6	24	80	0.3000000
NODE_3463_length_1255_cov_37.271626	640	720	2	39	80	0.4875000
NODE_3463_length_1255_cov_37.271626	640	720	4	3	80	0.0375000
NODE_3463_length_1255_cov_37.271626	640	720	6	38	80	0.4750000
NODE_3464_length_1255_cov_21.374567	516	596	0	80	80	1.0000000
NODE_3464_length_1255_cov_21.374567	569	649	0	80	80	1.0000000
NODE_3464_length_1255_cov_21.374567	645	725	0	80	80	1.0000000
NODE_3464_length_1255_cov_21.374567	698	778	0	80	80	1.0000000
NODE_3465_length_1255_cov_18.391869	521	601	0	36	80	0.4500000
NODE_3465_length_1255_cov_18.391869	521	601	2	44	80	0.5500000
NODE_3465_length_1255_cov_18.391869	574	654	0	7	80	0.0875000
NODE_3465_length_1255_cov_18.391869	574	654	2	73	80	0.9125000
NODE_3466_length_1255_cov_4.096021	1194	1242	0	48	48	1.0000000
NODE_3469_length_1254_cov_32.470996	612	692	0	80	80	1.0000000
NODE_3469_length_1254_cov_32.470996	665	745	0	80	80	1.0000000
NODE_3470_length_1254_cov_26.449351	488	568	0	50	80	0.6250000
NODE_3470_length_1254_cov_26.449351	488	568	9	2	80	0.0250000
NODE_3470_length_1254_cov_26.449351	488	568	10	28	80	0.3500000
NODE_3470_length_1254_cov_26.449351	541	621	0	9	80	0.1125000
NODE_3470_length_1254_cov_26.449351	541	621	9	46	80	0.5750000
NODE_3470_length_1254_cov_26.449351	541	621	10	25	80	0.3125000
NODE_3471_length_1254_cov_22.032035	531	611	0	27	80	0.3375000
NODE_3471_length_1254_cov_22.032035	531	611	9	3	80	0.0375000
NODE_3471_length_1254_cov_22.032035	531	611	10	2	80	0.0250000
NODE_3471_length_1254_cov_22.032035	531	611	12	48	80	0.6000000
NODE_3471_length_1254_cov_22.032035	584	664	6	35	80	0.4375000
NODE_3471_length_1254_cov_22.032035	584	664	7	1	80	0.0125000
NODE_3471_length_1254_cov_22.032035	584	664	8	11	80	0.1375000
NODE_3471_length_1254_cov_22.032035	584	664	12	33	80	0.4125000
NODE_3479_length_1253_cov_16.916811	651	731	0	80	80	1.0000000
NODE_3479_length_1253_cov_16.916811	704	784	0	62	80	0.7750000
NODE_3479_length_1253_cov_16.916811	704	784	2	18	80	0.2250000
NODE_3479_length_1253_cov_16.916811	780	860	0	9	80	0.1125000
NODE_3479_length_1253_cov_16.916811	780	860	2	71	80	0.8875000
NODE_3479_length_1253_cov_16.916811	833	913	0	62	80	0.7750000
NODE_3479_length_1253_cov_16.916811	833	913	2	18	80	0.2250000
NODE_3480_length_1253_cov_13.816291	811	891	2	80	80	1.0000000
NODE_3481_length_1253_cov_9.067591	306	386	0	1	80	0.0125000
NODE_3481_length_1253_cov_9.067591	306	386	2	7	80	0.0875000
NODE_3481_length_1253_cov_9.067591	306	386	4	72	80	0.9000000
NODE_3481_length_1253_cov_9.067591	359	439	0	24	80	0.3000000
NODE_3481_length_1253_cov_9.067591	359	439	4	56	80	0.7000000
NODE_3487_length_1252_cov_57.745880	477	557	0	80	80	1.0000000
NODE_3487_length_1252_cov_57.745880	530	610	0	80	80	1.0000000
NODE_3487_length_1252_cov_57.745880	606	686	0	29	80	0.3625000
NODE_3487_length_1252_cov_57.745880	606	686	1	2	80	0.0250000
NODE_3487_length_1252_cov_57.745880	606	686	2	49	80	0.6125000
NODE_3487_length_1252_cov_57.745880	659	739	2	80	80	1.0000000
NODE_3488_length_1252_cov_56.694709	594	674	0	10	80	0.1250000
NODE_3488_length_1252_cov_56.694709	594	674	2	35	80	0.4375000
NODE_3488_length_1252_cov_56.694709	594	674	4	35	80	0.4375000
NODE_3488_length_1252_cov_56.694709	647	727	0	38	80	0.4750000
NODE_3488_length_1252_cov_56.694709	647	727	2	26	80	0.3250000
NODE_3488_length_1252_cov_56.694709	647	727	4	16	80	0.2000000
NODE_3488_length_1252_cov_56.694709	723	803	0	80	80	1.0000000
NODE_3488_length_1252_cov_56.694709	785	847	0	62	62	1.0000000
NODE_3489_length_1252_cov_34.023417	468	548	0	15	80	0.1875000
NODE_3489_length_1252_cov_34.023417	468	548	2	65	80	0.8125000
NODE_3489_length_1252_cov_34.023417	521	601	0	6	80	0.0750000
NODE_3489_length_1252_cov_34.023417	521	601	2	74	80	0.9250000
NODE_3489_length_1252_cov_34.023417	597	677	0	11	80	0.1375000
NODE_3489_length_1252_cov_34.023417	597	677	2	67	80	0.8375000
NODE_3489_length_1252_cov_34.023417	597	677	4	2	80	0.0250000
NODE_3489_length_1252_cov_34.023417	650	730	2	36	80	0.4500000
NODE_3489_length_1252_cov_34.023417	650	730	4	44	80	0.5500000
NODE_3490_length_1252_cov_9.316565	573	653	2	80	80	1.0000000
NODE_3490_length_1252_cov_9.316565	626	706	0	33	80	0.4125000
NODE_3490_length_1252_cov_9.316565	626	706	2	47	80	0.5875000
NODE_3491_length_1252_cov_8.295750	602	682	0	80	80	1.0000000
NODE_3491_length_1252_cov_8.295750	655	735	0	80	80	1.0000000
NODE_3494_length_1251_cov_17.513889	579	659	0	80	80	1.0000000
NODE_3494_length_1251_cov_17.513889	632	712	0	80	80	1.0000000
NODE_3494_length_1251_cov_17.513889	708	788	0	80	80	1.0000000
NODE_3494_length_1251_cov_17.513889	761	841	0	80	80	1.0000000
NODE_3497_length_1251_cov_3.139757	0	76	0	76	76	1.0000000
NODE_3497_length_1251_cov_3.139757	49	98	0	47	49	0.9591837
NODE_3497_length_1251_cov_3.139757	49	98	2	2	49	0.0408163
NODE_3501_length_1250_cov_25.133797	325	405	0	45	80	0.5625000
NODE_3501_length_1250_cov_25.133797	325	405	2	35	80	0.4375000
NODE_3501_length_1250_cov_25.133797	378	458	0	3	80	0.0375000
NODE_3501_length_1250_cov_25.133797	378	458	2	77	80	0.9625000
NODE_3503_length_1250_cov_11.471764	652	733	0	81	81	1.0000000
NODE_3503_length_1250_cov_11.471764	706	786	0	80	80	1.0000000
NODE_3505_length_1249_cov_45.772174	543	623	0	72	80	0.9000000
NODE_3505_length_1249_cov_45.772174	543	623	1	8	80	0.1000000
NODE_3505_length_1249_cov_45.772174	596	676	0	19	80	0.2375000
NODE_3505_length_1249_cov_45.772174	596	676	1	45	80	0.5625000
NODE_3505_length_1249_cov_45.772174	596	676	2	16	80	0.2000000
NODE_3505_length_1249_cov_45.772174	672	749	2	9	77	0.1168831
NODE_3505_length_1249_cov_45.772174	672	749	3	1	77	0.0129870
NODE_3505_length_1249_cov_45.772174	672	749	4	57	77	0.7402598
NODE_3505_length_1249_cov_45.772174	672	749	6	10	77	0.1298701
NODE_3505_length_1249_cov_45.772174	729	802	3	39	73	0.5342466
NODE_3505_length_1249_cov_45.772174	729	802	4	10	73	0.1369863
NODE_3505_length_1249_cov_45.772174	729	802	5	5	73	0.0684932
NODE_3505_length_1249_cov_45.772174	729	802	6	19	73	0.2602740
NODE_3506_length_1249_cov_35.670435	515	595	0	30	80	0.3750000
NODE_3506_length_1249_cov_35.670435	515	595	2	50	80	0.6250000
NODE_3506_length_1249_cov_35.670435	568	648	0	30	80	0.3750000
NODE_3506_length_1249_cov_35.670435	568	648	2	50	80	0.6250000
NODE_3506_length_1249_cov_35.670435	644	724	0	80	80	1.0000000
NODE_3506_length_1249_cov_35.670435	697	777	0	80	80	1.0000000
NODE_3507_length_1249_cov_34.616522	576	656	0	7	80	0.0875000
NODE_3507_length_1249_cov_34.616522	576	656	8	73	80	0.9125000
NODE_3507_length_1249_cov_34.616522	629	709	0	7	80	0.0875000
NODE_3507_length_1249_cov_34.616522	629	709	8	73	80	0.9125000
NODE_3507_length_1249_cov_34.616522	705	785	0	80	80	1.0000000
NODE_3507_length_1249_cov_34.616522	758	838	0	80	80	1.0000000
NODE_3508_length_1249_cov_19.592174	461	541	2	61	80	0.7625000
NODE_3508_length_1249_cov_19.592174	461	541	4	19	80	0.2375000
NODE_3508_length_1249_cov_19.592174	514	594	2	48	80	0.6000000
NODE_3508_length_1249_cov_19.592174	514	594	4	32	80	0.4000000
NODE_3508_length_1249_cov_19.592174	860	940	0	80	80	1.0000000
NODE_3508_length_1249_cov_19.592174	913	993	0	80	80	1.0000000
NODE_3509_length_1249_cov_14.926957	1153	1219	0	49	66	0.7424242
NODE_3509_length_1249_cov_14.926957	1153	1219	2	17	66	0.2575758
NODE_3509_length_1249_cov_14.926957	1192	1249	0	57	57	1.0000000
NODE_3509_length_1249_cov_14.926957	1192	1247	0	55	55	1.0000000
NODE_3509_length_1249_cov_14.926957	1192	1249	0	57	57	1.0000000
NODE_3510_length_1249_cov_7.682609	757	837	0	80	80	1.0000000
NODE_3510_length_1249_cov_7.682609	810	890	0	80	80	1.0000000
NODE_3514_length_1248_cov_14.351610	469	549	0	8	80	0.1000000
NODE_3514_length_1248_cov_14.351610	469	549	2	72	80	0.9000000
NODE_3514_length_1248_cov_14.351610	522	602	0	57	80	0.7125000
NODE_3514_length_1248_cov_14.351610	522	602	2	23	80	0.2875000
NODE_3514_length_1248_cov_14.351610	598	678	0	80	80	1.0000000
NODE_3514_length_1248_cov_14.351610	651	731	0	80	80	1.0000000
NODE_3515_length_1248_cov_11.181027	303	383	0	80	80	1.0000000
NODE_3515_length_1248_cov_11.181027	356	436	0	80	80	1.0000000
NODE_3515_length_1248_cov_11.181027	432	512	0	42	80	0.5250000
NODE_3515_length_1248_cov_11.181027	432	512	2	38	80	0.4750000
NODE_3515_length_1248_cov_11.181027	485	565	0	20	80	0.2500000
NODE_3515_length_1248_cov_11.181027	485	565	2	60	80	0.7500000
NODE_3516_length_1248_cov_4.372498	17	98	0	81	81	1.0000000
NODE_3516_length_1248_cov_4.372498	94	152	0	58	58	1.0000000
NODE_3517_length_1248_cov_2.356832	952	1032	0	80	80	1.0000000
NODE_3517_length_1248_cov_2.356832	1005	1085	0	80	80	1.0000000
NODE_3518_length_1248_cov_2.283725	1102	1151	0	49	49	1.0000000
NODE_3522_length_1247_cov_25.355401	487	567	0	80	80	1.0000000
NODE_3522_length_1247_cov_25.355401	540	620	0	80	80	1.0000000
NODE_3522_length_1247_cov_25.355401	616	696	0	80	80	1.0000000
NODE_3522_length_1247_cov_25.355401	669	749	0	80	80	1.0000000
NODE_3528_length_1246_cov_30.231909	433	513	0	80	80	1.0000000
NODE_3528_length_1246_cov_30.231909	486	566	0	43	80	0.5375000
NODE_3528_length_1246_cov_30.231909	486	566	2	37	80	0.4625000
NODE_3528_length_1246_cov_30.231909	562	642	2	36	80	0.4500000
NODE_3528_length_1246_cov_30.231909	562	642	4	44	80	0.5500000
NODE_3528_length_1246_cov_30.231909	615	695	0	1	80	0.0125000
NODE_3528_length_1246_cov_30.231909	615	695	1	6	80	0.0750000
NODE_3528_length_1246_cov_30.231909	615	695	2	68	80	0.8500000
NODE_3528_length_1246_cov_30.231909	615	695	4	5	80	0.0625000
NODE_3529_length_1246_cov_13.847428	497	577	6	7	80	0.0875000
NODE_3529_length_1246_cov_13.847428	497	577	12	37	80	0.4625000
NODE_3529_length_1246_cov_13.847428	497	577	18	36	80	0.4500000
NODE_3529_length_1246_cov_13.847428	550	630	12	54	80	0.6750000
NODE_3529_length_1246_cov_13.847428	550	630	14	26	80	0.3250000
NODE_3535_length_1245_cov_31.472949	443	523	0	80	80	1.0000000
NODE_3535_length_1245_cov_31.472949	496	576	0	80	80	1.0000000
NODE_3536_length_1245_cov_30.068935	771	841	0	23	70	0.3285714
NODE_3536_length_1245_cov_30.068935	771	841	1	47	70	0.6714286
NODE_3537_length_1245_cov_24.765271	668	748	0	80	80	1.0000000
NODE_3537_length_1245_cov_24.765271	721	801	0	80	80	1.0000000
NODE_3537_length_1245_cov_24.765271	797	877	0	80	80	1.0000000
NODE_3537_length_1245_cov_24.765271	850	930	0	80	80	1.0000000
NODE_3538_length_1245_cov_16.854276	655	735	0	80	80	1.0000000
NODE_3538_length_1245_cov_16.854276	701	771	0	70	70	1.0000000
NODE_3538_length_1245_cov_16.854276	708	788	0	80	80	1.0000000
NODE_3540_length_1245_cov_1.187609	1148	1194	4	46	46	1.0000000
NODE_3540_length_1245_cov_1.187609	1167	1245	0	15	78	0.1923077
NODE_3540_length_1245_cov_1.187609	1167	1245	4	63	78	0.8076923
NODE_3541_length_1244_cov_52.633188	501	581	0	22	80	0.2750000
NODE_3541_length_1244_cov_52.633188	501	581	2	58	80	0.7250000
NODE_3541_length_1244_cov_52.633188	554	634	0	75	80	0.9375000
NODE_3541_length_1244_cov_52.633188	554	634	2	5	80	0.0625000
NODE_3541_length_1244_cov_52.633188	630	710	0	80	80	1.0000000
NODE_3541_length_1244_cov_52.633188	683	763	0	80	80	1.0000000
NODE_3542_length_1244_cov_33.889956	445	525	0	80	80	1.0000000
NODE_3542_length_1244_cov_33.889956	498	578	0	80	80	1.0000000
NODE_3542_length_1244_cov_33.889956	574	654	0	80	80	1.0000000
NODE_3542_length_1244_cov_33.889956	627	707	0	80	80	1.0000000
NODE_3543_length_1244_cov_16.798253	644	724	4	80	80	1.0000000
NODE_3543_length_1244_cov_16.798253	697	777	4	80	80	1.0000000
NODE_3544_length_1244_cov_1.735371	276	347	0	71	71	1.0000000
NODE_3544_length_1244_cov_1.735371	276	347	0	71	71	1.0000000
NODE_3544_length_1244_cov_1.735371	320	400	0	80	80	1.0000000
NODE_3544_length_1244_cov_1.735371	320	400	0	80	80	1.0000000
NODE_3548_length_1243_cov_34.284965	774	854	1	68	80	0.8500000
NODE_3548_length_1243_cov_34.284965	774	854	4	4	80	0.0500000
NODE_3548_length_1243_cov_34.284965	774	854	5	8	80	0.1000000
NODE_3548_length_1243_cov_34.284965	827	907	1	15	80	0.1875000
NODE_3548_length_1243_cov_34.284965	827	907	4	33	80	0.4125000
NODE_3548_length_1243_cov_34.284965	827	907	5	32	80	0.4000000
NODE_3552_length_1242_cov_29.665792	539	619	0	80	80	1.0000000
NODE_3552_length_1242_cov_29.665792	592	672	0	80	80	1.0000000
NODE_3553_length_1242_cov_28.304462	506	586	0	80	80	1.0000000
NODE_3553_length_1242_cov_28.304462	559	639	0	60	80	0.7500000
NODE_3553_length_1242_cov_28.304462	559	639	2	20	80	0.2500000
NODE_3553_length_1242_cov_28.304462	635	715	2	80	80	1.0000000
NODE_3553_length_1242_cov_28.304462	688	768	0	22	80	0.2750000
NODE_3553_length_1242_cov_28.304462	688	768	2	58	80	0.7250000
NODE_3554_length_1242_cov_16.383202	704	784	0	80	80	1.0000000
NODE_3554_length_1242_cov_16.383202	757	837	0	80	80	1.0000000
NODE_3555_length_1242_cov_8.081365	688	768	4	46	80	0.5750000
NODE_3555_length_1242_cov_8.081365	688	768	8	34	80	0.4250000
NODE_3555_length_1242_cov_8.081365	741	821	6	8	80	0.1000000
NODE_3555_length_1242_cov_8.081365	741	821	8	72	80	0.9000000
NODE_3561_length_1241_cov_36.544658	602	682	4	38	80	0.4750000
NODE_3561_length_1241_cov_36.544658	602	682	6	42	80	0.5250000
NODE_3561_length_1241_cov_36.544658	655	735	0	33	80	0.4125000
NODE_3561_length_1241_cov_36.544658	655	735	4	25	80	0.3125000
NODE_3561_length_1241_cov_36.544658	655	735	6	22	80	0.2750000
NODE_3562_length_1241_cov_19.894921	676	756	0	80	80	1.0000000
NODE_3562_length_1241_cov_19.894921	729	809	0	36	80	0.4500000
NODE_3562_length_1241_cov_19.894921	729	809	4	44	80	0.5500000
NODE_3569_length_1240_cov_38.375110	483	563	0	80	80	1.0000000
NODE_3569_length_1240_cov_38.375110	536	616	0	80	80	1.0000000
NODE_3569_length_1240_cov_38.375110	612	692	0	80	80	1.0000000
NODE_3569_length_1240_cov_38.375110	665	745	0	80	80	1.0000000
NODE_3570_length_1240_cov_24.975460	625	705	14	44	80	0.5500000
NODE_3570_length_1240_cov_24.975460	625	705	16	36	80	0.4500000
NODE_3570_length_1240_cov_24.975460	678	758	2	32	80	0.4000000
NODE_3570_length_1240_cov_24.975460	678	758	16	48	80	0.6000000
NODE_3571_length_1240_cov_23.812445	731	811	0	80	80	1.0000000
NODE_3571_length_1240_cov_23.812445	784	864	0	80	80	1.0000000
NODE_3576_length_1239_cov_37.657895	399	479	0	80	80	1.0000000
NODE_3576_length_1239_cov_37.657895	452	532	0	80	80	1.0000000
NODE_3576_length_1239_cov_37.657895	528	608	0	80	80	1.0000000
NODE_3576_length_1239_cov_37.657895	581	661	0	80	80	1.0000000
NODE_3577_length_1239_cov_14.984211	398	478	0	1	80	0.0125000
NODE_3577_length_1239_cov_14.984211	398	478	2	1	80	0.0125000
NODE_3577_length_1239_cov_14.984211	398	478	4	78	80	0.9750000
NODE_3577_length_1239_cov_14.984211	451	531	4	80	80	1.0000000
NODE_3577_length_1239_cov_14.984211	771	825	0	54	54	1.0000000
NODE_3577_length_1239_cov_14.984211	798	878	0	80	80	1.0000000
NODE_3578_length_1239_cov_13.312281	806	886	0	80	80	1.0000000
NODE_3578_length_1239_cov_13.312281	859	939	0	80	80	1.0000000
NODE_3579_length_1239_cov_7.116667	444	524	0	20	80	0.2500000
NODE_3579_length_1239_cov_7.116667	444	524	2	60	80	0.7500000
NODE_3579_length_1239_cov_7.116667	497	577	0	35	80	0.4375000
NODE_3579_length_1239_cov_7.116667	497	577	2	45	80	0.5625000
NODE_3582_length_1238_cov_33.830553	625	705	0	80	80	1.0000000
NODE_3582_length_1238_cov_33.830553	678	758	0	80	80	1.0000000
NODE_3583_length_1238_cov_8.163301	664	744	2	2	80	0.0250000
NODE_3583_length_1238_cov_8.163301	664	744	4	45	80	0.5625000
NODE_3583_length_1238_cov_8.163301	664	744	6	33	80	0.4125000
NODE_3583_length_1238_cov_8.163301	717	797	4	23	80	0.2875000
NODE_3583_length_1238_cov_8.163301	717	797	5	1	80	0.0125000
NODE_3583_length_1238_cov_8.163301	717	797	6	6	80	0.0750000
NODE_3583_length_1238_cov_8.163301	717	797	10	23	80	0.2875000
NODE_3583_length_1238_cov_8.163301	717	797	12	15	80	0.1875000
NODE_3583_length_1238_cov_8.163301	717	797	14	12	80	0.1500000
NODE_3586_length_1237_cov_24.562390	447	527	3	48	80	0.6000000
NODE_3586_length_1237_cov_24.562390	447	527	4	32	80	0.4000000
NODE_3586_length_1237_cov_24.562390	500	580	0	35	80	0.4375000
NODE_3586_length_1237_cov_24.562390	500	580	4	45	80	0.5625000
NODE_3587_length_1237_cov_9.297012	515	595	0	80	80	1.0000000
NODE_3587_length_1237_cov_9.297012	568	648	0	80	80	1.0000000
NODE_3594_length_1236_cov_46.661390	632	712	9	25	80	0.3125000
NODE_3594_length_1236_cov_46.661390	632	712	10	36	80	0.4500000
NODE_3594_length_1236_cov_46.661390	632	712	14	19	80	0.2375000
NODE_3594_length_1236_cov_46.661390	685	765	4	36	80	0.4500000
NODE_3594_length_1236_cov_46.661390	685	765	10	8	80	0.1000000
NODE_3594_length_1236_cov_46.661390	685	765	14	36	80	0.4500000
NODE_3595_length_1236_cov_8.625330	735	815	10	7	80	0.0875000
NODE_3595_length_1236_cov_8.625330	735	815	12	25	80	0.3125000
NODE_3595_length_1236_cov_8.625330	735	815	14	8	80	0.1000000
NODE_3595_length_1236_cov_8.625330	735	815	16	40	80	0.5000000
NODE_3595_length_1236_cov_8.625330	788	868	0	35	80	0.4375000
NODE_3595_length_1236_cov_8.625330	788	868	2	2	80	0.0250000
NODE_3595_length_1236_cov_8.625330	788	868	6	1	80	0.0125000
NODE_3595_length_1236_cov_8.625330	788	868	10	22	80	0.2750000
NODE_3595_length_1236_cov_8.625330	788	868	12	15	80	0.1875000
NODE_3595_length_1236_cov_8.625330	788	868	16	5	80	0.0625000
NODE_3597_length_1235_cov_31.619718	331	411	8	80	80	1.0000000
NODE_3597_length_1235_cov_31.619718	384	464	0	50	80	0.6250000
NODE_3597_length_1235_cov_31.619718	384	464	8	30	80	0.3750000
NODE_3598_length_1235_cov_20.252641	559	639	0	14	80	0.1750000
NODE_3598_length_1235_cov_20.252641	559	639	2	66	80	0.8250000
NODE_3598_length_1235_cov_20.252641	612	692	0	12	80	0.1500000
NODE_3598_length_1235_cov_20.252641	612	692	2	68	80	0.8500000
NODE_3598_length_1235_cov_20.252641	688	768	0	80	80	1.0000000
NODE_3598_length_1235_cov_20.252641	741	821	0	80	80	1.0000000
NODE_3599_length_1235_cov_18.462148	695	775	0	62	80	0.7750000
NODE_3599_length_1235_cov_18.462148	695	775	2	3	80	0.0375000
NODE_3599_length_1235_cov_18.462148	695	775	4	15	80	0.1875000
NODE_3599_length_1235_cov_18.462148	748	828	0	9	80	0.1125000
NODE_3599_length_1235_cov_18.462148	748	828	2	3	80	0.0375000
NODE_3599_length_1235_cov_18.462148	748	828	4	68	80	0.8500000
NODE_3600_length_1235_cov_8.696303	765	845	2	7	80	0.0875000
NODE_3600_length_1235_cov_8.696303	765	845	4	11	80	0.1375000
NODE_3600_length_1235_cov_8.696303	765	845	6	62	80	0.7750000
NODE_3600_length_1235_cov_8.696303	818	898	0	42	80	0.5250000
NODE_3600_length_1235_cov_8.696303	818	898	2	18	80	0.2250000
NODE_3600_length_1235_cov_8.696303	818	898	6	20	80	0.2500000
NODE_3601_length_1235_cov_5.580106	544	624	2	80	80	1.0000000
NODE_3601_length_1235_cov_5.580106	597	677	0	27	80	0.3375000
NODE_3601_length_1235_cov_5.580106	597	677	2	53	80	0.6625000
NODE_3608_length_1234_cov_27.136564	528	608	0	80	80	1.0000000
NODE_3608_length_1234_cov_27.136564	581	661	0	80	80	1.0000000
NODE_3611_length_1233_cov_64.374780	497	577	0	80	80	1.0000000
NODE_3611_length_1233_cov_64.374780	550	630	0	36	80	0.4500000
NODE_3611_length_1233_cov_64.374780	550	630	10	44	80	0.5500000
NODE_3611_length_1233_cov_64.374780	626	706	0	26	80	0.3250000
NODE_3611_length_1233_cov_64.374780	626	706	10	54	80	0.6750000
NODE_3611_length_1233_cov_64.374780	679	759	0	79	80	0.9875000
NODE_3611_length_1233_cov_64.374780	679	759	10	1	80	0.0125000
NODE_3612_length_1233_cov_52.833333	654	734	14	63	80	0.7875000
NODE_3612_length_1233_cov_52.833333	654	734	31	16	80	0.2000000
NODE_3612_length_1233_cov_52.833333	654	734	33	1	80	0.0125000
NODE_3612_length_1233_cov_52.833333	707	787	14	10	80	0.1250000
NODE_3612_length_1233_cov_52.833333	707	787	22	28	80	0.3500000
NODE_3612_length_1233_cov_52.833333	707	787	27	1	80	0.0125000
NODE_3612_length_1233_cov_52.833333	707	787	28	9	80	0.1125000
NODE_3612_length_1233_cov_52.833333	707	787	31	29	80	0.3625000
NODE_3612_length_1233_cov_52.833333	707	787	32	1	80	0.0125000
NODE_3612_length_1233_cov_52.833333	707	787	33	2	80	0.0250000
NODE_3613_length_1233_cov_18.096120	522	602	0	5	80	0.0625000
NODE_3613_length_1233_cov_18.096120	522	602	4	21	80	0.2625000
NODE_3613_length_1233_cov_18.096120	522	602	6	54	80	0.6750000
NODE_3613_length_1233_cov_18.096120	575	655	0	38	80	0.4750000
NODE_3613_length_1233_cov_18.096120	575	655	2	14	80	0.1750000
NODE_3613_length_1233_cov_18.096120	575	655	6	28	80	0.3500000
NODE_3613_length_1233_cov_18.096120	651	731	0	80	80	1.0000000
NODE_3613_length_1233_cov_18.096120	704	784	0	80	80	1.0000000
NODE_3614_length_1233_cov_15.360670	585	656	2	71	71	1.0000000
NODE_3614_length_1233_cov_15.360670	631	709	0	39	78	0.5000000
NODE_3614_length_1233_cov_15.360670	631	709	2	39	78	0.5000000
NODE_3620_length_1232_cov_62.112974	552	632	0	80	80	1.0000000
NODE_3620_length_1232_cov_62.112974	605	694	0	42	89	0.4719101
NODE_3620_length_1232_cov_62.112974	605	694	2	47	89	0.5280899
NODE_3620_length_1232_cov_62.112974	690	770	0	65	80	0.8125000
NODE_3620_length_1232_cov_62.112974	690	770	2	15	80	0.1875000
NODE_3620_length_1232_cov_62.112974	743	823	0	23	80	0.2875000
NODE_3620_length_1232_cov_62.112974	743	823	2	8	80	0.1000000
NODE_3620_length_1232_cov_62.112974	743	823	4	49	80	0.6125000
NODE_3621_length_1232_cov_34.635481	469	549	0	30	80	0.3750000
NODE_3621_length_1232_cov_34.635481	469	549	2	16	80	0.2000000
NODE_3621_length_1232_cov_34.635481	469	549	6	34	80	0.4250000
NODE_3621_length_1232_cov_34.635481	522	602	0	4	80	0.0500000
NODE_3621_length_1232_cov_34.635481	522	602	4	30	80	0.3750000
NODE_3621_length_1232_cov_34.635481	522	602	6	46	80	0.5750000
NODE_3622_length_1232_cov_16.362754	774	854	0	18	80	0.2250000
NODE_3622_length_1232_cov_16.362754	774	854	6	62	80	0.7750000
NODE_3622_length_1232_cov_16.362754	827	907	0	71	80	0.8875000
NODE_3622_length_1232_cov_16.362754	827	907	6	9	80	0.1125000
NODE_3623_length_1232_cov_13.395410	234	315	0	33	81	0.4074074
NODE_3623_length_1232_cov_13.395410	234	315	2	48	81	0.5925926
NODE_3623_length_1232_cov_13.395410	287	368	0	81	81	1.0000000
NODE_3623_length_1232_cov_13.395410	364	444	0	80	80	1.0000000
NODE_3623_length_1232_cov_13.395410	417	497	0	71	80	0.8875000
NODE_3623_length_1232_cov_13.395410	417	497	2	9	80	0.1125000
NODE_3625_length_1231_cov_47.606890	509	589	2	18	80	0.2250000
NODE_3625_length_1231_cov_47.606890	509	589	4	62	80	0.7750000
NODE_3625_length_1231_cov_47.606890	562	642	0	7	80	0.0875000
NODE_3625_length_1231_cov_47.606890	562	642	2	44	80	0.5500000
NODE_3625_length_1231_cov_47.606890	562	642	3	1	80	0.0125000
NODE_3625_length_1231_cov_47.606890	562	642	4	28	80	0.3500000
NODE_3625_length_1231_cov_47.606890	638	718	0	1	80	0.0125000
NODE_3625_length_1231_cov_47.606890	638	718	4	79	80	0.9875000
NODE_3625_length_1231_cov_47.606890	691	771	0	54	80	0.6750000
NODE_3625_length_1231_cov_47.606890	691	771	4	26	80	0.3250000
NODE_3626_length_1231_cov_27.498233	698	777	0	79	79	1.0000000
NODE_3626_length_1231_cov_27.498233	750	830	0	80	80	1.0000000
NODE_3627_length_1231_cov_21.245583	673	753	0	80	80	1.0000000
NODE_3627_length_1231_cov_21.245583	726	806	0	80	80	1.0000000
NODE_3627_length_1231_cov_21.245583	802	882	0	80	80	1.0000000
NODE_3627_length_1231_cov_21.245583	860	935	0	75	75	1.0000000
NODE_3628_length_1231_cov_9.895760	515	595	4	80	80	1.0000000
NODE_3628_length_1231_cov_9.895760	568	648	0	45	80	0.5625000
NODE_3628_length_1231_cov_9.895760	568	648	4	35	80	0.4375000
NODE_3630_length_1230_cov_43.705570	412	492	0	22	80	0.2750000
NODE_3630_length_1230_cov_43.705570	412	492	2	58	80	0.7250000
NODE_3630_length_1230_cov_43.705570	465	545	0	75	80	0.9375000
NODE_3630_length_1230_cov_43.705570	465	545	2	5	80	0.0625000
NODE_3631_length_1230_cov_43.663130	501	581	0	78	80	0.9750000
NODE_3631_length_1230_cov_43.663130	501	581	2	2	80	0.0250000
NODE_3631_length_1230_cov_43.663130	554	634	0	25	80	0.3125000
NODE_3631_length_1230_cov_43.663130	554	634	2	55	80	0.6875000
NODE_3632_length_1230_cov_33.173298	315	395	0	4	80	0.0500000
NODE_3632_length_1230_cov_33.173298	315	395	4	76	80	0.9500000
NODE_3632_length_1230_cov_33.173298	368	448	0	35	80	0.4375000
NODE_3632_length_1230_cov_33.173298	368	448	4	45	80	0.5625000
NODE_3633_length_1230_cov_12.939876	201	281	0	38	80	0.4750000
NODE_3633_length_1230_cov_12.939876	201	281	2	8	80	0.1000000
NODE_3633_length_1230_cov_12.939876	201	281	6	34	80	0.4250000
NODE_3633_length_1230_cov_12.939876	218	273	0	21	55	0.3818182
NODE_3633_length_1230_cov_12.939876	218	273	2	8	55	0.1454545
NODE_3633_length_1230_cov_12.939876	218	273	6	26	55	0.4727273
NODE_3633_length_1230_cov_12.939876	254	334	6	64	80	0.8000000
NODE_3633_length_1230_cov_12.939876	254	334	8	8	80	0.1000000
NODE_3633_length_1230_cov_12.939876	254	334	10	8	80	0.1000000
NODE_3633_length_1230_cov_12.939876	330	410	4	4	80	0.0500000
NODE_3633_length_1230_cov_12.939876	330	410	8	26	80	0.3250000
NODE_3633_length_1230_cov_12.939876	330	410	10	21	80	0.2625000
NODE_3633_length_1230_cov_12.939876	330	410	11	11	80	0.1375000
NODE_3633_length_1230_cov_12.939876	330	410	12	18	80	0.2250000
NODE_3633_length_1230_cov_12.939876	383	463	2	17	80	0.2125000
NODE_3633_length_1230_cov_12.939876	383	463	4	40	80	0.5000000
NODE_3633_length_1230_cov_12.939876	383	463	8	23	80	0.2875000
NODE_3634_length_1230_cov_5.155615	248	328	0	8	80	0.1000000
NODE_3634_length_1230_cov_5.155615	248	328	2	72	80	0.9000000
NODE_3634_length_1230_cov_5.155615	301	381	0	8	80	0.1000000
NODE_3634_length_1230_cov_5.155615	301	381	2	72	80	0.9000000
NODE_3640_length_1229_cov_30.214159	341	421	0	41	80	0.5125000
NODE_3640_length_1229_cov_30.214159	341	421	2	39	80	0.4875000
NODE_3640_length_1229_cov_30.214159	394	474	2	80	80	1.0000000
NODE_3641_length_1229_cov_23.165487	376	456	0	28	80	0.3500000
NODE_3641_length_1229_cov_23.165487	376	456	2	52	80	0.6500000
NODE_3641_length_1229_cov_23.165487	429	509	0	41	80	0.5125000
NODE_3641_length_1229_cov_23.165487	429	509	2	39	80	0.4875000
NODE_3641_length_1229_cov_23.165487	505	585	0	80	80	1.0000000
NODE_3641_length_1229_cov_23.165487	558	638	0	80	80	1.0000000
NODE_3642_length_1229_cov_19.376991	484	564	0	64	80	0.8000000
NODE_3642_length_1229_cov_19.376991	484	564	2	16	80	0.2000000
NODE_3642_length_1229_cov_19.376991	537	614	0	11	77	0.1428571
NODE_3642_length_1229_cov_19.376991	537	614	2	66	77	0.8571429
NODE_3643_length_1229_cov_11.799115	670	748	0	78	78	1.0000000
NODE_3643_length_1229_cov_11.799115	728	801	0	73	73	1.0000000
NODE_3644_length_1229_cov_8.140708	970	1050	0	80	80	1.0000000
NODE_3644_length_1229_cov_8.140708	1023	1103	0	80	80	1.0000000
NODE_3646_length_1229_cov_3.654867	765	840	0	10	75	0.1333333
NODE_3646_length_1229_cov_3.654867	765	840	2	65	75	0.8666667
NODE_3646_length_1229_cov_3.654867	813	893	0	32	80	0.4000000
NODE_3646_length_1229_cov_3.654867	813	893	2	48	80	0.6000000
NODE_3652_length_1229_cov_0.949558	1034	1079	0	16	45	0.3555556
NODE_3652_length_1229_cov_0.949558	1034	1079	1	2	45	0.0444444
NODE_3652_length_1229_cov_0.949558	1034	1079	2	5	45	0.1111111
NODE_3652_length_1229_cov_0.949558	1034	1079	8	22	45	0.4888889
NODE_3652_length_1229_cov_0.949558	1090	1130	8	2	40	0.0500000
NODE_3652_length_1229_cov_0.949558	1090	1130	10	6	40	0.1500000
NODE_3652_length_1229_cov_0.949558	1090	1130	12	32	40	0.8000000
NODE_3654_length_1228_cov_22.622675	604	684	4	19	80	0.2375000
NODE_3654_length_1228_cov_22.622675	604	684	6	16	80	0.2000000
NODE_3654_length_1228_cov_22.622675	604	684	8	35	80	0.4375000
NODE_3654_length_1228_cov_22.622675	604	684	10	10	80	0.1250000
NODE_3654_length_1228_cov_22.622675	657	738	0	43	81	0.5308642
NODE_3654_length_1228_cov_22.622675	657	738	4	1	81	0.0123457
NODE_3654_length_1228_cov_22.622675	657	738	6	26	81	0.3209876
NODE_3654_length_1228_cov_22.622675	657	738	8	11	81	0.1358025
NODE_3655_length_1228_cov_17.900797	423	503	0	10	80	0.1250000
NODE_3655_length_1228_cov_17.900797	423	503	1	70	80	0.8750000
NODE_3655_length_1228_cov_17.900797	423	503	0	10	80	0.1250000
NODE_3655_length_1228_cov_17.900797	423	503	1	70	80	0.8750000
NODE_3655_length_1228_cov_17.900797	423	503	0	10	80	0.1250000
NODE_3655_length_1228_cov_17.900797	423	503	1	70	80	0.8750000
NODE_3655_length_1228_cov_17.900797	476	538	1	49	62	0.7903226
NODE_3655_length_1228_cov_17.900797	476	538	2	13	62	0.2096774
NODE_3655_length_1228_cov_17.900797	476	538	1	49	62	0.7903226
NODE_3655_length_1228_cov_17.900797	476	538	2	13	62	0.2096774
NODE_3655_length_1228_cov_17.900797	476	538	1	49	62	0.7903226
NODE_3655_length_1228_cov_17.900797	476	538	2	13	62	0.2096774
NODE_3655_length_1228_cov_17.900797	476	556	1	49	80	0.6125000
NODE_3655_length_1228_cov_17.900797	476	556	2	31	80	0.3875000
NODE_3656_length_1228_cov_14.554473	367	447	2	80	80	1.0000000
NODE_3656_length_1228_cov_14.554473	420	500	0	38	80	0.4750000
NODE_3656_length_1228_cov_14.554473	420	500	2	42	80	0.5250000
NODE_3657_length_1228_cov_10.021258	661	741	0	39	80	0.4875000
NODE_3657_length_1228_cov_10.021258	661	741	2	41	80	0.5125000
NODE_3657_length_1228_cov_10.021258	714	794	2	80	80	1.0000000
NODE_3660_length_1228_cov_3.987600	1139	1219	0	80	80	1.0000000
NODE_3662_length_1227_cov_29.002660	423	503	2	27	80	0.3375000
NODE_3662_length_1227_cov_29.002660	423	503	7	2	80	0.0250000
NODE_3662_length_1227_cov_29.002660	423	503	8	51	80	0.6375000
NODE_3662_length_1227_cov_29.002660	476	556	0	27	80	0.3375000
NODE_3662_length_1227_cov_29.002660	476	556	2	53	80	0.6625000
NODE_3663_length_1227_cov_17.479610	759	839	0	80	80	1.0000000
NODE_3663_length_1227_cov_17.479610	812	892	0	80	80	1.0000000
NODE_3666_length_1227_cov_3.808511	120	186	8	5	66	0.0757576
NODE_3666_length_1227_cov_3.808511	120	186	10	1	66	0.0151515
NODE_3666_length_1227_cov_3.808511	120	186	13	2	66	0.0303030
NODE_3666_length_1227_cov_3.808511	120	186	14	1	66	0.0151515
NODE_3666_length_1227_cov_3.808511	120	186	16	11	66	0.1666667
NODE_3666_length_1227_cov_3.808511	120	186	18	4	66	0.0606061
NODE_3666_length_1227_cov_3.808511	120	186	22	1	66	0.0151515
NODE_3666_length_1227_cov_3.808511	120	186	24	21	66	0.3181818
NODE_3666_length_1227_cov_3.808511	120	186	26	15	66	0.2272727
NODE_3666_length_1227_cov_3.808511	120	186	28	5	66	0.0757576
NODE_3666_length_1227_cov_3.808511	173	239	21	6	66	0.0909091
NODE_3666_length_1227_cov_3.808511	173	239	24	20	66	0.3030303
NODE_3666_length_1227_cov_3.808511	173	239	26	29	66	0.4393939
NODE_3666_length_1227_cov_3.808511	173	239	28	11	66	0.1666667
NODE_3666_length_1227_cov_3.808511	229	299	2	3	70	0.0428571
NODE_3666_length_1227_cov_3.808511	229	299	6	1	70	0.0142857
NODE_3666_length_1227_cov_3.808511	229	299	8	17	70	0.2428571
NODE_3666_length_1227_cov_3.808511	229	299	9	2	70	0.0285714
NODE_3666_length_1227_cov_3.808511	229	299	10	6	70	0.0857143
NODE_3666_length_1227_cov_3.808511	229	299	11	2	70	0.0285714
NODE_3666_length_1227_cov_3.808511	229	299	13	2	70	0.0285714
NODE_3666_length_1227_cov_3.808511	229	299	14	4	70	0.0571429
NODE_3666_length_1227_cov_3.808511	229	299	15	2	70	0.0285714
NODE_3666_length_1227_cov_3.808511	229	299	17	1	70	0.0142857
NODE_3666_length_1227_cov_3.808511	229	299	19	12	70	0.1714286
NODE_3666_length_1227_cov_3.808511	229	299	21	14	70	0.2000000
NODE_3666_length_1227_cov_3.808511	229	299	24	4	70	0.0571429
NODE_3672_length_1226_cov_23.792369	579	659	20	5	80	0.0625000
NODE_3672_length_1226_cov_23.792369	579	659	21	2	80	0.0250000
NODE_3672_length_1226_cov_23.792369	579	659	22	9	80	0.1125000
NODE_3672_length_1226_cov_23.792369	579	659	23	17	80	0.2125000
NODE_3672_length_1226_cov_23.792369	579	659	24	47	80	0.5875000
NODE_3672_length_1226_cov_23.792369	632	712	0	37	80	0.4625000
NODE_3672_length_1226_cov_23.792369	632	712	6	4	80	0.0500000
NODE_3672_length_1226_cov_23.792369	632	712	20	17	80	0.2125000
NODE_3672_length_1226_cov_23.792369	632	712	21	2	80	0.0250000
NODE_3672_length_1226_cov_23.792369	632	712	22	9	80	0.1125000
NODE_3672_length_1226_cov_23.792369	632	712	23	11	80	0.1375000
NODE_3672_length_1226_cov_23.792369	708	788	0	80	80	1.0000000
NODE_3672_length_1226_cov_23.792369	761	839	0	78	78	1.0000000
NODE_3673_length_1226_cov_5.620231	463	543	0	30	80	0.3750000
NODE_3673_length_1226_cov_5.620231	463	543	4	41	80	0.5125000
NODE_3673_length_1226_cov_5.620231	463	543	6	9	80	0.1125000
NODE_3673_length_1226_cov_5.620231	516	596	4	18	80	0.2250000
NODE_3673_length_1226_cov_5.620231	516	596	6	62	80	0.7750000
NODE_3674_length_1226_cov_4.881988	582	662	0	80	80	1.0000000
NODE_3674_length_1226_cov_4.881988	635	715	0	80	80	1.0000000
NODE_3682_length_1225_cov_55.596803	637	717	0	80	80	1.0000000
NODE_3682_length_1225_cov_55.596803	690	770	0	80	80	1.0000000
NODE_3682_length_1225_cov_55.596803	766	846	0	55	80	0.6875000
NODE_3682_length_1225_cov_55.596803	766	846	2	25	80	0.3125000
NODE_3682_length_1225_cov_55.596803	819	899	0	2	80	0.0250000
NODE_3682_length_1225_cov_55.596803	819	899	2	78	80	0.9750000
NODE_3683_length_1225_cov_35.189165	661	742	0	43	81	0.5308642
NODE_3683_length_1225_cov_35.189165	661	742	6	38	81	0.4691358
NODE_3683_length_1225_cov_35.189165	714	795	6	81	81	1.0000000
NODE_3684_length_1225_cov_33.755773	456	535	0	79	79	1.0000000
NODE_3684_length_1225_cov_33.755773	508	588	0	80	80	1.0000000
NODE_3685_length_1225_cov_30.116341	566	646	0	80	80	1.0000000
NODE_3685_length_1225_cov_30.116341	619	699	0	80	80	1.0000000
NODE_3685_length_1225_cov_30.116341	695	775	0	80	80	1.0000000
NODE_3685_length_1225_cov_30.116341	748	828	0	80	80	1.0000000
NODE_3686_length_1225_cov_29.177620	195	275	12	8	80	0.1000000
NODE_3686_length_1225_cov_29.177620	195	275	17	4	80	0.0500000
NODE_3686_length_1225_cov_29.177620	195	275	19	19	80	0.2375000
NODE_3686_length_1225_cov_29.177620	195	275	20	49	80	0.6125000
NODE_3686_length_1225_cov_29.177620	248	328	0	9	80	0.1125000
NODE_3686_length_1225_cov_29.177620	248	328	8	20	80	0.2500000
NODE_3686_length_1225_cov_29.177620	248	328	12	4	80	0.0500000
NODE_3686_length_1225_cov_29.177620	248	328	15	18	80	0.2250000
NODE_3686_length_1225_cov_29.177620	248	328	17	6	80	0.0750000
NODE_3686_length_1225_cov_29.177620	248	328	19	19	80	0.2375000
NODE_3686_length_1225_cov_29.177620	248	328	20	4	80	0.0500000
NODE_3687_length_1225_cov_26.849023	588	668	0	58	80	0.7250000
NODE_3687_length_1225_cov_26.849023	588	668	2	6	80	0.0750000
NODE_3687_length_1225_cov_26.849023	588	668	3	1	80	0.0125000
NODE_3687_length_1225_cov_26.849023	588	668	12	4	80	0.0500000
NODE_3687_length_1225_cov_26.849023	588	668	14	11	80	0.1375000
NODE_3687_length_1225_cov_26.849023	641	721	0	5	80	0.0625000
NODE_3687_length_1225_cov_26.849023	641	721	2	6	80	0.0750000
NODE_3687_length_1225_cov_26.849023	641	721	3	1	80	0.0125000
NODE_3687_length_1225_cov_26.849023	641	721	12	4	80	0.0500000
NODE_3687_length_1225_cov_26.849023	641	721	14	14	80	0.1750000
NODE_3687_length_1225_cov_26.849023	641	721	15	2	80	0.0250000
NODE_3687_length_1225_cov_26.849023	641	721	16	3	80	0.0375000
NODE_3687_length_1225_cov_26.849023	641	721	17	45	80	0.5625000
NODE_3687_length_1225_cov_26.849023	717	797	0	6	80	0.0750000
NODE_3687_length_1225_cov_26.849023	717	797	2	63	80	0.7875000
NODE_3687_length_1225_cov_26.849023	717	797	17	11	80	0.1375000
NODE_3687_length_1225_cov_26.849023	770	850	0	59	80	0.7375000
NODE_3687_length_1225_cov_26.849023	770	850	2	21	80	0.2625000
NODE_3688_length_1225_cov_24.444938	386	466	2	80	80	1.0000000
NODE_3688_length_1225_cov_24.444938	439	519	0	43	80	0.5375000
NODE_3688_length_1225_cov_24.444938	439	519	2	37	80	0.4625000
NODE_3690_length_1225_cov_19.369449	491	571	4	26	80	0.3250000
NODE_3690_length_1225_cov_19.369449	491	571	6	16	80	0.2000000
NODE_3690_length_1225_cov_19.369449	491	571	7	25	80	0.3125000
NODE_3690_length_1225_cov_19.369449	491	571	8	13	80	0.1625000
NODE_3690_length_1225_cov_19.369449	544	624	2	13	80	0.1625000
NODE_3690_length_1225_cov_19.369449	544	624	4	25	80	0.3125000
NODE_3690_length_1225_cov_19.369449	544	624	7	14	80	0.1750000
NODE_3690_length_1225_cov_19.369449	544	624	8	28	80	0.3500000
NODE_3690_length_1225_cov_19.369449	620	700	1	17	80	0.2125000
NODE_3690_length_1225_cov_19.369449	620	700	2	63	80	0.7875000
NODE_3690_length_1225_cov_19.369449	673	753	0	45	80	0.5625000
NODE_3690_length_1225_cov_19.369449	673	753	1	25	80	0.3125000
NODE_3690_length_1225_cov_19.369449	673	753	2	10	80	0.1250000
NODE_3691_length_1225_cov_13.281528	462	542	0	80	80	1.0000000
NODE_3691_length_1225_cov_13.281528	515	595	0	71	80	0.8875000
NODE_3691_length_1225_cov_13.281528	515	595	5	9	80	0.1125000
NODE_3691_length_1225_cov_13.281528	591	671	5	38	80	0.4750000
NODE_3691_length_1225_cov_13.281528	591	671	6	42	80	0.5250000
NODE_3691_length_1225_cov_13.281528	644	724	5	37	80	0.4625000
NODE_3691_length_1225_cov_13.281528	644	724	6	43	80	0.5375000
NODE_3692_length_1225_cov_10.887211	566	646	0	80	80	1.0000000
NODE_3692_length_1225_cov_10.887211	619	699	0	80	80	1.0000000
NODE_3696_length_1224_cov_24.568889	613	693	0	55	80	0.6875000
NODE_3696_length_1224_cov_24.568889	613	693	4	25	80	0.3125000
NODE_3696_length_1224_cov_24.568889	666	746	0	2	80	0.0250000
NODE_3696_length_1224_cov_24.568889	666	746	4	78	80	0.9750000
NODE_3697_length_1224_cov_17.538667	762	842	0	80	80	1.0000000
NODE_3697_length_1224_cov_17.538667	815	895	0	80	80	1.0000000
NODE_3698_length_1224_cov_14.138667	389	469	0	80	80	1.0000000
NODE_3698_length_1224_cov_14.138667	442	522	0	80	80	1.0000000
NODE_3699_length_1224_cov_11.358222	704	784	0	80	80	1.0000000
NODE_3699_length_1224_cov_11.358222	757	837	0	80	80	1.0000000
NODE_3700_length_1224_cov_6.963556	516	581	0	2	65	0.0307692
NODE_3700_length_1224_cov_6.963556	516	581	10	63	65	0.9692308
NODE_3705_length_1223_cov_44.608541	548	630	2	82	82	1.0000000
NODE_3705_length_1223_cov_44.608541	601	683	0	41	82	0.5000000
NODE_3705_length_1223_cov_44.608541	601	683	2	41	82	0.5000000
NODE_3705_length_1223_cov_44.608541	679	759	0	80	80	1.0000000
NODE_3705_length_1223_cov_44.608541	732	812	0	80	80	1.0000000
NODE_3706_length_1223_cov_26.730427	508	588	3	4	80	0.0500000
NODE_3706_length_1223_cov_26.730427	508	588	7	10	80	0.1250000
NODE_3706_length_1223_cov_26.730427	508	588	16	56	80	0.7000000
NODE_3706_length_1223_cov_26.730427	508	588	18	10	80	0.1250000
NODE_3706_length_1223_cov_26.730427	561	641	3	27	80	0.3375000
NODE_3706_length_1223_cov_26.730427	561	641	5	2	80	0.0250000
NODE_3706_length_1223_cov_26.730427	561	641	6	28	80	0.3500000
NODE_3706_length_1223_cov_26.730427	561	641	7	10	80	0.1250000
NODE_3706_length_1223_cov_26.730427	561	641	16	13	80	0.1625000
NODE_3707_length_1223_cov_18.902135	460	540	0	80	80	1.0000000
NODE_3707_length_1223_cov_18.902135	513	593	0	80	80	1.0000000
NODE_3708_length_1223_cov_6.989324	707	778	6	57	71	0.8028169
NODE_3708_length_1223_cov_6.989324	707	778	10	14	71	0.1971831
NODE_3710_length_1223_cov_5.251779	666	746	0	17	80	0.2125000
NODE_3710_length_1223_cov_5.251779	666	746	2	63	80	0.7875000
NODE_3710_length_1223_cov_5.251779	719	799	0	43	80	0.5375000
NODE_3710_length_1223_cov_5.251779	719	799	2	10	80	0.1250000
NODE_3710_length_1223_cov_5.251779	719	799	4	27	80	0.3375000
NODE_3710_length_1223_cov_5.251779	795	875	4	14	80	0.1750000
NODE_3710_length_1223_cov_5.251779	795	875	6	66	80	0.8250000
NODE_3710_length_1223_cov_5.251779	848	928	0	32	80	0.4000000
NODE_3710_length_1223_cov_5.251779	848	928	2	12	80	0.1500000
NODE_3710_length_1223_cov_5.251779	848	928	6	36	80	0.4500000
NODE_3716_length_1222_cov_18.406946	273	353	4	80	80	1.0000000
NODE_3716_length_1222_cov_18.406946	326	406	0	47	80	0.5875000
NODE_3716_length_1222_cov_18.406946	326	406	4	33	80	0.4125000
NODE_3720_length_1221_cov_33.261141	505	577	0	72	72	1.0000000
NODE_3720_length_1221_cov_33.261141	558	637	0	79	79	1.0000000
NODE_3720_length_1221_cov_33.261141	633	713	0	80	80	1.0000000
NODE_3720_length_1221_cov_33.261141	686	766	0	27	80	0.3375000
NODE_3720_length_1221_cov_33.261141	686	766	7	53	80	0.6625000
NODE_3721_length_1221_cov_19.466132	541	621	2	5	80	0.0625000
NODE_3721_length_1221_cov_19.466132	541	621	4	2	80	0.0250000
NODE_3721_length_1221_cov_19.466132	541	621	12	73	80	0.9125000
NODE_3721_length_1221_cov_19.466132	594	674	10	27	80	0.3375000
NODE_3721_length_1221_cov_19.466132	594	674	12	53	80	0.6625000
NODE_3722_length_1221_cov_15.940285	788	868	0	1	80	0.0125000
NODE_3722_length_1221_cov_15.940285	788	868	4	79	80	0.9875000
NODE_3722_length_1221_cov_15.940285	841	921	0	13	80	0.1625000
NODE_3722_length_1221_cov_15.940285	841	921	2	1	80	0.0125000
NODE_3722_length_1221_cov_15.940285	841	921	4	66	80	0.8250000
NODE_3722_length_1221_cov_15.940285	917	997	0	80	80	1.0000000
NODE_3722_length_1221_cov_15.940285	970	1050	0	80	80	1.0000000
NODE_3723_length_1221_cov_15.796791	484	564	0	80	80	1.0000000
NODE_3723_length_1221_cov_15.796791	537	617	0	80	80	1.0000000
NODE_3724_length_1221_cov_15.312834	342	415	0	73	73	1.0000000
NODE_3724_length_1221_cov_15.312834	395	474	0	79	79	1.0000000
NODE_3725_length_1221_cov_9.695187	988	1068	0	1	80	0.0125000
NODE_3725_length_1221_cov_9.695187	988	1068	2	79	80	0.9875000
NODE_3725_length_1221_cov_9.695187	1041	1100	0	26	59	0.4406780
NODE_3725_length_1221_cov_9.695187	1041	1100	2	33	59	0.5593221
NODE_3726_length_1221_cov_9.043672	695	775	0	80	80	1.0000000
NODE_3726_length_1221_cov_9.043672	748	828	0	80	80	1.0000000
NODE_3727_length_1221_cov_7.946524	147	227	6	80	80	1.0000000
NODE_3727_length_1221_cov_7.946524	200	280	0	49	80	0.6125000
NODE_3727_length_1221_cov_7.946524	200	280	6	31	80	0.3875000
NODE_3728_length_1221_cov_5.122103	248	328	0	47	80	0.5875000
NODE_3728_length_1221_cov_5.122103	248	328	2	33	80	0.4125000
NODE_3728_length_1221_cov_5.122103	301	381	0	80	80	1.0000000
NODE_3736_length_1220_cov_44.501338	319	399	0	38	80	0.4750000
NODE_3736_length_1220_cov_44.501338	319	399	4	42	80	0.5250000
NODE_3736_length_1220_cov_44.501338	372	452	0	9	80	0.1125000
NODE_3736_length_1220_cov_44.501338	372	452	4	71	80	0.8875000
NODE_3736_length_1220_cov_44.501338	448	528	0	80	80	1.0000000
NODE_3736_length_1220_cov_44.501338	501	581	0	80	80	1.0000000
NODE_3737_length_1220_cov_43.868867	720	800	0	80	80	1.0000000
NODE_3737_length_1220_cov_43.868867	773	853	0	80	80	1.0000000
NODE_3738_length_1220_cov_41.900089	593	673	8	3	80	0.0375000
NODE_3738_length_1220_cov_41.900089	593	673	12	77	80	0.9625000
NODE_3738_length_1220_cov_41.900089	646	726	2	41	80	0.5125000
NODE_3738_length_1220_cov_41.900089	646	726	8	8	80	0.1000000
NODE_3738_length_1220_cov_41.900089	646	726	10	7	80	0.0875000
NODE_3738_length_1220_cov_41.900089	646	726	12	24	80	0.3000000
NODE_3738_length_1220_cov_41.900089	722	802	2	68	80	0.8500000
NODE_3738_length_1220_cov_41.900089	722	802	4	12	80	0.1500000
NODE_3738_length_1220_cov_41.900089	775	855	2	44	80	0.5500000
NODE_3738_length_1220_cov_41.900089	775	855	4	36	80	0.4500000
NODE_3739_length_1220_cov_15.485281	395	475	0	80	80	1.0000000
NODE_3739_length_1220_cov_15.485281	448	528	0	80	80	1.0000000
NODE_3745_length_1219_cov_30.493750	643	723	0	44	80	0.5500000
NODE_3745_length_1219_cov_30.493750	643	723	2	36	80	0.4500000
NODE_3745_length_1219_cov_30.493750	696	776	0	80	80	1.0000000
NODE_3745_length_1219_cov_30.493750	772	852	0	80	80	1.0000000
NODE_3745_length_1219_cov_30.493750	825	905	0	80	80	1.0000000
NODE_3746_length_1219_cov_24.991071	566	646	0	80	80	1.0000000
NODE_3746_length_1219_cov_24.991071	619	699	0	80	80	1.0000000
NODE_3746_length_1219_cov_24.991071	695	775	0	80	80	1.0000000
NODE_3746_length_1219_cov_24.991071	748	828	0	80	80	1.0000000
NODE_3747_length_1219_cov_24.728571	465	545	0	28	80	0.3500000
NODE_3747_length_1219_cov_24.728571	465	545	2	1	80	0.0125000
NODE_3747_length_1219_cov_24.728571	465	545	3	46	80	0.5750000
NODE_3747_length_1219_cov_24.728571	465	545	6	5	80	0.0625000
NODE_3747_length_1219_cov_24.728571	518	598	3	22	80	0.2750000
NODE_3747_length_1219_cov_24.728571	518	598	6	58	80	0.7250000
NODE_3747_length_1219_cov_24.728571	594	674	3	31	80	0.3875000
NODE_3747_length_1219_cov_24.728571	594	674	6	49	80	0.6125000
NODE_3747_length_1219_cov_24.728571	647	727	0	37	80	0.4625000
NODE_3747_length_1219_cov_24.728571	647	727	3	43	80	0.5375000
NODE_3748_length_1219_cov_11.130357	535	615	0	55	80	0.6875000
NODE_3748_length_1219_cov_11.130357	535	615	2	25	80	0.3125000
NODE_3748_length_1219_cov_11.130357	588	668	0	3	80	0.0375000
NODE_3748_length_1219_cov_11.130357	588	668	2	77	80	0.9625000
NODE_3749_length_1219_cov_9.696429	734	814	0	7	80	0.0875000
NODE_3749_length_1219_cov_9.696429	734	814	4	73	80	0.9125000
NODE_3749_length_1219_cov_9.696429	787	867	0	18	80	0.2250000
NODE_3749_length_1219_cov_9.696429	787	867	4	62	80	0.7750000
NODE_3754_length_1218_cov_40.159071	554	634	0	80	80	1.0000000
NODE_3754_length_1218_cov_40.159071	607	687	0	80	80	1.0000000
NODE_3754_length_1218_cov_40.159071	683	763	0	80	80	1.0000000
NODE_3754_length_1218_cov_40.159071	736	816	0	80	80	1.0000000
NODE_3765_length_1216_cov_99.538944	44	124	346	1	80	0.0125000
NODE_3765_length_1216_cov_99.538944	44	124	356	1	80	0.0125000
NODE_3765_length_1216_cov_99.538944	44	124	365	1	80	0.0125000
NODE_3765_length_1216_cov_99.538944	44	124	372	1	80	0.0125000
NODE_3765_length_1216_cov_99.538944	44	124	379	1	80	0.0125000
NODE_3765_length_1216_cov_99.538944	44	124	383	1	80	0.0125000
NODE_3765_length_1216_cov_99.538944	44	124	387	1	80	0.0125000
NODE_3765_length_1216_cov_99.538944	44	124	395	1	80	0.0125000
NODE_3765_length_1216_cov_99.538944	44	124	401	1	80	0.0125000
NODE_3765_length_1216_cov_99.538944	44	124	404	1	80	0.0125000
NODE_3765_length_1216_cov_99.538944	44	124	420	1	80	0.0125000
NODE_3765_length_1216_cov_99.538944	44	124	423	1	80	0.0125000
NODE_3765_length_1216_cov_99.538944	44	124	428	1	80	0.0125000
NODE_3765_length_1216_cov_99.538944	44	124	437	1	80	0.0125000
NODE_3765_length_1216_cov_99.538944	44	124	448	1	80	0.0125000
NODE_3765_length_1216_cov_99.538944	44	124	458	1	80	0.0125000
NODE_3765_length_1216_cov_99.538944	44	124	478	1	80	0.0125000
NODE_3765_length_1216_cov_99.538944	44	124	482	1	80	0.0125000
NODE_3765_length_1216_cov_99.538944	44	124	487	1	80	0.0125000
NODE_3765_length_1216_cov_99.538944	44	124	496	1	80	0.0125000
NODE_3765_length_1216_cov_99.538944	44	124	499	1	80	0.0125000
NODE_3765_length_1216_cov_99.538944	44	124	504	1	80	0.0125000
NODE_3765_length_1216_cov_99.538944	44	124	513	1	80	0.0125000
NODE_3765_length_1216_cov_99.538944	44	124	520	1	80	0.0125000
NODE_3765_length_1216_cov_99.538944	44	124	521	1	80	0.0125000
NODE_3765_length_1216_cov_99.538944	44	124	533	1	80	0.0125000
NODE_3765_length_1216_cov_99.538944	44	124	538	1	80	0.0125000
NODE_3765_length_1216_cov_99.538944	44	124	544	1	80	0.0125000
NODE_3765_length_1216_cov_99.538944	44	124	564	1	80	0.0125000
NODE_3765_length_1216_cov_99.538944	44	124	569	1	80	0.0125000
NODE_3765_length_1216_cov_99.538944	44	124	583	1	80	0.0125000
NODE_3765_length_1216_cov_99.538944	44	124	595	1	80	0.0125000
NODE_3765_length_1216_cov_99.538944	44	124	603	2	80	0.0250000
NODE_3765_length_1216_cov_99.538944	44	124	604	1	80	0.0125000
NODE_3765_length_1216_cov_99.538944	44	124	609	1	80	0.0125000
NODE_3765_length_1216_cov_99.538944	44	124	612	1	80	0.0125000
NODE_3765_length_1216_cov_99.538944	44	124	615	1	80	0.0125000
NODE_3765_length_1216_cov_99.538944	44	124	616	1	80	0.0125000
NODE_3765_length_1216_cov_99.538944	44	124	629	1	80	0.0125000
NODE_3765_length_1216_cov_99.538944	44	124	630	1	80	0.0125000
NODE_3765_length_1216_cov_99.538944	44	124	632	1	80	0.0125000
NODE_3765_length_1216_cov_99.538944	44	124	638	1	80	0.0125000
NODE_3765_length_1216_cov_99.538944	44	124	641	1	80	0.0125000
NODE_3765_length_1216_cov_99.538944	44	124	644	1	80	0.0125000
NODE_3765_length_1216_cov_99.538944	44	124	649	1	80	0.0125000
NODE_3765_length_1216_cov_99.538944	44	124	656	1	80	0.0125000
NODE_3765_length_1216_cov_99.538944	44	124	660	1	80	0.0125000
NODE_3765_length_1216_cov_99.538944	44	124	662	1	80	0.0125000
NODE_3765_length_1216_cov_99.538944	44	124	664	1	80	0.0125000
NODE_3765_length_1216_cov_99.538944	44	124	666	2	80	0.0250000
NODE_3765_length_1216_cov_99.538944	44	124	680	1	80	0.0125000
NODE_3765_length_1216_cov_99.538944	44	124	685	1	80	0.0125000
NODE_3765_length_1216_cov_99.538944	44	124	694	1	80	0.0125000
NODE_3765_length_1216_cov_99.538944	44	124	696	1	80	0.0125000
NODE_3765_length_1216_cov_99.538944	44	124	698	1	80	0.0125000
NODE_3765_length_1216_cov_99.538944	44	124	704	1	80	0.0125000
NODE_3765_length_1216_cov_99.538944	44	124	706	1	80	0.0125000
NODE_3765_length_1216_cov_99.538944	44	124	712	1	80	0.0125000
NODE_3765_length_1216_cov_99.538944	44	124	714	1	80	0.0125000
NODE_3765_length_1216_cov_99.538944	44	124	716	1	80	0.0125000
NODE_3765_length_1216_cov_99.538944	44	124	720	1	80	0.0125000
NODE_3765_length_1216_cov_99.538944	44	124	724	1	80	0.0125000
NODE_3765_length_1216_cov_99.538944	44	124	727	5	80	0.0625000
NODE_3765_length_1216_cov_99.538944	44	124	728	2	80	0.0250000
NODE_3765_length_1216_cov_99.538944	44	124	731	2	80	0.0250000
NODE_3765_length_1216_cov_99.538944	44	124	732	4	80	0.0500000
NODE_3765_length_1216_cov_99.538944	44	124	733	1	80	0.0125000
NODE_3765_length_1216_cov_99.538944	44	124	735	2	80	0.0250000
NODE_3765_length_1216_cov_99.538944	97	157	643	1	60	0.0166667
NODE_3765_length_1216_cov_99.538944	97	157	655	1	60	0.0166667
NODE_3765_length_1216_cov_99.538944	97	157	658	1	60	0.0166667
NODE_3765_length_1216_cov_99.538944	97	157	661	1	60	0.0166667
NODE_3765_length_1216_cov_99.538944	97	157	663	1	60	0.0166667
NODE_3765_length_1216_cov_99.538944	97	157	676	1	60	0.0166667
NODE_3765_length_1216_cov_99.538944	97	157	683	1	60	0.0166667
NODE_3765_length_1216_cov_99.538944	97	157	685	1	60	0.0166667
NODE_3765_length_1216_cov_99.538944	97	157	694	1	60	0.0166667
NODE_3765_length_1216_cov_99.538944	97	157	696	1	60	0.0166667
NODE_3765_length_1216_cov_99.538944	97	157	698	1	60	0.0166667
NODE_3765_length_1216_cov_99.538944	97	157	704	1	60	0.0166667
NODE_3765_length_1216_cov_99.538944	97	157	706	1	60	0.0166667
NODE_3765_length_1216_cov_99.538944	97	157	712	1	60	0.0166667
NODE_3765_length_1216_cov_99.538944	97	157	714	1	60	0.0166667
NODE_3765_length_1216_cov_99.538944	97	157	716	1	60	0.0166667
NODE_3765_length_1216_cov_99.538944	97	157	718	1	60	0.0166667
NODE_3765_length_1216_cov_99.538944	97	157	719	1	60	0.0166667
NODE_3765_length_1216_cov_99.538944	97	157	720	1	60	0.0166667
NODE_3765_length_1216_cov_99.538944	97	157	724	3	60	0.0500000
NODE_3765_length_1216_cov_99.538944	97	157	725	1	60	0.0166667
NODE_3765_length_1216_cov_99.538944	97	157	727	5	60	0.0833333
NODE_3765_length_1216_cov_99.538944	97	157	728	2	60	0.0333333
NODE_3765_length_1216_cov_99.538944	97	157	731	4	60	0.0666667
NODE_3765_length_1216_cov_99.538944	97	157	732	7	60	0.1166667
NODE_3765_length_1216_cov_99.538944	97	157	733	2	60	0.0333333
NODE_3765_length_1216_cov_99.538944	97	157	734	1	60	0.0166667
NODE_3765_length_1216_cov_99.538944	97	157	735	3	60	0.0500000
NODE_3765_length_1216_cov_99.538944	97	157	737	1	60	0.0166667
NODE_3765_length_1216_cov_99.538944	97	157	738	1	60	0.0166667
NODE_3765_length_1216_cov_99.538944	97	157	739	2	60	0.0333333
NODE_3765_length_1216_cov_99.538944	97	157	740	4	60	0.0666667
NODE_3765_length_1216_cov_99.538944	97	157	742	2	60	0.0333333
NODE_3765_length_1216_cov_99.538944	97	157	745	1	60	0.0166667
NODE_3765_length_1216_cov_99.538944	97	157	747	1	60	0.0166667
NODE_3765_length_1216_cov_99.538944	97	157	753	1	60	0.0166667
NODE_3765_length_1216_cov_99.538944	824	903	238	1	79	0.0126582
NODE_3765_length_1216_cov_99.538944	824	903	242	1	79	0.0126582
NODE_3765_length_1216_cov_99.538944	824	903	245	2	79	0.0253165
NODE_3765_length_1216_cov_99.538944	824	903	249	1	79	0.0126582
NODE_3765_length_1216_cov_99.538944	824	903	253	2	79	0.0253165
NODE_3765_length_1216_cov_99.538944	824	903	255	1	79	0.0126582
NODE_3765_length_1216_cov_99.538944	824	903	256	1	79	0.0126582
NODE_3765_length_1216_cov_99.538944	824	903	258	3	79	0.0379747
NODE_3765_length_1216_cov_99.538944	824	903	260	2	79	0.0253165
NODE_3765_length_1216_cov_99.538944	824	903	261	1	79	0.0126582
NODE_3765_length_1216_cov_99.538944	824	903	262	2	79	0.0253165
NODE_3765_length_1216_cov_99.538944	824	903	263	1	79	0.0126582
NODE_3765_length_1216_cov_99.538944	824	903	264	1	79	0.0126582
NODE_3765_length_1216_cov_99.538944	824	903	265	1	79	0.0126582
NODE_3765_length_1216_cov_99.538944	824	903	266	2	79	0.0253165
NODE_3765_length_1216_cov_99.538944	824	903	268	1	79	0.0126582
NODE_3765_length_1216_cov_99.538944	824	903	271	2	79	0.0253165
NODE_3765_length_1216_cov_99.538944	824	903	272	3	79	0.0379747
NODE_3765_length_1216_cov_99.538944	824	903	273	2	79	0.0253165
NODE_3765_length_1216_cov_99.538944	824	903	274	3	79	0.0379747
NODE_3765_length_1216_cov_99.538944	824	903	275	2	79	0.0253165
NODE_3765_length_1216_cov_99.538944	824	903	276	1	79	0.0126582
NODE_3765_length_1216_cov_99.538944	824	903	278	3	79	0.0379747
NODE_3765_length_1216_cov_99.538944	824	903	279	2	79	0.0253165
NODE_3765_length_1216_cov_99.538944	824	903	280	1	79	0.0126582
NODE_3765_length_1216_cov_99.538944	824	903	281	1	79	0.0126582
NODE_3765_length_1216_cov_99.538944	824	903	282	1	79	0.0126582
NODE_3765_length_1216_cov_99.538944	824	903	283	1	79	0.0126582
NODE_3765_length_1216_cov_99.538944	824	903	284	1	79	0.0126582
NODE_3765_length_1216_cov_99.538944	824	903	286	1	79	0.0126582
NODE_3765_length_1216_cov_99.538944	824	903	288	1	79	0.0126582
NODE_3765_length_1216_cov_99.538944	824	903	290	1	79	0.0126582
NODE_3765_length_1216_cov_99.538944	824	903	302	1	79	0.0126582
NODE_3765_length_1216_cov_99.538944	824	903	313	1	79	0.0126582
NODE_3765_length_1216_cov_99.538944	824	903	314	1	79	0.0126582
NODE_3765_length_1216_cov_99.538944	824	903	318	1	79	0.0126582
NODE_3765_length_1216_cov_99.538944	824	903	319	1	79	0.0126582
NODE_3765_length_1216_cov_99.538944	824	903	328	1	79	0.0126582
NODE_3765_length_1216_cov_99.538944	824	903	334	4	79	0.0506329
NODE_3765_length_1216_cov_99.538944	824	903	335	2	79	0.0253165
NODE_3765_length_1216_cov_99.538944	824	903	336	2	79	0.0253165
NODE_3765_length_1216_cov_99.538944	824	903	337	2	79	0.0253165
NODE_3765_length_1216_cov_99.538944	824	903	338	1	79	0.0126582
NODE_3765_length_1216_cov_99.538944	824	903	339	3	79	0.0379747
NODE_3765_length_1216_cov_99.538944	824	903	340	2	79	0.0253165
NODE_3765_length_1216_cov_99.538944	824	903	342	4	79	0.0506329
NODE_3765_length_1216_cov_99.538944	824	903	343	1	79	0.0126582
NODE_3765_length_1216_cov_99.538944	824	903	344	1	79	0.0126582
NODE_3765_length_1216_cov_99.538944	824	903	346	1	79	0.0126582
NODE_3765_length_1216_cov_99.538944	824	903	347	1	79	0.0126582
NODE_3766_length_1216_cov_15.855864	668	748	0	5	80	0.0625000
NODE_3766_length_1216_cov_15.855864	668	748	2	6	80	0.0750000
NODE_3766_length_1216_cov_15.855864	668	748	4	69	80	0.8625000
NODE_3766_length_1216_cov_15.855864	721	801	2	52	80	0.6500000
NODE_3766_length_1216_cov_15.855864	721	801	4	28	80	0.3500000
NODE_3767_length_1216_cov_4.128917	720	800	0	80	80	1.0000000
NODE_3767_length_1216_cov_4.128917	773	853	0	80	80	1.0000000
NODE_3774_length_1215_cov_32.293011	411	491	0	80	80	1.0000000
NODE_3774_length_1215_cov_32.293011	464	544	0	80	80	1.0000000
NODE_3775_length_1215_cov_24.177419	729	809	0	80	80	1.0000000
NODE_3775_length_1215_cov_24.177419	782	862	0	80	80	1.0000000
NODE_3776_length_1215_cov_21.566308	645	725	0	31	80	0.3875000
NODE_3776_length_1215_cov_21.566308	645	725	4	49	80	0.6125000
NODE_3776_length_1215_cov_21.566308	698	778	4	80	80	1.0000000
NODE_3777_length_1215_cov_19.278674	630	710	0	17	80	0.2125000
NODE_3777_length_1215_cov_19.278674	630	710	3	7	80	0.0875000
NODE_3777_length_1215_cov_19.278674	630	710	4	56	80	0.7000000
NODE_3777_length_1215_cov_19.278674	683	763	0	45	80	0.5625000
NODE_3777_length_1215_cov_19.278674	683	763	3	15	80	0.1875000
NODE_3777_length_1215_cov_19.278674	683	763	4	20	80	0.2500000
NODE_3778_length_1215_cov_15.074373	664	744	0	80	80	1.0000000
NODE_3778_length_1215_cov_15.074373	717	797	0	80	80	1.0000000
NODE_3779_length_1215_cov_5.932796	507	587	0	80	80	1.0000000
NODE_3779_length_1215_cov_5.932796	560	640	0	80	80	1.0000000
NODE_3787_length_1214_cov_26.771300	420	500	93	2	80	0.0250000
NODE_3787_length_1214_cov_26.771300	420	500	95	2	80	0.0250000
NODE_3787_length_1214_cov_26.771300	420	500	99	3	80	0.0375000
NODE_3787_length_1214_cov_26.771300	420	500	103	1	80	0.0125000
NODE_3787_length_1214_cov_26.771300	420	500	104	1	80	0.0125000
NODE_3787_length_1214_cov_26.771300	420	500	106	1	80	0.0125000
NODE_3787_length_1214_cov_26.771300	420	500	114	1	80	0.0125000
NODE_3787_length_1214_cov_26.771300	420	500	118	1	80	0.0125000
NODE_3787_length_1214_cov_26.771300	420	500	122	2	80	0.0250000
NODE_3787_length_1214_cov_26.771300	420	500	124	1	80	0.0125000
NODE_3787_length_1214_cov_26.771300	420	500	128	2	80	0.0250000
NODE_3787_length_1214_cov_26.771300	420	500	136	1	80	0.0125000
NODE_3787_length_1214_cov_26.771300	420	500	140	1	80	0.0125000
NODE_3787_length_1214_cov_26.771300	420	500	141	1	80	0.0125000
NODE_3787_length_1214_cov_26.771300	420	500	142	1	80	0.0125000
NODE_3787_length_1214_cov_26.771300	420	500	144	2	80	0.0250000
NODE_3787_length_1214_cov_26.771300	420	500	169	1	80	0.0125000
NODE_3787_length_1214_cov_26.771300	420	500	173	2	80	0.0250000
NODE_3787_length_1214_cov_26.771300	420	500	174	1	80	0.0125000
NODE_3787_length_1214_cov_26.771300	420	500	176	1	80	0.0125000
NODE_3787_length_1214_cov_26.771300	420	500	178	2	80	0.0250000
NODE_3787_length_1214_cov_26.771300	420	500	180	1	80	0.0125000
NODE_3787_length_1214_cov_26.771300	420	500	181	1	80	0.0125000
NODE_3787_length_1214_cov_26.771300	420	500	182	2	80	0.0250000
NODE_3787_length_1214_cov_26.771300	420	500	183	1	80	0.0125000
NODE_3787_length_1214_cov_26.771300	420	500	187	7	80	0.0875000
NODE_3787_length_1214_cov_26.771300	420	500	188	7	80	0.0875000
NODE_3787_length_1214_cov_26.771300	420	500	190	4	80	0.0500000
NODE_3787_length_1214_cov_26.771300	420	500	192	6	80	0.0750000
NODE_3787_length_1214_cov_26.771300	420	500	193	1	80	0.0125000
NODE_3787_length_1214_cov_26.771300	420	500	194	5	80	0.0625000
NODE_3787_length_1214_cov_26.771300	420	500	195	8	80	0.1000000
NODE_3787_length_1214_cov_26.771300	420	500	196	3	80	0.0375000
NODE_3787_length_1214_cov_26.771300	420	500	197	1	80	0.0125000
NODE_3787_length_1214_cov_26.771300	420	500	198	1	80	0.0125000
NODE_3787_length_1214_cov_26.771300	420	500	199	2	80	0.0250000
NODE_3787_length_1214_cov_26.771300	473	553	46	1	80	0.0125000
NODE_3787_length_1214_cov_26.771300	473	553	58	1	80	0.0125000
NODE_3787_length_1214_cov_26.771300	473	553	66	1	80	0.0125000
NODE_3787_length_1214_cov_26.771300	473	553	68	3	80	0.0375000
NODE_3787_length_1214_cov_26.771300	473	553	70	2	80	0.0250000
NODE_3787_length_1214_cov_26.771300	473	553	72	2	80	0.0250000
NODE_3787_length_1214_cov_26.771300	473	553	76	2	80	0.0250000
NODE_3787_length_1214_cov_26.771300	473	553	82	2	80	0.0250000
NODE_3787_length_1214_cov_26.771300	473	553	83	1	80	0.0125000
NODE_3787_length_1214_cov_26.771300	473	553	91	1	80	0.0125000
NODE_3787_length_1214_cov_26.771300	473	553	93	2	80	0.0250000
NODE_3787_length_1214_cov_26.771300	473	553	94	1	80	0.0125000
NODE_3787_length_1214_cov_26.771300	473	553	103	2	80	0.0250000
NODE_3787_length_1214_cov_26.771300	473	553	105	1	80	0.0125000
NODE_3787_length_1214_cov_26.771300	473	553	107	1	80	0.0125000
NODE_3787_length_1214_cov_26.771300	473	553	109	1	80	0.0125000
NODE_3787_length_1214_cov_26.771300	473	553	111	1	80	0.0125000
NODE_3787_length_1214_cov_26.771300	473	553	116	1	80	0.0125000
NODE_3787_length_1214_cov_26.771300	473	553	125	2	80	0.0250000
NODE_3787_length_1214_cov_26.771300	473	553	127	2	80	0.0250000
NODE_3787_length_1214_cov_26.771300	473	553	140	1	80	0.0125000
NODE_3787_length_1214_cov_26.771300	473	553	143	1	80	0.0125000
NODE_3787_length_1214_cov_26.771300	473	553	144	2	80	0.0250000
NODE_3787_length_1214_cov_26.771300	473	553	146	1	80	0.0125000
NODE_3787_length_1214_cov_26.771300	473	553	150	1	80	0.0125000
NODE_3787_length_1214_cov_26.771300	473	553	154	1	80	0.0125000
NODE_3787_length_1214_cov_26.771300	473	553	156	1	80	0.0125000
NODE_3787_length_1214_cov_26.771300	473	553	158	1	80	0.0125000
NODE_3787_length_1214_cov_26.771300	473	553	160	1	80	0.0125000
NODE_3787_length_1214_cov_26.771300	473	553	162	1	80	0.0125000
NODE_3787_length_1214_cov_26.771300	473	553	165	2	80	0.0250000
NODE_3787_length_1214_cov_26.771300	473	553	167	9	80	0.1125000
NODE_3787_length_1214_cov_26.771300	473	553	171	1	80	0.0125000
NODE_3787_length_1214_cov_26.771300	473	553	173	1	80	0.0125000
NODE_3787_length_1214_cov_26.771300	473	553	174	1	80	0.0125000
NODE_3787_length_1214_cov_26.771300	473	553	178	1	80	0.0125000
NODE_3787_length_1214_cov_26.771300	473	553	181	1	80	0.0125000
NODE_3787_length_1214_cov_26.771300	473	553	183	1	80	0.0125000
NODE_3787_length_1214_cov_26.771300	473	553	187	7	80	0.0875000
NODE_3787_length_1214_cov_26.771300	473	553	193	1	80	0.0125000
NODE_3787_length_1214_cov_26.771300	473	553	194	1	80	0.0125000
NODE_3787_length_1214_cov_26.771300	473	553	195	8	80	0.1000000
NODE_3787_length_1214_cov_26.771300	473	553	196	1	80	0.0125000
NODE_3787_length_1214_cov_26.771300	473	553	197	1	80	0.0125000
NODE_3787_length_1214_cov_26.771300	473	553	198	1	80	0.0125000
NODE_3787_length_1214_cov_26.771300	473	553	199	2	80	0.0250000
NODE_3788_length_1214_cov_24.555157	480	560	0	80	80	1.0000000
NODE_3788_length_1214_cov_24.555157	533	613	0	80	80	1.0000000
NODE_3789_length_1214_cov_23.167713	623	703	0	80	80	1.0000000
NODE_3789_length_1214_cov_23.167713	676	756	0	80	80	1.0000000
NODE_3790_length_1214_cov_18.452915	555	635	0	80	80	1.0000000
NODE_3790_length_1214_cov_18.452915	608	688	0	80	80	1.0000000
NODE_3790_length_1214_cov_18.452915	684	764	0	80	80	1.0000000
NODE_3790_length_1214_cov_18.452915	737	817	0	73	80	0.9125000
NODE_3790_length_1214_cov_18.452915	737	817	2	7	80	0.0875000
NODE_3791_length_1214_cov_8.906726	206	286	0	80	80	1.0000000
NODE_3791_length_1214_cov_8.906726	259	339	0	80	80	1.0000000
NODE_3792_length_1214_cov_3.686996	415	495	0	32	80	0.4000000
NODE_3792_length_1214_cov_3.686996	415	495	2	48	80	0.6000000
NODE_3792_length_1214_cov_3.686996	468	548	2	80	80	1.0000000
NODE_3799_length_1214_cov_0.967713	1049	1129	330	1	80	0.0125000
NODE_3799_length_1214_cov_0.967713	1049	1129	351	1	80	0.0125000
NODE_3799_length_1214_cov_0.967713	1049	1129	358	1	80	0.0125000
NODE_3799_length_1214_cov_0.967713	1049	1129	368	1	80	0.0125000
NODE_3799_length_1214_cov_0.967713	1049	1129	379	1	80	0.0125000
NODE_3799_length_1214_cov_0.967713	1049	1129	380	1	80	0.0125000
NODE_3799_length_1214_cov_0.967713	1049	1129	384	1	80	0.0125000
NODE_3799_length_1214_cov_0.967713	1049	1129	390	1	80	0.0125000
NODE_3799_length_1214_cov_0.967713	1049	1129	396	1	80	0.0125000
NODE_3799_length_1214_cov_0.967713	1049	1129	398	1	80	0.0125000
NODE_3799_length_1214_cov_0.967713	1049	1129	410	1	80	0.0125000
NODE_3799_length_1214_cov_0.967713	1049	1129	413	1	80	0.0125000
NODE_3799_length_1214_cov_0.967713	1049	1129	415	1	80	0.0125000
NODE_3799_length_1214_cov_0.967713	1049	1129	424	2	80	0.0250000
NODE_3799_length_1214_cov_0.967713	1049	1129	427	1	80	0.0125000
NODE_3799_length_1214_cov_0.967713	1049	1129	430	2	80	0.0250000
NODE_3799_length_1214_cov_0.967713	1049	1129	432	1	80	0.0125000
NODE_3799_length_1214_cov_0.967713	1049	1129	438	2	80	0.0250000
NODE_3799_length_1214_cov_0.967713	1049	1129	440	1	80	0.0125000
NODE_3799_length_1214_cov_0.967713	1049	1129	443	1	80	0.0125000
NODE_3799_length_1214_cov_0.967713	1049	1129	450	1	80	0.0125000
NODE_3799_length_1214_cov_0.967713	1049	1129	453	1	80	0.0125000
NODE_3799_length_1214_cov_0.967713	1049	1129	454	2	80	0.0250000
NODE_3799_length_1214_cov_0.967713	1049	1129	456	1	80	0.0125000
NODE_3799_length_1214_cov_0.967713	1049	1129	460	1	80	0.0125000
NODE_3799_length_1214_cov_0.967713	1049	1129	463	1	80	0.0125000
NODE_3799_length_1214_cov_0.967713	1049	1129	469	5	80	0.0625000
NODE_3799_length_1214_cov_0.967713	1049	1129	471	1	80	0.0125000
NODE_3799_length_1214_cov_0.967713	1049	1129	475	2	80	0.0250000
NODE_3799_length_1214_cov_0.967713	1049	1129	476	2	80	0.0250000
NODE_3799_length_1214_cov_0.967713	1049	1129	480	2	80	0.0250000
NODE_3799_length_1214_cov_0.967713	1049	1129	484	2	80	0.0250000
NODE_3799_length_1214_cov_0.967713	1049	1129	486	2	80	0.0250000
NODE_3799_length_1214_cov_0.967713	1049	1129	488	2	80	0.0250000
NODE_3799_length_1214_cov_0.967713	1049	1129	495	3	80	0.0375000
NODE_3799_length_1214_cov_0.967713	1049	1129	496	1	80	0.0125000
NODE_3799_length_1214_cov_0.967713	1049	1129	497	1	80	0.0125000
NODE_3799_length_1214_cov_0.967713	1049	1129	499	1	80	0.0125000
NODE_3799_length_1214_cov_0.967713	1049	1129	502	4	80	0.0500000
NODE_3799_length_1214_cov_0.967713	1049	1129	504	3	80	0.0375000
NODE_3799_length_1214_cov_0.967713	1049	1129	506	3	80	0.0375000
NODE_3799_length_1214_cov_0.967713	1049	1129	508	1	80	0.0125000
NODE_3799_length_1214_cov_0.967713	1049	1129	512	1	80	0.0125000
NODE_3799_length_1214_cov_0.967713	1049	1129	516	4	80	0.0500000
NODE_3799_length_1214_cov_0.967713	1049	1129	517	4	80	0.0500000
NODE_3799_length_1214_cov_0.967713	1049	1129	518	1	80	0.0125000
NODE_3799_length_1214_cov_0.967713	1049	1129	519	2	80	0.0250000
NODE_3799_length_1214_cov_0.967713	1049	1129	521	3	80	0.0375000
NODE_3800_length_1213_cov_19.524237	499	579	2	80	80	1.0000000
NODE_3800_length_1213_cov_19.524237	552	632	0	52	80	0.6500000
NODE_3800_length_1213_cov_19.524237	552	632	2	28	80	0.3500000
NODE_3806_length_1212_cov_32.663073	688	768	3	2	80	0.0250000
NODE_3806_length_1212_cov_32.663073	688	768	5	8	80	0.1000000
NODE_3806_length_1212_cov_32.663073	688	768	8	11	80	0.1375000
NODE_3806_length_1212_cov_32.663073	688	768	10	59	80	0.7375000
NODE_3806_length_1212_cov_32.663073	741	821	8	52	80	0.6500000
NODE_3806_length_1212_cov_32.663073	741	821	10	28	80	0.3500000
NODE_3807_length_1212_cov_15.981132	33	113	19	10	80	0.1250000
NODE_3807_length_1212_cov_15.981132	33	113	21	7	80	0.0875000
NODE_3807_length_1212_cov_15.981132	33	113	23	8	80	0.1000000
NODE_3807_length_1212_cov_15.981132	33	113	25	55	80	0.6875000
NODE_3807_length_1212_cov_15.981132	511	591	5	80	80	1.0000000
NODE_3807_length_1212_cov_15.981132	564	637	1	6	73	0.0821918
NODE_3807_length_1212_cov_15.981132	564	637	3	1	73	0.0136986
NODE_3807_length_1212_cov_15.981132	564	637	4	7	73	0.0958904
NODE_3807_length_1212_cov_15.981132	564	637	5	31	73	0.4246575
NODE_3807_length_1212_cov_15.981132	564	637	6	28	73	0.3835616
NODE_3813_length_1211_cov_30.513489	561	641	0	80	80	1.0000000
NODE_3813_length_1211_cov_30.513489	614	694	0	80	80	1.0000000
NODE_3813_length_1211_cov_30.513489	690	770	0	80	80	1.0000000
NODE_3813_length_1211_cov_30.513489	743	823	0	80	80	1.0000000
NODE_3815_length_1211_cov_10.073741	380	460	0	18	80	0.2250000
NODE_3815_length_1211_cov_10.073741	380	460	3	4	80	0.0500000
NODE_3815_length_1211_cov_10.073741	380	460	4	58	80	0.7250000
NODE_3815_length_1211_cov_10.073741	433	513	0	71	80	0.8875000
NODE_3815_length_1211_cov_10.073741	433	513	3	4	80	0.0500000
NODE_3815_length_1211_cov_10.073741	433	513	4	5	80	0.0625000
NODE_3816_length_1211_cov_7.561151	598	678	0	42	80	0.5250000
NODE_3816_length_1211_cov_7.561151	598	678	2	38	80	0.4750000
NODE_3816_length_1211_cov_7.561151	651	731	0	80	80	1.0000000
NODE_3820_length_1210_cov_49.743474	398	478	0	17	80	0.2125000
NODE_3820_length_1210_cov_49.743474	398	478	6	22	80	0.2750000
NODE_3820_length_1210_cov_49.743474	398	478	7	18	80	0.2250000
NODE_3820_length_1210_cov_49.743474	398	478	9	5	80	0.0625000
NODE_3820_length_1210_cov_49.743474	398	478	10	13	80	0.1625000
NODE_3820_length_1210_cov_49.743474	398	478	12	5	80	0.0625000
NODE_3820_length_1210_cov_49.743474	451	531	6	16	80	0.2000000
NODE_3820_length_1210_cov_49.743474	451	531	7	4	80	0.0500000
NODE_3820_length_1210_cov_49.743474	451	531	9	5	80	0.0625000
NODE_3820_length_1210_cov_49.743474	451	531	10	13	80	0.1625000
NODE_3820_length_1210_cov_49.743474	451	531	12	42	80	0.5250000
NODE_3821_length_1210_cov_15.647165	647	727	0	16	80	0.2000000
NODE_3821_length_1210_cov_15.647165	647	727	2	64	80	0.8000000
NODE_3821_length_1210_cov_15.647165	700	780	0	69	80	0.8625000
NODE_3821_length_1210_cov_15.647165	700	780	2	11	80	0.1375000
NODE_3822_length_1210_cov_11.194419	794	874	0	80	80	1.0000000
NODE_3822_length_1210_cov_11.194419	847	927	0	80	80	1.0000000
NODE_3826_length_1209_cov_24.504505	582	662	0	80	80	1.0000000
NODE_3826_length_1209_cov_24.504505	635	715	0	80	80	1.0000000
NODE_3826_length_1209_cov_24.504505	711	791	0	80	80	1.0000000
NODE_3826_length_1209_cov_24.504505	764	844	0	80	80	1.0000000
NODE_3827_length_1209_cov_21.846847	520	600	0	80	80	1.0000000
NODE_3827_length_1209_cov_21.846847	573	653	0	80	80	1.0000000
NODE_3827_length_1209_cov_21.846847	649	729	0	80	80	1.0000000
NODE_3827_length_1209_cov_21.846847	702	782	0	80	80	1.0000000
NODE_3828_length_1209_cov_9.026126	782	862	0	80	80	1.0000000
NODE_3828_length_1209_cov_9.026126	835	915	0	80	80	1.0000000
NODE_3830_length_1209_cov_5.721622	926	1006	0	20	80	0.2500000
NODE_3830_length_1209_cov_5.721622	926	1006	2	60	80	0.7500000
NODE_3830_length_1209_cov_5.721622	979	1059	0	21	80	0.2625000
NODE_3830_length_1209_cov_5.721622	979	1059	2	59	80	0.7375000
NODE_3833_length_1208_cov_40.717764	886	966	235	1	80	0.0125000
NODE_3833_length_1208_cov_40.717764	886	966	236	3	80	0.0375000
NODE_3833_length_1208_cov_40.717764	886	966	237	1	80	0.0125000
NODE_3833_length_1208_cov_40.717764	886	966	239	1	80	0.0125000
NODE_3833_length_1208_cov_40.717764	886	966	242	1	80	0.0125000
NODE_3833_length_1208_cov_40.717764	886	966	246	1	80	0.0125000
NODE_3833_length_1208_cov_40.717764	886	966	252	1	80	0.0125000
NODE_3833_length_1208_cov_40.717764	886	966	261	1	80	0.0125000
NODE_3833_length_1208_cov_40.717764	886	966	269	2	80	0.0250000
NODE_3833_length_1208_cov_40.717764	886	966	272	1	80	0.0125000
NODE_3833_length_1208_cov_40.717764	886	966	280	1	80	0.0125000
NODE_3833_length_1208_cov_40.717764	886	966	286	1	80	0.0125000
NODE_3833_length_1208_cov_40.717764	886	966	287	1	80	0.0125000
NODE_3833_length_1208_cov_40.717764	886	966	288	3	80	0.0375000
NODE_3833_length_1208_cov_40.717764	886	966	289	2	80	0.0250000
NODE_3833_length_1208_cov_40.717764	886	966	292	1	80	0.0125000
NODE_3833_length_1208_cov_40.717764	886	966	303	1	80	0.0125000
NODE_3833_length_1208_cov_40.717764	886	966	305	2	80	0.0250000
NODE_3833_length_1208_cov_40.717764	886	966	321	1	80	0.0125000
NODE_3833_length_1208_cov_40.717764	886	966	329	1	80	0.0125000
NODE_3833_length_1208_cov_40.717764	886	966	340	1	80	0.0125000
NODE_3833_length_1208_cov_40.717764	886	966	347	1	80	0.0125000
NODE_3833_length_1208_cov_40.717764	886	966	353	2	80	0.0250000
NODE_3833_length_1208_cov_40.717764	886	966	367	1	80	0.0125000
NODE_3833_length_1208_cov_40.717764	886	966	371	1	80	0.0125000
NODE_3833_length_1208_cov_40.717764	886	966	373	2	80	0.0250000
NODE_3833_length_1208_cov_40.717764	886	966	378	1	80	0.0125000
NODE_3833_length_1208_cov_40.717764	886	966	379	1	80	0.0125000
NODE_3833_length_1208_cov_40.717764	886	966	385	2	80	0.0250000
NODE_3833_length_1208_cov_40.717764	886	966	386	1	80	0.0125000
NODE_3833_length_1208_cov_40.717764	886	966	392	1	80	0.0125000
NODE_3833_length_1208_cov_40.717764	886	966	394	1	80	0.0125000
NODE_3833_length_1208_cov_40.717764	886	966	395	1	80	0.0125000
NODE_3833_length_1208_cov_40.717764	886	966	399	1	80	0.0125000
NODE_3833_length_1208_cov_40.717764	886	966	402	3	80	0.0375000
NODE_3833_length_1208_cov_40.717764	886	966	403	1	80	0.0125000
NODE_3833_length_1208_cov_40.717764	886	966	404	1	80	0.0125000
NODE_3833_length_1208_cov_40.717764	886	966	412	2	80	0.0250000
NODE_3833_length_1208_cov_40.717764	886	966	417	1	80	0.0125000
NODE_3833_length_1208_cov_40.717764	886	966	419	1	80	0.0125000
NODE_3833_length_1208_cov_40.717764	886	966	461	1	80	0.0125000
NODE_3833_length_1208_cov_40.717764	886	966	481	1	80	0.0125000
NODE_3833_length_1208_cov_40.717764	886	966	488	1	80	0.0125000
NODE_3833_length_1208_cov_40.717764	886	966	513	1	80	0.0125000
NODE_3833_length_1208_cov_40.717764	886	966	517	1	80	0.0125000
NODE_3833_length_1208_cov_40.717764	886	966	524	1	80	0.0125000
NODE_3833_length_1208_cov_40.717764	886	966	535	1	80	0.0125000
NODE_3833_length_1208_cov_40.717764	886	966	541	1	80	0.0125000
NODE_3833_length_1208_cov_40.717764	886	966	552	1	80	0.0125000
NODE_3833_length_1208_cov_40.717764	886	966	558	1	80	0.0125000
NODE_3833_length_1208_cov_40.717764	886	966	560	1	80	0.0125000
NODE_3833_length_1208_cov_40.717764	886	966	567	1	80	0.0125000
NODE_3833_length_1208_cov_40.717764	886	966	573	1	80	0.0125000
NODE_3833_length_1208_cov_40.717764	886	966	577	1	80	0.0125000
NODE_3833_length_1208_cov_40.717764	886	966	591	1	80	0.0125000
NODE_3833_length_1208_cov_40.717764	886	966	610	1	80	0.0125000
NODE_3833_length_1208_cov_40.717764	886	966	631	1	80	0.0125000
NODE_3833_length_1208_cov_40.717764	886	966	634	1	80	0.0125000
NODE_3833_length_1208_cov_40.717764	886	966	639	1	80	0.0125000
NODE_3833_length_1208_cov_40.717764	886	966	657	1	80	0.0125000
NODE_3833_length_1208_cov_40.717764	886	966	667	1	80	0.0125000
NODE_3833_length_1208_cov_40.717764	886	966	676	1	80	0.0125000
NODE_3833_length_1208_cov_40.717764	886	966	702	1	80	0.0125000
NODE_3833_length_1208_cov_40.717764	886	966	710	1	80	0.0125000
NODE_3833_length_1208_cov_40.717764	886	966	716	1	80	0.0125000
NODE_3833_length_1208_cov_40.717764	886	966	735	1	80	0.0125000
NODE_3833_length_1208_cov_40.717764	886	966	741	1	80	0.0125000
NODE_3833_length_1208_cov_40.717764	939	985	461	1	46	0.0217391
NODE_3833_length_1208_cov_40.717764	939	985	481	1	46	0.0217391
NODE_3833_length_1208_cov_40.717764	939	985	488	1	46	0.0217391
NODE_3833_length_1208_cov_40.717764	939	985	513	1	46	0.0217391
NODE_3833_length_1208_cov_40.717764	939	985	517	1	46	0.0217391
NODE_3833_length_1208_cov_40.717764	939	985	524	1	46	0.0217391
NODE_3833_length_1208_cov_40.717764	939	985	535	1	46	0.0217391
NODE_3833_length_1208_cov_40.717764	939	985	541	1	46	0.0217391
NODE_3833_length_1208_cov_40.717764	939	985	552	1	46	0.0217391
NODE_3833_length_1208_cov_40.717764	939	985	558	1	46	0.0217391
NODE_3833_length_1208_cov_40.717764	939	985	560	1	46	0.0217391
NODE_3833_length_1208_cov_40.717764	939	985	567	1	46	0.0217391
NODE_3833_length_1208_cov_40.717764	939	985	573	1	46	0.0217391
NODE_3833_length_1208_cov_40.717764	939	985	577	1	46	0.0217391
NODE_3833_length_1208_cov_40.717764	939	985	591	1	46	0.0217391
NODE_3833_length_1208_cov_40.717764	939	985	610	1	46	0.0217391
NODE_3833_length_1208_cov_40.717764	939	985	631	1	46	0.0217391
NODE_3833_length_1208_cov_40.717764	939	985	634	1	46	0.0217391
NODE_3833_length_1208_cov_40.717764	939	985	639	1	46	0.0217391
NODE_3833_length_1208_cov_40.717764	939	985	657	1	46	0.0217391
NODE_3833_length_1208_cov_40.717764	939	985	667	1	46	0.0217391
NODE_3833_length_1208_cov_40.717764	939	985	676	1	46	0.0217391
NODE_3833_length_1208_cov_40.717764	939	985	702	1	46	0.0217391
NODE_3833_length_1208_cov_40.717764	939	985	710	1	46	0.0217391
NODE_3833_length_1208_cov_40.717764	939	985	716	1	46	0.0217391
NODE_3833_length_1208_cov_40.717764	939	985	735	1	46	0.0217391
NODE_3833_length_1208_cov_40.717764	939	985	741	1	46	0.0217391
NODE_3833_length_1208_cov_40.717764	939	985	751	1	46	0.0217391
NODE_3833_length_1208_cov_40.717764	939	985	761	1	46	0.0217391
NODE_3833_length_1208_cov_40.717764	939	985	779	1	46	0.0217391
NODE_3833_length_1208_cov_40.717764	939	985	789	1	46	0.0217391
NODE_3833_length_1208_cov_40.717764	939	985	797	1	46	0.0217391
NODE_3833_length_1208_cov_40.717764	939	985	804	1	46	0.0217391
NODE_3833_length_1208_cov_40.717764	939	985	806	1	46	0.0217391
NODE_3833_length_1208_cov_40.717764	939	985	814	1	46	0.0217391
NODE_3833_length_1208_cov_40.717764	939	985	816	1	46	0.0217391
NODE_3833_length_1208_cov_40.717764	939	985	818	2	46	0.0434783
NODE_3833_length_1208_cov_40.717764	939	985	829	2	46	0.0434783
NODE_3833_length_1208_cov_40.717764	939	985	832	2	46	0.0434783
NODE_3833_length_1208_cov_40.717764	939	985	833	1	46	0.0217391
NODE_3833_length_1208_cov_40.717764	939	985	835	1	46	0.0217391
NODE_3833_length_1208_cov_40.717764	939	985	841	1	46	0.0217391
NODE_3833_length_1208_cov_40.717764	939	985	844	1	46	0.0217391
NODE_3834_length_1208_cov_28.528404	614	694	0	80	80	1.0000000
NODE_3834_length_1208_cov_28.528404	667	747	0	80	80	1.0000000
NODE_3835_length_1208_cov_19.688007	682	762	0	80	80	1.0000000
NODE_3835_length_1208_cov_19.688007	735	815	0	80	80	1.0000000
NODE_3836_length_1208_cov_18.577096	455	535	2	46	80	0.5750000
NODE_3836_length_1208_cov_18.577096	455	535	6	7	80	0.0875000
NODE_3836_length_1208_cov_18.577096	455	535	8	9	80	0.1125000
NODE_3836_length_1208_cov_18.577096	455	535	10	18	80	0.2250000
NODE_3836_length_1208_cov_18.577096	508	588	8	9	80	0.1125000
NODE_3836_length_1208_cov_18.577096	508	588	10	33	80	0.4125000
NODE_3836_length_1208_cov_18.577096	508	588	12	30	80	0.3750000
NODE_3836_length_1208_cov_18.577096	508	588	14	8	80	0.1000000
NODE_3836_length_1208_cov_18.577096	584	664	4	13	80	0.1625000
NODE_3836_length_1208_cov_18.577096	584	664	8	30	80	0.3750000
NODE_3836_length_1208_cov_18.577096	584	664	10	32	80	0.4000000
NODE_3836_length_1208_cov_18.577096	584	664	12	5	80	0.0625000
NODE_3836_length_1208_cov_18.577096	637	717	0	14	80	0.1750000
NODE_3836_length_1208_cov_18.577096	637	717	4	52	80	0.6500000
NODE_3836_length_1208_cov_18.577096	637	717	8	14	80	0.1750000
NODE_3837_length_1208_cov_12.733995	766	846	0	80	80	1.0000000
NODE_3837_length_1208_cov_12.733995	819	899	0	49	80	0.6125000
NODE_3837_length_1208_cov_12.733995	819	899	2	31	80	0.3875000
NODE_3837_length_1208_cov_12.733995	895	975	2	57	80	0.7125000
NODE_3837_length_1208_cov_12.733995	895	975	4	23	80	0.2875000
NODE_3837_length_1208_cov_12.733995	948	1028	2	51	80	0.6375000
NODE_3837_length_1208_cov_12.733995	948	1028	4	29	80	0.3625000
NODE_3838_length_1207_cov_20.461191	874	954	2	35	80	0.4375000
NODE_3838_length_1207_cov_20.461191	874	954	6	45	80	0.5625000
NODE_3838_length_1207_cov_20.461191	927	1007	5	6	80	0.0750000
NODE_3838_length_1207_cov_20.461191	927	1007	6	74	80	0.9250000
NODE_3846_length_1206_cov_59.851852	540	620	0	29	80	0.3625000
NODE_3846_length_1206_cov_59.851852	540	620	12	51	80	0.6375000
NODE_3846_length_1206_cov_59.851852	593	673	2	2	80	0.0250000
NODE_3846_length_1206_cov_59.851852	593	673	12	70	80	0.8750000
NODE_3846_length_1206_cov_59.851852	593	673	14	8	80	0.1000000
NODE_3846_length_1206_cov_59.851852	669	749	2	78	80	0.9750000
NODE_3846_length_1206_cov_59.851852	669	749	14	2	80	0.0250000
NODE_3846_length_1206_cov_59.851852	722	802	0	45	80	0.5625000
NODE_3846_length_1206_cov_59.851852	722	802	2	35	80	0.4375000
NODE_3847_length_1206_cov_23.752484	669	749	0	13	80	0.1625000
NODE_3847_length_1206_cov_23.752484	669	749	4	67	80	0.8375000
NODE_3847_length_1206_cov_23.752484	722	802	0	37	80	0.4625000
NODE_3847_length_1206_cov_23.752484	722	802	4	43	80	0.5375000
NODE_3848_length_1206_cov_21.226739	585	665	8	80	80	1.0000000
NODE_3848_length_1206_cov_21.226739	638	718	0	50	80	0.6250000
NODE_3848_length_1206_cov_21.226739	638	718	8	30	80	0.3750000
NODE_3855_length_1205_cov_23.990054	355	435	0	80	80	1.0000000
NODE_3855_length_1205_cov_23.990054	408	488	0	80	80	1.0000000
NODE_3856_length_1205_cov_10.473779	780	860	0	80	80	1.0000000
NODE_3856_length_1205_cov_10.473779	833	913	0	80	80	1.0000000
NODE_3863_length_1204_cov_19.396380	537	617	0	80	80	1.0000000
NODE_3863_length_1204_cov_19.396380	590	670	0	80	80	1.0000000
NODE_3864_length_1204_cov_17.716742	448	528	0	80	80	1.0000000
NODE_3864_length_1204_cov_17.716742	501	581	0	80	80	1.0000000
NODE_3865_length_1204_cov_15.206335	426	506	0	80	80	1.0000000
NODE_3865_length_1204_cov_15.206335	479	559	0	80	80	1.0000000
NODE_3866_length_1204_cov_14.097738	632	712	0	26	80	0.3250000
NODE_3866_length_1204_cov_14.097738	632	712	2	54	80	0.6750000
NODE_3866_length_1204_cov_14.097738	685	765	0	4	80	0.0500000
NODE_3866_length_1204_cov_14.097738	685	765	2	76	80	0.9500000
NODE_3867_length_1204_cov_11.971946	549	629	0	80	80	1.0000000
NODE_3867_length_1204_cov_11.971946	602	682	0	80	80	1.0000000
NODE_3867_length_1204_cov_11.971946	678	758	0	80	80	1.0000000
NODE_3867_length_1204_cov_11.971946	731	811	0	80	80	1.0000000
NODE_3868_length_1204_cov_11.665158	499	579	0	80	80	1.0000000
NODE_3868_length_1204_cov_11.665158	552	632	0	80	80	1.0000000
NODE_3869_length_1204_cov_7.028959	637	717	0	80	80	1.0000000
NODE_3869_length_1204_cov_7.028959	690	770	0	80	80	1.0000000
NODE_3870_length_1204_cov_4.677828	807	887	0	80	80	1.0000000
NODE_3870_length_1204_cov_4.677828	860	940	0	80	80	1.0000000
NODE_3873_length_1203_cov_46.789855	515	595	0	65	80	0.8125000
NODE_3873_length_1203_cov_46.789855	515	595	2	15	80	0.1875000
NODE_3873_length_1203_cov_46.789855	568	648	0	80	80	1.0000000
NODE_3873_length_1203_cov_46.789855	644	724	0	80	80	1.0000000
NODE_3873_length_1203_cov_46.789855	697	777	0	80	80	1.0000000
NODE_3874_length_1203_cov_44.029891	471	551	0	16	80	0.2000000
NODE_3874_length_1203_cov_44.029891	471	551	4	64	80	0.8000000
NODE_3874_length_1203_cov_44.029891	524	604	2	26	80	0.3250000
NODE_3874_length_1203_cov_44.029891	524	604	4	36	80	0.4500000
NODE_3874_length_1203_cov_44.029891	524	604	6	18	80	0.2250000
NODE_3874_length_1203_cov_44.029891	600	680	0	1	80	0.0125000
NODE_3874_length_1203_cov_44.029891	600	680	2	37	80	0.4625000
NODE_3874_length_1203_cov_44.029891	600	680	6	42	80	0.5250000
NODE_3874_length_1203_cov_44.029891	653	733	4	32	80	0.4000000
NODE_3874_length_1203_cov_44.029891	653	733	6	48	80	0.6000000
NODE_3875_length_1203_cov_23.790761	308	388	0	73	80	0.9125000
NODE_3875_length_1203_cov_23.790761	308	388	6	7	80	0.0875000
NODE_3875_length_1203_cov_23.790761	361	441	0	20	80	0.2500000
NODE_3875_length_1203_cov_23.790761	361	441	6	60	80	0.7500000
NODE_3875_length_1203_cov_23.790761	437	517	0	23	80	0.2875000
NODE_3875_length_1203_cov_23.790761	437	517	6	57	80	0.7125000
NODE_3875_length_1203_cov_23.790761	490	570	0	66	80	0.8250000
NODE_3875_length_1203_cov_23.790761	490	570	3	1	80	0.0125000
NODE_3875_length_1203_cov_23.790761	490	570	4	9	80	0.1125000
NODE_3875_length_1203_cov_23.790761	490	570	6	4	80	0.0500000
NODE_3876_length_1203_cov_19.498188	336	416	0	30	80	0.3750000
NODE_3876_length_1203_cov_19.498188	336	416	7	2	80	0.0250000
NODE_3876_length_1203_cov_19.498188	336	416	8	13	80	0.1625000
NODE_3876_length_1203_cov_19.498188	336	416	9	35	80	0.4375000
NODE_3876_length_1203_cov_19.498188	389	469	9	54	80	0.6750000
NODE_3876_length_1203_cov_19.498188	389	469	10	26	80	0.3250000
NODE_3877_length_1203_cov_10.996377	317	397	0	71	80	0.8875000
NODE_3877_length_1203_cov_10.996377	317	397	2	9	80	0.1125000
NODE_3877_length_1203_cov_10.996377	370	450	0	33	80	0.4125000
NODE_3877_length_1203_cov_10.996377	370	450	4	47	80	0.5875000
NODE_3878_length_1203_cov_5.747283	725	805	0	80	80	1.0000000
NODE_3878_length_1203_cov_5.747283	778	858	0	80	80	1.0000000
NODE_3881_length_1202_cov_39.333636	475	555	0	13	80	0.1625000
NODE_3881_length_1202_cov_39.333636	475	555	2	67	80	0.8375000
NODE_3881_length_1202_cov_39.333636	528	608	2	80	80	1.0000000
NODE_3881_length_1202_cov_39.333636	604	684	0	65	80	0.8125000
NODE_3881_length_1202_cov_39.333636	604	684	2	15	80	0.1875000
NODE_3881_length_1202_cov_39.333636	657	737	0	80	80	1.0000000
NODE_3882_length_1202_cov_17.556664	599	679	0	11	80	0.1375000
NODE_3882_length_1202_cov_17.556664	599	679	2	69	80	0.8625000
NODE_3882_length_1202_cov_17.556664	652	732	0	21	80	0.2625000
NODE_3882_length_1202_cov_17.556664	652	732	2	59	80	0.7375000
NODE_3883_length_1202_cov_12.338169	634	714	8	80	80	1.0000000
NODE_3883_length_1202_cov_12.338169	687	767	0	16	80	0.2000000
NODE_3883_length_1202_cov_12.338169	687	767	8	64	80	0.8000000
NODE_3884_length_1202_cov_11.800544	520	600	4	35	80	0.4375000
NODE_3884_length_1202_cov_11.800544	520	600	6	39	80	0.4875000
NODE_3884_length_1202_cov_11.800544	520	600	10	6	80	0.0750000
NODE_3884_length_1202_cov_11.800544	573	653	2	8	80	0.1000000
NODE_3884_length_1202_cov_11.800544	573	653	6	64	80	0.8000000
NODE_3884_length_1202_cov_11.800544	573	653	7	1	80	0.0125000
NODE_3884_length_1202_cov_11.800544	573	653	8	7	80	0.0875000
NODE_3887_length_1201_cov_12.161525	434	514	0	80	80	1.0000000
NODE_3887_length_1201_cov_12.161525	487	567	0	37	80	0.4625000
NODE_3887_length_1201_cov_12.161525	487	567	2	43	80	0.5375000
NODE_3888_length_1201_cov_12.046279	643	723	0	26	80	0.3250000
NODE_3888_length_1201_cov_12.046279	643	723	6	54	80	0.6750000
NODE_3888_length_1201_cov_12.046279	696	776	0	79	80	0.9875000
NODE_3888_length_1201_cov_12.046279	696	776	6	1	80	0.0125000
NODE_3891_length_1200_cov_76.694823	630	710	0	20	80	0.2500000
NODE_3891_length_1200_cov_76.694823	630	710	2	60	80	0.7500000
NODE_3891_length_1200_cov_76.694823	683	763	0	73	80	0.9125000
NODE_3891_length_1200_cov_76.694823	683	763	2	7	80	0.0875000
NODE_3891_length_1200_cov_76.694823	759	839	0	63	80	0.7875000
NODE_3891_length_1200_cov_76.694823	759	839	6	17	80	0.2125000
NODE_3891_length_1200_cov_76.694823	812	892	0	14	80	0.1750000
NODE_3891_length_1200_cov_76.694823	812	892	6	66	80	0.8250000
NODE_3892_length_1200_cov_16.881926	827	902	11	1	75	0.0133333
NODE_3892_length_1200_cov_16.881926	827	902	12	4	75	0.0533333
NODE_3892_length_1200_cov_16.881926	827	902	13	18	75	0.2400000
NODE_3892_length_1200_cov_16.881926	827	902	15	1	75	0.0133333
NODE_3892_length_1200_cov_16.881926	827	902	23	1	75	0.0133333
NODE_3892_length_1200_cov_16.881926	827	902	25	1	75	0.0133333
NODE_3892_length_1200_cov_16.881926	827	902	27	5	75	0.0666667
NODE_3892_length_1200_cov_16.881926	827	902	32	1	75	0.0133333
NODE_3892_length_1200_cov_16.881926	827	902	42	3	75	0.0400000
NODE_3892_length_1200_cov_16.881926	827	902	43	4	75	0.0533333
NODE_3892_length_1200_cov_16.881926	827	902	44	1	75	0.0133333
NODE_3892_length_1200_cov_16.881926	827	902	45	2	75	0.0266667
NODE_3892_length_1200_cov_16.881926	827	902	51	1	75	0.0133333
NODE_3892_length_1200_cov_16.881926	827	902	53	1	75	0.0133333
NODE_3892_length_1200_cov_16.881926	827	902	67	2	75	0.0266667
NODE_3892_length_1200_cov_16.881926	827	902	71	3	75	0.0400000
NODE_3892_length_1200_cov_16.881926	827	902	91	4	75	0.0533333
NODE_3892_length_1200_cov_16.881926	827	902	92	7	75	0.0933333
NODE_3892_length_1200_cov_16.881926	827	902	93	3	75	0.0400000
NODE_3892_length_1200_cov_16.881926	827	902	100	2	75	0.0266667
NODE_3892_length_1200_cov_16.881926	827	902	109	2	75	0.0266667
NODE_3892_length_1200_cov_16.881926	827	902	110	3	75	0.0400000
NODE_3892_length_1200_cov_16.881926	827	902	113	1	75	0.0133333
NODE_3892_length_1200_cov_16.881926	827	902	114	3	75	0.0400000
NODE_3892_length_1200_cov_16.881926	827	902	115	1	75	0.0133333
NODE_3892_length_1200_cov_16.881926	828	904	11	1	76	0.0131579
NODE_3892_length_1200_cov_16.881926	828	904	12	3	76	0.0394737
NODE_3892_length_1200_cov_16.881926	828	904	13	18	76	0.2368421
NODE_3892_length_1200_cov_16.881926	828	904	15	1	76	0.0131579
NODE_3892_length_1200_cov_16.881926	828	904	23	1	76	0.0131579
NODE_3892_length_1200_cov_16.881926	828	904	25	1	76	0.0131579
NODE_3892_length_1200_cov_16.881926	828	904	27	5	76	0.0657895
NODE_3892_length_1200_cov_16.881926	828	904	32	1	76	0.0131579
NODE_3892_length_1200_cov_16.881926	828	904	42	3	76	0.0394737
NODE_3892_length_1200_cov_16.881926	828	904	43	4	76	0.0526316
NODE_3892_length_1200_cov_16.881926	828	904	44	1	76	0.0131579
NODE_3892_length_1200_cov_16.881926	828	904	45	2	76	0.0263158
NODE_3892_length_1200_cov_16.881926	828	904	51	1	76	0.0131579
NODE_3892_length_1200_cov_16.881926	828	904	53	1	76	0.0131579
NODE_3892_length_1200_cov_16.881926	828	904	67	2	76	0.0263158
NODE_3892_length_1200_cov_16.881926	828	904	71	3	76	0.0394737
NODE_3892_length_1200_cov_16.881926	828	904	91	4	76	0.0526316
NODE_3892_length_1200_cov_16.881926	828	904	92	7	76	0.0921053
NODE_3892_length_1200_cov_16.881926	828	904	93	3	76	0.0394737
NODE_3892_length_1200_cov_16.881926	828	904	100	2	76	0.0263158
NODE_3892_length_1200_cov_16.881926	828	904	109	2	76	0.0263158
NODE_3892_length_1200_cov_16.881926	828	904	110	3	76	0.0394737
NODE_3892_length_1200_cov_16.881926	828	904	113	1	76	0.0131579
NODE_3892_length_1200_cov_16.881926	828	904	114	3	76	0.0394737
NODE_3892_length_1200_cov_16.881926	828	904	115	3	76	0.0394737
NODE_3892_length_1200_cov_16.881926	841	907	13	9	66	0.1363636
NODE_3892_length_1200_cov_16.881926	841	907	15	1	66	0.0151515
NODE_3892_length_1200_cov_16.881926	841	907	23	1	66	0.0151515
NODE_3892_length_1200_cov_16.881926	841	907	25	1	66	0.0151515
NODE_3892_length_1200_cov_16.881926	841	907	27	5	66	0.0757576
NODE_3892_length_1200_cov_16.881926	841	907	32	1	66	0.0151515
NODE_3892_length_1200_cov_16.881926	841	907	42	3	66	0.0454545
NODE_3892_length_1200_cov_16.881926	841	907	43	4	66	0.0606061
NODE_3892_length_1200_cov_16.881926	841	907	44	1	66	0.0151515
NODE_3892_length_1200_cov_16.881926	841	907	45	2	66	0.0303030
NODE_3892_length_1200_cov_16.881926	841	907	51	1	66	0.0151515
NODE_3892_length_1200_cov_16.881926	841	907	53	1	66	0.0151515
NODE_3892_length_1200_cov_16.881926	841	907	67	2	66	0.0303030
NODE_3892_length_1200_cov_16.881926	841	907	71	3	66	0.0454545
NODE_3892_length_1200_cov_16.881926	841	907	91	4	66	0.0606061
NODE_3892_length_1200_cov_16.881926	841	907	92	7	66	0.1060606
NODE_3892_length_1200_cov_16.881926	841	907	93	3	66	0.0454545
NODE_3892_length_1200_cov_16.881926	841	907	100	2	66	0.0303030
NODE_3892_length_1200_cov_16.881926	841	907	109	2	66	0.0303030
NODE_3892_length_1200_cov_16.881926	841	907	110	3	66	0.0454545
NODE_3892_length_1200_cov_16.881926	841	907	113	1	66	0.0151515
NODE_3892_length_1200_cov_16.881926	841	907	114	3	66	0.0454545
NODE_3892_length_1200_cov_16.881926	841	907	115	3	66	0.0454545
NODE_3892_length_1200_cov_16.881926	841	907	118	3	66	0.0454545
NODE_3892_length_1200_cov_16.881926	880	957	92	7	77	0.0909091
NODE_3892_length_1200_cov_16.881926	880	957	93	3	77	0.0389610
NODE_3892_length_1200_cov_16.881926	880	957	100	2	77	0.0259740
NODE_3892_length_1200_cov_16.881926	880	957	109	2	77	0.0259740
NODE_3892_length_1200_cov_16.881926	880	957	110	3	77	0.0389610
NODE_3892_length_1200_cov_16.881926	880	957	111	5	77	0.0649351
NODE_3892_length_1200_cov_16.881926	880	957	112	5	77	0.0649351
NODE_3892_length_1200_cov_16.881926	880	957	113	14	77	0.1818182
NODE_3892_length_1200_cov_16.881926	880	957	114	3	77	0.0389610
NODE_3892_length_1200_cov_16.881926	880	957	115	5	77	0.0649351
NODE_3892_length_1200_cov_16.881926	880	957	117	1	77	0.0129870
NODE_3892_length_1200_cov_16.881926	880	957	118	4	77	0.0519481
NODE_3892_length_1200_cov_16.881926	880	957	119	3	77	0.0389610
NODE_3892_length_1200_cov_16.881926	880	957	120	6	77	0.0779221
NODE_3892_length_1200_cov_16.881926	880	957	122	1	77	0.0129870
NODE_3892_length_1200_cov_16.881926	880	957	127	1	77	0.0129870
NODE_3892_length_1200_cov_16.881926	880	957	132	1	77	0.0129870
NODE_3892_length_1200_cov_16.881926	880	957	135	2	77	0.0259740
NODE_3892_length_1200_cov_16.881926	880	957	139	2	77	0.0259740
NODE_3892_length_1200_cov_16.881926	880	957	141	1	77	0.0129870
NODE_3892_length_1200_cov_16.881926	880	957	149	2	77	0.0259740
NODE_3892_length_1200_cov_16.881926	880	957	150	4	77	0.0519481
NODE_3892_length_1200_cov_16.881926	880	957	92	7	77	0.0909091
NODE_3892_length_1200_cov_16.881926	880	957	93	3	77	0.0389610
NODE_3892_length_1200_cov_16.881926	880	957	100	2	77	0.0259740
NODE_3892_length_1200_cov_16.881926	880	957	109	2	77	0.0259740
NODE_3892_length_1200_cov_16.881926	880	957	110	3	77	0.0389610
NODE_3892_length_1200_cov_16.881926	880	957	111	5	77	0.0649351
NODE_3892_length_1200_cov_16.881926	880	957	112	5	77	0.0649351
NODE_3892_length_1200_cov_16.881926	880	957	113	14	77	0.1818182
NODE_3892_length_1200_cov_16.881926	880	957	114	3	77	0.0389610
NODE_3892_length_1200_cov_16.881926	880	957	115	5	77	0.0649351
NODE_3892_length_1200_cov_16.881926	880	957	117	1	77	0.0129870
NODE_3892_length_1200_cov_16.881926	880	957	118	4	77	0.0519481
NODE_3892_length_1200_cov_16.881926	880	957	119	3	77	0.0389610
NODE_3892_length_1200_cov_16.881926	880	957	120	6	77	0.0779221
NODE_3892_length_1200_cov_16.881926	880	957	122	1	77	0.0129870
NODE_3892_length_1200_cov_16.881926	880	957	127	1	77	0.0129870
NODE_3892_length_1200_cov_16.881926	880	957	132	1	77	0.0129870
NODE_3892_length_1200_cov_16.881926	880	957	135	2	77	0.0259740
NODE_3892_length_1200_cov_16.881926	880	957	139	2	77	0.0259740
NODE_3892_length_1200_cov_16.881926	880	957	141	1	77	0.0129870
NODE_3892_length_1200_cov_16.881926	880	957	149	2	77	0.0259740
NODE_3892_length_1200_cov_16.881926	880	957	150	4	77	0.0519481
NODE_3892_length_1200_cov_16.881926	880	957	92	7	77	0.0909091
NODE_3892_length_1200_cov_16.881926	880	957	93	3	77	0.0389610
NODE_3892_length_1200_cov_16.881926	880	957	100	2	77	0.0259740
NODE_3892_length_1200_cov_16.881926	880	957	109	2	77	0.0259740
NODE_3892_length_1200_cov_16.881926	880	957	110	3	77	0.0389610
NODE_3892_length_1200_cov_16.881926	880	957	111	5	77	0.0649351
NODE_3892_length_1200_cov_16.881926	880	957	112	5	77	0.0649351
NODE_3892_length_1200_cov_16.881926	880	957	113	14	77	0.1818182
NODE_3892_length_1200_cov_16.881926	880	957	114	3	77	0.0389610
NODE_3892_length_1200_cov_16.881926	880	957	115	5	77	0.0649351
NODE_3892_length_1200_cov_16.881926	880	957	117	1	77	0.0129870
NODE_3892_length_1200_cov_16.881926	880	957	118	4	77	0.0519481
NODE_3892_length_1200_cov_16.881926	880	957	119	3	77	0.0389610
NODE_3892_length_1200_cov_16.881926	880	957	120	6	77	0.0779221
NODE_3892_length_1200_cov_16.881926	880	957	122	1	77	0.0129870
NODE_3892_length_1200_cov_16.881926	880	957	127	1	77	0.0129870
NODE_3892_length_1200_cov_16.881926	880	957	132	1	77	0.0129870
NODE_3892_length_1200_cov_16.881926	880	957	135	2	77	0.0259740
NODE_3892_length_1200_cov_16.881926	880	957	139	2	77	0.0259740
NODE_3892_length_1200_cov_16.881926	880	957	141	1	77	0.0129870
NODE_3892_length_1200_cov_16.881926	880	957	149	2	77	0.0259740
NODE_3892_length_1200_cov_16.881926	880	957	150	4	77	0.0519481
NODE_3893_length_1200_cov_15.374205	605	685	0	80	80	1.0000000
NODE_3893_length_1200_cov_15.374205	658	738	0	80	80	1.0000000
NODE_3894_length_1200_cov_12.953678	486	550	0	5	64	0.0781250
NODE_3894_length_1200_cov_12.953678	486	550	9	37	64	0.5781250
NODE_3894_length_1200_cov_12.953678	486	550	10	22	64	0.3437500
NODE_3899_length_1199_cov_14.843636	222	302	0	19	80	0.2375000
NODE_3899_length_1199_cov_14.843636	222	302	20	8	80	0.1000000
NODE_3899_length_1199_cov_14.843636	222	302	21	5	80	0.0625000
NODE_3899_length_1199_cov_14.843636	222	302	22	2	80	0.0250000
NODE_3899_length_1199_cov_14.843636	222	302	23	19	80	0.2375000
NODE_3899_length_1199_cov_14.843636	222	302	24	4	80	0.0500000
NODE_3899_length_1199_cov_14.843636	222	302	28	23	80	0.2875000
NODE_3899_length_1199_cov_14.843636	275	355	24	4	80	0.0500000
NODE_3899_length_1199_cov_14.843636	275	355	28	76	80	0.9500000
NODE_3900_length_1199_cov_12.005455	383	463	0	38	80	0.4750000
NODE_3900_length_1199_cov_12.005455	383	463	2	42	80	0.5250000
NODE_3900_length_1199_cov_12.005455	436	516	0	80	80	1.0000000
NODE_3900_length_1199_cov_12.005455	512	592	0	36	80	0.4500000
NODE_3900_length_1199_cov_12.005455	512	592	2	44	80	0.5500000
NODE_3900_length_1199_cov_12.005455	565	645	2	80	80	1.0000000
NODE_3902_length_1198_cov_36.830755	619	699	0	63	80	0.7875000
NODE_3902_length_1198_cov_36.830755	619	699	1	4	80	0.0500000
NODE_3902_length_1198_cov_36.830755	619	699	2	13	80	0.1625000
NODE_3902_length_1198_cov_36.830755	672	752	0	80	80	1.0000000
NODE_3903_length_1198_cov_22.864422	719	799	0	80	80	1.0000000
NODE_3903_length_1198_cov_22.864422	772	852	0	80	80	1.0000000
NODE_3904_length_1198_cov_17.619654	260	340	0	12	80	0.1500000
NODE_3904_length_1198_cov_17.619654	260	340	2	68	80	0.8500000
NODE_3904_length_1198_cov_17.619654	313	392	0	44	79	0.5569620
NODE_3904_length_1198_cov_17.619654	313	392	2	35	79	0.4430380
NODE_3905_length_1198_cov_10.148317	718	798	0	15	80	0.1875000
NODE_3905_length_1198_cov_10.148317	718	798	2	52	80	0.6500000
NODE_3905_length_1198_cov_10.148317	718	798	4	13	80	0.1625000
NODE_3905_length_1198_cov_10.148317	771	851	0	12	80	0.1500000
NODE_3905_length_1198_cov_10.148317	771	851	2	47	80	0.5875000
NODE_3905_length_1198_cov_10.148317	771	851	4	21	80	0.2625000
NODE_3906_length_1198_cov_6.733394	549	629	0	19	80	0.2375000
NODE_3906_length_1198_cov_6.733394	549	629	2	61	80	0.7625000
NODE_3906_length_1198_cov_6.733394	602	682	0	72	80	0.9000000
NODE_3906_length_1198_cov_6.733394	602	682	2	8	80	0.1000000
NODE_3912_length_1197_cov_27.653005	417	497	0	34	80	0.4250000
NODE_3912_length_1197_cov_27.653005	417	497	2	46	80	0.5750000
NODE_3912_length_1197_cov_27.653005	470	550	2	80	80	1.0000000
NODE_3912_length_1197_cov_27.653005	546	626	0	62	80	0.7750000
NODE_3912_length_1197_cov_27.653005	546	626	2	18	80	0.2250000
NODE_3912_length_1197_cov_27.653005	599	679	0	80	80	1.0000000
NODE_3913_length_1197_cov_14.653916	490	570	0	80	80	1.0000000
NODE_3913_length_1197_cov_14.653916	543	623	0	80	80	1.0000000
NODE_3921_length_1196_cov_26.169553	298	378	2	26	80	0.3250000
NODE_3921_length_1196_cov_26.169553	298	378	4	54	80	0.6750000
NODE_3921_length_1196_cov_26.169553	351	431	0	6	80	0.0750000
NODE_3921_length_1196_cov_26.169553	351	431	1	1	80	0.0125000
NODE_3921_length_1196_cov_26.169553	351	431	3	31	80	0.3875000
NODE_3921_length_1196_cov_26.169553	351	431	4	42	80	0.5250000
NODE_3921_length_1196_cov_26.169553	427	507	0	53	80	0.6625000
NODE_3921_length_1196_cov_26.169553	427	507	6	27	80	0.3375000
NODE_3921_length_1196_cov_26.169553	480	560	0	4	80	0.0500000
NODE_3921_length_1196_cov_26.169553	480	560	2	14	80	0.1750000
NODE_3921_length_1196_cov_26.169553	480	560	6	62	80	0.7750000
NODE_3922_length_1196_cov_21.755697	521	601	0	35	80	0.4375000
NODE_3922_length_1196_cov_21.755697	521	601	2	45	80	0.5625000
NODE_3922_length_1196_cov_21.755697	574	654	2	80	80	1.0000000
NODE_3922_length_1196_cov_21.755697	650	730	0	65	80	0.8125000
NODE_3922_length_1196_cov_21.755697	650	730	2	15	80	0.1875000
NODE_3922_length_1196_cov_21.755697	703	783	0	80	80	1.0000000
NODE_3923_length_1196_cov_5.966272	556	636	0	80	80	1.0000000
NODE_3923_length_1196_cov_5.966272	609	689	0	80	80	1.0000000
NODE_3927_length_1195_cov_69.056569	474	554	0	80	80	1.0000000
NODE_3927_length_1195_cov_69.056569	527	607	0	80	80	1.0000000
NODE_3927_length_1195_cov_69.056569	603	683	0	80	80	1.0000000
NODE_3927_length_1195_cov_69.056569	656	736	0	80	80	1.0000000
NODE_3928_length_1195_cov_65.062044	579	659	0	80	80	1.0000000
NODE_3928_length_1195_cov_65.062044	632	712	0	80	80	1.0000000
NODE_3928_length_1195_cov_65.062044	708	788	0	30	80	0.3750000
NODE_3928_length_1195_cov_65.062044	708	788	2	6	80	0.0750000
NODE_3928_length_1195_cov_65.062044	708	788	4	44	80	0.5500000
NODE_3928_length_1195_cov_65.062044	761	841	0	19	80	0.2375000
NODE_3928_length_1195_cov_65.062044	761	841	2	7	80	0.0875000
NODE_3928_length_1195_cov_65.062044	761	841	4	54	80	0.6750000
NODE_3929_length_1195_cov_23.187044	460	540	0	70	80	0.8750000
NODE_3929_length_1195_cov_23.187044	460	540	2	10	80	0.1250000
NODE_3929_length_1195_cov_23.187044	513	593	0	17	80	0.2125000
NODE_3929_length_1195_cov_23.187044	513	593	2	63	80	0.7875000
NODE_3930_length_1195_cov_18.983577	521	601	0	80	80	1.0000000
NODE_3930_length_1195_cov_18.983577	574	654	0	80	80	1.0000000
NODE_3931_length_1195_cov_14.119526	726	806	0	80	80	1.0000000
NODE_3931_length_1195_cov_14.119526	779	859	0	80	80	1.0000000
NODE_3931_length_1195_cov_14.119526	855	935	0	80	80	1.0000000
NODE_3931_length_1195_cov_14.119526	908	988	0	80	80	1.0000000
NODE_3932_length_1195_cov_13.805657	759	839	0	6	80	0.0750000
NODE_3932_length_1195_cov_13.805657	759	839	2	31	80	0.3875000
NODE_3932_length_1195_cov_13.805657	759	839	4	43	80	0.5375000
NODE_3932_length_1195_cov_13.805657	812	892	0	59	80	0.7375000
NODE_3932_length_1195_cov_13.805657	812	892	2	21	80	0.2625000
NODE_3938_length_1195_cov_1.969891	912	992	15	11	80	0.1375000
NODE_3938_length_1195_cov_1.969891	912	992	16	33	80	0.4125000
NODE_3938_length_1195_cov_1.969891	912	992	17	23	80	0.2875000
NODE_3938_length_1195_cov_1.969891	912	992	19	13	80	0.1625000
NODE_3938_length_1195_cov_1.969891	912	992	15	11	80	0.1375000
NODE_3938_length_1195_cov_1.969891	912	992	16	33	80	0.4125000
NODE_3938_length_1195_cov_1.969891	912	992	17	23	80	0.2875000
NODE_3938_length_1195_cov_1.969891	912	992	19	13	80	0.1625000
NODE_3941_length_1194_cov_40.157991	237	317	0	45	80	0.5625000
NODE_3941_length_1194_cov_40.157991	237	317	2	35	80	0.4375000
NODE_3941_length_1194_cov_40.157991	290	370	0	80	80	1.0000000
NODE_3946_length_1193_cov_34.295247	443	523	0	80	80	1.0000000
NODE_3946_length_1193_cov_34.295247	496	576	0	80	80	1.0000000
NODE_3947_length_1193_cov_16.930530	124	154	6	23	30	0.7666667
NODE_3947_length_1193_cov_16.930530	124	154	8	7	30	0.2333333
NODE_3947_length_1193_cov_16.930530	390	470	0	11	80	0.1375000
NODE_3947_length_1193_cov_16.930530	390	470	2	69	80	0.8625000
NODE_3947_length_1193_cov_16.930530	443	523	0	64	80	0.8000000
NODE_3947_length_1193_cov_16.930530	443	523	2	16	80	0.2000000
NODE_3949_length_1192_cov_26.803294	205	285	0	80	80	1.0000000
NODE_3949_length_1192_cov_26.803294	258	338	0	80	80	1.0000000
NODE_3949_length_1192_cov_26.803294	334	414	0	80	80	1.0000000
NODE_3949_length_1192_cov_26.803294	387	467	0	80	80	1.0000000
NODE_3950_length_1192_cov_23.228728	487	567	0	80	80	1.0000000
NODE_3950_length_1192_cov_23.228728	540	620	0	78	80	0.9750000
NODE_3950_length_1192_cov_23.228728	540	620	4	2	80	0.0250000
NODE_3950_length_1192_cov_23.228728	616	696	0	2	80	0.0250000
NODE_3950_length_1192_cov_23.228728	616	696	4	8	80	0.1000000
NODE_3950_length_1192_cov_23.228728	616	696	8	1	80	0.0125000
NODE_3950_length_1192_cov_23.228728	616	696	10	69	80	0.8625000
NODE_3950_length_1192_cov_23.228728	669	749	6	37	80	0.4625000
NODE_3950_length_1192_cov_23.228728	669	749	10	43	80	0.5375000
NODE_3951_length_1192_cov_18.314730	613	693	0	80	80	1.0000000
NODE_3951_length_1192_cov_18.314730	666	746	0	80	80	1.0000000
NODE_3951_length_1192_cov_18.314730	742	822	0	75	80	0.9375000
NODE_3951_length_1192_cov_18.314730	742	822	2	5	80	0.0625000
NODE_3951_length_1192_cov_18.314730	795	875	0	22	80	0.2750000
NODE_3951_length_1192_cov_18.314730	795	875	2	58	80	0.7250000
NODE_3952_length_1192_cov_14.888381	622	702	0	47	80	0.5875000
NODE_3952_length_1192_cov_14.888381	622	702	2	33	80	0.4125000
NODE_3952_length_1192_cov_14.888381	675	755	0	80	80	1.0000000
NODE_3952_length_1192_cov_14.888381	751	831	0	80	80	1.0000000
NODE_3952_length_1192_cov_14.888381	804	884	0	80	80	1.0000000
NODE_3953_length_1192_cov_9.995425	161	241	4	49	80	0.6125000
NODE_3953_length_1192_cov_9.995425	161	241	6	13	80	0.1625000
NODE_3953_length_1192_cov_9.995425	161	241	10	18	80	0.2250000
NODE_3953_length_1192_cov_9.995425	214	294	6	45	80	0.5625000
NODE_3953_length_1192_cov_9.995425	214	294	8	12	80	0.1500000
NODE_3953_length_1192_cov_9.995425	214	294	10	23	80	0.2875000
NODE_3954_length_1192_cov_5.078683	749	829	0	21	80	0.2625000
NODE_3954_length_1192_cov_5.078683	749	829	2	59	80	0.7375000
NODE_3954_length_1192_cov_5.078683	802	882	0	20	80	0.2500000
NODE_3954_length_1192_cov_5.078683	802	882	2	60	80	0.7500000
NODE_3960_length_1192_cov_0.614822	1046	1126	0	80	80	1.0000000
NODE_3961_length_1191_cov_55.466117	392	472	0	80	80	1.0000000
NODE_3961_length_1191_cov_55.466117	445	525	0	55	80	0.6875000
NODE_3961_length_1191_cov_55.466117	445	525	6	11	80	0.1375000
NODE_3961_length_1191_cov_55.466117	445	525	7	14	80	0.1750000
NODE_3961_length_1191_cov_55.466117	521	601	2	36	80	0.4500000
NODE_3961_length_1191_cov_55.466117	521	601	7	4	80	0.0500000
NODE_3961_length_1191_cov_55.466117	521	601	8	40	80	0.5000000
NODE_3961_length_1191_cov_55.466117	574	654	2	80	80	1.0000000
NODE_3963_length_1191_cov_20.677656	695	775	0	62	80	0.7750000
NODE_3963_length_1191_cov_20.677656	695	775	2	18	80	0.2250000
NODE_3963_length_1191_cov_20.677656	748	828	0	30	80	0.3750000
NODE_3963_length_1191_cov_20.677656	748	828	2	50	80	0.6250000
NODE_3964_length_1191_cov_9.074176	420	500	0	80	80	1.0000000
NODE_3964_length_1191_cov_9.074176	473	553	0	56	80	0.7000000
NODE_3964_length_1191_cov_9.074176	473	553	2	24	80	0.3000000
NODE_3968_length_1190_cov_40.916590	521	601	0	29	80	0.3625000
NODE_3968_length_1190_cov_40.916590	521	601	2	51	80	0.6375000
NODE_3968_length_1190_cov_40.916590	574	654	2	80	80	1.0000000
NODE_3968_length_1190_cov_40.916590	650	730	0	72	80	0.9000000
NODE_3968_length_1190_cov_40.916590	650	730	2	8	80	0.1000000
NODE_3968_length_1190_cov_40.916590	703	783	0	80	80	1.0000000
NODE_3969_length_1190_cov_20.715857	257	337	2	39	80	0.4875000
NODE_3969_length_1190_cov_20.715857	257	337	4	12	80	0.1500000
NODE_3969_length_1190_cov_20.715857	257	337	8	29	80	0.3625000
NODE_3969_length_1190_cov_20.715857	310	390	0	20	80	0.2500000
NODE_3969_length_1190_cov_20.715857	310	390	4	7	80	0.0875000
NODE_3969_length_1190_cov_20.715857	310	390	6	11	80	0.1375000
NODE_3969_length_1190_cov_20.715857	310	390	8	42	80	0.5250000
NODE_3970_length_1190_cov_19.724106	296	376	2	80	80	1.0000000
NODE_3970_length_1190_cov_19.724106	349	429	0	36	80	0.4500000
NODE_3970_length_1190_cov_19.724106	349	429	2	44	80	0.5500000
NODE_3973_length_1190_cov_2.698442	1022	1070	2	22	48	0.4583333
NODE_3973_length_1190_cov_2.698442	1022	1070	4	8	48	0.1666667
NODE_3973_length_1190_cov_2.698442	1022	1070	6	18	48	0.3750000
NODE_3973_length_1190_cov_2.698442	1075	1123	4	5	48	0.1041667
NODE_3973_length_1190_cov_2.698442	1075	1123	6	43	48	0.8958333
NODE_3977_length_1189_cov_29.193578	576	656	0	80	80	1.0000000
NODE_3977_length_1189_cov_29.193578	629	709	0	80	80	1.0000000
NODE_3978_length_1189_cov_13.484404	315	341	0	26	26	1.0000000
NODE_3978_length_1189_cov_13.484404	366	446	0	11	80	0.1375000
NODE_3978_length_1189_cov_13.484404	366	446	2	69	80	0.8625000
NODE_3984_length_1188_cov_19.278237	396	476	0	8	80	0.1000000
NODE_3984_length_1188_cov_19.278237	396	476	12	14	80	0.1750000
NODE_3984_length_1188_cov_19.278237	396	476	16	24	80	0.3000000
NODE_3984_length_1188_cov_19.278237	396	476	19	34	80	0.4250000
NODE_3984_length_1188_cov_19.278237	449	529	19	30	80	0.3750000
NODE_3984_length_1188_cov_19.278237	449	529	21	50	80	0.6250000
NODE_3990_length_1187_cov_63.185662	529	609	12	63	80	0.7875000
NODE_3990_length_1187_cov_63.185662	529	609	14	17	80	0.2125000
NODE_3990_length_1187_cov_63.185662	582	662	2	3	80	0.0375000
NODE_3990_length_1187_cov_63.185662	582	662	4	12	80	0.1500000
NODE_3990_length_1187_cov_63.185662	582	662	5	1	80	0.0125000
NODE_3990_length_1187_cov_63.185662	582	662	6	22	80	0.2750000
NODE_3990_length_1187_cov_63.185662	582	662	12	42	80	0.5250000
NODE_3990_length_1187_cov_63.185662	658	738	4	41	80	0.5125000
NODE_3990_length_1187_cov_63.185662	658	738	8	29	80	0.3625000
NODE_3990_length_1187_cov_63.185662	658	738	12	10	80	0.1250000
NODE_3990_length_1187_cov_63.185662	711	791	0	11	80	0.1375000
NODE_3990_length_1187_cov_63.185662	711	791	8	69	80	0.8625000
NODE_3991_length_1187_cov_36.926471	432	512	0	80	80	1.0000000
NODE_3991_length_1187_cov_36.926471	485	565	0	80	80	1.0000000
NODE_3991_length_1187_cov_36.926471	561	641	0	80	80	1.0000000
NODE_3991_length_1187_cov_36.926471	614	694	0	80	80	1.0000000
NODE_3992_length_1187_cov_20.383272	492	572	0	80	80	1.0000000
NODE_3992_length_1187_cov_20.383272	545	625	0	78	80	0.9750000
NODE_3992_length_1187_cov_20.383272	545	625	2	2	80	0.0250000
NODE_3993_length_1187_cov_17.941176	377	457	0	80	80	1.0000000
NODE_3993_length_1187_cov_17.941176	430	510	0	80	80	1.0000000
NODE_3993_length_1187_cov_17.941176	506	586	0	80	80	1.0000000
NODE_3993_length_1187_cov_17.941176	559	639	0	80	80	1.0000000
NODE_3997_length_1186_cov_59.606256	338	418	0	80	80	1.0000000
NODE_3997_length_1186_cov_59.606256	391	471	0	80	80	1.0000000
NODE_3997_length_1186_cov_59.606256	480	551	0	71	71	1.0000000
NODE_3997_length_1186_cov_59.606256	524	604	0	80	80	1.0000000
NODE_3998_length_1186_cov_34.937443	582	662	0	17	80	0.2125000
NODE_3998_length_1186_cov_34.937443	582	662	2	63	80	0.7875000
NODE_3998_length_1186_cov_34.937443	635	715	0	48	80	0.6000000
NODE_3998_length_1186_cov_34.937443	635	715	2	32	80	0.4000000
NODE_3998_length_1186_cov_34.937443	711	791	2	4	80	0.0500000
NODE_3998_length_1186_cov_34.937443	711	791	8	20	80	0.2500000
NODE_3998_length_1186_cov_34.937443	711	791	14	56	80	0.7000000
NODE_3998_length_1186_cov_34.937443	764	844	12	49	80	0.6125000
NODE_3998_length_1186_cov_34.937443	764	844	14	31	80	0.3875000
NODE_3999_length_1186_cov_29.840846	511	591	0	80	80	1.0000000
NODE_3999_length_1186_cov_29.840846	564	644	0	80	80	1.0000000
NODE_3999_length_1186_cov_29.840846	640	720	0	80	80	1.0000000
NODE_3999_length_1186_cov_29.840846	693	773	0	80	80	1.0000000
NODE_4000_length_1186_cov_13.108556	578	658	0	11	80	0.1375000
NODE_4000_length_1186_cov_13.108556	578	658	2	69	80	0.8625000
NODE_4000_length_1186_cov_13.108556	631	711	2	80	80	1.0000000
NODE_4001_length_1186_cov_12.867525	404	484	0	58	80	0.7250000
NODE_4001_length_1186_cov_12.867525	404	484	2	4	80	0.0500000
NODE_4001_length_1186_cov_12.867525	404	484	4	18	80	0.2250000
NODE_4001_length_1186_cov_12.867525	457	534	0	77	77	1.0000000
NODE_4001_length_1186_cov_12.867525	536	613	0	77	77	1.0000000
NODE_4001_length_1186_cov_12.867525	586	666	0	80	80	1.0000000
NODE_4002_length_1186_cov_12.135235	643	723	0	14	80	0.1750000
NODE_4002_length_1186_cov_12.135235	643	723	2	66	80	0.8250000
NODE_4002_length_1186_cov_12.135235	696	776	0	20	80	0.2500000
NODE_4002_length_1186_cov_12.135235	696	776	2	60	80	0.7500000
NODE_4012_length_1185_cov_36.974217	423	503	0	18	80	0.2250000
NODE_4012_length_1185_cov_36.974217	423	503	2	40	80	0.5000000
NODE_4012_length_1185_cov_36.974217	423	503	4	22	80	0.2750000
NODE_4012_length_1185_cov_36.974217	476	556	0	5	80	0.0625000
NODE_4012_length_1185_cov_36.974217	476	556	4	75	80	0.9375000
NODE_4013_length_1185_cov_28.410681	448	528	0	80	80	1.0000000
NODE_4013_length_1185_cov_28.410681	501	581	0	80	80	1.0000000
NODE_4014_length_1185_cov_19.768877	411	491	0	17	80	0.2125000
NODE_4014_length_1185_cov_19.768877	411	491	2	63	80	0.7875000
NODE_4014_length_1185_cov_19.768877	464	544	0	14	80	0.1750000
NODE_4014_length_1185_cov_19.768877	464	544	2	66	80	0.8250000
NODE_4014_length_1185_cov_19.768877	540	620	0	80	80	1.0000000
NODE_4014_length_1185_cov_19.768877	593	673	0	80	80	1.0000000
NODE_4015_length_1185_cov_14.490792	379	459	0	2	80	0.0250000
NODE_4015_length_1185_cov_14.490792	379	459	2	6	80	0.0750000
NODE_4015_length_1185_cov_14.490792	379	459	4	8	80	0.1000000
NODE_4015_length_1185_cov_14.490792	379	459	6	64	80	0.8000000
NODE_4015_length_1185_cov_14.490792	432	512	0	55	80	0.6875000
NODE_4015_length_1185_cov_14.490792	432	512	4	8	80	0.1000000
NODE_4015_length_1185_cov_14.490792	432	512	6	17	80	0.2125000
NODE_4016_length_1185_cov_13.686004	677	757	0	80	80	1.0000000
NODE_4016_length_1185_cov_13.686004	730	810	0	80	80	1.0000000
NODE_4017_length_1185_cov_12.362799	711	791	0	57	80	0.7125000
NODE_4017_length_1185_cov_12.362799	711	791	4	6	80	0.0750000
NODE_4017_length_1185_cov_12.362799	711	791	8	17	80	0.2125000
NODE_4017_length_1185_cov_12.362799	764	844	0	80	80	1.0000000
NODE_4024_length_1184_cov_30.061751	416	497	0	81	81	1.0000000
NODE_4024_length_1184_cov_30.061751	470	550	0	80	80	1.0000000
NODE_4024_length_1184_cov_30.061751	546	627	0	81	81	1.0000000
NODE_4024_length_1184_cov_30.061751	600	680	0	80	80	1.0000000
NODE_4025_length_1184_cov_19.544700	550	630	0	80	80	1.0000000
NODE_4025_length_1184_cov_19.544700	603	683	0	80	80	1.0000000
NODE_4025_length_1184_cov_19.544700	679	759	0	11	80	0.1375000
NODE_4025_length_1184_cov_19.544700	679	759	10	69	80	0.8625000
NODE_4025_length_1184_cov_19.544700	732	812	9	32	80	0.4000000
NODE_4025_length_1184_cov_19.544700	732	812	10	48	80	0.6000000
NODE_4026_length_1184_cov_9.129954	624	704	0	34	80	0.4250000
NODE_4026_length_1184_cov_9.129954	624	704	2	25	80	0.3125000
NODE_4026_length_1184_cov_9.129954	624	704	4	21	80	0.2625000
NODE_4026_length_1184_cov_9.129954	677	757	0	4	80	0.0500000
NODE_4026_length_1184_cov_9.129954	677	757	2	10	80	0.1250000
NODE_4026_length_1184_cov_9.129954	677	757	4	66	80	0.8250000
NODE_4031_length_1183_cov_17.260148	545	625	0	80	80	1.0000000
NODE_4031_length_1183_cov_17.260148	598	678	0	80	80	1.0000000
NODE_4031_length_1183_cov_17.260148	674	754	0	53	80	0.6625000
NODE_4031_length_1183_cov_17.260148	674	754	2	27	80	0.3375000
NODE_4031_length_1183_cov_17.260148	727	807	0	3	80	0.0375000
NODE_4031_length_1183_cov_17.260148	727	807	2	77	80	0.9625000
NODE_4032_length_1183_cov_9.777675	484	564	0	80	80	1.0000000
NODE_4032_length_1183_cov_9.777675	537	617	0	80	80	1.0000000
NODE_4033_length_1183_cov_6.847786	711	791	8	80	80	1.0000000
NODE_4033_length_1183_cov_6.847786	764	844	0	23	80	0.2875000
NODE_4033_length_1183_cov_6.847786	764	844	8	57	80	0.7125000
NODE_4033_length_1183_cov_6.847786	840	920	0	80	80	1.0000000
NODE_4033_length_1183_cov_6.847786	893	973	0	59	80	0.7375000
NODE_4033_length_1183_cov_6.847786	893	973	2	21	80	0.2625000
NODE_4035_length_1183_cov_2.680812	59	139	6	6	80	0.0750000
NODE_4035_length_1183_cov_2.680812	59	139	10	6	80	0.0750000
NODE_4035_length_1183_cov_2.680812	59	139	12	5	80	0.0625000
NODE_4035_length_1183_cov_2.680812	59	139	18	9	80	0.1125000
NODE_4035_length_1183_cov_2.680812	59	139	20	4	80	0.0500000
NODE_4035_length_1183_cov_2.680812	59	139	22	50	80	0.6250000
NODE_4040_length_1182_cov_64.600185	588	668	0	6	80	0.0750000
NODE_4040_length_1182_cov_64.600185	588	668	4	74	80	0.9250000
NODE_4040_length_1182_cov_64.600185	641	721	0	33	80	0.4125000
NODE_4040_length_1182_cov_64.600185	641	721	2	10	80	0.1250000
NODE_4040_length_1182_cov_64.600185	641	721	4	37	80	0.4625000
NODE_4040_length_1182_cov_64.600185	717	797	2	36	80	0.4500000
NODE_4040_length_1182_cov_64.600185	717	797	15	1	80	0.0125000
NODE_4040_length_1182_cov_64.600185	717	797	16	43	80	0.5375000
NODE_4040_length_1182_cov_64.600185	770	849	14	35	79	0.4430380
NODE_4040_length_1182_cov_64.600185	770	849	16	44	79	0.5569620
NODE_4041_length_1182_cov_18.584488	487	557	0	70	70	1.0000000
NODE_4041_length_1182_cov_18.584488	536	612	0	61	76	0.8026316
NODE_4041_length_1182_cov_18.584488	536	612	4	15	76	0.1973684
NODE_4041_length_1182_cov_18.584488	608	688	4	80	80	1.0000000
NODE_4041_length_1182_cov_18.584488	671	741	2	3	70	0.0428571
NODE_4041_length_1182_cov_18.584488	671	741	4	59	70	0.8428571
NODE_4041_length_1182_cov_18.584488	671	741	6	8	70	0.1142857
NODE_4042_length_1182_cov_18.075716	598	678	0	80	80	1.0000000
NODE_4042_length_1182_cov_18.075716	651	731	0	80	80	1.0000000
NODE_4042_length_1182_cov_18.075716	727	807	0	80	80	1.0000000
NODE_4042_length_1182_cov_18.075716	780	860	0	80	80	1.0000000
NODE_4043_length_1182_cov_8.716528	464	544	0	80	80	1.0000000
NODE_4043_length_1182_cov_8.716528	517	597	0	80	80	1.0000000
NODE_4044_length_1182_cov_4.109880	793	873	0	13	80	0.1625000
NODE_4044_length_1182_cov_4.109880	793	873	4	67	80	0.8375000
NODE_4044_length_1182_cov_4.109880	846	926	0	66	80	0.8250000
NODE_4044_length_1182_cov_4.109880	846	926	4	14	80	0.1750000
NODE_4045_length_1182_cov_3.433980	1052	1100	0	48	48	1.0000000
NODE_4050_length_1181_cov_13.856747	687	767	0	80	80	1.0000000
NODE_4050_length_1181_cov_13.856747	740	820	0	80	80	1.0000000
NODE_4051_length_1181_cov_8.239372	735	815	0	80	80	1.0000000
NODE_4059_length_1180_cov_46.345051	695	775	14	80	80	1.0000000
NODE_4059_length_1180_cov_46.345051	748	828	14	80	80	1.0000000
NODE_4066_length_1179_cov_93.272222	660	740	94	1	80	0.0125000
NODE_4066_length_1179_cov_93.272222	660	740	97	5	80	0.0625000
NODE_4066_length_1179_cov_93.272222	660	740	98	8	80	0.1000000
NODE_4066_length_1179_cov_93.272222	660	740	101	4	80	0.0500000
NODE_4066_length_1179_cov_93.272222	660	740	103	1	80	0.0125000
NODE_4066_length_1179_cov_93.272222	660	740	105	8	80	0.1000000
NODE_4066_length_1179_cov_93.272222	660	740	106	3	80	0.0375000
NODE_4066_length_1179_cov_93.272222	660	740	107	1	80	0.0125000
NODE_4066_length_1179_cov_93.272222	660	740	113	1	80	0.0125000
NODE_4066_length_1179_cov_93.272222	660	740	116	2	80	0.0250000
NODE_4066_length_1179_cov_93.272222	660	740	118	1	80	0.0125000
NODE_4066_length_1179_cov_93.272222	660	740	121	1	80	0.0125000
NODE_4066_length_1179_cov_93.272222	660	740	123	1	80	0.0125000
NODE_4066_length_1179_cov_93.272222	660	740	124	4	80	0.0500000
NODE_4066_length_1179_cov_93.272222	660	740	125	1	80	0.0125000
NODE_4066_length_1179_cov_93.272222	660	740	126	3	80	0.0375000
NODE_4066_length_1179_cov_93.272222	660	740	127	6	80	0.0750000
NODE_4066_length_1179_cov_93.272222	660	740	128	6	80	0.0750000
NODE_4066_length_1179_cov_93.272222	660	740	129	1	80	0.0125000
NODE_4066_length_1179_cov_93.272222	660	740	130	8	80	0.1000000
NODE_4066_length_1179_cov_93.272222	660	740	131	6	80	0.0750000
NODE_4066_length_1179_cov_93.272222	660	740	132	4	80	0.0500000
NODE_4066_length_1179_cov_93.272222	660	740	133	4	80	0.0500000
NODE_4066_length_1179_cov_93.272222	713	793	39	1	80	0.0125000
NODE_4066_length_1179_cov_93.272222	713	793	41	1	80	0.0125000
NODE_4066_length_1179_cov_93.272222	713	793	43	2	80	0.0250000
NODE_4066_length_1179_cov_93.272222	713	793	47	1	80	0.0125000
NODE_4066_length_1179_cov_93.272222	713	793	51	2	80	0.0250000
NODE_4066_length_1179_cov_93.272222	713	793	58	5	80	0.0625000
NODE_4066_length_1179_cov_93.272222	713	793	59	2	80	0.0250000
NODE_4066_length_1179_cov_93.272222	713	793	60	1	80	0.0125000
NODE_4066_length_1179_cov_93.272222	713	793	61	1	80	0.0125000
NODE_4066_length_1179_cov_93.272222	713	793	67	1	80	0.0125000
NODE_4066_length_1179_cov_93.272222	713	793	68	3	80	0.0375000
NODE_4066_length_1179_cov_93.272222	713	793	70	1	80	0.0125000
NODE_4066_length_1179_cov_93.272222	713	793	73	3	80	0.0375000
NODE_4066_length_1179_cov_93.272222	713	793	74	1	80	0.0125000
NODE_4066_length_1179_cov_93.272222	713	793	77	6	80	0.0750000
NODE_4066_length_1179_cov_93.272222	713	793	78	1	80	0.0125000
NODE_4066_length_1179_cov_93.272222	713	793	80	3	80	0.0375000
NODE_4066_length_1179_cov_93.272222	713	793	81	3	80	0.0375000
NODE_4066_length_1179_cov_93.272222	713	793	83	1	80	0.0125000
NODE_4066_length_1179_cov_93.272222	713	793	84	1	80	0.0125000
NODE_4066_length_1179_cov_93.272222	713	793	86	1	80	0.0125000
NODE_4066_length_1179_cov_93.272222	713	793	88	2	80	0.0250000
NODE_4066_length_1179_cov_93.272222	713	793	89	1	80	0.0125000
NODE_4066_length_1179_cov_93.272222	713	793	91	3	80	0.0375000
NODE_4066_length_1179_cov_93.272222	713	793	92	1	80	0.0125000
NODE_4066_length_1179_cov_93.272222	713	793	93	2	80	0.0250000
NODE_4066_length_1179_cov_93.272222	713	793	94	3	80	0.0375000
NODE_4066_length_1179_cov_93.272222	713	793	95	1	80	0.0125000
NODE_4066_length_1179_cov_93.272222	713	793	97	5	80	0.0625000
NODE_4066_length_1179_cov_93.272222	713	793	98	8	80	0.1000000
NODE_4066_length_1179_cov_93.272222	713	793	101	4	80	0.0500000
NODE_4066_length_1179_cov_93.272222	713	793	103	1	80	0.0125000
NODE_4066_length_1179_cov_93.272222	713	793	105	8	80	0.1000000
NODE_4067_length_1179_cov_55.355556	547	627	2	32	80	0.4000000
NODE_4067_length_1179_cov_55.355556	547	627	8	48	80	0.6000000
NODE_4067_length_1179_cov_55.355556	600	680	2	16	80	0.2000000
NODE_4067_length_1179_cov_55.355556	600	680	8	43	80	0.5375000
NODE_4067_length_1179_cov_55.355556	600	680	10	21	80	0.2625000
NODE_4068_length_1179_cov_29.712037	613	693	0	80	80	1.0000000
NODE_4068_length_1179_cov_29.712037	666	746	0	80	80	1.0000000
NODE_4069_length_1179_cov_26.767593	483	563	0	27	80	0.3375000
NODE_4069_length_1179_cov_26.767593	483	563	6	53	80	0.6625000
NODE_4069_length_1179_cov_26.767593	536	616	6	80	80	1.0000000
NODE_4069_length_1179_cov_26.767593	612	692	0	34	80	0.4250000
NODE_4069_length_1179_cov_26.767593	612	692	6	46	80	0.5750000
NODE_4069_length_1179_cov_26.767593	665	745	0	80	80	1.0000000
NODE_4070_length_1179_cov_22.249074	581	661	0	79	80	0.9875000
NODE_4070_length_1179_cov_22.249074	581	661	2	1	80	0.0125000
NODE_4070_length_1179_cov_22.249074	634	714	0	80	80	1.0000000
NODE_4071_length_1179_cov_16.538889	498	568	13	30	70	0.4285714
NODE_4071_length_1179_cov_16.538889	498	568	14	13	70	0.1857143
NODE_4071_length_1179_cov_16.538889	498	568	16	27	70	0.3857143
NODE_4072_length_1179_cov_15.442593	535	615	2	15	80	0.1875000
NODE_4072_length_1179_cov_15.442593	535	615	4	34	80	0.4250000
NODE_4072_length_1179_cov_15.442593	535	615	6	31	80	0.3875000
NODE_4072_length_1179_cov_15.442593	588	668	2	68	80	0.8500000
NODE_4072_length_1179_cov_15.442593	588	668	6	12	80	0.1500000
NODE_4076_length_1179_cov_2.419444	1108	1155	0	47	47	1.0000000
NODE_4078_length_1179_cov_1.009259	944	1024	0	80	80	1.0000000
NODE_4078_length_1179_cov_1.009259	997	1077	0	80	80	1.0000000
NODE_4079_length_1178_cov_42.484708	423	503	0	80	80	1.0000000
NODE_4079_length_1178_cov_42.484708	476	556	0	80	80	1.0000000
NODE_4079_length_1178_cov_42.484708	552	632	0	80	80	1.0000000
NODE_4079_length_1178_cov_42.484708	605	685	0	56	80	0.7000000
NODE_4079_length_1178_cov_42.484708	605	685	2	24	80	0.3000000
NODE_4080_length_1178_cov_15.332715	215	295	0	80	80	1.0000000
NODE_4080_length_1178_cov_15.332715	268	348	0	80	80	1.0000000
NODE_4081_length_1178_cov_11.403151	527	607	0	80	80	1.0000000
NODE_4081_length_1178_cov_11.403151	580	660	0	80	80	1.0000000
NODE_4084_length_1177_cov_34.920223	369	449	0	80	80	1.0000000
NODE_4084_length_1177_cov_34.920223	422	502	0	80	80	1.0000000
NODE_4084_length_1177_cov_34.920223	498	578	0	62	80	0.7750000
NODE_4084_length_1177_cov_34.920223	498	578	8	18	80	0.2250000
NODE_4084_length_1177_cov_34.920223	551	631	0	9	80	0.1125000
NODE_4084_length_1177_cov_34.920223	551	631	8	71	80	0.8875000
NODE_4085_length_1177_cov_12.186456	481	561	0	80	80	1.0000000
NODE_4085_length_1177_cov_12.186456	534	614	0	77	80	0.9625000
NODE_4085_length_1177_cov_12.186456	534	614	2	3	80	0.0375000
NODE_4085_length_1177_cov_12.186456	610	690	0	1	80	0.0125000
NODE_4085_length_1177_cov_12.186456	610	690	2	79	80	0.9875000
NODE_4085_length_1177_cov_12.186456	663	743	0	23	80	0.2875000
NODE_4085_length_1177_cov_12.186456	663	743	2	57	80	0.7125000
NODE_4086_length_1177_cov_11.926716	443	523	0	80	80	1.0000000
NODE_4086_length_1177_cov_11.926716	496	578	0	82	82	1.0000000
NODE_4088_length_1177_cov_5.923933	358	438	0	80	80	1.0000000
NODE_4088_length_1177_cov_5.923933	411	491	0	80	80	1.0000000
NODE_4089_length_1177_cov_5.775510	760	840	0	80	80	1.0000000
NODE_4089_length_1177_cov_5.775510	813	893	0	80	80	1.0000000
NODE_4096_length_1176_cov_26.994429	377	457	0	4	80	0.0500000
NODE_4096_length_1176_cov_26.994429	377	457	2	52	80	0.6500000
NODE_4096_length_1176_cov_26.994429	377	457	4	24	80	0.3000000
NODE_4096_length_1176_cov_26.994429	430	510	0	57	80	0.7125000
NODE_4096_length_1176_cov_26.994429	430	510	2	23	80	0.2875000
NODE_4096_length_1176_cov_26.994429	506	586	0	80	80	1.0000000
NODE_4096_length_1176_cov_26.994429	559	639	0	51	80	0.6375000
NODE_4096_length_1176_cov_26.994429	559	639	2	29	80	0.3625000
NODE_4097_length_1176_cov_15.766945	531	611	2	50	80	0.6250000
NODE_4097_length_1176_cov_15.766945	531	611	7	30	80	0.3750000
NODE_4097_length_1176_cov_15.766945	584	664	0	43	80	0.5375000
NODE_4097_length_1176_cov_15.766945	584	664	2	37	80	0.4625000
NODE_4098_length_1176_cov_14.882080	628	708	0	80	80	1.0000000
NODE_4098_length_1176_cov_14.882080	681	761	0	80	80	1.0000000
NODE_4099_length_1176_cov_10.692665	392	472	0	2	80	0.0250000
NODE_4099_length_1176_cov_10.692665	392	472	5	1	80	0.0125000
NODE_4099_length_1176_cov_10.692665	392	472	6	4	80	0.0500000
NODE_4099_length_1176_cov_10.692665	392	472	12	73	80	0.9125000
NODE_4099_length_1176_cov_10.692665	445	525	0	34	80	0.4250000
NODE_4099_length_1176_cov_10.692665	445	525	6	6	80	0.0750000
NODE_4099_length_1176_cov_10.692665	445	525	11	1	80	0.0125000
NODE_4099_length_1176_cov_10.692665	445	525	12	39	80	0.4875000
NODE_4106_length_1175_cov_50.754647	526	606	0	80	80	1.0000000
NODE_4106_length_1175_cov_50.754647	579	659	0	34	80	0.4250000
NODE_4106_length_1175_cov_50.754647	579	659	2	46	80	0.5750000
NODE_4107_length_1175_cov_42.638476	327	407	2	80	80	1.0000000
NODE_4107_length_1175_cov_42.638476	380	460	0	38	80	0.4750000
NODE_4107_length_1175_cov_42.638476	380	460	2	42	80	0.5250000
NODE_4107_length_1175_cov_42.638476	456	536	0	80	80	1.0000000
NODE_4107_length_1175_cov_42.638476	509	589	0	80	80	1.0000000
NODE_4108_length_1175_cov_40.217472	437	517	0	79	80	0.9875000
NODE_4108_length_1175_cov_40.217472	437	517	2	1	80	0.0125000
NODE_4108_length_1175_cov_40.217472	490	570	0	26	80	0.3250000
NODE_4108_length_1175_cov_40.217472	490	570	2	54	80	0.6750000
NODE_4108_length_1175_cov_40.217472	566	646	0	40	80	0.5000000
NODE_4108_length_1175_cov_40.217472	566	646	2	40	80	0.5000000
NODE_4108_length_1175_cov_40.217472	619	699	0	80	80	1.0000000
NODE_4109_length_1175_cov_12.834572	775	855	0	15	80	0.1875000
NODE_4109_length_1175_cov_12.834572	775	855	2	65	80	0.8125000
NODE_4109_length_1175_cov_12.834572	828	908	0	68	80	0.8500000
NODE_4109_length_1175_cov_12.834572	828	908	2	12	80	0.1500000
NODE_4115_length_1174_cov_20.569302	433	513	0	80	80	1.0000000
NODE_4115_length_1174_cov_20.569302	486	566	0	80	80	1.0000000
NODE_4115_length_1174_cov_20.569302	562	642	0	12	80	0.1500000
NODE_4115_length_1174_cov_20.569302	562	642	3	1	80	0.0125000
NODE_4115_length_1174_cov_20.569302	562	642	4	67	80	0.8375000
NODE_4115_length_1174_cov_20.569302	615	695	0	32	80	0.4000000
NODE_4115_length_1174_cov_20.569302	615	695	4	48	80	0.6000000
NODE_4116_length_1174_cov_18.797209	578	658	12	68	80	0.8500000
NODE_4116_length_1174_cov_18.797209	578	658	14	12	80	0.1500000
NODE_4116_length_1174_cov_18.797209	631	711	2	31	80	0.3875000
NODE_4116_length_1174_cov_18.797209	631	711	8	20	80	0.2500000
NODE_4116_length_1174_cov_18.797209	631	711	12	15	80	0.1875000
NODE_4116_length_1174_cov_18.797209	631	711	13	1	80	0.0125000
NODE_4116_length_1174_cov_18.797209	631	711	14	13	80	0.1625000
NODE_4117_length_1174_cov_17.486512	589	669	0	37	80	0.4625000
NODE_4117_length_1174_cov_17.486512	589	669	2	43	80	0.5375000
NODE_4117_length_1174_cov_17.486512	642	722	0	12	80	0.1500000
NODE_4117_length_1174_cov_17.486512	642	722	2	68	80	0.8500000
NODE_4118_length_1174_cov_15.888372	570	650	0	43	80	0.5375000
NODE_4118_length_1174_cov_15.888372	570	650	4	37	80	0.4625000
NODE_4118_length_1174_cov_15.888372	623	703	0	13	80	0.1625000
NODE_4118_length_1174_cov_15.888372	623	703	3	1	80	0.0125000
NODE_4118_length_1174_cov_15.888372	623	703	4	66	80	0.8250000
NODE_4118_length_1174_cov_15.888372	699	779	0	80	80	1.0000000
NODE_4118_length_1174_cov_15.888372	752	832	0	80	80	1.0000000
NODE_4124_length_1174_cov_1.536744	1066	1115	0	42	49	0.8571429
NODE_4124_length_1174_cov_1.536744	1066	1115	2	7	49	0.1428571
NODE_4124_length_1174_cov_1.536744	1088	1168	0	80	80	1.0000000
NODE_4128_length_1173_cov_29.562384	455	535	0	37	80	0.4625000
NODE_4128_length_1173_cov_29.562384	455	535	2	43	80	0.5375000
NODE_4128_length_1173_cov_29.562384	508	588	2	80	80	1.0000000
NODE_4128_length_1173_cov_29.562384	584	664	0	50	80	0.6250000
NODE_4128_length_1173_cov_29.562384	584	664	2	30	80	0.3750000
NODE_4128_length_1173_cov_29.562384	637	717	0	80	80	1.0000000
NODE_4129_length_1173_cov_25.206704	395	475	0	80	80	1.0000000
NODE_4129_length_1173_cov_25.206704	448	528	0	80	80	1.0000000
NODE_4130_length_1173_cov_9.486965	693	773	0	13	80	0.1625000
NODE_4130_length_1173_cov_9.486965	693	773	2	67	80	0.8375000
NODE_4130_length_1173_cov_9.486965	746	826	0	66	80	0.8250000
NODE_4130_length_1173_cov_9.486965	746	826	2	14	80	0.1750000
NODE_4131_length_1173_cov_7.946927	201	281	0	80	80	1.0000000
NODE_4131_length_1173_cov_7.946927	254	334	0	80	80	1.0000000
NODE_4136_length_1172_cov_37.177074	527	607	0	80	80	1.0000000
NODE_4136_length_1172_cov_37.177074	580	660	0	80	80	1.0000000
NODE_4137_length_1172_cov_20.397018	677	757	0	80	80	1.0000000
NODE_4137_length_1172_cov_20.397018	730	810	0	80	80	1.0000000
NODE_4138_length_1172_cov_15.018639	460	540	0	34	80	0.4250000
NODE_4138_length_1172_cov_15.018639	460	540	2	46	80	0.5750000
NODE_4138_length_1172_cov_15.018639	513	593	0	35	80	0.4375000
NODE_4138_length_1172_cov_15.018639	513	593	2	45	80	0.5625000
NODE_4139_length_1172_cov_13.199441	622	702	2	80	80	1.0000000
NODE_4139_length_1172_cov_13.199441	675	755	0	30	80	0.3750000
NODE_4139_length_1172_cov_13.199441	675	755	2	50	80	0.6250000
NODE_4140_length_1172_cov_10.720410	499	579	0	80	80	1.0000000
NODE_4140_length_1172_cov_10.720410	552	632	0	80	80	1.0000000
NODE_4140_length_1172_cov_10.720410	628	708	0	80	80	1.0000000
NODE_4140_length_1172_cov_10.720410	681	761	0	80	80	1.0000000
NODE_4141_length_1172_cov_10.574091	951	1021	10	14	70	0.2000000
NODE_4141_length_1172_cov_10.574091	951	1021	12	5	70	0.0714286
NODE_4141_length_1172_cov_10.574091	951	1021	14	4	70	0.0571429
NODE_4141_length_1172_cov_10.574091	951	1021	16	23	70	0.3285714
NODE_4141_length_1172_cov_10.574091	951	1021	20	7	70	0.1000000
NODE_4141_length_1172_cov_10.574091	951	1021	22	17	70	0.2428571
NODE_4142_length_1172_cov_9.204101	276	356	0	80	80	1.0000000
NODE_4142_length_1172_cov_9.204101	329	409	0	80	80	1.0000000
NODE_4148_length_1171_cov_13.311567	666	746	0	80	80	1.0000000
NODE_4148_length_1171_cov_13.311567	719	803	0	84	84	1.0000000
NODE_4149_length_1171_cov_9.154851	198	278	0	80	80	1.0000000
NODE_4149_length_1171_cov_9.154851	251	331	0	80	80	1.0000000
NODE_4157_length_1170_cov_65.480859	402	482	0	26	80	0.3250000
NODE_4157_length_1170_cov_65.480859	402	482	1	3	80	0.0375000
NODE_4157_length_1170_cov_65.480859	402	482	2	51	80	0.6375000
NODE_4157_length_1170_cov_65.480859	455	535	0	79	80	0.9875000
NODE_4157_length_1170_cov_65.480859	455	535	1	1	80	0.0125000
NODE_4158_length_1170_cov_35.283847	704	784	0	72	80	0.9000000
NODE_4158_length_1170_cov_35.283847	704	784	2	8	80	0.1000000
NODE_4158_length_1170_cov_35.283847	757	837	0	80	80	1.0000000
NODE_4159_length_1170_cov_23.600373	450	530	0	78	80	0.9750000
NODE_4159_length_1170_cov_23.600373	450	530	1	2	80	0.0250000
NODE_4159_length_1170_cov_23.600373	503	583	0	25	80	0.3125000
NODE_4159_length_1170_cov_23.600373	503	583	1	26	80	0.3250000
NODE_4159_length_1170_cov_23.600373	503	583	2	29	80	0.3625000
NODE_4159_length_1170_cov_23.600373	579	659	2	80	80	1.0000000
NODE_4159_length_1170_cov_23.600373	632	705	0	4	73	0.0547945
NODE_4159_length_1170_cov_23.600373	632	705	1	26	73	0.3561644
NODE_4159_length_1170_cov_23.600373	632	705	2	43	73	0.5890411
NODE_4160_length_1170_cov_19.783380	325	405	0	80	80	1.0000000
NODE_4160_length_1170_cov_19.783380	378	458	0	80	80	1.0000000
NODE_4168_length_1169_cov_61.689720	464	544	0	18	80	0.2250000
NODE_4168_length_1169_cov_61.689720	464	544	2	62	80	0.7750000
NODE_4168_length_1169_cov_61.689720	517	597	0	6	80	0.0750000
NODE_4168_length_1169_cov_61.689720	517	597	2	74	80	0.9250000
NODE_4168_length_1169_cov_61.689720	593	673	2	6	80	0.0750000
NODE_4168_length_1169_cov_61.689720	593	673	5	36	80	0.4500000
NODE_4168_length_1169_cov_61.689720	593	673	6	26	80	0.3250000
NODE_4168_length_1169_cov_61.689720	593	673	7	12	80	0.1500000
NODE_4168_length_1169_cov_61.689720	646	726	0	23	80	0.2875000
NODE_4168_length_1169_cov_61.689720	646	726	5	2	80	0.0250000
NODE_4168_length_1169_cov_61.689720	646	726	6	55	80	0.6875000
NODE_4169_length_1169_cov_55.247664	640	720	0	28	80	0.3500000
NODE_4169_length_1169_cov_55.247664	640	720	2	52	80	0.6500000
NODE_4169_length_1169_cov_55.247664	693	773	0	15	80	0.1875000
NODE_4169_length_1169_cov_55.247664	693	773	2	65	80	0.8125000
NODE_4170_length_1169_cov_39.016822	447	527	0	80	80	1.0000000
NODE_4170_length_1169_cov_39.016822	500	580	0	80	80	1.0000000
NODE_4170_length_1169_cov_39.016822	576	656	0	80	80	1.0000000
NODE_4170_length_1169_cov_39.016822	629	709	0	80	80	1.0000000
NODE_4171_length_1169_cov_35.383178	582	662	0	80	80	1.0000000
NODE_4171_length_1169_cov_35.383178	635	715	0	29	80	0.3625000
NODE_4171_length_1169_cov_35.383178	635	715	2	51	80	0.6375000
NODE_4173_length_1169_cov_12.010280	338	418	0	80	80	1.0000000
NODE_4173_length_1169_cov_12.010280	391	471	0	80	80	1.0000000
NODE_4175_length_1169_cov_4.172897	74	135	0	61	61	1.0000000
NODE_4175_length_1169_cov_4.172897	74	135	0	61	61	1.0000000
NODE_4175_length_1169_cov_4.172897	74	135	0	61	61	1.0000000
NODE_4183_length_1168_cov_27.350795	517	597	6	80	80	1.0000000
NODE_4183_length_1168_cov_27.350795	570	650	6	80	80	1.0000000
NODE_4183_length_1168_cov_27.350795	646	726	0	74	80	0.9250000
NODE_4183_length_1168_cov_27.350795	646	726	6	6	80	0.0750000
NODE_4183_length_1168_cov_27.350795	699	779	0	80	80	1.0000000
NODE_4184_length_1168_cov_25.777362	672	752	6	17	80	0.2125000
NODE_4184_length_1168_cov_25.777362	672	752	10	34	80	0.4250000
NODE_4184_length_1168_cov_25.777362	672	752	12	29	80	0.3625000
NODE_4184_length_1168_cov_25.777362	725	805	0	18	80	0.2250000
NODE_4184_length_1168_cov_25.777362	725	805	6	10	80	0.1250000
NODE_4184_length_1168_cov_25.777362	725	805	8	19	80	0.2375000
NODE_4184_length_1168_cov_25.777362	725	805	12	33	80	0.4125000
NODE_4185_length_1168_cov_25.295603	543	623	0	80	80	1.0000000
NODE_4185_length_1168_cov_25.295603	596	676	0	80	80	1.0000000
NODE_4185_length_1168_cov_25.295603	672	752	0	16	80	0.2000000
NODE_4185_length_1168_cov_25.295603	672	752	2	64	80	0.8000000
NODE_4185_length_1168_cov_25.295603	725	804	2	79	79	1.0000000
NODE_4186_length_1168_cov_20.202058	434	514	0	6	80	0.0750000
NODE_4186_length_1168_cov_20.202058	434	514	2	74	80	0.9250000
NODE_4186_length_1168_cov_20.202058	487	567	0	53	80	0.6625000
NODE_4186_length_1168_cov_20.202058	487	567	2	27	80	0.3375000
NODE_4187_length_1168_cov_16.787652	405	485	0	12	80	0.1500000
NODE_4187_length_1168_cov_16.787652	405	485	2	68	80	0.8500000
NODE_4187_length_1168_cov_16.787652	458	538	0	65	80	0.8125000
NODE_4187_length_1168_cov_16.787652	458	538	2	15	80	0.1875000
NODE_4188_length_1168_cov_10.079514	722	802	0	17	80	0.2125000
NODE_4188_length_1168_cov_10.079514	722	802	4	63	80	0.7875000
NODE_4188_length_1168_cov_10.079514	775	855	0	47	80	0.5875000
NODE_4188_length_1168_cov_10.079514	775	855	4	33	80	0.4125000
NODE_4198_length_1167_cov_27.961610	591	671	4	19	80	0.2375000
NODE_4198_length_1167_cov_27.961610	591	671	6	61	80	0.7625000
NODE_4198_length_1167_cov_27.961610	644	724	0	29	80	0.3625000
NODE_4198_length_1167_cov_27.961610	644	724	4	43	80	0.5375000
NODE_4198_length_1167_cov_27.961610	644	724	6	8	80	0.1000000
NODE_4199_length_1167_cov_12.393258	670	750	0	80	80	1.0000000
NODE_4199_length_1167_cov_12.393258	723	803	0	80	80	1.0000000
NODE_4200_length_1167_cov_11.189139	434	514	0	80	80	1.0000000
NODE_4200_length_1167_cov_11.189139	487	567	0	80	80	1.0000000
NODE_4201_length_1167_cov_7.998127	711	791	0	75	80	0.9375000
NODE_4201_length_1167_cov_7.998127	711	791	1	5	80	0.0625000
NODE_4201_length_1167_cov_7.998127	764	844	0	22	80	0.2750000
NODE_4201_length_1167_cov_7.998127	764	844	1	13	80	0.1625000
NODE_4201_length_1167_cov_7.998127	764	844	2	45	80	0.5625000
NODE_4206_length_1166_cov_313.815370	444	524	159	2	80	0.0250000
NODE_4206_length_1166_cov_313.815370	444	524	161	3	80	0.0375000
NODE_4206_length_1166_cov_313.815370	444	524	162	2	80	0.0250000
NODE_4206_length_1166_cov_313.815370	444	524	163	2	80	0.0250000
NODE_4206_length_1166_cov_313.815370	444	524	166	2	80	0.0250000
NODE_4206_length_1166_cov_313.815370	444	524	167	1	80	0.0125000
NODE_4206_length_1166_cov_313.815370	444	524	183	1	80	0.0125000
NODE_4206_length_1166_cov_313.815370	444	524	201	1	80	0.0125000
NODE_4206_length_1166_cov_313.815370	444	524	271	1	80	0.0125000
NODE_4206_length_1166_cov_313.815370	444	524	285	1	80	0.0125000
NODE_4206_length_1166_cov_313.815370	444	524	300	1	80	0.0125000
NODE_4206_length_1166_cov_313.815370	444	524	309	1	80	0.0125000
NODE_4206_length_1166_cov_313.815370	444	524	362	1	80	0.0125000
NODE_4206_length_1166_cov_313.815370	444	524	419	1	80	0.0125000
NODE_4206_length_1166_cov_313.815370	444	524	420	1	80	0.0125000
NODE_4206_length_1166_cov_313.815370	444	524	435	1	80	0.0125000
NODE_4206_length_1166_cov_313.815370	444	524	493	1	80	0.0125000
NODE_4206_length_1166_cov_313.815370	444	524	533	1	80	0.0125000
NODE_4206_length_1166_cov_313.815370	444	524	538	1	80	0.0125000
NODE_4206_length_1166_cov_313.815370	444	524	547	1	80	0.0125000
NODE_4206_length_1166_cov_313.815370	444	524	551	1	80	0.0125000
NODE_4206_length_1166_cov_313.815370	444	524	564	1	80	0.0125000
NODE_4206_length_1166_cov_313.815370	444	524	608	1	80	0.0125000
NODE_4206_length_1166_cov_313.815370	444	524	635	1	80	0.0125000
NODE_4206_length_1166_cov_313.815370	444	524	641	1	80	0.0125000
NODE_4206_length_1166_cov_313.815370	444	524	680	1	80	0.0125000
NODE_4206_length_1166_cov_313.815370	444	524	750	1	80	0.0125000
NODE_4206_length_1166_cov_313.815370	444	524	769	1	80	0.0125000
NODE_4206_length_1166_cov_313.815370	444	524	770	1	80	0.0125000
NODE_4206_length_1166_cov_313.815370	444	524	812	1	80	0.0125000
NODE_4206_length_1166_cov_313.815370	444	524	816	1	80	0.0125000
NODE_4206_length_1166_cov_313.815370	444	524	830	1	80	0.0125000
NODE_4206_length_1166_cov_313.815370	444	524	839	1	80	0.0125000
NODE_4206_length_1166_cov_313.815370	444	524	842	1	80	0.0125000
NODE_4206_length_1166_cov_313.815370	444	524	851	1	80	0.0125000
NODE_4206_length_1166_cov_313.815370	444	524	928	1	80	0.0125000
NODE_4206_length_1166_cov_313.815370	444	524	939	1	80	0.0125000
NODE_4206_length_1166_cov_313.815370	444	524	962	1	80	0.0125000
NODE_4206_length_1166_cov_313.815370	444	524	1002	1	80	0.0125000
NODE_4206_length_1166_cov_313.815370	444	524	1021	1	80	0.0125000
NODE_4206_length_1166_cov_313.815370	444	524	1046	1	80	0.0125000
NODE_4206_length_1166_cov_313.815370	444	524	1064	1	80	0.0125000
NODE_4206_length_1166_cov_313.815370	444	524	1069	1	80	0.0125000
NODE_4206_length_1166_cov_313.815370	444	524	1084	1	80	0.0125000
NODE_4206_length_1166_cov_313.815370	444	524	1093	1	80	0.0125000
NODE_4206_length_1166_cov_313.815370	444	524	1108	1	80	0.0125000
NODE_4206_length_1166_cov_313.815370	444	524	1113	1	80	0.0125000
NODE_4206_length_1166_cov_313.815370	444	524	1116	1	80	0.0125000
NODE_4206_length_1166_cov_313.815370	444	524	1135	1	80	0.0125000
NODE_4206_length_1166_cov_313.815370	444	524	1147	1	80	0.0125000
NODE_4206_length_1166_cov_313.815370	444	524	1152	1	80	0.0125000
NODE_4206_length_1166_cov_313.815370	444	524	1172	1	80	0.0125000
NODE_4206_length_1166_cov_313.815370	444	524	1210	1	80	0.0125000
NODE_4206_length_1166_cov_313.815370	444	524	1223	1	80	0.0125000
NODE_4206_length_1166_cov_313.815370	444	524	1252	1	80	0.0125000
NODE_4206_length_1166_cov_313.815370	444	524	1263	1	80	0.0125000
NODE_4206_length_1166_cov_313.815370	444	524	1282	1	80	0.0125000
NODE_4206_length_1166_cov_313.815370	444	524	1337	1	80	0.0125000
NODE_4206_length_1166_cov_313.815370	444	524	1338	1	80	0.0125000
NODE_4206_length_1166_cov_313.815370	444	524	1339	1	80	0.0125000
NODE_4206_length_1166_cov_313.815370	444	524	1351	1	80	0.0125000
NODE_4206_length_1166_cov_313.815370	444	524	1363	1	80	0.0125000
NODE_4206_length_1166_cov_313.815370	444	524	1371	1	80	0.0125000
NODE_4206_length_1166_cov_313.815370	444	524	1383	1	80	0.0125000
NODE_4206_length_1166_cov_313.815370	444	524	1393	1	80	0.0125000
NODE_4206_length_1166_cov_313.815370	444	524	1394	1	80	0.0125000
NODE_4206_length_1166_cov_313.815370	444	524	1415	1	80	0.0125000
NODE_4206_length_1166_cov_313.815370	444	524	1431	1	80	0.0125000
NODE_4206_length_1166_cov_313.815370	444	524	1432	1	80	0.0125000
NODE_4206_length_1166_cov_313.815370	444	524	1434	1	80	0.0125000
NODE_4206_length_1166_cov_313.815370	444	524	1437	1	80	0.0125000
NODE_4206_length_1166_cov_313.815370	444	524	1440	1	80	0.0125000
NODE_4206_length_1166_cov_313.815370	444	524	1441	1	80	0.0125000
NODE_4206_length_1166_cov_313.815370	444	524	1452	1	80	0.0125000
NODE_4206_length_1166_cov_313.815370	444	524	159	2	80	0.0250000
NODE_4206_length_1166_cov_313.815370	444	524	161	3	80	0.0375000
NODE_4206_length_1166_cov_313.815370	444	524	162	2	80	0.0250000
NODE_4206_length_1166_cov_313.815370	444	524	163	2	80	0.0250000
NODE_4206_length_1166_cov_313.815370	444	524	166	2	80	0.0250000
NODE_4206_length_1166_cov_313.815370	444	524	167	1	80	0.0125000
NODE_4206_length_1166_cov_313.815370	444	524	183	1	80	0.0125000
NODE_4206_length_1166_cov_313.815370	444	524	201	1	80	0.0125000
NODE_4206_length_1166_cov_313.815370	444	524	271	1	80	0.0125000
NODE_4206_length_1166_cov_313.815370	444	524	285	1	80	0.0125000
NODE_4206_length_1166_cov_313.815370	444	524	300	1	80	0.0125000
NODE_4206_length_1166_cov_313.815370	444	524	309	1	80	0.0125000
NODE_4206_length_1166_cov_313.815370	444	524	362	1	80	0.0125000
NODE_4206_length_1166_cov_313.815370	444	524	419	1	80	0.0125000
NODE_4206_length_1166_cov_313.815370	444	524	420	1	80	0.0125000
NODE_4206_length_1166_cov_313.815370	444	524	435	1	80	0.0125000
NODE_4206_length_1166_cov_313.815370	444	524	493	1	80	0.0125000
NODE_4206_length_1166_cov_313.815370	444	524	533	1	80	0.0125000
NODE_4206_length_1166_cov_313.815370	444	524	538	1	80	0.0125000
NODE_4206_length_1166_cov_313.815370	444	524	547	1	80	0.0125000
NODE_4206_length_1166_cov_313.815370	444	524	551	1	80	0.0125000
NODE_4206_length_1166_cov_313.815370	444	524	564	1	80	0.0125000
NODE_4206_length_1166_cov_313.815370	444	524	608	1	80	0.0125000
NODE_4206_length_1166_cov_313.815370	444	524	635	1	80	0.0125000
NODE_4206_length_1166_cov_313.815370	444	524	641	1	80	0.0125000
NODE_4206_length_1166_cov_313.815370	444	524	680	1	80	0.0125000
NODE_4206_length_1166_cov_313.815370	444	524	750	1	80	0.0125000
NODE_4206_length_1166_cov_313.815370	444	524	769	1	80	0.0125000
NODE_4206_length_1166_cov_313.815370	444	524	770	1	80	0.0125000
NODE_4206_length_1166_cov_313.815370	444	524	812	1	80	0.0125000
NODE_4206_length_1166_cov_313.815370	444	524	816	1	80	0.0125000
NODE_4206_length_1166_cov_313.815370	444	524	830	1	80	0.0125000
NODE_4206_length_1166_cov_313.815370	444	524	839	1	80	0.0125000
NODE_4206_length_1166_cov_313.815370	444	524	842	1	80	0.0125000
NODE_4206_length_1166_cov_313.815370	444	524	851	1	80	0.0125000
NODE_4206_length_1166_cov_313.815370	444	524	928	1	80	0.0125000
NODE_4206_length_1166_cov_313.815370	444	524	939	1	80	0.0125000
NODE_4206_length_1166_cov_313.815370	444	524	962	1	80	0.0125000
NODE_4206_length_1166_cov_313.815370	444	524	1002	1	80	0.0125000
NODE_4206_length_1166_cov_313.815370	444	524	1021	1	80	0.0125000
NODE_4206_length_1166_cov_313.815370	444	524	1046	1	80	0.0125000
NODE_4206_length_1166_cov_313.815370	444	524	1064	1	80	0.0125000
NODE_4206_length_1166_cov_313.815370	444	524	1069	1	80	0.0125000
NODE_4206_length_1166_cov_313.815370	444	524	1084	1	80	0.0125000
NODE_4206_length_1166_cov_313.815370	444	524	1093	1	80	0.0125000
NODE_4206_length_1166_cov_313.815370	444	524	1108	1	80	0.0125000
NODE_4206_length_1166_cov_313.815370	444	524	1113	1	80	0.0125000
NODE_4206_length_1166_cov_313.815370	444	524	1116	1	80	0.0125000
NODE_4206_length_1166_cov_313.815370	444	524	1135	1	80	0.0125000
NODE_4206_length_1166_cov_313.815370	444	524	1147	1	80	0.0125000
NODE_4206_length_1166_cov_313.815370	444	524	1152	1	80	0.0125000
NODE_4206_length_1166_cov_313.815370	444	524	1172	1	80	0.0125000
NODE_4206_length_1166_cov_313.815370	444	524	1210	1	80	0.0125000
NODE_4206_length_1166_cov_313.815370	444	524	1223	1	80	0.0125000
NODE_4206_length_1166_cov_313.815370	444	524	1252	1	80	0.0125000
NODE_4206_length_1166_cov_313.815370	444	524	1263	1	80	0.0125000
NODE_4206_length_1166_cov_313.815370	444	524	1282	1	80	0.0125000
NODE_4206_length_1166_cov_313.815370	444	524	1337	1	80	0.0125000
NODE_4206_length_1166_cov_313.815370	444	524	1338	1	80	0.0125000
NODE_4206_length_1166_cov_313.815370	444	524	1339	1	80	0.0125000
NODE_4206_length_1166_cov_313.815370	444	524	1351	1	80	0.0125000
NODE_4206_length_1166_cov_313.815370	444	524	1363	1	80	0.0125000
NODE_4206_length_1166_cov_313.815370	444	524	1371	1	80	0.0125000
NODE_4206_length_1166_cov_313.815370	444	524	1383	1	80	0.0125000
NODE_4206_length_1166_cov_313.815370	444	524	1393	1	80	0.0125000
NODE_4206_length_1166_cov_313.815370	444	524	1394	1	80	0.0125000
NODE_4206_length_1166_cov_313.815370	444	524	1415	1	80	0.0125000
NODE_4206_length_1166_cov_313.815370	444	524	1431	1	80	0.0125000
NODE_4206_length_1166_cov_313.815370	444	524	1432	1	80	0.0125000
NODE_4206_length_1166_cov_313.815370	444	524	1434	1	80	0.0125000
NODE_4206_length_1166_cov_313.815370	444	524	1437	1	80	0.0125000
NODE_4206_length_1166_cov_313.815370	444	524	1440	1	80	0.0125000
NODE_4206_length_1166_cov_313.815370	444	524	1441	1	80	0.0125000
NODE_4206_length_1166_cov_313.815370	444	524	1452	1	80	0.0125000
NODE_4206_length_1166_cov_313.815370	444	524	159	2	80	0.0250000
NODE_4206_length_1166_cov_313.815370	444	524	161	3	80	0.0375000
NODE_4206_length_1166_cov_313.815370	444	524	162	2	80	0.0250000
NODE_4206_length_1166_cov_313.815370	444	524	163	2	80	0.0250000
NODE_4206_length_1166_cov_313.815370	444	524	166	2	80	0.0250000
NODE_4206_length_1166_cov_313.815370	444	524	167	1	80	0.0125000
NODE_4206_length_1166_cov_313.815370	444	524	183	1	80	0.0125000
NODE_4206_length_1166_cov_313.815370	444	524	201	1	80	0.0125000
NODE_4206_length_1166_cov_313.815370	444	524	271	1	80	0.0125000
NODE_4206_length_1166_cov_313.815370	444	524	285	1	80	0.0125000
NODE_4206_length_1166_cov_313.815370	444	524	300	1	80	0.0125000
NODE_4206_length_1166_cov_313.815370	444	524	309	1	80	0.0125000
NODE_4206_length_1166_cov_313.815370	444	524	362	1	80	0.0125000
NODE_4206_length_1166_cov_313.815370	444	524	419	1	80	0.0125000
NODE_4206_length_1166_cov_313.815370	444	524	420	1	80	0.0125000
NODE_4206_length_1166_cov_313.815370	444	524	435	1	80	0.0125000
NODE_4206_length_1166_cov_313.815370	444	524	493	1	80	0.0125000
NODE_4206_length_1166_cov_313.815370	444	524	533	1	80	0.0125000
NODE_4206_length_1166_cov_313.815370	444	524	538	1	80	0.0125000
NODE_4206_length_1166_cov_313.815370	444	524	547	1	80	0.0125000
NODE_4206_length_1166_cov_313.815370	444	524	551	1	80	0.0125000
NODE_4206_length_1166_cov_313.815370	444	524	564	1	80	0.0125000
NODE_4206_length_1166_cov_313.815370	444	524	608	1	80	0.0125000
NODE_4206_length_1166_cov_313.815370	444	524	635	1	80	0.0125000
NODE_4206_length_1166_cov_313.815370	444	524	641	1	80	0.0125000
NODE_4206_length_1166_cov_313.815370	444	524	680	1	80	0.0125000
NODE_4206_length_1166_cov_313.815370	444	524	750	1	80	0.0125000
NODE_4206_length_1166_cov_313.815370	444	524	769	1	80	0.0125000
NODE_4206_length_1166_cov_313.815370	444	524	770	1	80	0.0125000
NODE_4206_length_1166_cov_313.815370	444	524	812	1	80	0.0125000
NODE_4206_length_1166_cov_313.815370	444	524	816	1	80	0.0125000
NODE_4206_length_1166_cov_313.815370	444	524	830	1	80	0.0125000
NODE_4206_length_1166_cov_313.815370	444	524	839	1	80	0.0125000
NODE_4206_length_1166_cov_313.815370	444	524	842	1	80	0.0125000
NODE_4206_length_1166_cov_313.815370	444	524	851	1	80	0.0125000
NODE_4206_length_1166_cov_313.815370	444	524	928	1	80	0.0125000
NODE_4206_length_1166_cov_313.815370	444	524	939	1	80	0.0125000
NODE_4206_length_1166_cov_313.815370	444	524	962	1	80	0.0125000
NODE_4206_length_1166_cov_313.815370	444	524	1002	1	80	0.0125000
NODE_4206_length_1166_cov_313.815370	444	524	1021	1	80	0.0125000
NODE_4206_length_1166_cov_313.815370	444	524	1046	1	80	0.0125000
NODE_4206_length_1166_cov_313.815370	444	524	1064	1	80	0.0125000
NODE_4206_length_1166_cov_313.815370	444	524	1069	1	80	0.0125000
NODE_4206_length_1166_cov_313.815370	444	524	1084	1	80	0.0125000
NODE_4206_length_1166_cov_313.815370	444	524	1093	1	80	0.0125000
NODE_4206_length_1166_cov_313.815370	444	524	1108	1	80	0.0125000
NODE_4206_length_1166_cov_313.815370	444	524	1113	1	80	0.0125000
NODE_4206_length_1166_cov_313.815370	444	524	1116	1	80	0.0125000
NODE_4206_length_1166_cov_313.815370	444	524	1135	1	80	0.0125000
NODE_4206_length_1166_cov_313.815370	444	524	1147	1	80	0.0125000
NODE_4206_length_1166_cov_313.815370	444	524	1152	1	80	0.0125000
NODE_4206_length_1166_cov_313.815370	444	524	1172	1	80	0.0125000
NODE_4206_length_1166_cov_313.815370	444	524	1210	1	80	0.0125000
NODE_4206_length_1166_cov_313.815370	444	524	1223	1	80	0.0125000
NODE_4206_length_1166_cov_313.815370	444	524	1252	1	80	0.0125000
NODE_4206_length_1166_cov_313.815370	444	524	1263	1	80	0.0125000
NODE_4206_length_1166_cov_313.815370	444	524	1282	1	80	0.0125000
NODE_4206_length_1166_cov_313.815370	444	524	1337	1	80	0.0125000
NODE_4206_length_1166_cov_313.815370	444	524	1338	1	80	0.0125000
NODE_4206_length_1166_cov_313.815370	444	524	1339	1	80	0.0125000
NODE_4206_length_1166_cov_313.815370	444	524	1351	1	80	0.0125000
NODE_4206_length_1166_cov_313.815370	444	524	1363	1	80	0.0125000
NODE_4206_length_1166_cov_313.815370	444	524	1371	1	80	0.0125000
NODE_4206_length_1166_cov_313.815370	444	524	1383	1	80	0.0125000
NODE_4206_length_1166_cov_313.815370	444	524	1393	1	80	0.0125000
NODE_4206_length_1166_cov_313.815370	444	524	1394	1	80	0.0125000
NODE_4206_length_1166_cov_313.815370	444	524	1415	1	80	0.0125000
NODE_4206_length_1166_cov_313.815370	444	524	1431	1	80	0.0125000
NODE_4206_length_1166_cov_313.815370	444	524	1432	1	80	0.0125000
NODE_4206_length_1166_cov_313.815370	444	524	1434	1	80	0.0125000
NODE_4206_length_1166_cov_313.815370	444	524	1437	1	80	0.0125000
NODE_4206_length_1166_cov_313.815370	444	524	1440	1	80	0.0125000
NODE_4206_length_1166_cov_313.815370	444	524	1441	1	80	0.0125000
NODE_4206_length_1166_cov_313.815370	444	524	1452	1	80	0.0125000
NODE_4206_length_1166_cov_313.815370	444	524	159	2	80	0.0250000
NODE_4206_length_1166_cov_313.815370	444	524	161	3	80	0.0375000
NODE_4206_length_1166_cov_313.815370	444	524	162	2	80	0.0250000
NODE_4206_length_1166_cov_313.815370	444	524	163	2	80	0.0250000
NODE_4206_length_1166_cov_313.815370	444	524	166	2	80	0.0250000
NODE_4206_length_1166_cov_313.815370	444	524	167	1	80	0.0125000
NODE_4206_length_1166_cov_313.815370	444	524	183	1	80	0.0125000
NODE_4206_length_1166_cov_313.815370	444	524	201	1	80	0.0125000
NODE_4206_length_1166_cov_313.815370	444	524	271	1	80	0.0125000
NODE_4206_length_1166_cov_313.815370	444	524	285	1	80	0.0125000
NODE_4206_length_1166_cov_313.815370	444	524	300	1	80	0.0125000
NODE_4206_length_1166_cov_313.815370	444	524	309	1	80	0.0125000
NODE_4206_length_1166_cov_313.815370	444	524	362	1	80	0.0125000
NODE_4206_length_1166_cov_313.815370	444	524	419	1	80	0.0125000
NODE_4206_length_1166_cov_313.815370	444	524	420	1	80	0.0125000
NODE_4206_length_1166_cov_313.815370	444	524	435	1	80	0.0125000
NODE_4206_length_1166_cov_313.815370	444	524	493	1	80	0.0125000
NODE_4206_length_1166_cov_313.815370	444	524	533	1	80	0.0125000
NODE_4206_length_1166_cov_313.815370	444	524	538	1	80	0.0125000
NODE_4206_length_1166_cov_313.815370	444	524	547	1	80	0.0125000
NODE_4206_length_1166_cov_313.815370	444	524	551	1	80	0.0125000
NODE_4206_length_1166_cov_313.815370	444	524	564	1	80	0.0125000
NODE_4206_length_1166_cov_313.815370	444	524	608	1	80	0.0125000
NODE_4206_length_1166_cov_313.815370	444	524	635	1	80	0.0125000
NODE_4206_length_1166_cov_313.815370	444	524	641	1	80	0.0125000
NODE_4206_length_1166_cov_313.815370	444	524	680	1	80	0.0125000
NODE_4206_length_1166_cov_313.815370	444	524	750	1	80	0.0125000
NODE_4206_length_1166_cov_313.815370	444	524	769	1	80	0.0125000
NODE_4206_length_1166_cov_313.815370	444	524	770	1	80	0.0125000
NODE_4206_length_1166_cov_313.815370	444	524	812	1	80	0.0125000
NODE_4206_length_1166_cov_313.815370	444	524	816	1	80	0.0125000
NODE_4206_length_1166_cov_313.815370	444	524	830	1	80	0.0125000
NODE_4206_length_1166_cov_313.815370	444	524	839	1	80	0.0125000
NODE_4206_length_1166_cov_313.815370	444	524	842	1	80	0.0125000
NODE_4206_length_1166_cov_313.815370	444	524	851	1	80	0.0125000
NODE_4206_length_1166_cov_313.815370	444	524	928	1	80	0.0125000
NODE_4206_length_1166_cov_313.815370	444	524	939	1	80	0.0125000
NODE_4206_length_1166_cov_313.815370	444	524	962	1	80	0.0125000
NODE_4206_length_1166_cov_313.815370	444	524	1002	1	80	0.0125000
NODE_4206_length_1166_cov_313.815370	444	524	1021	1	80	0.0125000
NODE_4206_length_1166_cov_313.815370	444	524	1046	1	80	0.0125000
NODE_4206_length_1166_cov_313.815370	444	524	1064	1	80	0.0125000
NODE_4206_length_1166_cov_313.815370	444	524	1069	1	80	0.0125000
NODE_4206_length_1166_cov_313.815370	444	524	1084	1	80	0.0125000
NODE_4206_length_1166_cov_313.815370	444	524	1093	1	80	0.0125000
NODE_4206_length_1166_cov_313.815370	444	524	1108	1	80	0.0125000
NODE_4206_length_1166_cov_313.815370	444	524	1113	1	80	0.0125000
NODE_4206_length_1166_cov_313.815370	444	524	1116	1	80	0.0125000
NODE_4206_length_1166_cov_313.815370	444	524	1135	1	80	0.0125000
NODE_4206_length_1166_cov_313.815370	444	524	1147	1	80	0.0125000
NODE_4206_length_1166_cov_313.815370	444	524	1152	1	80	0.0125000
NODE_4206_length_1166_cov_313.815370	444	524	1172	1	80	0.0125000
NODE_4206_length_1166_cov_313.815370	444	524	1210	1	80	0.0125000
NODE_4206_length_1166_cov_313.815370	444	524	1223	1	80	0.0125000
NODE_4206_length_1166_cov_313.815370	444	524	1252	1	80	0.0125000
NODE_4206_length_1166_cov_313.815370	444	524	1263	1	80	0.0125000
NODE_4206_length_1166_cov_313.815370	444	524	1282	1	80	0.0125000
NODE_4206_length_1166_cov_313.815370	444	524	1337	1	80	0.0125000
NODE_4206_length_1166_cov_313.815370	444	524	1338	1	80	0.0125000
NODE_4206_length_1166_cov_313.815370	444	524	1339	1	80	0.0125000
NODE_4206_length_1166_cov_313.815370	444	524	1351	1	80	0.0125000
NODE_4206_length_1166_cov_313.815370	444	524	1363	1	80	0.0125000
NODE_4206_length_1166_cov_313.815370	444	524	1371	1	80	0.0125000
NODE_4206_length_1166_cov_313.815370	444	524	1383	1	80	0.0125000
NODE_4206_length_1166_cov_313.815370	444	524	1393	1	80	0.0125000
NODE_4206_length_1166_cov_313.815370	444	524	1394	1	80	0.0125000
NODE_4206_length_1166_cov_313.815370	444	524	1415	1	80	0.0125000
NODE_4206_length_1166_cov_313.815370	444	524	1431	1	80	0.0125000
NODE_4206_length_1166_cov_313.815370	444	524	1432	1	80	0.0125000
NODE_4206_length_1166_cov_313.815370	444	524	1434	1	80	0.0125000
NODE_4206_length_1166_cov_313.815370	444	524	1437	1	80	0.0125000
NODE_4206_length_1166_cov_313.815370	444	524	1440	1	80	0.0125000
NODE_4206_length_1166_cov_313.815370	444	524	1441	1	80	0.0125000
NODE_4206_length_1166_cov_313.815370	444	524	1452	1	80	0.0125000
NODE_4206_length_1166_cov_313.815370	444	524	159	2	80	0.0250000
NODE_4206_length_1166_cov_313.815370	444	524	161	3	80	0.0375000
NODE_4206_length_1166_cov_313.815370	444	524	162	2	80	0.0250000
NODE_4206_length_1166_cov_313.815370	444	524	163	2	80	0.0250000
NODE_4206_length_1166_cov_313.815370	444	524	166	2	80	0.0250000
NODE_4206_length_1166_cov_313.815370	444	524	167	1	80	0.0125000
NODE_4206_length_1166_cov_313.815370	444	524	183	1	80	0.0125000
NODE_4206_length_1166_cov_313.815370	444	524	201	1	80	0.0125000
NODE_4206_length_1166_cov_313.815370	444	524	271	1	80	0.0125000
NODE_4206_length_1166_cov_313.815370	444	524	285	1	80	0.0125000
NODE_4206_length_1166_cov_313.815370	444	524	300	1	80	0.0125000
NODE_4206_length_1166_cov_313.815370	444	524	309	1	80	0.0125000
NODE_4206_length_1166_cov_313.815370	444	524	362	1	80	0.0125000
NODE_4206_length_1166_cov_313.815370	444	524	419	1	80	0.0125000
NODE_4206_length_1166_cov_313.815370	444	524	420	1	80	0.0125000
NODE_4206_length_1166_cov_313.815370	444	524	435	1	80	0.0125000
NODE_4206_length_1166_cov_313.815370	444	524	493	1	80	0.0125000
NODE_4206_length_1166_cov_313.815370	444	524	533	1	80	0.0125000
NODE_4206_length_1166_cov_313.815370	444	524	538	1	80	0.0125000
NODE_4206_length_1166_cov_313.815370	444	524	547	1	80	0.0125000
NODE_4206_length_1166_cov_313.815370	444	524	551	1	80	0.0125000
NODE_4206_length_1166_cov_313.815370	444	524	564	1	80	0.0125000
NODE_4206_length_1166_cov_313.815370	444	524	608	1	80	0.0125000
NODE_4206_length_1166_cov_313.815370	444	524	635	1	80	0.0125000
NODE_4206_length_1166_cov_313.815370	444	524	641	1	80	0.0125000
NODE_4206_length_1166_cov_313.815370	444	524	680	1	80	0.0125000
NODE_4206_length_1166_cov_313.815370	444	524	750	1	80	0.0125000
NODE_4206_length_1166_cov_313.815370	444	524	769	1	80	0.0125000
NODE_4206_length_1166_cov_313.815370	444	524	770	1	80	0.0125000
NODE_4206_length_1166_cov_313.815370	444	524	812	1	80	0.0125000
NODE_4206_length_1166_cov_313.815370	444	524	816	1	80	0.0125000
NODE_4206_length_1166_cov_313.815370	444	524	830	1	80	0.0125000
NODE_4206_length_1166_cov_313.815370	444	524	839	1	80	0.0125000
NODE_4206_length_1166_cov_313.815370	444	524	842	1	80	0.0125000
NODE_4206_length_1166_cov_313.815370	444	524	851	1	80	0.0125000
NODE_4206_length_1166_cov_313.815370	444	524	928	1	80	0.0125000
NODE_4206_length_1166_cov_313.815370	444	524	939	1	80	0.0125000
NODE_4206_length_1166_cov_313.815370	444	524	962	1	80	0.0125000
NODE_4206_length_1166_cov_313.815370	444	524	1002	1	80	0.0125000
NODE_4206_length_1166_cov_313.815370	444	524	1021	1	80	0.0125000
NODE_4206_length_1166_cov_313.815370	444	524	1046	1	80	0.0125000
NODE_4206_length_1166_cov_313.815370	444	524	1064	1	80	0.0125000
NODE_4206_length_1166_cov_313.815370	444	524	1069	1	80	0.0125000
NODE_4206_length_1166_cov_313.815370	444	524	1084	1	80	0.0125000
NODE_4206_length_1166_cov_313.815370	444	524	1093	1	80	0.0125000
NODE_4206_length_1166_cov_313.815370	444	524	1108	1	80	0.0125000
NODE_4206_length_1166_cov_313.815370	444	524	1113	1	80	0.0125000
NODE_4206_length_1166_cov_313.815370	444	524	1116	1	80	0.0125000
NODE_4206_length_1166_cov_313.815370	444	524	1135	1	80	0.0125000
NODE_4206_length_1166_cov_313.815370	444	524	1147	1	80	0.0125000
NODE_4206_length_1166_cov_313.815370	444	524	1152	1	80	0.0125000
NODE_4206_length_1166_cov_313.815370	444	524	1172	1	80	0.0125000
NODE_4206_length_1166_cov_313.815370	444	524	1210	1	80	0.0125000
NODE_4206_length_1166_cov_313.815370	444	524	1223	1	80	0.0125000
NODE_4206_length_1166_cov_313.815370	444	524	1252	1	80	0.0125000
NODE_4206_length_1166_cov_313.815370	444	524	1263	1	80	0.0125000
NODE_4206_length_1166_cov_313.815370	444	524	1282	1	80	0.0125000
NODE_4206_length_1166_cov_313.815370	444	524	1337	1	80	0.0125000
NODE_4206_length_1166_cov_313.815370	444	524	1338	1	80	0.0125000
NODE_4206_length_1166_cov_313.815370	444	524	1339	1	80	0.0125000
NODE_4206_length_1166_cov_313.815370	444	524	1351	1	80	0.0125000
NODE_4206_length_1166_cov_313.815370	444	524	1363	1	80	0.0125000
NODE_4206_length_1166_cov_313.815370	444	524	1371	1	80	0.0125000
NODE_4206_length_1166_cov_313.815370	444	524	1383	1	80	0.0125000
NODE_4206_length_1166_cov_313.815370	444	524	1393	1	80	0.0125000
NODE_4206_length_1166_cov_313.815370	444	524	1394	1	80	0.0125000
NODE_4206_length_1166_cov_313.815370	444	524	1415	1	80	0.0125000
NODE_4206_length_1166_cov_313.815370	444	524	1431	1	80	0.0125000
NODE_4206_length_1166_cov_313.815370	444	524	1432	1	80	0.0125000
NODE_4206_length_1166_cov_313.815370	444	524	1434	1	80	0.0125000
NODE_4206_length_1166_cov_313.815370	444	524	1437	1	80	0.0125000
NODE_4206_length_1166_cov_313.815370	444	524	1440	1	80	0.0125000
NODE_4206_length_1166_cov_313.815370	444	524	1441	1	80	0.0125000
NODE_4206_length_1166_cov_313.815370	444	524	1452	1	80	0.0125000
NODE_4206_length_1166_cov_313.815370	444	524	159	2	80	0.0250000
NODE_4206_length_1166_cov_313.815370	444	524	161	3	80	0.0375000
NODE_4206_length_1166_cov_313.815370	444	524	162	2	80	0.0250000
NODE_4206_length_1166_cov_313.815370	444	524	163	2	80	0.0250000
NODE_4206_length_1166_cov_313.815370	444	524	166	2	80	0.0250000
NODE_4206_length_1166_cov_313.815370	444	524	167	1	80	0.0125000
NODE_4206_length_1166_cov_313.815370	444	524	183	1	80	0.0125000
NODE_4206_length_1166_cov_313.815370	444	524	201	1	80	0.0125000
NODE_4206_length_1166_cov_313.815370	444	524	271	1	80	0.0125000
NODE_4206_length_1166_cov_313.815370	444	524	285	1	80	0.0125000
NODE_4206_length_1166_cov_313.815370	444	524	300	1	80	0.0125000
NODE_4206_length_1166_cov_313.815370	444	524	309	1	80	0.0125000
NODE_4206_length_1166_cov_313.815370	444	524	362	1	80	0.0125000
NODE_4206_length_1166_cov_313.815370	444	524	419	1	80	0.0125000
NODE_4206_length_1166_cov_313.815370	444	524	420	1	80	0.0125000
NODE_4206_length_1166_cov_313.815370	444	524	435	1	80	0.0125000
NODE_4206_length_1166_cov_313.815370	444	524	493	1	80	0.0125000
NODE_4206_length_1166_cov_313.815370	444	524	533	1	80	0.0125000
NODE_4206_length_1166_cov_313.815370	444	524	538	1	80	0.0125000
NODE_4206_length_1166_cov_313.815370	444	524	547	1	80	0.0125000
NODE_4206_length_1166_cov_313.815370	444	524	551	1	80	0.0125000
NODE_4206_length_1166_cov_313.815370	444	524	564	1	80	0.0125000
NODE_4206_length_1166_cov_313.815370	444	524	608	1	80	0.0125000
NODE_4206_length_1166_cov_313.815370	444	524	635	1	80	0.0125000
NODE_4206_length_1166_cov_313.815370	444	524	641	1	80	0.0125000
NODE_4206_length_1166_cov_313.815370	444	524	680	1	80	0.0125000
NODE_4206_length_1166_cov_313.815370	444	524	750	1	80	0.0125000
NODE_4206_length_1166_cov_313.815370	444	524	769	1	80	0.0125000
NODE_4206_length_1166_cov_313.815370	444	524	770	1	80	0.0125000
NODE_4206_length_1166_cov_313.815370	444	524	812	1	80	0.0125000
NODE_4206_length_1166_cov_313.815370	444	524	816	1	80	0.0125000
NODE_4206_length_1166_cov_313.815370	444	524	830	1	80	0.0125000
NODE_4206_length_1166_cov_313.815370	444	524	839	1	80	0.0125000
NODE_4206_length_1166_cov_313.815370	444	524	842	1	80	0.0125000
NODE_4206_length_1166_cov_313.815370	444	524	851	1	80	0.0125000
NODE_4206_length_1166_cov_313.815370	444	524	928	1	80	0.0125000
NODE_4206_length_1166_cov_313.815370	444	524	939	1	80	0.0125000
NODE_4206_length_1166_cov_313.815370	444	524	962	1	80	0.0125000
NODE_4206_length_1166_cov_313.815370	444	524	1002	1	80	0.0125000
NODE_4206_length_1166_cov_313.815370	444	524	1021	1	80	0.0125000
NODE_4206_length_1166_cov_313.815370	444	524	1046	1	80	0.0125000
NODE_4206_length_1166_cov_313.815370	444	524	1064	1	80	0.0125000
NODE_4206_length_1166_cov_313.815370	444	524	1069	1	80	0.0125000
NODE_4206_length_1166_cov_313.815370	444	524	1084	1	80	0.0125000
NODE_4206_length_1166_cov_313.815370	444	524	1093	1	80	0.0125000
NODE_4206_length_1166_cov_313.815370	444	524	1108	1	80	0.0125000
NODE_4206_length_1166_cov_313.815370	444	524	1113	1	80	0.0125000
NODE_4206_length_1166_cov_313.815370	444	524	1116	1	80	0.0125000
NODE_4206_length_1166_cov_313.815370	444	524	1135	1	80	0.0125000
NODE_4206_length_1166_cov_313.815370	444	524	1147	1	80	0.0125000
NODE_4206_length_1166_cov_313.815370	444	524	1152	1	80	0.0125000
NODE_4206_length_1166_cov_313.815370	444	524	1172	1	80	0.0125000
NODE_4206_length_1166_cov_313.815370	444	524	1210	1	80	0.0125000
NODE_4206_length_1166_cov_313.815370	444	524	1223	1	80	0.0125000
NODE_4206_length_1166_cov_313.815370	444	524	1252	1	80	0.0125000
NODE_4206_length_1166_cov_313.815370	444	524	1263	1	80	0.0125000
NODE_4206_length_1166_cov_313.815370	444	524	1282	1	80	0.0125000
NODE_4206_length_1166_cov_313.815370	444	524	1337	1	80	0.0125000
NODE_4206_length_1166_cov_313.815370	444	524	1338	1	80	0.0125000
NODE_4206_length_1166_cov_313.815370	444	524	1339	1	80	0.0125000
NODE_4206_length_1166_cov_313.815370	444	524	1351	1	80	0.0125000
NODE_4206_length_1166_cov_313.815370	444	524	1363	1	80	0.0125000
NODE_4206_length_1166_cov_313.815370	444	524	1371	1	80	0.0125000
NODE_4206_length_1166_cov_313.815370	444	524	1383	1	80	0.0125000
NODE_4206_length_1166_cov_313.815370	444	524	1393	1	80	0.0125000
NODE_4206_length_1166_cov_313.815370	444	524	1394	1	80	0.0125000
NODE_4206_length_1166_cov_313.815370	444	524	1415	1	80	0.0125000
NODE_4206_length_1166_cov_313.815370	444	524	1431	1	80	0.0125000
NODE_4206_length_1166_cov_313.815370	444	524	1432	1	80	0.0125000
NODE_4206_length_1166_cov_313.815370	444	524	1434	1	80	0.0125000
NODE_4206_length_1166_cov_313.815370	444	524	1437	1	80	0.0125000
NODE_4206_length_1166_cov_313.815370	444	524	1440	1	80	0.0125000
NODE_4206_length_1166_cov_313.815370	444	524	1441	1	80	0.0125000
NODE_4206_length_1166_cov_313.815370	444	524	1452	1	80	0.0125000
NODE_4206_length_1166_cov_313.815370	497	577	1116	1	80	0.0125000
NODE_4206_length_1166_cov_313.815370	497	577	1135	1	80	0.0125000
NODE_4206_length_1166_cov_313.815370	497	577	1147	1	80	0.0125000
NODE_4206_length_1166_cov_313.815370	497	577	1152	1	80	0.0125000
NODE_4206_length_1166_cov_313.815370	497	577	1172	1	80	0.0125000
NODE_4206_length_1166_cov_313.815370	497	577	1210	1	80	0.0125000
NODE_4206_length_1166_cov_313.815370	497	577	1223	1	80	0.0125000
NODE_4206_length_1166_cov_313.815370	497	577	1252	1	80	0.0125000
NODE_4206_length_1166_cov_313.815370	497	577	1263	1	80	0.0125000
NODE_4206_length_1166_cov_313.815370	497	577	1282	1	80	0.0125000
NODE_4206_length_1166_cov_313.815370	497	577	1337	1	80	0.0125000
NODE_4206_length_1166_cov_313.815370	497	577	1338	1	80	0.0125000
NODE_4206_length_1166_cov_313.815370	497	577	1339	1	80	0.0125000
NODE_4206_length_1166_cov_313.815370	497	577	1351	1	80	0.0125000
NODE_4206_length_1166_cov_313.815370	497	577	1363	1	80	0.0125000
NODE_4206_length_1166_cov_313.815370	497	577	1371	1	80	0.0125000
NODE_4206_length_1166_cov_313.815370	497	577	1383	1	80	0.0125000
NODE_4206_length_1166_cov_313.815370	497	577	1393	1	80	0.0125000
NODE_4206_length_1166_cov_313.815370	497	577	1394	1	80	0.0125000
NODE_4206_length_1166_cov_313.815370	497	577	1415	1	80	0.0125000
NODE_4206_length_1166_cov_313.815370	497	577	1431	1	80	0.0125000
NODE_4206_length_1166_cov_313.815370	497	577	1432	1	80	0.0125000
NODE_4206_length_1166_cov_313.815370	497	577	1434	1	80	0.0125000
NODE_4206_length_1166_cov_313.815370	497	577	1437	2	80	0.0250000
NODE_4206_length_1166_cov_313.815370	497	577	1439	2	80	0.0250000
NODE_4206_length_1166_cov_313.815370	497	577	1440	2	80	0.0250000
NODE_4206_length_1166_cov_313.815370	497	577	1441	1	80	0.0125000
NODE_4206_length_1166_cov_313.815370	497	577	1448	1	80	0.0125000
NODE_4206_length_1166_cov_313.815370	497	577	1449	3	80	0.0375000
NODE_4206_length_1166_cov_313.815370	497	577	1452	1	80	0.0125000
NODE_4206_length_1166_cov_313.815370	497	577	1457	2	80	0.0250000
NODE_4206_length_1166_cov_313.815370	497	577	1458	1	80	0.0125000
NODE_4206_length_1166_cov_313.815370	497	577	1459	1	80	0.0125000
NODE_4206_length_1166_cov_313.815370	497	577	1462	1	80	0.0125000
NODE_4206_length_1166_cov_313.815370	497	577	1474	1	80	0.0125000
NODE_4206_length_1166_cov_313.815370	497	577	1475	1	80	0.0125000
NODE_4206_length_1166_cov_313.815370	497	577	1476	6	80	0.0750000
NODE_4206_length_1166_cov_313.815370	497	577	1478	7	80	0.0875000
NODE_4206_length_1166_cov_313.815370	497	577	1479	3	80	0.0375000
NODE_4206_length_1166_cov_313.815370	497	577	1481	4	80	0.0500000
NODE_4206_length_1166_cov_313.815370	497	577	1482	5	80	0.0625000
NODE_4206_length_1166_cov_313.815370	497	577	1483	3	80	0.0375000
NODE_4206_length_1166_cov_313.815370	497	577	1485	2	80	0.0250000
NODE_4206_length_1166_cov_313.815370	497	577	1487	3	80	0.0375000
NODE_4206_length_1166_cov_313.815370	497	577	1488	2	80	0.0250000
NODE_4206_length_1166_cov_313.815370	497	577	1489	1	80	0.0125000
NODE_4206_length_1166_cov_313.815370	497	577	1493	1	80	0.0125000
NODE_4206_length_1166_cov_313.815370	497	577	1494	1	80	0.0125000
NODE_4206_length_1166_cov_313.815370	497	577	1116	1	80	0.0125000
NODE_4206_length_1166_cov_313.815370	497	577	1135	1	80	0.0125000
NODE_4206_length_1166_cov_313.815370	497	577	1147	1	80	0.0125000
NODE_4206_length_1166_cov_313.815370	497	577	1152	1	80	0.0125000
NODE_4206_length_1166_cov_313.815370	497	577	1172	1	80	0.0125000
NODE_4206_length_1166_cov_313.815370	497	577	1210	1	80	0.0125000
NODE_4206_length_1166_cov_313.815370	497	577	1223	1	80	0.0125000
NODE_4206_length_1166_cov_313.815370	497	577	1252	1	80	0.0125000
NODE_4206_length_1166_cov_313.815370	497	577	1263	1	80	0.0125000
NODE_4206_length_1166_cov_313.815370	497	577	1282	1	80	0.0125000
NODE_4206_length_1166_cov_313.815370	497	577	1337	1	80	0.0125000
NODE_4206_length_1166_cov_313.815370	497	577	1338	1	80	0.0125000
NODE_4206_length_1166_cov_313.815370	497	577	1339	1	80	0.0125000
NODE_4206_length_1166_cov_313.815370	497	577	1351	1	80	0.0125000
NODE_4206_length_1166_cov_313.815370	497	577	1363	1	80	0.0125000
NODE_4206_length_1166_cov_313.815370	497	577	1371	1	80	0.0125000
NODE_4206_length_1166_cov_313.815370	497	577	1383	1	80	0.0125000
NODE_4206_length_1166_cov_313.815370	497	577	1393	1	80	0.0125000
NODE_4206_length_1166_cov_313.815370	497	577	1394	1	80	0.0125000
NODE_4206_length_1166_cov_313.815370	497	577	1415	1	80	0.0125000
NODE_4206_length_1166_cov_313.815370	497	577	1431	1	80	0.0125000
NODE_4206_length_1166_cov_313.815370	497	577	1432	1	80	0.0125000
NODE_4206_length_1166_cov_313.815370	497	577	1434	1	80	0.0125000
NODE_4206_length_1166_cov_313.815370	497	577	1437	2	80	0.0250000
NODE_4206_length_1166_cov_313.815370	497	577	1439	2	80	0.0250000
NODE_4206_length_1166_cov_313.815370	497	577	1440	2	80	0.0250000
NODE_4206_length_1166_cov_313.815370	497	577	1441	1	80	0.0125000
NODE_4206_length_1166_cov_313.815370	497	577	1448	1	80	0.0125000
NODE_4206_length_1166_cov_313.815370	497	577	1449	3	80	0.0375000
NODE_4206_length_1166_cov_313.815370	497	577	1452	1	80	0.0125000
NODE_4206_length_1166_cov_313.815370	497	577	1457	2	80	0.0250000
NODE_4206_length_1166_cov_313.815370	497	577	1458	1	80	0.0125000
NODE_4206_length_1166_cov_313.815370	497	577	1459	1	80	0.0125000
NODE_4206_length_1166_cov_313.815370	497	577	1462	1	80	0.0125000
NODE_4206_length_1166_cov_313.815370	497	577	1474	1	80	0.0125000
NODE_4206_length_1166_cov_313.815370	497	577	1475	1	80	0.0125000
NODE_4206_length_1166_cov_313.815370	497	577	1476	6	80	0.0750000
NODE_4206_length_1166_cov_313.815370	497	577	1478	7	80	0.0875000
NODE_4206_length_1166_cov_313.815370	497	577	1479	3	80	0.0375000
NODE_4206_length_1166_cov_313.815370	497	577	1481	4	80	0.0500000
NODE_4206_length_1166_cov_313.815370	497	577	1482	5	80	0.0625000
NODE_4206_length_1166_cov_313.815370	497	577	1483	3	80	0.0375000
NODE_4206_length_1166_cov_313.815370	497	577	1485	2	80	0.0250000
NODE_4206_length_1166_cov_313.815370	497	577	1487	3	80	0.0375000
NODE_4206_length_1166_cov_313.815370	497	577	1488	2	80	0.0250000
NODE_4206_length_1166_cov_313.815370	497	577	1489	1	80	0.0125000
NODE_4206_length_1166_cov_313.815370	497	577	1493	1	80	0.0125000
NODE_4206_length_1166_cov_313.815370	497	577	1494	1	80	0.0125000
NODE_4206_length_1166_cov_313.815370	497	577	1116	1	80	0.0125000
NODE_4206_length_1166_cov_313.815370	497	577	1135	1	80	0.0125000
NODE_4206_length_1166_cov_313.815370	497	577	1147	1	80	0.0125000
NODE_4206_length_1166_cov_313.815370	497	577	1152	1	80	0.0125000
NODE_4206_length_1166_cov_313.815370	497	577	1172	1	80	0.0125000
NODE_4206_length_1166_cov_313.815370	497	577	1210	1	80	0.0125000
NODE_4206_length_1166_cov_313.815370	497	577	1223	1	80	0.0125000
NODE_4206_length_1166_cov_313.815370	497	577	1252	1	80	0.0125000
NODE_4206_length_1166_cov_313.815370	497	577	1263	1	80	0.0125000
NODE_4206_length_1166_cov_313.815370	497	577	1282	1	80	0.0125000
NODE_4206_length_1166_cov_313.815370	497	577	1337	1	80	0.0125000
NODE_4206_length_1166_cov_313.815370	497	577	1338	1	80	0.0125000
NODE_4206_length_1166_cov_313.815370	497	577	1339	1	80	0.0125000
NODE_4206_length_1166_cov_313.815370	497	577	1351	1	80	0.0125000
NODE_4206_length_1166_cov_313.815370	497	577	1363	1	80	0.0125000
NODE_4206_length_1166_cov_313.815370	497	577	1371	1	80	0.0125000
NODE_4206_length_1166_cov_313.815370	497	577	1383	1	80	0.0125000
NODE_4206_length_1166_cov_313.815370	497	577	1393	1	80	0.0125000
NODE_4206_length_1166_cov_313.815370	497	577	1394	1	80	0.0125000
NODE_4206_length_1166_cov_313.815370	497	577	1415	1	80	0.0125000
NODE_4206_length_1166_cov_313.815370	497	577	1431	1	80	0.0125000
NODE_4206_length_1166_cov_313.815370	497	577	1432	1	80	0.0125000
NODE_4206_length_1166_cov_313.815370	497	577	1434	1	80	0.0125000
NODE_4206_length_1166_cov_313.815370	497	577	1437	2	80	0.0250000
NODE_4206_length_1166_cov_313.815370	497	577	1439	2	80	0.0250000
NODE_4206_length_1166_cov_313.815370	497	577	1440	2	80	0.0250000
NODE_4206_length_1166_cov_313.815370	497	577	1441	1	80	0.0125000
NODE_4206_length_1166_cov_313.815370	497	577	1448	1	80	0.0125000
NODE_4206_length_1166_cov_313.815370	497	577	1449	3	80	0.0375000
NODE_4206_length_1166_cov_313.815370	497	577	1452	1	80	0.0125000
NODE_4206_length_1166_cov_313.815370	497	577	1457	2	80	0.0250000
NODE_4206_length_1166_cov_313.815370	497	577	1458	1	80	0.0125000
NODE_4206_length_1166_cov_313.815370	497	577	1459	1	80	0.0125000
NODE_4206_length_1166_cov_313.815370	497	577	1462	1	80	0.0125000
NODE_4206_length_1166_cov_313.815370	497	577	1474	1	80	0.0125000
NODE_4206_length_1166_cov_313.815370	497	577	1475	1	80	0.0125000
NODE_4206_length_1166_cov_313.815370	497	577	1476	6	80	0.0750000
NODE_4206_length_1166_cov_313.815370	497	577	1478	7	80	0.0875000
NODE_4206_length_1166_cov_313.815370	497	577	1479	3	80	0.0375000
NODE_4206_length_1166_cov_313.815370	497	577	1481	4	80	0.0500000
NODE_4206_length_1166_cov_313.815370	497	577	1482	5	80	0.0625000
NODE_4206_length_1166_cov_313.815370	497	577	1483	3	80	0.0375000
NODE_4206_length_1166_cov_313.815370	497	577	1485	2	80	0.0250000
NODE_4206_length_1166_cov_313.815370	497	577	1487	3	80	0.0375000
NODE_4206_length_1166_cov_313.815370	497	577	1488	2	80	0.0250000
NODE_4206_length_1166_cov_313.815370	497	577	1489	1	80	0.0125000
NODE_4206_length_1166_cov_313.815370	497	577	1493	1	80	0.0125000
NODE_4206_length_1166_cov_313.815370	497	577	1494	1	80	0.0125000
NODE_4206_length_1166_cov_313.815370	497	577	1116	1	80	0.0125000
NODE_4206_length_1166_cov_313.815370	497	577	1135	1	80	0.0125000
NODE_4206_length_1166_cov_313.815370	497	577	1147	1	80	0.0125000
NODE_4206_length_1166_cov_313.815370	497	577	1152	1	80	0.0125000
NODE_4206_length_1166_cov_313.815370	497	577	1172	1	80	0.0125000
NODE_4206_length_1166_cov_313.815370	497	577	1210	1	80	0.0125000
NODE_4206_length_1166_cov_313.815370	497	577	1223	1	80	0.0125000
NODE_4206_length_1166_cov_313.815370	497	577	1252	1	80	0.0125000
NODE_4206_length_1166_cov_313.815370	497	577	1263	1	80	0.0125000
NODE_4206_length_1166_cov_313.815370	497	577	1282	1	80	0.0125000
NODE_4206_length_1166_cov_313.815370	497	577	1337	1	80	0.0125000
NODE_4206_length_1166_cov_313.815370	497	577	1338	1	80	0.0125000
NODE_4206_length_1166_cov_313.815370	497	577	1339	1	80	0.0125000
NODE_4206_length_1166_cov_313.815370	497	577	1351	1	80	0.0125000
NODE_4206_length_1166_cov_313.815370	497	577	1363	1	80	0.0125000
NODE_4206_length_1166_cov_313.815370	497	577	1371	1	80	0.0125000
NODE_4206_length_1166_cov_313.815370	497	577	1383	1	80	0.0125000
NODE_4206_length_1166_cov_313.815370	497	577	1393	1	80	0.0125000
NODE_4206_length_1166_cov_313.815370	497	577	1394	1	80	0.0125000
NODE_4206_length_1166_cov_313.815370	497	577	1415	1	80	0.0125000
NODE_4206_length_1166_cov_313.815370	497	577	1431	1	80	0.0125000
NODE_4206_length_1166_cov_313.815370	497	577	1432	1	80	0.0125000
NODE_4206_length_1166_cov_313.815370	497	577	1434	1	80	0.0125000
NODE_4206_length_1166_cov_313.815370	497	577	1437	2	80	0.0250000
NODE_4206_length_1166_cov_313.815370	497	577	1439	2	80	0.0250000
NODE_4206_length_1166_cov_313.815370	497	577	1440	2	80	0.0250000
NODE_4206_length_1166_cov_313.815370	497	577	1441	1	80	0.0125000
NODE_4206_length_1166_cov_313.815370	497	577	1448	1	80	0.0125000
NODE_4206_length_1166_cov_313.815370	497	577	1449	3	80	0.0375000
NODE_4206_length_1166_cov_313.815370	497	577	1452	1	80	0.0125000
NODE_4206_length_1166_cov_313.815370	497	577	1457	2	80	0.0250000
NODE_4206_length_1166_cov_313.815370	497	577	1458	1	80	0.0125000
NODE_4206_length_1166_cov_313.815370	497	577	1459	1	80	0.0125000
NODE_4206_length_1166_cov_313.815370	497	577	1462	1	80	0.0125000
NODE_4206_length_1166_cov_313.815370	497	577	1474	1	80	0.0125000
NODE_4206_length_1166_cov_313.815370	497	577	1475	1	80	0.0125000
NODE_4206_length_1166_cov_313.815370	497	577	1476	6	80	0.0750000
NODE_4206_length_1166_cov_313.815370	497	577	1478	7	80	0.0875000
NODE_4206_length_1166_cov_313.815370	497	577	1479	3	80	0.0375000
NODE_4206_length_1166_cov_313.815370	497	577	1481	4	80	0.0500000
NODE_4206_length_1166_cov_313.815370	497	577	1482	5	80	0.0625000
NODE_4206_length_1166_cov_313.815370	497	577	1483	3	80	0.0375000
NODE_4206_length_1166_cov_313.815370	497	577	1485	2	80	0.0250000
NODE_4206_length_1166_cov_313.815370	497	577	1487	3	80	0.0375000
NODE_4206_length_1166_cov_313.815370	497	577	1488	2	80	0.0250000
NODE_4206_length_1166_cov_313.815370	497	577	1489	1	80	0.0125000
NODE_4206_length_1166_cov_313.815370	497	577	1493	1	80	0.0125000
NODE_4206_length_1166_cov_313.815370	497	577	1494	1	80	0.0125000
NODE_4206_length_1166_cov_313.815370	497	577	1116	1	80	0.0125000
NODE_4206_length_1166_cov_313.815370	497	577	1135	1	80	0.0125000
NODE_4206_length_1166_cov_313.815370	497	577	1147	1	80	0.0125000
NODE_4206_length_1166_cov_313.815370	497	577	1152	1	80	0.0125000
NODE_4206_length_1166_cov_313.815370	497	577	1172	1	80	0.0125000
NODE_4206_length_1166_cov_313.815370	497	577	1210	1	80	0.0125000
NODE_4206_length_1166_cov_313.815370	497	577	1223	1	80	0.0125000
NODE_4206_length_1166_cov_313.815370	497	577	1252	1	80	0.0125000
NODE_4206_length_1166_cov_313.815370	497	577	1263	1	80	0.0125000
NODE_4206_length_1166_cov_313.815370	497	577	1282	1	80	0.0125000
NODE_4206_length_1166_cov_313.815370	497	577	1337	1	80	0.0125000
NODE_4206_length_1166_cov_313.815370	497	577	1338	1	80	0.0125000
NODE_4206_length_1166_cov_313.815370	497	577	1339	1	80	0.0125000
NODE_4206_length_1166_cov_313.815370	497	577	1351	1	80	0.0125000
NODE_4206_length_1166_cov_313.815370	497	577	1363	1	80	0.0125000
NODE_4206_length_1166_cov_313.815370	497	577	1371	1	80	0.0125000
NODE_4206_length_1166_cov_313.815370	497	577	1383	1	80	0.0125000
NODE_4206_length_1166_cov_313.815370	497	577	1393	1	80	0.0125000
NODE_4206_length_1166_cov_313.815370	497	577	1394	1	80	0.0125000
NODE_4206_length_1166_cov_313.815370	497	577	1415	1	80	0.0125000
NODE_4206_length_1166_cov_313.815370	497	577	1431	1	80	0.0125000
NODE_4206_length_1166_cov_313.815370	497	577	1432	1	80	0.0125000
NODE_4206_length_1166_cov_313.815370	497	577	1434	1	80	0.0125000
NODE_4206_length_1166_cov_313.815370	497	577	1437	2	80	0.0250000
NODE_4206_length_1166_cov_313.815370	497	577	1439	2	80	0.0250000
NODE_4206_length_1166_cov_313.815370	497	577	1440	2	80	0.0250000
NODE_4206_length_1166_cov_313.815370	497	577	1441	1	80	0.0125000
NODE_4206_length_1166_cov_313.815370	497	577	1448	1	80	0.0125000
NODE_4206_length_1166_cov_313.815370	497	577	1449	3	80	0.0375000
NODE_4206_length_1166_cov_313.815370	497	577	1452	1	80	0.0125000
NODE_4206_length_1166_cov_313.815370	497	577	1457	2	80	0.0250000
NODE_4206_length_1166_cov_313.815370	497	577	1458	1	80	0.0125000
NODE_4206_length_1166_cov_313.815370	497	577	1459	1	80	0.0125000
NODE_4206_length_1166_cov_313.815370	497	577	1462	1	80	0.0125000
NODE_4206_length_1166_cov_313.815370	497	577	1474	1	80	0.0125000
NODE_4206_length_1166_cov_313.815370	497	577	1475	1	80	0.0125000
NODE_4206_length_1166_cov_313.815370	497	577	1476	6	80	0.0750000
NODE_4206_length_1166_cov_313.815370	497	577	1478	7	80	0.0875000
NODE_4206_length_1166_cov_313.815370	497	577	1479	3	80	0.0375000
NODE_4206_length_1166_cov_313.815370	497	577	1481	4	80	0.0500000
NODE_4206_length_1166_cov_313.815370	497	577	1482	5	80	0.0625000
NODE_4206_length_1166_cov_313.815370	497	577	1483	3	80	0.0375000
NODE_4206_length_1166_cov_313.815370	497	577	1485	2	80	0.0250000
NODE_4206_length_1166_cov_313.815370	497	577	1487	3	80	0.0375000
NODE_4206_length_1166_cov_313.815370	497	577	1488	2	80	0.0250000
NODE_4206_length_1166_cov_313.815370	497	577	1489	1	80	0.0125000
NODE_4206_length_1166_cov_313.815370	497	577	1493	1	80	0.0125000
NODE_4206_length_1166_cov_313.815370	497	577	1494	1	80	0.0125000
NODE_4206_length_1166_cov_313.815370	497	577	1116	1	80	0.0125000
NODE_4206_length_1166_cov_313.815370	497	577	1135	1	80	0.0125000
NODE_4206_length_1166_cov_313.815370	497	577	1147	1	80	0.0125000
NODE_4206_length_1166_cov_313.815370	497	577	1152	1	80	0.0125000
NODE_4206_length_1166_cov_313.815370	497	577	1172	1	80	0.0125000
NODE_4206_length_1166_cov_313.815370	497	577	1210	1	80	0.0125000
NODE_4206_length_1166_cov_313.815370	497	577	1223	1	80	0.0125000
NODE_4206_length_1166_cov_313.815370	497	577	1252	1	80	0.0125000
NODE_4206_length_1166_cov_313.815370	497	577	1263	1	80	0.0125000
NODE_4206_length_1166_cov_313.815370	497	577	1282	1	80	0.0125000
NODE_4206_length_1166_cov_313.815370	497	577	1337	1	80	0.0125000
NODE_4206_length_1166_cov_313.815370	497	577	1338	1	80	0.0125000
NODE_4206_length_1166_cov_313.815370	497	577	1339	1	80	0.0125000
NODE_4206_length_1166_cov_313.815370	497	577	1351	1	80	0.0125000
NODE_4206_length_1166_cov_313.815370	497	577	1363	1	80	0.0125000
NODE_4206_length_1166_cov_313.815370	497	577	1371	1	80	0.0125000
NODE_4206_length_1166_cov_313.815370	497	577	1383	1	80	0.0125000
NODE_4206_length_1166_cov_313.815370	497	577	1393	1	80	0.0125000
NODE_4206_length_1166_cov_313.815370	497	577	1394	1	80	0.0125000
NODE_4206_length_1166_cov_313.815370	497	577	1415	1	80	0.0125000
NODE_4206_length_1166_cov_313.815370	497	577	1431	1	80	0.0125000
NODE_4206_length_1166_cov_313.815370	497	577	1432	1	80	0.0125000
NODE_4206_length_1166_cov_313.815370	497	577	1434	1	80	0.0125000
NODE_4206_length_1166_cov_313.815370	497	577	1437	2	80	0.0250000
NODE_4206_length_1166_cov_313.815370	497	577	1439	2	80	0.0250000
NODE_4206_length_1166_cov_313.815370	497	577	1440	2	80	0.0250000
NODE_4206_length_1166_cov_313.815370	497	577	1441	1	80	0.0125000
NODE_4206_length_1166_cov_313.815370	497	577	1448	1	80	0.0125000
NODE_4206_length_1166_cov_313.815370	497	577	1449	3	80	0.0375000
NODE_4206_length_1166_cov_313.815370	497	577	1452	1	80	0.0125000
NODE_4206_length_1166_cov_313.815370	497	577	1457	2	80	0.0250000
NODE_4206_length_1166_cov_313.815370	497	577	1458	1	80	0.0125000
NODE_4206_length_1166_cov_313.815370	497	577	1459	1	80	0.0125000
NODE_4206_length_1166_cov_313.815370	497	577	1462	1	80	0.0125000
NODE_4206_length_1166_cov_313.815370	497	577	1474	1	80	0.0125000
NODE_4206_length_1166_cov_313.815370	497	577	1475	1	80	0.0125000
NODE_4206_length_1166_cov_313.815370	497	577	1476	6	80	0.0750000
NODE_4206_length_1166_cov_313.815370	497	577	1478	7	80	0.0875000
NODE_4206_length_1166_cov_313.815370	497	577	1479	3	80	0.0375000
NODE_4206_length_1166_cov_313.815370	497	577	1481	4	80	0.0500000
NODE_4206_length_1166_cov_313.815370	497	577	1482	5	80	0.0625000
NODE_4206_length_1166_cov_313.815370	497	577	1483	3	80	0.0375000
NODE_4206_length_1166_cov_313.815370	497	577	1485	2	80	0.0250000
NODE_4206_length_1166_cov_313.815370	497	577	1487	3	80	0.0375000
NODE_4206_length_1166_cov_313.815370	497	577	1488	2	80	0.0250000
NODE_4206_length_1166_cov_313.815370	497	577	1489	1	80	0.0125000
NODE_4206_length_1166_cov_313.815370	497	577	1493	1	80	0.0125000
NODE_4206_length_1166_cov_313.815370	497	577	1494	1	80	0.0125000
NODE_4206_length_1166_cov_313.815370	497	568	1116	1	71	0.0140845
NODE_4206_length_1166_cov_313.815370	497	568	1135	1	71	0.0140845
NODE_4206_length_1166_cov_313.815370	497	568	1147	1	71	0.0140845
NODE_4206_length_1166_cov_313.815370	497	568	1152	1	71	0.0140845
NODE_4206_length_1166_cov_313.815370	497	568	1172	1	71	0.0140845
NODE_4206_length_1166_cov_313.815370	497	568	1210	1	71	0.0140845
NODE_4206_length_1166_cov_313.815370	497	568	1223	1	71	0.0140845
NODE_4206_length_1166_cov_313.815370	497	568	1252	1	71	0.0140845
NODE_4206_length_1166_cov_313.815370	497	568	1263	1	71	0.0140845
NODE_4206_length_1166_cov_313.815370	497	568	1282	1	71	0.0140845
NODE_4206_length_1166_cov_313.815370	497	568	1337	1	71	0.0140845
NODE_4206_length_1166_cov_313.815370	497	568	1338	1	71	0.0140845
NODE_4206_length_1166_cov_313.815370	497	568	1339	1	71	0.0140845
NODE_4206_length_1166_cov_313.815370	497	568	1351	1	71	0.0140845
NODE_4206_length_1166_cov_313.815370	497	568	1363	1	71	0.0140845
NODE_4206_length_1166_cov_313.815370	497	568	1371	1	71	0.0140845
NODE_4206_length_1166_cov_313.815370	497	568	1383	1	71	0.0140845
NODE_4206_length_1166_cov_313.815370	497	568	1393	1	71	0.0140845
NODE_4206_length_1166_cov_313.815370	497	568	1394	1	71	0.0140845
NODE_4206_length_1166_cov_313.815370	497	568	1415	1	71	0.0140845
NODE_4206_length_1166_cov_313.815370	497	568	1431	1	71	0.0140845
NODE_4206_length_1166_cov_313.815370	497	568	1432	1	71	0.0140845
NODE_4206_length_1166_cov_313.815370	497	568	1434	1	71	0.0140845
NODE_4206_length_1166_cov_313.815370	497	568	1437	1	71	0.0140845
NODE_4206_length_1166_cov_313.815370	497	568	1440	1	71	0.0140845
NODE_4206_length_1166_cov_313.815370	497	568	1441	1	71	0.0140845
NODE_4206_length_1166_cov_313.815370	497	568	1452	1	71	0.0140845
NODE_4206_length_1166_cov_313.815370	497	568	1457	2	71	0.0281690
NODE_4206_length_1166_cov_313.815370	497	568	1459	1	71	0.0140845
NODE_4206_length_1166_cov_313.815370	497	568	1462	1	71	0.0140845
NODE_4206_length_1166_cov_313.815370	497	568	1474	1	71	0.0140845
NODE_4206_length_1166_cov_313.815370	497	568	1475	1	71	0.0140845
NODE_4206_length_1166_cov_313.815370	497	568	1476	6	71	0.0845070
NODE_4206_length_1166_cov_313.815370	497	568	1478	7	71	0.0985916
NODE_4206_length_1166_cov_313.815370	497	568	1479	3	71	0.0422535
NODE_4206_length_1166_cov_313.815370	497	568	1481	4	71	0.0563380
NODE_4206_length_1166_cov_313.815370	497	568	1482	5	71	0.0704225
NODE_4206_length_1166_cov_313.815370	497	568	1483	3	71	0.0422535
NODE_4206_length_1166_cov_313.815370	497	568	1485	2	71	0.0281690
NODE_4206_length_1166_cov_313.815370	497	568	1487	3	71	0.0422535
NODE_4206_length_1166_cov_313.815370	497	568	1488	2	71	0.0281690
NODE_4206_length_1166_cov_313.815370	497	568	1489	1	71	0.0140845
NODE_4206_length_1166_cov_313.815370	497	568	1493	1	71	0.0140845
NODE_4206_length_1166_cov_313.815370	497	568	1494	1	71	0.0140845
NODE_4206_length_1166_cov_313.815370	500	570	1152	1	70	0.0142857
NODE_4206_length_1166_cov_313.815370	500	570	1172	1	70	0.0142857
NODE_4206_length_1166_cov_313.815370	500	570	1210	1	70	0.0142857
NODE_4206_length_1166_cov_313.815370	500	570	1223	1	70	0.0142857
NODE_4206_length_1166_cov_313.815370	500	570	1252	1	70	0.0142857
NODE_4206_length_1166_cov_313.815370	500	570	1263	1	70	0.0142857
NODE_4206_length_1166_cov_313.815370	500	570	1282	1	70	0.0142857
NODE_4206_length_1166_cov_313.815370	500	570	1337	1	70	0.0142857
NODE_4206_length_1166_cov_313.815370	500	570	1338	1	70	0.0142857
NODE_4206_length_1166_cov_313.815370	500	570	1339	1	70	0.0142857
NODE_4206_length_1166_cov_313.815370	500	570	1351	1	70	0.0142857
NODE_4206_length_1166_cov_313.815370	500	570	1363	1	70	0.0142857
NODE_4206_length_1166_cov_313.815370	500	570	1371	1	70	0.0142857
NODE_4206_length_1166_cov_313.815370	500	570	1383	1	70	0.0142857
NODE_4206_length_1166_cov_313.815370	500	570	1393	1	70	0.0142857
NODE_4206_length_1166_cov_313.815370	500	570	1394	1	70	0.0142857
NODE_4206_length_1166_cov_313.815370	500	570	1415	1	70	0.0142857
NODE_4206_length_1166_cov_313.815370	500	570	1431	1	70	0.0142857
NODE_4206_length_1166_cov_313.815370	500	570	1432	1	70	0.0142857
NODE_4206_length_1166_cov_313.815370	500	570	1434	1	70	0.0142857
NODE_4206_length_1166_cov_313.815370	500	570	1437	1	70	0.0142857
NODE_4206_length_1166_cov_313.815370	500	570	1440	1	70	0.0142857
NODE_4206_length_1166_cov_313.815370	500	570	1441	1	70	0.0142857
NODE_4206_length_1166_cov_313.815370	500	570	1449	1	70	0.0142857
NODE_4206_length_1166_cov_313.815370	500	570	1452	1	70	0.0142857
NODE_4206_length_1166_cov_313.815370	500	570	1457	2	70	0.0285714
NODE_4206_length_1166_cov_313.815370	500	570	1458	1	70	0.0142857
NODE_4206_length_1166_cov_313.815370	500	570	1459	1	70	0.0142857
NODE_4206_length_1166_cov_313.815370	500	570	1462	1	70	0.0142857
NODE_4206_length_1166_cov_313.815370	500	570	1474	1	70	0.0142857
NODE_4206_length_1166_cov_313.815370	500	570	1475	1	70	0.0142857
NODE_4206_length_1166_cov_313.815370	500	570	1476	6	70	0.0857143
NODE_4206_length_1166_cov_313.815370	500	570	1478	7	70	0.1000000
NODE_4206_length_1166_cov_313.815370	500	570	1479	3	70	0.0428571
NODE_4206_length_1166_cov_313.815370	500	570	1481	4	70	0.0571429
NODE_4206_length_1166_cov_313.815370	500	570	1482	5	70	0.0714286
NODE_4206_length_1166_cov_313.815370	500	570	1483	3	70	0.0428571
NODE_4206_length_1166_cov_313.815370	500	570	1485	2	70	0.0285714
NODE_4206_length_1166_cov_313.815370	500	570	1487	3	70	0.0428571
NODE_4206_length_1166_cov_313.815370	500	570	1488	2	70	0.0285714
NODE_4206_length_1166_cov_313.815370	500	570	1489	1	70	0.0142857
NODE_4206_length_1166_cov_313.815370	500	570	1493	1	70	0.0142857
NODE_4206_length_1166_cov_313.815370	500	570	1494	1	70	0.0142857
NODE_4206_length_1166_cov_313.815370	997	1077	22	11	80	0.1375000
NODE_4206_length_1166_cov_313.815370	997	1077	24	4	80	0.0500000
NODE_4206_length_1166_cov_313.815370	997	1077	26	2	80	0.0250000
NODE_4206_length_1166_cov_313.815370	997	1077	34	13	80	0.1625000
NODE_4206_length_1166_cov_313.815370	997	1077	36	24	80	0.3000000
NODE_4206_length_1166_cov_313.815370	997	1077	41	26	80	0.3250000
NODE_4206_length_1166_cov_313.815370	1050	1130	23	6	80	0.0750000
NODE_4206_length_1166_cov_313.815370	1050	1130	25	8	80	0.1000000
NODE_4206_length_1166_cov_313.815370	1050	1130	31	13	80	0.1625000
NODE_4206_length_1166_cov_313.815370	1050	1130	34	1	80	0.0125000
NODE_4206_length_1166_cov_313.815370	1050	1130	35	16	80	0.2000000
NODE_4206_length_1166_cov_313.815370	1050	1130	40	1	80	0.0125000
NODE_4206_length_1166_cov_313.815370	1050	1130	41	35	80	0.4375000
NODE_4206_length_1166_cov_313.815370	1050	1130	23	6	80	0.0750000
NODE_4206_length_1166_cov_313.815370	1050	1130	25	8	80	0.1000000
NODE_4206_length_1166_cov_313.815370	1050	1130	31	13	80	0.1625000
NODE_4206_length_1166_cov_313.815370	1050	1130	34	1	80	0.0125000
NODE_4206_length_1166_cov_313.815370	1050	1130	35	16	80	0.2000000
NODE_4206_length_1166_cov_313.815370	1050	1130	40	1	80	0.0125000
NODE_4206_length_1166_cov_313.815370	1050	1130	41	35	80	0.4375000
NODE_4206_length_1166_cov_313.815370	1050	1121	25	5	71	0.0704225
NODE_4206_length_1166_cov_313.815370	1050	1121	31	13	71	0.1830986
NODE_4206_length_1166_cov_313.815370	1050	1121	34	1	71	0.0140845
NODE_4206_length_1166_cov_313.815370	1050	1121	35	16	71	0.2253521
NODE_4206_length_1166_cov_313.815370	1050	1121	40	1	71	0.0140845
NODE_4206_length_1166_cov_313.815370	1050	1121	41	35	71	0.4929577
NODE_4207_length_1166_cov_25.107779	561	641	0	80	80	1.0000000
NODE_4207_length_1166_cov_25.107779	614	694	0	80	80	1.0000000
NODE_4209_length_1166_cov_18.820056	325	405	0	80	80	1.0000000
NODE_4209_length_1166_cov_18.820056	378	458	0	80	80	1.0000000
NODE_4210_length_1166_cov_18.404873	676	756	0	80	80	1.0000000
NODE_4210_length_1166_cov_18.404873	729	809	0	80	80	1.0000000
NODE_4214_length_1166_cov_1.893158	0	71	0	71	71	1.0000000
NODE_4214_length_1166_cov_1.893158	44	99	0	55	55	1.0000000
NODE_4218_length_1165_cov_29.402439	497	577	0	80	80	1.0000000
NODE_4218_length_1165_cov_29.402439	550	630	0	46	80	0.5750000
NODE_4218_length_1165_cov_29.402439	550	630	5	1	80	0.0125000
NODE_4218_length_1165_cov_29.402439	550	630	6	33	80	0.4125000
NODE_4218_length_1165_cov_29.402439	626	706	6	80	80	1.0000000
NODE_4218_length_1165_cov_29.402439	679	759	0	34	80	0.4250000
NODE_4218_length_1165_cov_29.402439	679	759	5	1	80	0.0125000
NODE_4218_length_1165_cov_29.402439	679	759	6	45	80	0.5625000
NODE_4219_length_1165_cov_28.366792	663	743	4	80	80	1.0000000
NODE_4219_length_1165_cov_28.366792	716	796	0	44	80	0.5500000
NODE_4219_length_1165_cov_28.366792	716	796	4	36	80	0.4500000
NODE_4220_length_1165_cov_23.841463	631	711	0	80	80	1.0000000
NODE_4220_length_1165_cov_23.841463	684	765	0	81	81	1.0000000
NODE_4220_length_1165_cov_23.841463	761	841	0	53	80	0.6625000
NODE_4220_length_1165_cov_23.841463	761	841	6	27	80	0.3375000
NODE_4220_length_1165_cov_23.841463	814	894	6	80	80	1.0000000
NODE_4221_length_1165_cov_21.883677	482	562	2	21	80	0.2625000
NODE_4221_length_1165_cov_21.883677	482	562	6	34	80	0.4250000
NODE_4221_length_1165_cov_21.883677	482	562	8	25	80	0.3125000
NODE_4221_length_1165_cov_21.883677	535	615	0	29	80	0.3625000
NODE_4221_length_1165_cov_21.883677	535	615	6	51	80	0.6375000
NODE_4222_length_1165_cov_14.591932	295	375	0	80	80	1.0000000
NODE_4222_length_1165_cov_14.591932	348	428	0	80	80	1.0000000
NODE_4223_length_1165_cov_13.683865	502	582	0	80	80	1.0000000
NODE_4223_length_1165_cov_13.683865	555	635	0	80	80	1.0000000
NODE_4224_length_1165_cov_7.915572	383	463	0	80	80	1.0000000
NODE_4224_length_1165_cov_7.915572	436	516	0	80	80	1.0000000
NODE_4225_length_1165_cov_7.466229	552	632	2	47	80	0.5875000
NODE_4225_length_1165_cov_7.466229	552	632	4	33	80	0.4125000
NODE_4225_length_1165_cov_7.466229	605	685	0	23	80	0.2875000
NODE_4225_length_1165_cov_7.466229	605	685	2	57	80	0.7125000
NODE_4226_length_1165_cov_5.617261	676	756	0	80	80	1.0000000
NODE_4226_length_1165_cov_5.617261	729	809	0	80	80	1.0000000
NODE_4227_length_1165_cov_3.658537	554	602	0	48	48	1.0000000
NODE_4233_length_1164_cov_55.273239	459	539	6	1	80	0.0125000
NODE_4233_length_1164_cov_55.273239	459	539	20	15	80	0.1875000
NODE_4233_length_1164_cov_55.273239	459	539	21	37	80	0.4625000
NODE_4233_length_1164_cov_55.273239	459	539	22	27	80	0.3375000
NODE_4233_length_1164_cov_55.273239	512	592	16	10	80	0.1250000
NODE_4233_length_1164_cov_55.273239	512	592	22	54	80	0.6750000
NODE_4233_length_1164_cov_55.273239	512	592	29	16	80	0.2000000
NODE_4234_length_1164_cov_44.183099	571	651	0	13	80	0.1625000
NODE_4234_length_1164_cov_44.183099	571	651	2	56	80	0.7000000
NODE_4234_length_1164_cov_44.183099	571	651	14	11	80	0.1375000
NODE_4234_length_1164_cov_44.183099	624	704	2	16	80	0.2000000
NODE_4234_length_1164_cov_44.183099	624	704	12	53	80	0.6625000
NODE_4234_length_1164_cov_44.183099	624	704	14	11	80	0.1375000
NODE_4234_length_1164_cov_44.183099	700	780	11	57	80	0.7125000
NODE_4234_length_1164_cov_44.183099	700	780	12	23	80	0.2875000
NODE_4234_length_1164_cov_44.183099	753	833	0	53	80	0.6625000
NODE_4234_length_1164_cov_44.183099	753	833	11	27	80	0.3375000
NODE_4235_length_1164_cov_14.277934	1029	1109	10	6	80	0.0750000
NODE_4235_length_1164_cov_14.277934	1029	1109	12	7	80	0.0875000
NODE_4235_length_1164_cov_14.277934	1029	1109	14	5	80	0.0625000
NODE_4235_length_1164_cov_14.277934	1029	1109	16	13	80	0.1625000
NODE_4235_length_1164_cov_14.277934	1029	1109	20	49	80	0.6125000
NODE_4235_length_1164_cov_14.277934	1097	1162	0	4	65	0.0615385
NODE_4235_length_1164_cov_14.277934	1097	1162	2	1	65	0.0153846
NODE_4235_length_1164_cov_14.277934	1097	1162	6	19	65	0.2923077
NODE_4235_length_1164_cov_14.277934	1097	1162	8	13	65	0.2000000
NODE_4235_length_1164_cov_14.277934	1097	1162	10	22	65	0.3384615
NODE_4235_length_1164_cov_14.277934	1097	1162	20	6	65	0.0923077
NODE_4236_length_1164_cov_12.880751	415	495	0	60	80	0.7500000
NODE_4236_length_1164_cov_12.880751	415	495	2	20	80	0.2500000
NODE_4236_length_1164_cov_12.880751	468	548	0	7	80	0.0875000
NODE_4236_length_1164_cov_12.880751	468	548	2	73	80	0.9125000
NODE_4237_length_1164_cov_6.924883	415	495	0	80	80	1.0000000
NODE_4237_length_1164_cov_6.924883	468	548	0	80	80	1.0000000
NODE_4245_length_1163_cov_36.315789	458	538	0	16	80	0.2000000
NODE_4245_length_1163_cov_36.315789	458	538	1	2	80	0.0250000
NODE_4245_length_1163_cov_36.315789	458	538	2	10	80	0.1250000
NODE_4245_length_1163_cov_36.315789	458	538	4	52	80	0.6500000
NODE_4245_length_1163_cov_36.315789	511	591	4	80	80	1.0000000
NODE_4245_length_1163_cov_36.315789	587	667	0	41	80	0.5125000
NODE_4245_length_1163_cov_36.315789	587	667	1	2	80	0.0250000
NODE_4245_length_1163_cov_36.315789	587	667	2	24	80	0.3000000
NODE_4245_length_1163_cov_36.315789	587	667	4	13	80	0.1625000
NODE_4245_length_1163_cov_36.315789	640	720	0	80	80	1.0000000
NODE_4246_length_1163_cov_29.466165	542	622	6	80	80	1.0000000
NODE_4246_length_1163_cov_29.466165	595	675	0	48	80	0.6000000
NODE_4246_length_1163_cov_29.466165	595	675	6	32	80	0.4000000
NODE_4246_length_1163_cov_29.466165	671	751	0	80	80	1.0000000
NODE_4246_length_1163_cov_29.466165	724	804	0	80	80	1.0000000
NODE_4247_length_1163_cov_15.107143	668	748	0	28	80	0.3500000
NODE_4247_length_1163_cov_15.107143	668	748	2	52	80	0.6500000
NODE_4247_length_1163_cov_15.107143	721	801	0	80	80	1.0000000
NODE_4248_length_1163_cov_14.347744	540	620	0	12	80	0.1500000
NODE_4248_length_1163_cov_14.347744	540	620	2	68	80	0.8500000
NODE_4248_length_1163_cov_14.347744	593	673	0	65	80	0.8125000
NODE_4248_length_1163_cov_14.347744	593	673	2	15	80	0.1875000
NODE_4249_length_1163_cov_11.650376	354	434	0	80	80	1.0000000
NODE_4249_length_1163_cov_11.650376	407	487	0	80	80	1.0000000
NODE_4249_length_1163_cov_11.650376	738	818	0	63	80	0.7875000
NODE_4249_length_1163_cov_11.650376	738	818	2	17	80	0.2125000
NODE_4249_length_1163_cov_11.650376	791	871	0	10	80	0.1250000
NODE_4249_length_1163_cov_11.650376	791	871	2	70	80	0.8750000
NODE_4253_length_1162_cov_30.049859	359	439	0	22	80	0.2750000
NODE_4253_length_1162_cov_30.049859	359	439	4	23	80	0.2875000
NODE_4253_length_1162_cov_30.049859	359	439	5	35	80	0.4375000
NODE_4253_length_1162_cov_30.049859	412	492	5	59	80	0.7375000
NODE_4253_length_1162_cov_30.049859	412	492	6	21	80	0.2625000
NODE_4254_length_1162_cov_25.960489	440	520	0	5	80	0.0625000
NODE_4254_length_1162_cov_25.960489	440	520	2	75	80	0.9375000
NODE_4254_length_1162_cov_25.960489	493	573	0	40	80	0.5000000
NODE_4254_length_1162_cov_25.960489	493	573	2	40	80	0.5000000
NODE_4254_length_1162_cov_25.960489	569	649	0	50	80	0.6250000
NODE_4254_length_1162_cov_25.960489	569	649	2	30	80	0.3750000
NODE_4254_length_1162_cov_25.960489	622	702	0	9	80	0.1125000
NODE_4254_length_1162_cov_25.960489	622	702	2	71	80	0.8875000
NODE_4255_length_1162_cov_24.843838	523	603	0	80	80	1.0000000
NODE_4255_length_1162_cov_24.843838	576	656	0	80	80	1.0000000
NODE_4255_length_1162_cov_24.843838	652	732	0	63	80	0.7875000
NODE_4255_length_1162_cov_24.843838	652	732	2	17	80	0.2125000
NODE_4255_length_1162_cov_24.843838	705	785	0	10	80	0.1250000
NODE_4255_length_1162_cov_24.843838	705	785	2	19	80	0.2375000
NODE_4255_length_1162_cov_24.843838	705	785	4	51	80	0.6375000
NODE_4257_length_1162_cov_17.131703	302	382	0	80	80	1.0000000
NODE_4257_length_1162_cov_17.131703	355	435	0	80	80	1.0000000
NODE_4257_length_1162_cov_17.131703	431	511	0	80	80	1.0000000
NODE_4257_length_1162_cov_17.131703	484	564	0	80	80	1.0000000
NODE_4258_length_1162_cov_14.766698	630	710	0	80	80	1.0000000
NODE_4258_length_1162_cov_14.766698	683	763	0	29	80	0.3625000
NODE_4258_length_1162_cov_14.766698	683	763	2	51	80	0.6375000
NODE_4259_length_1162_cov_13.968015	423	503	2	57	80	0.7125000
NODE_4259_length_1162_cov_13.968015	423	503	4	23	80	0.2875000
NODE_4259_length_1162_cov_13.968015	476	556	0	5	80	0.0625000
NODE_4259_length_1162_cov_13.968015	476	556	2	75	80	0.9375000
NODE_4264_length_1162_cov_1.977422	855	926	0	71	71	1.0000000
NODE_4264_length_1162_cov_1.977422	908	977	0	69	69	1.0000000
NODE_4264_length_1162_cov_1.977422	908	977	0	69	69	1.0000000
NODE_4266_length_1161_cov_33.312618	456	536	2	17	80	0.2125000
NODE_4266_length_1161_cov_33.312618	456	536	4	26	80	0.3250000
NODE_4266_length_1161_cov_33.312618	456	536	6	37	80	0.4625000
NODE_4266_length_1161_cov_33.312618	509	587	4	16	78	0.2051282
NODE_4266_length_1161_cov_33.312618	509	587	6	62	78	0.7948718
NODE_4267_length_1161_cov_30.466102	594	674	0	56	80	0.7000000
NODE_4267_length_1161_cov_30.466102	594	674	2	24	80	0.3000000
NODE_4267_length_1161_cov_30.466102	647	727	0	3	80	0.0375000
NODE_4267_length_1161_cov_30.466102	647	727	2	77	80	0.9625000
NODE_4268_length_1161_cov_29.628060	426	506	0	61	80	0.7625000
NODE_4268_length_1161_cov_29.628060	426	506	2	19	80	0.2375000
NODE_4268_length_1161_cov_29.628060	479	559	0	8	80	0.1000000
NODE_4268_length_1161_cov_29.628060	479	559	2	72	80	0.9000000
NODE_4268_length_1161_cov_29.628060	603	683	0	78	80	0.9750000
NODE_4268_length_1161_cov_29.628060	603	683	2	2	80	0.0250000
NODE_4268_length_1161_cov_29.628060	656	736	0	80	80	1.0000000
NODE_4269_length_1161_cov_22.923729	492	572	0	29	80	0.3625000
NODE_4269_length_1161_cov_22.923729	492	572	2	51	80	0.6375000
NODE_4269_length_1161_cov_22.923729	545	625	0	22	80	0.2750000
NODE_4269_length_1161_cov_22.923729	545	625	2	58	80	0.7250000
NODE_4269_length_1161_cov_22.923729	621	701	0	80	80	1.0000000
NODE_4269_length_1161_cov_22.923729	674	754	0	80	80	1.0000000
NODE_4270_length_1161_cov_20.184557	480	560	0	80	80	1.0000000
NODE_4270_length_1161_cov_20.184557	533	613	0	80	80	1.0000000
NODE_4271_length_1161_cov_17.437853	375	455	0	80	80	1.0000000
NODE_4271_length_1161_cov_17.437853	428	508	0	80	80	1.0000000
NODE_4272_length_1161_cov_14.062147	375	455	2	36	80	0.4500000
NODE_4272_length_1161_cov_14.062147	375	455	5	26	80	0.3250000
NODE_4272_length_1161_cov_14.062147	375	455	7	18	80	0.2250000
NODE_4272_length_1161_cov_14.062147	428	508	5	9	80	0.1125000
NODE_4272_length_1161_cov_14.062147	428	508	6	27	80	0.3375000
NODE_4272_length_1161_cov_14.062147	428	508	7	32	80	0.4000000
NODE_4272_length_1161_cov_14.062147	428	508	8	12	80	0.1500000
NODE_4273_length_1161_cov_12.304143	381	461	0	80	80	1.0000000
NODE_4273_length_1161_cov_12.304143	434	514	0	80	80	1.0000000
NODE_4274_length_1161_cov_10.297552	598	678	0	80	80	1.0000000
NODE_4274_length_1161_cov_10.297552	651	731	0	80	80	1.0000000
NODE_4283_length_1160_cov_86.515551	613	693	2	21	80	0.2625000
NODE_4283_length_1160_cov_86.515551	613	693	4	15	80	0.1875000
NODE_4283_length_1160_cov_86.515551	613	693	16	1	80	0.0125000
NODE_4283_length_1160_cov_86.515551	613	693	17	19	80	0.2375000
NODE_4283_length_1160_cov_86.515551	613	693	34	9	80	0.1125000
NODE_4283_length_1160_cov_86.515551	613	693	35	1	80	0.0125000
NODE_4283_length_1160_cov_86.515551	613	693	36	14	80	0.1750000
NODE_4283_length_1160_cov_86.515551	666	746	17	3	80	0.0375000
NODE_4283_length_1160_cov_86.515551	666	746	33	2	80	0.0250000
NODE_4283_length_1160_cov_86.515551	666	746	34	17	80	0.2125000
NODE_4283_length_1160_cov_86.515551	666	746	35	15	80	0.1875000
NODE_4283_length_1160_cov_86.515551	666	746	36	18	80	0.2250000
NODE_4283_length_1160_cov_86.515551	666	746	38	1	80	0.0125000
NODE_4283_length_1160_cov_86.515551	666	746	39	1	80	0.0125000
NODE_4283_length_1160_cov_86.515551	666	746	40	1	80	0.0125000
NODE_4283_length_1160_cov_86.515551	666	746	41	2	80	0.0250000
NODE_4283_length_1160_cov_86.515551	666	746	42	2	80	0.0250000
NODE_4283_length_1160_cov_86.515551	666	746	43	4	80	0.0500000
NODE_4283_length_1160_cov_86.515551	666	746	44	2	80	0.0250000
NODE_4283_length_1160_cov_86.515551	666	746	49	12	80	0.1500000
NODE_4284_length_1160_cov_29.272385	526	606	0	80	80	1.0000000
NODE_4284_length_1160_cov_29.272385	579	659	0	80	80	1.0000000
NODE_4285_length_1160_cov_21.391140	767	847	0	80	80	1.0000000
NODE_4296_length_1159_cov_147.794340	911	991	292	1	80	0.0125000
NODE_4296_length_1159_cov_147.794340	911	991	296	1	80	0.0125000
NODE_4296_length_1159_cov_147.794340	911	991	302	1	80	0.0125000
NODE_4296_length_1159_cov_147.794340	911	991	328	1	80	0.0125000
NODE_4296_length_1159_cov_147.794340	911	991	341	1	80	0.0125000
NODE_4296_length_1159_cov_147.794340	911	991	342	2	80	0.0250000
NODE_4296_length_1159_cov_147.794340	911	991	343	1	80	0.0125000
NODE_4296_length_1159_cov_147.794340	911	991	344	1	80	0.0125000
NODE_4296_length_1159_cov_147.794340	911	991	345	1	80	0.0125000
NODE_4296_length_1159_cov_147.794340	911	991	346	2	80	0.0250000
NODE_4296_length_1159_cov_147.794340	911	991	347	1	80	0.0125000
NODE_4296_length_1159_cov_147.794340	911	991	349	2	80	0.0250000
NODE_4296_length_1159_cov_147.794340	911	991	351	2	80	0.0250000
NODE_4296_length_1159_cov_147.794340	911	991	352	1	80	0.0125000
NODE_4296_length_1159_cov_147.794340	911	991	356	1	80	0.0125000
NODE_4296_length_1159_cov_147.794340	911	991	358	1	80	0.0125000
NODE_4296_length_1159_cov_147.794340	911	991	369	2	80	0.0250000
NODE_4296_length_1159_cov_147.794340	911	991	370	2	80	0.0250000
NODE_4296_length_1159_cov_147.794340	911	991	372	1	80	0.0125000
NODE_4296_length_1159_cov_147.794340	911	991	379	1	80	0.0125000
NODE_4296_length_1159_cov_147.794340	911	991	399	1	80	0.0125000
NODE_4296_length_1159_cov_147.794340	911	991	419	1	80	0.0125000
NODE_4296_length_1159_cov_147.794340	911	991	442	1	80	0.0125000
NODE_4296_length_1159_cov_147.794340	911	991	455	1	80	0.0125000
NODE_4296_length_1159_cov_147.794340	911	991	478	1	80	0.0125000
NODE_4296_length_1159_cov_147.794340	911	991	486	1	80	0.0125000
NODE_4296_length_1159_cov_147.794340	911	991	492	1	80	0.0125000
NODE_4296_length_1159_cov_147.794340	911	991	493	1	80	0.0125000
NODE_4296_length_1159_cov_147.794340	911	991	495	1	80	0.0125000
NODE_4296_length_1159_cov_147.794340	911	991	499	1	80	0.0125000
NODE_4296_length_1159_cov_147.794340	911	991	500	1	80	0.0125000
NODE_4296_length_1159_cov_147.794340	911	991	503	1	80	0.0125000
NODE_4296_length_1159_cov_147.794340	911	991	507	1	80	0.0125000
NODE_4296_length_1159_cov_147.794340	911	991	514	1	80	0.0125000
NODE_4296_length_1159_cov_147.794340	911	991	526	2	80	0.0250000
NODE_4296_length_1159_cov_147.794340	911	991	531	1	80	0.0125000
NODE_4296_length_1159_cov_147.794340	911	991	541	1	80	0.0125000
NODE_4296_length_1159_cov_147.794340	911	991	554	1	80	0.0125000
NODE_4296_length_1159_cov_147.794340	911	991	558	1	80	0.0125000
NODE_4296_length_1159_cov_147.794340	911	991	560	1	80	0.0125000
NODE_4296_length_1159_cov_147.794340	911	991	561	2	80	0.0250000
NODE_4296_length_1159_cov_147.794340	911	991	563	2	80	0.0250000
NODE_4296_length_1159_cov_147.794340	911	991	566	1	80	0.0125000
NODE_4296_length_1159_cov_147.794340	911	991	572	1	80	0.0125000
NODE_4296_length_1159_cov_147.794340	911	991	573	1	80	0.0125000
NODE_4296_length_1159_cov_147.794340	911	991	578	1	80	0.0125000
NODE_4296_length_1159_cov_147.794340	911	991	583	2	80	0.0250000
NODE_4296_length_1159_cov_147.794340	911	991	586	1	80	0.0125000
NODE_4296_length_1159_cov_147.794340	911	991	588	2	80	0.0250000
NODE_4296_length_1159_cov_147.794340	911	991	589	3	80	0.0375000
NODE_4296_length_1159_cov_147.794340	911	991	591	2	80	0.0250000
NODE_4296_length_1159_cov_147.794340	911	991	592	1	80	0.0125000
NODE_4296_length_1159_cov_147.794340	911	991	593	2	80	0.0250000
NODE_4296_length_1159_cov_147.794340	911	991	594	3	80	0.0375000
NODE_4296_length_1159_cov_147.794340	911	991	595	3	80	0.0375000
NODE_4296_length_1159_cov_147.794340	911	991	596	2	80	0.0250000
NODE_4296_length_1159_cov_147.794340	911	991	600	2	80	0.0250000
NODE_4296_length_1159_cov_147.794340	911	991	602	1	80	0.0125000
NODE_4296_length_1159_cov_147.794340	911	991	607	1	80	0.0125000
NODE_4296_length_1159_cov_147.794340	964	1044	397	1	80	0.0125000
NODE_4296_length_1159_cov_147.794340	964	1044	400	1	80	0.0125000
NODE_4296_length_1159_cov_147.794340	964	1044	401	2	80	0.0250000
NODE_4296_length_1159_cov_147.794340	964	1044	403	1	80	0.0125000
NODE_4296_length_1159_cov_147.794340	964	1044	412	1	80	0.0125000
NODE_4296_length_1159_cov_147.794340	964	1044	415	1	80	0.0125000
NODE_4296_length_1159_cov_147.794340	964	1044	416	1	80	0.0125000
NODE_4296_length_1159_cov_147.794340	964	1044	424	1	80	0.0125000
NODE_4296_length_1159_cov_147.794340	964	1044	437	1	80	0.0125000
NODE_4296_length_1159_cov_147.794340	964	1044	445	2	80	0.0250000
NODE_4296_length_1159_cov_147.794340	964	1044	449	1	80	0.0125000
NODE_4296_length_1159_cov_147.794340	964	1044	451	1	80	0.0125000
NODE_4296_length_1159_cov_147.794340	964	1044	458	1	80	0.0125000
NODE_4296_length_1159_cov_147.794340	964	1044	467	1	80	0.0125000
NODE_4296_length_1159_cov_147.794340	964	1044	472	1	80	0.0125000
NODE_4296_length_1159_cov_147.794340	964	1044	487	1	80	0.0125000
NODE_4296_length_1159_cov_147.794340	964	1044	488	1	80	0.0125000
NODE_4296_length_1159_cov_147.794340	964	1044	497	2	80	0.0250000
NODE_4296_length_1159_cov_147.794340	964	1044	501	1	80	0.0125000
NODE_4296_length_1159_cov_147.794340	964	1044	516	1	80	0.0125000
NODE_4296_length_1159_cov_147.794340	964	1044	517	1	80	0.0125000
NODE_4296_length_1159_cov_147.794340	964	1044	518	2	80	0.0250000
NODE_4296_length_1159_cov_147.794340	964	1044	520	1	80	0.0125000
NODE_4296_length_1159_cov_147.794340	964	1044	522	1	80	0.0125000
NODE_4296_length_1159_cov_147.794340	964	1044	524	1	80	0.0125000
NODE_4296_length_1159_cov_147.794340	964	1044	526	1	80	0.0125000
NODE_4296_length_1159_cov_147.794340	964	1044	528	1	80	0.0125000
NODE_4296_length_1159_cov_147.794340	964	1044	529	2	80	0.0250000
NODE_4296_length_1159_cov_147.794340	964	1044	531	1	80	0.0125000
NODE_4296_length_1159_cov_147.794340	964	1044	533	1	80	0.0125000
NODE_4296_length_1159_cov_147.794340	964	1044	538	1	80	0.0125000
NODE_4296_length_1159_cov_147.794340	964	1044	552	1	80	0.0125000
NODE_4296_length_1159_cov_147.794340	964	1044	555	1	80	0.0125000
NODE_4296_length_1159_cov_147.794340	964	1044	564	1	80	0.0125000
NODE_4296_length_1159_cov_147.794340	964	1044	566	1	80	0.0125000
NODE_4296_length_1159_cov_147.794340	964	1044	570	1	80	0.0125000
NODE_4296_length_1159_cov_147.794340	964	1044	572	2	80	0.0250000
NODE_4296_length_1159_cov_147.794340	964	1044	577	2	80	0.0250000
NODE_4296_length_1159_cov_147.794340	964	1044	578	1	80	0.0125000
NODE_4296_length_1159_cov_147.794340	964	1044	583	2	80	0.0250000
NODE_4296_length_1159_cov_147.794340	964	1044	586	1	80	0.0125000
NODE_4296_length_1159_cov_147.794340	964	1044	588	2	80	0.0250000
NODE_4296_length_1159_cov_147.794340	964	1044	589	3	80	0.0375000
NODE_4296_length_1159_cov_147.794340	964	1044	591	2	80	0.0250000
NODE_4296_length_1159_cov_147.794340	964	1044	592	1	80	0.0125000
NODE_4296_length_1159_cov_147.794340	964	1044	593	3	80	0.0375000
NODE_4296_length_1159_cov_147.794340	964	1044	594	3	80	0.0375000
NODE_4296_length_1159_cov_147.794340	964	1044	595	6	80	0.0750000
NODE_4296_length_1159_cov_147.794340	964	1044	596	4	80	0.0500000
NODE_4296_length_1159_cov_147.794340	964	1044	600	2	80	0.0250000
NODE_4296_length_1159_cov_147.794340	964	1044	602	1	80	0.0125000
NODE_4296_length_1159_cov_147.794340	964	1044	604	1	80	0.0125000
NODE_4296_length_1159_cov_147.794340	964	1044	605	1	80	0.0125000
NODE_4296_length_1159_cov_147.794340	964	1044	607	1	80	0.0125000
NODE_4296_length_1159_cov_147.794340	964	1044	608	1	80	0.0125000
NODE_4297_length_1159_cov_57.566981	457	537	0	80	80	1.0000000
NODE_4297_length_1159_cov_57.566981	510	590	0	74	80	0.9250000
NODE_4297_length_1159_cov_57.566981	510	590	4	6	80	0.0750000
NODE_4297_length_1159_cov_57.566981	586	666	4	24	80	0.3000000
NODE_4297_length_1159_cov_57.566981	586	666	8	56	80	0.7000000
NODE_4297_length_1159_cov_57.566981	639	719	8	80	80	1.0000000
NODE_4298_length_1159_cov_44.053774	329	409	0	72	80	0.9000000
NODE_4298_length_1159_cov_44.053774	329	409	1	8	80	0.1000000
NODE_4298_length_1159_cov_44.053774	382	462	0	19	80	0.2375000
NODE_4298_length_1159_cov_44.053774	382	462	1	45	80	0.5625000
NODE_4298_length_1159_cov_44.053774	382	462	4	16	80	0.2000000
NODE_4298_length_1159_cov_44.053774	458	538	2	28	80	0.3500000
NODE_4298_length_1159_cov_44.053774	458	538	4	52	80	0.6500000
NODE_4298_length_1159_cov_44.053774	511	591	1	40	80	0.5000000
NODE_4298_length_1159_cov_44.053774	511	591	2	40	80	0.5000000
NODE_4299_length_1159_cov_40.194340	391	471	0	80	80	1.0000000
NODE_4299_length_1159_cov_40.194340	444	524	0	80	80	1.0000000
NODE_4301_length_1159_cov_25.919811	456	536	0	72	80	0.9000000
NODE_4301_length_1159_cov_25.919811	456	536	2	8	80	0.1000000
NODE_4301_length_1159_cov_25.919811	509	591	0	19	82	0.2317073
NODE_4301_length_1159_cov_25.919811	509	591	2	14	82	0.1707317
NODE_4301_length_1159_cov_25.919811	509	591	6	2	82	0.0243902
NODE_4301_length_1159_cov_25.919811	509	591	8	47	82	0.5731707
NODE_4302_length_1159_cov_18.306604	538	618	0	12	80	0.1500000
NODE_4302_length_1159_cov_18.306604	538	618	2	68	80	0.8500000
NODE_4302_length_1159_cov_18.306604	591	671	2	32	80	0.4000000
NODE_4302_length_1159_cov_18.306604	591	671	4	47	80	0.5875000
NODE_4302_length_1159_cov_18.306604	591	671	6	1	80	0.0125000
NODE_4303_length_1159_cov_14.457547	358	438	0	80	80	1.0000000
NODE_4303_length_1159_cov_14.457547	411	491	0	80	80	1.0000000
NODE_4304_length_1159_cov_11.566981	625	705	0	37	80	0.4625000
NODE_4304_length_1159_cov_11.566981	625	705	2	43	80	0.5375000
NODE_4304_length_1159_cov_11.566981	678	758	0	80	80	1.0000000
NODE_4305_length_1159_cov_9.927358	278	358	0	3	80	0.0375000
NODE_4305_length_1159_cov_9.927358	278	358	5	1	80	0.0125000
NODE_4305_length_1159_cov_9.927358	278	358	6	76	80	0.9500000
NODE_4305_length_1159_cov_9.927358	331	411	0	56	80	0.7000000
NODE_4305_length_1159_cov_9.927358	331	411	5	1	80	0.0125000
NODE_4305_length_1159_cov_9.927358	331	411	6	23	80	0.2875000
NODE_4314_length_1159_cov_1.568868	513	562	8	4	49	0.0816327
NODE_4314_length_1159_cov_1.568868	513	562	10	24	49	0.4897959
NODE_4314_length_1159_cov_1.568868	513	562	11	2	49	0.0408163
NODE_4314_length_1159_cov_1.568868	513	562	12	12	49	0.2448980
NODE_4314_length_1159_cov_1.568868	513	562	14	4	49	0.0816327
NODE_4314_length_1159_cov_1.568868	513	562	16	3	49	0.0612245
NODE_4316_length_1158_cov_33.529745	357	437	6	80	80	1.0000000
NODE_4316_length_1158_cov_33.529745	410	490	0	25	80	0.3125000
NODE_4316_length_1158_cov_33.529745	410	490	2	20	80	0.2500000
NODE_4316_length_1158_cov_33.529745	410	490	6	35	80	0.4375000
NODE_4316_length_1158_cov_33.529745	486	566	0	80	80	1.0000000
NODE_4316_length_1158_cov_33.529745	539	619	0	80	80	1.0000000
NODE_4317_length_1158_cov_31.368272	416	496	0	53	80	0.6625000
NODE_4317_length_1158_cov_31.368272	416	496	1	2	80	0.0250000
NODE_4317_length_1158_cov_31.368272	416	496	3	22	80	0.2750000
NODE_4317_length_1158_cov_31.368272	416	496	4	3	80	0.0375000
NODE_4317_length_1158_cov_31.368272	469	549	0	80	80	1.0000000
NODE_4317_length_1158_cov_31.368272	545	626	0	33	81	0.4074074
NODE_4317_length_1158_cov_31.368272	545	626	2	15	81	0.1851852
NODE_4317_length_1158_cov_31.368272	545	626	6	33	81	0.4074074
NODE_4317_length_1158_cov_31.368272	599	679	4	26	80	0.3250000
NODE_4317_length_1158_cov_31.368272	599	679	6	54	80	0.6750000
NODE_4318_length_1158_cov_31.240793	430	510	0	64	80	0.8000000
NODE_4318_length_1158_cov_31.240793	430	510	2	16	80	0.2000000
NODE_4318_length_1158_cov_31.240793	483	563	0	11	80	0.1375000
NODE_4318_length_1158_cov_31.240793	483	563	2	50	80	0.6250000
NODE_4318_length_1158_cov_31.240793	483	563	6	19	80	0.2375000
NODE_4318_length_1158_cov_31.240793	559	639	0	30	80	0.3750000
NODE_4318_length_1158_cov_31.240793	559	639	4	33	80	0.4125000
NODE_4318_length_1158_cov_31.240793	559	639	6	17	80	0.2125000
NODE_4318_length_1158_cov_31.240793	612	692	0	80	80	1.0000000
NODE_4319_length_1158_cov_29.216242	405	485	0	52	80	0.6500000
NODE_4319_length_1158_cov_29.216242	405	485	2	28	80	0.3500000
NODE_4319_length_1158_cov_29.216242	458	538	0	8	80	0.1000000
NODE_4319_length_1158_cov_29.216242	458	538	2	72	80	0.9000000
NODE_4320_length_1158_cov_25.245515	500	580	0	80	80	1.0000000
NODE_4320_length_1158_cov_25.245515	553	633	0	80	80	1.0000000
NODE_4320_length_1158_cov_25.245515	629	709	0	80	80	1.0000000
NODE_4320_length_1158_cov_25.245515	682	762	0	80	80	1.0000000
NODE_4321_length_1158_cov_16.566572	396	476	0	80	80	1.0000000
NODE_4321_length_1158_cov_16.566572	449	529	0	80	80	1.0000000
NODE_4322_length_1158_cov_13.092540	372	452	0	80	80	1.0000000
NODE_4322_length_1158_cov_13.092540	425	505	0	80	80	1.0000000
NODE_4322_length_1158_cov_13.092540	735	815	0	80	80	1.0000000
NODE_4322_length_1158_cov_13.092540	788	868	0	80	80	1.0000000
NODE_4323_length_1158_cov_7.408876	656	736	0	80	80	1.0000000
NODE_4323_length_1158_cov_7.408876	709	789	0	32	80	0.4000000
NODE_4323_length_1158_cov_7.408876	709	789	2	48	80	0.6000000
NODE_4324_length_1158_cov_6.242682	239	310	6	27	71	0.3802817
NODE_4324_length_1158_cov_6.242682	239	310	8	16	71	0.2253521
NODE_4324_length_1158_cov_6.242682	239	310	10	28	71	0.3943662
NODE_4325_length_1158_cov_6.043437	531	611	4	14	80	0.1750000
NODE_4325_length_1158_cov_6.043437	531	611	6	6	80	0.0750000
NODE_4325_length_1158_cov_6.043437	531	611	8	60	80	0.7500000
NODE_4325_length_1158_cov_6.043437	584	634	4	20	50	0.4000000
NODE_4325_length_1158_cov_6.043437	584	634	6	9	50	0.1800000
NODE_4325_length_1158_cov_6.043437	584	634	8	21	50	0.4200000
NODE_4326_length_1158_cov_5.855524	324	404	0	62	80	0.7750000
NODE_4326_length_1158_cov_5.855524	324	404	1	14	80	0.1750000
NODE_4326_length_1158_cov_5.855524	324	404	2	4	80	0.0500000
NODE_4326_length_1158_cov_5.855524	377	457	0	80	80	1.0000000
NODE_4329_length_1157_cov_32.233459	472	552	0	21	80	0.2625000
NODE_4329_length_1157_cov_32.233459	472	552	2	5	80	0.0625000
NODE_4329_length_1157_cov_32.233459	472	552	4	31	80	0.3875000
NODE_4329_length_1157_cov_32.233459	472	552	10	23	80	0.2875000
NODE_4329_length_1157_cov_32.233459	525	605	4	4	80	0.0500000
NODE_4329_length_1157_cov_32.233459	525	605	6	21	80	0.2625000
NODE_4329_length_1157_cov_32.233459	525	605	8	26	80	0.3250000
NODE_4329_length_1157_cov_32.233459	525	605	10	29	80	0.3625000
NODE_4329_length_1157_cov_32.233459	601	681	0	5	80	0.0625000
NODE_4329_length_1157_cov_32.233459	601	681	6	75	80	0.9375000
NODE_4329_length_1157_cov_32.233459	654	734	0	58	80	0.7250000
NODE_4329_length_1157_cov_32.233459	654	734	6	22	80	0.2750000
NODE_4330_length_1157_cov_6.438563	765	788	0	23	23	1.0000000
NODE_4332_length_1157_cov_4.068053	221	292	0	71	71	1.0000000
NODE_4333_length_1156_cov_46.381268	328	408	0	80	80	1.0000000
NODE_4333_length_1156_cov_46.381268	381	461	0	80	80	1.0000000
NODE_4333_length_1156_cov_46.381268	457	537	0	50	80	0.6250000
NODE_4333_length_1156_cov_46.381268	457	537	10	30	80	0.3750000
NODE_4333_length_1156_cov_46.381268	510	590	10	80	80	1.0000000
NODE_4334_length_1156_cov_32.198675	378	458	0	64	80	0.8000000
NODE_4334_length_1156_cov_32.198675	378	458	8	16	80	0.2000000
NODE_4334_length_1156_cov_32.198675	431	511	0	11	80	0.1375000
NODE_4334_length_1156_cov_32.198675	431	511	8	69	80	0.8625000
NODE_4334_length_1156_cov_32.198675	507	587	6	7	80	0.0875000
NODE_4334_length_1156_cov_32.198675	507	587	8	51	80	0.6375000
NODE_4334_length_1156_cov_32.198675	507	587	13	1	80	0.0125000
NODE_4334_length_1156_cov_32.198675	507	587	14	21	80	0.2625000
NODE_4334_length_1156_cov_32.198675	560	641	6	61	81	0.7530864
NODE_4334_length_1156_cov_32.198675	560	641	14	20	81	0.2469136
NODE_4335_length_1156_cov_12.683065	593	673	0	29	80	0.3625000
NODE_4335_length_1156_cov_12.683065	593	673	4	51	80	0.6375000
NODE_4335_length_1156_cov_12.683065	646	726	0	13	80	0.1625000
NODE_4335_length_1156_cov_12.683065	646	726	3	1	80	0.0125000
NODE_4335_length_1156_cov_12.683065	646	726	4	66	80	0.8250000
NODE_4336_length_1156_cov_9.287606	680	760	0	80	80	1.0000000
NODE_4336_length_1156_cov_9.287606	733	813	0	80	80	1.0000000
NODE_4339_length_1155_cov_19.570076	437	517	0	25	80	0.3125000
NODE_4339_length_1155_cov_19.570076	437	517	4	2	80	0.0250000
NODE_4339_length_1155_cov_19.570076	437	517	8	24	80	0.3000000
NODE_4339_length_1155_cov_19.570076	437	517	10	17	80	0.2125000
NODE_4339_length_1155_cov_19.570076	437	517	12	12	80	0.1500000
NODE_4339_length_1155_cov_19.570076	490	570	2	20	80	0.2500000
NODE_4339_length_1155_cov_19.570076	490	570	8	18	80	0.2250000
NODE_4339_length_1155_cov_19.570076	490	570	10	15	80	0.1875000
NODE_4339_length_1155_cov_19.570076	490	570	12	27	80	0.3375000
NODE_4340_length_1155_cov_18.666667	332	412	4	58	80	0.7250000
NODE_4340_length_1155_cov_18.666667	332	412	6	22	80	0.2750000
NODE_4340_length_1155_cov_18.666667	385	465	0	26	80	0.3250000
NODE_4340_length_1155_cov_18.666667	385	465	4	54	80	0.6750000
NODE_4346_length_1154_cov_61.769668	488	568	0	11	80	0.1375000
NODE_4346_length_1154_cov_61.769668	488	568	4	41	80	0.5125000
NODE_4346_length_1154_cov_61.769668	488	568	42	21	80	0.2625000
NODE_4346_length_1154_cov_61.769668	488	568	43	7	80	0.0875000
NODE_4346_length_1154_cov_61.769668	541	621	41	10	80	0.1250000
NODE_4346_length_1154_cov_61.769668	541	621	42	20	80	0.2500000
NODE_4346_length_1154_cov_61.769668	541	621	43	41	80	0.5125000
NODE_4346_length_1154_cov_61.769668	541	621	44	2	80	0.0250000
NODE_4346_length_1154_cov_61.769668	541	621	45	2	80	0.0250000
NODE_4346_length_1154_cov_61.769668	541	621	46	3	80	0.0375000
NODE_4346_length_1154_cov_61.769668	541	621	48	2	80	0.0250000
NODE_4347_length_1154_cov_50.909005	409	489	0	47	80	0.5875000
NODE_4347_length_1154_cov_50.909005	409	489	1	8	80	0.1000000
NODE_4347_length_1154_cov_50.909005	409	489	2	25	80	0.3125000
NODE_4347_length_1154_cov_50.909005	462	542	1	2	80	0.0250000
NODE_4347_length_1154_cov_50.909005	462	542	2	26	80	0.3250000
NODE_4347_length_1154_cov_50.909005	462	542	14	19	80	0.2375000
NODE_4347_length_1154_cov_50.909005	462	542	25	33	80	0.4125000
NODE_4347_length_1154_cov_50.909005	538	618	24	4	80	0.0500000
NODE_4347_length_1154_cov_50.909005	538	618	25	20	80	0.2500000
NODE_4347_length_1154_cov_50.909005	538	618	26	53	80	0.6625000
NODE_4347_length_1154_cov_50.909005	538	618	27	3	80	0.0375000
NODE_4347_length_1154_cov_50.909005	591	671	2	12	80	0.1500000
NODE_4347_length_1154_cov_50.909005	591	671	11	1	80	0.0125000
NODE_4347_length_1154_cov_50.909005	591	671	13	18	80	0.2250000
NODE_4347_length_1154_cov_50.909005	591	671	24	26	80	0.3250000
NODE_4347_length_1154_cov_50.909005	591	671	25	6	80	0.0750000
NODE_4347_length_1154_cov_50.909005	591	671	26	14	80	0.1750000
NODE_4347_length_1154_cov_50.909005	591	671	27	3	80	0.0375000
NODE_4348_length_1154_cov_28.941232	695	775	0	32	80	0.4000000
NODE_4348_length_1154_cov_28.941232	695	775	2	48	80	0.6000000
NODE_4348_length_1154_cov_28.941232	748	828	0	80	80	1.0000000
NODE_4349_length_1154_cov_13.765877	322	402	6	63	80	0.7875000
NODE_4349_length_1154_cov_13.765877	322	402	8	17	80	0.2125000
NODE_4349_length_1154_cov_13.765877	375	455	0	40	80	0.5000000
NODE_4349_length_1154_cov_13.765877	375	455	6	40	80	0.5000000
NODE_4351_length_1154_cov_5.930806	497	577	0	80	80	1.0000000
NODE_4351_length_1154_cov_5.930806	550	622	0	72	72	1.0000000
NODE_4357_length_1153_cov_65.486717	416	496	0	24	80	0.3000000
NODE_4357_length_1153_cov_65.486717	416	496	8	56	80	0.7000000
NODE_4357_length_1153_cov_65.486717	469	549	0	34	80	0.4250000
NODE_4357_length_1153_cov_65.486717	469	549	8	46	80	0.5750000
NODE_4357_length_1153_cov_65.486717	545	625	0	80	80	1.0000000
NODE_4357_length_1153_cov_65.486717	598	678	0	80	80	1.0000000
NODE_4358_length_1153_cov_50.733397	404	484	1	25	80	0.3125000
NODE_4358_length_1153_cov_50.733397	404	484	3	55	80	0.6875000
NODE_4358_length_1153_cov_50.733397	457	537	1	47	80	0.5875000
NODE_4358_length_1153_cov_50.733397	457	537	2	29	80	0.3625000
NODE_4358_length_1153_cov_50.733397	457	537	3	4	80	0.0500000
NODE_4358_length_1153_cov_50.733397	533	613	2	22	80	0.2750000
NODE_4358_length_1153_cov_50.733397	533	613	4	2	80	0.0250000
NODE_4358_length_1153_cov_50.733397	533	613	6	1	80	0.0125000
NODE_4358_length_1153_cov_50.733397	533	613	7	3	80	0.0375000
NODE_4358_length_1153_cov_50.733397	533	613	8	52	80	0.6500000
NODE_4358_length_1153_cov_50.733397	586	666	6	54	80	0.6750000
NODE_4358_length_1153_cov_50.733397	586	666	8	26	80	0.3250000
NODE_4359_length_1153_cov_26.131879	493	573	2	80	80	1.0000000
NODE_4359_length_1153_cov_26.131879	546	626	0	18	80	0.2250000
NODE_4359_length_1153_cov_26.131879	546	626	2	62	80	0.7750000
NODE_4360_length_1153_cov_10.195446	500	580	0	66	80	0.8250000
NODE_4360_length_1153_cov_10.195446	500	580	2	14	80	0.1750000
NODE_4360_length_1153_cov_10.195446	553	633	0	80	80	1.0000000
NODE_4361_length_1153_cov_8.286528	558	638	0	20	80	0.2500000
NODE_4361_length_1153_cov_8.286528	558	638	1	2	80	0.0250000
NODE_4361_length_1153_cov_8.286528	558	638	2	30	80	0.3750000
NODE_4361_length_1153_cov_8.286528	558	638	18	28	80	0.3500000
NODE_4361_length_1153_cov_8.286528	611	691	18	80	80	1.0000000
NODE_4368_length_1152_cov_19.800570	553	633	2	6	80	0.0750000
NODE_4368_length_1152_cov_19.800570	553	633	4	39	80	0.4875000
NODE_4368_length_1152_cov_19.800570	553	633	5	1	80	0.0125000
NODE_4368_length_1152_cov_19.800570	553	633	6	34	80	0.4250000
NODE_4368_length_1152_cov_19.800570	606	686	0	27	80	0.3375000
NODE_4368_length_1152_cov_19.800570	606	686	2	32	80	0.4000000
NODE_4368_length_1152_cov_19.800570	606	686	5	1	80	0.0125000
NODE_4368_length_1152_cov_19.800570	606	686	6	20	80	0.2500000
NODE_4369_length_1152_cov_19.365622	490	570	0	80	80	1.0000000
NODE_4369_length_1152_cov_19.365622	543	623	0	80	80	1.0000000
NODE_4370_length_1152_cov_18.654321	594	674	6	28	80	0.3500000
NODE_4370_length_1152_cov_18.654321	594	674	7	11	80	0.1375000
NODE_4370_length_1152_cov_18.654321	594	674	8	36	80	0.4500000
NODE_4370_length_1152_cov_18.654321	594	674	9	1	80	0.0125000
NODE_4370_length_1152_cov_18.654321	594	674	10	4	80	0.0500000
NODE_4370_length_1152_cov_18.654321	647	727	3	17	80	0.2125000
NODE_4370_length_1152_cov_18.654321	647	727	4	1	80	0.0125000
NODE_4370_length_1152_cov_18.654321	647	727	6	59	80	0.7375000
NODE_4370_length_1152_cov_18.654321	647	727	7	3	80	0.0375000
NODE_4371_length_1152_cov_18.075024	377	457	2	26	80	0.3250000
NODE_4371_length_1152_cov_18.075024	377	457	6	54	80	0.6750000
NODE_4371_length_1152_cov_18.075024	430	510	4	47	80	0.5875000
NODE_4371_length_1152_cov_18.075024	430	510	6	33	80	0.4125000
NODE_4371_length_1152_cov_18.075024	506	586	0	52	80	0.6500000
NODE_4371_length_1152_cov_18.075024	506	586	4	28	80	0.3500000
NODE_4371_length_1152_cov_18.075024	559	639	0	80	80	1.0000000
NODE_4373_length_1152_cov_16.047483	543	623	0	80	80	1.0000000
NODE_4373_length_1152_cov_16.047483	596	676	0	80	80	1.0000000
NODE_4373_length_1152_cov_16.047483	672	752	0	80	80	1.0000000
NODE_4373_length_1152_cov_16.047483	725	805	0	80	80	1.0000000
NODE_4374_length_1152_cov_13.981007	583	663	0	80	80	1.0000000
NODE_4374_length_1152_cov_13.981007	636	716	0	80	80	1.0000000
NODE_4380_length_1151_cov_30.469582	479	559	0	76	80	0.9500000
NODE_4380_length_1151_cov_30.469582	479	559	2	4	80	0.0500000
NODE_4380_length_1151_cov_30.469582	532	612	0	23	80	0.2875000
NODE_4380_length_1151_cov_30.469582	532	612	2	18	80	0.2250000
NODE_4380_length_1151_cov_30.469582	532	612	4	39	80	0.4875000
NODE_4381_length_1151_cov_26.650190	567	647	0	80	80	1.0000000
NODE_4381_length_1151_cov_26.650190	620	700	0	80	80	1.0000000
NODE_4382_length_1151_cov_26.375475	441	521	0	80	80	1.0000000
NODE_4382_length_1151_cov_26.375475	494	574	0	80	80	1.0000000
NODE_4382_length_1151_cov_26.375475	570	650	0	80	80	1.0000000
NODE_4382_length_1151_cov_26.375475	623	703	0	80	80	1.0000000
NODE_4383_length_1151_cov_23.614068	590	670	8	80	80	1.0000000
NODE_4383_length_1151_cov_23.614068	643	721	0	12	78	0.1538462
NODE_4383_length_1151_cov_23.614068	643	721	8	66	78	0.8461539
NODE_4384_length_1151_cov_18.693916	355	435	0	80	80	1.0000000
NODE_4384_length_1151_cov_18.693916	408	491	0	83	83	1.0000000
NODE_4385_length_1151_cov_16.093156	474	554	0	80	80	1.0000000
NODE_4385_length_1151_cov_16.093156	527	607	0	80	80	1.0000000
NODE_4386_length_1151_cov_13.782319	400	482	0	82	82	1.0000000
NODE_4386_length_1151_cov_13.782319	450	535	0	85	85	1.0000000
NODE_4392_length_1150_cov_38.601332	563	643	0	80	80	1.0000000
NODE_4392_length_1150_cov_38.601332	616	696	0	80	80	1.0000000
NODE_4392_length_1150_cov_38.601332	692	772	0	80	80	1.0000000
NODE_4392_length_1150_cov_38.601332	745	825	0	80	80	1.0000000
NODE_4393_length_1150_cov_15.741199	497	578	1	6	81	0.0740741
NODE_4393_length_1150_cov_15.741199	497	578	7	75	81	0.9259259
NODE_4393_length_1150_cov_15.741199	550	631	0	48	81	0.5925926
NODE_4393_length_1150_cov_15.741199	550	631	1	11	81	0.1358025
NODE_4393_length_1150_cov_15.741199	550	631	7	22	81	0.2716049
NODE_4394_length_1150_cov_11.132255	795	875	0	80	80	1.0000000
NODE_4394_length_1150_cov_11.132255	848	928	0	80	80	1.0000000
NODE_4395_length_1150_cov_9.253092	583	663	0	80	80	1.0000000
NODE_4395_length_1150_cov_9.253092	636	716	0	59	80	0.7375000
NODE_4395_length_1150_cov_9.253092	636	716	2	21	80	0.2625000
NODE_4398_length_1149_cov_17.289524	644	695	0	51	51	1.0000000
NODE_4399_length_1149_cov_13.805714	584	664	0	9	80	0.1125000
NODE_4399_length_1149_cov_13.805714	584	664	2	43	80	0.5375000
NODE_4399_length_1149_cov_13.805714	584	664	6	28	80	0.3500000
NODE_4399_length_1149_cov_13.805714	637	717	4	34	80	0.4250000
NODE_4399_length_1149_cov_13.805714	637	717	6	46	80	0.5750000
NODE_4399_length_1149_cov_13.805714	713	793	0	59	80	0.7375000
NODE_4399_length_1149_cov_13.805714	713	793	4	21	80	0.2625000
NODE_4399_length_1149_cov_13.805714	766	846	0	80	80	1.0000000
NODE_4407_length_1148_cov_27.674929	387	467	0	80	80	1.0000000
NODE_4407_length_1148_cov_27.674929	440	520	0	80	80	1.0000000
NODE_4408_length_1148_cov_13.275500	136	216	0	47	80	0.5875000
NODE_4408_length_1148_cov_13.275500	136	216	2	3	80	0.0375000
NODE_4408_length_1148_cov_13.275500	136	216	4	30	80	0.3750000
NODE_4408_length_1148_cov_13.275500	189	268	2	9	79	0.1139240
NODE_4408_length_1148_cov_13.275500	189	268	4	50	79	0.6329114
NODE_4408_length_1148_cov_13.275500	189	268	5	8	79	0.1012658
NODE_4408_length_1148_cov_13.275500	189	268	6	12	79	0.1518987
NODE_4409_length_1148_cov_10.613918	506	586	0	80	80	1.0000000
NODE_4409_length_1148_cov_10.613918	559	639	0	80	80	1.0000000
NODE_4415_length_1147_cov_33.543893	378	458	0	74	80	0.9250000
NODE_4415_length_1147_cov_33.543893	378	458	2	6	80	0.0750000
NODE_4415_length_1147_cov_33.543893	431	511	0	24	80	0.3000000
NODE_4415_length_1147_cov_33.543893	431	511	2	56	80	0.7000000
NODE_4416_length_1147_cov_26.858779	254	334	0	44	80	0.5500000
NODE_4416_length_1147_cov_26.858779	254	334	2	36	80	0.4500000
NODE_4416_length_1147_cov_26.858779	307	387	0	77	80	0.9625000
NODE_4416_length_1147_cov_26.858779	307	387	1	1	80	0.0125000
NODE_4416_length_1147_cov_26.858779	307	387	2	2	80	0.0250000
NODE_4416_length_1147_cov_26.858779	383	463	0	1	80	0.0125000
NODE_4416_length_1147_cov_26.858779	383	463	1	1	80	0.0125000
NODE_4416_length_1147_cov_26.858779	383	463	2	8	80	0.1000000
NODE_4416_length_1147_cov_26.858779	383	463	4	26	80	0.3250000
NODE_4416_length_1147_cov_26.858779	383	463	8	44	80	0.5500000
NODE_4416_length_1147_cov_26.858779	436	516	2	10	80	0.1250000
NODE_4416_length_1147_cov_26.858779	436	516	6	42	80	0.5250000
NODE_4416_length_1147_cov_26.858779	436	516	8	28	80	0.3500000
NODE_4417_length_1147_cov_24.227099	606	686	0	80	80	1.0000000
NODE_4417_length_1147_cov_24.227099	659	739	0	80	80	1.0000000
NODE_4417_length_1147_cov_24.227099	735	815	0	13	80	0.1625000
NODE_4417_length_1147_cov_24.227099	735	815	2	67	80	0.8375000
NODE_4417_length_1147_cov_24.227099	788	868	0	8	80	0.1000000
NODE_4417_length_1147_cov_24.227099	788	868	2	72	80	0.9000000
NODE_4418_length_1147_cov_16.559160	417	497	0	60	80	0.7500000
NODE_4418_length_1147_cov_16.559160	417	497	2	20	80	0.2500000
NODE_4418_length_1147_cov_16.559160	470	550	0	7	80	0.0875000
NODE_4418_length_1147_cov_16.559160	470	550	2	73	80	0.9125000
NODE_4428_length_1146_cov_52.393505	411	491	0	80	80	1.0000000
NODE_4428_length_1146_cov_52.393505	464	544	0	80	80	1.0000000
NODE_4428_length_1146_cov_52.393505	540	620	0	80	80	1.0000000
NODE_4428_length_1146_cov_52.393505	593	673	0	80	80	1.0000000
NODE_4429_length_1146_cov_46.364852	233	313	0	80	80	1.0000000
NODE_4429_length_1146_cov_46.364852	286	366	0	80	80	1.0000000
NODE_4430_length_1146_cov_26.159503	476	556	4	61	80	0.7625000
NODE_4430_length_1146_cov_26.159503	476	556	6	19	80	0.2375000
NODE_4430_length_1146_cov_26.159503	529	609	0	29	80	0.3625000
NODE_4430_length_1146_cov_26.159503	529	609	2	12	80	0.1500000
NODE_4430_length_1146_cov_26.159503	529	609	4	39	80	0.4875000
NODE_4430_length_1146_cov_26.159503	605	685	2	80	80	1.0000000
NODE_4430_length_1146_cov_26.159503	658	738	0	42	80	0.5250000
NODE_4430_length_1146_cov_26.159503	658	738	2	38	80	0.4750000
NODE_4431_length_1146_cov_14.210124	343	423	0	15	80	0.1875000
NODE_4431_length_1146_cov_14.210124	343	423	2	65	80	0.8125000
NODE_4431_length_1146_cov_14.210124	396	476	0	54	80	0.6750000
NODE_4431_length_1146_cov_14.210124	396	476	2	26	80	0.3250000
NODE_4432_length_1146_cov_13.479465	425	501	0	64	76	0.8421053
NODE_4432_length_1146_cov_13.479465	425	501	2	12	76	0.1578947
NODE_4432_length_1146_cov_13.479465	505	565	0	60	60	1.0000000
NODE_4432_length_1146_cov_13.479465	561	641	0	80	80	1.0000000
NODE_4432_length_1146_cov_13.479465	614	694	0	80	80	1.0000000
NODE_4438_length_1145_cov_49.566922	395	470	0	75	75	1.0000000
NODE_4438_length_1145_cov_49.566922	443	523	0	80	80	1.0000000
NODE_4439_length_1145_cov_38.191205	497	576	0	79	79	1.0000000
NODE_4439_length_1145_cov_38.191205	549	629	0	80	80	1.0000000
NODE_4440_length_1145_cov_26.929254	468	548	2	28	80	0.3500000
NODE_4440_length_1145_cov_26.929254	468	548	3	8	80	0.1000000
NODE_4440_length_1145_cov_26.929254	468	548	4	31	80	0.3875000
NODE_4440_length_1145_cov_26.929254	468	548	6	13	80	0.1625000
NODE_4440_length_1145_cov_26.929254	521	601	0	12	80	0.1500000
NODE_4440_length_1145_cov_26.929254	521	601	3	49	80	0.6125000
NODE_4440_length_1145_cov_26.929254	521	601	4	19	80	0.2375000
NODE_4441_length_1145_cov_20.121415	508	588	0	80	80	1.0000000
NODE_4441_length_1145_cov_20.121415	561	641	0	80	80	1.0000000
NODE_4442_length_1145_cov_11.753346	527	605	0	78	78	1.0000000
NODE_4442_length_1145_cov_11.753346	578	659	0	50	81	0.6172839
NODE_4442_length_1145_cov_11.753346	578	659	2	31	81	0.3827161
NODE_4443_length_1145_cov_9.571702	93	173	0	80	80	1.0000000
NODE_4443_length_1145_cov_9.571702	146	226	0	80	80	1.0000000
NODE_4455_length_1143_cov_42.255747	380	460	0	80	80	1.0000000
NODE_4455_length_1143_cov_42.255747	433	513	0	80	80	1.0000000
NODE_4455_length_1143_cov_42.255747	509	589	0	80	80	1.0000000
NODE_4455_length_1143_cov_42.255747	562	642	0	80	80	1.0000000
NODE_4456_length_1143_cov_22.076628	526	606	0	80	80	1.0000000
NODE_4456_length_1143_cov_22.076628	579	659	0	80	80	1.0000000
NODE_4457_length_1143_cov_19.106322	565	645	0	26	80	0.3250000
NODE_4457_length_1143_cov_19.106322	565	645	1	13	80	0.1625000
NODE_4457_length_1143_cov_19.106322	565	645	2	41	80	0.5125000
NODE_4457_length_1143_cov_19.106322	618	698	2	80	80	1.0000000
NODE_4458_length_1143_cov_16.223180	638	719	0	3	81	0.0370370
NODE_4458_length_1143_cov_16.223180	638	719	2	78	81	0.9629630
NODE_4458_length_1143_cov_16.223180	692	772	0	51	80	0.6375000
NODE_4458_length_1143_cov_16.223180	692	772	2	29	80	0.3625000
NODE_4459_length_1143_cov_13.961686	634	714	0	80	80	1.0000000
NODE_4459_length_1143_cov_13.961686	687	767	0	80	80	1.0000000
NODE_4459_length_1143_cov_13.961686	763	843	0	80	80	1.0000000
NODE_4459_length_1143_cov_13.961686	816	896	0	80	80	1.0000000
NODE_4460_length_1143_cov_12.782567	328	409	0	81	81	1.0000000
NODE_4460_length_1143_cov_12.782567	381	462	0	81	81	1.0000000
NODE_4460_length_1143_cov_12.782567	458	538	0	23	80	0.2875000
NODE_4460_length_1143_cov_12.782567	458	538	2	55	80	0.6875000
NODE_4460_length_1143_cov_12.782567	458	538	4	2	80	0.0250000
NODE_4460_length_1143_cov_12.782567	511	591	0	20	80	0.2500000
NODE_4460_length_1143_cov_12.782567	511	591	2	58	80	0.7250000
NODE_4460_length_1143_cov_12.782567	511	591	4	2	80	0.0250000
NODE_4461_length_1143_cov_8.287356	692	772	0	80	80	1.0000000
NODE_4461_length_1143_cov_8.287356	745	825	0	80	80	1.0000000
NODE_4463_length_1143_cov_2.197318	988	1057	9	2	69	0.0289855
NODE_4463_length_1143_cov_2.197318	988	1057	10	36	69	0.5217391
NODE_4463_length_1143_cov_2.197318	988	1057	12	31	69	0.4492754
NODE_4466_length_1142_cov_28.364334	613	693	0	80	80	1.0000000
NODE_4466_length_1142_cov_28.364334	666	746	0	80	80	1.0000000
NODE_4467_length_1142_cov_21.669223	518	598	0	80	80	1.0000000
NODE_4467_length_1142_cov_21.669223	571	651	0	80	80	1.0000000
NODE_4468_length_1142_cov_19.007670	411	491	0	80	80	1.0000000
NODE_4468_length_1142_cov_19.007670	464	544	0	80	80	1.0000000
NODE_4474_length_1141_cov_12.500960	17	97	8	12	80	0.1500000
NODE_4474_length_1141_cov_12.500960	17	97	12	8	80	0.1000000
NODE_4474_length_1141_cov_12.500960	17	97	16	3	80	0.0375000
NODE_4474_length_1141_cov_12.500960	17	97	20	5	80	0.0625000
NODE_4474_length_1141_cov_12.500960	17	97	22	11	80	0.1375000
NODE_4474_length_1141_cov_12.500960	17	97	24	41	80	0.5125000
NODE_4474_length_1141_cov_12.500960	17	97	8	12	80	0.1500000
NODE_4474_length_1141_cov_12.500960	17	97	12	8	80	0.1000000
NODE_4474_length_1141_cov_12.500960	17	97	16	3	80	0.0375000
NODE_4474_length_1141_cov_12.500960	17	97	20	5	80	0.0625000
NODE_4474_length_1141_cov_12.500960	17	97	22	11	80	0.1375000
NODE_4474_length_1141_cov_12.500960	17	97	24	41	80	0.5125000
NODE_4474_length_1141_cov_12.500960	17	97	8	12	80	0.1500000
NODE_4474_length_1141_cov_12.500960	17	97	12	8	80	0.1000000
NODE_4474_length_1141_cov_12.500960	17	97	16	3	80	0.0375000
NODE_4474_length_1141_cov_12.500960	17	97	20	5	80	0.0625000
NODE_4474_length_1141_cov_12.500960	17	97	22	11	80	0.1375000
NODE_4474_length_1141_cov_12.500960	17	97	24	41	80	0.5125000
NODE_4474_length_1141_cov_12.500960	17	97	8	12	80	0.1500000
NODE_4474_length_1141_cov_12.500960	17	97	12	8	80	0.1000000
NODE_4474_length_1141_cov_12.500960	17	97	16	3	80	0.0375000
NODE_4474_length_1141_cov_12.500960	17	97	20	5	80	0.0625000
NODE_4474_length_1141_cov_12.500960	17	97	22	11	80	0.1375000
NODE_4474_length_1141_cov_12.500960	17	97	24	41	80	0.5125000
NODE_4474_length_1141_cov_12.500960	70	132	11	1	62	0.0161290
NODE_4474_length_1141_cov_12.500960	70	132	14	9	62	0.1451613
NODE_4474_length_1141_cov_12.500960	70	132	16	1	62	0.0161290
NODE_4474_length_1141_cov_12.500960	70	132	20	6	62	0.0967742
NODE_4474_length_1141_cov_12.500960	70	132	24	45	62	0.7258065
NODE_4474_length_1141_cov_12.500960	70	132	11	1	62	0.0161290
NODE_4474_length_1141_cov_12.500960	70	132	14	9	62	0.1451613
NODE_4474_length_1141_cov_12.500960	70	132	16	1	62	0.0161290
NODE_4474_length_1141_cov_12.500960	70	132	20	6	62	0.0967742
NODE_4474_length_1141_cov_12.500960	70	132	24	45	62	0.7258065
NODE_4474_length_1141_cov_12.500960	70	132	11	1	62	0.0161290
NODE_4474_length_1141_cov_12.500960	70	132	14	9	62	0.1451613
NODE_4474_length_1141_cov_12.500960	70	132	16	1	62	0.0161290
NODE_4474_length_1141_cov_12.500960	70	132	20	6	62	0.0967742
NODE_4474_length_1141_cov_12.500960	70	132	24	45	62	0.7258065
NODE_4474_length_1141_cov_12.500960	70	132	11	1	62	0.0161290
NODE_4474_length_1141_cov_12.500960	70	132	14	9	62	0.1451613
NODE_4474_length_1141_cov_12.500960	70	132	16	1	62	0.0161290
NODE_4474_length_1141_cov_12.500960	70	132	20	6	62	0.0967742
NODE_4474_length_1141_cov_12.500960	70	132	24	45	62	0.7258065
NODE_4475_length_1141_cov_7.197697	54	134	4	13	80	0.1625000
NODE_4475_length_1141_cov_7.197697	54	134	6	67	80	0.8375000
NODE_4475_length_1141_cov_7.197697	107	187	2	19	80	0.2375000
NODE_4475_length_1141_cov_7.197697	107	187	4	15	80	0.1875000
NODE_4475_length_1141_cov_7.197697	107	187	6	46	80	0.5750000
NODE_4475_length_1141_cov_7.197697	573	653	0	80	80	1.0000000
NODE_4475_length_1141_cov_7.197697	626	707	0	81	81	1.0000000
NODE_4476_length_1141_cov_5.428023	411	491	0	80	80	1.0000000
NODE_4476_length_1141_cov_5.428023	464	544	0	80	80	1.0000000
NODE_4482_length_1140_cov_39.383285	451	531	2	72	80	0.9000000
NODE_4482_length_1140_cov_39.383285	451	531	4	8	80	0.1000000
NODE_4482_length_1140_cov_39.383285	504	584	0	18	80	0.2250000
NODE_4482_length_1140_cov_39.383285	504	584	2	54	80	0.6750000
NODE_4482_length_1140_cov_39.383285	504	584	4	8	80	0.1000000
NODE_4482_length_1140_cov_39.383285	580	660	0	80	80	1.0000000
NODE_4482_length_1140_cov_39.383285	633	713	0	80	80	1.0000000
NODE_4483_length_1140_cov_19.493756	543	623	0	80	80	1.0000000
NODE_4483_length_1140_cov_19.493756	596	676	0	80	80	1.0000000
NODE_4484_length_1140_cov_18.341018	347	427	0	80	80	1.0000000
NODE_4484_length_1140_cov_18.341018	400	480	0	80	80	1.0000000
NODE_4484_length_1140_cov_18.341018	476	556	0	48	80	0.6000000
NODE_4484_length_1140_cov_18.341018	476	556	2	32	80	0.4000000
NODE_4484_length_1140_cov_18.341018	529	609	0	9	80	0.1125000
NODE_4484_length_1140_cov_18.341018	529	609	2	71	80	0.8875000
NODE_4494_length_1139_cov_26.812500	410	490	0	80	80	1.0000000
NODE_4494_length_1139_cov_26.812500	463	543	0	35	80	0.4375000
NODE_4494_length_1139_cov_26.812500	463	543	2	25	80	0.3125000
NODE_4494_length_1139_cov_26.812500	463	543	4	20	80	0.2500000
NODE_4494_length_1139_cov_26.812500	539	619	2	46	80	0.5750000
NODE_4494_length_1139_cov_26.812500	539	619	4	34	80	0.4250000
NODE_4494_length_1139_cov_26.812500	592	672	0	41	80	0.5125000
NODE_4494_length_1139_cov_26.812500	592	672	2	39	80	0.4875000
NODE_4495_length_1139_cov_26.323077	308	388	0	80	80	1.0000000
NODE_4495_length_1139_cov_26.323077	361	441	0	80	80	1.0000000
NODE_4495_length_1139_cov_26.323077	437	517	0	80	80	1.0000000
NODE_4495_length_1139_cov_26.323077	490	570	0	80	80	1.0000000
NODE_4496_length_1139_cov_15.223077	530	610	0	80	80	1.0000000
NODE_4496_length_1139_cov_15.223077	583	663	0	80	80	1.0000000
NODE_4505_length_1138_cov_74.599615	480	560	0	80	80	1.0000000
NODE_4505_length_1138_cov_74.599615	533	613	0	80	80	1.0000000
NODE_4505_length_1138_cov_74.599615	609	689	0	80	80	1.0000000
NODE_4505_length_1138_cov_74.599615	662	742	0	80	80	1.0000000
NODE_4506_length_1138_cov_29.407122	559	639	0	22	80	0.2750000
NODE_4506_length_1138_cov_29.407122	559	639	4	58	80	0.7250000
NODE_4506_length_1138_cov_29.407122	612	692	0	11	80	0.1375000
NODE_4506_length_1138_cov_29.407122	612	692	4	69	80	0.8625000
NODE_4506_length_1138_cov_29.407122	688	768	0	80	80	1.0000000
NODE_4506_length_1138_cov_29.407122	741	821	0	80	80	1.0000000
NODE_4507_length_1138_cov_18.326275	454	534	0	80	80	1.0000000
NODE_4507_length_1138_cov_18.326275	507	587	0	80	80	1.0000000
NODE_4507_length_1138_cov_18.326275	583	663	0	80	80	1.0000000
NODE_4507_length_1138_cov_18.326275	636	716	0	80	80	1.0000000
NODE_4509_length_1138_cov_11.834456	291	371	12	80	80	1.0000000
NODE_4509_length_1138_cov_11.834456	344	424	0	35	80	0.4375000
NODE_4509_length_1138_cov_11.834456	344	424	12	45	80	0.5625000
NODE_4510_length_1138_cov_10.923003	318	398	0	2	80	0.0250000
NODE_4510_length_1138_cov_10.923003	318	398	3	39	80	0.4875000
NODE_4510_length_1138_cov_10.923003	318	398	5	5	80	0.0625000
NODE_4510_length_1138_cov_10.923003	318	398	9	23	80	0.2875000
NODE_4510_length_1138_cov_10.923003	318	398	10	11	80	0.1375000
NODE_4510_length_1138_cov_10.923003	371	451	8	11	80	0.1375000
NODE_4510_length_1138_cov_10.923003	371	451	9	16	80	0.2000000
NODE_4510_length_1138_cov_10.923003	371	451	10	53	80	0.6625000
NODE_4517_length_1137_cov_23.983622	470	550	0	21	80	0.2625000
NODE_4517_length_1137_cov_23.983622	470	550	3	1	80	0.0125000
NODE_4517_length_1137_cov_23.983622	470	550	4	58	80	0.7250000
NODE_4517_length_1137_cov_23.983622	523	603	0	36	80	0.4500000
NODE_4517_length_1137_cov_23.983622	523	603	4	44	80	0.5500000
NODE_4517_length_1137_cov_23.983622	599	679	0	80	80	1.0000000
NODE_4517_length_1137_cov_23.983622	652	732	0	80	80	1.0000000
NODE_4518_length_1137_cov_22.877649	405	485	0	80	80	1.0000000
NODE_4518_length_1137_cov_22.877649	458	538	0	80	80	1.0000000
NODE_4518_length_1137_cov_22.877649	534	614	0	80	80	1.0000000
NODE_4518_length_1137_cov_22.877649	587	667	0	80	80	1.0000000
NODE_4519_length_1137_cov_21.570328	383	463	0	37	80	0.4625000
NODE_4519_length_1137_cov_21.570328	383	463	2	43	80	0.5375000
NODE_4519_length_1137_cov_21.570328	436	516	0	38	80	0.4750000
NODE_4519_length_1137_cov_21.570328	436	516	2	42	80	0.5250000
NODE_4520_length_1137_cov_18.560694	665	745	0	51	80	0.6375000
NODE_4520_length_1137_cov_18.560694	665	745	1	14	80	0.1750000
NODE_4520_length_1137_cov_18.560694	665	745	2	15	80	0.1875000
NODE_4520_length_1137_cov_18.560694	718	798	1	12	80	0.1500000
NODE_4520_length_1137_cov_18.560694	718	798	2	68	80	0.8500000
NODE_4521_length_1137_cov_18.505780	557	637	0	28	80	0.3500000
NODE_4521_length_1137_cov_18.505780	557	637	2	52	80	0.6500000
NODE_4521_length_1137_cov_18.505780	610	690	0	80	80	1.0000000
NODE_4521_length_1137_cov_18.505780	686	766	0	80	80	1.0000000
NODE_4521_length_1137_cov_18.505780	739	819	0	80	80	1.0000000
NODE_4523_length_1137_cov_11.866089	313	393	0	80	80	1.0000000
NODE_4523_length_1137_cov_11.866089	366	446	0	80	80	1.0000000
NODE_4523_length_1137_cov_11.866089	442	522	0	71	80	0.8875000
NODE_4523_length_1137_cov_11.866089	442	522	4	7	80	0.0875000
NODE_4523_length_1137_cov_11.866089	442	522	8	2	80	0.0250000
NODE_4523_length_1137_cov_11.866089	495	575	0	18	80	0.2250000
NODE_4523_length_1137_cov_11.866089	495	575	4	7	80	0.0875000
NODE_4523_length_1137_cov_11.866089	495	575	8	55	80	0.6875000
NODE_4524_length_1137_cov_5.594412	144	224	0	80	80	1.0000000
NODE_4524_length_1137_cov_5.594412	197	277	0	80	80	1.0000000
NODE_4532_length_1136_cov_42.827387	445	525	0	4	80	0.0500000
NODE_4532_length_1136_cov_42.827387	445	525	4	3	80	0.0375000
NODE_4532_length_1136_cov_42.827387	445	525	6	73	80	0.9125000
NODE_4532_length_1136_cov_42.827387	498	578	0	38	80	0.4750000
NODE_4532_length_1136_cov_42.827387	498	578	2	19	80	0.2375000
NODE_4532_length_1136_cov_42.827387	498	578	4	3	80	0.0375000
NODE_4532_length_1136_cov_42.827387	498	578	6	20	80	0.2500000
NODE_4532_length_1136_cov_42.827387	574	654	2	65	80	0.8125000
NODE_4532_length_1136_cov_42.827387	574	654	4	15	80	0.1875000
NODE_4532_length_1136_cov_42.827387	627	707	2	65	80	0.8125000
NODE_4532_length_1136_cov_42.827387	627	707	4	15	80	0.1875000
NODE_4533_length_1136_cov_30.940212	534	614	0	80	80	1.0000000
NODE_4533_length_1136_cov_30.940212	587	667	0	80	80	1.0000000
NODE_4533_length_1136_cov_30.940212	663	743	0	80	80	1.0000000
NODE_4533_length_1136_cov_30.940212	716	796	0	80	80	1.0000000
NODE_4534_length_1136_cov_30.797493	557	637	0	80	80	1.0000000
NODE_4534_length_1136_cov_30.797493	610	691	0	81	81	1.0000000
NODE_4534_length_1136_cov_30.797493	687	767	0	80	80	1.0000000
NODE_4534_length_1136_cov_30.797493	740	820	0	80	80	1.0000000
NODE_4535_length_1136_cov_23.142719	704	784	0	80	80	1.0000000
NODE_4535_length_1136_cov_23.142719	757	837	0	80	80	1.0000000
NODE_4536_length_1136_cov_21.798457	570	651	0	81	81	1.0000000
NODE_4536_length_1136_cov_21.798457	624	704	0	80	80	1.0000000
NODE_4537_length_1136_cov_21.109932	460	532	0	72	72	1.0000000
NODE_4537_length_1136_cov_21.109932	505	585	0	80	80	1.0000000
NODE_4538_length_1136_cov_20.528447	19	99	34	1	80	0.0125000
NODE_4538_length_1136_cov_20.528447	19	99	40	3	80	0.0375000
NODE_4538_length_1136_cov_20.528447	19	99	42	2	80	0.0250000
NODE_4538_length_1136_cov_20.528447	19	99	44	2	80	0.0250000
NODE_4538_length_1136_cov_20.528447	19	99	48	2	80	0.0250000
NODE_4538_length_1136_cov_20.528447	19	99	52	30	80	0.3750000
NODE_4538_length_1136_cov_20.528447	19	99	55	2	80	0.0250000
NODE_4538_length_1136_cov_20.528447	19	99	57	2	80	0.0250000
NODE_4538_length_1136_cov_20.528447	19	99	59	36	80	0.4500000
NODE_4538_length_1136_cov_20.528447	19	99	34	1	80	0.0125000
NODE_4538_length_1136_cov_20.528447	19	99	40	3	80	0.0375000
NODE_4538_length_1136_cov_20.528447	19	99	42	2	80	0.0250000
NODE_4538_length_1136_cov_20.528447	19	99	44	2	80	0.0250000
NODE_4538_length_1136_cov_20.528447	19	99	48	2	80	0.0250000
NODE_4538_length_1136_cov_20.528447	19	99	52	30	80	0.3750000
NODE_4538_length_1136_cov_20.528447	19	99	55	2	80	0.0250000
NODE_4538_length_1136_cov_20.528447	19	99	57	2	80	0.0250000
NODE_4538_length_1136_cov_20.528447	19	99	59	36	80	0.4500000
NODE_4538_length_1136_cov_20.528447	28	99	48	1	71	0.0140845
NODE_4538_length_1136_cov_20.528447	28	99	52	30	71	0.4225352
NODE_4538_length_1136_cov_20.528447	28	99	55	2	71	0.0281690
NODE_4538_length_1136_cov_20.528447	28	99	57	2	71	0.0281690
NODE_4538_length_1136_cov_20.528447	28	99	59	36	71	0.5070422
NODE_4538_length_1136_cov_20.528447	877	912	0	35	35	1.0000000
NODE_4538_length_1136_cov_20.528447	879	921	0	42	42	1.0000000
NODE_4539_length_1136_cov_14.921890	657	737	0	80	80	1.0000000
NODE_4539_length_1136_cov_14.921890	710	790	0	80	80	1.0000000
NODE_4556_length_1135_cov_100.121622	454	534	0	11	80	0.1375000
NODE_4556_length_1135_cov_100.121622	454	534	4	69	80	0.8625000
NODE_4556_length_1135_cov_100.121622	507	587	0	40	80	0.5000000
NODE_4556_length_1135_cov_100.121622	507	587	4	40	80	0.5000000
NODE_4556_length_1135_cov_100.121622	583	663	0	80	80	1.0000000
NODE_4556_length_1135_cov_100.121622	636	719	0	83	83	1.0000000
NODE_4557_length_1135_cov_34.523166	313	393	0	36	80	0.4500000
NODE_4557_length_1135_cov_34.523166	313	393	6	40	80	0.5000000
NODE_4557_length_1135_cov_34.523166	313	393	7	1	80	0.0125000
NODE_4557_length_1135_cov_34.523166	313	393	9	1	80	0.0125000
NODE_4557_length_1135_cov_34.523166	313	393	10	2	80	0.0250000
NODE_4557_length_1135_cov_34.523166	366	446	6	23	80	0.2875000
NODE_4557_length_1135_cov_34.523166	366	446	7	1	80	0.0125000
NODE_4557_length_1135_cov_34.523166	366	446	9	1	80	0.0125000
NODE_4557_length_1135_cov_34.523166	366	446	10	29	80	0.3625000
NODE_4557_length_1135_cov_34.523166	366	446	11	26	80	0.3250000
NODE_4558_length_1135_cov_20.735521	484	564	0	9	80	0.1125000
NODE_4558_length_1135_cov_20.735521	484	564	4	44	80	0.5500000
NODE_4558_length_1135_cov_20.735521	484	564	5	20	80	0.2500000
NODE_4558_length_1135_cov_20.735521	484	564	6	7	80	0.0875000
NODE_4558_length_1135_cov_20.735521	537	617	0	62	80	0.7750000
NODE_4558_length_1135_cov_20.735521	537	617	4	18	80	0.2250000
NODE_4558_length_1135_cov_20.735521	613	693	0	80	80	1.0000000
NODE_4558_length_1135_cov_20.735521	666	746	0	80	80	1.0000000
NODE_4559_length_1135_cov_9.644788	620	700	0	80	80	1.0000000
NODE_4559_length_1135_cov_9.644788	673	753	0	80	80	1.0000000
NODE_4562_length_1135_cov_2.990347	349	429	0	80	80	1.0000000
NODE_4562_length_1135_cov_2.990347	402	482	0	80	80	1.0000000
NODE_4571_length_1134_cov_34.784541	478	558	0	80	80	1.0000000
NODE_4571_length_1134_cov_34.784541	531	611	0	80	80	1.0000000
NODE_4571_length_1134_cov_34.784541	607	687	0	69	80	0.8625000
NODE_4571_length_1134_cov_34.784541	607	687	2	11	80	0.1375000
NODE_4571_length_1134_cov_34.784541	660	740	0	16	80	0.2000000
NODE_4571_length_1134_cov_34.784541	660	740	2	64	80	0.8000000
NODE_4572_length_1134_cov_28.524638	511	591	0	80	80	1.0000000
NODE_4572_length_1134_cov_28.524638	564	644	0	80	80	1.0000000
NODE_4572_length_1134_cov_28.524638	640	720	0	80	80	1.0000000
NODE_4572_length_1134_cov_28.524638	693	773	0	80	80	1.0000000
NODE_4576_length_1134_cov_2.619324	606	686	0	17	80	0.2125000
NODE_4576_length_1134_cov_2.619324	606	686	2	63	80	0.7875000
NODE_4576_length_1134_cov_2.619324	659	739	0	17	80	0.2125000
NODE_4576_length_1134_cov_2.619324	659	739	2	63	80	0.7875000
NODE_4584_length_1133_cov_5.563830	292	372	0	80	80	1.0000000
NODE_4584_length_1133_cov_5.563830	345	425	0	80	80	1.0000000
NODE_4584_length_1133_cov_5.563830	904	966	5	6	62	0.0967742
NODE_4584_length_1133_cov_5.563830	904	966	6	20	62	0.3225806
NODE_4584_length_1133_cov_5.563830	904	966	7	27	62	0.4354839
NODE_4584_length_1133_cov_5.563830	904	966	8	2	62	0.0322581
NODE_4584_length_1133_cov_5.563830	904	966	9	4	62	0.0645161
NODE_4584_length_1133_cov_5.563830	904	966	10	3	62	0.0483871
NODE_4592_length_1132_cov_23.121007	485	565	0	80	80	1.0000000
NODE_4592_length_1132_cov_23.121007	538	618	0	80	80	1.0000000
NODE_4592_length_1132_cov_23.121007	618	664	0	46	46	1.0000000
NODE_4592_length_1132_cov_23.121007	700	751	0	51	51	1.0000000
NODE_4593_length_1132_cov_19.377541	595	675	0	80	80	1.0000000
NODE_4593_length_1132_cov_19.377541	648	728	0	80	80	1.0000000
NODE_4594_length_1132_cov_18.872217	363	443	0	25	80	0.3125000
NODE_4594_length_1132_cov_18.872217	363	443	2	55	80	0.6875000
NODE_4594_length_1132_cov_18.872217	416	496	0	30	80	0.3750000
NODE_4594_length_1132_cov_18.872217	416	496	2	50	80	0.6250000
NODE_4595_length_1132_cov_11.242982	474	554	0	72	80	0.9000000
NODE_4595_length_1132_cov_11.242982	474	554	2	8	80	0.1000000
NODE_4595_length_1132_cov_11.242982	527	607	0	80	80	1.0000000
NODE_4596_length_1132_cov_7.356244	354	434	0	80	80	1.0000000
NODE_4596_length_1132_cov_7.356244	407	487	0	80	80	1.0000000
NODE_4597_length_1132_cov_6.214908	269	349	0	80	80	1.0000000
NODE_4597_length_1132_cov_6.214908	322	402	0	80	80	1.0000000
NODE_4606_length_1131_cov_36.161822	478	558	0	80	80	1.0000000
NODE_4606_length_1131_cov_36.161822	531	611	0	29	80	0.3625000
NODE_4606_length_1131_cov_36.161822	531	611	2	24	80	0.3000000
NODE_4606_length_1131_cov_36.161822	531	611	4	27	80	0.3375000
NODE_4606_length_1131_cov_36.161822	607	687	4	80	80	1.0000000
NODE_4606_length_1131_cov_36.161822	660	740	0	6	80	0.0750000
NODE_4606_length_1131_cov_36.161822	660	740	2	24	80	0.3000000
NODE_4606_length_1131_cov_36.161822	660	740	4	50	80	0.6250000
NODE_4607_length_1131_cov_31.907946	390	470	0	80	80	1.0000000
NODE_4607_length_1131_cov_31.907946	443	523	0	80	80	1.0000000
NODE_4607_length_1131_cov_31.907946	519	599	0	80	80	1.0000000
NODE_4607_length_1131_cov_31.907946	572	652	0	80	80	1.0000000
NODE_4608_length_1131_cov_26.827519	464	544	0	80	80	1.0000000
NODE_4608_length_1131_cov_26.827519	517	597	0	80	80	1.0000000
NODE_4609_length_1131_cov_20.441860	555	635	0	9	80	0.1125000
NODE_4609_length_1131_cov_20.441860	555	635	4	71	80	0.8875000
NODE_4609_length_1131_cov_20.441860	608	688	0	56	80	0.7000000
NODE_4609_length_1131_cov_20.441860	608	688	4	24	80	0.3000000
NODE_4610_length_1131_cov_12.517442	420	500	0	80	80	1.0000000
NODE_4610_length_1131_cov_12.517442	473	553	0	80	80	1.0000000
NODE_4611_length_1131_cov_10.912791	429	509	0	80	80	1.0000000
NODE_4611_length_1131_cov_10.912791	482	562	0	80	80	1.0000000
NODE_4620_length_1130_cov_43.354995	742	822	0	26	80	0.3250000
NODE_4620_length_1130_cov_43.354995	742	822	4	54	80	0.6750000
NODE_4620_length_1130_cov_43.354995	795	875	4	80	80	1.0000000
NODE_4621_length_1130_cov_13.097963	642	722	4	44	80	0.5500000
NODE_4621_length_1130_cov_13.097963	642	722	5	20	80	0.2500000
NODE_4621_length_1130_cov_13.097963	642	722	6	16	80	0.2000000
NODE_4621_length_1130_cov_13.097963	695	775	0	5	80	0.0625000
NODE_4621_length_1130_cov_13.097963	695	775	2	46	80	0.5750000
NODE_4621_length_1130_cov_13.097963	695	775	4	1	80	0.0125000
NODE_4621_length_1130_cov_13.097963	695	775	5	21	80	0.2625000
NODE_4621_length_1130_cov_13.097963	695	775	6	7	80	0.0875000
NODE_4626_length_1129_cov_31.088350	396	476	6	3	80	0.0375000
NODE_4626_length_1129_cov_31.088350	396	476	7	31	80	0.3875000
NODE_4626_length_1129_cov_31.088350	396	476	8	6	80	0.0750000
NODE_4626_length_1129_cov_31.088350	396	476	9	1	80	0.0125000
NODE_4626_length_1129_cov_31.088350	396	476	10	39	80	0.4875000
NODE_4626_length_1129_cov_31.088350	449	529	0	29	80	0.3625000
NODE_4626_length_1129_cov_31.088350	449	529	3	8	80	0.1000000
NODE_4626_length_1129_cov_31.088350	449	529	7	43	80	0.5375000
NODE_4627_length_1129_cov_20.591262	450	530	0	80	80	1.0000000
NODE_4627_length_1129_cov_20.591262	503	583	0	80	80	1.0000000
NODE_4628_length_1129_cov_16.934951	261	341	0	80	80	1.0000000
NODE_4628_length_1129_cov_16.934951	314	394	0	80	80	1.0000000
NODE_4629_length_1129_cov_9.441748	665	738	0	73	73	1.0000000
NODE_4629_length_1129_cov_9.441748	711	791	0	80	80	1.0000000
NODE_4630_length_1129_cov_9.260194	658	738	0	80	80	1.0000000
NODE_4630_length_1129_cov_9.260194	711	791	0	80	80	1.0000000
NODE_4631_length_1129_cov_5.055340	759	839	6	15	80	0.1875000
NODE_4631_length_1129_cov_5.055340	759	839	8	65	80	0.8125000
NODE_4638_length_1128_cov_48.099125	588	668	0	1	80	0.0125000
NODE_4638_length_1128_cov_48.099125	588	668	1	1	80	0.0125000
NODE_4638_length_1128_cov_48.099125	588	668	2	40	80	0.5000000
NODE_4638_length_1128_cov_48.099125	588	668	5	18	80	0.2250000
NODE_4638_length_1128_cov_48.099125	588	668	6	20	80	0.2500000
NODE_4638_length_1128_cov_48.099125	641	721	5	7	80	0.0875000
NODE_4638_length_1128_cov_48.099125	641	721	6	73	80	0.9125000
NODE_4640_length_1128_cov_26.230321	455	535	0	80	80	1.0000000
NODE_4640_length_1128_cov_26.230321	508	588	0	80	80	1.0000000
NODE_4640_length_1128_cov_26.230321	584	664	0	55	80	0.6875000
NODE_4640_length_1128_cov_26.230321	584	664	2	25	80	0.3125000
NODE_4640_length_1128_cov_26.230321	637	718	0	11	81	0.1358025
NODE_4640_length_1128_cov_26.230321	637	718	2	70	81	0.8641976
NODE_4641_length_1128_cov_26.031098	594	674	0	80	80	1.0000000
NODE_4641_length_1128_cov_26.031098	647	727	0	80	80	1.0000000
NODE_4642_length_1128_cov_25.869776	465	538	0	73	73	1.0000000
NODE_4642_length_1128_cov_25.869776	601	674	0	36	73	0.4931507
NODE_4642_length_1128_cov_25.869776	601	674	2	37	73	0.5068493
NODE_4642_length_1128_cov_25.869776	647	723	2	76	76	1.0000000
NODE_4643_length_1128_cov_24.185617	350	430	0	80	80	1.0000000
NODE_4643_length_1128_cov_24.185617	403	483	0	80	80	1.0000000
NODE_4644_length_1128_cov_18.537415	335	415	0	80	80	1.0000000
NODE_4644_length_1128_cov_18.537415	388	468	0	80	80	1.0000000
NODE_4645_length_1128_cov_9.345967	690	770	0	80	80	1.0000000
NODE_4645_length_1128_cov_9.345967	743	823	0	80	80	1.0000000
NODE_4647_length_1128_cov_3.920311	675	725	0	23	50	0.4600000
NODE_4647_length_1128_cov_3.920311	675	725	2	27	50	0.5400000
NODE_4647_length_1128_cov_3.920311	698	778	2	80	80	1.0000000
NODE_4648_length_1128_cov_3.631681	613	693	0	80	80	1.0000000
NODE_4648_length_1128_cov_3.631681	666	746	0	80	80	1.0000000
NODE_4650_length_1128_cov_3.091351	519	599	0	80	80	1.0000000
NODE_4650_length_1128_cov_3.091351	572	652	0	80	80	1.0000000
NODE_4660_length_1127_cov_38.932879	405	485	0	54	80	0.6750000
NODE_4660_length_1127_cov_38.932879	405	485	2	8	80	0.1000000
NODE_4660_length_1127_cov_38.932879	405	485	6	18	80	0.2250000
NODE_4660_length_1127_cov_38.932879	458	538	0	1	80	0.0125000
NODE_4660_length_1127_cov_38.932879	458	538	2	8	80	0.1000000
NODE_4660_length_1127_cov_38.932879	458	538	6	51	80	0.6375000
NODE_4660_length_1127_cov_38.932879	458	538	10	20	80	0.2500000
NODE_4660_length_1127_cov_38.932879	534	614	2	14	80	0.1750000
NODE_4660_length_1127_cov_38.932879	534	614	6	2	80	0.0250000
NODE_4660_length_1127_cov_38.932879	534	614	7	2	80	0.0250000
NODE_4660_length_1127_cov_38.932879	534	614	8	14	80	0.1750000
NODE_4660_length_1127_cov_38.932879	534	614	10	48	80	0.6000000
NODE_4660_length_1127_cov_38.932879	587	667	0	34	80	0.4250000
NODE_4660_length_1127_cov_38.932879	587	667	2	33	80	0.4125000
NODE_4660_length_1127_cov_38.932879	587	667	7	2	80	0.0250000
NODE_4660_length_1127_cov_38.932879	587	667	8	11	80	0.1375000
NODE_4661_length_1127_cov_37.721790	236	316	0	70	80	0.8750000
NODE_4661_length_1127_cov_37.721790	236	316	2	10	80	0.1250000
NODE_4661_length_1127_cov_37.721790	289	369	0	80	80	1.0000000
NODE_4661_length_1127_cov_37.721790	365	445	0	80	80	1.0000000
NODE_4661_length_1127_cov_37.721790	418	498	0	80	80	1.0000000
NODE_4662_length_1127_cov_31.866732	444	523	0	19	79	0.2405063
NODE_4662_length_1127_cov_31.866732	444	523	2	13	79	0.1645570
NODE_4662_length_1127_cov_31.866732	444	523	4	2	79	0.0253165
NODE_4662_length_1127_cov_31.866732	444	523	6	45	79	0.5696203
NODE_4662_length_1127_cov_31.866732	496	576	0	15	80	0.1875000
NODE_4662_length_1127_cov_31.866732	496	576	2	65	80	0.8125000
NODE_4662_length_1127_cov_31.866732	572	652	0	43	80	0.5375000
NODE_4662_length_1127_cov_31.866732	572	652	2	37	80	0.4625000
NODE_4662_length_1127_cov_31.866732	625	705	0	80	80	1.0000000
NODE_4663_length_1127_cov_25.616732	430	510	0	80	80	1.0000000
NODE_4663_length_1127_cov_25.616732	483	563	0	80	80	1.0000000
NODE_4664_length_1127_cov_21.838521	338	418	0	80	80	1.0000000
NODE_4664_length_1127_cov_21.838521	391	471	0	80	80	1.0000000
NODE_4664_length_1127_cov_21.838521	467	547	0	80	80	1.0000000
NODE_4664_length_1127_cov_21.838521	520	600	0	80	80	1.0000000
NODE_4665_length_1127_cov_15.024319	711	800	0	89	89	1.0000000
NODE_4665_length_1127_cov_15.024319	773	853	0	80	80	1.0000000
NODE_4667_length_1127_cov_4.786965	386	466	0	80	80	1.0000000
NODE_4667_length_1127_cov_4.786965	439	519	0	80	80	1.0000000
NODE_4672_length_1126_cov_51.699124	448	528	0	80	80	1.0000000
NODE_4672_length_1126_cov_51.699124	501	581	0	80	80	1.0000000
NODE_4673_length_1126_cov_38.135346	427	507	0	8	80	0.1000000
NODE_4673_length_1126_cov_38.135346	427	507	1	6	80	0.0750000
NODE_4673_length_1126_cov_38.135346	427	507	2	9	80	0.1125000
NODE_4673_length_1126_cov_38.135346	427	507	3	57	80	0.7125000
NODE_4673_length_1126_cov_38.135346	480	560	0	61	80	0.7625000
NODE_4673_length_1126_cov_38.135346	480	560	2	9	80	0.1125000
NODE_4673_length_1126_cov_38.135346	480	560	3	10	80	0.1250000
NODE_4673_length_1126_cov_38.135346	556	638	0	45	82	0.5487805
NODE_4673_length_1126_cov_38.135346	556	638	2	37	82	0.4512195
NODE_4673_length_1126_cov_38.135346	611	691	0	33	80	0.4125000
NODE_4673_length_1126_cov_38.135346	611	691	2	47	80	0.5875000
NODE_4674_length_1126_cov_34.637780	23	97	50	2	74	0.0270270
NODE_4674_length_1126_cov_34.637780	23	97	55	2	74	0.0270270
NODE_4674_length_1126_cov_34.637780	23	97	59	3	74	0.0405405
NODE_4674_length_1126_cov_34.637780	23	97	60	2	74	0.0270270
NODE_4674_length_1126_cov_34.637780	23	97	65	2	74	0.0270270
NODE_4674_length_1126_cov_34.637780	23	97	68	1	74	0.0135135
NODE_4674_length_1126_cov_34.637780	23	97	70	2	74	0.0270270
NODE_4674_length_1126_cov_34.637780	23	97	75	1	74	0.0135135
NODE_4674_length_1126_cov_34.637780	23	97	76	3	74	0.0405405
NODE_4674_length_1126_cov_34.637780	23	97	77	3	74	0.0405405
NODE_4674_length_1126_cov_34.637780	23	97	80	17	74	0.2297297
NODE_4674_length_1126_cov_34.637780	23	97	82	19	74	0.2567568
NODE_4674_length_1126_cov_34.637780	23	97	86	11	74	0.1486486
NODE_4674_length_1126_cov_34.637780	23	97	89	6	74	0.0810811
NODE_4674_length_1126_cov_34.637780	146	226	21	5	80	0.0625000
NODE_4674_length_1126_cov_34.637780	146	226	22	30	80	0.3750000
NODE_4674_length_1126_cov_34.637780	146	226	23	4	80	0.0500000
NODE_4674_length_1126_cov_34.637780	146	226	25	3	80	0.0375000
NODE_4674_length_1126_cov_34.637780	146	226	27	1	80	0.0125000
NODE_4674_length_1126_cov_34.637780	146	226	28	1	80	0.0125000
NODE_4674_length_1126_cov_34.637780	146	226	35	1	80	0.0125000
NODE_4674_length_1126_cov_34.637780	146	226	37	3	80	0.0375000
NODE_4674_length_1126_cov_34.637780	146	226	40	4	80	0.0500000
NODE_4674_length_1126_cov_34.637780	146	226	42	8	80	0.1000000
NODE_4674_length_1126_cov_34.637780	146	226	43	1	80	0.0125000
NODE_4674_length_1126_cov_34.637780	146	226	45	2	80	0.0250000
NODE_4674_length_1126_cov_34.637780	146	226	51	1	80	0.0125000
NODE_4674_length_1126_cov_34.637780	146	226	56	1	80	0.0125000
NODE_4674_length_1126_cov_34.637780	146	226	66	1	80	0.0125000
NODE_4674_length_1126_cov_34.637780	146	226	67	3	80	0.0375000
NODE_4674_length_1126_cov_34.637780	146	226	76	3	80	0.0375000
NODE_4674_length_1126_cov_34.637780	146	226	86	1	80	0.0125000
NODE_4674_length_1126_cov_34.637780	146	226	89	4	80	0.0500000
NODE_4674_length_1126_cov_34.637780	146	226	90	3	80	0.0375000
NODE_4674_length_1126_cov_34.637780	146	226	21	5	80	0.0625000
NODE_4674_length_1126_cov_34.637780	146	226	22	30	80	0.3750000
NODE_4674_length_1126_cov_34.637780	146	226	23	4	80	0.0500000
NODE_4674_length_1126_cov_34.637780	146	226	25	3	80	0.0375000
NODE_4674_length_1126_cov_34.637780	146	226	27	1	80	0.0125000
NODE_4674_length_1126_cov_34.637780	146	226	28	1	80	0.0125000
NODE_4674_length_1126_cov_34.637780	146	226	35	1	80	0.0125000
NODE_4674_length_1126_cov_34.637780	146	226	37	3	80	0.0375000
NODE_4674_length_1126_cov_34.637780	146	226	40	4	80	0.0500000
NODE_4674_length_1126_cov_34.637780	146	226	42	8	80	0.1000000
NODE_4674_length_1126_cov_34.637780	146	226	43	1	80	0.0125000
NODE_4674_length_1126_cov_34.637780	146	226	45	2	80	0.0250000
NODE_4674_length_1126_cov_34.637780	146	226	51	1	80	0.0125000
NODE_4674_length_1126_cov_34.637780	146	226	56	1	80	0.0125000
NODE_4674_length_1126_cov_34.637780	146	226	66	1	80	0.0125000
NODE_4674_length_1126_cov_34.637780	146	226	67	3	80	0.0375000
NODE_4674_length_1126_cov_34.637780	146	226	76	3	80	0.0375000
NODE_4674_length_1126_cov_34.637780	146	226	86	1	80	0.0125000
NODE_4674_length_1126_cov_34.637780	146	226	89	4	80	0.0500000
NODE_4674_length_1126_cov_34.637780	146	226	90	3	80	0.0375000
NODE_4674_length_1126_cov_34.637780	146	208	21	5	62	0.0806452
NODE_4674_length_1126_cov_34.637780	146	208	22	12	62	0.1935484
NODE_4674_length_1126_cov_34.637780	146	208	23	4	62	0.0645161
NODE_4674_length_1126_cov_34.637780	146	208	25	3	62	0.0483871
NODE_4674_length_1126_cov_34.637780	146	208	27	1	62	0.0161290
NODE_4674_length_1126_cov_34.637780	146	208	28	1	62	0.0161290
NODE_4674_length_1126_cov_34.637780	146	208	35	1	62	0.0161290
NODE_4674_length_1126_cov_34.637780	146	208	37	3	62	0.0483871
NODE_4674_length_1126_cov_34.637780	146	208	40	4	62	0.0645161
NODE_4674_length_1126_cov_34.637780	146	208	42	8	62	0.1290323
NODE_4674_length_1126_cov_34.637780	146	208	43	1	62	0.0161290
NODE_4674_length_1126_cov_34.637780	146	208	45	2	62	0.0322581
NODE_4674_length_1126_cov_34.637780	146	208	51	1	62	0.0161290
NODE_4674_length_1126_cov_34.637780	146	208	56	1	62	0.0161290
NODE_4674_length_1126_cov_34.637780	146	208	66	1	62	0.0161290
NODE_4674_length_1126_cov_34.637780	146	208	67	3	62	0.0483871
NODE_4674_length_1126_cov_34.637780	146	208	76	3	62	0.0483871
NODE_4674_length_1126_cov_34.637780	146	208	86	1	62	0.0161290
NODE_4674_length_1126_cov_34.637780	146	208	89	4	62	0.0645161
NODE_4674_length_1126_cov_34.637780	146	208	90	3	62	0.0483871
NODE_4674_length_1126_cov_34.637780	146	217	21	5	71	0.0704225
NODE_4674_length_1126_cov_34.637780	146	217	22	21	71	0.2957746
NODE_4674_length_1126_cov_34.637780	146	217	23	4	71	0.0563380
NODE_4674_length_1126_cov_34.637780	146	217	25	3	71	0.0422535
NODE_4674_length_1126_cov_34.637780	146	217	27	1	71	0.0140845
NODE_4674_length_1126_cov_34.637780	146	217	28	1	71	0.0140845
NODE_4674_length_1126_cov_34.637780	146	217	35	1	71	0.0140845
NODE_4674_length_1126_cov_34.637780	146	217	37	3	71	0.0422535
NODE_4674_length_1126_cov_34.637780	146	217	40	4	71	0.0563380
NODE_4674_length_1126_cov_34.637780	146	217	42	8	71	0.1126761
NODE_4674_length_1126_cov_34.637780	146	217	43	1	71	0.0140845
NODE_4674_length_1126_cov_34.637780	146	217	45	2	71	0.0281690
NODE_4674_length_1126_cov_34.637780	146	217	51	1	71	0.0140845
NODE_4674_length_1126_cov_34.637780	146	217	56	1	71	0.0140845
NODE_4674_length_1126_cov_34.637780	146	217	66	1	71	0.0140845
NODE_4674_length_1126_cov_34.637780	146	217	67	3	71	0.0422535
NODE_4674_length_1126_cov_34.637780	146	217	76	3	71	0.0422535
NODE_4674_length_1126_cov_34.637780	146	217	86	1	71	0.0140845
NODE_4674_length_1126_cov_34.637780	146	217	89	4	71	0.0563380
NODE_4674_length_1126_cov_34.637780	146	217	90	3	71	0.0422535
NODE_4675_length_1126_cov_21.360273	595	675	4	56	80	0.7000000
NODE_4675_length_1126_cov_21.360273	595	675	8	24	80	0.3000000
NODE_4675_length_1126_cov_21.360273	648	728	4	48	80	0.6000000
NODE_4675_length_1126_cov_21.360273	648	728	8	32	80	0.4000000
NODE_4676_length_1126_cov_17.420643	422	502	1	9	80	0.1125000
NODE_4676_length_1126_cov_17.420643	422	502	2	71	80	0.8875000
NODE_4676_length_1126_cov_17.420643	475	555	1	31	80	0.3875000
NODE_4676_length_1126_cov_17.420643	475	555	2	49	80	0.6125000
NODE_4677_length_1126_cov_15.896787	383	463	0	15	80	0.1875000
NODE_4677_length_1126_cov_15.896787	383	463	2	65	80	0.8125000
NODE_4677_length_1126_cov_15.896787	436	516	0	43	80	0.5375000
NODE_4677_length_1126_cov_15.896787	436	516	2	37	80	0.4625000
NODE_4678_length_1126_cov_8.525803	174	254	0	80	80	1.0000000
NODE_4678_length_1126_cov_8.525803	227	307	0	80	80	1.0000000
NODE_4679_length_1126_cov_5.805258	463	543	0	17	80	0.2125000
NODE_4679_length_1126_cov_5.805258	463	543	1	5	80	0.0625000
NODE_4679_length_1126_cov_5.805258	463	543	2	58	80	0.7250000
NODE_4679_length_1126_cov_5.805258	516	596	2	80	80	1.0000000
NODE_4685_length_1126_cov_1.502434	6	86	0	80	80	1.0000000
NODE_4685_length_1126_cov_1.502434	59	108	0	49	49	1.0000000
NODE_4689_length_1125_cov_34.314815	405	485	0	1	80	0.0125000
NODE_4689_length_1125_cov_34.314815	405	485	4	79	80	0.9875000
NODE_4689_length_1125_cov_34.314815	458	538	0	22	80	0.2750000
NODE_4689_length_1125_cov_34.314815	458	538	4	58	80	0.7250000
NODE_4689_length_1125_cov_34.314815	534	614	0	79	80	0.9875000
NODE_4689_length_1125_cov_34.314815	534	614	2	1	80	0.0125000
NODE_4689_length_1125_cov_34.314815	587	667	0	26	80	0.3250000
NODE_4689_length_1125_cov_34.314815	587	667	2	12	80	0.1500000
NODE_4689_length_1125_cov_34.314815	587	667	4	42	80	0.5250000
NODE_4690_length_1125_cov_33.553606	458	538	0	65	80	0.8125000
NODE_4690_length_1125_cov_33.553606	458	538	5	9	80	0.1125000
NODE_4690_length_1125_cov_33.553606	458	538	6	6	80	0.0750000
NODE_4690_length_1125_cov_33.553606	511	591	0	12	80	0.1500000
NODE_4690_length_1125_cov_33.553606	511	591	5	9	80	0.1125000
NODE_4690_length_1125_cov_33.553606	511	591	6	59	80	0.7375000
NODE_4690_length_1125_cov_33.553606	587	667	5	74	80	0.9250000
NODE_4690_length_1125_cov_33.553606	587	667	6	6	80	0.0750000
NODE_4690_length_1125_cov_33.553606	640	720	0	52	80	0.6500000
NODE_4690_length_1125_cov_33.553606	640	720	5	28	80	0.3500000
NODE_4691_length_1125_cov_33.371345	408	488	0	80	80	1.0000000
NODE_4691_length_1125_cov_33.371345	461	541	0	80	80	1.0000000
NODE_4691_length_1125_cov_33.371345	537	617	0	79	80	0.9875000
NODE_4691_length_1125_cov_33.371345	537	617	2	1	80	0.0125000
NODE_4691_length_1125_cov_33.371345	590	670	0	26	80	0.3250000
NODE_4691_length_1125_cov_33.371345	590	670	2	54	80	0.6750000
NODE_4692_length_1125_cov_22.580897	279	359	0	80	80	1.0000000
NODE_4692_length_1125_cov_22.580897	332	412	0	80	80	1.0000000
NODE_4692_length_1125_cov_22.580897	408	488	0	80	80	1.0000000
NODE_4692_length_1125_cov_22.580897	461	541	0	80	80	1.0000000
NODE_4705_length_1124_cov_52.278049	616	696	0	80	80	1.0000000
NODE_4705_length_1124_cov_52.278049	669	749	0	80	80	1.0000000
NODE_4706_length_1124_cov_25.280000	444	524	0	2	80	0.0250000
NODE_4706_length_1124_cov_25.280000	444	524	2	78	80	0.9750000
NODE_4706_length_1124_cov_25.280000	497	577	0	22	80	0.2750000
NODE_4706_length_1124_cov_25.280000	497	577	2	58	80	0.7250000
NODE_4706_length_1124_cov_25.280000	573	653	0	80	80	1.0000000
NODE_4706_length_1124_cov_25.280000	626	706	0	80	80	1.0000000
NODE_4707_length_1124_cov_18.700488	114	194	0	74	80	0.9250000
NODE_4707_length_1124_cov_18.700488	114	194	2	6	80	0.0750000
NODE_4707_length_1124_cov_18.700488	167	247	0	30	80	0.3750000
NODE_4707_length_1124_cov_18.700488	167	247	2	50	80	0.6250000
NODE_4717_length_1123_cov_26.445312	388	468	0	80	80	1.0000000
NODE_4717_length_1123_cov_26.445312	441	521	0	80	80	1.0000000
NODE_4717_length_1123_cov_26.445312	517	597	0	80	80	1.0000000
NODE_4717_length_1123_cov_26.445312	570	650	0	80	80	1.0000000
NODE_4718_length_1123_cov_18.677734	522	602	0	80	80	1.0000000
NODE_4718_length_1123_cov_18.677734	575	655	0	80	80	1.0000000
NODE_4718_length_1123_cov_18.677734	651	731	0	80	80	1.0000000
NODE_4718_length_1123_cov_18.677734	704	784	0	80	80	1.0000000
NODE_4728_length_1122_cov_38.688172	295	375	1	52	80	0.6500000
NODE_4728_length_1122_cov_38.688172	295	375	2	28	80	0.3500000
NODE_4728_length_1122_cov_38.688172	348	428	0	46	80	0.5750000
NODE_4728_length_1122_cov_38.688172	348	428	1	34	80	0.4250000
NODE_4728_length_1122_cov_38.688172	424	504	0	80	80	1.0000000
NODE_4728_length_1122_cov_38.688172	477	557	0	74	80	0.9250000
NODE_4728_length_1122_cov_38.688172	477	557	6	6	80	0.0750000
NODE_4729_length_1122_cov_32.827957	232	312	0	80	80	1.0000000
NODE_4729_length_1122_cov_32.827957	285	365	0	80	80	1.0000000
NODE_4729_length_1122_cov_32.827957	361	441	0	80	80	1.0000000
NODE_4729_length_1122_cov_32.827957	414	494	0	80	80	1.0000000
NODE_4730_length_1122_cov_12.574780	396	476	0	41	80	0.5125000
NODE_4730_length_1122_cov_12.574780	396	476	2	39	80	0.4875000
NODE_4730_length_1122_cov_12.574780	449	529	0	24	80	0.3000000
NODE_4730_length_1122_cov_12.574780	449	529	2	56	80	0.7000000
NODE_4730_length_1122_cov_12.574780	525	605	0	80	80	1.0000000
NODE_4730_length_1122_cov_12.574780	578	658	0	32	80	0.4000000
NODE_4730_length_1122_cov_12.574780	578	658	2	48	80	0.6000000
NODE_4731_length_1122_cov_8.582600	586	666	0	80	80	1.0000000
NODE_4731_length_1122_cov_8.582600	639	719	0	80	80	1.0000000
NODE_4733_length_1122_cov_3.714565	284	364	0	80	80	1.0000000
NODE_4733_length_1122_cov_3.714565	337	417	0	80	80	1.0000000
NODE_4738_length_1122_cov_1.757576	25	87	0	62	62	1.0000000
NODE_4742_length_1121_cov_39.595890	507	587	0	36	80	0.4500000
NODE_4742_length_1121_cov_39.595890	507	587	2	44	80	0.5500000
NODE_4742_length_1121_cov_39.595890	560	640	0	80	80	1.0000000
NODE_4742_length_1121_cov_39.595890	636	716	0	4	80	0.0500000
NODE_4742_length_1121_cov_39.595890	636	716	2	76	80	0.9500000
NODE_4742_length_1121_cov_39.595890	689	769	0	43	80	0.5375000
NODE_4742_length_1121_cov_39.595890	689	769	2	37	80	0.4625000
NODE_4743_length_1121_cov_23.832681	525	605	0	80	80	1.0000000
NODE_4743_length_1121_cov_23.832681	578	658	0	80	80	1.0000000
NODE_4744_length_1121_cov_18.033268	1	42	0	41	41	1.0000000
NODE_4744_length_1121_cov_18.033268	671	751	0	80	80	1.0000000
NODE_4744_length_1121_cov_18.033268	724	804	0	80	80	1.0000000
NODE_4745_length_1121_cov_8.633072	610	690	0	80	80	1.0000000
NODE_4745_length_1121_cov_8.633072	663	743	0	80	80	1.0000000
NODE_4751_length_1120_cov_34.281097	377	457	0	24	80	0.3000000
NODE_4751_length_1120_cov_34.281097	377	457	2	56	80	0.7000000
NODE_4751_length_1120_cov_34.281097	430	510	0	37	80	0.4625000
NODE_4751_length_1120_cov_34.281097	430	510	2	43	80	0.5375000
NODE_4751_length_1120_cov_34.281097	506	586	0	52	80	0.6500000
NODE_4751_length_1120_cov_34.281097	506	586	2	28	80	0.3500000
NODE_4751_length_1120_cov_34.281097	559	639	0	80	80	1.0000000
NODE_4752_length_1120_cov_31.468168	401	481	0	80	80	1.0000000
NODE_4752_length_1120_cov_31.468168	454	534	0	80	80	1.0000000
NODE_4752_length_1120_cov_31.468168	530	610	0	80	80	1.0000000
NODE_4752_length_1120_cov_31.468168	583	663	0	61	80	0.7625000
NODE_4752_length_1120_cov_31.468168	583	663	2	19	80	0.2375000
NODE_4753_length_1120_cov_28.182174	418	498	0	49	80	0.6125000
NODE_4753_length_1120_cov_28.182174	418	498	2	31	80	0.3875000
NODE_4753_length_1120_cov_28.182174	471	551	0	6	80	0.0750000
NODE_4753_length_1120_cov_28.182174	471	551	2	74	80	0.9250000
NODE_4754_length_1120_cov_25.423115	405	485	0	80	80	1.0000000
NODE_4754_length_1120_cov_25.423115	458	538	0	80	80	1.0000000
NODE_4754_length_1120_cov_25.423115	534	614	0	80	80	1.0000000
NODE_4754_length_1120_cov_25.423115	587	667	0	80	80	1.0000000
NODE_4755_length_1120_cov_24.441724	589	662	0	6	73	0.0821918
NODE_4755_length_1120_cov_24.441724	589	662	2	67	73	0.9178082
NODE_4755_length_1120_cov_24.441724	636	716	0	39	80	0.4875000
NODE_4755_length_1120_cov_24.441724	636	716	2	41	80	0.5125000
NODE_4756_length_1120_cov_18.966699	406	486	0	22	80	0.2750000
NODE_4756_length_1120_cov_18.966699	406	486	1	41	80	0.5125000
NODE_4756_length_1120_cov_18.966699	406	486	2	17	80	0.2125000
NODE_4756_length_1120_cov_18.966699	459	539	0	10	80	0.1250000
NODE_4756_length_1120_cov_18.966699	459	539	2	70	80	0.8750000
NODE_4757_length_1120_cov_16.136141	508	588	4	24	80	0.3000000
NODE_4757_length_1120_cov_16.136141	508	588	6	23	80	0.2875000
NODE_4757_length_1120_cov_16.136141	508	588	8	2	80	0.0250000
NODE_4757_length_1120_cov_16.136141	508	588	10	31	80	0.3875000
NODE_4757_length_1120_cov_16.136141	561	641	8	11	80	0.1375000
NODE_4757_length_1120_cov_16.136141	561	641	10	62	80	0.7750000
NODE_4757_length_1120_cov_16.136141	561	641	12	7	80	0.0875000
NODE_4758_length_1120_cov_15.492654	460	540	0	80	80	1.0000000
NODE_4758_length_1120_cov_15.492654	460	540	0	80	80	1.0000000
NODE_4758_length_1120_cov_15.492654	513	593	0	80	80	1.0000000
NODE_4759_length_1120_cov_8.696376	646	726	2	22	80	0.2750000
NODE_4759_length_1120_cov_8.696376	646	726	4	58	80	0.7250000
NODE_4759_length_1120_cov_8.696376	699	779	0	30	80	0.3750000
NODE_4759_length_1120_cov_8.696376	699	779	2	14	80	0.1750000
NODE_4759_length_1120_cov_8.696376	699	779	4	36	80	0.4500000
NODE_4760_length_1120_cov_7.916748	304	384	0	40	80	0.5000000
NODE_4760_length_1120_cov_7.916748	304	384	2	30	80	0.3750000
NODE_4760_length_1120_cov_7.916748	304	384	11	2	80	0.0250000
NODE_4760_length_1120_cov_7.916748	304	384	12	8	80	0.1000000
NODE_4760_length_1120_cov_7.916748	357	437	2	17	80	0.2125000
NODE_4760_length_1120_cov_7.916748	357	437	10	13	80	0.1625000
NODE_4760_length_1120_cov_7.916748	357	437	11	2	80	0.0250000
NODE_4760_length_1120_cov_7.916748	357	437	12	48	80	0.6000000
NODE_4772_length_1119_cov_32.617647	425	505	2	8	80	0.1000000
NODE_4772_length_1119_cov_32.617647	425	505	6	19	80	0.2375000
NODE_4772_length_1119_cov_32.617647	425	505	8	53	80	0.6625000
NODE_4772_length_1119_cov_32.617647	478	558	0	23	80	0.2875000
NODE_4772_length_1119_cov_32.617647	478	558	2	38	80	0.4750000
NODE_4772_length_1119_cov_32.617647	478	558	8	19	80	0.2375000
NODE_4773_length_1119_cov_24.944118	455	535	0	22	80	0.2750000
NODE_4773_length_1119_cov_24.944118	455	535	2	58	80	0.7250000
NODE_4773_length_1119_cov_24.944118	508	588	0	50	80	0.6250000
NODE_4773_length_1119_cov_24.944118	508	588	2	30	80	0.3750000
NODE_4774_length_1119_cov_22.214706	614	694	0	42	80	0.5250000
NODE_4774_length_1119_cov_22.214706	614	694	6	38	80	0.4750000
NODE_4774_length_1119_cov_22.214706	667	747	6	80	80	1.0000000
NODE_4775_length_1119_cov_21.115686	431	511	0	76	80	0.9500000
NODE_4775_length_1119_cov_21.115686	431	511	2	4	80	0.0500000
NODE_4775_length_1119_cov_21.115686	484	564	0	80	80	1.0000000
NODE_4777_length_1119_cov_11.895098	565	645	5	18	80	0.2250000
NODE_4777_length_1119_cov_11.895098	565	645	6	2	80	0.0250000
NODE_4777_length_1119_cov_11.895098	565	645	14	22	80	0.2750000
NODE_4777_length_1119_cov_11.895098	565	645	15	4	80	0.0500000
NODE_4777_length_1119_cov_11.895098	565	645	17	7	80	0.0875000
NODE_4777_length_1119_cov_11.895098	565	645	18	27	80	0.3375000
NODE_4777_length_1119_cov_11.895098	618	698	10	10	80	0.1250000
NODE_4777_length_1119_cov_11.895098	618	698	16	9	80	0.1125000
NODE_4777_length_1119_cov_11.895098	618	698	18	61	80	0.7625000
NODE_4782_length_1119_cov_2.783333	37	99	0	62	62	1.0000000
NODE_4789_length_1118_cov_35.214917	555	635	0	55	80	0.6875000
NODE_4789_length_1118_cov_35.214917	555	635	2	25	80	0.3125000
NODE_4789_length_1118_cov_35.214917	608	688	0	19	80	0.2375000
NODE_4789_length_1118_cov_35.214917	608	688	2	61	80	0.7625000
NODE_4789_length_1118_cov_35.214917	684	764	0	80	80	1.0000000
NODE_4789_length_1118_cov_35.214917	737	817	0	80	80	1.0000000
NODE_4790_length_1118_cov_23.114818	602	682	2	80	80	1.0000000
NODE_4790_length_1118_cov_23.114818	655	735	0	45	80	0.5625000
NODE_4790_length_1118_cov_23.114818	655	735	2	35	80	0.4375000
NODE_4790_length_1118_cov_23.114818	731	811	0	4	80	0.0500000
NODE_4790_length_1118_cov_23.114818	731	811	6	76	80	0.9500000
NODE_4790_length_1118_cov_23.114818	784	864	6	27	80	0.3375000
NODE_4790_length_1118_cov_23.114818	784	864	8	53	80	0.6625000
NODE_4791_length_1118_cov_18.293425	388	463	0	75	75	1.0000000
NODE_4791_length_1118_cov_18.293425	436	516	0	80	80	1.0000000
NODE_4791_length_1118_cov_18.293425	512	592	0	80	80	1.0000000
NODE_4791_length_1118_cov_18.293425	565	645	0	80	80	1.0000000
NODE_4792_length_1118_cov_17.228656	480	560	0	80	80	1.0000000
NODE_4792_length_1118_cov_17.228656	533	613	0	80	80	1.0000000
NODE_4794_length_1118_cov_14.299313	468	548	2	28	80	0.3500000
NODE_4794_length_1118_cov_14.299313	468	548	3	2	80	0.0250000
NODE_4794_length_1118_cov_14.299313	468	548	4	50	80	0.6250000
NODE_4794_length_1118_cov_14.299313	521	601	2	57	80	0.7125000
NODE_4794_length_1118_cov_14.299313	521	601	4	23	80	0.2875000
NODE_4795_length_1118_cov_10.203140	306	386	0	65	80	0.8125000
NODE_4795_length_1118_cov_10.203140	306	386	2	15	80	0.1875000
NODE_4795_length_1118_cov_10.203140	359	439	0	12	80	0.1500000
NODE_4795_length_1118_cov_10.203140	359	439	2	68	80	0.8500000
NODE_4795_length_1118_cov_10.203140	435	515	0	48	80	0.6000000
NODE_4795_length_1118_cov_10.203140	435	515	2	32	80	0.4000000
NODE_4795_length_1118_cov_10.203140	488	568	0	80	80	1.0000000
NODE_4796_length_1118_cov_2.885182	471	551	0	80	80	1.0000000
NODE_4796_length_1118_cov_2.885182	524	604	0	80	80	1.0000000
NODE_4805_length_1117_cov_19.425344	541	621	0	8	80	0.1000000
NODE_4805_length_1117_cov_19.425344	541	621	8	72	80	0.9000000
NODE_4805_length_1117_cov_19.425344	594	674	8	80	80	1.0000000
NODE_4806_length_1117_cov_16.386051	385	465	0	6	80	0.0750000
NODE_4806_length_1117_cov_16.386051	385	465	4	74	80	0.9250000
NODE_4806_length_1117_cov_16.386051	438	518	4	80	80	1.0000000
NODE_4807_length_1117_cov_10.353635	294	374	0	49	80	0.6125000
NODE_4807_length_1117_cov_10.353635	294	374	4	31	80	0.3875000
NODE_4807_length_1117_cov_10.353635	347	427	4	80	80	1.0000000
NODE_4808_length_1117_cov_7.492141	417	497	0	80	80	1.0000000
NODE_4808_length_1117_cov_7.492141	470	550	0	80	80	1.0000000
NODE_4812_length_1117_cov_3.225933	666	728	3	10	62	0.1612903
NODE_4812_length_1117_cov_3.225933	666	728	6	52	62	0.8387097
NODE_4819_length_1116_cov_30.106195	457	537	0	21	80	0.2625000
NODE_4819_length_1116_cov_30.106195	457	537	2	37	80	0.4625000
NODE_4819_length_1116_cov_30.106195	457	537	6	22	80	0.2750000
NODE_4819_length_1116_cov_30.106195	510	590	2	5	80	0.0625000
NODE_4819_length_1116_cov_30.106195	510	590	4	16	80	0.2000000
NODE_4819_length_1116_cov_30.106195	510	590	6	59	80	0.7375000
NODE_4820_length_1116_cov_25.518191	831	911	0	80	80	1.0000000
NODE_4820_length_1116_cov_25.518191	884	964	0	80	80	1.0000000
NODE_4821_length_1116_cov_20.629302	500	580	0	80	80	1.0000000
NODE_4821_length_1116_cov_20.629302	553	633	0	43	80	0.5375000
NODE_4821_length_1116_cov_20.629302	553	633	3	37	80	0.4625000
NODE_4822_length_1116_cov_16.723697	345	425	0	80	80	1.0000000
NODE_4822_length_1116_cov_16.723697	398	478	0	80	80	1.0000000
NODE_4823_length_1116_cov_16.046214	735	815	0	41	80	0.5125000
NODE_4823_length_1116_cov_16.046214	735	815	2	39	80	0.4875000
NODE_4823_length_1116_cov_16.046214	788	868	0	80	80	1.0000000
NODE_4828_length_1116_cov_1.379548	800	880	0	80	80	1.0000000
NODE_4828_length_1116_cov_1.379548	853	933	0	80	80	1.0000000
NODE_4832_length_1115_cov_30.584646	549	629	0	38	80	0.4750000
NODE_4832_length_1115_cov_30.584646	549	629	6	42	80	0.5250000
NODE_4832_length_1115_cov_30.584646	602	682	2	1	80	0.0125000
NODE_4832_length_1115_cov_30.584646	602	682	6	33	80	0.4125000
NODE_4832_length_1115_cov_30.584646	602	682	8	46	80	0.5750000
NODE_4833_length_1115_cov_15.871063	454	534	0	80	80	1.0000000
NODE_4833_length_1115_cov_15.871063	507	587	0	80	80	1.0000000
NODE_4833_length_1115_cov_15.871063	583	663	0	80	80	1.0000000
NODE_4833_length_1115_cov_15.871063	636	716	0	80	80	1.0000000
NODE_4840_length_1114_cov_20.633498	1034	1114	2	8	80	0.1000000
NODE_4840_length_1114_cov_20.633498	1034	1114	4	27	80	0.3375000
NODE_4840_length_1114_cov_20.633498	1034	1114	6	27	80	0.3375000
NODE_4840_length_1114_cov_20.633498	1034	1114	8	18	80	0.2250000
NODE_4840_length_1114_cov_20.633498	1034	1114	2	8	80	0.1000000
NODE_4840_length_1114_cov_20.633498	1034	1114	4	27	80	0.3375000
NODE_4840_length_1114_cov_20.633498	1034	1114	6	27	80	0.3375000
NODE_4840_length_1114_cov_20.633498	1034	1114	8	18	80	0.2250000
NODE_4840_length_1114_cov_20.633498	1034	1114	2	8	80	0.1000000
NODE_4840_length_1114_cov_20.633498	1034	1114	4	27	80	0.3375000
NODE_4840_length_1114_cov_20.633498	1034	1114	6	27	80	0.3375000
NODE_4840_length_1114_cov_20.633498	1034	1114	8	18	80	0.2250000
NODE_4840_length_1114_cov_20.633498	1034	1114	2	8	80	0.1000000
NODE_4840_length_1114_cov_20.633498	1034	1114	4	27	80	0.3375000
NODE_4840_length_1114_cov_20.633498	1034	1114	6	27	80	0.3375000
NODE_4840_length_1114_cov_20.633498	1034	1114	8	18	80	0.2250000
NODE_4840_length_1114_cov_20.633498	1034	1114	2	8	80	0.1000000
NODE_4840_length_1114_cov_20.633498	1034	1114	4	27	80	0.3375000
NODE_4840_length_1114_cov_20.633498	1034	1114	6	27	80	0.3375000
NODE_4840_length_1114_cov_20.633498	1034	1114	8	18	80	0.2250000
NODE_4840_length_1114_cov_20.633498	1043	1114	2	8	71	0.1126761
NODE_4840_length_1114_cov_20.633498	1043	1114	4	27	71	0.3802817
NODE_4840_length_1114_cov_20.633498	1043	1114	6	27	71	0.3802817
NODE_4840_length_1114_cov_20.633498	1043	1114	8	9	71	0.1267606
NODE_4841_length_1114_cov_17.383251	516	601	0	85	85	1.0000000
NODE_4841_length_1114_cov_17.383251	574	653	0	79	79	1.0000000
NODE_4841_length_1114_cov_17.383251	649	729	0	80	80	1.0000000
NODE_4841_length_1114_cov_17.383251	702	782	0	80	80	1.0000000
NODE_4842_length_1114_cov_5.562562	563	643	0	15	80	0.1875000
NODE_4842_length_1114_cov_5.562562	563	643	2	65	80	0.8125000
NODE_4842_length_1114_cov_5.562562	616	696	0	16	80	0.2000000
NODE_4842_length_1114_cov_5.562562	616	696	2	64	80	0.8000000
NODE_4847_length_1113_cov_51.988166	343	423	0	28	80	0.3500000
NODE_4847_length_1113_cov_51.988166	343	423	2	52	80	0.6500000
NODE_4847_length_1113_cov_51.988166	396	476	2	80	80	1.0000000
NODE_4847_length_1113_cov_51.988166	472	552	0	75	80	0.9375000
NODE_4847_length_1113_cov_51.988166	472	552	2	5	80	0.0625000
NODE_4847_length_1113_cov_51.988166	525	605	0	80	80	1.0000000
NODE_4848_length_1113_cov_35.005917	359	439	0	80	80	1.0000000
NODE_4848_length_1113_cov_35.005917	412	492	0	80	80	1.0000000
NODE_4849_length_1113_cov_28.106509	570	650	0	80	80	1.0000000
NODE_4849_length_1113_cov_28.106509	623	703	0	80	80	1.0000000
NODE_4849_length_1113_cov_28.106509	699	779	0	15	80	0.1875000
NODE_4849_length_1113_cov_28.106509	699	779	4	65	80	0.8125000
NODE_4849_length_1113_cov_28.106509	752	832	4	80	80	1.0000000
NODE_4850_length_1113_cov_18.636095	512	592	0	42	80	0.5250000
NODE_4850_length_1113_cov_18.636095	512	592	1	38	80	0.4750000
NODE_4850_length_1113_cov_18.636095	565	645	1	50	80	0.6250000
NODE_4850_length_1113_cov_18.636095	565	645	2	30	80	0.3750000
NODE_4851_length_1113_cov_16.664694	352	432	0	80	80	1.0000000
NODE_4851_length_1113_cov_16.664694	405	485	0	80	80	1.0000000
NODE_4851_length_1113_cov_16.664694	481	561	0	80	80	1.0000000
NODE_4851_length_1113_cov_16.664694	534	614	0	80	80	1.0000000
NODE_4852_length_1113_cov_14.155819	454	512	10	13	58	0.2241379
NODE_4852_length_1113_cov_14.155819	454	512	11	5	58	0.0862069
NODE_4852_length_1113_cov_14.155819	454	512	13	39	58	0.6724138
NODE_4852_length_1113_cov_14.155819	454	512	16	1	58	0.0172414
NODE_4852_length_1113_cov_14.155819	511	575	6	37	64	0.5781250
NODE_4852_length_1113_cov_14.155819	511	575	14	11	64	0.1718750
NODE_4852_length_1113_cov_14.155819	511	575	15	1	64	0.0156250
NODE_4852_length_1113_cov_14.155819	511	575	16	15	64	0.2343750
NODE_4853_length_1113_cov_10.185404	494	574	2	80	80	1.0000000
NODE_4853_length_1113_cov_10.185404	547	627	0	22	80	0.2750000
NODE_4853_length_1113_cov_10.185404	547	627	2	58	80	0.7250000
NODE_4855_length_1113_cov_4.005917	700	780	0	80	80	1.0000000
NODE_4855_length_1113_cov_4.005917	753	833	0	29	80	0.3625000
NODE_4855_length_1113_cov_4.005917	753	833	2	51	80	0.6375000
NODE_4866_length_1112_cov_14.961500	427	507	0	80	80	1.0000000
NODE_4866_length_1112_cov_14.961500	480	560	0	80	80	1.0000000
NODE_4866_length_1112_cov_14.961500	556	636	0	80	80	1.0000000
NODE_4866_length_1112_cov_14.961500	609	689	0	80	80	1.0000000
NODE_4875_length_1112_cov_1.655479	45	123	0	78	78	1.0000000
NODE_4875_length_1112_cov_1.655479	98	166	0	68	68	1.0000000
NODE_4880_length_1111_cov_37.999012	473	553	0	80	80	1.0000000
NODE_4880_length_1111_cov_37.999012	526	606	0	30	80	0.3750000
NODE_4880_length_1111_cov_37.999012	526	606	2	50	80	0.6250000
NODE_4880_length_1111_cov_37.999012	602	682	2	31	80	0.3875000
NODE_4880_length_1111_cov_37.999012	602	682	4	14	80	0.1750000
NODE_4880_length_1111_cov_37.999012	602	682	6	35	80	0.4375000
NODE_4880_length_1111_cov_37.999012	655	735	4	67	80	0.8375000
NODE_4880_length_1111_cov_37.999012	655	735	6	13	80	0.1625000
NODE_4881_length_1111_cov_24.394269	644	724	0	29	80	0.3625000
NODE_4881_length_1111_cov_24.394269	644	724	2	10	80	0.1250000
NODE_4881_length_1111_cov_24.394269	644	724	6	38	80	0.4750000
NODE_4881_length_1111_cov_24.394269	644	724	8	3	80	0.0375000
NODE_4881_length_1111_cov_24.394269	697	777	4	3	80	0.0375000
NODE_4881_length_1111_cov_24.394269	697	777	6	24	80	0.3000000
NODE_4881_length_1111_cov_24.394269	697	777	8	53	80	0.6625000
NODE_4882_length_1111_cov_23.676877	374	454	0	24	80	0.3000000
NODE_4882_length_1111_cov_23.676877	374	454	2	56	80	0.7000000
NODE_4882_length_1111_cov_23.676877	427	507	0	49	80	0.6125000
NODE_4882_length_1111_cov_23.676877	427	507	1	2	80	0.0250000
NODE_4882_length_1111_cov_23.676877	427	507	2	3	80	0.0375000
NODE_4882_length_1111_cov_23.676877	427	507	3	1	80	0.0125000
NODE_4882_length_1111_cov_23.676877	427	507	4	25	80	0.3125000
NODE_4883_length_1111_cov_17.522727	383	463	0	80	80	1.0000000
NODE_4883_length_1111_cov_17.522727	436	516	0	80	80	1.0000000
NODE_4884_length_1111_cov_16.495059	388	468	0	80	80	1.0000000
NODE_4884_length_1111_cov_16.495059	441	521	0	80	80	1.0000000
NODE_4885_length_1111_cov_15.366601	555	635	0	54	80	0.6750000
NODE_4885_length_1111_cov_15.366601	555	635	2	26	80	0.3250000
NODE_4885_length_1111_cov_15.366601	608	688	0	80	80	1.0000000
NODE_4886_length_1111_cov_15.314229	809	889	0	17	80	0.2125000
NODE_4886_length_1111_cov_15.314229	809	889	2	63	80	0.7875000
NODE_4886_length_1111_cov_15.314229	862	942	2	46	80	0.5750000
NODE_4886_length_1111_cov_15.314229	862	942	4	34	80	0.4250000
NODE_4887_length_1111_cov_9.732213	443	523	0	80	80	1.0000000
NODE_4887_length_1111_cov_9.732213	496	576	0	80	80	1.0000000
NODE_4888_length_1111_cov_4.907115	606	686	1	7	80	0.0875000
NODE_4888_length_1111_cov_4.907115	606	686	2	36	80	0.4500000
NODE_4888_length_1111_cov_4.907115	606	686	3	16	80	0.2000000
NODE_4888_length_1111_cov_4.907115	606	686	4	21	80	0.2625000
NODE_4888_length_1111_cov_4.907115	659	739	0	53	80	0.6625000
NODE_4888_length_1111_cov_4.907115	659	739	1	7	80	0.0875000
NODE_4888_length_1111_cov_4.907115	659	739	2	20	80	0.2500000
NODE_4892_length_1110_cov_23.012859	453	533	0	69	80	0.8625000
NODE_4892_length_1110_cov_23.012859	453	533	2	11	80	0.1375000
NODE_4892_length_1110_cov_23.012859	506	586	0	16	80	0.2000000
NODE_4892_length_1110_cov_23.012859	506	586	2	64	80	0.8000000
NODE_4892_length_1110_cov_23.012859	582	662	0	58	80	0.7250000
NODE_4892_length_1110_cov_23.012859	582	662	2	22	80	0.2750000
NODE_4892_length_1110_cov_23.012859	635	715	0	80	80	1.0000000
NODE_4895_length_1110_cov_5.305638	754	834	0	80	80	1.0000000
NODE_4895_length_1110_cov_5.305638	807	887	0	80	80	1.0000000
NODE_4896_length_1110_cov_3.698318	642	685	6	43	43	1.0000000
NODE_4899_length_1110_cov_1.871414	15	86	2	20	71	0.2816902
NODE_4899_length_1110_cov_1.871414	15	86	4	44	71	0.6197183
NODE_4899_length_1110_cov_1.871414	15	86	6	7	71	0.0985916
NODE_4903_length_1109_cov_35.307921	413	493	0	35	80	0.4375000
NODE_4903_length_1109_cov_35.307921	413	493	4	10	80	0.1250000
NODE_4903_length_1109_cov_35.307921	413	493	22	35	80	0.4375000
NODE_4903_length_1109_cov_35.307921	466	546	22	80	80	1.0000000
NODE_4903_length_1109_cov_35.307921	542	622	2	29	80	0.3625000
NODE_4903_length_1109_cov_35.307921	542	622	18	46	80	0.5750000
NODE_4903_length_1109_cov_35.307921	542	622	22	5	80	0.0625000
NODE_4903_length_1109_cov_35.307921	595	675	2	80	80	1.0000000
NODE_4904_length_1109_cov_27.880198	501	581	0	80	80	1.0000000
NODE_4904_length_1109_cov_27.880198	554	634	0	80	80	1.0000000
NODE_4904_length_1109_cov_27.880198	630	710	0	35	80	0.4375000
NODE_4904_length_1109_cov_27.880198	630	710	2	45	80	0.5625000
NODE_4904_length_1109_cov_27.880198	683	763	0	12	80	0.1500000
NODE_4904_length_1109_cov_27.880198	683	763	2	68	80	0.8500000
NODE_4905_length_1109_cov_21.858416	571	651	4	80	80	1.0000000
NODE_4905_length_1109_cov_21.858416	624	704	0	39	80	0.4875000
NODE_4905_length_1109_cov_21.858416	624	704	4	41	80	0.5125000
NODE_4912_length_1108_cov_59.921705	386	466	0	63	80	0.7875000
NODE_4912_length_1108_cov_59.921705	386	466	2	17	80	0.2125000
NODE_4912_length_1108_cov_59.921705	439	519	0	13	80	0.1625000
NODE_4912_length_1108_cov_59.921705	439	519	2	67	80	0.8375000
NODE_4912_length_1108_cov_59.921705	515	595	0	79	80	0.9875000
NODE_4912_length_1108_cov_59.921705	515	595	2	1	80	0.0125000
NODE_4912_length_1108_cov_59.921705	568	648	0	80	80	1.0000000
NODE_4914_length_1108_cov_16.069376	513	593	0	80	80	1.0000000
NODE_4914_length_1108_cov_16.069376	566	646	0	80	80	1.0000000
NODE_4916_length_1108_cov_11.656095	333	413	0	80	80	1.0000000
NODE_4916_length_1108_cov_11.656095	386	466	0	80	80	1.0000000
NODE_4917_length_1108_cov_10.266601	431	511	0	80	80	1.0000000
NODE_4917_length_1108_cov_10.266601	484	564	0	80	80	1.0000000
NODE_4918_length_1108_cov_8.895937	635	715	0	80	80	1.0000000
NODE_4918_length_1108_cov_8.895937	688	768	0	80	80	1.0000000
NODE_4920_length_1108_cov_5.682854	577	657	0	80	80	1.0000000
NODE_4920_length_1108_cov_5.682854	630	710	0	80	80	1.0000000
NODE_4927_length_1107_cov_35.050595	423	503	0	80	80	1.0000000
NODE_4927_length_1107_cov_35.050595	476	556	0	80	80	1.0000000
NODE_4927_length_1107_cov_35.050595	552	632	0	18	80	0.2250000
NODE_4927_length_1107_cov_35.050595	552	632	11	1	80	0.0125000
NODE_4927_length_1107_cov_35.050595	552	632	12	61	80	0.7625000
NODE_4927_length_1107_cov_35.050595	605	685	11	21	80	0.2625000
NODE_4927_length_1107_cov_35.050595	605	685	12	59	80	0.7375000
NODE_4928_length_1107_cov_31.386905	422	502	0	27	80	0.3375000
NODE_4928_length_1107_cov_31.386905	422	502	2	16	80	0.2000000
NODE_4928_length_1107_cov_31.386905	422	502	5	1	80	0.0125000
NODE_4928_length_1107_cov_31.386905	422	502	6	36	80	0.4500000
NODE_4928_length_1107_cov_31.386905	475	555	2	7	80	0.0875000
NODE_4928_length_1107_cov_31.386905	475	555	4	10	80	0.1250000
NODE_4928_length_1107_cov_31.386905	475	555	5	1	80	0.0125000
NODE_4928_length_1107_cov_31.386905	475	555	6	39	80	0.4875000
NODE_4928_length_1107_cov_31.386905	475	555	8	23	80	0.2875000
NODE_4929_length_1107_cov_29.178571	577	657	0	80	80	1.0000000
NODE_4929_length_1107_cov_29.178571	630	710	0	80	80	1.0000000
NODE_4929_length_1107_cov_29.178571	934	1000	0	38	66	0.5757576
NODE_4929_length_1107_cov_29.178571	934	1000	2	13	66	0.1969697
NODE_4929_length_1107_cov_29.178571	934	1000	4	15	66	0.2272727
NODE_4929_length_1107_cov_29.178571	934	1005	0	38	71	0.5352113
NODE_4929_length_1107_cov_29.178571	934	1005	2	13	71	0.1830986
NODE_4929_length_1107_cov_29.178571	934	1005	4	20	71	0.2816902
NODE_4930_length_1107_cov_16.038690	574	654	0	61	80	0.7625000
NODE_4930_length_1107_cov_16.038690	574	654	2	19	80	0.2375000
NODE_4930_length_1107_cov_16.038690	627	707	0	8	80	0.1000000
NODE_4930_length_1107_cov_16.038690	627	707	2	72	80	0.9000000
NODE_4931_length_1107_cov_15.472222	78	158	167	3	80	0.0375000
NODE_4931_length_1107_cov_15.472222	78	158	169	1	80	0.0125000
NODE_4931_length_1107_cov_15.472222	78	158	172	1	80	0.0125000
NODE_4931_length_1107_cov_15.472222	78	158	179	1	80	0.0125000
NODE_4931_length_1107_cov_15.472222	78	158	183	1	80	0.0125000
NODE_4931_length_1107_cov_15.472222	78	158	191	2	80	0.0250000
NODE_4931_length_1107_cov_15.472222	78	158	207	1	80	0.0125000
NODE_4931_length_1107_cov_15.472222	78	158	208	2	80	0.0250000
NODE_4931_length_1107_cov_15.472222	78	158	214	2	80	0.0250000
NODE_4931_length_1107_cov_15.472222	78	158	232	5	80	0.0625000
NODE_4931_length_1107_cov_15.472222	78	158	236	1	80	0.0125000
NODE_4931_length_1107_cov_15.472222	78	158	238	2	80	0.0250000
NODE_4931_length_1107_cov_15.472222	78	158	240	8	80	0.1000000
NODE_4931_length_1107_cov_15.472222	78	158	242	1	80	0.0125000
NODE_4931_length_1107_cov_15.472222	78	158	244	1	80	0.0125000
NODE_4931_length_1107_cov_15.472222	78	158	246	2	80	0.0250000
NODE_4931_length_1107_cov_15.472222	78	158	247	1	80	0.0125000
NODE_4931_length_1107_cov_15.472222	78	158	253	1	80	0.0125000
NODE_4931_length_1107_cov_15.472222	78	158	255	2	80	0.0250000
NODE_4931_length_1107_cov_15.472222	78	158	259	5	80	0.0625000
NODE_4931_length_1107_cov_15.472222	78	158	261	1	80	0.0125000
NODE_4931_length_1107_cov_15.472222	78	158	263	1	80	0.0125000
NODE_4931_length_1107_cov_15.472222	78	158	269	1	80	0.0125000
NODE_4931_length_1107_cov_15.472222	78	158	270	1	80	0.0125000
NODE_4931_length_1107_cov_15.472222	78	158	271	2	80	0.0250000
NODE_4931_length_1107_cov_15.472222	78	158	272	1	80	0.0125000
NODE_4931_length_1107_cov_15.472222	78	158	275	3	80	0.0375000
NODE_4931_length_1107_cov_15.472222	78	158	277	2	80	0.0250000
NODE_4931_length_1107_cov_15.472222	78	158	279	4	80	0.0500000
NODE_4931_length_1107_cov_15.472222	78	158	281	8	80	0.1000000
NODE_4931_length_1107_cov_15.472222	78	158	283	13	80	0.1625000
NODE_4931_length_1107_cov_15.472222	131	194	20	2	63	0.0317460
NODE_4931_length_1107_cov_15.472222	131	194	26	1	63	0.0158730
NODE_4931_length_1107_cov_15.472222	131	194	30	1	63	0.0158730
NODE_4931_length_1107_cov_15.472222	131	194	33	4	63	0.0634921
NODE_4931_length_1107_cov_15.472222	131	194	37	1	63	0.0158730
NODE_4931_length_1107_cov_15.472222	131	194	38	2	63	0.0317460
NODE_4931_length_1107_cov_15.472222	131	194	40	1	63	0.0158730
NODE_4931_length_1107_cov_15.472222	131	194	50	1	63	0.0158730
NODE_4931_length_1107_cov_15.472222	131	194	51	1	63	0.0158730
NODE_4931_length_1107_cov_15.472222	131	194	72	2	63	0.0317460
NODE_4931_length_1107_cov_15.472222	131	194	85	1	63	0.0158730
NODE_4931_length_1107_cov_15.472222	131	194	89	2	63	0.0317460
NODE_4931_length_1107_cov_15.472222	131	194	95	1	63	0.0158730
NODE_4931_length_1107_cov_15.472222	131	194	103	2	63	0.0317460
NODE_4931_length_1107_cov_15.472222	131	194	125	2	63	0.0317460
NODE_4931_length_1107_cov_15.472222	131	194	135	5	63	0.0793651
NODE_4931_length_1107_cov_15.472222	131	194	141	1	63	0.0158730
NODE_4931_length_1107_cov_15.472222	131	194	143	1	63	0.0158730
NODE_4931_length_1107_cov_15.472222	131	194	152	1	63	0.0158730
NODE_4931_length_1107_cov_15.472222	131	194	154	1	63	0.0158730
NODE_4931_length_1107_cov_15.472222	131	194	163	2	63	0.0317460
NODE_4931_length_1107_cov_15.472222	131	194	165	1	63	0.0158730
NODE_4931_length_1107_cov_15.472222	131	194	167	3	63	0.0476190
NODE_4931_length_1107_cov_15.472222	131	194	169	1	63	0.0158730
NODE_4931_length_1107_cov_15.472222	131	194	172	1	63	0.0158730
NODE_4931_length_1107_cov_15.472222	131	194	179	1	63	0.0158730
NODE_4931_length_1107_cov_15.472222	131	194	183	1	63	0.0158730
NODE_4931_length_1107_cov_15.472222	131	194	191	2	63	0.0317460
NODE_4931_length_1107_cov_15.472222	131	194	207	1	63	0.0158730
NODE_4931_length_1107_cov_15.472222	131	194	208	2	63	0.0317460
NODE_4931_length_1107_cov_15.472222	131	194	214	2	63	0.0317460
NODE_4931_length_1107_cov_15.472222	131	194	232	5	63	0.0793651
NODE_4931_length_1107_cov_15.472222	131	194	236	1	63	0.0158730
NODE_4931_length_1107_cov_15.472222	131	194	238	2	63	0.0317460
NODE_4931_length_1107_cov_15.472222	131	194	240	5	63	0.0793651
NODE_4931_length_1107_cov_15.472222	952	995	0	40	43	0.9302326
NODE_4931_length_1107_cov_15.472222	952	995	2	3	43	0.0697674
NODE_4931_length_1107_cov_15.472222	968	1052	0	84	84	1.0000000
NODE_4932_length_1107_cov_13.911706	502	582	0	1	80	0.0125000
NODE_4932_length_1107_cov_13.911706	502	582	2	79	80	0.9875000
NODE_4932_length_1107_cov_13.911706	555	635	0	12	80	0.1500000
NODE_4932_length_1107_cov_13.911706	555	635	2	68	80	0.8500000
NODE_4933_length_1107_cov_11.701389	520	600	0	80	80	1.0000000
NODE_4933_length_1107_cov_11.701389	573	653	0	80	80	1.0000000
NODE_4944_length_1106_cov_59.617676	452	532	0	42	80	0.5250000
NODE_4944_length_1106_cov_59.617676	452	532	2	38	80	0.4750000
NODE_4944_length_1106_cov_59.617676	505	585	0	30	80	0.3750000
NODE_4944_length_1106_cov_59.617676	505	585	2	50	80	0.6250000
NODE_4944_length_1106_cov_59.617676	581	661	2	28	80	0.3500000
NODE_4944_length_1106_cov_59.617676	581	661	4	52	80	0.6500000
NODE_4944_length_1106_cov_59.617676	634	714	0	48	80	0.6000000
NODE_4944_length_1106_cov_59.617676	634	714	2	10	80	0.1250000
NODE_4944_length_1106_cov_59.617676	634	714	4	22	80	0.2750000
NODE_4945_length_1106_cov_40.808342	439	504	0	65	65	1.0000000
NODE_4945_length_1106_cov_40.808342	471	511	0	40	40	1.0000000
NODE_4945_length_1106_cov_40.808342	503	569	0	66	66	1.0000000
NODE_4945_length_1106_cov_40.808342	536	601	0	65	65	1.0000000
NODE_4945_length_1106_cov_40.808342	568	648	0	80	80	1.0000000
NODE_4945_length_1106_cov_40.808342	621	682	0	61	61	1.0000000
NODE_4946_length_1106_cov_23.186693	560	640	0	80	80	1.0000000
NODE_4946_length_1106_cov_23.186693	613	693	0	80	80	1.0000000
NODE_4947_length_1106_cov_14.570010	466	546	0	36	80	0.4500000
NODE_4947_length_1106_cov_14.570010	466	546	2	44	80	0.5500000
NODE_4947_length_1106_cov_14.570010	519	599	0	13	80	0.1625000
NODE_4947_length_1106_cov_14.570010	519	599	2	67	80	0.8375000
NODE_4948_length_1106_cov_14.039722	487	567	0	11	80	0.1375000
NODE_4948_length_1106_cov_14.039722	487	567	2	17	80	0.2125000
NODE_4948_length_1106_cov_14.039722	487	567	4	52	80	0.6500000
NODE_4948_length_1106_cov_14.039722	540	620	0	64	80	0.8000000
NODE_4948_length_1106_cov_14.039722	540	620	2	16	80	0.2000000
NODE_4949_length_1106_cov_8.872890	328	408	0	80	80	1.0000000
NODE_4949_length_1106_cov_8.872890	381	461	0	80	80	1.0000000
NODE_4950_length_1106_cov_7.157895	332	412	0	19	80	0.2375000
NODE_4950_length_1106_cov_7.157895	332	412	2	61	80	0.7625000
NODE_4950_length_1106_cov_7.157895	385	465	0	45	80	0.5625000
NODE_4950_length_1106_cov_7.157895	385	465	2	35	80	0.4375000
NODE_4951_length_1106_cov_6.530288	513	593	0	34	80	0.4250000
NODE_4951_length_1106_cov_6.530288	513	593	2	46	80	0.5750000
NODE_4951_length_1106_cov_6.530288	566	646	2	80	80	1.0000000
NODE_4959_length_1105_cov_28.126243	253	333	0	12	80	0.1500000
NODE_4959_length_1105_cov_28.126243	253	333	2	68	80	0.8500000
NODE_4959_length_1105_cov_28.126243	306	386	0	42	80	0.5250000
NODE_4959_length_1105_cov_28.126243	306	386	2	38	80	0.4750000
NODE_4960_length_1105_cov_24.994036	549	629	0	80	80	1.0000000
NODE_4960_length_1105_cov_24.994036	602	682	0	80	80	1.0000000
NODE_4961_length_1105_cov_17.635189	442	522	2	80	80	1.0000000
NODE_4961_length_1105_cov_17.635189	495	575	0	42	80	0.5250000
NODE_4961_length_1105_cov_17.635189	495	575	1	5	80	0.0625000
NODE_4961_length_1105_cov_17.635189	495	575	2	33	80	0.4125000
NODE_4963_length_1105_cov_10.114314	438	518	0	80	80	1.0000000
NODE_4963_length_1105_cov_10.114314	491	571	0	37	80	0.4625000
NODE_4963_length_1105_cov_10.114314	491	571	2	43	80	0.5375000
NODE_4964_length_1105_cov_8.403579	507	587	0	80	80	1.0000000
NODE_4964_length_1105_cov_8.403579	560	640	0	80	80	1.0000000
NODE_4966_length_1105_cov_6.682903	467	547	0	37	80	0.4625000
NODE_4966_length_1105_cov_6.682903	467	547	2	43	80	0.5375000
NODE_4966_length_1105_cov_6.682903	520	600	2	80	80	1.0000000
NODE_4966_length_1105_cov_6.682903	596	676	0	72	80	0.9000000
NODE_4966_length_1105_cov_6.682903	596	676	2	8	80	0.1000000
NODE_4966_length_1105_cov_6.682903	649	729	0	80	80	1.0000000
NODE_4974_length_1104_cov_27.599005	388	468	6	28	80	0.3500000
NODE_4974_length_1104_cov_27.599005	388	468	8	16	80	0.2000000
NODE_4974_length_1104_cov_27.599005	388	468	12	3	80	0.0375000
NODE_4974_length_1104_cov_27.599005	388	468	14	33	80	0.4125000
NODE_4974_length_1104_cov_27.599005	441	521	2	36	80	0.4500000
NODE_4974_length_1104_cov_27.599005	441	521	8	33	80	0.4125000
NODE_4974_length_1104_cov_27.599005	441	521	14	11	80	0.1375000
NODE_4984_length_1103_cov_2.787849	620	682	0	62	62	1.0000000
NODE_4986_length_1102_cov_34.484546	667	747	0	79	80	0.9875000
NODE_4986_length_1102_cov_34.484546	667	747	2	1	80	0.0125000
NODE_4986_length_1102_cov_34.484546	720	800	0	26	80	0.3250000
NODE_4986_length_1102_cov_34.484546	720	800	2	54	80	0.6750000
NODE_4987_length_1102_cov_17.631107	511	587	4	76	76	1.0000000
NODE_4987_length_1102_cov_17.631107	560	640	2	32	80	0.4000000
NODE_4987_length_1102_cov_17.631107	560	640	4	48	80	0.6000000
NODE_4998_length_1101_cov_35.638723	414	491	79	5	77	0.0649351
NODE_4998_length_1101_cov_35.638723	414	491	97	3	77	0.0389610
NODE_4998_length_1101_cov_35.638723	414	491	98	3	77	0.0389610
NODE_4998_length_1101_cov_35.638723	414	491	99	5	77	0.0649351
NODE_4998_length_1101_cov_35.638723	414	491	100	7	77	0.0909091
NODE_4998_length_1101_cov_35.638723	414	491	102	2	77	0.0259740
NODE_4998_length_1101_cov_35.638723	414	491	104	8	77	0.1038961
NODE_4998_length_1101_cov_35.638723	414	491	106	1	77	0.0129870
NODE_4998_length_1101_cov_35.638723	414	491	107	9	77	0.1168831
NODE_4998_length_1101_cov_35.638723	414	491	108	1	77	0.0129870
NODE_4998_length_1101_cov_35.638723	414	491	109	1	77	0.0129870
NODE_4998_length_1101_cov_35.638723	414	491	111	32	77	0.4155844
NODE_4998_length_1101_cov_35.638723	414	491	79	5	77	0.0649351
NODE_4998_length_1101_cov_35.638723	414	491	97	3	77	0.0389610
NODE_4998_length_1101_cov_35.638723	414	491	98	3	77	0.0389610
NODE_4998_length_1101_cov_35.638723	414	491	99	5	77	0.0649351
NODE_4998_length_1101_cov_35.638723	414	491	100	7	77	0.0909091
NODE_4998_length_1101_cov_35.638723	414	491	102	2	77	0.0259740
NODE_4998_length_1101_cov_35.638723	414	491	104	8	77	0.1038961
NODE_4998_length_1101_cov_35.638723	414	491	106	1	77	0.0129870
NODE_4998_length_1101_cov_35.638723	414	491	107	9	77	0.1168831
NODE_4998_length_1101_cov_35.638723	414	491	108	1	77	0.0129870
NODE_4998_length_1101_cov_35.638723	414	491	109	1	77	0.0129870
NODE_4998_length_1101_cov_35.638723	414	491	111	32	77	0.4155844
NODE_4998_length_1101_cov_35.638723	488	544	70	8	56	0.1428571
NODE_4998_length_1101_cov_35.638723	488	544	72	9	56	0.1607143
NODE_4998_length_1101_cov_35.638723	488	544	73	6	56	0.1071429
NODE_4998_length_1101_cov_35.638723	488	544	74	3	56	0.0535714
NODE_4998_length_1101_cov_35.638723	488	544	75	1	56	0.0178571
NODE_4998_length_1101_cov_35.638723	488	544	100	1	56	0.0178571
NODE_4998_length_1101_cov_35.638723	488	544	101	1	56	0.0178571
NODE_4998_length_1101_cov_35.638723	488	544	102	8	56	0.1428571
NODE_4998_length_1101_cov_35.638723	488	544	103	12	56	0.2142857
NODE_4998_length_1101_cov_35.638723	488	544	104	6	56	0.1071429
NODE_4998_length_1101_cov_35.638723	488	544	105	1	56	0.0178571
NODE_4998_length_1101_cov_35.638723	752	832	4	47	80	0.5875000
NODE_4998_length_1101_cov_35.638723	752	832	6	33	80	0.4125000
NODE_4998_length_1101_cov_35.638723	805	885	3	13	80	0.1625000
NODE_4998_length_1101_cov_35.638723	805	885	4	62	80	0.7750000
NODE_4998_length_1101_cov_35.638723	805	885	6	4	80	0.0500000
NODE_4998_length_1101_cov_35.638723	805	885	7	1	80	0.0125000
NODE_4998_length_1101_cov_35.638723	881	961	2	16	80	0.2000000
NODE_4998_length_1101_cov_35.638723	881	961	4	64	80	0.8000000
NODE_4998_length_1101_cov_35.638723	934	1014	2	16	80	0.2000000
NODE_4998_length_1101_cov_35.638723	934	1014	4	25	80	0.3125000
NODE_4998_length_1101_cov_35.638723	934	1014	5	9	80	0.1125000
NODE_4998_length_1101_cov_35.638723	934	1014	6	15	80	0.1875000
NODE_4998_length_1101_cov_35.638723	934	1014	7	15	80	0.1875000
NODE_4999_length_1101_cov_28.366267	452	532	0	8	80	0.1000000
NODE_4999_length_1101_cov_28.366267	452	532	4	72	80	0.9000000
NODE_4999_length_1101_cov_28.366267	505	585	0	61	80	0.7625000
NODE_4999_length_1101_cov_28.366267	505	585	4	19	80	0.2375000
NODE_5000_length_1101_cov_24.513972	475	555	0	5	80	0.0625000
NODE_5000_length_1101_cov_24.513972	475	555	2	75	80	0.9375000
NODE_5000_length_1101_cov_24.513972	528	608	0	58	80	0.7250000
NODE_5000_length_1101_cov_24.513972	528	608	2	22	80	0.2750000
NODE_5001_length_1101_cov_22.315369	335	415	0	6	80	0.0750000
NODE_5001_length_1101_cov_22.315369	335	415	2	46	80	0.5750000
NODE_5001_length_1101_cov_22.315369	335	415	7	28	80	0.3500000
NODE_5001_length_1101_cov_22.315369	388	468	5	18	80	0.2250000
NODE_5001_length_1101_cov_22.315369	388	468	6	32	80	0.4000000
NODE_5001_length_1101_cov_22.315369	388	468	7	30	80	0.3750000
NODE_5001_length_1101_cov_22.315369	464	544	0	21	80	0.2625000
NODE_5001_length_1101_cov_22.315369	464	544	2	22	80	0.2750000
NODE_5001_length_1101_cov_22.315369	464	544	5	37	80	0.4625000
NODE_5001_length_1101_cov_22.315369	517	597	0	5	80	0.0625000
NODE_5001_length_1101_cov_22.315369	517	597	2	75	80	0.9375000
NODE_5002_length_1101_cov_22.070858	419	499	0	80	80	1.0000000
NODE_5002_length_1101_cov_22.070858	472	552	0	80	80	1.0000000
NODE_5002_length_1101_cov_22.070858	548	628	0	80	80	1.0000000
NODE_5002_length_1101_cov_22.070858	601	681	0	80	80	1.0000000
NODE_5003_length_1101_cov_18.821357	469	549	0	80	80	1.0000000
NODE_5003_length_1101_cov_18.821357	522	602	0	80	80	1.0000000
NODE_5004_length_1101_cov_17.151697	502	582	4	14	80	0.1750000
NODE_5004_length_1101_cov_17.151697	502	582	6	14	80	0.1750000
NODE_5004_length_1101_cov_17.151697	502	582	8	16	80	0.2000000
NODE_5004_length_1101_cov_17.151697	502	582	14	29	80	0.3625000
NODE_5004_length_1101_cov_17.151697	502	582	16	7	80	0.0875000
NODE_5004_length_1101_cov_17.151697	555	635	12	11	80	0.1375000
NODE_5004_length_1101_cov_17.151697	555	635	14	41	80	0.5125000
NODE_5004_length_1101_cov_17.151697	555	635	16	28	80	0.3500000
NODE_5005_length_1101_cov_8.371257	968	1048	23	1	80	0.0125000
NODE_5005_length_1101_cov_8.371257	968	1048	50	1	80	0.0125000
NODE_5005_length_1101_cov_8.371257	968	1048	54	1	80	0.0125000
NODE_5005_length_1101_cov_8.371257	968	1048	56	2	80	0.0250000
NODE_5005_length_1101_cov_8.371257	968	1048	58	2	80	0.0250000
NODE_5005_length_1101_cov_8.371257	968	1048	60	2	80	0.0250000
NODE_5005_length_1101_cov_8.371257	968	1048	64	3	80	0.0375000
NODE_5005_length_1101_cov_8.371257	968	1048	70	1	80	0.0125000
NODE_5005_length_1101_cov_8.371257	968	1048	80	2	80	0.0250000
NODE_5005_length_1101_cov_8.371257	968	1048	82	2	80	0.0250000
NODE_5005_length_1101_cov_8.371257	968	1048	84	1	80	0.0125000
NODE_5005_length_1101_cov_8.371257	968	1048	85	1	80	0.0125000
NODE_5005_length_1101_cov_8.371257	968	1048	90	7	80	0.0875000
NODE_5005_length_1101_cov_8.371257	968	1048	92	1	80	0.0125000
NODE_5005_length_1101_cov_8.371257	968	1048	96	4	80	0.0500000
NODE_5005_length_1101_cov_8.371257	968	1048	98	49	80	0.6125000
NODE_5010_length_1100_cov_42.528472	582	662	0	16	80	0.2000000
NODE_5010_length_1100_cov_42.528472	582	662	4	64	80	0.8000000
NODE_5010_length_1100_cov_42.528472	635	715	0	14	80	0.1750000
NODE_5010_length_1100_cov_42.528472	635	715	4	66	80	0.8250000
NODE_5010_length_1100_cov_42.528472	711	791	0	80	80	1.0000000
NODE_5010_length_1100_cov_42.528472	764	844	0	80	80	1.0000000
NODE_5011_length_1100_cov_40.883117	324	404	0	80	80	1.0000000
NODE_5011_length_1100_cov_40.883117	377	457	0	80	80	1.0000000
NODE_5011_length_1100_cov_40.883117	453	533	0	80	80	1.0000000
NODE_5011_length_1100_cov_40.883117	506	586	0	80	80	1.0000000
NODE_5012_length_1100_cov_23.160839	524	604	0	5	80	0.0625000
NODE_5012_length_1100_cov_23.160839	524	604	2	1	80	0.0125000
NODE_5012_length_1100_cov_23.160839	524	604	4	74	80	0.9250000
NODE_5012_length_1100_cov_23.160839	577	657	0	58	80	0.7250000
NODE_5012_length_1100_cov_23.160839	577	657	2	1	80	0.0125000
NODE_5012_length_1100_cov_23.160839	577	657	4	21	80	0.2625000
NODE_5012_length_1100_cov_23.160839	653	733	0	80	80	1.0000000
NODE_5012_length_1100_cov_23.160839	706	786	0	80	80	1.0000000
NODE_5013_length_1100_cov_22.200799	485	565	0	80	80	1.0000000
NODE_5013_length_1100_cov_22.200799	538	618	0	80	80	1.0000000
NODE_5013_length_1100_cov_22.200799	614	694	0	56	80	0.7000000
NODE_5013_length_1100_cov_22.200799	614	694	2	24	80	0.3000000
NODE_5013_length_1100_cov_22.200799	667	745	0	3	78	0.0384615
NODE_5013_length_1100_cov_22.200799	667	745	2	75	78	0.9615384
NODE_5014_length_1100_cov_15.353646	472	552	0	80	80	1.0000000
NODE_5014_length_1100_cov_15.353646	525	605	0	80	80	1.0000000
NODE_5015_length_1100_cov_14.584416	673	753	0	80	80	1.0000000
NODE_5015_length_1100_cov_14.584416	726	806	0	80	80	1.0000000
NODE_5029_length_1099_cov_85.893000	464	544	0	23	80	0.2875000
NODE_5029_length_1099_cov_85.893000	464	544	2	57	80	0.7125000
NODE_5029_length_1099_cov_85.893000	517	597	0	61	80	0.7625000
NODE_5029_length_1099_cov_85.893000	517	597	2	19	80	0.2375000
NODE_5029_length_1099_cov_85.893000	593	673	0	80	80	1.0000000
NODE_5029_length_1099_cov_85.893000	646	726	0	80	80	1.0000000
NODE_5030_length_1099_cov_45.874000	521	601	0	80	80	1.0000000
NODE_5030_length_1099_cov_45.874000	574	654	0	80	80	1.0000000
NODE_5030_length_1099_cov_45.874000	650	730	0	80	80	1.0000000
NODE_5030_length_1099_cov_45.874000	703	783	0	80	80	1.0000000
NODE_5031_length_1099_cov_25.192000	526	606	0	80	80	1.0000000
NODE_5031_length_1099_cov_25.192000	579	659	0	80	80	1.0000000
NODE_5032_length_1099_cov_11.846000	565	645	0	3	80	0.0375000
NODE_5032_length_1099_cov_11.846000	565	645	2	49	80	0.6125000
NODE_5032_length_1099_cov_11.846000	565	645	4	28	80	0.3500000
NODE_5032_length_1099_cov_11.846000	618	698	0	56	80	0.7000000
NODE_5032_length_1099_cov_11.846000	618	698	2	24	80	0.3000000
NODE_5033_length_1099_cov_9.527000	495	575	2	24	80	0.3000000
NODE_5033_length_1099_cov_9.527000	495	575	4	56	80	0.7000000
NODE_5033_length_1099_cov_9.527000	548	628	0	29	80	0.3625000
NODE_5033_length_1099_cov_9.527000	548	628	2	21	80	0.2625000
NODE_5033_length_1099_cov_9.527000	548	628	4	30	80	0.3750000
NODE_5034_length_1099_cov_8.993000	464	544	0	80	80	1.0000000
NODE_5034_length_1099_cov_8.993000	517	597	0	80	80	1.0000000
NODE_5039_length_1099_cov_2.286000	273	353	0	60	80	0.7500000
NODE_5039_length_1099_cov_2.286000	273	353	2	20	80	0.2500000
NODE_5045_length_1098_cov_44.988989	360	440	0	80	80	1.0000000
NODE_5045_length_1098_cov_44.988989	413	493	0	80	80	1.0000000
NODE_5046_length_1098_cov_35.192192	452	532	12	80	80	1.0000000
NODE_5046_length_1098_cov_35.192192	505	585	0	3	80	0.0375000
NODE_5046_length_1098_cov_35.192192	505	585	1	25	80	0.3125000
NODE_5046_length_1098_cov_35.192192	505	585	2	6	80	0.0750000
NODE_5046_length_1098_cov_35.192192	505	585	11	19	80	0.2375000
NODE_5046_length_1098_cov_35.192192	505	585	12	27	80	0.3375000
NODE_5046_length_1098_cov_35.192192	581	661	2	13	80	0.1625000
NODE_5046_length_1098_cov_35.192192	581	661	4	41	80	0.5125000
NODE_5046_length_1098_cov_35.192192	581	661	6	26	80	0.3250000
NODE_5046_length_1098_cov_35.192192	634	714	2	18	80	0.2250000
NODE_5046_length_1098_cov_35.192192	634	714	4	8	80	0.1000000
NODE_5046_length_1098_cov_35.192192	634	714	6	54	80	0.6750000
NODE_5047_length_1098_cov_28.743744	449	529	8	31	80	0.3875000
NODE_5047_length_1098_cov_28.743744	449	529	10	6	80	0.0750000
NODE_5047_length_1098_cov_28.743744	449	529	12	5	80	0.0625000
NODE_5047_length_1098_cov_28.743744	449	529	14	38	80	0.4750000
NODE_5047_length_1098_cov_28.743744	502	582	0	24	80	0.3000000
NODE_5047_length_1098_cov_28.743744	502	582	2	1	80	0.0125000
NODE_5047_length_1098_cov_28.743744	502	582	6	5	80	0.0625000
NODE_5047_length_1098_cov_28.743744	502	582	8	50	80	0.6250000
NODE_5047_length_1098_cov_28.743744	578	658	0	7	80	0.0875000
NODE_5047_length_1098_cov_28.743744	578	658	6	66	80	0.8250000
NODE_5047_length_1098_cov_28.743744	578	658	8	7	80	0.0875000
NODE_5047_length_1098_cov_28.743744	631	711	6	20	80	0.2500000
NODE_5047_length_1098_cov_28.743744	631	711	8	11	80	0.1375000
NODE_5047_length_1098_cov_28.743744	631	711	10	39	80	0.4875000
NODE_5047_length_1098_cov_28.743744	631	711	14	3	80	0.0375000
NODE_5047_length_1098_cov_28.743744	631	711	16	7	80	0.0875000
NODE_5048_length_1098_cov_28.230230	477	557	0	80	80	1.0000000
NODE_5048_length_1098_cov_28.230230	530	610	0	80	80	1.0000000
NODE_5048_length_1098_cov_28.230230	606	686	0	30	80	0.3750000
NODE_5048_length_1098_cov_28.230230	606	686	4	13	80	0.1625000
NODE_5048_length_1098_cov_28.230230	606	686	8	37	80	0.4625000
NODE_5048_length_1098_cov_28.230230	659	739	8	80	80	1.0000000
NODE_5049_length_1098_cov_26.131131	494	574	0	80	80	1.0000000
NODE_5049_length_1098_cov_26.131131	547	627	0	80	80	1.0000000
NODE_5050_length_1098_cov_21.355355	599	679	21	37	80	0.4625000
NODE_5050_length_1098_cov_21.355355	599	679	23	2	80	0.0250000
NODE_5050_length_1098_cov_21.355355	599	679	24	4	80	0.0500000
NODE_5050_length_1098_cov_21.355355	599	679	26	1	80	0.0125000
NODE_5050_length_1098_cov_21.355355	599	679	27	19	80	0.2375000
NODE_5050_length_1098_cov_21.355355	599	679	28	1	80	0.0125000
NODE_5050_length_1098_cov_21.355355	599	679	30	1	80	0.0125000
NODE_5050_length_1098_cov_21.355355	599	679	32	15	80	0.1875000
NODE_5050_length_1098_cov_21.355355	652	732	7	37	80	0.4625000
NODE_5050_length_1098_cov_21.355355	652	732	18	5	80	0.0625000
NODE_5050_length_1098_cov_21.355355	652	732	21	38	80	0.4750000
NODE_5051_length_1098_cov_17.087087	541	621	0	80	80	1.0000000
NODE_5051_length_1098_cov_17.087087	594	674	0	75	80	0.9375000
NODE_5051_length_1098_cov_17.087087	594	674	2	5	80	0.0625000
NODE_5051_length_1098_cov_17.087087	670	750	2	80	80	1.0000000
NODE_5051_length_1098_cov_17.087087	723	803	0	45	80	0.5625000
NODE_5051_length_1098_cov_17.087087	723	803	2	35	80	0.4375000
NODE_5052_length_1098_cov_15.455455	545	625	0	80	80	1.0000000
NODE_5052_length_1098_cov_15.455455	598	678	0	80	80	1.0000000
NODE_5052_length_1098_cov_15.455455	674	754	0	80	80	1.0000000
NODE_5052_length_1098_cov_15.455455	727	807	0	80	80	1.0000000
NODE_5054_length_1097_cov_37.103206	438	518	0	80	80	1.0000000
NODE_5054_length_1097_cov_37.103206	491	571	0	70	80	0.8750000
NODE_5054_length_1097_cov_37.103206	491	571	2	10	80	0.1250000
NODE_5054_length_1097_cov_37.103206	567	647	2	80	80	1.0000000
NODE_5054_length_1097_cov_37.103206	620	700	0	38	80	0.4750000
NODE_5054_length_1097_cov_37.103206	620	700	2	42	80	0.5250000
NODE_5055_length_1097_cov_32.624248	501	581	6	14	80	0.1750000
NODE_5055_length_1097_cov_32.624248	501	581	9	2	80	0.0250000
NODE_5055_length_1097_cov_32.624248	501	581	10	42	80	0.5250000
NODE_5055_length_1097_cov_32.624248	501	581	12	22	80	0.2750000
NODE_5055_length_1097_cov_32.624248	554	634	0	46	80	0.5750000
NODE_5055_length_1097_cov_32.624248	554	634	6	21	80	0.2625000
NODE_5055_length_1097_cov_32.624248	554	634	9	2	80	0.0250000
NODE_5055_length_1097_cov_32.624248	554	634	10	11	80	0.1375000
NODE_5056_length_1097_cov_25.240481	401	480	0	13	79	0.1645570
NODE_5056_length_1097_cov_25.240481	401	480	2	66	79	0.8354430
NODE_5056_length_1097_cov_25.240481	453	533	0	6	80	0.0750000
NODE_5056_length_1097_cov_25.240481	453	533	2	74	80	0.9250000
NODE_5056_length_1097_cov_25.240481	529	609	2	19	80	0.2375000
NODE_5056_length_1097_cov_25.240481	529	609	4	61	80	0.7625000
NODE_5056_length_1097_cov_25.240481	582	662	2	55	80	0.6875000
NODE_5056_length_1097_cov_25.240481	582	662	4	25	80	0.3125000
NODE_5057_length_1097_cov_21.221443	484	564	0	4	80	0.0500000
NODE_5057_length_1097_cov_21.221443	484	564	4	56	80	0.7000000
NODE_5057_length_1097_cov_21.221443	484	564	6	20	80	0.2500000
NODE_5057_length_1097_cov_21.221443	537	617	2	42	80	0.5250000
NODE_5057_length_1097_cov_21.221443	537	617	4	7	80	0.0875000
NODE_5057_length_1097_cov_21.221443	537	617	6	31	80	0.3875000
NODE_5057_length_1097_cov_21.221443	613	693	0	31	80	0.3875000
NODE_5057_length_1097_cov_21.221443	613	693	2	49	80	0.6125000
NODE_5057_length_1097_cov_21.221443	666	746	0	80	80	1.0000000
NODE_5058_length_1097_cov_20.968938	515	595	2	80	80	1.0000000
NODE_5058_length_1097_cov_20.968938	568	648	0	22	80	0.2750000
NODE_5058_length_1097_cov_20.968938	568	648	2	58	80	0.7250000
NODE_5059_length_1097_cov_13.136273	697	779	0	82	82	1.0000000
NODE_5059_length_1097_cov_13.136273	752	832	0	80	80	1.0000000
NODE_5060_length_1097_cov_6.376754	442	522	0	59	80	0.7375000
NODE_5060_length_1097_cov_6.376754	442	522	2	21	80	0.2625000
NODE_5060_length_1097_cov_6.376754	495	575	0	80	80	1.0000000
NODE_5061_length_1097_cov_6.068136	299	379	0	80	80	1.0000000
NODE_5061_length_1097_cov_6.068136	352	432	0	80	80	1.0000000
NODE_5072_length_1096_cov_55.816449	430	510	0	80	80	1.0000000
NODE_5072_length_1096_cov_55.816449	483	563	0	80	80	1.0000000
NODE_5072_length_1096_cov_55.816449	559	639	0	80	80	1.0000000
NODE_5072_length_1096_cov_55.816449	612	692	0	80	80	1.0000000
NODE_5073_length_1096_cov_24.672016	431	511	0	80	80	1.0000000
NODE_5073_length_1096_cov_24.672016	484	564	0	80	80	1.0000000
NODE_5073_length_1096_cov_24.672016	560	640	0	80	80	1.0000000
NODE_5073_length_1096_cov_24.672016	613	693	0	80	80	1.0000000
NODE_5074_length_1096_cov_22.980943	372	452	0	5	80	0.0625000
NODE_5074_length_1096_cov_22.980943	372	452	2	75	80	0.9375000
NODE_5074_length_1096_cov_22.980943	425	505	0	58	80	0.7250000
NODE_5074_length_1096_cov_22.980943	425	505	2	22	80	0.2750000
NODE_5075_length_1096_cov_16.649950	486	566	6	80	80	1.0000000
NODE_5075_length_1096_cov_16.649950	539	619	0	40	80	0.5000000
NODE_5075_length_1096_cov_16.649950	539	619	6	40	80	0.5000000
NODE_5076_length_1096_cov_16.433300	443	523	0	48	80	0.6000000
NODE_5076_length_1096_cov_16.433300	443	523	4	32	80	0.4000000
NODE_5076_length_1096_cov_16.433300	496	576	4	80	80	1.0000000
NODE_5076_length_1096_cov_16.433300	886	966	0	80	80	1.0000000
NODE_5076_length_1096_cov_16.433300	939	1018	0	79	79	1.0000000
NODE_5077_length_1096_cov_13.398195	670	750	0	34	80	0.4250000
NODE_5077_length_1096_cov_13.398195	670	750	2	46	80	0.5750000
NODE_5077_length_1096_cov_13.398195	723	803	0	56	80	0.7000000
NODE_5077_length_1096_cov_13.398195	723	803	4	24	80	0.3000000
NODE_5080_length_1095_cov_25.390562	520	600	0	80	80	1.0000000
NODE_5080_length_1095_cov_25.390562	573	653	0	80	80	1.0000000
NODE_5080_length_1095_cov_25.390562	649	729	0	80	80	1.0000000
NODE_5080_length_1095_cov_25.390562	702	782	0	80	80	1.0000000
NODE_5081_length_1095_cov_13.832329	549	629	0	20	80	0.2500000
NODE_5081_length_1095_cov_13.832329	549	629	2	60	80	0.7500000
NODE_5081_length_1095_cov_13.832329	602	682	2	80	80	1.0000000
NODE_5082_length_1095_cov_13.017068	497	577	0	80	80	1.0000000
NODE_5082_length_1095_cov_13.017068	550	630	0	80	80	1.0000000
NODE_5083_length_1095_cov_7.640562	627	707	0	20	80	0.2500000
NODE_5083_length_1095_cov_7.640562	627	707	2	60	80	0.7500000
NODE_5083_length_1095_cov_7.640562	680	760	0	52	80	0.6500000
NODE_5083_length_1095_cov_7.640562	680	760	2	28	80	0.3500000
NODE_5085_length_1095_cov_4.664659	307	387	0	80	80	1.0000000
NODE_5089_length_1094_cov_35.850251	409	489	0	80	80	1.0000000
NODE_5089_length_1094_cov_35.850251	462	542	0	80	80	1.0000000
NODE_5089_length_1094_cov_35.850251	538	618	0	24	80	0.3000000
NODE_5089_length_1094_cov_35.850251	538	618	4	56	80	0.7000000
NODE_5089_length_1094_cov_35.850251	591	671	0	34	80	0.4250000
NODE_5089_length_1094_cov_35.850251	591	671	4	46	80	0.5750000
NODE_5090_length_1094_cov_27.197990	462	542	14	80	80	1.0000000
NODE_5090_length_1094_cov_27.197990	515	595	0	8	80	0.1000000
NODE_5090_length_1094_cov_27.197990	515	595	1	1	80	0.0125000
NODE_5090_length_1094_cov_27.197990	515	595	11	10	80	0.1250000
NODE_5090_length_1094_cov_27.197990	515	595	14	61	80	0.7625000
NODE_5091_length_1094_cov_19.282412	451	531	0	80	80	1.0000000
NODE_5091_length_1094_cov_19.282412	504	584	0	80	80	1.0000000
NODE_5092_length_1094_cov_16.084422	558	614	0	56	56	1.0000000
NODE_5092_length_1094_cov_16.084422	587	667	0	80	80	1.0000000
NODE_5093_length_1094_cov_11.335678	384	464	0	58	80	0.7250000
NODE_5093_length_1094_cov_11.335678	384	464	4	22	80	0.2750000
NODE_5093_length_1094_cov_11.335678	437	517	0	5	80	0.0625000
NODE_5093_length_1094_cov_11.335678	437	517	4	75	80	0.9375000
NODE_5094_length_1094_cov_10.767839	396	476	0	80	80	1.0000000
NODE_5094_length_1094_cov_10.767839	449	529	0	80	80	1.0000000
NODE_5095_length_1094_cov_9.527638	579	659	0	80	80	1.0000000
NODE_5095_length_1094_cov_9.527638	632	712	0	80	80	1.0000000
NODE_5096_length_1094_cov_9.166834	527	607	0	80	80	1.0000000
NODE_5096_length_1094_cov_9.166834	580	660	0	80	80	1.0000000
NODE_5097_length_1094_cov_5.632161	708	768	0	60	60	1.0000000
NODE_5097_length_1094_cov_5.632161	761	821	0	38	60	0.6333333
NODE_5097_length_1094_cov_5.632161	761	821	2	8	60	0.1333333
NODE_5097_length_1094_cov_5.632161	761	821	4	14	60	0.2333333
NODE_5108_length_1093_cov_28.531187	374	454	0	80	80	1.0000000
NODE_5108_length_1093_cov_28.531187	427	507	0	80	80	1.0000000
NODE_5109_length_1093_cov_22.744467	516	596	0	80	80	1.0000000
NODE_5109_length_1093_cov_22.744467	569	649	0	80	80	1.0000000
NODE_5109_length_1093_cov_22.744467	645	725	0	80	80	1.0000000
NODE_5109_length_1093_cov_22.744467	698	778	0	80	80	1.0000000
NODE_5110_length_1093_cov_11.637827	282	362	2	29	80	0.3625000
NODE_5110_length_1093_cov_11.637827	282	362	4	51	80	0.6375000
NODE_5110_length_1093_cov_11.637827	335	415	0	50	80	0.6250000
NODE_5110_length_1093_cov_11.637827	335	415	2	20	80	0.2500000
NODE_5110_length_1093_cov_11.637827	335	415	4	10	80	0.1250000
NODE_5111_length_1093_cov_9.047284	660	740	3	40	80	0.5000000
NODE_5111_length_1093_cov_9.047284	660	740	6	40	80	0.5000000
NODE_5111_length_1093_cov_9.047284	713	793	6	80	80	1.0000000
NODE_5112_length_1093_cov_6.857143	658	738	0	80	80	1.0000000
NODE_5112_length_1093_cov_6.857143	711	791	0	80	80	1.0000000
NODE_5113_length_1093_cov_5.311871	587	667	0	80	80	1.0000000
NODE_5113_length_1093_cov_5.311871	640	720	0	63	80	0.7875000
NODE_5113_length_1093_cov_5.311871	640	720	2	17	80	0.2125000
NODE_5118_length_1092_cov_105.542800	682	768	211	2	86	0.0232558
NODE_5118_length_1092_cov_105.542800	682	768	217	2	86	0.0232558
NODE_5118_length_1092_cov_105.542800	682	768	221	1	86	0.0116279
NODE_5118_length_1092_cov_105.542800	682	768	222	1	86	0.0116279
NODE_5118_length_1092_cov_105.542800	682	768	223	1	86	0.0116279
NODE_5118_length_1092_cov_105.542800	682	768	224	1	86	0.0116279
NODE_5118_length_1092_cov_105.542800	682	768	246	1	86	0.0116279
NODE_5118_length_1092_cov_105.542800	682	768	247	1	86	0.0116279
NODE_5118_length_1092_cov_105.542800	682	768	248	1	86	0.0116279
NODE_5118_length_1092_cov_105.542800	682	768	262	2	86	0.0232558
NODE_5118_length_1092_cov_105.542800	682	768	266	1	86	0.0116279
NODE_5118_length_1092_cov_105.542800	682	768	275	1	86	0.0116279
NODE_5118_length_1092_cov_105.542800	682	768	289	1	86	0.0116279
NODE_5118_length_1092_cov_105.542800	682	768	290	1	86	0.0116279
NODE_5118_length_1092_cov_105.542800	682	768	296	1	86	0.0116279
NODE_5118_length_1092_cov_105.542800	682	768	307	1	86	0.0116279
NODE_5118_length_1092_cov_105.542800	682	768	311	1	86	0.0116279
NODE_5118_length_1092_cov_105.542800	682	768	319	1	86	0.0116279
NODE_5118_length_1092_cov_105.542800	682	768	322	1	86	0.0116279
NODE_5118_length_1092_cov_105.542800	682	768	328	4	86	0.0465116
NODE_5118_length_1092_cov_105.542800	682	768	336	1	86	0.0116279
NODE_5118_length_1092_cov_105.542800	682	768	348	1	86	0.0116279
NODE_5118_length_1092_cov_105.542800	682	768	351	1	86	0.0116279
NODE_5118_length_1092_cov_105.542800	682	768	359	3	86	0.0348837
NODE_5118_length_1092_cov_105.542800	682	768	361	2	86	0.0232558
NODE_5118_length_1092_cov_105.542800	682	768	365	2	86	0.0232558
NODE_5118_length_1092_cov_105.542800	682	768	369	1	86	0.0116279
NODE_5118_length_1092_cov_105.542800	682	768	379	1	86	0.0116279
NODE_5118_length_1092_cov_105.542800	682	768	383	1	86	0.0116279
NODE_5118_length_1092_cov_105.542800	682	768	385	1	86	0.0116279
NODE_5118_length_1092_cov_105.542800	682	768	391	1	86	0.0116279
NODE_5118_length_1092_cov_105.542800	682	768	393	1	86	0.0116279
NODE_5118_length_1092_cov_105.542800	682	768	396	1	86	0.0116279
NODE_5118_length_1092_cov_105.542800	682	768	397	1	86	0.0116279
NODE_5118_length_1092_cov_105.542800	682	768	400	1	86	0.0116279
NODE_5118_length_1092_cov_105.542800	682	768	402	1	86	0.0116279
NODE_5118_length_1092_cov_105.542800	682	768	410	1	86	0.0116279
NODE_5118_length_1092_cov_105.542800	682	768	415	1	86	0.0116279
NODE_5118_length_1092_cov_105.542800	682	768	416	1	86	0.0116279
NODE_5118_length_1092_cov_105.542800	682	768	419	1	86	0.0116279
NODE_5118_length_1092_cov_105.542800	682	768	423	1	86	0.0116279
NODE_5118_length_1092_cov_105.542800	682	768	427	1	86	0.0116279
NODE_5118_length_1092_cov_105.542800	682	768	428	1	86	0.0116279
NODE_5118_length_1092_cov_105.542800	682	768	429	2	86	0.0232558
NODE_5118_length_1092_cov_105.542800	682	768	430	2	86	0.0232558
NODE_5118_length_1092_cov_105.542800	682	768	432	4	86	0.0465116
NODE_5118_length_1092_cov_105.542800	682	768	436	2	86	0.0232558
NODE_5118_length_1092_cov_105.542800	682	768	439	5	86	0.0581395
NODE_5118_length_1092_cov_105.542800	682	768	441	2	86	0.0232558
NODE_5118_length_1092_cov_105.542800	682	768	442	1	86	0.0116279
NODE_5118_length_1092_cov_105.542800	682	768	443	3	86	0.0348837
NODE_5118_length_1092_cov_105.542800	682	768	445	7	86	0.0813954
NODE_5118_length_1092_cov_105.542800	682	768	447	4	86	0.0465116
NODE_5118_length_1092_cov_105.542800	682	768	449	1	86	0.0116279
NODE_5118_length_1092_cov_105.542800	745	807	310	1	62	0.0161290
NODE_5118_length_1092_cov_105.542800	745	807	334	1	62	0.0161290
NODE_5118_length_1092_cov_105.542800	745	807	335	1	62	0.0161290
NODE_5118_length_1092_cov_105.542800	745	807	336	1	62	0.0161290
NODE_5118_length_1092_cov_105.542800	745	807	339	2	62	0.0322581
NODE_5118_length_1092_cov_105.542800	745	807	347	1	62	0.0161290
NODE_5118_length_1092_cov_105.542800	745	807	348	1	62	0.0161290
NODE_5118_length_1092_cov_105.542800	745	807	349	1	62	0.0161290
NODE_5118_length_1092_cov_105.542800	745	807	351	1	62	0.0161290
NODE_5118_length_1092_cov_105.542800	745	807	357	4	62	0.0645161
NODE_5118_length_1092_cov_105.542800	745	807	363	1	62	0.0161290
NODE_5118_length_1092_cov_105.542800	745	807	366	1	62	0.0161290
NODE_5118_length_1092_cov_105.542800	745	807	372	2	62	0.0322581
NODE_5118_length_1092_cov_105.542800	745	807	375	1	62	0.0161290
NODE_5118_length_1092_cov_105.542800	745	807	383	2	62	0.0322581
NODE_5118_length_1092_cov_105.542800	745	807	388	1	62	0.0161290
NODE_5118_length_1092_cov_105.542800	745	807	391	1	62	0.0161290
NODE_5118_length_1092_cov_105.542800	745	807	394	1	62	0.0161290
NODE_5118_length_1092_cov_105.542800	745	807	395	1	62	0.0161290
NODE_5118_length_1092_cov_105.542800	745	807	402	4	62	0.0645161
NODE_5118_length_1092_cov_105.542800	745	807	406	4	62	0.0645161
NODE_5118_length_1092_cov_105.542800	745	807	413	1	62	0.0161290
NODE_5118_length_1092_cov_105.542800	745	807	415	3	62	0.0483871
NODE_5118_length_1092_cov_105.542800	745	807	418	1	62	0.0161290
NODE_5118_length_1092_cov_105.542800	745	807	422	1	62	0.0161290
NODE_5118_length_1092_cov_105.542800	745	807	427	1	62	0.0161290
NODE_5118_length_1092_cov_105.542800	745	807	428	1	62	0.0161290
NODE_5118_length_1092_cov_105.542800	745	807	429	2	62	0.0322581
NODE_5118_length_1092_cov_105.542800	745	807	430	2	62	0.0322581
NODE_5118_length_1092_cov_105.542800	745	807	436	2	62	0.0322581
NODE_5118_length_1092_cov_105.542800	745	807	439	5	62	0.0806452
NODE_5118_length_1092_cov_105.542800	745	807	441	2	62	0.0322581
NODE_5118_length_1092_cov_105.542800	745	807	443	1	62	0.0161290
NODE_5118_length_1092_cov_105.542800	745	807	445	3	62	0.0483871
NODE_5118_length_1092_cov_105.542800	745	807	447	4	62	0.0645161
NODE_5119_length_1092_cov_30.957704	610	690	0	51	80	0.6375000
NODE_5119_length_1092_cov_30.957704	610	690	8	29	80	0.3625000
NODE_5119_length_1092_cov_30.957704	663	743	8	80	80	1.0000000
NODE_5121_length_1092_cov_16.737160	725	805	0	80	80	1.0000000
NODE_5121_length_1092_cov_16.737160	778	858	0	80	80	1.0000000
NODE_5123_length_1092_cov_11.193353	335	415	0	80	80	1.0000000
NODE_5123_length_1092_cov_11.193353	388	468	0	80	80	1.0000000
NODE_5124_length_1092_cov_9.348439	489	569	0	80	80	1.0000000
NODE_5124_length_1092_cov_9.348439	542	622	0	80	80	1.0000000
NODE_5125_length_1092_cov_7.533736	243	323	2	48	80	0.6000000
NODE_5125_length_1092_cov_7.533736	243	323	4	32	80	0.4000000
NODE_5125_length_1092_cov_7.533736	296	376	0	51	80	0.6375000
NODE_5125_length_1092_cov_7.533736	296	376	2	29	80	0.3625000
NODE_5126_length_1092_cov_6.968781	470	550	0	80	80	1.0000000
NODE_5126_length_1092_cov_6.968781	523	603	0	80	80	1.0000000
NODE_5134_length_1091_cov_54.234879	417	497	2	11	80	0.1375000
NODE_5134_length_1091_cov_54.234879	417	497	4	15	80	0.1875000
NODE_5134_length_1091_cov_54.234879	417	497	6	54	80	0.6750000
NODE_5134_length_1091_cov_54.234879	470	550	0	35	80	0.4375000
NODE_5134_length_1091_cov_54.234879	470	550	4	33	80	0.4125000
NODE_5134_length_1091_cov_54.234879	470	550	6	12	80	0.1500000
NODE_5134_length_1091_cov_54.234879	546	626	0	80	80	1.0000000
NODE_5134_length_1091_cov_54.234879	599	679	0	80	80	1.0000000
NODE_5135_length_1091_cov_35.045363	384	464	0	80	80	1.0000000
NODE_5135_length_1091_cov_35.045363	437	517	0	80	80	1.0000000
NODE_5135_length_1091_cov_35.045363	513	593	0	54	80	0.6750000
NODE_5135_length_1091_cov_35.045363	513	593	2	26	80	0.3250000
NODE_5135_length_1091_cov_35.045363	566	646	0	1	80	0.0125000
NODE_5135_length_1091_cov_35.045363	566	646	2	79	80	0.9875000
NODE_5136_length_1091_cov_28.490927	329	409	0	80	80	1.0000000
NODE_5136_length_1091_cov_28.490927	382	462	0	80	80	1.0000000
NODE_5136_length_1091_cov_28.490927	618	698	0	8	80	0.1000000
NODE_5136_length_1091_cov_28.490927	618	698	4	72	80	0.9000000
NODE_5136_length_1091_cov_28.490927	671	751	0	29	80	0.3625000
NODE_5136_length_1091_cov_28.490927	671	751	4	51	80	0.6375000
NODE_5137_length_1091_cov_23.733871	514	594	2	20	80	0.2500000
NODE_5137_length_1091_cov_23.733871	514	594	4	37	80	0.4625000
NODE_5137_length_1091_cov_23.733871	514	594	8	2	80	0.0250000
NODE_5137_length_1091_cov_23.733871	514	594	15	21	80	0.2625000
NODE_5137_length_1091_cov_23.733871	567	647	4	4	80	0.0500000
NODE_5137_length_1091_cov_23.733871	567	647	8	2	80	0.0250000
NODE_5137_length_1091_cov_23.733871	567	647	11	8	80	0.1000000
NODE_5137_length_1091_cov_23.733871	567	647	13	25	80	0.3125000
NODE_5137_length_1091_cov_23.733871	567	647	15	41	80	0.5125000
NODE_5138_length_1091_cov_13.065524	444	524	0	15	80	0.1875000
NODE_5138_length_1091_cov_13.065524	444	524	2	65	80	0.8125000
NODE_5138_length_1091_cov_13.065524	497	577	0	6	80	0.0750000
NODE_5138_length_1091_cov_13.065524	497	577	2	74	80	0.9250000
NODE_5139_length_1091_cov_10.961694	582	646	0	64	64	1.0000000
NODE_5140_length_1091_cov_8.166331	299	379	2	80	80	1.0000000
NODE_5140_length_1091_cov_8.166331	352	432	0	50	80	0.6250000
NODE_5140_length_1091_cov_8.166331	352	432	2	30	80	0.3750000
NODE_5141_length_1091_cov_7.006048	617	697	0	17	80	0.2125000
NODE_5141_length_1091_cov_7.006048	617	697	4	63	80	0.7875000
NODE_5141_length_1091_cov_7.006048	670	750	0	70	80	0.8750000
NODE_5141_length_1091_cov_7.006048	670	750	4	10	80	0.1250000
NODE_5151_length_1090_cov_73.781029	352	432	4	35	80	0.4375000
NODE_5151_length_1090_cov_73.781029	352	432	8	35	80	0.4375000
NODE_5151_length_1090_cov_73.781029	352	432	10	7	80	0.0875000
NODE_5151_length_1090_cov_73.781029	352	432	12	3	80	0.0375000
NODE_5151_length_1090_cov_73.781029	405	485	8	30	80	0.3750000
NODE_5151_length_1090_cov_73.781029	405	485	10	50	80	0.6250000
NODE_5151_length_1090_cov_73.781029	481	567	0	38	86	0.4418605
NODE_5151_length_1090_cov_73.781029	481	567	2	38	86	0.4418605
NODE_5151_length_1090_cov_73.781029	481	567	6	2	86	0.0232558
NODE_5151_length_1090_cov_73.781029	481	567	10	8	86	0.0930233
NODE_5151_length_1090_cov_73.781029	540	620	0	25	80	0.3125000
NODE_5151_length_1090_cov_73.781029	540	620	6	55	80	0.6875000
NODE_5152_length_1090_cov_42.394551	530	610	0	80	80	1.0000000
NODE_5152_length_1090_cov_42.394551	583	663	0	80	80	1.0000000
NODE_5153_length_1090_cov_37.643794	436	516	0	80	80	1.0000000
NODE_5153_length_1090_cov_37.643794	489	569	0	80	80	1.0000000
NODE_5153_length_1090_cov_37.643794	565	645	0	43	80	0.5375000
NODE_5153_length_1090_cov_37.643794	565	645	12	37	80	0.4625000
NODE_5153_length_1090_cov_37.643794	618	698	12	80	80	1.0000000
NODE_5154_length_1090_cov_32.876892	487	567	0	2	80	0.0250000
NODE_5154_length_1090_cov_32.876892	487	567	1	12	80	0.1500000
NODE_5154_length_1090_cov_32.876892	487	567	2	66	80	0.8250000
NODE_5154_length_1090_cov_32.876892	540	620	2	80	80	1.0000000
NODE_5155_length_1090_cov_25.373360	486	566	0	80	80	1.0000000
NODE_5155_length_1090_cov_25.373360	539	619	0	80	80	1.0000000
NODE_5156_length_1090_cov_21.290616	422	502	0	29	80	0.3625000
NODE_5156_length_1090_cov_21.290616	422	502	4	51	80	0.6375000
NODE_5156_length_1090_cov_21.290616	475	555	0	22	80	0.2750000
NODE_5156_length_1090_cov_21.290616	475	555	4	58	80	0.7250000
NODE_5156_length_1090_cov_21.290616	551	631	0	80	80	1.0000000
NODE_5156_length_1090_cov_21.290616	604	684	0	80	80	1.0000000
NODE_5157_length_1090_cov_16.040363	666	746	2	29	80	0.3625000
NODE_5157_length_1090_cov_16.040363	666	746	4	22	80	0.2750000
NODE_5157_length_1090_cov_16.040363	666	746	6	29	80	0.3625000
NODE_5157_length_1090_cov_16.040363	719	799	4	41	80	0.5125000
NODE_5157_length_1090_cov_16.040363	719	799	6	39	80	0.4875000
NODE_5158_length_1090_cov_14.826438	393	473	0	80	80	1.0000000
NODE_5158_length_1090_cov_14.826438	446	526	0	80	80	1.0000000
NODE_5159_length_1090_cov_13.721493	498	578	2	80	80	1.0000000
NODE_5159_length_1090_cov_13.721493	551	631	0	51	80	0.6375000
NODE_5159_length_1090_cov_13.721493	551	631	2	29	80	0.3625000
NODE_5160_length_1090_cov_12.365288	386	467	0	81	81	1.0000000
NODE_5160_length_1090_cov_12.365288	440	520	0	46	80	0.5750000
NODE_5160_length_1090_cov_12.365288	440	520	2	34	80	0.4250000
NODE_5160_length_1090_cov_12.365288	516	596	2	52	80	0.6500000
NODE_5160_length_1090_cov_12.365288	516	596	4	28	80	0.3500000
NODE_5160_length_1090_cov_12.365288	569	649	2	56	80	0.7000000
NODE_5160_length_1090_cov_12.365288	569	649	4	24	80	0.3000000
NODE_5161_length_1090_cov_5.348133	0	80	7	4	80	0.0500000
NODE_5161_length_1090_cov_5.348133	0	80	9	1	80	0.0125000
NODE_5161_length_1090_cov_5.348133	0	80	11	1	80	0.0125000
NODE_5161_length_1090_cov_5.348133	0	80	13	2	80	0.0250000
NODE_5161_length_1090_cov_5.348133	0	80	15	2	80	0.0250000
NODE_5161_length_1090_cov_5.348133	0	80	19	2	80	0.0250000
NODE_5161_length_1090_cov_5.348133	0	80	21	1	80	0.0125000
NODE_5161_length_1090_cov_5.348133	0	80	23	1	80	0.0125000
NODE_5161_length_1090_cov_5.348133	0	80	25	7	80	0.0875000
NODE_5161_length_1090_cov_5.348133	0	80	27	3	80	0.0375000
NODE_5161_length_1090_cov_5.348133	0	80	30	10	80	0.1250000
NODE_5161_length_1090_cov_5.348133	0	80	31	1	80	0.0125000
NODE_5161_length_1090_cov_5.348133	0	80	32	14	80	0.1750000
NODE_5161_length_1090_cov_5.348133	0	80	34	1	80	0.0125000
NODE_5161_length_1090_cov_5.348133	0	80	35	3	80	0.0375000
NODE_5161_length_1090_cov_5.348133	0	80	43	2	80	0.0250000
NODE_5161_length_1090_cov_5.348133	0	80	51	1	80	0.0125000
NODE_5161_length_1090_cov_5.348133	0	80	55	1	80	0.0125000
NODE_5161_length_1090_cov_5.348133	0	80	62	8	80	0.1000000
NODE_5161_length_1090_cov_5.348133	0	80	63	5	80	0.0625000
NODE_5161_length_1090_cov_5.348133	0	80	64	10	80	0.1250000
NODE_5161_length_1090_cov_5.348133	53	99	43	2	46	0.0434783
NODE_5161_length_1090_cov_5.348133	53	99	51	1	46	0.0217391
NODE_5161_length_1090_cov_5.348133	53	99	55	1	46	0.0217391
NODE_5161_length_1090_cov_5.348133	53	99	62	8	46	0.1739130
NODE_5161_length_1090_cov_5.348133	53	99	63	5	46	0.1086956
NODE_5161_length_1090_cov_5.348133	53	99	64	10	46	0.2173913
NODE_5161_length_1090_cov_5.348133	53	99	66	4	46	0.0869565
NODE_5161_length_1090_cov_5.348133	53	99	69	1	46	0.0217391
NODE_5161_length_1090_cov_5.348133	53	99	70	3	46	0.0652174
NODE_5161_length_1090_cov_5.348133	53	99	74	9	46	0.1956522
NODE_5161_length_1090_cov_5.348133	53	99	76	2	46	0.0434783
NODE_5163_length_1090_cov_3.598385	300	340	32	2	40	0.0500000
NODE_5163_length_1090_cov_3.598385	300	340	33	1	40	0.0250000
NODE_5163_length_1090_cov_3.598385	300	340	36	2	40	0.0500000
NODE_5163_length_1090_cov_3.598385	300	340	38	6	40	0.1500000
NODE_5163_length_1090_cov_3.598385	300	340	40	1	40	0.0250000
NODE_5163_length_1090_cov_3.598385	300	340	41	2	40	0.0500000
NODE_5163_length_1090_cov_3.598385	300	340	42	13	40	0.3250000
NODE_5163_length_1090_cov_3.598385	300	340	43	13	40	0.3250000
NODE_5170_length_1089_cov_55.374747	515	594	0	79	79	1.0000000
NODE_5170_length_1089_cov_55.374747	567	647	0	80	80	1.0000000
NODE_5170_length_1089_cov_55.374747	643	723	0	80	80	1.0000000
NODE_5170_length_1089_cov_55.374747	696	776	0	80	80	1.0000000
NODE_5171_length_1089_cov_38.506061	458	538	0	80	80	1.0000000
NODE_5171_length_1089_cov_38.506061	511	591	0	80	80	1.0000000
NODE_5171_length_1089_cov_38.506061	587	667	0	40	80	0.5000000
NODE_5171_length_1089_cov_38.506061	587	667	8	40	80	0.5000000
NODE_5171_length_1089_cov_38.506061	640	720	0	8	80	0.1000000
NODE_5171_length_1089_cov_38.506061	640	720	8	72	80	0.9000000
NODE_5172_length_1089_cov_22.657576	379	459	4	13	80	0.1625000
NODE_5172_length_1089_cov_22.657576	379	459	6	67	80	0.8375000
NODE_5172_length_1089_cov_22.657576	432	512	0	23	80	0.2875000
NODE_5172_length_1089_cov_22.657576	432	512	4	24	80	0.3000000
NODE_5172_length_1089_cov_22.657576	432	512	6	33	80	0.4125000
NODE_5173_length_1089_cov_21.180808	547	627	6	10	80	0.1250000
NODE_5173_length_1089_cov_21.180808	547	627	10	61	80	0.7625000
NODE_5173_length_1089_cov_21.180808	547	627	14	9	80	0.1125000
NODE_5173_length_1089_cov_21.180808	600	680	6	35	80	0.4375000
NODE_5173_length_1089_cov_21.180808	600	680	8	5	80	0.0625000
NODE_5173_length_1089_cov_21.180808	600	680	9	4	80	0.0500000
NODE_5173_length_1089_cov_21.180808	600	680	10	22	80	0.2750000
NODE_5173_length_1089_cov_21.180808	600	680	13	1	80	0.0125000
NODE_5173_length_1089_cov_21.180808	600	680	14	13	80	0.1625000
NODE_5174_length_1089_cov_18.713131	431	511	2	29	80	0.3625000
NODE_5174_length_1089_cov_18.713131	431	511	4	27	80	0.3375000
NODE_5174_length_1089_cov_18.713131	431	511	6	24	80	0.3000000
NODE_5174_length_1089_cov_18.713131	484	564	0	41	80	0.5125000
NODE_5174_length_1089_cov_18.713131	484	564	2	32	80	0.4000000
NODE_5174_length_1089_cov_18.713131	484	564	4	7	80	0.0875000
NODE_5174_length_1089_cov_18.713131	560	640	4	20	80	0.2500000
NODE_5174_length_1089_cov_18.713131	560	640	8	60	80	0.7500000
NODE_5174_length_1089_cov_18.713131	613	693	0	37	80	0.4625000
NODE_5174_length_1089_cov_18.713131	613	693	4	20	80	0.2500000
NODE_5174_length_1089_cov_18.713131	613	693	8	23	80	0.2875000
NODE_5175_length_1089_cov_17.382828	376	456	0	80	80	1.0000000
NODE_5175_length_1089_cov_17.382828	429	509	0	80	80	1.0000000
NODE_5175_length_1089_cov_17.382828	505	585	0	80	80	1.0000000
NODE_5175_length_1089_cov_17.382828	558	638	0	80	80	1.0000000
NODE_5176_length_1089_cov_14.540404	610	690	0	80	80	1.0000000
NODE_5176_length_1089_cov_14.540404	663	743	0	80	80	1.0000000
NODE_5182_length_1088_cov_10.603640	504	584	0	80	80	1.0000000
NODE_5182_length_1088_cov_10.603640	557	632	0	75	75	1.0000000
NODE_5194_length_1088_cov_0.759353	0	59	0	59	59	1.0000000
NODE_5194_length_1088_cov_0.759353	32	97	0	65	65	1.0000000
NODE_5195_length_1087_cov_51.676113	457	537	0	48	80	0.6000000
NODE_5195_length_1087_cov_51.676113	457	537	3	32	80	0.4000000
NODE_5195_length_1087_cov_51.676113	510	590	0	80	80	1.0000000
NODE_5195_length_1087_cov_51.676113	586	666	0	80	80	1.0000000
NODE_5195_length_1087_cov_51.676113	639	719	0	80	80	1.0000000
NODE_5196_length_1087_cov_47.144737	214	276	100	2	62	0.0322581
NODE_5196_length_1087_cov_47.144737	214	276	106	3	62	0.0483871
NODE_5196_length_1087_cov_47.144737	214	276	115	1	62	0.0161290
NODE_5196_length_1087_cov_47.144737	214	276	117	2	62	0.0322581
NODE_5196_length_1087_cov_47.144737	214	276	118	1	62	0.0161290
NODE_5196_length_1087_cov_47.144737	214	276	121	1	62	0.0161290
NODE_5196_length_1087_cov_47.144737	214	276	125	1	62	0.0161290
NODE_5196_length_1087_cov_47.144737	214	276	129	1	62	0.0161290
NODE_5196_length_1087_cov_47.144737	214	276	130	1	62	0.0161290
NODE_5196_length_1087_cov_47.144737	214	276	138	1	62	0.0161290
NODE_5196_length_1087_cov_47.144737	214	276	139	1	62	0.0161290
NODE_5196_length_1087_cov_47.144737	214	276	156	1	62	0.0161290
NODE_5196_length_1087_cov_47.144737	214	276	157	1	62	0.0161290
NODE_5196_length_1087_cov_47.144737	214	276	160	1	62	0.0161290
NODE_5196_length_1087_cov_47.144737	214	276	162	2	62	0.0322581
NODE_5196_length_1087_cov_47.144737	214	276	163	1	62	0.0161290
NODE_5196_length_1087_cov_47.144737	214	276	166	2	62	0.0322581
NODE_5196_length_1087_cov_47.144737	214	276	170	1	62	0.0161290
NODE_5196_length_1087_cov_47.144737	214	276	176	1	62	0.0161290
NODE_5196_length_1087_cov_47.144737	214	276	179	1	62	0.0161290
NODE_5196_length_1087_cov_47.144737	214	276	185	2	62	0.0322581
NODE_5196_length_1087_cov_47.144737	214	276	193	1	62	0.0161290
NODE_5196_length_1087_cov_47.144737	214	276	195	2	62	0.0322581
NODE_5196_length_1087_cov_47.144737	214	276	197	1	62	0.0161290
NODE_5196_length_1087_cov_47.144737	214	276	201	2	62	0.0322581
NODE_5196_length_1087_cov_47.144737	214	276	211	1	62	0.0161290
NODE_5196_length_1087_cov_47.144737	214	276	215	1	62	0.0161290
NODE_5196_length_1087_cov_47.144737	214	276	219	1	62	0.0161290
NODE_5196_length_1087_cov_47.144737	214	276	232	2	62	0.0322581
NODE_5196_length_1087_cov_47.144737	214	276	235	5	62	0.0806452
NODE_5196_length_1087_cov_47.144737	214	276	237	4	62	0.0645161
NODE_5196_length_1087_cov_47.144737	214	276	239	1	62	0.0161290
NODE_5196_length_1087_cov_47.144737	214	276	241	9	62	0.1451613
NODE_5196_length_1087_cov_47.144737	214	276	243	1	62	0.0161290
NODE_5196_length_1087_cov_47.144737	214	276	244	3	62	0.0483871
NODE_5196_length_1087_cov_47.144737	630	710	0	72	80	0.9000000
NODE_5196_length_1087_cov_47.144737	630	710	2	8	80	0.1000000
NODE_5196_length_1087_cov_47.144737	683	763	0	19	80	0.2375000
NODE_5196_length_1087_cov_47.144737	683	763	2	61	80	0.7625000
NODE_5197_length_1087_cov_46.633603	871	951	0	80	80	1.0000000
NODE_5197_length_1087_cov_46.633603	924	999	0	75	75	1.0000000
NODE_5198_length_1087_cov_30.577935	528	608	0	47	80	0.5875000
NODE_5198_length_1087_cov_30.577935	528	608	4	33	80	0.4125000
NODE_5198_length_1087_cov_30.577935	581	661	0	80	80	1.0000000
NODE_5199_length_1087_cov_30.205466	515	591	0	20	76	0.2631579
NODE_5199_length_1087_cov_30.205466	515	591	2	3	76	0.0394737
NODE_5199_length_1087_cov_30.205466	515	591	6	32	76	0.4210526
NODE_5199_length_1087_cov_30.205466	515	591	10	21	76	0.2763158
NODE_5199_length_1087_cov_30.205466	564	644	6	6	80	0.0750000
NODE_5199_length_1087_cov_30.205466	564	644	8	15	80	0.1875000
NODE_5199_length_1087_cov_30.205466	564	644	10	59	80	0.7375000
NODE_5200_length_1087_cov_29.595142	568	648	0	80	80	1.0000000
NODE_5200_length_1087_cov_29.595142	621	701	0	80	80	1.0000000
NODE_5201_length_1087_cov_11.600202	374	454	0	80	80	1.0000000
NODE_5201_length_1087_cov_11.600202	427	507	0	80	80	1.0000000
NODE_5202_length_1087_cov_7.746964	436	516	0	80	80	1.0000000
NODE_5202_length_1087_cov_7.746964	489	569	0	80	80	1.0000000
NODE_5211_length_1086_cov_35.748734	406	486	0	80	80	1.0000000
NODE_5211_length_1086_cov_35.748734	459	539	0	80	80	1.0000000
NODE_5212_length_1086_cov_18.445795	325	405	0	80	80	1.0000000
NODE_5212_length_1086_cov_18.445795	378	458	0	80	80	1.0000000
NODE_5213_length_1086_cov_16.878419	528	608	0	80	80	1.0000000
NODE_5213_length_1086_cov_16.878419	581	661	0	80	80	1.0000000
NODE_5214_length_1086_cov_10.700101	498	578	0	80	80	1.0000000
NODE_5214_length_1086_cov_10.700101	551	631	0	80	80	1.0000000
NODE_5215_length_1086_cov_10.656535	277	357	0	80	80	1.0000000
NODE_5215_length_1086_cov_10.656535	330	410	0	80	80	1.0000000
NODE_5216_length_1086_cov_6.873354	374	454	0	42	80	0.5250000
NODE_5216_length_1086_cov_6.873354	374	454	2	38	80	0.4750000
NODE_5216_length_1086_cov_6.873354	427	507	0	80	80	1.0000000
NODE_5217_length_1086_cov_5.225937	869	949	0	80	80	1.0000000
NODE_5217_length_1086_cov_5.225937	922	1002	0	80	80	1.0000000
NODE_5229_length_1085_cov_30.599391	515	595	0	80	80	1.0000000
NODE_5229_length_1085_cov_30.599391	568	648	0	27	80	0.3375000
NODE_5229_length_1085_cov_30.599391	568	648	3	1	80	0.0125000
NODE_5229_length_1085_cov_30.599391	568	648	4	52	80	0.6500000
NODE_5231_length_1085_cov_13.723124	558	638	0	80	80	1.0000000
NODE_5231_length_1085_cov_13.723124	611	691	0	80	80	1.0000000
NODE_5232_length_1085_cov_12.481744	576	656	0	80	80	1.0000000
NODE_5232_length_1085_cov_12.481744	629	709	0	80	80	1.0000000
NODE_5233_length_1085_cov_11.570994	553	633	0	51	80	0.6375000
NODE_5233_length_1085_cov_11.570994	553	633	2	29	80	0.3625000
NODE_5233_length_1085_cov_11.570994	606	686	0	26	80	0.3250000
NODE_5233_length_1085_cov_11.570994	606	686	2	54	80	0.6750000
NODE_5234_length_1085_cov_10.730223	273	353	0	80	80	1.0000000
NODE_5234_length_1085_cov_10.730223	326	406	0	80	80	1.0000000
NODE_5234_length_1085_cov_10.730223	402	482	0	5	80	0.0625000
NODE_5234_length_1085_cov_10.730223	402	482	2	45	80	0.5625000
NODE_5234_length_1085_cov_10.730223	402	482	6	30	80	0.3750000
NODE_5234_length_1085_cov_10.730223	455	535	2	12	80	0.1500000
NODE_5234_length_1085_cov_10.730223	455	535	6	68	80	0.8500000
NODE_5234_length_1085_cov_10.730223	832	908	12	1	76	0.0131579
NODE_5234_length_1085_cov_10.730223	832	908	14	1	76	0.0131579
NODE_5234_length_1085_cov_10.730223	832	908	18	4	76	0.0526316
NODE_5234_length_1085_cov_10.730223	832	908	20	4	76	0.0526316
NODE_5234_length_1085_cov_10.730223	832	908	24	3	76	0.0394737
NODE_5234_length_1085_cov_10.730223	832	908	28	4	76	0.0526316
NODE_5234_length_1085_cov_10.730223	832	908	32	10	76	0.1315790
NODE_5234_length_1085_cov_10.730223	832	908	34	1	76	0.0131579
NODE_5234_length_1085_cov_10.730223	832	908	38	1	76	0.0131579
NODE_5234_length_1085_cov_10.730223	832	908	40	1	76	0.0131579
NODE_5234_length_1085_cov_10.730223	832	908	44	1	76	0.0131579
NODE_5234_length_1085_cov_10.730223	832	908	46	3	76	0.0394737
NODE_5234_length_1085_cov_10.730223	832	908	48	1	76	0.0131579
NODE_5234_length_1085_cov_10.730223	832	908	49	3	76	0.0394737
NODE_5234_length_1085_cov_10.730223	832	908	51	2	76	0.0263158
NODE_5234_length_1085_cov_10.730223	832	908	53	12	76	0.1578947
NODE_5234_length_1085_cov_10.730223	832	908	54	4	76	0.0526316
NODE_5234_length_1085_cov_10.730223	832	908	55	2	76	0.0263158
NODE_5234_length_1085_cov_10.730223	832	908	56	11	76	0.1447368
NODE_5234_length_1085_cov_10.730223	832	908	58	7	76	0.0921053
NODE_5236_length_1085_cov_8.309331	400	480	0	16	80	0.2000000
NODE_5236_length_1085_cov_8.309331	400	480	2	64	80	0.8000000
NODE_5236_length_1085_cov_8.309331	453	533	0	69	80	0.8625000
NODE_5236_length_1085_cov_8.309331	453	533	2	11	80	0.1375000
NODE_5248_length_1084_cov_60.255838	446	524	0	20	78	0.2564103
NODE_5248_length_1084_cov_60.255838	446	524	11	21	78	0.2692308
NODE_5248_length_1084_cov_60.255838	446	524	15	28	78	0.3589744
NODE_5248_length_1084_cov_60.255838	446	524	22	1	78	0.0128205
NODE_5248_length_1084_cov_60.255838	446	524	26	8	78	0.1025641
NODE_5248_length_1084_cov_60.255838	497	577	15	18	80	0.2250000
NODE_5248_length_1084_cov_60.255838	497	577	22	21	80	0.2625000
NODE_5248_length_1084_cov_60.255838	497	577	26	41	80	0.5125000
NODE_5249_length_1084_cov_33.332995	445	525	0	19	80	0.2375000
NODE_5249_length_1084_cov_33.332995	445	525	1	1	80	0.0125000
NODE_5249_length_1084_cov_33.332995	445	525	2	60	80	0.7500000
NODE_5249_length_1084_cov_33.332995	498	578	0	72	80	0.9000000
NODE_5249_length_1084_cov_33.332995	498	578	1	1	80	0.0125000
NODE_5249_length_1084_cov_33.332995	498	578	2	7	80	0.0875000
NODE_5250_length_1084_cov_11.004061	757	837	0	80	80	1.0000000
NODE_5250_length_1084_cov_11.004061	810	890	0	80	80	1.0000000
NODE_5258_length_1083_cov_42.182927	451	531	0	80	80	1.0000000
NODE_5258_length_1083_cov_42.182927	504	584	0	49	80	0.6125000
NODE_5258_length_1083_cov_42.182927	504	584	2	31	80	0.3875000
NODE_5258_length_1083_cov_42.182927	580	660	2	20	80	0.2500000
NODE_5258_length_1083_cov_42.182927	580	660	6	48	80	0.6000000
NODE_5258_length_1083_cov_42.182927	580	660	8	2	80	0.0250000
NODE_5258_length_1083_cov_42.182927	580	660	14	10	80	0.1250000
NODE_5258_length_1083_cov_42.182927	633	713	6	15	80	0.1875000
NODE_5258_length_1083_cov_42.182927	633	713	8	2	80	0.0250000
NODE_5258_length_1083_cov_42.182927	633	713	10	45	80	0.5625000
NODE_5258_length_1083_cov_42.182927	633	713	14	18	80	0.2250000
NODE_5259_length_1083_cov_41.163618	275	355	0	80	80	1.0000000
NODE_5259_length_1083_cov_41.163618	328	408	0	80	80	1.0000000
NODE_5259_length_1083_cov_41.163618	404	484	0	80	80	1.0000000
NODE_5259_length_1083_cov_41.163618	457	537	0	80	80	1.0000000
NODE_5260_length_1083_cov_39.798780	527	607	0	17	80	0.2125000
NODE_5260_length_1083_cov_39.798780	527	607	2	63	80	0.7875000
NODE_5260_length_1083_cov_39.798780	580	660	0	55	80	0.6875000
NODE_5260_length_1083_cov_39.798780	580	660	2	25	80	0.3125000
NODE_5261_length_1083_cov_34.261179	475	555	0	30	80	0.3750000
NODE_5261_length_1083_cov_34.261179	475	555	2	50	80	0.6250000
NODE_5261_length_1083_cov_34.261179	528	608	0	80	80	1.0000000
NODE_5262_length_1083_cov_33.573171	486	566	0	80	80	1.0000000
NODE_5262_length_1083_cov_33.573171	539	619	0	80	80	1.0000000
NODE_5262_length_1083_cov_33.573171	615	695	0	15	80	0.1875000
NODE_5262_length_1083_cov_33.573171	615	695	4	65	80	0.8125000
NODE_5262_length_1083_cov_33.573171	668	748	0	28	80	0.3500000
NODE_5262_length_1083_cov_33.573171	668	748	4	52	80	0.6500000
NODE_5263_length_1083_cov_33.091463	452	532	0	80	80	1.0000000
NODE_5263_length_1083_cov_33.091463	505	585	0	80	80	1.0000000
NODE_5264_length_1083_cov_30.982724	550	630	8	80	80	1.0000000
NODE_5264_length_1083_cov_30.982724	603	683	0	21	80	0.2625000
NODE_5264_length_1083_cov_30.982724	603	683	8	59	80	0.7375000
NODE_5265_length_1083_cov_18.819106	586	666	2	80	80	1.0000000
NODE_5265_length_1083_cov_18.819106	639	719	0	53	80	0.6625000
NODE_5265_length_1083_cov_18.819106	639	719	2	27	80	0.3375000
NODE_5266_length_1083_cov_17.278455	408	488	0	80	80	1.0000000
NODE_5266_length_1083_cov_17.278455	461	541	0	80	80	1.0000000
NODE_5267_length_1083_cov_13.862805	481	561	0	80	80	1.0000000
NODE_5267_length_1083_cov_13.862805	534	614	0	80	80	1.0000000
NODE_5268_length_1083_cov_13.083333	522	602	0	13	80	0.1625000
NODE_5268_length_1083_cov_13.083333	522	602	9	2	80	0.0250000
NODE_5268_length_1083_cov_13.083333	522	602	10	65	80	0.8125000
NODE_5268_length_1083_cov_13.083333	575	655	10	80	80	1.0000000
NODE_5269_length_1083_cov_11.824187	242	322	0	80	80	1.0000000
NODE_5269_length_1083_cov_11.824187	295	375	0	80	80	1.0000000
NODE_5271_length_1083_cov_3.025407	359	439	2	18	80	0.2250000
NODE_5271_length_1083_cov_3.025407	359	439	4	24	80	0.3000000
NODE_5271_length_1083_cov_3.025407	359	439	6	38	80	0.4750000
NODE_5271_length_1083_cov_3.025407	412	489	0	41	77	0.5324675
NODE_5271_length_1083_cov_3.025407	412	489	2	17	77	0.2207792
NODE_5271_length_1083_cov_3.025407	412	489	4	17	77	0.2207792
NODE_5271_length_1083_cov_3.025407	412	489	6	2	77	0.0259740
NODE_5277_length_1082_cov_34.664293	461	541	0	80	80	1.0000000
NODE_5277_length_1082_cov_34.664293	514	594	0	80	80	1.0000000
NODE_5278_length_1082_cov_17.422177	406	486	2	80	80	1.0000000
NODE_5278_length_1082_cov_17.422177	459	539	0	52	80	0.6500000
NODE_5278_length_1082_cov_17.422177	459	539	2	28	80	0.3500000
NODE_5279_length_1082_cov_15.906409	442	522	0	80	80	1.0000000
NODE_5279_length_1082_cov_15.906409	495	575	0	80	80	1.0000000
NODE_5280_length_1082_cov_13.703967	324	404	0	27	80	0.3375000
NODE_5280_length_1082_cov_13.703967	324	404	2	53	80	0.6625000
NODE_5280_length_1082_cov_13.703967	377	457	0	80	80	1.0000000
NODE_5281_length_1082_cov_6.478128	159	205	2	2	46	0.0434783
NODE_5281_length_1082_cov_6.478128	159	205	4	29	46	0.6304348
NODE_5281_length_1082_cov_6.478128	159	205	9	6	46	0.1304348
NODE_5281_length_1082_cov_6.478128	159	205	10	1	46	0.0217391
NODE_5281_length_1082_cov_6.478128	159	205	11	8	46	0.1739130
NODE_5281_length_1082_cov_6.478128	203	283	9	2	80	0.0250000
NODE_5281_length_1082_cov_6.478128	203	283	10	8	80	0.1000000
NODE_5281_length_1082_cov_6.478128	203	283	11	9	80	0.1125000
NODE_5281_length_1082_cov_6.478128	203	283	13	13	80	0.1625000
NODE_5281_length_1082_cov_6.478128	203	283	14	16	80	0.2000000
NODE_5281_length_1082_cov_6.478128	203	283	16	32	80	0.4000000
NODE_5281_length_1082_cov_6.478128	256	336	2	6	80	0.0750000
NODE_5281_length_1082_cov_6.478128	256	336	10	5	80	0.0625000
NODE_5281_length_1082_cov_6.478128	256	336	11	1	80	0.0125000
NODE_5281_length_1082_cov_6.478128	256	336	12	14	80	0.1750000
NODE_5281_length_1082_cov_6.478128	256	336	14	3	80	0.0375000
NODE_5281_length_1082_cov_6.478128	256	336	16	51	80	0.6375000
NODE_5281_length_1082_cov_6.478128	861	941	0	15	80	0.1875000
NODE_5281_length_1082_cov_6.478128	861	941	2	19	80	0.2375000
NODE_5281_length_1082_cov_6.478128	861	941	4	2	80	0.0250000
NODE_5281_length_1082_cov_6.478128	861	941	6	44	80	0.5500000
NODE_5282_length_1082_cov_4.218718	982	1062	119	2	80	0.0250000
NODE_5282_length_1082_cov_4.218718	982	1062	127	1	80	0.0125000
NODE_5282_length_1082_cov_4.218718	982	1062	132	1	80	0.0125000
NODE_5282_length_1082_cov_4.218718	982	1062	139	1	80	0.0125000
NODE_5282_length_1082_cov_4.218718	982	1062	147	2	80	0.0250000
NODE_5282_length_1082_cov_4.218718	982	1062	149	1	80	0.0125000
NODE_5282_length_1082_cov_4.218718	982	1062	153	1	80	0.0125000
NODE_5282_length_1082_cov_4.218718	982	1062	158	1	80	0.0125000
NODE_5282_length_1082_cov_4.218718	982	1062	166	2	80	0.0250000
NODE_5282_length_1082_cov_4.218718	982	1062	180	1	80	0.0125000
NODE_5282_length_1082_cov_4.218718	982	1062	181	1	80	0.0125000
NODE_5282_length_1082_cov_4.218718	982	1062	190	1	80	0.0125000
NODE_5282_length_1082_cov_4.218718	982	1062	191	1	80	0.0125000
NODE_5282_length_1082_cov_4.218718	982	1062	201	1	80	0.0125000
NODE_5282_length_1082_cov_4.218718	982	1062	202	1	80	0.0125000
NODE_5282_length_1082_cov_4.218718	982	1062	213	2	80	0.0250000
NODE_5282_length_1082_cov_4.218718	982	1062	225	1	80	0.0125000
NODE_5282_length_1082_cov_4.218718	982	1062	241	2	80	0.0250000
NODE_5282_length_1082_cov_4.218718	982	1062	243	1	80	0.0125000
NODE_5282_length_1082_cov_4.218718	982	1062	247	1	80	0.0125000
NODE_5282_length_1082_cov_4.218718	982	1062	266	1	80	0.0125000
NODE_5282_length_1082_cov_4.218718	982	1062	267	1	80	0.0125000
NODE_5282_length_1082_cov_4.218718	982	1062	274	1	80	0.0125000
NODE_5282_length_1082_cov_4.218718	982	1062	277	2	80	0.0250000
NODE_5282_length_1082_cov_4.218718	982	1062	281	1	80	0.0125000
NODE_5282_length_1082_cov_4.218718	982	1062	282	1	80	0.0125000
NODE_5282_length_1082_cov_4.218718	982	1062	283	1	80	0.0125000
NODE_5282_length_1082_cov_4.218718	982	1062	284	1	80	0.0125000
NODE_5282_length_1082_cov_4.218718	982	1062	289	1	80	0.0125000
NODE_5282_length_1082_cov_4.218718	982	1062	295	1	80	0.0125000
NODE_5282_length_1082_cov_4.218718	982	1062	301	1	80	0.0125000
NODE_5282_length_1082_cov_4.218718	982	1062	303	1	80	0.0125000
NODE_5282_length_1082_cov_4.218718	982	1062	324	1	80	0.0125000
NODE_5282_length_1082_cov_4.218718	982	1062	330	1	80	0.0125000
NODE_5282_length_1082_cov_4.218718	982	1062	340	2	80	0.0250000
NODE_5282_length_1082_cov_4.218718	982	1062	343	1	80	0.0125000
NODE_5282_length_1082_cov_4.218718	982	1062	345	1	80	0.0125000
NODE_5282_length_1082_cov_4.218718	982	1062	352	1	80	0.0125000
NODE_5282_length_1082_cov_4.218718	982	1062	356	1	80	0.0125000
NODE_5282_length_1082_cov_4.218718	982	1062	358	1	80	0.0125000
NODE_5282_length_1082_cov_4.218718	982	1062	360	1	80	0.0125000
NODE_5282_length_1082_cov_4.218718	982	1062	362	1	80	0.0125000
NODE_5282_length_1082_cov_4.218718	982	1062	365	1	80	0.0125000
NODE_5282_length_1082_cov_4.218718	982	1062	366	1	80	0.0125000
NODE_5282_length_1082_cov_4.218718	982	1062	368	1	80	0.0125000
NODE_5282_length_1082_cov_4.218718	982	1062	370	2	80	0.0250000
NODE_5282_length_1082_cov_4.218718	982	1062	373	1	80	0.0125000
NODE_5282_length_1082_cov_4.218718	982	1062	375	1	80	0.0125000
NODE_5282_length_1082_cov_4.218718	982	1062	382	1	80	0.0125000
NODE_5282_length_1082_cov_4.218718	982	1062	386	1	80	0.0125000
NODE_5282_length_1082_cov_4.218718	982	1062	393	2	80	0.0250000
NODE_5282_length_1082_cov_4.218718	982	1062	401	2	80	0.0250000
NODE_5282_length_1082_cov_4.218718	982	1062	406	1	80	0.0125000
NODE_5282_length_1082_cov_4.218718	982	1062	407	1	80	0.0125000
NODE_5282_length_1082_cov_4.218718	982	1062	413	1	80	0.0125000
NODE_5282_length_1082_cov_4.218718	982	1062	416	1	80	0.0125000
NODE_5282_length_1082_cov_4.218718	982	1062	419	2	80	0.0250000
NODE_5282_length_1082_cov_4.218718	982	1062	422	1	80	0.0125000
NODE_5282_length_1082_cov_4.218718	982	1062	428	2	80	0.0250000
NODE_5282_length_1082_cov_4.218718	982	1062	432	1	80	0.0125000
NODE_5282_length_1082_cov_4.218718	982	1062	434	2	80	0.0250000
NODE_5282_length_1082_cov_4.218718	982	1062	436	1	80	0.0125000
NODE_5282_length_1082_cov_4.218718	982	1062	440	1	80	0.0125000
NODE_5282_length_1082_cov_4.218718	982	1062	447	2	80	0.0250000
NODE_5282_length_1082_cov_4.218718	982	1062	449	1	80	0.0125000
NODE_5282_length_1082_cov_4.218718	982	1062	451	1	80	0.0125000
NODE_5291_length_1081_cov_45.308554	510	590	0	50	80	0.6250000
NODE_5291_length_1081_cov_45.308554	510	590	4	30	80	0.3750000
NODE_5291_length_1081_cov_45.308554	563	643	4	80	80	1.0000000
NODE_5292_length_1081_cov_39.581466	476	556	0	80	80	1.0000000
NODE_5292_length_1081_cov_39.581466	529	609	0	80	80	1.0000000
NODE_5292_length_1081_cov_39.581466	605	685	0	80	80	1.0000000
NODE_5292_length_1081_cov_39.581466	658	738	0	80	80	1.0000000
NODE_5293_length_1081_cov_39.457230	373	453	0	80	80	1.0000000
NODE_5293_length_1081_cov_39.457230	426	506	0	80	80	1.0000000
NODE_5294_length_1081_cov_20.415479	376	451	0	75	75	1.0000000
NODE_5294_length_1081_cov_20.415479	436	511	0	75	75	1.0000000
NODE_5294_length_1081_cov_20.415479	496	571	0	75	75	1.0000000
NODE_5294_length_1081_cov_20.415479	544	624	0	80	80	1.0000000
NODE_5295_length_1081_cov_19.985743	378	458	2	80	80	1.0000000
NODE_5295_length_1081_cov_19.985743	431	511	0	10	80	0.1250000
NODE_5295_length_1081_cov_19.985743	431	511	2	70	80	0.8750000
NODE_5295_length_1081_cov_19.985743	507	587	2	80	80	1.0000000
NODE_5295_length_1081_cov_19.985743	560	640	0	46	80	0.5750000
NODE_5295_length_1081_cov_19.985743	560	640	2	34	80	0.4250000
NODE_5296_length_1081_cov_12.658859	468	548	0	80	80	1.0000000
NODE_5296_length_1081_cov_12.658859	521	601	0	80	80	1.0000000
NODE_5299_length_1081_cov_2.586558	7	44	0	37	37	1.0000000
NODE_5304_length_1080_cov_27.857288	261	341	0	80	80	1.0000000
NODE_5304_length_1080_cov_27.857288	314	394	0	80	80	1.0000000
NODE_5305_length_1080_cov_24.258919	321	401	0	80	80	1.0000000
NODE_5305_length_1080_cov_24.258919	374	454	0	80	80	1.0000000
NODE_5305_length_1080_cov_24.258919	450	530	0	80	80	1.0000000
NODE_5305_length_1080_cov_24.258919	503	583	0	80	80	1.0000000
NODE_5306_length_1080_cov_22.589195	446	526	0	19	80	0.2375000
NODE_5306_length_1080_cov_22.589195	446	526	2	51	80	0.6375000
NODE_5306_length_1080_cov_22.589195	446	526	4	10	80	0.1250000
NODE_5306_length_1080_cov_22.589195	499	579	2	70	80	0.8750000
NODE_5306_length_1080_cov_22.589195	499	579	4	10	80	0.1250000
NODE_5306_length_1080_cov_22.589195	575	655	0	31	80	0.3875000
NODE_5306_length_1080_cov_22.589195	575	655	2	49	80	0.6125000
NODE_5306_length_1080_cov_22.589195	628	708	0	35	80	0.4375000
NODE_5306_length_1080_cov_22.589195	628	708	2	45	80	0.5625000
NODE_5307_length_1080_cov_15.544343	599	679	0	80	80	1.0000000
NODE_5307_length_1080_cov_15.544343	652	732	0	80	80	1.0000000
NODE_5308_length_1080_cov_10.416922	321	401	0	80	80	1.0000000
NODE_5308_length_1080_cov_10.416922	374	454	0	60	80	0.7500000
NODE_5308_length_1080_cov_10.416922	374	454	1	20	80	0.2500000
NODE_5315_length_1079_cov_55.352041	367	447	0	80	80	1.0000000
NODE_5315_length_1079_cov_55.352041	420	500	0	80	80	1.0000000
NODE_5315_length_1079_cov_55.352041	496	576	0	5	80	0.0625000
NODE_5315_length_1079_cov_55.352041	496	576	2	6	80	0.0750000
NODE_5315_length_1079_cov_55.352041	496	576	5	4	80	0.0500000
NODE_5315_length_1079_cov_55.352041	496	576	7	65	80	0.8125000
NODE_5315_length_1079_cov_55.352041	549	629	6	2	80	0.0250000
NODE_5315_length_1079_cov_55.352041	549	629	7	50	80	0.6250000
NODE_5315_length_1079_cov_55.352041	549	629	8	28	80	0.3500000
NODE_5316_length_1079_cov_46.879592	444	524	7	22	80	0.2750000
NODE_5316_length_1079_cov_46.879592	444	524	9	50	80	0.6250000
NODE_5316_length_1079_cov_46.879592	444	524	11	8	80	0.1000000
NODE_5316_length_1079_cov_46.879592	497	577	7	2	80	0.0250000
NODE_5316_length_1079_cov_46.879592	497	577	9	58	80	0.7250000
NODE_5316_length_1079_cov_46.879592	497	577	10	12	80	0.1500000
NODE_5316_length_1079_cov_46.879592	497	577	11	7	80	0.0875000
NODE_5316_length_1079_cov_46.879592	497	577	12	1	80	0.0125000
NODE_5316_length_1079_cov_46.879592	573	652	3	1	79	0.0126582
NODE_5316_length_1079_cov_46.879592	573	652	5	21	79	0.2658228
NODE_5316_length_1079_cov_46.879592	573	652	9	16	79	0.2025317
NODE_5316_length_1079_cov_46.879592	573	652	11	28	79	0.3544304
NODE_5316_length_1079_cov_46.879592	573	652	12	13	79	0.1645570
NODE_5316_length_1079_cov_46.879592	625	703	8	4	78	0.0512821
NODE_5316_length_1079_cov_46.879592	625	703	9	11	78	0.1410256
NODE_5316_length_1079_cov_46.879592	625	703	11	3	78	0.0384615
NODE_5316_length_1079_cov_46.879592	625	703	12	17	78	0.2179487
NODE_5316_length_1079_cov_46.879592	625	703	14	10	78	0.1282051
NODE_5316_length_1079_cov_46.879592	625	703	15	33	78	0.4230769
NODE_5317_length_1079_cov_13.708163	611	691	0	80	80	1.0000000
NODE_5317_length_1079_cov_13.708163	664	744	0	80	80	1.0000000
NODE_5318_length_1079_cov_8.632653	416	496	0	80	80	1.0000000
NODE_5318_length_1079_cov_8.632653	469	549	0	80	80	1.0000000
NODE_5325_length_1078_cov_27.804903	357	437	0	68	80	0.8500000
NODE_5325_length_1078_cov_27.804903	357	437	4	12	80	0.1500000
NODE_5325_length_1078_cov_27.804903	410	490	0	15	80	0.1875000
NODE_5325_length_1078_cov_27.804903	410	490	4	26	80	0.3250000
NODE_5325_length_1078_cov_27.804903	410	490	6	39	80	0.4875000
NODE_5326_length_1078_cov_26.071502	459	539	2	40	80	0.5000000
NODE_5326_length_1078_cov_26.071502	459	539	4	40	80	0.5000000
NODE_5326_length_1078_cov_26.071502	512	592	2	14	80	0.1750000
NODE_5326_length_1078_cov_26.071502	512	592	3	3	80	0.0375000
NODE_5326_length_1078_cov_26.071502	512	592	4	63	80	0.7875000
NODE_5326_length_1078_cov_26.071502	588	668	0	2	80	0.0250000
NODE_5326_length_1078_cov_26.071502	588	668	2	76	80	0.9500000
NODE_5326_length_1078_cov_26.071502	588	668	4	2	80	0.0250000
NODE_5326_length_1078_cov_26.071502	641	718	0	52	77	0.6753247
NODE_5326_length_1078_cov_26.071502	641	718	2	25	77	0.3246753
NODE_5327_length_1078_cov_14.985700	495	575	0	80	80	1.0000000
NODE_5327_length_1078_cov_14.985700	548	628	0	80	80	1.0000000
NODE_5333_length_1077_cov_23.876278	546	626	0	26	80	0.3250000
NODE_5333_length_1077_cov_23.876278	546	626	2	54	80	0.6750000
NODE_5333_length_1077_cov_23.876278	599	679	0	79	80	0.9875000
NODE_5333_length_1077_cov_23.876278	599	679	2	1	80	0.0125000
NODE_5334_length_1077_cov_16.067485	532	612	0	80	80	1.0000000
NODE_5334_length_1077_cov_16.067485	585	665	0	80	80	1.0000000
NODE_5335_length_1077_cov_14.568507	556	636	2	78	80	0.9750000
NODE_5335_length_1077_cov_14.568507	556	636	4	2	80	0.0250000
NODE_5335_length_1077_cov_14.568507	609	689	0	36	80	0.4500000
NODE_5335_length_1077_cov_14.568507	609	689	2	35	80	0.4375000
NODE_5335_length_1077_cov_14.568507	609	689	4	9	80	0.1125000
NODE_5336_length_1077_cov_9.507157	496	576	2	25	80	0.3125000
NODE_5336_length_1077_cov_9.507157	496	576	4	10	80	0.1250000
NODE_5336_length_1077_cov_9.507157	496	576	8	45	80	0.5625000
NODE_5336_length_1077_cov_9.507157	549	629	0	12	80	0.1500000
NODE_5336_length_1077_cov_9.507157	549	629	3	1	80	0.0125000
NODE_5336_length_1077_cov_9.507157	549	629	4	21	80	0.2625000
NODE_5336_length_1077_cov_9.507157	549	629	6	15	80	0.1875000
NODE_5336_length_1077_cov_9.507157	549	629	8	31	80	0.3875000
NODE_5342_length_1077_cov_1.781186	252	274	0	22	22	1.0000000
NODE_5345_length_1076_cov_20.592631	534	614	0	80	80	1.0000000
NODE_5345_length_1076_cov_20.592631	587	667	0	80	80	1.0000000
NODE_5346_length_1076_cov_14.788127	427	507	0	80	80	1.0000000
NODE_5346_length_1076_cov_14.788127	480	560	0	80	80	1.0000000
NODE_5348_length_1076_cov_6.306039	883	961	0	78	78	1.0000000
NODE_5348_length_1076_cov_6.306039	936	1014	0	78	78	1.0000000
NODE_5357_length_1075_cov_37.941598	550	630	6	4	80	0.0500000
NODE_5357_length_1075_cov_37.941598	550	630	10	76	80	0.9500000
NODE_5357_length_1075_cov_37.941598	603	685	0	10	82	0.1219512
NODE_5357_length_1075_cov_37.941598	603	685	4	14	82	0.1707317
NODE_5357_length_1075_cov_37.941598	603	685	10	58	82	0.7073171
NODE_5357_length_1075_cov_37.941598	681	761	0	80	80	1.0000000
NODE_5357_length_1075_cov_37.941598	734	814	0	80	80	1.0000000
NODE_5358_length_1075_cov_32.224385	397	477	0	58	80	0.7250000
NODE_5358_length_1075_cov_32.224385	397	477	6	22	80	0.2750000
NODE_5358_length_1075_cov_32.224385	450	530	0	5	80	0.0625000
NODE_5358_length_1075_cov_32.224385	450	530	6	75	80	0.9375000
NODE_5359_length_1075_cov_9.626025	440	520	0	80	80	1.0000000
NODE_5359_length_1075_cov_9.626025	493	573	0	80	80	1.0000000
NODE_5362_length_1075_cov_2.926230	38	99	0	61	61	1.0000000
NODE_5372_length_1074_cov_19.034872	568	648	0	80	80	1.0000000
NODE_5372_length_1074_cov_19.034872	621	701	0	80	80	1.0000000
NODE_5372_length_1074_cov_19.034872	697	777	0	5	80	0.0625000
NODE_5372_length_1074_cov_19.034872	697	777	2	75	80	0.9375000
NODE_5372_length_1074_cov_19.034872	750	830	0	34	80	0.4250000
NODE_5372_length_1074_cov_19.034872	750	830	2	46	80	0.5750000
NODE_5373_length_1074_cov_9.450256	577	657	0	10	80	0.1250000
NODE_5373_length_1074_cov_9.450256	577	657	2	69	80	0.8625000
NODE_5373_length_1074_cov_9.450256	577	657	4	1	80	0.0125000
NODE_5373_length_1074_cov_9.450256	630	710	2	64	80	0.8000000
NODE_5373_length_1074_cov_9.450256	630	710	4	16	80	0.2000000
NODE_5374_length_1074_cov_9.155897	526	606	0	50	80	0.6250000
NODE_5374_length_1074_cov_9.155897	526	606	1	30	80	0.3750000
NODE_5374_length_1074_cov_9.155897	579	659	0	80	80	1.0000000
NODE_5374_length_1074_cov_9.155897	655	735	0	80	80	1.0000000
NODE_5374_length_1074_cov_9.155897	708	788	0	80	80	1.0000000
NODE_5375_length_1074_cov_4.600000	606	686	0	80	80	1.0000000
NODE_5375_length_1074_cov_4.600000	659	739	0	80	80	1.0000000
NODE_5376_length_1074_cov_4.328205	32	112	16	4	80	0.0500000
NODE_5376_length_1074_cov_4.328205	32	112	18	1	80	0.0125000
NODE_5376_length_1074_cov_4.328205	32	112	24	11	80	0.1375000
NODE_5376_length_1074_cov_4.328205	32	112	27	11	80	0.1375000
NODE_5376_length_1074_cov_4.328205	32	112	29	2	80	0.0250000
NODE_5376_length_1074_cov_4.328205	32	112	31	9	80	0.1125000
NODE_5376_length_1074_cov_4.328205	32	112	33	11	80	0.1375000
NODE_5376_length_1074_cov_4.328205	32	112	35	19	80	0.2375000
NODE_5376_length_1074_cov_4.328205	32	112	37	1	80	0.0125000
NODE_5376_length_1074_cov_4.328205	32	112	39	11	80	0.1375000
NODE_5380_length_1073_cov_60.012320	448	528	3	46	80	0.5750000
NODE_5380_length_1073_cov_60.012320	448	528	7	3	80	0.0375000
NODE_5380_length_1073_cov_60.012320	448	528	8	31	80	0.3875000
NODE_5380_length_1073_cov_60.012320	501	581	0	11	80	0.1375000
NODE_5380_length_1073_cov_60.012320	501	581	4	27	80	0.3375000
NODE_5380_length_1073_cov_60.012320	501	581	8	42	80	0.5250000
NODE_5382_length_1073_cov_26.415811	529	609	0	80	80	1.0000000
NODE_5382_length_1073_cov_26.415811	582	662	0	42	80	0.5250000
NODE_5382_length_1073_cov_26.415811	582	662	2	38	80	0.4750000
NODE_5383_length_1073_cov_19.062628	571	651	2	80	80	1.0000000
NODE_5383_length_1073_cov_19.062628	624	704	1	3	80	0.0375000
NODE_5383_length_1073_cov_19.062628	624	704	2	61	80	0.7625000
NODE_5383_length_1073_cov_19.062628	624	704	3	16	80	0.2000000
NODE_5384_length_1073_cov_18.536961	447	527	0	80	80	1.0000000
NODE_5384_length_1073_cov_18.536961	500	580	0	80	80	1.0000000
NODE_5384_length_1073_cov_18.536961	576	656	0	80	80	1.0000000
NODE_5384_length_1073_cov_18.536961	629	709	0	80	80	1.0000000
NODE_5385_length_1073_cov_15.318275	712	792	0	80	80	1.0000000
NODE_5385_length_1073_cov_15.318275	765	845	0	80	80	1.0000000
NODE_5386_length_1073_cov_8.376797	287	367	4	80	80	1.0000000
NODE_5386_length_1073_cov_8.376797	340	420	0	11	80	0.1375000
NODE_5386_length_1073_cov_8.376797	340	420	4	69	80	0.8625000
NODE_5387_length_1073_cov_5.749487	257	337	0	18	80	0.2250000
NODE_5387_length_1073_cov_5.749487	257	337	2	62	80	0.7750000
NODE_5387_length_1073_cov_5.749487	310	390	0	21	80	0.2625000
NODE_5387_length_1073_cov_5.749487	310	390	2	59	80	0.7375000
NODE_5388_length_1073_cov_5.156057	408	444	0	36	36	1.0000000
NODE_5390_length_1073_cov_3.019507	1	69	0	37	68	0.5441176
NODE_5390_length_1073_cov_3.019507	1	69	2	31	68	0.4558823
NODE_5390_length_1073_cov_3.019507	42	122	0	2	80	0.0250000
NODE_5390_length_1073_cov_3.019507	42	122	2	78	80	0.9750000
NODE_5399_length_1072_cov_62.729702	351	431	0	80	80	1.0000000
NODE_5399_length_1072_cov_62.729702	404	484	0	80	80	1.0000000
NODE_5399_length_1072_cov_62.729702	480	560	0	80	80	1.0000000
NODE_5399_length_1072_cov_62.729702	533	613	0	80	80	1.0000000
NODE_5400_length_1072_cov_34.045221	430	510	0	80	80	1.0000000
NODE_5400_length_1072_cov_34.045221	483	563	0	80	80	1.0000000
NODE_5401_length_1072_cov_34.006166	342	423	0	10	81	0.1234568
NODE_5401_length_1072_cov_34.006166	342	423	2	71	81	0.8765432
NODE_5401_length_1072_cov_34.006166	396	476	0	54	80	0.6750000
NODE_5401_length_1072_cov_34.006166	396	476	2	26	80	0.3250000
NODE_5401_length_1072_cov_34.006166	472	552	0	26	80	0.3250000
NODE_5401_length_1072_cov_34.006166	472	552	4	54	80	0.6750000
NODE_5401_length_1072_cov_34.006166	525	605	4	80	80	1.0000000
NODE_5403_length_1072_cov_21.852004	300	380	0	80	80	1.0000000
NODE_5403_length_1072_cov_21.852004	353	433	0	80	80	1.0000000
NODE_5404_length_1072_cov_21.532374	476	556	0	80	80	1.0000000
NODE_5404_length_1072_cov_21.532374	529	609	0	80	80	1.0000000
NODE_5405_length_1072_cov_17.018499	415	495	0	17	80	0.2125000
NODE_5405_length_1072_cov_17.018499	415	495	4	63	80	0.7875000
NODE_5405_length_1072_cov_17.018499	468	548	0	50	80	0.6250000
NODE_5405_length_1072_cov_17.018499	468	548	4	30	80	0.3750000
NODE_5410_length_1072_cov_3.302158	388	449	2	24	61	0.3934426
NODE_5410_length_1072_cov_3.302158	388	449	4	37	61	0.6065574
NODE_5410_length_1072_cov_3.302158	422	502	2	14	80	0.1750000
NODE_5410_length_1072_cov_3.302158	422	502	4	66	80	0.8250000
NODE_5414_length_1072_cov_1.773895	114	176	6	4	62	0.0645161
NODE_5414_length_1072_cov_1.773895	114	176	8	20	62	0.3225806
NODE_5414_length_1072_cov_1.773895	114	176	10	7	62	0.1129032
NODE_5414_length_1072_cov_1.773895	114	176	11	5	62	0.0806452
NODE_5414_length_1072_cov_1.773895	114	176	12	3	62	0.0483871
NODE_5414_length_1072_cov_1.773895	114	176	14	2	62	0.0322581
NODE_5414_length_1072_cov_1.773895	114	176	15	2	62	0.0322581
NODE_5414_length_1072_cov_1.773895	114	176	16	5	62	0.0806452
NODE_5414_length_1072_cov_1.773895	114	176	20	14	62	0.2258064
NODE_5417_length_1071_cov_27.565844	312	392	0	8	80	0.1000000
NODE_5417_length_1071_cov_27.565844	312	392	2	12	80	0.1500000
NODE_5417_length_1071_cov_27.565844	312	392	4	60	80	0.7500000
NODE_5417_length_1071_cov_27.565844	365	445	0	61	80	0.7625000
NODE_5417_length_1071_cov_27.565844	365	445	2	8	80	0.1000000
NODE_5417_length_1071_cov_27.565844	365	445	4	11	80	0.1375000
NODE_5419_length_1071_cov_12.666667	480	560	0	80	80	1.0000000
NODE_5419_length_1071_cov_12.666667	533	613	0	80	80	1.0000000
NODE_5421_length_1071_cov_8.942387	418	498	0	80	80	1.0000000
NODE_5421_length_1071_cov_8.942387	471	551	0	80	80	1.0000000
NODE_5427_length_1070_cov_39.255407	591	671	0	59	80	0.7375000
NODE_5427_length_1070_cov_39.255407	591	671	2	21	80	0.2625000
NODE_5427_length_1070_cov_39.255407	644	724	0	6	80	0.0750000
NODE_5427_length_1070_cov_39.255407	644	724	2	74	80	0.9250000
NODE_5428_length_1070_cov_21.903193	430	510	0	18	80	0.2250000
NODE_5428_length_1070_cov_21.903193	430	510	2	62	80	0.7750000
NODE_5428_length_1070_cov_21.903193	483	563	0	47	80	0.5875000
NODE_5428_length_1070_cov_21.903193	483	563	2	33	80	0.4125000
NODE_5428_length_1070_cov_21.903193	559	639	0	80	80	1.0000000
NODE_5428_length_1070_cov_21.903193	612	692	0	80	80	1.0000000
NODE_5429_length_1070_cov_8.963955	871	900	16	2	29	0.0689655
NODE_5429_length_1070_cov_8.963955	871	900	24	1	29	0.0344828
NODE_5429_length_1070_cov_8.963955	871	900	37	1	29	0.0344828
NODE_5429_length_1070_cov_8.963955	871	900	39	1	29	0.0344828
NODE_5429_length_1070_cov_8.963955	871	900	40	1	29	0.0344828
NODE_5429_length_1070_cov_8.963955	871	900	42	1	29	0.0344828
NODE_5429_length_1070_cov_8.963955	871	900	45	1	29	0.0344828
NODE_5429_length_1070_cov_8.963955	871	900	52	1	29	0.0344828
NODE_5429_length_1070_cov_8.963955	871	900	58	1	29	0.0344828
NODE_5429_length_1070_cov_8.963955	871	900	60	1	29	0.0344828
NODE_5429_length_1070_cov_8.963955	871	900	61	2	29	0.0689655
NODE_5429_length_1070_cov_8.963955	871	900	63	2	29	0.0689655
NODE_5429_length_1070_cov_8.963955	871	900	64	1	29	0.0344828
NODE_5429_length_1070_cov_8.963955	871	900	68	2	29	0.0689655
NODE_5429_length_1070_cov_8.963955	871	900	70	1	29	0.0344828
NODE_5429_length_1070_cov_8.963955	871	900	75	1	29	0.0344828
NODE_5429_length_1070_cov_8.963955	871	900	76	1	29	0.0344828
NODE_5429_length_1070_cov_8.963955	871	900	80	1	29	0.0344828
NODE_5429_length_1070_cov_8.963955	871	900	81	1	29	0.0344828
NODE_5429_length_1070_cov_8.963955	871	900	89	1	29	0.0344828
NODE_5429_length_1070_cov_8.963955	871	900	90	1	29	0.0344828
NODE_5429_length_1070_cov_8.963955	871	900	94	1	29	0.0344828
NODE_5429_length_1070_cov_8.963955	871	900	95	1	29	0.0344828
NODE_5429_length_1070_cov_8.963955	871	900	97	1	29	0.0344828
NODE_5429_length_1070_cov_8.963955	871	900	107	1	29	0.0344828
NODE_5429_length_1070_cov_8.963955	873	953	24	1	80	0.0125000
NODE_5429_length_1070_cov_8.963955	873	953	37	1	80	0.0125000
NODE_5429_length_1070_cov_8.963955	873	953	39	1	80	0.0125000
NODE_5429_length_1070_cov_8.963955	873	953	40	1	80	0.0125000
NODE_5429_length_1070_cov_8.963955	873	953	42	1	80	0.0125000
NODE_5429_length_1070_cov_8.963955	873	953	45	1	80	0.0125000
NODE_5429_length_1070_cov_8.963955	873	953	52	1	80	0.0125000
NODE_5429_length_1070_cov_8.963955	873	953	58	1	80	0.0125000
NODE_5429_length_1070_cov_8.963955	873	953	60	1	80	0.0125000
NODE_5429_length_1070_cov_8.963955	873	953	61	2	80	0.0250000
NODE_5429_length_1070_cov_8.963955	873	953	63	2	80	0.0250000
NODE_5429_length_1070_cov_8.963955	873	953	64	1	80	0.0125000
NODE_5429_length_1070_cov_8.963955	873	953	68	2	80	0.0250000
NODE_5429_length_1070_cov_8.963955	873	953	70	1	80	0.0125000
NODE_5429_length_1070_cov_8.963955	873	953	75	1	80	0.0125000
NODE_5429_length_1070_cov_8.963955	873	953	76	1	80	0.0125000
NODE_5429_length_1070_cov_8.963955	873	953	80	1	80	0.0125000
NODE_5429_length_1070_cov_8.963955	873	953	81	1	80	0.0125000
NODE_5429_length_1070_cov_8.963955	873	953	89	1	80	0.0125000
NODE_5429_length_1070_cov_8.963955	873	953	90	1	80	0.0125000
NODE_5429_length_1070_cov_8.963955	873	953	94	1	80	0.0125000
NODE_5429_length_1070_cov_8.963955	873	953	95	1	80	0.0125000
NODE_5429_length_1070_cov_8.963955	873	953	97	1	80	0.0125000
NODE_5429_length_1070_cov_8.963955	873	953	107	2	80	0.0250000
NODE_5429_length_1070_cov_8.963955	873	953	109	2	80	0.0250000
NODE_5429_length_1070_cov_8.963955	873	953	110	1	80	0.0125000
NODE_5429_length_1070_cov_8.963955	873	953	130	1	80	0.0125000
NODE_5429_length_1070_cov_8.963955	873	953	138	1	80	0.0125000
NODE_5429_length_1070_cov_8.963955	873	953	140	2	80	0.0250000
NODE_5429_length_1070_cov_8.963955	873	953	142	3	80	0.0375000
NODE_5429_length_1070_cov_8.963955	873	953	146	1	80	0.0125000
NODE_5429_length_1070_cov_8.963955	873	953	148	1	80	0.0125000
NODE_5429_length_1070_cov_8.963955	873	953	150	1	80	0.0125000
NODE_5429_length_1070_cov_8.963955	873	953	155	3	80	0.0375000
NODE_5429_length_1070_cov_8.963955	873	953	156	4	80	0.0500000
NODE_5429_length_1070_cov_8.963955	873	953	158	2	80	0.0250000
NODE_5429_length_1070_cov_8.963955	873	953	160	5	80	0.0625000
NODE_5429_length_1070_cov_8.963955	873	953	162	3	80	0.0375000
NODE_5429_length_1070_cov_8.963955	873	953	164	1	80	0.0125000
NODE_5429_length_1070_cov_8.963955	873	953	168	1	80	0.0125000
NODE_5429_length_1070_cov_8.963955	873	953	169	1	80	0.0125000
NODE_5429_length_1070_cov_8.963955	873	953	171	3	80	0.0375000
NODE_5429_length_1070_cov_8.963955	873	953	172	7	80	0.0875000
NODE_5429_length_1070_cov_8.963955	873	953	173	9	80	0.1125000
NODE_5433_length_1070_cov_1.659114	1027	1046	0	19	19	1.0000000
NODE_5439_length_1069_cov_40.277320	451	531	9	5	80	0.0625000
NODE_5439_length_1069_cov_40.277320	451	531	11	73	80	0.9125000
NODE_5439_length_1069_cov_40.277320	451	531	12	2	80	0.0250000
NODE_5439_length_1069_cov_40.277320	504	584	9	40	80	0.5000000
NODE_5439_length_1069_cov_40.277320	504	584	10	12	80	0.1500000
NODE_5439_length_1069_cov_40.277320	504	584	11	25	80	0.3125000
NODE_5439_length_1069_cov_40.277320	504	584	12	3	80	0.0375000
NODE_5440_length_1069_cov_23.571134	274	354	0	80	80	1.0000000
NODE_5440_length_1069_cov_23.571134	327	407	0	80	80	1.0000000
NODE_5441_length_1069_cov_22.436082	185	265	0	80	80	1.0000000
NODE_5441_length_1069_cov_22.436082	238	318	0	80	80	1.0000000
NODE_5442_length_1069_cov_18.207216	436	516	0	80	80	1.0000000
NODE_5442_length_1069_cov_18.207216	489	569	0	80	80	1.0000000
NODE_5443_length_1069_cov_17.601031	596	676	0	9	80	0.1125000
NODE_5443_length_1069_cov_17.601031	596	676	2	71	80	0.8875000
NODE_5443_length_1069_cov_17.601031	649	729	2	76	80	0.9500000
NODE_5443_length_1069_cov_17.601031	649	729	4	4	80	0.0500000
NODE_5444_length_1069_cov_16.318557	353	433	0	29	80	0.3625000
NODE_5444_length_1069_cov_16.318557	353	433	1	38	80	0.4750000
NODE_5444_length_1069_cov_16.318557	353	433	3	11	80	0.1375000
NODE_5444_length_1069_cov_16.318557	353	433	5	2	80	0.0250000
NODE_5444_length_1069_cov_16.318557	406	486	0	80	80	1.0000000
NODE_5444_length_1069_cov_16.318557	482	562	0	80	80	1.0000000
NODE_5444_length_1069_cov_16.318557	535	615	0	57	80	0.7125000
NODE_5444_length_1069_cov_16.318557	535	615	2	23	80	0.2875000
NODE_5445_length_1069_cov_13.349485	471	551	0	80	80	1.0000000
NODE_5445_length_1069_cov_13.349485	524	604	0	47	80	0.5875000
NODE_5445_length_1069_cov_13.349485	524	604	2	33	80	0.4125000
NODE_5446_length_1069_cov_13.050515	314	394	0	80	80	1.0000000
NODE_5446_length_1069_cov_13.050515	367	447	0	80	80	1.0000000
NODE_5447_length_1069_cov_12.818557	240	320	0	80	80	1.0000000
NODE_5447_length_1069_cov_12.818557	293	373	0	80	80	1.0000000
NODE_5448_length_1069_cov_11.985567	554	634	0	54	80	0.6750000
NODE_5448_length_1069_cov_11.985567	554	634	4	26	80	0.3250000
NODE_5448_length_1069_cov_11.985567	607	687	0	10	80	0.1250000
NODE_5448_length_1069_cov_11.985567	607	687	4	70	80	0.8750000
NODE_5449_length_1069_cov_10.812371	366	446	0	80	80	1.0000000
NODE_5449_length_1069_cov_10.812371	419	499	0	80	80	1.0000000
NODE_5450_length_1069_cov_7.729897	482	562	0	20	80	0.2500000
NODE_5450_length_1069_cov_7.729897	482	562	2	60	80	0.7500000
NODE_5450_length_1069_cov_7.729897	535	615	0	19	80	0.2375000
NODE_5450_length_1069_cov_7.729897	535	615	2	61	80	0.7625000
NODE_5456_length_1068_cov_31.692466	314	394	0	80	80	1.0000000
NODE_5456_length_1068_cov_31.692466	367	447	0	80	80	1.0000000
NODE_5456_length_1068_cov_31.692466	443	523	0	80	80	1.0000000
NODE_5456_length_1068_cov_31.692466	496	576	0	80	80	1.0000000
NODE_5457_length_1068_cov_29.579979	347	427	0	80	80	1.0000000
NODE_5457_length_1068_cov_29.579979	400	480	0	80	80	1.0000000
NODE_5459_length_1068_cov_23.020640	476	556	0	80	80	1.0000000
NODE_5459_length_1068_cov_23.020640	529	609	0	80	80	1.0000000
NODE_5460_length_1068_cov_15.272446	546	626	0	6	80	0.0750000
NODE_5460_length_1068_cov_15.272446	546	626	4	74	80	0.9250000
NODE_5460_length_1068_cov_15.272446	599	679	0	59	80	0.7375000
NODE_5460_length_1068_cov_15.272446	599	679	4	21	80	0.2625000
NODE_5461_length_1068_cov_13.557276	674	754	0	80	80	1.0000000
NODE_5461_length_1068_cov_13.557276	727	807	0	80	80	1.0000000
NODE_5479_length_1067_cov_48.282025	429	509	0	80	80	1.0000000
NODE_5479_length_1067_cov_48.282025	482	562	0	80	80	1.0000000
NODE_5480_length_1067_cov_41.111570	460	540	12	6	80	0.0750000
NODE_5480_length_1067_cov_41.111570	460	540	14	13	80	0.1625000
NODE_5480_length_1067_cov_41.111570	460	540	21	1	80	0.0125000
NODE_5480_length_1067_cov_41.111570	460	540	22	60	80	0.7500000
NODE_5480_length_1067_cov_41.111570	513	593	12	14	80	0.1750000
NODE_5480_length_1067_cov_41.111570	513	593	20	12	80	0.1500000
NODE_5480_length_1067_cov_41.111570	513	593	22	54	80	0.6750000
NODE_5481_length_1067_cov_39.109504	295	375	0	27	80	0.3375000
NODE_5481_length_1067_cov_39.109504	295	375	2	53	80	0.6625000
NODE_5481_length_1067_cov_39.109504	348	428	0	13	80	0.1625000
NODE_5481_length_1067_cov_39.109504	348	428	2	67	80	0.8375000
NODE_5481_length_1067_cov_39.109504	424	504	0	80	80	1.0000000
NODE_5481_length_1067_cov_39.109504	477	557	0	80	80	1.0000000
NODE_5482_length_1067_cov_35.426653	252	332	0	80	80	1.0000000
NODE_5482_length_1067_cov_35.426653	305	385	0	80	80	1.0000000
NODE_5483_length_1067_cov_29.467975	412	492	0	80	80	1.0000000
NODE_5483_length_1067_cov_29.467975	465	545	0	80	80	1.0000000
NODE_5484_length_1067_cov_20.738636	579	645	13	12	66	0.1818182
NODE_5484_length_1067_cov_20.738636	579	645	15	1	66	0.0151515
NODE_5484_length_1067_cov_20.738636	579	645	17	5	66	0.0757576
NODE_5484_length_1067_cov_20.738636	579	645	18	9	66	0.1363636
NODE_5484_length_1067_cov_20.738636	579	645	19	2	66	0.0303030
NODE_5484_length_1067_cov_20.738636	579	645	21	14	66	0.2121212
NODE_5484_length_1067_cov_20.738636	579	645	23	12	66	0.1818182
NODE_5484_length_1067_cov_20.738636	579	645	24	4	66	0.0606061
NODE_5484_length_1067_cov_20.738636	579	645	26	1	66	0.0151515
NODE_5484_length_1067_cov_20.738636	579	645	27	1	66	0.0151515
NODE_5484_length_1067_cov_20.738636	579	645	28	5	66	0.0757576
NODE_5484_length_1067_cov_20.738636	618	698	21	4	80	0.0500000
NODE_5484_length_1067_cov_20.738636	618	698	23	12	80	0.1500000
NODE_5484_length_1067_cov_20.738636	618	698	24	4	80	0.0500000
NODE_5484_length_1067_cov_20.738636	618	698	26	1	80	0.0125000
NODE_5484_length_1067_cov_20.738636	618	698	27	4	80	0.0500000
NODE_5484_length_1067_cov_20.738636	618	698	28	5	80	0.0625000
NODE_5484_length_1067_cov_20.738636	618	698	31	8	80	0.1000000
NODE_5484_length_1067_cov_20.738636	618	698	32	5	80	0.0625000
NODE_5484_length_1067_cov_20.738636	618	698	33	4	80	0.0500000
NODE_5484_length_1067_cov_20.738636	618	698	34	9	80	0.1125000
NODE_5484_length_1067_cov_20.738636	618	698	35	5	80	0.0625000
NODE_5484_length_1067_cov_20.738636	618	698	36	8	80	0.1000000
NODE_5484_length_1067_cov_20.738636	618	698	38	11	80	0.1375000
NODE_5485_length_1067_cov_15.280992	538	617	0	79	79	1.0000000
NODE_5485_length_1067_cov_15.280992	590	670	0	80	80	1.0000000
NODE_5486_length_1067_cov_13.708678	478	558	0	80	80	1.0000000
NODE_5486_length_1067_cov_13.708678	531	611	0	80	80	1.0000000
NODE_5488_length_1067_cov_9.070248	625	705	0	80	80	1.0000000
NODE_5488_length_1067_cov_9.070248	678	758	0	80	80	1.0000000
NODE_5494_length_1067_cov_1.946281	765	812	0	47	47	1.0000000
NODE_5501_length_1066_cov_54.227508	395	475	0	80	80	1.0000000
NODE_5501_length_1066_cov_54.227508	448	528	0	80	80	1.0000000
NODE_5502_length_1066_cov_33.501551	357	437	0	80	80	1.0000000
NODE_5502_length_1066_cov_33.501551	410	490	0	80	80	1.0000000
NODE_5503_length_1066_cov_33.115822	397	477	0	13	80	0.1625000
NODE_5503_length_1066_cov_33.115822	397	477	2	67	80	0.8375000
NODE_5503_length_1066_cov_33.115822	450	530	2	80	80	1.0000000
NODE_5504_length_1066_cov_26.517063	215	285	353	1	70	0.0142857
NODE_5504_length_1066_cov_26.517063	215	285	355	1	70	0.0142857
NODE_5504_length_1066_cov_26.517063	215	285	360	1	70	0.0142857
NODE_5504_length_1066_cov_26.517063	215	285	361	1	70	0.0142857
NODE_5504_length_1066_cov_26.517063	215	285	362	3	70	0.0428571
NODE_5504_length_1066_cov_26.517063	215	285	363	2	70	0.0285714
NODE_5504_length_1066_cov_26.517063	215	285	368	2	70	0.0285714
NODE_5504_length_1066_cov_26.517063	215	285	370	2	70	0.0285714
NODE_5504_length_1066_cov_26.517063	215	285	371	1	70	0.0142857
NODE_5504_length_1066_cov_26.517063	215	285	374	1	70	0.0142857
NODE_5504_length_1066_cov_26.517063	215	285	375	1	70	0.0142857
NODE_5504_length_1066_cov_26.517063	215	285	376	1	70	0.0142857
NODE_5504_length_1066_cov_26.517063	215	285	385	3	70	0.0428571
NODE_5504_length_1066_cov_26.517063	215	285	387	4	70	0.0571429
NODE_5504_length_1066_cov_26.517063	215	285	388	2	70	0.0285714
NODE_5504_length_1066_cov_26.517063	215	285	389	1	70	0.0142857
NODE_5504_length_1066_cov_26.517063	215	285	390	3	70	0.0428571
NODE_5504_length_1066_cov_26.517063	215	285	391	1	70	0.0142857
NODE_5504_length_1066_cov_26.517063	215	285	392	3	70	0.0428571
NODE_5504_length_1066_cov_26.517063	215	285	394	2	70	0.0285714
NODE_5504_length_1066_cov_26.517063	215	285	395	1	70	0.0142857
NODE_5504_length_1066_cov_26.517063	215	285	399	2	70	0.0285714
NODE_5504_length_1066_cov_26.517063	215	285	401	1	70	0.0142857
NODE_5504_length_1066_cov_26.517063	215	285	407	2	70	0.0285714
NODE_5504_length_1066_cov_26.517063	215	285	411	1	70	0.0142857
NODE_5504_length_1066_cov_26.517063	215	285	414	1	70	0.0142857
NODE_5504_length_1066_cov_26.517063	215	285	415	1	70	0.0142857
NODE_5504_length_1066_cov_26.517063	215	285	416	2	70	0.0285714
NODE_5504_length_1066_cov_26.517063	215	285	421	1	70	0.0142857
NODE_5504_length_1066_cov_26.517063	215	285	422	1	70	0.0142857
NODE_5504_length_1066_cov_26.517063	215	285	423	1	70	0.0142857
NODE_5504_length_1066_cov_26.517063	215	285	424	1	70	0.0142857
NODE_5504_length_1066_cov_26.517063	215	285	425	4	70	0.0571429
NODE_5504_length_1066_cov_26.517063	215	285	426	2	70	0.0285714
NODE_5504_length_1066_cov_26.517063	215	285	427	1	70	0.0142857
NODE_5504_length_1066_cov_26.517063	215	285	430	1	70	0.0142857
NODE_5504_length_1066_cov_26.517063	215	285	431	3	70	0.0428571
NODE_5504_length_1066_cov_26.517063	215	285	432	1	70	0.0142857
NODE_5504_length_1066_cov_26.517063	215	285	436	1	70	0.0142857
NODE_5504_length_1066_cov_26.517063	215	285	439	1	70	0.0142857
NODE_5504_length_1066_cov_26.517063	215	285	440	2	70	0.0285714
NODE_5504_length_1066_cov_26.517063	215	285	442	1	70	0.0142857
NODE_5504_length_1066_cov_26.517063	215	285	447	1	70	0.0142857
NODE_5504_length_1066_cov_26.517063	215	285	448	1	70	0.0142857
NODE_5505_length_1066_cov_16.906929	526	606	0	59	80	0.7375000
NODE_5505_length_1066_cov_16.906929	526	606	2	21	80	0.2625000
NODE_5505_length_1066_cov_16.906929	579	659	0	12	80	0.1500000
NODE_5505_length_1066_cov_16.906929	579	659	2	68	80	0.8500000
NODE_5506_length_1066_cov_16.190279	298	378	0	69	80	0.8625000
NODE_5506_length_1066_cov_16.190279	298	378	6	11	80	0.1375000
NODE_5506_length_1066_cov_16.190279	351	432	0	16	81	0.1975309
NODE_5506_length_1066_cov_16.190279	351	432	6	65	81	0.8024691
NODE_5507_length_1066_cov_15.444674	582	662	2	14	80	0.1750000
NODE_5507_length_1066_cov_15.444674	582	662	4	20	80	0.2500000
NODE_5507_length_1066_cov_15.444674	582	662	6	46	80	0.5750000
NODE_5507_length_1066_cov_15.444674	635	715	0	18	80	0.2250000
NODE_5507_length_1066_cov_15.444674	635	715	4	55	80	0.6875000
NODE_5507_length_1066_cov_15.444674	635	715	6	7	80	0.0875000
NODE_5516_length_1065_cov_51.693582	480	560	0	7	80	0.0875000
NODE_5516_length_1065_cov_51.693582	480	560	2	73	80	0.9125000
NODE_5516_length_1065_cov_51.693582	533	613	0	60	80	0.7500000
NODE_5516_length_1065_cov_51.693582	533	613	2	20	80	0.2500000
NODE_5517_length_1065_cov_33.428571	422	502	4	6	80	0.0750000
NODE_5517_length_1065_cov_33.428571	422	502	10	27	80	0.3375000
NODE_5517_length_1065_cov_33.428571	422	502	12	27	80	0.3375000
NODE_5517_length_1065_cov_33.428571	422	502	14	15	80	0.1875000
NODE_5517_length_1065_cov_33.428571	422	502	16	5	80	0.0625000
NODE_5517_length_1065_cov_33.428571	422	502	4	6	80	0.0750000
NODE_5517_length_1065_cov_33.428571	422	502	10	27	80	0.3375000
NODE_5517_length_1065_cov_33.428571	422	502	12	27	80	0.3375000
NODE_5517_length_1065_cov_33.428571	422	502	14	15	80	0.1875000
NODE_5517_length_1065_cov_33.428571	422	502	16	5	80	0.0625000
NODE_5517_length_1065_cov_33.428571	422	502	4	6	80	0.0750000
NODE_5517_length_1065_cov_33.428571	422	502	10	27	80	0.3375000
NODE_5517_length_1065_cov_33.428571	422	502	12	27	80	0.3375000
NODE_5517_length_1065_cov_33.428571	422	502	14	15	80	0.1875000
NODE_5517_length_1065_cov_33.428571	422	502	16	5	80	0.0625000
NODE_5517_length_1065_cov_33.428571	475	555	12	27	80	0.3375000
NODE_5517_length_1065_cov_33.428571	475	555	13	4	80	0.0500000
NODE_5517_length_1065_cov_33.428571	475	555	14	6	80	0.0750000
NODE_5517_length_1065_cov_33.428571	475	555	16	19	80	0.2375000
NODE_5517_length_1065_cov_33.428571	475	555	20	5	80	0.0625000
NODE_5517_length_1065_cov_33.428571	475	555	28	9	80	0.1125000
NODE_5517_length_1065_cov_33.428571	475	555	34	10	80	0.1250000
NODE_5517_length_1065_cov_33.428571	475	555	12	27	80	0.3375000
NODE_5517_length_1065_cov_33.428571	475	555	13	4	80	0.0500000
NODE_5517_length_1065_cov_33.428571	475	555	14	6	80	0.0750000
NODE_5517_length_1065_cov_33.428571	475	555	16	19	80	0.2375000
NODE_5517_length_1065_cov_33.428571	475	555	20	5	80	0.0625000
NODE_5517_length_1065_cov_33.428571	475	555	28	9	80	0.1125000
NODE_5517_length_1065_cov_33.428571	475	555	34	10	80	0.1250000
NODE_5517_length_1065_cov_33.428571	551	631	24	8	80	0.1000000
NODE_5517_length_1065_cov_33.428571	551	631	26	15	80	0.1875000
NODE_5517_length_1065_cov_33.428571	551	631	28	17	80	0.2125000
NODE_5517_length_1065_cov_33.428571	551	631	29	1	80	0.0125000
NODE_5517_length_1065_cov_33.428571	551	631	30	4	80	0.0500000
NODE_5517_length_1065_cov_33.428571	551	631	32	4	80	0.0500000
NODE_5517_length_1065_cov_33.428571	551	631	34	31	80	0.3875000
NODE_5517_length_1065_cov_33.428571	551	631	24	8	80	0.1000000
NODE_5517_length_1065_cov_33.428571	551	631	26	15	80	0.1875000
NODE_5517_length_1065_cov_33.428571	551	631	28	17	80	0.2125000
NODE_5517_length_1065_cov_33.428571	551	631	29	1	80	0.0125000
NODE_5517_length_1065_cov_33.428571	551	631	30	4	80	0.0500000
NODE_5517_length_1065_cov_33.428571	551	631	32	4	80	0.0500000
NODE_5517_length_1065_cov_33.428571	551	631	34	31	80	0.3875000
NODE_5517_length_1065_cov_33.428571	551	572	28	14	21	0.6666667
NODE_5517_length_1065_cov_33.428571	551	572	34	7	21	0.3333333
NODE_5517_length_1065_cov_33.428571	604	666	8	4	62	0.0645161
NODE_5517_length_1065_cov_33.428571	604	666	16	5	62	0.0806452
NODE_5517_length_1065_cov_33.428571	604	666	17	4	62	0.0645161
NODE_5517_length_1065_cov_33.428571	604	666	18	2	62	0.0322581
NODE_5517_length_1065_cov_33.428571	604	666	24	28	62	0.4516129
NODE_5517_length_1065_cov_33.428571	604	666	26	15	62	0.2419355
NODE_5517_length_1065_cov_33.428571	604	666	28	3	62	0.0483871
NODE_5517_length_1065_cov_33.428571	604	666	29	1	62	0.0161290
NODE_5517_length_1065_cov_33.428571	604	684	6	1	80	0.0125000
NODE_5517_length_1065_cov_33.428571	604	684	8	11	80	0.1375000
NODE_5517_length_1065_cov_33.428571	604	684	10	10	80	0.1250000
NODE_5517_length_1065_cov_33.428571	604	684	16	5	80	0.0625000
NODE_5517_length_1065_cov_33.428571	604	684	17	4	80	0.0500000
NODE_5517_length_1065_cov_33.428571	604	684	18	2	80	0.0250000
NODE_5517_length_1065_cov_33.428571	604	684	24	28	80	0.3500000
NODE_5517_length_1065_cov_33.428571	604	684	26	15	80	0.1875000
NODE_5517_length_1065_cov_33.428571	604	684	28	3	80	0.0375000
NODE_5517_length_1065_cov_33.428571	604	684	29	1	80	0.0125000
NODE_5518_length_1065_cov_31.874741	255	335	0	26	80	0.3250000
NODE_5518_length_1065_cov_31.874741	255	335	4	54	80	0.6750000
NODE_5518_length_1065_cov_31.874741	308	388	4	80	80	1.0000000
NODE_5519_length_1065_cov_21.762940	234	314	0	80	80	1.0000000
NODE_5519_length_1065_cov_21.762940	287	367	0	80	80	1.0000000
NODE_5520_length_1065_cov_19.947205	447	527	0	1	80	0.0125000
NODE_5520_length_1065_cov_19.947205	447	527	2	17	80	0.2125000
NODE_5520_length_1065_cov_19.947205	447	527	4	62	80	0.7750000
NODE_5520_length_1065_cov_19.947205	500	580	4	45	80	0.5625000
NODE_5520_length_1065_cov_19.947205	500	580	6	35	80	0.4375000
NODE_5521_length_1065_cov_14.590062	343	423	0	19	80	0.2375000
NODE_5521_length_1065_cov_14.590062	343	423	5	9	80	0.1125000
NODE_5521_length_1065_cov_14.590062	343	423	7	12	80	0.1500000
NODE_5521_length_1065_cov_14.590062	343	423	8	40	80	0.5000000
NODE_5521_length_1065_cov_14.590062	396	476	6	36	80	0.4500000
NODE_5521_length_1065_cov_14.590062	396	476	8	44	80	0.5500000
NODE_5522_length_1065_cov_13.232919	243	323	0	80	80	1.0000000
NODE_5522_length_1065_cov_13.232919	296	376	0	80	80	1.0000000
NODE_5523_length_1065_cov_10.670807	481	561	0	15	80	0.1875000
NODE_5523_length_1065_cov_10.670807	481	561	2	65	80	0.8125000
NODE_5523_length_1065_cov_10.670807	534	614	2	80	80	1.0000000
NODE_5524_length_1065_cov_10.473085	496	576	0	21	80	0.2625000
NODE_5524_length_1065_cov_10.473085	496	576	2	59	80	0.7375000
NODE_5524_length_1065_cov_10.473085	549	629	2	76	80	0.9500000
NODE_5524_length_1065_cov_10.473085	549	629	4	4	80	0.0500000
NODE_5525_length_1065_cov_9.711180	286	360	0	29	74	0.3918919
NODE_5525_length_1065_cov_9.711180	286	360	2	20	74	0.2702703
NODE_5525_length_1065_cov_9.711180	286	360	4	25	74	0.3378378
NODE_5525_length_1065_cov_9.711180	339	419	4	80	80	1.0000000
NODE_5534_length_1064_cov_59.929534	457	537	0	80	80	1.0000000
NODE_5534_length_1064_cov_59.929534	510	590	0	80	80	1.0000000
NODE_5534_length_1064_cov_59.929534	586	666	0	73	80	0.9125000
NODE_5534_length_1064_cov_59.929534	586	666	4	7	80	0.0875000
NODE_5534_length_1064_cov_59.929534	639	719	0	25	80	0.3125000
NODE_5534_length_1064_cov_59.929534	639	719	4	55	80	0.6875000
NODE_5535_length_1064_cov_36.480829	367	447	0	80	80	1.0000000
NODE_5535_length_1064_cov_36.480829	420	500	0	80	80	1.0000000
NODE_5535_length_1064_cov_36.480829	496	576	0	80	80	1.0000000
NODE_5535_length_1064_cov_36.480829	549	629	0	80	80	1.0000000
NODE_5536_length_1064_cov_32.307772	547	627	0	80	80	1.0000000
NODE_5536_length_1064_cov_32.307772	600	680	0	80	80	1.0000000
NODE_5537_length_1064_cov_25.255959	462	542	0	80	80	1.0000000
NODE_5537_length_1064_cov_25.255959	515	595	0	80	80	1.0000000
NODE_5537_length_1064_cov_25.255959	591	671	0	80	80	1.0000000
NODE_5537_length_1064_cov_25.255959	644	724	0	53	80	0.6625000
NODE_5537_length_1064_cov_25.255959	644	724	2	10	80	0.1250000
NODE_5537_length_1064_cov_25.255959	644	724	4	17	80	0.2125000
NODE_5538_length_1064_cov_23.053886	343	423	0	80	80	1.0000000
NODE_5538_length_1064_cov_23.053886	396	476	0	80	80	1.0000000
NODE_5538_length_1064_cov_23.053886	472	552	0	80	80	1.0000000
NODE_5538_length_1064_cov_23.053886	525	605	0	80	80	1.0000000
NODE_5539_length_1064_cov_22.018653	479	559	0	80	80	1.0000000
NODE_5539_length_1064_cov_22.018653	532	612	0	80	80	1.0000000
NODE_5540_length_1064_cov_12.868394	424	504	0	80	80	1.0000000
NODE_5540_length_1064_cov_12.868394	477	557	0	69	80	0.8625000
NODE_5540_length_1064_cov_12.868394	477	557	2	11	80	0.1375000
NODE_5541_length_1064_cov_10.098446	467	547	0	80	80	1.0000000
NODE_5541_length_1064_cov_10.098446	520	600	0	80	80	1.0000000
NODE_5543_length_1064_cov_2.925389	173	245	2	2	72	0.0277778
NODE_5543_length_1064_cov_2.925389	173	245	3	5	72	0.0694444
NODE_5543_length_1064_cov_2.925389	173	245	4	4	72	0.0555556
NODE_5543_length_1064_cov_2.925389	173	245	6	11	72	0.1527778
NODE_5543_length_1064_cov_2.925389	173	245	7	4	72	0.0555556
NODE_5543_length_1064_cov_2.925389	173	245	9	1	72	0.0138889
NODE_5543_length_1064_cov_2.925389	173	245	13	9	72	0.1250000
NODE_5543_length_1064_cov_2.925389	173	245	15	8	72	0.1111111
NODE_5543_length_1064_cov_2.925389	173	245	17	3	72	0.0416667
NODE_5543_length_1064_cov_2.925389	173	245	19	3	72	0.0416667
NODE_5543_length_1064_cov_2.925389	173	245	25	2	72	0.0277778
NODE_5543_length_1064_cov_2.925389	173	245	29	2	72	0.0277778
NODE_5543_length_1064_cov_2.925389	173	245	31	1	72	0.0138889
NODE_5543_length_1064_cov_2.925389	173	245	32	5	72	0.0694444
NODE_5543_length_1064_cov_2.925389	173	245	34	1	72	0.0138889
NODE_5543_length_1064_cov_2.925389	173	245	36	1	72	0.0138889
NODE_5543_length_1064_cov_2.925389	173	245	40	3	72	0.0416667
NODE_5543_length_1064_cov_2.925389	173	245	42	2	72	0.0277778
NODE_5543_length_1064_cov_2.925389	173	245	45	3	72	0.0416667
NODE_5543_length_1064_cov_2.925389	173	245	47	2	72	0.0277778
NODE_5551_length_1063_cov_104.615145	504	584	0	80	80	1.0000000
NODE_5551_length_1063_cov_104.615145	557	637	0	80	80	1.0000000
NODE_5552_length_1063_cov_36.515560	482	562	0	80	80	1.0000000
NODE_5552_length_1063_cov_36.515560	535	615	0	80	80	1.0000000
NODE_5552_length_1063_cov_36.515560	611	691	0	22	80	0.2750000
NODE_5552_length_1063_cov_36.515560	611	691	1	58	80	0.7250000
NODE_5552_length_1063_cov_36.515560	664	744	0	10	80	0.1250000
NODE_5552_length_1063_cov_36.515560	664	744	1	70	80	0.8750000
NODE_5553_length_1063_cov_30.700207	470	550	0	19	80	0.2375000
NODE_5553_length_1063_cov_30.700207	470	550	2	61	80	0.7625000
NODE_5553_length_1063_cov_30.700207	523	603	0	67	80	0.8375000
NODE_5553_length_1063_cov_30.700207	523	603	2	13	80	0.1625000
NODE_5553_length_1063_cov_30.700207	599	679	0	80	80	1.0000000
NODE_5553_length_1063_cov_30.700207	652	732	0	80	80	1.0000000
NODE_5554_length_1063_cov_24.552905	362	442	0	80	80	1.0000000
NODE_5554_length_1063_cov_24.552905	415	495	0	80	80	1.0000000
NODE_5555_length_1063_cov_21.985477	407	487	0	40	80	0.5000000
NODE_5555_length_1063_cov_21.985477	407	487	2	40	80	0.5000000
NODE_5555_length_1063_cov_21.985477	460	540	2	80	80	1.0000000
NODE_5555_length_1063_cov_21.985477	536	616	0	29	80	0.3625000
NODE_5555_length_1063_cov_21.985477	536	616	2	51	80	0.6375000
NODE_5555_length_1063_cov_21.985477	589	670	0	81	81	1.0000000
NODE_5557_length_1063_cov_15.400415	685	765	0	80	80	1.0000000
NODE_5557_length_1063_cov_15.400415	738	818	0	80	80	1.0000000
NODE_5558_length_1063_cov_13.282158	510	590	0	80	80	1.0000000
NODE_5558_length_1063_cov_13.282158	563	643	0	80	80	1.0000000
NODE_5559_length_1063_cov_12.970954	417	495	0	78	78	1.0000000
NODE_5559_length_1063_cov_12.970954	468	548	0	80	80	1.0000000
NODE_5560_length_1063_cov_7.917012	639	719	0	80	80	1.0000000
NODE_5560_length_1063_cov_7.917012	692	772	0	80	80	1.0000000
NODE_5569_length_1063_cov_1.695021	893	947	34	7	54	0.1296296
NODE_5569_length_1063_cov_1.695021	893	947	36	2	54	0.0370370
NODE_5569_length_1063_cov_1.695021	893	947	37	2	54	0.0370370
NODE_5569_length_1063_cov_1.695021	893	947	38	4	54	0.0740741
NODE_5569_length_1063_cov_1.695021	893	947	41	2	54	0.0370370
NODE_5569_length_1063_cov_1.695021	893	947	42	27	54	0.5000000
NODE_5569_length_1063_cov_1.695021	893	947	44	10	54	0.1851852
NODE_5574_length_1062_cov_43.399792	272	352	0	80	80	1.0000000
NODE_5574_length_1062_cov_43.399792	325	405	0	80	80	1.0000000
NODE_5576_length_1062_cov_19.778816	401	481	0	29	80	0.3625000
NODE_5576_length_1062_cov_19.778816	401	481	4	31	80	0.3875000
NODE_5576_length_1062_cov_19.778816	401	481	6	20	80	0.2500000
NODE_5576_length_1062_cov_19.778816	454	534	0	4	80	0.0500000
NODE_5576_length_1062_cov_19.778816	454	534	4	20	80	0.2500000
NODE_5576_length_1062_cov_19.778816	454	534	6	56	80	0.7000000
NODE_5577_length_1062_cov_16.034268	628	708	4	10	80	0.1250000
NODE_5577_length_1062_cov_16.034268	628	708	6	70	80	0.8750000
NODE_5577_length_1062_cov_16.034268	681	761	2	36	80	0.4500000
NODE_5577_length_1062_cov_16.034268	681	761	4	10	80	0.1250000
NODE_5577_length_1062_cov_16.034268	681	761	6	34	80	0.4250000
NODE_5578_length_1062_cov_13.346833	623	703	0	80	80	1.0000000
NODE_5578_length_1062_cov_13.346833	676	756	0	80	80	1.0000000
NODE_5579_length_1062_cov_9.886812	670	750	0	80	80	1.0000000
NODE_5579_length_1062_cov_9.886812	723	803	0	80	80	1.0000000
NODE_5580_length_1062_cov_9.078920	525	604	0	79	79	1.0000000
NODE_5580_length_1062_cov_9.078920	577	657	0	80	80	1.0000000
NODE_5581_length_1062_cov_8.934579	203	283	0	80	80	1.0000000
NODE_5581_length_1062_cov_8.934579	256	336	0	80	80	1.0000000
NODE_5588_length_1061_cov_22.637214	418	498	0	51	80	0.6375000
NODE_5588_length_1061_cov_22.637214	418	498	1	29	80	0.3625000
NODE_5588_length_1061_cov_22.637214	471	551	1	48	80	0.6000000
NODE_5588_length_1061_cov_22.637214	471	551	2	32	80	0.4000000
NODE_5589_length_1061_cov_22.338877	479	559	0	33	80	0.4125000
NODE_5589_length_1061_cov_22.338877	479	559	6	27	80	0.3375000
NODE_5589_length_1061_cov_22.338877	479	559	10	20	80	0.2500000
NODE_5589_length_1061_cov_22.338877	532	612	4	34	80	0.4250000
NODE_5589_length_1061_cov_22.338877	532	612	6	7	80	0.0875000
NODE_5589_length_1061_cov_22.338877	532	612	10	39	80	0.4875000
NODE_5597_length_1060_cov_31.595213	394	473	0	79	79	1.0000000
NODE_5597_length_1060_cov_31.595213	446	526	0	80	80	1.0000000
NODE_5597_length_1060_cov_31.595213	522	602	0	80	80	1.0000000
NODE_5597_length_1060_cov_31.595213	575	655	0	80	80	1.0000000
NODE_5598_length_1060_cov_26.136316	486	566	0	80	80	1.0000000
NODE_5598_length_1060_cov_26.136316	539	619	0	80	80	1.0000000
NODE_5598_length_1060_cov_26.136316	615	695	0	80	80	1.0000000
NODE_5598_length_1060_cov_26.136316	668	748	0	46	80	0.5750000
NODE_5598_length_1060_cov_26.136316	668	748	2	34	80	0.4250000
NODE_5599_length_1060_cov_25.329865	370	450	16	80	80	1.0000000
NODE_5599_length_1060_cov_25.329865	423	503	0	10	80	0.1250000
NODE_5599_length_1060_cov_25.329865	423	503	16	70	80	0.8750000
NODE_5600_length_1060_cov_16.881374	539	611	0	67	72	0.9305556
NODE_5600_length_1060_cov_16.881374	539	611	2	5	72	0.0694444
NODE_5601_length_1060_cov_14.789802	406	486	0	80	80	1.0000000
NODE_5601_length_1060_cov_14.789802	459	539	0	80	80	1.0000000
NODE_5603_length_1060_cov_5.900104	517	597	0	80	80	1.0000000
NODE_5603_length_1060_cov_5.900104	570	650	0	80	80	1.0000000
NODE_5611_length_1059_cov_16.630208	412	492	0	80	80	1.0000000
NODE_5611_length_1059_cov_16.630208	465	552	0	87	87	1.0000000
NODE_5611_length_1059_cov_16.630208	548	628	0	26	80	0.3250000
NODE_5611_length_1059_cov_16.630208	548	628	5	1	80	0.0125000
NODE_5611_length_1059_cov_16.630208	548	628	6	53	80	0.6625000
NODE_5611_length_1059_cov_16.630208	601	681	2	7	80	0.0875000
NODE_5611_length_1059_cov_16.630208	601	681	4	17	80	0.2125000
NODE_5611_length_1059_cov_16.630208	601	681	6	42	80	0.5250000
NODE_5611_length_1059_cov_16.630208	601	681	8	14	80	0.1750000
NODE_5621_length_1058_cov_60.155370	395	475	0	49	80	0.6125000
NODE_5621_length_1058_cov_60.155370	395	475	1	31	80	0.3875000
NODE_5621_length_1058_cov_60.155370	448	528	0	50	80	0.6250000
NODE_5621_length_1058_cov_60.155370	448	528	2	30	80	0.3750000
NODE_5621_length_1058_cov_60.155370	524	604	0	26	80	0.3250000
NODE_5621_length_1058_cov_60.155370	524	604	2	54	80	0.6750000
NODE_5621_length_1058_cov_60.155370	577	657	0	79	80	0.9875000
NODE_5621_length_1058_cov_60.155370	577	657	2	1	80	0.0125000
NODE_5622_length_1058_cov_31.253389	475	555	18	9	80	0.1125000
NODE_5622_length_1058_cov_31.253389	475	555	26	1	80	0.0125000
NODE_5622_length_1058_cov_31.253389	475	555	31	6	80	0.0750000
NODE_5622_length_1058_cov_31.253389	475	555	37	13	80	0.1625000
NODE_5622_length_1058_cov_31.253389	475	555	47	19	80	0.2375000
NODE_5622_length_1058_cov_31.253389	475	555	49	32	80	0.4000000
NODE_5622_length_1058_cov_31.253389	475	555	18	9	80	0.1125000
NODE_5622_length_1058_cov_31.253389	475	555	26	1	80	0.0125000
NODE_5622_length_1058_cov_31.253389	475	555	31	6	80	0.0750000
NODE_5622_length_1058_cov_31.253389	475	555	37	13	80	0.1625000
NODE_5622_length_1058_cov_31.253389	475	555	47	19	80	0.2375000
NODE_5622_length_1058_cov_31.253389	475	555	49	32	80	0.4000000
NODE_5622_length_1058_cov_31.253389	528	608	27	39	80	0.4875000
NODE_5622_length_1058_cov_31.253389	528	608	39	1	80	0.0125000
NODE_5622_length_1058_cov_31.253389	528	608	47	32	80	0.4000000
NODE_5622_length_1058_cov_31.253389	528	608	49	8	80	0.1000000
NODE_5622_length_1058_cov_31.253389	533	608	27	39	75	0.5200000
NODE_5622_length_1058_cov_31.253389	533	608	39	1	75	0.0133333
NODE_5622_length_1058_cov_31.253389	533	608	47	32	75	0.4266667
NODE_5622_length_1058_cov_31.253389	533	608	49	3	75	0.0400000
NODE_5623_length_1058_cov_24.520334	264	344	2	18	80	0.2250000
NODE_5623_length_1058_cov_24.520334	264	344	5	43	80	0.5375000
NODE_5623_length_1058_cov_24.520334	264	344	6	1	80	0.0125000
NODE_5623_length_1058_cov_24.520334	264	344	7	18	80	0.2250000
NODE_5623_length_1058_cov_24.520334	317	397	5	43	80	0.5375000
NODE_5623_length_1058_cov_24.520334	317	397	6	37	80	0.4625000
NODE_5624_length_1058_cov_24.211679	297	377	2	9	80	0.1125000
NODE_5624_length_1058_cov_24.211679	297	377	4	14	80	0.1750000
NODE_5624_length_1058_cov_24.211679	297	377	8	57	80	0.7125000
NODE_5624_length_1058_cov_24.211679	350	430	2	9	80	0.1125000
NODE_5624_length_1058_cov_24.211679	350	430	3	2	80	0.0250000
NODE_5624_length_1058_cov_24.211679	350	430	4	60	80	0.7500000
NODE_5624_length_1058_cov_24.211679	350	430	5	5	80	0.0625000
NODE_5624_length_1058_cov_24.211679	350	430	8	4	80	0.0500000
NODE_5625_length_1058_cov_18.100104	454	534	0	80	80	1.0000000
NODE_5625_length_1058_cov_18.100104	507	587	0	80	80	1.0000000
NODE_5626_length_1058_cov_11.645464	476	556	0	80	80	1.0000000
NODE_5626_length_1058_cov_11.645464	529	609	0	80	80	1.0000000
NODE_5627_length_1058_cov_9.953076	621	712	0	86	91	0.9450549
NODE_5627_length_1058_cov_9.953076	621	712	2	5	91	0.0549451
NODE_5627_length_1058_cov_9.953076	685	765	0	80	80	1.0000000
NODE_5628_length_1058_cov_6.294056	819	899	0	80	80	1.0000000
NODE_5628_length_1058_cov_6.294056	875	952	0	77	77	1.0000000
NODE_5637_length_1057_cov_43.191023	413	493	0	42	80	0.5250000
NODE_5637_length_1057_cov_43.191023	413	493	2	38	80	0.4750000
NODE_5637_length_1057_cov_43.191023	466	546	2	27	80	0.3375000
NODE_5637_length_1057_cov_43.191023	466	546	8	39	80	0.4875000
NODE_5637_length_1057_cov_43.191023	466	546	14	9	80	0.1125000
NODE_5637_length_1057_cov_43.191023	466	546	16	5	80	0.0625000
NODE_5637_length_1057_cov_43.191023	542	622	14	61	80	0.7625000
NODE_5637_length_1057_cov_43.191023	542	622	15	17	80	0.2125000
NODE_5637_length_1057_cov_43.191023	542	622	16	2	80	0.0250000
NODE_5637_length_1057_cov_43.191023	595	675	2	1	80	0.0125000
NODE_5637_length_1057_cov_43.191023	595	675	3	4	80	0.0500000
NODE_5637_length_1057_cov_43.191023	595	675	4	35	80	0.4375000
NODE_5637_length_1057_cov_43.191023	595	675	8	6	80	0.0750000
NODE_5637_length_1057_cov_43.191023	595	675	14	8	80	0.1000000
NODE_5637_length_1057_cov_43.191023	595	675	15	17	80	0.2125000
NODE_5637_length_1057_cov_43.191023	595	675	16	9	80	0.1125000
NODE_5638_length_1057_cov_27.387265	486	566	0	26	80	0.3250000
NODE_5638_length_1057_cov_27.387265	486	566	4	54	80	0.6750000
NODE_5638_length_1057_cov_27.387265	539	619	0	8	80	0.1000000
NODE_5638_length_1057_cov_27.387265	539	619	2	13	80	0.1625000
NODE_5638_length_1057_cov_27.387265	539	619	4	59	80	0.7375000
NODE_5639_length_1057_cov_16.489562	416	496	0	49	80	0.6125000
NODE_5639_length_1057_cov_16.489562	416	496	3	3	80	0.0375000
NODE_5639_length_1057_cov_16.489562	416	496	5	28	80	0.3500000
NODE_5639_length_1057_cov_16.489562	469	549	5	29	80	0.3625000
NODE_5639_length_1057_cov_16.489562	469	549	7	22	80	0.2750000
NODE_5639_length_1057_cov_16.489562	469	549	8	29	80	0.3625000
NODE_5640_length_1057_cov_13.605428	631	711	0	11	80	0.1375000
NODE_5640_length_1057_cov_13.605428	631	711	2	69	80	0.8625000
NODE_5640_length_1057_cov_13.605428	684	764	0	42	80	0.5250000
NODE_5640_length_1057_cov_13.605428	684	764	2	38	80	0.4750000
NODE_5641_length_1057_cov_12.768267	518	598	0	80	80	1.0000000
NODE_5641_length_1057_cov_12.768267	571	651	0	80	80	1.0000000
NODE_5644_length_1057_cov_7.692067	706	786	0	80	80	1.0000000
NODE_5644_length_1057_cov_7.692067	759	839	0	80	80	1.0000000
NODE_5645_length_1057_cov_6.697286	561	641	0	2	80	0.0250000
NODE_5645_length_1057_cov_6.697286	561	641	2	70	80	0.8750000
NODE_5645_length_1057_cov_6.697286	561	641	4	8	80	0.1000000
NODE_5645_length_1057_cov_6.697286	614	694	0	2	80	0.0250000
NODE_5645_length_1057_cov_6.697286	614	694	2	17	80	0.2125000
NODE_5645_length_1057_cov_6.697286	614	694	4	61	80	0.7625000
NODE_5654_length_1056_cov_57.539185	462	542	0	6	80	0.0750000
NODE_5654_length_1056_cov_57.539185	462	542	4	71	80	0.8875000
NODE_5654_length_1056_cov_57.539185	462	542	6	3	80	0.0375000
NODE_5654_length_1056_cov_57.539185	515	595	0	59	80	0.7375000
NODE_5654_length_1056_cov_57.539185	515	595	4	21	80	0.2625000
NODE_5655_length_1056_cov_35.751306	421	501	0	15	80	0.1875000
NODE_5655_length_1056_cov_35.751306	421	501	2	65	80	0.8125000
NODE_5655_length_1056_cov_35.751306	474	554	0	68	80	0.8500000
NODE_5655_length_1056_cov_35.751306	474	554	2	12	80	0.1500000
NODE_5656_length_1056_cov_29.749216	415	490	0	28	75	0.3733333
NODE_5656_length_1056_cov_29.749216	415	490	2	30	75	0.4000000
NODE_5656_length_1056_cov_29.749216	415	490	4	5	75	0.0666667
NODE_5656_length_1056_cov_29.749216	415	490	6	12	75	0.1600000
NODE_5656_length_1056_cov_29.749216	416	495	0	28	79	0.3544304
NODE_5656_length_1056_cov_29.749216	416	495	2	29	79	0.3670886
NODE_5656_length_1056_cov_29.749216	416	495	4	5	79	0.0632911
NODE_5656_length_1056_cov_29.749216	416	495	6	17	79	0.2151899
NODE_5656_length_1056_cov_29.749216	448	495	0	25	47	0.5319149
NODE_5656_length_1056_cov_29.749216	448	495	4	5	47	0.1063830
NODE_5656_length_1056_cov_29.749216	448	495	6	17	47	0.3617021
NODE_5656_length_1056_cov_29.749216	468	548	0	5	80	0.0625000
NODE_5656_length_1056_cov_29.749216	468	548	4	5	80	0.0625000
NODE_5656_length_1056_cov_29.749216	468	548	6	70	80	0.8750000
NODE_5656_length_1056_cov_29.749216	468	548	0	5	80	0.0625000
NODE_5656_length_1056_cov_29.749216	468	548	4	5	80	0.0625000
NODE_5656_length_1056_cov_29.749216	468	548	6	70	80	0.8750000
NODE_5656_length_1056_cov_29.749216	468	548	0	5	80	0.0625000
NODE_5656_length_1056_cov_29.749216	468	548	4	5	80	0.0625000
NODE_5656_length_1056_cov_29.749216	468	548	6	70	80	0.8750000
NODE_5657_length_1056_cov_25.342738	297	377	0	29	80	0.3625000
NODE_5657_length_1056_cov_25.342738	297	377	2	51	80	0.6375000
NODE_5657_length_1056_cov_25.342738	350	430	0	80	80	1.0000000
NODE_5657_length_1056_cov_25.342738	426	506	0	80	80	1.0000000
NODE_5657_length_1056_cov_25.342738	479	559	0	80	80	1.0000000
NODE_5658_length_1056_cov_24.094044	535	615	0	78	80	0.9750000
NODE_5658_length_1056_cov_24.094044	535	615	2	2	80	0.0250000
NODE_5658_length_1056_cov_24.094044	588	668	0	80	80	1.0000000
NODE_5659_length_1056_cov_20.700104	570	650	0	8	80	0.1000000
NODE_5659_length_1056_cov_20.700104	570	650	8	4	80	0.0500000
NODE_5659_length_1056_cov_20.700104	570	650	9	68	80	0.8500000
NODE_5659_length_1056_cov_20.700104	623	703	0	18	80	0.2250000
NODE_5659_length_1056_cov_20.700104	623	703	8	9	80	0.1125000
NODE_5659_length_1056_cov_20.700104	623	703	9	53	80	0.6625000
NODE_5660_length_1056_cov_14.215256	349	429	0	5	80	0.0625000
NODE_5660_length_1056_cov_14.215256	349	429	2	75	80	0.9375000
NODE_5660_length_1056_cov_14.215256	402	482	0	33	80	0.4125000
NODE_5660_length_1056_cov_14.215256	402	482	2	47	80	0.5875000
NODE_5660_length_1056_cov_14.215256	478	558	0	80	80	1.0000000
NODE_5660_length_1056_cov_14.215256	531	611	0	80	80	1.0000000
NODE_5661_length_1056_cov_13.782654	563	643	0	80	80	1.0000000
NODE_5661_length_1056_cov_13.782654	616	696	0	57	80	0.7125000
NODE_5661_length_1056_cov_13.782654	616	696	2	23	80	0.2875000
NODE_5663_length_1056_cov_9.298851	373	453	2	13	80	0.1625000
NODE_5663_length_1056_cov_9.298851	373	453	4	67	80	0.8375000
NODE_5663_length_1056_cov_9.298851	426	503	0	35	77	0.4545455
NODE_5663_length_1056_cov_9.298851	426	503	2	28	77	0.3636364
NODE_5663_length_1056_cov_9.298851	426	503	4	14	77	0.1818182
NODE_5665_length_1056_cov_6.157785	396	476	0	80	80	1.0000000
NODE_5665_length_1056_cov_6.157785	449	529	0	80	80	1.0000000
NODE_5666_length_1056_cov_6.034483	287	367	0	56	80	0.7000000
NODE_5666_length_1056_cov_6.034483	287	367	2	24	80	0.3000000
NODE_5666_length_1056_cov_6.034483	340	420	0	80	80	1.0000000
NODE_5667_length_1056_cov_3.259143	371	410	0	39	39	1.0000000
NODE_5667_length_1056_cov_3.259143	424	463	0	39	39	1.0000000
NODE_5668_length_1056_cov_2.362591	234	314	4	13	80	0.1625000
NODE_5668_length_1056_cov_2.362591	234	314	6	67	80	0.8375000
NODE_5672_length_1055_cov_36.460251	468	548	0	47	80	0.5875000
NODE_5672_length_1055_cov_36.460251	468	548	2	33	80	0.4125000
NODE_5672_length_1055_cov_36.460251	521	601	0	19	80	0.2375000
NODE_5672_length_1055_cov_36.460251	521	601	2	61	80	0.7625000
NODE_5673_length_1055_cov_31.235356	502	582	0	80	80	1.0000000
NODE_5673_length_1055_cov_31.235356	555	635	0	80	80	1.0000000
NODE_5674_length_1055_cov_23.330544	403	483	5	80	80	1.0000000
NODE_5674_length_1055_cov_23.330544	456	536	0	49	80	0.6125000
NODE_5674_length_1055_cov_23.330544	456	536	3	1	80	0.0125000
NODE_5674_length_1055_cov_23.330544	456	536	5	30	80	0.3750000
NODE_5674_length_1055_cov_23.330544	532	612	0	80	80	1.0000000
NODE_5674_length_1055_cov_23.330544	585	665	0	61	80	0.7625000
NODE_5674_length_1055_cov_23.330544	585	665	2	19	80	0.2375000
NODE_5675_length_1055_cov_19.541841	321	401	0	20	80	0.2500000
NODE_5675_length_1055_cov_19.541841	321	401	1	19	80	0.2375000
NODE_5675_length_1055_cov_19.541841	321	401	2	9	80	0.1125000
NODE_5675_length_1055_cov_19.541841	321	401	4	32	80	0.4000000
NODE_5675_length_1055_cov_19.541841	374	454	2	11	80	0.1375000
NODE_5675_length_1055_cov_19.541841	374	454	4	69	80	0.8625000
NODE_5676_length_1055_cov_15.744770	525	605	0	80	80	1.0000000
NODE_5676_length_1055_cov_15.744770	578	658	0	80	80	1.0000000
NODE_5677_length_1055_cov_10.729079	335	415	0	45	80	0.5625000
NODE_5677_length_1055_cov_10.729079	335	415	2	35	80	0.4375000
NODE_5677_length_1055_cov_10.729079	388	468	2	48	80	0.6000000
NODE_5677_length_1055_cov_10.729079	388	468	4	32	80	0.4000000
NODE_5678_length_1055_cov_7.525105	575	655	0	25	80	0.3125000
NODE_5678_length_1055_cov_7.525105	575	655	4	55	80	0.6875000
NODE_5678_length_1055_cov_7.525105	628	708	0	78	80	0.9750000
NODE_5678_length_1055_cov_7.525105	628	708	4	2	80	0.0250000
NODE_5688_length_1054_cov_45.920419	371	451	0	75	80	0.9375000
NODE_5688_length_1054_cov_45.920419	371	451	2	5	80	0.0625000
NODE_5688_length_1054_cov_45.920419	424	505	0	22	81	0.2716049
NODE_5688_length_1054_cov_45.920419	424	505	2	59	81	0.7283950
NODE_5689_length_1054_cov_30.545550	499	578	0	23	79	0.2911392
NODE_5689_length_1054_cov_30.545550	499	578	2	56	79	0.7088608
NODE_5689_length_1054_cov_30.545550	552	631	0	23	79	0.2911392
NODE_5689_length_1054_cov_30.545550	552	631	2	56	79	0.7088608
NODE_5689_length_1054_cov_30.545550	627	707	0	19	80	0.2375000
NODE_5689_length_1054_cov_30.545550	627	707	2	61	80	0.7625000
NODE_5689_length_1054_cov_30.545550	680	760	0	72	80	0.9000000
NODE_5689_length_1054_cov_30.545550	680	760	2	8	80	0.1000000
NODE_5690_length_1054_cov_16.606283	347	427	2	24	80	0.3000000
NODE_5690_length_1054_cov_16.606283	347	427	3	56	80	0.7000000
NODE_5690_length_1054_cov_16.606283	400	480	0	16	80	0.2000000
NODE_5690_length_1054_cov_16.606283	400	480	2	17	80	0.2125000
NODE_5690_length_1054_cov_16.606283	400	480	3	47	80	0.5875000
NODE_5691_length_1054_cov_11.637696	244	316	0	72	72	1.0000000
NODE_5691_length_1054_cov_11.637696	312	392	0	80	80	1.0000000
NODE_5691_length_1054_cov_11.637696	365	445	0	80	80	1.0000000
NODE_5692_length_1054_cov_10.381152	493	573	0	80	80	1.0000000
NODE_5692_length_1054_cov_10.381152	546	626	0	80	80	1.0000000
NODE_5703_length_1053_cov_57.660377	445	527	0	82	82	1.0000000
NODE_5703_length_1053_cov_57.660377	500	580	0	32	80	0.4000000
NODE_5703_length_1053_cov_57.660377	500	580	3	48	80	0.6000000
NODE_5704_length_1053_cov_33.518868	329	409	0	80	80	1.0000000
NODE_5704_length_1053_cov_33.518868	382	462	0	80	80	1.0000000
NODE_5704_length_1053_cov_33.518868	458	538	0	80	80	1.0000000
NODE_5704_length_1053_cov_33.518868	511	591	0	80	80	1.0000000
NODE_5705_length_1053_cov_32.412998	375	455	0	80	80	1.0000000
NODE_5705_length_1053_cov_32.412998	428	508	0	80	80	1.0000000
NODE_5705_length_1053_cov_32.412998	504	584	0	22	80	0.2750000
NODE_5705_length_1053_cov_32.412998	504	584	2	9	80	0.1125000
NODE_5705_length_1053_cov_32.412998	504	584	4	49	80	0.6125000
NODE_5705_length_1053_cov_32.412998	557	637	4	80	80	1.0000000
NODE_5706_length_1053_cov_26.545073	456	536	0	33	80	0.4125000
NODE_5706_length_1053_cov_26.545073	456	536	5	2	80	0.0250000
NODE_5706_length_1053_cov_26.545073	456	536	6	45	80	0.5625000
NODE_5706_length_1053_cov_26.545073	509	589	6	80	80	1.0000000
NODE_5706_length_1053_cov_26.545073	585	665	0	52	80	0.6500000
NODE_5706_length_1053_cov_26.545073	585	665	3	1	80	0.0125000
NODE_5706_length_1053_cov_26.545073	585	665	6	27	80	0.3375000
NODE_5706_length_1053_cov_26.545073	638	718	0	80	80	1.0000000
NODE_5707_length_1053_cov_20.346960	543	623	0	38	80	0.4750000
NODE_5707_length_1053_cov_20.346960	543	623	2	6	80	0.0750000
NODE_5707_length_1053_cov_20.346960	543	623	4	36	80	0.4500000
NODE_5707_length_1053_cov_20.346960	596	677	4	81	81	1.0000000
NODE_5708_length_1053_cov_11.655136	393	473	4	26	80	0.3250000
NODE_5708_length_1053_cov_11.655136	393	473	6	54	80	0.6750000
NODE_5708_length_1053_cov_11.655136	446	526	0	9	80	0.1125000
NODE_5708_length_1053_cov_11.655136	446	526	2	40	80	0.5000000
NODE_5708_length_1053_cov_11.655136	446	526	6	31	80	0.3875000
NODE_5710_length_1053_cov_4.771488	84	149	0	8	65	0.1230769
NODE_5710_length_1053_cov_4.771488	84	149	2	57	65	0.8769231
NODE_5718_length_1052_cov_18.469045	448	528	0	80	80	1.0000000
NODE_5718_length_1052_cov_18.469045	501	581	0	80	80	1.0000000
NODE_5719_length_1052_cov_13.136411	425	505	0	80	80	1.0000000
NODE_5719_length_1052_cov_13.136411	478	558	0	80	80	1.0000000
NODE_5722_length_1052_cov_3.082896	607	687	0	80	80	1.0000000
NODE_5722_length_1052_cov_3.082896	660	740	0	80	80	1.0000000
NODE_5729_length_1051_cov_34.868697	472	552	0	4	80	0.0500000
NODE_5729_length_1051_cov_34.868697	472	552	2	24	80	0.3000000
NODE_5729_length_1051_cov_34.868697	472	552	12	52	80	0.6500000
NODE_5729_length_1051_cov_34.868697	525	605	12	80	80	1.0000000
NODE_5730_length_1051_cov_19.446429	549	629	0	51	80	0.6375000
NODE_5730_length_1051_cov_19.446429	549	629	2	29	80	0.3625000
NODE_5730_length_1051_cov_19.446429	602	682	0	14	80	0.1750000
NODE_5730_length_1051_cov_19.446429	602	682	2	66	80	0.8250000
NODE_5731_length_1051_cov_4.022059	600	680	0	80	80	1.0000000
NODE_5736_length_1050_cov_31.556257	429	509	0	37	80	0.4625000
NODE_5736_length_1050_cov_31.556257	429	509	4	43	80	0.5375000
NODE_5736_length_1050_cov_31.556257	482	562	0	17	80	0.2125000
NODE_5736_length_1050_cov_31.556257	482	562	4	63	80	0.7875000
NODE_5736_length_1050_cov_31.556257	558	638	0	80	80	1.0000000
NODE_5736_length_1050_cov_31.556257	611	691	0	80	80	1.0000000
NODE_5737_length_1050_cov_16.337539	398	478	0	80	80	1.0000000
NODE_5737_length_1050_cov_16.337539	451	531	0	80	80	1.0000000
NODE_5738_length_1050_cov_13.290221	507	587	2	33	80	0.4125000
NODE_5738_length_1050_cov_13.290221	507	587	4	47	80	0.5875000
NODE_5738_length_1050_cov_13.290221	560	640	2	16	80	0.2000000
NODE_5738_length_1050_cov_13.290221	560	640	3	21	80	0.2625000
NODE_5738_length_1050_cov_13.290221	560	640	4	43	80	0.5375000
NODE_5739_length_1050_cov_11.389064	532	612	0	36	80	0.4500000
NODE_5739_length_1050_cov_11.389064	532	612	2	44	80	0.5500000
NODE_5739_length_1050_cov_11.389064	585	665	0	14	80	0.1750000
NODE_5739_length_1050_cov_11.389064	585	665	2	66	80	0.8250000
NODE_5740_length_1050_cov_11.091483	259	321	2	61	62	0.9838710
NODE_5740_length_1050_cov_11.091483	259	321	9	1	62	0.0161290
NODE_5740_length_1050_cov_11.091483	294	374	2	26	80	0.3250000
NODE_5740_length_1050_cov_11.091483	294	374	8	35	80	0.4375000
NODE_5740_length_1050_cov_11.091483	294	374	9	7	80	0.0875000
NODE_5740_length_1050_cov_11.091483	294	374	10	12	80	0.1500000
NODE_5740_length_1050_cov_11.091483	370	450	9	20	80	0.2500000
NODE_5740_length_1050_cov_11.091483	370	450	10	60	80	0.7500000
NODE_5740_length_1050_cov_11.091483	423	503	2	52	80	0.6500000
NODE_5740_length_1050_cov_11.091483	423	503	10	28	80	0.3500000
NODE_5742_length_1050_cov_2.201893	928	990	10	2	62	0.0322581
NODE_5742_length_1050_cov_2.201893	928	990	12	32	62	0.5161290
NODE_5742_length_1050_cov_2.201893	928	990	16	28	62	0.4516129
NODE_5742_length_1050_cov_2.201893	981	1043	6	9	62	0.1451613
NODE_5742_length_1050_cov_2.201893	981	1043	8	5	62	0.0806452
NODE_5742_length_1050_cov_2.201893	981	1043	12	16	62	0.2580645
NODE_5742_length_1050_cov_2.201893	981	1043	13	1	62	0.0161290
NODE_5742_length_1050_cov_2.201893	981	1043	15	8	62	0.1290323
NODE_5742_length_1050_cov_2.201893	981	1043	16	23	62	0.3709677
NODE_5748_length_1050_cov_1.241851	935	990	20	9	55	0.1636364
NODE_5748_length_1050_cov_1.241851	935	990	26	2	55	0.0363636
NODE_5748_length_1050_cov_1.241851	935	990	28	4	55	0.0727273
NODE_5748_length_1050_cov_1.241851	935	990	32	1	55	0.0181818
NODE_5748_length_1050_cov_1.241851	935	990	34	4	55	0.0727273
NODE_5748_length_1050_cov_1.241851	935	990	38	7	55	0.1272727
NODE_5748_length_1050_cov_1.241851	935	990	40	1	55	0.0181818
NODE_5748_length_1050_cov_1.241851	935	990	42	11	55	0.2000000
NODE_5748_length_1050_cov_1.241851	935	990	44	16	55	0.2909091
NODE_5748_length_1050_cov_1.241851	956	1036	22	3	80	0.0375000
NODE_5748_length_1050_cov_1.241851	956	1036	24	1	80	0.0125000
NODE_5748_length_1050_cov_1.241851	956	1036	26	1	80	0.0125000
NODE_5748_length_1050_cov_1.241851	956	1036	28	1	80	0.0125000
NODE_5748_length_1050_cov_1.241851	956	1036	30	2	80	0.0250000
NODE_5748_length_1050_cov_1.241851	956	1036	34	2	80	0.0250000
NODE_5748_length_1050_cov_1.241851	956	1036	38	7	80	0.0875000
NODE_5748_length_1050_cov_1.241851	956	1036	40	2	80	0.0250000
NODE_5748_length_1050_cov_1.241851	956	1036	42	16	80	0.2000000
NODE_5748_length_1050_cov_1.241851	956	1036	44	25	80	0.3125000
NODE_5748_length_1050_cov_1.241851	956	1036	46	12	80	0.1500000
NODE_5748_length_1050_cov_1.241851	956	1036	48	8	80	0.1000000
NODE_5752_length_1049_cov_28.174737	446	526	2	62	80	0.7750000
NODE_5752_length_1049_cov_28.174737	446	526	4	18	80	0.2250000
NODE_5752_length_1049_cov_28.174737	499	579	0	46	80	0.5750000
NODE_5752_length_1049_cov_28.174737	499	579	2	34	80	0.4250000
NODE_5753_length_1049_cov_23.186316	389	469	0	80	80	1.0000000
NODE_5753_length_1049_cov_23.186316	442	522	0	80	80	1.0000000
NODE_5753_length_1049_cov_23.186316	518	595	0	41	77	0.5324675
NODE_5753_length_1049_cov_23.186316	518	595	6	36	77	0.4675325
NODE_5753_length_1049_cov_23.186316	568	648	6	80	80	1.0000000
NODE_5754_length_1049_cov_21.097895	532	612	2	44	80	0.5500000
NODE_5754_length_1049_cov_21.097895	532	612	4	36	80	0.4500000
NODE_5754_length_1049_cov_21.097895	585	665	2	17	80	0.2125000
NODE_5754_length_1049_cov_21.097895	585	665	4	63	80	0.7875000
NODE_5755_length_1049_cov_18.964211	375	466	0	89	91	0.9780220
NODE_5755_length_1049_cov_18.964211	375	466	4	2	91	0.0219780
NODE_5755_length_1049_cov_18.964211	439	519	0	80	80	1.0000000
NODE_5755_length_1049_cov_18.964211	515	595	0	80	80	1.0000000
NODE_5755_length_1049_cov_18.964211	568	648	0	80	80	1.0000000
NODE_5756_length_1049_cov_18.075789	437	517	0	80	80	1.0000000
NODE_5756_length_1049_cov_18.075789	490	570	0	80	80	1.0000000
NODE_5756_length_1049_cov_18.075789	566	644	0	12	78	0.1538462
NODE_5756_length_1049_cov_18.075789	566	644	4	7	78	0.0897436
NODE_5756_length_1049_cov_18.075789	566	644	9	59	78	0.7564102
NODE_5756_length_1049_cov_18.075789	620	695	5	27	75	0.3600000
NODE_5756_length_1049_cov_18.075789	620	695	9	48	75	0.6400000
NODE_5757_length_1049_cov_16.194737	569	650	2	81	81	1.0000000
NODE_5757_length_1049_cov_16.194737	623	703	0	37	80	0.4625000
NODE_5757_length_1049_cov_16.194737	623	703	2	43	80	0.5375000
NODE_5757_length_1049_cov_16.194737	699	779	0	43	80	0.5375000
NODE_5757_length_1049_cov_16.194737	699	779	2	37	80	0.4625000
NODE_5757_length_1049_cov_16.194737	752	832	2	80	80	1.0000000
NODE_5759_length_1049_cov_6.323158	588	668	0	80	80	1.0000000
NODE_5759_length_1049_cov_6.323158	641	721	0	80	80	1.0000000
NODE_5770_length_1048_cov_73.887250	535	615	0	80	80	1.0000000
NODE_5770_length_1048_cov_73.887250	588	668	0	59	80	0.7375000
NODE_5770_length_1048_cov_73.887250	588	668	2	21	80	0.2625000
NODE_5770_length_1048_cov_73.887250	664	744	2	12	80	0.1500000
NODE_5770_length_1048_cov_73.887250	664	744	4	68	80	0.8500000
NODE_5770_length_1048_cov_73.887250	717	797	0	45	80	0.5625000
NODE_5770_length_1048_cov_73.887250	717	797	2	4	80	0.0500000
NODE_5770_length_1048_cov_73.887250	717	797	4	31	80	0.3875000
NODE_5770_length_1048_cov_73.887250	899	979	0	80	80	1.0000000
NODE_5771_length_1048_cov_48.242360	407	487	0	16	80	0.2000000
NODE_5771_length_1048_cov_48.242360	407	487	4	64	80	0.8000000
NODE_5771_length_1048_cov_48.242360	460	540	0	69	80	0.8625000
NODE_5771_length_1048_cov_48.242360	460	540	4	11	80	0.1375000
NODE_5771_length_1048_cov_48.242360	536	616	0	80	80	1.0000000
NODE_5771_length_1048_cov_48.242360	589	669	0	80	80	1.0000000
NODE_5772_length_1048_cov_38.430980	352	432	0	80	80	1.0000000
NODE_5772_length_1048_cov_38.430980	405	485	0	80	80	1.0000000
NODE_5773_length_1048_cov_28.179136	548	628	2	8	80	0.1000000
NODE_5773_length_1048_cov_28.179136	548	628	4	34	80	0.4250000
NODE_5773_length_1048_cov_28.179136	548	628	6	38	80	0.4750000
NODE_5773_length_1048_cov_28.179136	601	681	2	61	80	0.7625000
NODE_5773_length_1048_cov_28.179136	601	681	6	19	80	0.2375000
NODE_5773_length_1048_cov_28.179136	677	757	0	6	80	0.0750000
NODE_5773_length_1048_cov_28.179136	677	757	2	74	80	0.9250000
NODE_5773_length_1048_cov_28.179136	730	810	0	54	80	0.6750000
NODE_5773_length_1048_cov_28.179136	730	810	2	26	80	0.3250000
NODE_5774_length_1048_cov_22.985248	409	489	0	80	80	1.0000000
NODE_5774_length_1048_cov_22.985248	462	542	0	80	80	1.0000000
NODE_5774_length_1048_cov_22.985248	538	618	0	80	80	1.0000000
NODE_5774_length_1048_cov_22.985248	591	671	0	80	80	1.0000000
NODE_5775_length_1048_cov_17.883035	500	580	0	80	80	1.0000000
NODE_5775_length_1048_cov_17.883035	553	633	0	80	80	1.0000000
NODE_5776_length_1048_cov_17.444679	377	457	0	1	80	0.0125000
NODE_5776_length_1048_cov_17.444679	377	457	2	79	80	0.9875000
NODE_5776_length_1048_cov_17.444679	430	510	0	54	80	0.6750000
NODE_5776_length_1048_cov_17.444679	430	510	2	26	80	0.3250000
NODE_5777_length_1048_cov_13.387777	518	598	0	43	80	0.5375000
NODE_5777_length_1048_cov_13.387777	518	598	4	37	80	0.4625000
NODE_5777_length_1048_cov_13.387777	571	651	0	7	80	0.0875000
NODE_5777_length_1048_cov_13.387777	571	651	3	2	80	0.0250000
NODE_5777_length_1048_cov_13.387777	571	651	4	71	80	0.8875000
NODE_5778_length_1048_cov_12.934668	716	796	0	80	80	1.0000000
NODE_5778_length_1048_cov_12.934668	769	849	0	80	80	1.0000000
NODE_5778_length_1048_cov_12.934668	845	925	0	80	80	1.0000000
NODE_5778_length_1048_cov_12.934668	898	975	0	77	77	1.0000000
NODE_5779_length_1048_cov_12.712329	330	410	0	80	80	1.0000000
NODE_5779_length_1048_cov_12.712329	384	463	0	79	79	1.0000000
NODE_5779_length_1048_cov_12.712329	459	539	0	80	80	1.0000000
NODE_5779_length_1048_cov_12.712329	512	592	0	80	80	1.0000000
NODE_5780_length_1048_cov_9.232877	305	355	0	50	50	1.0000000
NODE_5786_length_1047_cov_79.917722	540	620	35	13	80	0.1625000
NODE_5786_length_1047_cov_79.917722	540	620	40	7	80	0.0875000
NODE_5786_length_1047_cov_79.917722	540	620	41	13	80	0.1625000
NODE_5786_length_1047_cov_79.917722	540	620	42	9	80	0.1125000
NODE_5786_length_1047_cov_79.917722	540	620	43	9	80	0.1125000
NODE_5786_length_1047_cov_79.917722	540	620	44	29	80	0.3625000
NODE_5786_length_1047_cov_79.917722	593	673	22	8	80	0.1000000
NODE_5786_length_1047_cov_79.917722	593	673	44	72	80	0.9000000
NODE_5787_length_1047_cov_28.527426	582	662	2	80	80	1.0000000
NODE_5787_length_1047_cov_28.527426	635	715	0	36	80	0.4500000
NODE_5787_length_1047_cov_28.527426	635	715	2	44	80	0.5500000
NODE_5788_length_1047_cov_26.068565	372	452	0	80	80	1.0000000
NODE_5788_length_1047_cov_26.068565	425	505	0	80	80	1.0000000
NODE_5789_length_1047_cov_25.946203	424	504	4	66	80	0.8250000
NODE_5789_length_1047_cov_25.946203	424	504	6	14	80	0.1750000
NODE_5789_length_1047_cov_25.946203	477	557	2	36	80	0.4500000
NODE_5789_length_1047_cov_25.946203	477	557	4	34	80	0.4250000
NODE_5789_length_1047_cov_25.946203	477	557	6	10	80	0.1250000
NODE_5790_length_1047_cov_19.255274	458	538	0	20	80	0.2500000
NODE_5790_length_1047_cov_19.255274	458	538	2	60	80	0.7500000
NODE_5790_length_1047_cov_19.255274	511	591	2	80	80	1.0000000
NODE_5791_length_1047_cov_16.618143	467	547	0	21	80	0.2625000
NODE_5791_length_1047_cov_16.618143	467	547	4	59	80	0.7375000
NODE_5791_length_1047_cov_16.618143	520	600	0	34	80	0.4250000
NODE_5791_length_1047_cov_16.618143	520	600	4	46	80	0.5750000
NODE_5792_length_1047_cov_14.246835	643	723	0	80	80	1.0000000
NODE_5792_length_1047_cov_14.246835	696	776	0	80	80	1.0000000
NODE_5793_length_1047_cov_9.869198	414	494	0	8	80	0.1000000
NODE_5793_length_1047_cov_9.869198	414	494	8	9	80	0.1125000
NODE_5793_length_1047_cov_9.869198	414	494	12	29	80	0.3625000
NODE_5793_length_1047_cov_9.869198	414	494	13	5	80	0.0625000
NODE_5793_length_1047_cov_9.869198	414	494	14	1	80	0.0125000
NODE_5793_length_1047_cov_9.869198	414	494	16	28	80	0.3500000
NODE_5793_length_1047_cov_9.869198	467	547	2	12	80	0.1500000
NODE_5793_length_1047_cov_9.869198	467	547	6	14	80	0.1750000
NODE_5793_length_1047_cov_9.869198	467	547	16	54	80	0.6750000
NODE_5794_length_1047_cov_8.513713	300	380	0	80	80	1.0000000
NODE_5794_length_1047_cov_8.513713	353	433	0	80	80	1.0000000
NODE_5795_length_1047_cov_7.412447	442	522	0	30	80	0.3750000
NODE_5795_length_1047_cov_7.412447	442	522	4	3	80	0.0375000
NODE_5795_length_1047_cov_7.412447	442	522	6	47	80	0.5875000
NODE_5795_length_1047_cov_7.412447	495	575	2	2	80	0.0250000
NODE_5795_length_1047_cov_7.412447	495	575	6	78	80	0.9750000
NODE_5803_length_1046_cov_41.392819	587	667	0	80	80	1.0000000
NODE_5803_length_1046_cov_41.392819	640	720	0	80	80	1.0000000
NODE_5804_length_1046_cov_30.317846	382	462	0	39	80	0.4875000
NODE_5804_length_1046_cov_30.317846	382	462	4	41	80	0.5125000
NODE_5804_length_1046_cov_30.317846	435	515	0	8	80	0.1000000
NODE_5804_length_1046_cov_30.317846	435	515	4	72	80	0.9000000
NODE_5805_length_1046_cov_28.184794	346	426	6	4	80	0.0500000
NODE_5805_length_1046_cov_28.184794	346	426	8	6	80	0.0750000
NODE_5805_length_1046_cov_28.184794	346	426	9	61	80	0.7625000
NODE_5805_length_1046_cov_28.184794	346	426	10	9	80	0.1125000
NODE_5805_length_1046_cov_28.184794	399	479	4	41	80	0.5125000
NODE_5805_length_1046_cov_28.184794	399	479	6	1	80	0.0125000
NODE_5805_length_1046_cov_28.184794	399	479	7	2	80	0.0250000
NODE_5805_length_1046_cov_28.184794	399	479	8	15	80	0.1875000
NODE_5805_length_1046_cov_28.184794	399	479	9	12	80	0.1500000
NODE_5805_length_1046_cov_28.184794	399	479	10	9	80	0.1125000
NODE_5806_length_1046_cov_24.595565	501	581	0	40	80	0.5000000
NODE_5806_length_1046_cov_24.595565	501	581	4	40	80	0.5000000
NODE_5806_length_1046_cov_24.595565	554	634	0	11	80	0.1375000
NODE_5806_length_1046_cov_24.595565	554	634	3	16	80	0.2000000
NODE_5806_length_1046_cov_24.595565	554	634	4	53	80	0.6625000
NODE_5807_length_1046_cov_17.958817	447	527	10	17	80	0.2125000
NODE_5807_length_1046_cov_17.958817	447	527	12	63	80	0.7875000
NODE_5807_length_1046_cov_17.958817	500	580	5	33	80	0.4125000
NODE_5807_length_1046_cov_17.958817	500	580	9	1	80	0.0125000
NODE_5807_length_1046_cov_17.958817	500	580	10	10	80	0.1250000
NODE_5807_length_1046_cov_17.958817	500	580	12	36	80	0.4500000
NODE_5808_length_1046_cov_15.494192	385	465	4	80	80	1.0000000
NODE_5808_length_1046_cov_15.494192	438	518	0	2	80	0.0250000
NODE_5808_length_1046_cov_15.494192	438	518	4	78	80	0.9750000
NODE_5809_length_1046_cov_12.639916	554	634	0	80	80	1.0000000
NODE_5809_length_1046_cov_12.639916	607	687	0	80	80	1.0000000
NODE_5810_length_1046_cov_11.238648	471	551	0	46	80	0.5750000
NODE_5810_length_1046_cov_11.238648	471	551	2	34	80	0.4250000
NODE_5810_length_1046_cov_11.238648	524	604	2	80	80	1.0000000
NODE_5811_length_1046_cov_10.744456	459	539	0	2	80	0.0250000
NODE_5811_length_1046_cov_10.744456	459	539	2	78	80	0.9750000
NODE_5811_length_1046_cov_10.744456	512	592	2	80	80	1.0000000
NODE_5812_length_1046_cov_8.689546	302	382	0	80	80	1.0000000
NODE_5812_length_1046_cov_8.689546	355	435	0	80	80	1.0000000
NODE_5823_length_1045_cov_75.975687	359	440	0	13	81	0.1604938
NODE_5823_length_1045_cov_75.975687	359	440	2	68	81	0.8395061
NODE_5823_length_1045_cov_75.975687	412	493	0	66	81	0.8148148
NODE_5823_length_1045_cov_75.975687	412	493	2	15	81	0.1851852
NODE_5823_length_1045_cov_75.975687	489	569	0	80	80	1.0000000
NODE_5823_length_1045_cov_75.975687	542	622	0	80	80	1.0000000
NODE_5824_length_1045_cov_54.419662	434	514	0	80	80	1.0000000
NODE_5824_length_1045_cov_54.419662	487	567	0	80	80	1.0000000
NODE_5824_length_1045_cov_54.419662	563	639	0	76	76	1.0000000
NODE_5824_length_1045_cov_54.419662	616	696	0	33	80	0.4125000
NODE_5824_length_1045_cov_54.419662	616	696	4	47	80	0.5875000
NODE_5825_length_1045_cov_23.188161	395	475	2	80	80	1.0000000
NODE_5825_length_1045_cov_23.188161	448	528	2	71	80	0.8875000
NODE_5825_length_1045_cov_23.188161	448	528	4	9	80	0.1125000
NODE_5826_length_1045_cov_19.686047	571	651	0	80	80	1.0000000
NODE_5826_length_1045_cov_19.686047	624	704	0	80	80	1.0000000
NODE_5827_length_1045_cov_19.378436	478	558	0	80	80	1.0000000
NODE_5827_length_1045_cov_19.378436	531	611	0	44	80	0.5500000
NODE_5827_length_1045_cov_19.378436	531	611	2	36	80	0.4500000
NODE_5828_length_1045_cov_17.601480	359	439	0	80	80	1.0000000
NODE_5828_length_1045_cov_17.601480	412	492	0	80	80	1.0000000
NODE_5829_length_1045_cov_17.372093	633	713	0	2	80	0.0250000
NODE_5829_length_1045_cov_17.372093	633	713	2	78	80	0.9750000
NODE_5829_length_1045_cov_17.372093	686	766	0	2	80	0.0250000
NODE_5829_length_1045_cov_17.372093	686	766	2	78	80	0.9750000
NODE_5830_length_1045_cov_14.828753	433	513	4	80	80	1.0000000
NODE_5830_length_1045_cov_14.828753	486	566	0	29	80	0.3625000
NODE_5830_length_1045_cov_14.828753	486	566	2	3	80	0.0375000
NODE_5830_length_1045_cov_14.828753	486	566	4	48	80	0.6000000
NODE_5831_length_1045_cov_11.673362	664	744	0	80	80	1.0000000
NODE_5831_length_1045_cov_11.673362	717	797	0	80	80	1.0000000
NODE_5843_length_1044_cov_42.600000	344	424	0	14	80	0.1750000
NODE_5843_length_1044_cov_42.600000	344	424	3	18	80	0.2250000
NODE_5843_length_1044_cov_42.600000	344	424	6	48	80	0.6000000
NODE_5843_length_1044_cov_42.600000	397	477	6	80	80	1.0000000
NODE_5844_length_1044_cov_27.653968	454	534	0	80	80	1.0000000
NODE_5844_length_1044_cov_27.653968	507	587	0	80	80	1.0000000
NODE_5845_length_1044_cov_24.561905	297	375	0	78	78	1.0000000
NODE_5845_length_1044_cov_24.561905	348	428	0	80	80	1.0000000
NODE_5845_length_1044_cov_24.561905	424	504	0	80	80	1.0000000
NODE_5845_length_1044_cov_24.561905	477	557	0	32	80	0.4000000
NODE_5845_length_1044_cov_24.561905	477	557	2	48	80	0.6000000
NODE_5846_length_1044_cov_23.720635	294	374	0	80	80	1.0000000
NODE_5846_length_1044_cov_23.720635	347	427	0	80	80	1.0000000
NODE_5846_length_1044_cov_23.720635	423	503	0	10	80	0.1250000
NODE_5846_length_1044_cov_23.720635	423	503	12	6	80	0.0750000
NODE_5846_length_1044_cov_23.720635	423	503	14	64	80	0.8000000
NODE_5846_length_1044_cov_23.720635	476	556	0	1	80	0.0125000
NODE_5846_length_1044_cov_23.720635	476	556	12	39	80	0.4875000
NODE_5846_length_1044_cov_23.720635	476	556	14	40	80	0.5000000
NODE_5847_length_1044_cov_20.871958	462	542	0	80	80	1.0000000
NODE_5847_length_1044_cov_20.871958	515	595	0	80	80	1.0000000
NODE_5847_length_1044_cov_20.871958	591	671	0	80	80	1.0000000
NODE_5847_length_1044_cov_20.871958	644	724	0	80	80	1.0000000
NODE_5848_length_1044_cov_18.596825	433	513	0	80	80	1.0000000
NODE_5848_length_1044_cov_18.596825	486	566	0	80	80	1.0000000
NODE_5849_length_1044_cov_16.102646	414	494	0	80	80	1.0000000
NODE_5849_length_1044_cov_16.102646	467	547	0	80	80	1.0000000
NODE_5850_length_1044_cov_12.156614	578	658	0	80	80	1.0000000
NODE_5850_length_1044_cov_12.156614	631	711	0	80	80	1.0000000
NODE_5851_length_1044_cov_10.661376	506	586	0	80	80	1.0000000
NODE_5851_length_1044_cov_10.661376	559	639	0	80	80	1.0000000
NODE_5852_length_1044_cov_9.534392	461	541	0	80	80	1.0000000
NODE_5852_length_1044_cov_9.534392	514	594	0	80	80	1.0000000
NODE_5853_length_1044_cov_5.517460	434	514	0	80	80	1.0000000
NODE_5853_length_1044_cov_5.517460	487	567	0	80	80	1.0000000
NODE_5856_length_1044_cov_1.502646	769	845	0	63	76	0.8289474
NODE_5856_length_1044_cov_1.502646	769	845	2	13	76	0.1710526
NODE_5860_length_1043_cov_42.288136	452	532	0	60	80	0.7500000
NODE_5860_length_1043_cov_42.288136	452	532	2	20	80	0.2500000
NODE_5860_length_1043_cov_42.288136	505	585	0	11	80	0.1375000
NODE_5860_length_1043_cov_42.288136	505	585	2	69	80	0.8625000
NODE_5861_length_1043_cov_25.987288	350	430	0	45	80	0.5625000
NODE_5861_length_1043_cov_25.987288	350	430	2	20	80	0.2500000
NODE_5861_length_1043_cov_25.987288	350	430	4	15	80	0.1875000
NODE_5861_length_1043_cov_25.987288	403	483	2	12	80	0.1500000
NODE_5861_length_1043_cov_25.987288	403	483	4	39	80	0.4875000
NODE_5861_length_1043_cov_25.987288	403	483	6	29	80	0.3625000
NODE_5861_length_1043_cov_25.987288	479	559	2	8	80	0.1000000
NODE_5861_length_1043_cov_25.987288	479	559	4	41	80	0.5125000
NODE_5861_length_1043_cov_25.987288	479	559	6	31	80	0.3875000
NODE_5861_length_1043_cov_25.987288	532	612	4	64	80	0.8000000
NODE_5861_length_1043_cov_25.987288	532	612	6	16	80	0.2000000
NODE_5862_length_1043_cov_20.838983	561	641	0	80	80	1.0000000
NODE_5862_length_1043_cov_20.838983	614	694	0	80	80	1.0000000
NODE_5863_length_1043_cov_20.312500	489	569	0	54	80	0.6750000
NODE_5863_length_1043_cov_20.312500	489	569	2	10	80	0.1250000
NODE_5863_length_1043_cov_20.312500	489	569	4	16	80	0.2000000
NODE_5863_length_1043_cov_20.312500	542	622	0	1	80	0.0125000
NODE_5863_length_1043_cov_20.312500	542	622	2	10	80	0.1250000
NODE_5863_length_1043_cov_20.312500	542	622	4	69	80	0.8625000
NODE_5864_length_1043_cov_16.320975	569	649	6	31	80	0.3875000
NODE_5864_length_1043_cov_16.320975	569	649	7	9	80	0.1125000
NODE_5864_length_1043_cov_16.320975	569	649	10	40	80	0.5000000
NODE_5864_length_1043_cov_16.320975	622	702	0	23	80	0.2875000
NODE_5864_length_1043_cov_16.320975	622	702	3	2	80	0.0250000
NODE_5864_length_1043_cov_16.320975	622	702	7	37	80	0.4625000
NODE_5864_length_1043_cov_16.320975	622	702	10	18	80	0.2250000
NODE_5865_length_1043_cov_11.176907	521	601	0	80	80	1.0000000
NODE_5865_length_1043_cov_11.176907	574	654	0	80	80	1.0000000
NODE_5866_length_1043_cov_8.146186	530	596	0	66	66	1.0000000
NODE_5866_length_1043_cov_8.146186	569	649	0	80	80	1.0000000
NODE_5868_length_1043_cov_5.347458	646	726	0	8	80	0.1000000
NODE_5868_length_1043_cov_5.347458	646	726	1	17	80	0.2125000
NODE_5868_length_1043_cov_5.347458	646	726	2	47	80	0.5875000
NODE_5868_length_1043_cov_5.347458	646	726	3	8	80	0.1000000
NODE_5868_length_1043_cov_5.347458	699	779	0	61	80	0.7625000
NODE_5868_length_1043_cov_5.347458	699	779	1	17	80	0.2125000
NODE_5868_length_1043_cov_5.347458	699	779	2	2	80	0.0250000
NODE_5879_length_1042_cov_242.728526	820	900	343	1	80	0.0125000
NODE_5879_length_1042_cov_242.728526	820	900	345	1	80	0.0125000
NODE_5879_length_1042_cov_242.728526	820	900	348	1	80	0.0125000
NODE_5879_length_1042_cov_242.728526	820	900	349	1	80	0.0125000
NODE_5879_length_1042_cov_242.728526	820	900	351	1	80	0.0125000
NODE_5879_length_1042_cov_242.728526	820	900	353	2	80	0.0250000
NODE_5879_length_1042_cov_242.728526	820	900	360	1	80	0.0125000
NODE_5879_length_1042_cov_242.728526	820	900	362	1	80	0.0125000
NODE_5879_length_1042_cov_242.728526	820	900	364	1	80	0.0125000
NODE_5879_length_1042_cov_242.728526	820	900	369	1	80	0.0125000
NODE_5879_length_1042_cov_242.728526	820	900	373	1	80	0.0125000
NODE_5879_length_1042_cov_242.728526	820	900	390	1	80	0.0125000
NODE_5879_length_1042_cov_242.728526	820	900	393	1	80	0.0125000
NODE_5879_length_1042_cov_242.728526	820	900	415	1	80	0.0125000
NODE_5879_length_1042_cov_242.728526	820	900	418	1	80	0.0125000
NODE_5879_length_1042_cov_242.728526	820	900	419	1	80	0.0125000
NODE_5879_length_1042_cov_242.728526	820	900	422	1	80	0.0125000
NODE_5879_length_1042_cov_242.728526	820	900	423	1	80	0.0125000
NODE_5879_length_1042_cov_242.728526	820	900	425	1	80	0.0125000
NODE_5879_length_1042_cov_242.728526	820	900	427	1	80	0.0125000
NODE_5879_length_1042_cov_242.728526	820	900	429	1	80	0.0125000
NODE_5879_length_1042_cov_242.728526	820	900	431	1	80	0.0125000
NODE_5879_length_1042_cov_242.728526	820	900	432	1	80	0.0125000
NODE_5879_length_1042_cov_242.728526	820	900	435	1	80	0.0125000
NODE_5879_length_1042_cov_242.728526	820	900	436	1	80	0.0125000
NODE_5879_length_1042_cov_242.728526	820	900	446	2	80	0.0250000
NODE_5879_length_1042_cov_242.728526	820	900	447	1	80	0.0125000
NODE_5879_length_1042_cov_242.728526	820	900	448	1	80	0.0125000
NODE_5879_length_1042_cov_242.728526	820	900	449	1	80	0.0125000
NODE_5879_length_1042_cov_242.728526	820	900	450	2	80	0.0250000
NODE_5879_length_1042_cov_242.728526	820	900	451	1	80	0.0125000
NODE_5879_length_1042_cov_242.728526	820	900	455	1	80	0.0125000
NODE_5879_length_1042_cov_242.728526	820	900	464	1	80	0.0125000
NODE_5879_length_1042_cov_242.728526	820	900	467	1	80	0.0125000
NODE_5879_length_1042_cov_242.728526	820	900	468	2	80	0.0250000
NODE_5879_length_1042_cov_242.728526	820	900	470	1	80	0.0125000
NODE_5879_length_1042_cov_242.728526	820	900	472	1	80	0.0125000
NODE_5879_length_1042_cov_242.728526	820	900	475	2	80	0.0250000
NODE_5879_length_1042_cov_242.728526	820	900	477	1	80	0.0125000
NODE_5879_length_1042_cov_242.728526	820	900	484	4	80	0.0500000
NODE_5879_length_1042_cov_242.728526	820	900	486	1	80	0.0125000
NODE_5879_length_1042_cov_242.728526	820	900	487	2	80	0.0250000
NODE_5879_length_1042_cov_242.728526	820	900	488	1	80	0.0125000
NODE_5879_length_1042_cov_242.728526	820	900	489	3	80	0.0375000
NODE_5879_length_1042_cov_242.728526	820	900	495	1	80	0.0125000
NODE_5879_length_1042_cov_242.728526	820	900	496	3	80	0.0375000
NODE_5879_length_1042_cov_242.728526	820	900	498	1	80	0.0125000
NODE_5879_length_1042_cov_242.728526	820	900	505	3	80	0.0375000
NODE_5879_length_1042_cov_242.728526	820	900	507	3	80	0.0375000
NODE_5879_length_1042_cov_242.728526	820	900	508	2	80	0.0250000
NODE_5879_length_1042_cov_242.728526	820	900	522	1	80	0.0125000
NODE_5879_length_1042_cov_242.728526	820	900	524	1	80	0.0125000
NODE_5879_length_1042_cov_242.728526	820	900	525	2	80	0.0250000
NODE_5879_length_1042_cov_242.728526	820	900	528	2	80	0.0250000
NODE_5879_length_1042_cov_242.728526	820	900	529	1	80	0.0125000
NODE_5879_length_1042_cov_242.728526	820	900	530	2	80	0.0250000
NODE_5879_length_1042_cov_242.728526	820	900	532	1	80	0.0125000
NODE_5879_length_1042_cov_242.728526	820	900	534	2	80	0.0250000
NODE_5879_length_1042_cov_242.728526	873	903	486	1	30	0.0333333
NODE_5879_length_1042_cov_242.728526	873	903	487	1	30	0.0333333
NODE_5879_length_1042_cov_242.728526	873	903	495	1	30	0.0333333
NODE_5879_length_1042_cov_242.728526	873	903	496	3	30	0.1000000
NODE_5879_length_1042_cov_242.728526	873	903	498	1	30	0.0333333
NODE_5879_length_1042_cov_242.728526	873	903	505	3	30	0.1000000
NODE_5879_length_1042_cov_242.728526	873	903	507	3	30	0.1000000
NODE_5879_length_1042_cov_242.728526	873	903	508	2	30	0.0666667
NODE_5879_length_1042_cov_242.728526	873	903	522	1	30	0.0333333
NODE_5879_length_1042_cov_242.728526	873	903	524	1	30	0.0333333
NODE_5879_length_1042_cov_242.728526	873	903	525	2	30	0.0666667
NODE_5879_length_1042_cov_242.728526	873	903	528	2	30	0.0666667
NODE_5879_length_1042_cov_242.728526	873	903	529	1	30	0.0333333
NODE_5879_length_1042_cov_242.728526	873	903	530	3	30	0.1000000
NODE_5879_length_1042_cov_242.728526	873	903	531	1	30	0.0333333
NODE_5879_length_1042_cov_242.728526	873	903	532	1	30	0.0333333
NODE_5879_length_1042_cov_242.728526	873	903	534	3	30	0.1000000
NODE_5880_length_1042_cov_63.214210	355	435	18	1	80	0.0125000
NODE_5880_length_1042_cov_63.214210	355	435	19	20	80	0.2500000
NODE_5880_length_1042_cov_63.214210	355	435	21	59	80	0.7375000
NODE_5880_length_1042_cov_63.214210	408	488	5	3	80	0.0375000
NODE_5880_length_1042_cov_63.214210	408	488	6	33	80	0.4125000
NODE_5880_length_1042_cov_63.214210	408	488	12	17	80	0.2125000
NODE_5880_length_1042_cov_63.214210	408	488	18	1	80	0.0125000
NODE_5880_length_1042_cov_63.214210	408	488	19	20	80	0.2500000
NODE_5880_length_1042_cov_63.214210	408	488	21	6	80	0.0750000
NODE_5881_length_1042_cov_29.581124	497	577	0	27	80	0.3375000
NODE_5881_length_1042_cov_29.581124	497	577	8	53	80	0.6625000
NODE_5881_length_1042_cov_29.581124	550	630	7	13	80	0.1625000
NODE_5881_length_1042_cov_29.581124	550	630	8	67	80	0.8375000
NODE_5882_length_1042_cov_23.861082	519	599	0	80	80	1.0000000
NODE_5882_length_1042_cov_23.861082	572	652	0	80	80	1.0000000
NODE_5882_length_1042_cov_23.861082	648	728	0	72	80	0.9000000
NODE_5882_length_1042_cov_23.861082	648	728	2	8	80	0.1000000
NODE_5882_length_1042_cov_23.861082	701	781	0	19	80	0.2375000
NODE_5882_length_1042_cov_23.861082	701	781	2	61	80	0.7625000
NODE_5883_length_1042_cov_22.247084	555	635	0	65	80	0.8125000
NODE_5883_length_1042_cov_22.247084	555	635	2	9	80	0.1125000
NODE_5883_length_1042_cov_22.247084	555	635	4	6	80	0.0750000
NODE_5883_length_1042_cov_22.247084	608	688	0	21	80	0.2625000
NODE_5883_length_1042_cov_22.247084	608	688	4	59	80	0.7375000
NODE_5884_length_1042_cov_22.117709	335	415	0	11	80	0.1375000
NODE_5884_length_1042_cov_22.117709	335	415	2	69	80	0.8625000
NODE_5884_length_1042_cov_22.117709	388	468	0	64	80	0.8000000
NODE_5884_length_1042_cov_22.117709	388	468	2	16	80	0.2000000
NODE_5884_length_1042_cov_22.117709	464	544	0	80	80	1.0000000
NODE_5884_length_1042_cov_22.117709	517	597	0	80	80	1.0000000
NODE_5885_length_1042_cov_16.831389	27	97	2	1	70	0.0142857
NODE_5885_length_1042_cov_16.831389	27	97	4	31	70	0.4428571
NODE_5885_length_1042_cov_16.831389	27	97	6	38	70	0.5428572
NODE_5885_length_1042_cov_16.831389	372	452	0	80	80	1.0000000
NODE_5885_length_1042_cov_16.831389	425	505	0	80	80	1.0000000
NODE_5886_length_1042_cov_16.662778	416	496	0	80	80	1.0000000
NODE_5886_length_1042_cov_16.662778	469	549	0	80	80	1.0000000
NODE_5887_length_1042_cov_9.474019	361	441	0	80	80	1.0000000
NODE_5887_length_1042_cov_9.474019	414	494	0	80	80	1.0000000
NODE_5888_length_1042_cov_6.725345	356	419	3	17	63	0.2698413
NODE_5888_length_1042_cov_6.725345	356	419	4	31	63	0.4920635
NODE_5888_length_1042_cov_6.725345	356	419	5	15	63	0.2380952
NODE_5888_length_1042_cov_6.725345	392	472	2	26	80	0.3250000
NODE_5888_length_1042_cov_6.725345	392	472	3	12	80	0.1500000
NODE_5888_length_1042_cov_6.725345	392	472	5	42	80	0.5250000
NODE_5896_length_1041_cov_42.960722	335	415	0	80	80	1.0000000
NODE_5896_length_1041_cov_42.960722	388	468	0	80	80	1.0000000
NODE_5896_length_1041_cov_42.960722	464	544	0	23	80	0.2875000
NODE_5896_length_1041_cov_42.960722	464	544	2	57	80	0.7125000
NODE_5896_length_1041_cov_42.960722	517	597	0	16	80	0.2000000
NODE_5896_length_1041_cov_42.960722	517	597	2	64	80	0.8000000
NODE_5897_length_1041_cov_37.331210	513	593	0	3	80	0.0375000
NODE_5897_length_1041_cov_37.331210	513	593	2	12	80	0.1500000
NODE_5897_length_1041_cov_37.331210	513	593	6	14	80	0.1750000
NODE_5897_length_1041_cov_37.331210	513	593	11	6	80	0.0750000
NODE_5897_length_1041_cov_37.331210	513	593	12	45	80	0.5625000
NODE_5897_length_1041_cov_37.331210	566	646	6	27	80	0.3375000
NODE_5897_length_1041_cov_37.331210	566	646	9	26	80	0.3250000
NODE_5897_length_1041_cov_37.331210	566	646	11	6	80	0.0750000
NODE_5897_length_1041_cov_37.331210	566	646	12	21	80	0.2625000
NODE_5897_length_1041_cov_37.331210	642	722	0	70	80	0.8750000
NODE_5897_length_1041_cov_37.331210	642	722	6	10	80	0.1250000
NODE_5897_length_1041_cov_37.331210	695	775	0	80	80	1.0000000
NODE_5898_length_1041_cov_36.477707	455	535	0	14	80	0.1750000
NODE_5898_length_1041_cov_36.477707	455	535	2	66	80	0.8250000
NODE_5898_length_1041_cov_36.477707	508	588	2	67	80	0.8375000
NODE_5898_length_1041_cov_36.477707	508	588	8	13	80	0.1625000
NODE_5898_length_1041_cov_36.477707	584	664	2	11	80	0.1375000
NODE_5898_length_1041_cov_36.477707	584	664	6	63	80	0.7875000
NODE_5898_length_1041_cov_36.477707	584	664	8	6	80	0.0750000
NODE_5898_length_1041_cov_36.477707	637	717	0	40	80	0.5000000
NODE_5898_length_1041_cov_36.477707	637	717	2	24	80	0.3000000
NODE_5898_length_1041_cov_36.477707	637	717	6	16	80	0.2000000
NODE_5898_length_1041_cov_36.477707	753	799	0	46	46	1.0000000
NODE_5899_length_1041_cov_19.286624	468	548	0	80	80	1.0000000
NODE_5899_length_1041_cov_19.286624	521	601	0	80	80	1.0000000
NODE_5900_length_1041_cov_17.072187	578	658	0	12	80	0.1500000
NODE_5900_length_1041_cov_17.072187	578	658	4	68	80	0.8500000
NODE_5900_length_1041_cov_17.072187	631	711	0	60	80	0.7500000
NODE_5900_length_1041_cov_17.072187	631	711	4	20	80	0.2500000
NODE_5901_length_1041_cov_11.887473	437	517	0	80	80	1.0000000
NODE_5901_length_1041_cov_11.887473	490	570	0	80	80	1.0000000
NODE_5902_length_1041_cov_6.957537	354	434	0	80	80	1.0000000
NODE_5902_length_1041_cov_6.957537	407	487	0	80	80	1.0000000
NODE_5913_length_1040_cov_34.618491	478	558	0	14	80	0.1750000
NODE_5913_length_1040_cov_34.618491	478	558	2	66	80	0.8250000
NODE_5913_length_1040_cov_34.618491	531	611	0	12	80	0.1500000
NODE_5913_length_1040_cov_34.618491	531	611	2	68	80	0.8500000
NODE_5914_length_1040_cov_33.061637	485	565	2	59	80	0.7375000
NODE_5914_length_1040_cov_33.061637	485	565	4	21	80	0.2625000
NODE_5914_length_1040_cov_33.061637	538	618	2	49	80	0.6125000
NODE_5914_length_1040_cov_33.061637	538	618	4	31	80	0.3875000
NODE_5915_length_1040_cov_27.818278	402	482	0	80	80	1.0000000
NODE_5915_length_1040_cov_27.818278	455	535	0	80	80	1.0000000
NODE_5916_length_1040_cov_17.933050	487	567	0	13	80	0.1625000
NODE_5916_length_1040_cov_17.933050	487	567	2	51	80	0.6375000
NODE_5916_length_1040_cov_17.933050	487	567	4	16	80	0.2000000
NODE_5916_length_1040_cov_17.933050	540	620	2	40	80	0.5000000
NODE_5916_length_1040_cov_17.933050	540	620	4	40	80	0.5000000
NODE_5917_length_1040_cov_14.327311	237	317	0	80	80	1.0000000
NODE_5917_length_1040_cov_14.327311	290	370	0	58	80	0.7250000
NODE_5917_length_1040_cov_14.327311	290	370	2	22	80	0.2750000
NODE_5917_length_1040_cov_14.327311	366	446	2	80	80	1.0000000
NODE_5917_length_1040_cov_14.327311	419	499	0	45	80	0.5625000
NODE_5917_length_1040_cov_14.327311	419	499	2	35	80	0.4375000
NODE_5918_length_1040_cov_11.910733	369	449	4	4	80	0.0500000
NODE_5918_length_1040_cov_11.910733	369	449	8	10	80	0.1250000
NODE_5918_length_1040_cov_11.910733	369	449	10	58	80	0.7250000
NODE_5918_length_1040_cov_11.910733	369	449	12	8	80	0.1000000
NODE_5918_length_1040_cov_11.910733	422	502	6	2	80	0.0250000
NODE_5918_length_1040_cov_11.910733	422	502	10	74	80	0.9250000
NODE_5918_length_1040_cov_11.910733	422	502	12	4	80	0.0500000
NODE_5919_length_1040_cov_11.521785	355	435	0	4	80	0.0500000
NODE_5919_length_1040_cov_11.521785	355	435	2	76	80	0.9500000
NODE_5919_length_1040_cov_11.521785	408	488	2	78	80	0.9750000
NODE_5919_length_1040_cov_11.521785	408	488	4	2	80	0.0250000
NODE_5920_length_1040_cov_9.573858	632	712	0	13	80	0.1625000
NODE_5920_length_1040_cov_9.573858	632	712	2	48	80	0.6000000
NODE_5920_length_1040_cov_9.573858	632	712	4	13	80	0.1625000
NODE_5920_length_1040_cov_9.573858	632	712	6	6	80	0.0750000
NODE_5920_length_1040_cov_9.573858	685	765	2	8	80	0.1000000
NODE_5920_length_1040_cov_9.573858	685	765	4	66	80	0.8250000
NODE_5920_length_1040_cov_9.573858	685	765	6	6	80	0.0750000
NODE_5921_length_1040_cov_8.148778	349	429	0	80	80	1.0000000
NODE_5921_length_1040_cov_8.148778	402	482	0	80	80	1.0000000
NODE_5922_length_1040_cov_7.927736	282	362	2	80	80	1.0000000
NODE_5922_length_1040_cov_7.927736	335	415	0	30	80	0.3750000
NODE_5922_length_1040_cov_7.927736	335	415	2	50	80	0.6250000
NODE_5927_length_1040_cov_2.317747	2	78	0	1	76	0.0131579
NODE_5927_length_1040_cov_2.317747	2	78	2	26	76	0.3421053
NODE_5927_length_1040_cov_2.317747	2	78	4	8	76	0.1052632
NODE_5927_length_1040_cov_2.317747	2	78	5	24	76	0.3157895
NODE_5927_length_1040_cov_2.317747	2	78	6	17	76	0.2236842
NODE_5934_length_1039_cov_40.150000	487	567	0	51	80	0.6375000
NODE_5934_length_1039_cov_40.150000	487	567	2	29	80	0.3625000
NODE_5934_length_1039_cov_40.150000	540	620	0	80	80	1.0000000
NODE_5934_length_1039_cov_40.150000	616	696	0	80	80	1.0000000
NODE_5934_length_1039_cov_40.150000	669	739	0	70	70	1.0000000
NODE_5935_length_1039_cov_37.940426	175	255	0	59	80	0.7375000
NODE_5935_length_1039_cov_37.940426	175	255	4	20	80	0.2500000
NODE_5935_length_1039_cov_37.940426	175	255	7	1	80	0.0125000
NODE_5935_length_1039_cov_37.940426	228	308	0	6	80	0.0750000
NODE_5935_length_1039_cov_37.940426	228	308	4	20	80	0.2500000
NODE_5935_length_1039_cov_37.940426	228	308	7	1	80	0.0125000
NODE_5935_length_1039_cov_37.940426	228	308	8	53	80	0.6625000
NODE_5935_length_1039_cov_37.940426	304	384	8	15	80	0.1875000
NODE_5935_length_1039_cov_37.940426	304	384	10	20	80	0.2500000
NODE_5935_length_1039_cov_37.940426	304	384	11	12	80	0.1500000
NODE_5935_length_1039_cov_37.940426	304	384	12	1	80	0.0125000
NODE_5935_length_1039_cov_37.940426	304	384	13	32	80	0.4000000
NODE_5935_length_1039_cov_37.940426	357	437	0	16	80	0.2000000
NODE_5935_length_1039_cov_37.940426	357	437	2	15	80	0.1875000
NODE_5935_length_1039_cov_37.940426	357	437	5	2	80	0.0250000
NODE_5935_length_1039_cov_37.940426	357	437	9	1	80	0.0125000
NODE_5935_length_1039_cov_37.940426	357	437	10	39	80	0.4875000
NODE_5935_length_1039_cov_37.940426	357	437	13	7	80	0.0875000
NODE_5936_length_1039_cov_24.567021	371	451	0	80	80	1.0000000
NODE_5936_length_1039_cov_24.567021	424	504	0	80	80	1.0000000
NODE_5937_length_1039_cov_15.790426	293	373	0	26	80	0.3250000
NODE_5937_length_1039_cov_15.790426	293	373	2	54	80	0.6750000
NODE_5937_length_1039_cov_15.790426	346	426	2	80	80	1.0000000
NODE_5938_length_1039_cov_14.670213	591	671	0	80	80	1.0000000
NODE_5938_length_1039_cov_14.670213	644	724	0	80	80	1.0000000
NODE_5939_length_1039_cov_11.568085	439	519	0	80	80	1.0000000
NODE_5939_length_1039_cov_11.568085	492	571	0	79	79	1.0000000
NODE_5947_length_1038_cov_17.191693	549	629	0	5	80	0.0625000
NODE_5947_length_1038_cov_17.191693	549	629	2	75	80	0.9375000
NODE_5947_length_1038_cov_17.191693	602	682	0	58	80	0.7250000
NODE_5947_length_1038_cov_17.191693	602	682	2	22	80	0.2750000
NODE_5948_length_1038_cov_13.520767	516	596	0	80	80	1.0000000
NODE_5948_length_1038_cov_13.520767	569	649	0	80	80	1.0000000
NODE_5949_length_1038_cov_10.541001	487	567	2	8	80	0.1000000
NODE_5949_length_1038_cov_10.541001	487	567	6	20	80	0.2500000
NODE_5949_length_1038_cov_10.541001	487	567	8	13	80	0.1625000
NODE_5949_length_1038_cov_10.541001	487	567	10	39	80	0.4875000
NODE_5949_length_1038_cov_10.541001	540	620	4	37	80	0.4625000
NODE_5949_length_1038_cov_10.541001	540	620	8	29	80	0.3625000
NODE_5949_length_1038_cov_10.541001	540	620	10	14	80	0.1750000
NODE_5950_length_1038_cov_8.826411	432	512	0	48	80	0.6000000
NODE_5950_length_1038_cov_8.826411	432	512	2	32	80	0.4000000
NODE_5950_length_1038_cov_8.826411	485	565	0	80	80	1.0000000
NODE_5952_length_1038_cov_2.587859	673	753	0	53	80	0.6625000
NODE_5952_length_1038_cov_2.587859	673	753	2	27	80	0.3375000
NODE_5952_length_1038_cov_2.587859	726	806	0	80	80	1.0000000
NODE_5963_length_1037_cov_66.968017	402	482	0	80	80	1.0000000
NODE_5963_length_1037_cov_66.968017	455	535	0	45	80	0.5625000
NODE_5963_length_1037_cov_66.968017	455	535	2	35	80	0.4375000
NODE_5964_length_1037_cov_53.639659	527	607	0	4	80	0.0500000
NODE_5964_length_1037_cov_53.639659	527	607	2	37	80	0.4625000
NODE_5964_length_1037_cov_53.639659	527	607	6	39	80	0.4875000
NODE_5964_length_1037_cov_53.639659	580	660	4	44	80	0.5500000
NODE_5964_length_1037_cov_53.639659	580	660	6	36	80	0.4500000
NODE_5965_length_1037_cov_45.353945	542	622	0	80	80	1.0000000
NODE_5965_length_1037_cov_45.353945	595	675	0	34	80	0.4250000
NODE_5965_length_1037_cov_45.353945	595	675	2	46	80	0.5750000
NODE_5966_length_1037_cov_31.078891	356	436	0	80	80	1.0000000
NODE_5966_length_1037_cov_31.078891	409	489	0	80	80	1.0000000
NODE_5967_length_1037_cov_25.453092	421	501	6	13	80	0.1625000
NODE_5967_length_1037_cov_25.453092	421	501	8	17	80	0.2125000
NODE_5967_length_1037_cov_25.453092	421	501	10	50	80	0.6250000
NODE_5967_length_1037_cov_25.453092	474	554	0	30	80	0.3750000
NODE_5967_length_1037_cov_25.453092	474	554	4	23	80	0.2875000
NODE_5967_length_1037_cov_25.453092	474	554	8	17	80	0.2125000
NODE_5967_length_1037_cov_25.453092	474	554	10	10	80	0.1250000
NODE_5967_length_1037_cov_25.453092	550	573	0	23	23	1.0000000
NODE_5968_length_1037_cov_13.740938	348	428	2	80	80	1.0000000
NODE_5968_length_1037_cov_13.740938	401	481	0	17	80	0.2125000
NODE_5968_length_1037_cov_13.740938	401	481	2	63	80	0.7875000
NODE_5969_length_1037_cov_12.632196	564	644	0	80	80	1.0000000
NODE_5969_length_1037_cov_12.632196	617	697	0	80	80	1.0000000
NODE_5970_length_1037_cov_8.904051	640	720	0	80	80	1.0000000
NODE_5970_length_1037_cov_8.904051	693	773	0	80	80	1.0000000
NODE_5978_length_1037_cov_1.859275	31	91	0	60	60	1.0000000
NODE_5986_length_1036_cov_52.270011	493	573	0	8	80	0.1000000
NODE_5986_length_1036_cov_52.270011	493	573	4	11	80	0.1375000
NODE_5986_length_1036_cov_52.270011	493	573	6	61	80	0.7625000
NODE_5986_length_1036_cov_52.270011	546	626	0	61	80	0.7625000
NODE_5986_length_1036_cov_52.270011	546	626	4	11	80	0.1375000
NODE_5986_length_1036_cov_52.270011	546	626	6	8	80	0.1000000
NODE_5987_length_1036_cov_24.080043	369	449	6	48	80	0.6000000
NODE_5987_length_1036_cov_24.080043	369	449	8	32	80	0.4000000
NODE_5987_length_1036_cov_24.080043	422	502	0	34	80	0.4250000
NODE_5987_length_1036_cov_24.080043	422	502	6	46	80	0.5750000
NODE_5988_length_1036_cov_20.533618	513	593	0	80	80	1.0000000
NODE_5988_length_1036_cov_20.533618	566	645	0	79	79	1.0000000
NODE_5988_length_1036_cov_20.533618	648	728	0	67	80	0.8375000
NODE_5988_length_1036_cov_20.533618	648	728	2	13	80	0.1625000
NODE_5988_length_1036_cov_20.533618	701	781	0	14	80	0.1750000
NODE_5988_length_1036_cov_20.533618	701	781	2	55	80	0.6875000
NODE_5988_length_1036_cov_20.533618	701	781	4	11	80	0.1375000
NODE_5989_length_1036_cov_19.715048	467	547	1	1	80	0.0125000
NODE_5989_length_1036_cov_19.715048	467	547	2	79	80	0.9875000
NODE_5989_length_1036_cov_19.715048	520	600	1	1	80	0.0125000
NODE_5989_length_1036_cov_19.715048	520	600	2	28	80	0.3500000
NODE_5989_length_1036_cov_19.715048	520	600	4	51	80	0.6375000
NODE_5990_length_1036_cov_19.452508	399	479	2	60	80	0.7500000
NODE_5990_length_1036_cov_19.452508	399	479	4	20	80	0.2500000
NODE_5990_length_1036_cov_19.452508	452	532	2	33	80	0.4125000
NODE_5990_length_1036_cov_19.452508	452	532	4	47	80	0.5875000
NODE_5990_length_1036_cov_19.452508	528	608	0	11	80	0.1375000
NODE_5990_length_1036_cov_19.452508	528	608	2	57	80	0.7125000
NODE_5990_length_1036_cov_19.452508	528	608	4	12	80	0.1500000
NODE_5990_length_1036_cov_19.452508	581	661	0	64	80	0.8000000
NODE_5990_length_1036_cov_19.452508	581	661	2	16	80	0.2000000
NODE_5991_length_1036_cov_13.840982	635	715	0	80	80	1.0000000
NODE_5991_length_1036_cov_13.840982	688	768	0	80	80	1.0000000
NODE_5992_length_1036_cov_6.913554	424	504	0	74	80	0.9250000
NODE_5992_length_1036_cov_6.913554	424	504	2	6	80	0.0750000
NODE_5992_length_1036_cov_6.913554	477	557	0	21	80	0.2625000
NODE_5992_length_1036_cov_6.913554	477	557	2	59	80	0.7375000
NODE_5993_length_1036_cov_5.880470	436	516	0	80	80	1.0000000
NODE_5993_length_1036_cov_5.880470	489	569	0	80	80	1.0000000
NODE_5994_length_1036_cov_4.638207	531	611	0	80	80	1.0000000
NODE_5994_length_1036_cov_4.638207	584	664	0	80	80	1.0000000
NODE_5998_length_1036_cov_1.293490	19	69	0	50	50	1.0000000
NODE_6001_length_1035_cov_31.941239	590	670	2	74	80	0.9250000
NODE_6001_length_1035_cov_31.941239	590	670	4	6	80	0.0750000
NODE_6001_length_1035_cov_31.941239	643	723	0	25	80	0.3125000
NODE_6001_length_1035_cov_31.941239	643	723	2	55	80	0.6875000
NODE_6002_length_1035_cov_14.917735	396	476	0	80	80	1.0000000
NODE_6002_length_1035_cov_14.917735	449	529	0	80	80	1.0000000
NODE_6003_length_1035_cov_12.552350	467	547	0	80	80	1.0000000
NODE_6003_length_1035_cov_12.552350	520	600	0	28	80	0.3500000
NODE_6003_length_1035_cov_12.552350	520	600	2	52	80	0.6500000
NODE_6004_length_1035_cov_12.050214	40	103	0	17	63	0.2698413
NODE_6004_length_1035_cov_12.050214	40	103	2	15	63	0.2380952
NODE_6004_length_1035_cov_12.050214	40	103	4	14	63	0.2222222
NODE_6004_length_1035_cov_12.050214	40	103	8	17	63	0.2698413
NODE_6004_length_1035_cov_12.050214	138	219	2	3	81	0.0370370
NODE_6004_length_1035_cov_12.050214	138	219	4	19	81	0.2345679
NODE_6004_length_1035_cov_12.050214	138	219	6	6	81	0.0740741
NODE_6004_length_1035_cov_12.050214	138	219	8	4	81	0.0493827
NODE_6004_length_1035_cov_12.050214	138	219	12	32	81	0.3950617
NODE_6004_length_1035_cov_12.050214	138	219	14	17	81	0.2098765
NODE_6005_length_1035_cov_7.020299	350	430	0	18	80	0.2250000
NODE_6005_length_1035_cov_7.020299	350	430	2	62	80	0.7750000
NODE_6005_length_1035_cov_7.020299	403	483	0	18	80	0.2250000
NODE_6005_length_1035_cov_7.020299	403	483	2	62	80	0.7750000
NODE_6006_length_1035_cov_4.726496	531	611	0	80	80	1.0000000
NODE_6006_length_1035_cov_4.726496	584	664	0	43	80	0.5375000
NODE_6006_length_1035_cov_4.726496	584	664	2	37	80	0.4625000
NODE_6018_length_1034_cov_26.810695	322	402	0	80	80	1.0000000
NODE_6018_length_1034_cov_26.810695	375	455	0	65	80	0.8125000
NODE_6018_length_1034_cov_26.810695	375	455	8	15	80	0.1875000
NODE_6018_length_1034_cov_26.810695	451	531	8	80	80	1.0000000
NODE_6018_length_1034_cov_26.810695	504	584	2	35	80	0.4375000
NODE_6018_length_1034_cov_26.810695	504	584	8	27	80	0.3375000
NODE_6018_length_1034_cov_26.810695	504	584	10	18	80	0.2250000
NODE_6032_length_1033_cov_42.574946	462	542	0	29	80	0.3625000
NODE_6032_length_1033_cov_42.574946	462	542	6	51	80	0.6375000
NODE_6032_length_1033_cov_42.574946	515	595	0	17	80	0.2125000
NODE_6032_length_1033_cov_42.574946	515	595	6	63	80	0.7875000
NODE_6033_length_1033_cov_17.073876	464	544	0	80	80	1.0000000
NODE_6033_length_1033_cov_17.073876	517	597	0	80	80	1.0000000
NODE_6034_length_1033_cov_15.791221	309	386	0	32	77	0.4155844
NODE_6034_length_1033_cov_15.791221	309	386	2	38	77	0.4935065
NODE_6034_length_1033_cov_15.791221	309	386	4	7	77	0.0909091
NODE_6034_length_1033_cov_15.791221	359	439	0	20	80	0.2500000
NODE_6034_length_1033_cov_15.791221	359	439	4	60	80	0.7500000
NODE_6035_length_1033_cov_11.340471	437	517	0	80	80	1.0000000
NODE_6035_length_1033_cov_11.340471	490	570	0	80	80	1.0000000
NODE_6045_length_1032_cov_56.511254	466	546	0	24	80	0.3000000
NODE_6045_length_1032_cov_56.511254	466	546	2	56	80	0.7000000
NODE_6045_length_1032_cov_56.511254	519	599	0	51	80	0.6375000
NODE_6045_length_1032_cov_56.511254	519	599	2	29	80	0.3625000
NODE_6046_length_1032_cov_20.752412	479	559	0	21	80	0.2625000
NODE_6046_length_1032_cov_20.752412	479	559	2	59	80	0.7375000
NODE_6046_length_1032_cov_20.752412	532	612	0	74	80	0.9250000
NODE_6046_length_1032_cov_20.752412	532	612	2	6	80	0.0750000
NODE_6047_length_1032_cov_8.166131	257	337	0	80	80	1.0000000
NODE_6047_length_1032_cov_8.166131	310	390	0	80	80	1.0000000
NODE_6048_length_1032_cov_7.991426	277	357	0	80	80	1.0000000
NODE_6048_length_1032_cov_7.991426	330	410	0	80	80	1.0000000
NODE_6049_length_1032_cov_5.276527	371	451	4	38	80	0.4750000
NODE_6049_length_1032_cov_5.276527	371	451	6	2	80	0.0250000
NODE_6049_length_1032_cov_5.276527	371	451	8	40	80	0.5000000
NODE_6049_length_1032_cov_5.276527	424	504	0	14	80	0.1750000
NODE_6049_length_1032_cov_5.276527	424	504	2	3	80	0.0375000
NODE_6049_length_1032_cov_5.276527	424	504	6	38	80	0.4750000
NODE_6049_length_1032_cov_5.276527	424	504	8	25	80	0.3125000
NODE_6055_length_1031_cov_71.154506	586	654	0	38	68	0.5588235
NODE_6055_length_1031_cov_71.154506	586	654	4	27	68	0.3970588
NODE_6055_length_1031_cov_71.154506	586	654	12	3	68	0.0441176
NODE_6055_length_1031_cov_71.154506	616	696	0	8	80	0.1000000
NODE_6055_length_1031_cov_71.154506	616	696	4	27	80	0.3375000
NODE_6055_length_1031_cov_71.154506	616	696	12	20	80	0.2500000
NODE_6055_length_1031_cov_71.154506	616	696	14	2	80	0.0250000
NODE_6055_length_1031_cov_71.154506	616	696	16	23	80	0.2875000
NODE_6055_length_1031_cov_71.154506	669	749	11	6	80	0.0750000
NODE_6055_length_1031_cov_71.154506	669	749	12	33	80	0.4125000
NODE_6055_length_1031_cov_71.154506	669	749	14	2	80	0.0250000
NODE_6055_length_1031_cov_71.154506	669	749	16	39	80	0.4875000
NODE_6056_length_1031_cov_70.221030	409	489	4	58	80	0.7250000
NODE_6056_length_1031_cov_70.221030	409	489	6	5	80	0.0625000
NODE_6056_length_1031_cov_70.221030	409	489	7	1	80	0.0125000
NODE_6056_length_1031_cov_70.221030	409	489	8	16	80	0.2000000
NODE_6056_length_1031_cov_70.221030	462	542	4	32	80	0.4000000
NODE_6056_length_1031_cov_70.221030	462	542	6	9	80	0.1125000
NODE_6056_length_1031_cov_70.221030	462	542	10	39	80	0.4875000
NODE_6056_length_1031_cov_70.221030	538	618	0	25	80	0.3125000
NODE_6056_length_1031_cov_70.221030	538	618	6	55	80	0.6875000
NODE_6056_length_1031_cov_70.221030	591	671	0	78	80	0.9750000
NODE_6056_length_1031_cov_70.221030	591	671	6	2	80	0.0250000
NODE_6057_length_1031_cov_43.618026	462	542	0	40	80	0.5000000
NODE_6057_length_1031_cov_43.618026	462	542	2	40	80	0.5000000
NODE_6057_length_1031_cov_43.618026	515	595	0	20	80	0.2500000
NODE_6057_length_1031_cov_43.618026	515	595	2	60	80	0.7500000
NODE_6058_length_1031_cov_43.581545	303	383	0	37	80	0.4625000
NODE_6058_length_1031_cov_43.581545	303	383	3	1	80	0.0125000
NODE_6058_length_1031_cov_43.581545	303	383	5	42	80	0.5250000
NODE_6058_length_1031_cov_43.581545	356	436	4	28	80	0.3500000
NODE_6058_length_1031_cov_43.581545	356	436	5	52	80	0.6500000
NODE_6058_length_1031_cov_43.581545	432	512	0	54	80	0.6750000
NODE_6058_length_1031_cov_43.581545	432	512	4	26	80	0.3250000
NODE_6058_length_1031_cov_43.581545	485	565	0	80	80	1.0000000
NODE_6059_length_1031_cov_22.310086	382	462	0	80	80	1.0000000
NODE_6059_length_1031_cov_22.310086	435	515	0	80	80	1.0000000
NODE_6060_length_1031_cov_11.547210	481	561	2	68	80	0.8500000
NODE_6060_length_1031_cov_11.547210	481	561	4	12	80	0.1500000
NODE_6060_length_1031_cov_11.547210	534	614	0	49	80	0.6125000
NODE_6060_length_1031_cov_11.547210	534	614	2	31	80	0.3875000
NODE_6066_length_1030_cov_54.380236	363	443	0	80	80	1.0000000
NODE_6066_length_1030_cov_54.380236	416	496	0	80	80	1.0000000
NODE_6066_length_1030_cov_54.380236	492	572	0	4	80	0.0500000
NODE_6066_length_1030_cov_54.380236	492	572	2	76	80	0.9500000
NODE_6066_length_1030_cov_54.380236	545	625	0	32	80	0.4000000
NODE_6066_length_1030_cov_54.380236	545	625	2	48	80	0.6000000
NODE_6067_length_1030_cov_45.040816	334	414	0	80	80	1.0000000
NODE_6067_length_1030_cov_45.040816	387	467	0	80	80	1.0000000
NODE_6067_length_1030_cov_45.040816	463	543	0	66	80	0.8250000
NODE_6067_length_1030_cov_45.040816	463	543	2	14	80	0.1750000
NODE_6067_length_1030_cov_45.040816	516	596	0	13	80	0.1625000
NODE_6067_length_1030_cov_45.040816	516	596	2	52	80	0.6500000
NODE_6067_length_1030_cov_45.040816	516	596	4	15	80	0.1875000
NODE_6068_length_1030_cov_20.491944	511	591	0	10	80	0.1250000
NODE_6068_length_1030_cov_20.491944	511	591	2	52	80	0.6500000
NODE_6068_length_1030_cov_20.491944	511	591	4	18	80	0.2250000
NODE_6068_length_1030_cov_20.491944	564	644	0	2	80	0.0250000
NODE_6068_length_1030_cov_20.491944	564	644	2	7	80	0.0875000
NODE_6068_length_1030_cov_20.491944	564	644	4	71	80	0.8875000
NODE_6069_length_1030_cov_17.253491	524	604	0	80	80	1.0000000
NODE_6069_length_1030_cov_17.253491	577	657	0	80	80	1.0000000
NODE_6070_length_1030_cov_14.337272	564	644	0	32	80	0.4000000
NODE_6070_length_1030_cov_14.337272	564	644	2	48	80	0.6000000
NODE_6070_length_1030_cov_14.337272	617	697	0	80	80	1.0000000
NODE_6071_length_1030_cov_5.742213	474	554	6	80	80	1.0000000
NODE_6071_length_1030_cov_5.742213	527	607	0	53	80	0.6625000
NODE_6071_length_1030_cov_5.742213	527	607	6	27	80	0.3375000
NODE_6073_length_1030_cov_5.208378	978	1030	0	14	52	0.2692308
NODE_6073_length_1030_cov_5.208378	978	1030	2	27	52	0.5192308
NODE_6073_length_1030_cov_5.208378	978	1030	8	11	52	0.2115385
NODE_6077_length_1030_cov_2.146079	979	1010	0	31	31	1.0000000
NODE_6083_length_1029_cov_236.527957	584	666	18	62	82	0.7560976
NODE_6083_length_1029_cov_236.527957	584	666	22	20	82	0.2439024
NODE_6083_length_1029_cov_236.527957	639	702	4	21	63	0.3333333
NODE_6083_length_1029_cov_236.527957	639	702	9	2	63	0.0317460
NODE_6083_length_1029_cov_236.527957	639	702	18	35	63	0.5555556
NODE_6083_length_1029_cov_236.527957	639	702	22	5	63	0.0793651
NODE_6084_length_1029_cov_41.650538	364	444	0	80	80	1.0000000
NODE_6084_length_1029_cov_41.650538	417	497	0	80	80	1.0000000
NODE_6084_length_1029_cov_41.650538	493	573	0	68	80	0.8500000
NODE_6084_length_1029_cov_41.650538	493	573	2	12	80	0.1500000
NODE_6084_length_1029_cov_41.650538	546	626	0	15	80	0.1875000
NODE_6084_length_1029_cov_41.650538	546	626	2	57	80	0.7125000
NODE_6084_length_1029_cov_41.650538	546	626	3	1	80	0.0125000
NODE_6084_length_1029_cov_41.650538	546	626	4	7	80	0.0875000
NODE_6085_length_1029_cov_34.940860	314	360	0	46	46	1.0000000
NODE_6085_length_1029_cov_34.940860	371	451	0	80	80	1.0000000
NODE_6085_length_1029_cov_34.940860	424	502	0	78	78	1.0000000
NODE_6086_length_1029_cov_28.752688	255	335	0	9	80	0.1125000
NODE_6086_length_1029_cov_28.752688	255	335	2	71	80	0.8875000
NODE_6086_length_1029_cov_28.752688	308	388	0	48	80	0.6000000
NODE_6086_length_1029_cov_28.752688	308	388	2	32	80	0.4000000
NODE_6086_length_1029_cov_28.752688	384	464	0	80	80	1.0000000
NODE_6086_length_1029_cov_28.752688	437	517	0	80	80	1.0000000
NODE_6087_length_1029_cov_28.523656	409	489	0	80	80	1.0000000
NODE_6087_length_1029_cov_28.523656	462	542	0	80	80	1.0000000
NODE_6088_length_1029_cov_28.283871	281	361	0	80	80	1.0000000
NODE_6088_length_1029_cov_28.283871	334	414	0	72	80	0.9000000
NODE_6088_length_1029_cov_28.283871	334	414	4	8	80	0.1000000
NODE_6088_length_1029_cov_28.283871	410	490	4	80	80	1.0000000
NODE_6088_length_1029_cov_28.283871	463	546	0	51	83	0.6144578
NODE_6088_length_1029_cov_28.283871	463	546	4	32	83	0.3855422
NODE_6089_length_1029_cov_26.883871	434	514	0	4	80	0.0500000
NODE_6089_length_1029_cov_26.883871	434	514	9	20	80	0.2500000
NODE_6089_length_1029_cov_26.883871	434	514	10	7	80	0.0875000
NODE_6089_length_1029_cov_26.883871	434	514	14	49	80	0.6125000
NODE_6089_length_1029_cov_26.883871	487	567	0	57	80	0.7125000
NODE_6089_length_1029_cov_26.883871	487	567	9	20	80	0.2500000
NODE_6089_length_1029_cov_26.883871	487	567	10	3	80	0.0375000
NODE_6090_length_1029_cov_23.552688	305	385	2	46	80	0.5750000
NODE_6090_length_1029_cov_23.552688	305	385	4	25	80	0.3125000
NODE_6090_length_1029_cov_23.552688	305	385	6	9	80	0.1125000
NODE_6090_length_1029_cov_23.552688	358	438	4	48	80	0.6000000
NODE_6090_length_1029_cov_23.552688	358	438	6	32	80	0.4000000
NODE_6090_length_1029_cov_23.552688	434	514	0	14	80	0.1750000
NODE_6090_length_1029_cov_23.552688	434	514	2	60	80	0.7500000
NODE_6090_length_1029_cov_23.552688	434	514	4	6	80	0.0750000
NODE_6090_length_1029_cov_23.552688	487	567	0	67	80	0.8375000
NODE_6090_length_1029_cov_23.552688	487	567	2	13	80	0.1625000
NODE_6091_length_1029_cov_22.520430	434	514	0	80	80	1.0000000
NODE_6091_length_1029_cov_22.520430	487	567	0	80	80	1.0000000
NODE_6092_length_1029_cov_21.924731	335	415	4	52	80	0.6500000
NODE_6092_length_1029_cov_21.924731	335	415	6	28	80	0.3500000
NODE_6092_length_1029_cov_21.924731	388	468	2	7	80	0.0875000
NODE_6092_length_1029_cov_21.924731	388	468	5	1	80	0.0125000
NODE_6092_length_1029_cov_21.924731	388	468	6	72	80	0.9000000
NODE_6093_length_1029_cov_17.101075	501	581	0	49	80	0.6125000
NODE_6093_length_1029_cov_17.101075	501	581	2	1	80	0.0125000
NODE_6093_length_1029_cov_17.101075	501	581	3	19	80	0.2375000
NODE_6093_length_1029_cov_17.101075	501	581	4	11	80	0.1375000
NODE_6093_length_1029_cov_17.101075	554	634	3	16	80	0.2000000
NODE_6093_length_1029_cov_17.101075	554	634	4	64	80	0.8000000
NODE_6093_length_1029_cov_17.101075	630	710	0	53	80	0.6625000
NODE_6093_length_1029_cov_17.101075	630	710	2	8	80	0.1000000
NODE_6093_length_1029_cov_17.101075	630	710	4	19	80	0.2375000
NODE_6093_length_1029_cov_17.101075	683	755	0	19	72	0.2638889
NODE_6093_length_1029_cov_17.101075	683	755	2	53	72	0.7361111
NODE_6094_length_1029_cov_14.052688	405	485	2	33	80	0.4125000
NODE_6094_length_1029_cov_14.052688	405	485	4	47	80	0.5875000
NODE_6094_length_1029_cov_14.052688	458	538	0	24	80	0.3000000
NODE_6094_length_1029_cov_14.052688	458	538	2	38	80	0.4750000
NODE_6094_length_1029_cov_14.052688	458	538	4	18	80	0.2250000
NODE_6095_length_1029_cov_11.119355	291	369	0	12	78	0.1538462
NODE_6095_length_1029_cov_11.119355	291	369	8	11	78	0.1410256
NODE_6095_length_1029_cov_11.119355	291	369	11	6	78	0.0769231
NODE_6095_length_1029_cov_11.119355	291	369	14	49	78	0.6282051
NODE_6095_length_1029_cov_11.119355	342	422	14	80	80	1.0000000
NODE_6097_length_1029_cov_3.850538	231	311	0	80	80	1.0000000
NODE_6097_length_1029_cov_3.850538	284	364	0	80	80	1.0000000
NODE_6104_length_1028_cov_19.625404	495	575	0	80	80	1.0000000
NODE_6104_length_1028_cov_19.625404	548	628	0	80	80	1.0000000
NODE_6105_length_1028_cov_17.497309	533	613	0	32	80	0.4000000
NODE_6105_length_1028_cov_17.497309	533	613	2	48	80	0.6000000
NODE_6105_length_1028_cov_17.497309	586	666	0	80	80	1.0000000
NODE_6106_length_1028_cov_16.528525	497	577	0	80	80	1.0000000
NODE_6106_length_1028_cov_16.528525	550	630	0	80	80	1.0000000
NODE_6107_length_1028_cov_10.212056	463	543	0	51	80	0.6375000
NODE_6107_length_1028_cov_10.212056	463	543	2	29	80	0.3625000
NODE_6107_length_1028_cov_10.212056	516	596	0	13	80	0.1625000
NODE_6107_length_1028_cov_10.212056	516	596	2	67	80	0.8375000
NODE_6108_length_1028_cov_10.131324	399	479	0	80	80	1.0000000
NODE_6108_length_1028_cov_10.131324	452	532	0	80	80	1.0000000
NODE_6109_length_1028_cov_9.773950	482	562	0	80	80	1.0000000
NODE_6109_length_1028_cov_9.773950	535	615	0	80	80	1.0000000
NODE_6110_length_1028_cov_8.079656	399	479	0	80	80	1.0000000
NODE_6110_length_1028_cov_8.079656	452	532	0	80	80	1.0000000
NODE_6111_length_1028_cov_7.092573	439	519	0	43	80	0.5375000
NODE_6111_length_1028_cov_7.092573	439	519	2	37	80	0.4625000
NODE_6111_length_1028_cov_7.092573	492	572	0	15	80	0.1875000
NODE_6111_length_1028_cov_7.092573	492	572	2	65	80	0.8125000
NODE_6112_length_1028_cov_4.727664	416	488	0	72	72	1.0000000
NODE_6112_length_1028_cov_4.727664	461	541	0	80	80	1.0000000
NODE_6125_length_1027_cov_51.341595	399	479	0	80	80	1.0000000
NODE_6125_length_1027_cov_51.341595	452	532	0	80	80	1.0000000
NODE_6125_length_1027_cov_51.341595	528	608	0	80	80	1.0000000
NODE_6125_length_1027_cov_51.341595	581	661	0	79	80	0.9875000
NODE_6125_length_1027_cov_51.341595	581	661	2	1	80	0.0125000
NODE_6126_length_1027_cov_45.613147	347	427	0	80	80	1.0000000
NODE_6126_length_1027_cov_45.613147	400	480	0	55	80	0.6875000
NODE_6126_length_1027_cov_45.613147	400	480	1	18	80	0.2250000
NODE_6126_length_1027_cov_45.613147	400	480	2	7	80	0.0875000
NODE_6126_length_1027_cov_45.613147	476	556	2	59	80	0.7375000
NODE_6126_length_1027_cov_45.613147	476	556	4	21	80	0.2625000
NODE_6126_length_1027_cov_45.613147	529	609	2	6	80	0.0750000
NODE_6126_length_1027_cov_45.613147	529	609	3	4	80	0.0500000
NODE_6126_length_1027_cov_45.613147	529	609	4	70	80	0.8750000
NODE_6127_length_1027_cov_35.435345	431	511	4	7	80	0.0875000
NODE_6127_length_1027_cov_35.435345	431	511	5	25	80	0.3125000
NODE_6127_length_1027_cov_35.435345	431	511	6	23	80	0.2875000
NODE_6127_length_1027_cov_35.435345	431	511	8	25	80	0.3125000
NODE_6127_length_1027_cov_35.435345	484	564	4	2	80	0.0250000
NODE_6127_length_1027_cov_35.435345	484	564	6	27	80	0.3375000
NODE_6127_length_1027_cov_35.435345	484	564	8	51	80	0.6375000
NODE_6135_length_1026_cov_39.737864	374	454	0	80	80	1.0000000
NODE_6135_length_1026_cov_39.737864	427	509	0	82	82	1.0000000
NODE_6135_length_1026_cov_39.737864	505	585	0	80	80	1.0000000
NODE_6135_length_1026_cov_39.737864	558	638	0	80	80	1.0000000
NODE_6136_length_1026_cov_26.400216	423	503	0	80	80	1.0000000
NODE_6136_length_1026_cov_26.400216	476	556	0	80	80	1.0000000
NODE_6137_length_1026_cov_25.325782	477	557	1	15	80	0.1875000
NODE_6137_length_1026_cov_25.325782	477	557	2	22	80	0.2750000
NODE_6137_length_1026_cov_25.325782	477	557	4	17	80	0.2125000
NODE_6137_length_1026_cov_25.325782	477	557	5	26	80	0.3250000
NODE_6137_length_1026_cov_25.325782	530	610	4	1	80	0.0125000
NODE_6137_length_1026_cov_25.325782	530	610	5	47	80	0.5875000
NODE_6137_length_1026_cov_25.325782	530	610	6	32	80	0.4000000
NODE_6137_length_1026_cov_25.325782	606	686	0	13	80	0.1625000
NODE_6137_length_1026_cov_25.325782	606	686	2	19	80	0.2375000
NODE_6137_length_1026_cov_25.325782	606	686	4	9	80	0.1125000
NODE_6137_length_1026_cov_25.325782	606	686	5	39	80	0.4875000
NODE_6137_length_1026_cov_25.325782	659	739	0	66	80	0.8250000
NODE_6137_length_1026_cov_25.325782	659	739	2	14	80	0.1750000
NODE_6138_length_1026_cov_22.218986	408	488	0	80	80	1.0000000
NODE_6138_length_1026_cov_22.218986	461	541	0	80	80	1.0000000
NODE_6138_length_1026_cov_22.218986	537	617	0	80	80	1.0000000
NODE_6138_length_1026_cov_22.218986	590	670	0	80	80	1.0000000
NODE_6139_length_1026_cov_15.640777	450	530	0	80	80	1.0000000
NODE_6139_length_1026_cov_15.640777	503	583	0	80	80	1.0000000
NODE_6140_length_1026_cov_12.062567	165	245	2	80	80	1.0000000
NODE_6140_length_1026_cov_12.062567	218	298	0	4	80	0.0500000
NODE_6140_length_1026_cov_12.062567	218	298	1	27	80	0.3375000
NODE_6140_length_1026_cov_12.062567	218	298	2	49	80	0.6125000
NODE_6142_length_1026_cov_5.002157	335	415	0	80	80	1.0000000
NODE_6142_length_1026_cov_5.002157	388	468	0	80	80	1.0000000
NODE_6155_length_1025_cov_52.053996	366	446	2	80	80	1.0000000
NODE_6155_length_1025_cov_52.053996	419	499	0	53	80	0.6625000
NODE_6155_length_1025_cov_52.053996	419	499	2	27	80	0.3375000
NODE_6155_length_1025_cov_52.053996	495	575	0	80	80	1.0000000
NODE_6155_length_1025_cov_52.053996	548	628	0	80	80	1.0000000
NODE_6156_length_1025_cov_35.980562	318	375	0	57	57	1.0000000
NODE_6156_length_1025_cov_35.980562	348	428	0	60	80	0.7500000
NODE_6156_length_1025_cov_35.980562	348	428	2	20	80	0.2500000
NODE_6156_length_1025_cov_35.980562	425	482	2	57	57	1.0000000
NODE_6156_length_1025_cov_35.980562	455	521	0	8	66	0.1212121
NODE_6156_length_1025_cov_35.980562	455	521	2	58	66	0.8787879
NODE_6157_length_1025_cov_26.954644	607	687	0	80	80	1.0000000
NODE_6157_length_1025_cov_26.954644	660	740	0	80	80	1.0000000
NODE_6158_length_1025_cov_20.576674	428	508	0	80	80	1.0000000
NODE_6158_length_1025_cov_20.576674	481	561	0	80	80	1.0000000
NODE_6159_length_1025_cov_15.525918	415	495	0	55	80	0.6875000
NODE_6159_length_1025_cov_15.525918	415	495	6	25	80	0.3125000
NODE_6159_length_1025_cov_15.525918	468	548	0	2	80	0.0250000
NODE_6159_length_1025_cov_15.525918	468	548	6	78	80	0.9750000
NODE_6160_length_1025_cov_7.044276	240	320	0	80	80	1.0000000
NODE_6161_length_1025_cov_6.688985	334	414	0	80	80	1.0000000
NODE_6161_length_1025_cov_6.688985	387	467	0	80	80	1.0000000
NODE_6170_length_1024_cov_28.681081	264	344	0	80	80	1.0000000
NODE_6170_length_1024_cov_28.681081	317	397	0	80	80	1.0000000
NODE_6170_length_1024_cov_28.681081	393	477	0	84	84	1.0000000
NODE_6171_length_1024_cov_17.922162	324	404	0	80	80	1.0000000
NODE_6171_length_1024_cov_17.922162	377	457	0	80	80	1.0000000
NODE_6173_length_1024_cov_12.018378	368	448	4	80	80	1.0000000
NODE_6173_length_1024_cov_12.018378	421	501	0	32	80	0.4000000
NODE_6173_length_1024_cov_12.018378	421	501	4	48	80	0.6000000
NODE_6174_length_1024_cov_8.800000	517	597	0	80	80	1.0000000
NODE_6174_length_1024_cov_8.800000	570	650	0	80	80	1.0000000
NODE_6175_length_1024_cov_6.207568	318	398	0	80	80	1.0000000
NODE_6175_length_1024_cov_6.207568	371	451	0	80	80	1.0000000
NODE_6178_length_1024_cov_2.468108	274	324	0	50	50	1.0000000
NODE_6178_length_1024_cov_2.468108	274	322	0	48	48	1.0000000
NODE_6178_length_1024_cov_2.468108	274	324	0	50	50	1.0000000
NODE_6178_length_1024_cov_2.468108	274	323	0	49	49	1.0000000
NODE_6178_length_1024_cov_2.468108	274	322	0	48	48	1.0000000
NODE_6185_length_1023_cov_100.366883	441	521	1	79	80	0.9875000
NODE_6185_length_1023_cov_100.366883	441	521	2	1	80	0.0125000
NODE_6185_length_1023_cov_100.366883	494	574	1	80	80	1.0000000
NODE_6186_length_1023_cov_64.271645	349	429	0	80	80	1.0000000
NODE_6186_length_1023_cov_64.271645	402	482	0	80	80	1.0000000
NODE_6186_length_1023_cov_64.271645	478	558	0	49	80	0.6125000
NODE_6186_length_1023_cov_64.271645	478	558	18	1	80	0.0125000
NODE_6186_length_1023_cov_64.271645	478	558	21	12	80	0.1500000
NODE_6186_length_1023_cov_64.271645	478	558	22	18	80	0.2250000
NODE_6186_length_1023_cov_64.271645	531	611	21	9	80	0.1125000
NODE_6186_length_1023_cov_64.271645	531	611	22	71	80	0.8875000
NODE_6187_length_1023_cov_32.695887	318	398	0	80	80	1.0000000
NODE_6187_length_1023_cov_32.695887	371	451	0	80	80	1.0000000
NODE_6187_length_1023_cov_32.695887	447	527	0	80	80	1.0000000
NODE_6187_length_1023_cov_32.695887	500	580	0	80	80	1.0000000
NODE_6188_length_1023_cov_16.244589	601	681	0	66	80	0.8250000
NODE_6188_length_1023_cov_16.244589	601	681	4	8	80	0.1000000
NODE_6188_length_1023_cov_16.244589	601	681	6	6	80	0.0750000
NODE_6188_length_1023_cov_16.244589	654	734	0	13	80	0.1625000
NODE_6188_length_1023_cov_16.244589	654	734	4	8	80	0.1000000
NODE_6188_length_1023_cov_16.244589	654	734	6	59	80	0.7375000
NODE_6189_length_1023_cov_15.876623	371	451	0	80	80	1.0000000
NODE_6189_length_1023_cov_15.876623	424	504	0	80	80	1.0000000
NODE_6189_length_1023_cov_15.876623	500	580	0	38	80	0.4750000
NODE_6189_length_1023_cov_15.876623	500	580	2	42	80	0.5250000
NODE_6189_length_1023_cov_15.876623	553	633	0	9	80	0.1125000
NODE_6189_length_1023_cov_15.876623	553	633	2	71	80	0.8875000
NODE_6190_length_1023_cov_14.678571	555	635	0	80	80	1.0000000
NODE_6190_length_1023_cov_14.678571	608	688	0	80	80	1.0000000
NODE_6191_length_1023_cov_14.443723	406	486	0	6	80	0.0750000
NODE_6191_length_1023_cov_14.443723	406	486	2	74	80	0.9250000
NODE_6191_length_1023_cov_14.443723	459	539	0	14	80	0.1750000
NODE_6191_length_1023_cov_14.443723	459	539	2	66	80	0.8250000
NODE_6192_length_1023_cov_10.984848	590	670	0	80	80	1.0000000
NODE_6192_length_1023_cov_10.984848	643	723	0	80	80	1.0000000
NODE_6202_length_1022_cov_42.952329	555	636	0	23	81	0.2839506
NODE_6202_length_1022_cov_42.952329	555	636	2	58	81	0.7160494
NODE_6202_length_1022_cov_42.952329	609	689	0	39	80	0.4875000
NODE_6202_length_1022_cov_42.952329	609	689	2	41	80	0.5125000
NODE_6202_length_1022_cov_42.952329	685	765	0	36	80	0.4500000
NODE_6202_length_1022_cov_42.952329	685	765	2	44	80	0.5500000
NODE_6202_length_1022_cov_42.952329	738	818	0	3	80	0.0375000
NODE_6202_length_1022_cov_42.952329	738	818	2	77	80	0.9625000
NODE_6203_length_1022_cov_29.949079	510	590	0	80	80	1.0000000
NODE_6203_length_1022_cov_29.949079	563	643	0	80	80	1.0000000
NODE_6204_length_1022_cov_7.672806	461	541	0	80	80	1.0000000
NODE_6204_length_1022_cov_7.672806	514	594	0	80	80	1.0000000
NODE_6213_length_1021_cov_47.379610	341	421	0	38	80	0.4750000
NODE_6213_length_1021_cov_47.379610	341	421	2	42	80	0.5250000
NODE_6213_length_1021_cov_47.379610	394	474	0	13	80	0.1625000
NODE_6213_length_1021_cov_47.379610	394	474	2	67	80	0.8375000
NODE_6213_length_1021_cov_47.379610	470	550	0	80	80	1.0000000
NODE_6213_length_1021_cov_47.379610	523	603	0	80	80	1.0000000
NODE_6214_length_1021_cov_33.255965	588	668	0	28	80	0.3500000
NODE_6214_length_1021_cov_33.255965	588	668	6	52	80	0.6500000
NODE_6214_length_1021_cov_33.255965	641	721	0	4	80	0.0500000
NODE_6214_length_1021_cov_33.255965	641	721	6	76	80	0.9500000
NODE_6227_length_1020_cov_24.565689	485	565	3	74	80	0.9250000
NODE_6227_length_1020_cov_24.565689	485	565	4	1	80	0.0125000
NODE_6227_length_1020_cov_24.565689	485	565	6	5	80	0.0625000
NODE_6227_length_1020_cov_24.565689	538	618	0	1	80	0.0125000
NODE_6227_length_1020_cov_24.565689	538	618	2	8	80	0.1000000
NODE_6227_length_1020_cov_24.565689	538	618	3	21	80	0.2625000
NODE_6227_length_1020_cov_24.565689	538	618	4	1	80	0.0125000
NODE_6227_length_1020_cov_24.565689	538	618	6	49	80	0.6125000
NODE_6228_length_1020_cov_20.825190	395	475	0	40	80	0.5000000
NODE_6228_length_1020_cov_20.825190	395	475	8	40	80	0.5000000
NODE_6228_length_1020_cov_20.825190	448	528	2	2	80	0.0250000
NODE_6228_length_1020_cov_20.825190	448	528	8	48	80	0.6000000
NODE_6228_length_1020_cov_20.825190	448	528	10	30	80	0.3750000
NODE_6229_length_1020_cov_20.305103	285	365	0	80	80	1.0000000
NODE_6229_length_1020_cov_20.305103	338	418	0	80	80	1.0000000
NODE_6229_length_1020_cov_20.305103	414	494	0	80	80	1.0000000
NODE_6229_length_1020_cov_20.305103	467	548	0	81	81	1.0000000
NODE_6230_length_1020_cov_17.919653	408	488	0	27	80	0.3375000
NODE_6230_length_1020_cov_17.919653	408	488	2	8	80	0.1000000
NODE_6230_length_1020_cov_17.919653	408	488	4	6	80	0.0750000
NODE_6230_length_1020_cov_17.919653	408	488	6	39	80	0.4875000
NODE_6230_length_1020_cov_17.919653	461	541	0	4	80	0.0500000
NODE_6230_length_1020_cov_17.919653	461	541	4	55	80	0.6875000
NODE_6230_length_1020_cov_17.919653	461	541	6	21	80	0.2625000
NODE_6231_length_1020_cov_13.972856	436	516	0	80	80	1.0000000
NODE_6231_length_1020_cov_13.972856	489	569	0	80	80	1.0000000
NODE_6232_length_1020_cov_10.472313	407	487	0	80	80	1.0000000
NODE_6232_length_1020_cov_10.472313	460	540	0	80	80	1.0000000
NODE_6235_length_1020_cov_3.707926	821	901	0	80	80	1.0000000
NODE_6235_length_1020_cov_3.707926	874	954	0	80	80	1.0000000
NODE_6238_length_1020_cov_2.648208	0	70	0	70	70	1.0000000
NODE_6238_length_1020_cov_2.648208	43	88	0	45	45	1.0000000
NODE_6248_length_1019_cov_30.164130	476	556	0	80	80	1.0000000
NODE_6248_length_1019_cov_30.164130	529	609	0	80	80	1.0000000
NODE_6248_length_1019_cov_30.164130	605	685	0	80	80	1.0000000
NODE_6248_length_1019_cov_30.164130	658	738	0	80	80	1.0000000
NODE_6249_length_1019_cov_22.845652	343	423	0	12	80	0.1500000
NODE_6249_length_1019_cov_22.845652	343	423	2	68	80	0.8500000
NODE_6249_length_1019_cov_22.845652	396	476	0	65	80	0.8125000
NODE_6249_length_1019_cov_22.845652	396	476	2	15	80	0.1875000
NODE_6249_length_1019_cov_22.845652	472	552	0	80	80	1.0000000
NODE_6249_length_1019_cov_22.845652	525	605	0	80	80	1.0000000
NODE_6250_length_1019_cov_8.098913	523	601	0	78	78	1.0000000
NODE_6250_length_1019_cov_8.098913	574	654	0	80	80	1.0000000
NODE_6251_length_1019_cov_7.896739	423	503	0	80	80	1.0000000
NODE_6251_length_1019_cov_7.896739	476	556	0	60	80	0.7500000
NODE_6251_length_1019_cov_7.896739	476	556	2	20	80	0.2500000
NODE_6252_length_1019_cov_4.597826	625	696	0	31	71	0.4366197
NODE_6252_length_1019_cov_4.597826	625	696	2	40	71	0.5633803
NODE_6263_length_1019_cov_1.139130	89	165	6	22	76	0.2894737
NODE_6263_length_1019_cov_1.139130	89	165	8	8	76	0.1052632
NODE_6263_length_1019_cov_1.139130	89	165	10	14	76	0.1842105
NODE_6263_length_1019_cov_1.139130	89	165	12	5	76	0.0657895
NODE_6263_length_1019_cov_1.139130	89	165	14	27	76	0.3552631
NODE_6265_length_1018_cov_33.494015	212	292	0	9	80	0.1125000
NODE_6265_length_1018_cov_33.494015	212	292	4	2	80	0.0250000
NODE_6265_length_1018_cov_33.494015	212	292	6	69	80	0.8625000
NODE_6265_length_1018_cov_33.494015	265	345	0	62	80	0.7750000
NODE_6265_length_1018_cov_33.494015	265	345	4	2	80	0.0250000
NODE_6265_length_1018_cov_33.494015	265	345	6	16	80	0.2000000
NODE_6266_length_1018_cov_22.776931	372	452	0	80	80	1.0000000
NODE_6266_length_1018_cov_22.776931	425	505	0	80	80	1.0000000
NODE_6268_length_1018_cov_8.486398	404	484	0	80	80	1.0000000
NODE_6268_length_1018_cov_8.486398	457	537	0	80	80	1.0000000
NODE_6270_length_1018_cov_7.737758	357	437	0	80	80	1.0000000
NODE_6270_length_1018_cov_7.737758	410	490	0	80	80	1.0000000
NODE_6286_length_1017_cov_207.523965	0	41	48	3	41	0.0731707
NODE_6286_length_1017_cov_207.523965	0	41	50	1	41	0.0243902
NODE_6286_length_1017_cov_207.523965	0	41	56	4	41	0.0975610
NODE_6286_length_1017_cov_207.523965	0	41	58	1	41	0.0243902
NODE_6286_length_1017_cov_207.523965	0	41	66	2	41	0.0487805
NODE_6286_length_1017_cov_207.523965	0	41	73	1	41	0.0243902
NODE_6286_length_1017_cov_207.523965	0	41	77	1	41	0.0243902
NODE_6286_length_1017_cov_207.523965	0	41	78	3	41	0.0731707
NODE_6286_length_1017_cov_207.523965	0	41	83	1	41	0.0243902
NODE_6286_length_1017_cov_207.523965	0	41	86	3	41	0.0731707
NODE_6286_length_1017_cov_207.523965	0	41	91	5	41	0.1219512
NODE_6286_length_1017_cov_207.523965	0	41	94	1	41	0.0243902
NODE_6286_length_1017_cov_207.523965	0	41	95	1	41	0.0243902
NODE_6286_length_1017_cov_207.523965	0	41	99	1	41	0.0243902
NODE_6286_length_1017_cov_207.523965	0	41	103	1	41	0.0243902
NODE_6286_length_1017_cov_207.523965	0	41	107	1	41	0.0243902
NODE_6286_length_1017_cov_207.523965	0	41	116	1	41	0.0243902
NODE_6286_length_1017_cov_207.523965	0	41	117	3	41	0.0731707
NODE_6286_length_1017_cov_207.523965	0	41	119	1	41	0.0243902
NODE_6286_length_1017_cov_207.523965	0	41	121	1	41	0.0243902
NODE_6286_length_1017_cov_207.523965	0	41	122	2	41	0.0487805
NODE_6286_length_1017_cov_207.523965	0	41	124	3	41	0.0731707
NODE_6286_length_1017_cov_207.523965	14	94	78	2	80	0.0250000
NODE_6286_length_1017_cov_207.523965	14	94	83	1	80	0.0125000
NODE_6286_length_1017_cov_207.523965	14	94	86	3	80	0.0375000
NODE_6286_length_1017_cov_207.523965	14	94	91	5	80	0.0625000
NODE_6286_length_1017_cov_207.523965	14	94	94	1	80	0.0125000
NODE_6286_length_1017_cov_207.523965	14	94	95	1	80	0.0125000
NODE_6286_length_1017_cov_207.523965	14	94	99	1	80	0.0125000
NODE_6286_length_1017_cov_207.523965	14	94	103	1	80	0.0125000
NODE_6286_length_1017_cov_207.523965	14	94	107	1	80	0.0125000
NODE_6286_length_1017_cov_207.523965	14	94	116	1	80	0.0125000
NODE_6286_length_1017_cov_207.523965	14	94	117	3	80	0.0375000
NODE_6286_length_1017_cov_207.523965	14	94	119	1	80	0.0125000
NODE_6286_length_1017_cov_207.523965	14	94	121	1	80	0.0125000
NODE_6286_length_1017_cov_207.523965	14	94	122	2	80	0.0250000
NODE_6286_length_1017_cov_207.523965	14	94	124	3	80	0.0375000
NODE_6286_length_1017_cov_207.523965	14	94	126	1	80	0.0125000
NODE_6286_length_1017_cov_207.523965	14	94	128	2	80	0.0250000
NODE_6286_length_1017_cov_207.523965	14	94	138	1	80	0.0125000
NODE_6286_length_1017_cov_207.523965	14	94	139	3	80	0.0375000
NODE_6286_length_1017_cov_207.523965	14	94	141	1	80	0.0125000
NODE_6286_length_1017_cov_207.523965	14	94	142	1	80	0.0125000
NODE_6286_length_1017_cov_207.523965	14	94	147	5	80	0.0625000
NODE_6286_length_1017_cov_207.523965	14	94	148	1	80	0.0125000
NODE_6286_length_1017_cov_207.523965	14	94	154	2	80	0.0250000
NODE_6286_length_1017_cov_207.523965	14	94	156	4	80	0.0500000
NODE_6286_length_1017_cov_207.523965	14	94	158	5	80	0.0625000
NODE_6286_length_1017_cov_207.523965	14	94	162	8	80	0.1000000
NODE_6286_length_1017_cov_207.523965	14	94	164	5	80	0.0625000
NODE_6286_length_1017_cov_207.523965	14	94	166	1	80	0.0125000
NODE_6286_length_1017_cov_207.523965	14	94	170	5	80	0.0625000
NODE_6286_length_1017_cov_207.523965	14	94	171	1	80	0.0125000
NODE_6286_length_1017_cov_207.523965	14	94	172	3	80	0.0375000
NODE_6286_length_1017_cov_207.523965	14	94	174	2	80	0.0250000
NODE_6286_length_1017_cov_207.523965	14	94	175	1	80	0.0125000
NODE_6286_length_1017_cov_207.523965	14	94	177	1	80	0.0125000
NODE_6287_length_1017_cov_18.824619	490	570	6	1	80	0.0125000
NODE_6287_length_1017_cov_18.824619	490	570	12	79	80	0.9875000
NODE_6287_length_1017_cov_18.824619	543	623	0	51	80	0.6375000
NODE_6287_length_1017_cov_18.824619	543	623	6	3	80	0.0375000
NODE_6287_length_1017_cov_18.824619	543	623	12	26	80	0.3250000
NODE_6288_length_1017_cov_14.794118	428	508	0	80	80	1.0000000
NODE_6288_length_1017_cov_14.794118	481	561	0	80	80	1.0000000
NODE_6288_length_1017_cov_14.794118	557	637	0	80	80	1.0000000
NODE_6288_length_1017_cov_14.794118	610	690	0	80	80	1.0000000
NODE_6297_length_1016_cov_22.267176	577	657	4	80	80	1.0000000
NODE_6297_length_1016_cov_22.267176	630	710	2	18	80	0.2250000
NODE_6297_length_1016_cov_22.267176	630	710	4	62	80	0.7750000
NODE_6298_length_1016_cov_21.134133	625	705	0	80	80	1.0000000
NODE_6298_length_1016_cov_21.134133	678	758	0	48	80	0.6000000
NODE_6298_length_1016_cov_21.134133	678	758	2	32	80	0.4000000
NODE_6299_length_1016_cov_20.392585	504	584	0	80	80	1.0000000
NODE_6299_length_1016_cov_20.392585	557	637	0	80	80	1.0000000
NODE_6299_length_1016_cov_20.392585	633	713	0	80	80	1.0000000
NODE_6299_length_1016_cov_20.392585	686	766	0	80	80	1.0000000
NODE_6300_length_1016_cov_16.917121	524	604	0	4	80	0.0500000
NODE_6300_length_1016_cov_16.917121	524	604	2	76	80	0.9500000
NODE_6300_length_1016_cov_16.917121	577	657	0	42	80	0.5250000
NODE_6300_length_1016_cov_16.917121	577	657	2	38	80	0.4750000
NODE_6301_length_1016_cov_8.243184	438	518	0	80	80	1.0000000
NODE_6301_length_1016_cov_8.243184	491	571	0	80	80	1.0000000
NODE_6301_length_1016_cov_8.243184	567	647	0	80	80	1.0000000
NODE_6301_length_1016_cov_8.243184	620	700	0	80	80	1.0000000
NODE_6302_length_1016_cov_8.141767	166	256	6	1	90	0.0111111
NODE_6302_length_1016_cov_8.141767	166	256	16	2	90	0.0222222
NODE_6302_length_1016_cov_8.141767	166	256	20	6	90	0.0666667
NODE_6302_length_1016_cov_8.141767	166	256	21	3	90	0.0333333
NODE_6302_length_1016_cov_8.141767	166	256	23	4	90	0.0444444
NODE_6302_length_1016_cov_8.141767	166	256	24	2	90	0.0222222
NODE_6302_length_1016_cov_8.141767	166	256	28	2	90	0.0222222
NODE_6302_length_1016_cov_8.141767	166	256	30	2	90	0.0222222
NODE_6302_length_1016_cov_8.141767	166	256	32	16	90	0.1777778
NODE_6302_length_1016_cov_8.141767	166	256	33	1	90	0.0111111
NODE_6302_length_1016_cov_8.141767	166	256	36	5	90	0.0555556
NODE_6302_length_1016_cov_8.141767	166	256	37	1	90	0.0111111
NODE_6302_length_1016_cov_8.141767	166	256	39	5	90	0.0555556
NODE_6302_length_1016_cov_8.141767	166	256	42	2	90	0.0222222
NODE_6302_length_1016_cov_8.141767	166	256	43	4	90	0.0444444
NODE_6302_length_1016_cov_8.141767	166	256	45	1	90	0.0111111
NODE_6302_length_1016_cov_8.141767	166	256	47	29	90	0.3222222
NODE_6302_length_1016_cov_8.141767	166	256	48	2	90	0.0222222
NODE_6302_length_1016_cov_8.141767	166	256	50	2	90	0.0222222
NODE_6303_length_1016_cov_7.466739	576	656	0	80	80	1.0000000
NODE_6303_length_1016_cov_7.466739	629	709	0	80	80	1.0000000
NODE_6318_length_1015_cov_24.680131	459	539	2	80	80	1.0000000
NODE_6318_length_1015_cov_24.680131	512	592	0	44	80	0.5500000
NODE_6318_length_1015_cov_24.680131	512	592	2	36	80	0.4500000
NODE_6318_length_1015_cov_24.680131	588	668	0	80	80	1.0000000
NODE_6318_length_1015_cov_24.680131	641	721	0	80	80	1.0000000
NODE_6319_length_1015_cov_23.198690	407	487	0	80	80	1.0000000
NODE_6319_length_1015_cov_23.198690	460	540	0	80	80	1.0000000
NODE_6319_length_1015_cov_23.198690	536	616	0	80	80	1.0000000
NODE_6319_length_1015_cov_23.198690	589	669	0	80	80	1.0000000
NODE_6320_length_1015_cov_22.544760	490	570	0	80	80	1.0000000
NODE_6320_length_1015_cov_22.544760	543	623	0	80	80	1.0000000
NODE_6321_length_1015_cov_17.994541	510	590	0	80	80	1.0000000
NODE_6321_length_1015_cov_17.994541	563	643	0	80	80	1.0000000
NODE_6322_length_1015_cov_16.594978	437	517	0	5	80	0.0625000
NODE_6322_length_1015_cov_16.594978	437	517	2	75	80	0.9375000
NODE_6322_length_1015_cov_16.594978	490	570	0	58	80	0.7250000
NODE_6322_length_1015_cov_16.594978	490	570	2	22	80	0.2750000
NODE_6323_length_1015_cov_14.000000	505	585	0	80	80	1.0000000
NODE_6323_length_1015_cov_14.000000	558	638	0	80	80	1.0000000
NODE_6324_length_1015_cov_9.978166	345	425	0	80	80	1.0000000
NODE_6324_length_1015_cov_9.978166	398	478	0	80	80	1.0000000
NODE_6325_length_1015_cov_6.844978	393	473	2	42	80	0.5250000
NODE_6325_length_1015_cov_6.844978	393	473	6	38	80	0.4750000
NODE_6325_length_1015_cov_6.844978	446	526	4	44	80	0.5500000
NODE_6325_length_1015_cov_6.844978	446	526	6	36	80	0.4500000
NODE_6337_length_1014_cov_95.709290	259	335	0	57	76	0.7500000
NODE_6337_length_1014_cov_95.709290	259	335	2	19	76	0.2500000
NODE_6337_length_1014_cov_95.709290	310	390	0	6	80	0.0750000
NODE_6337_length_1014_cov_95.709290	310	390	2	56	80	0.7000000
NODE_6337_length_1014_cov_95.709290	310	390	8	18	80	0.2250000
NODE_6337_length_1014_cov_95.709290	386	466	2	10	80	0.1250000
NODE_6337_length_1014_cov_95.709290	386	466	7	1	80	0.0125000
NODE_6337_length_1014_cov_95.709290	386	466	8	69	80	0.8625000
NODE_6337_length_1014_cov_95.709290	439	519	0	26	80	0.3250000
NODE_6337_length_1014_cov_95.709290	439	519	2	37	80	0.4625000
NODE_6337_length_1014_cov_95.709290	439	519	7	1	80	0.0125000
NODE_6337_length_1014_cov_95.709290	439	519	8	16	80	0.2000000
NODE_6338_length_1014_cov_67.918033	182	262	0	14	80	0.1750000
NODE_6338_length_1014_cov_67.918033	182	262	4	29	80	0.3625000
NODE_6338_length_1014_cov_67.918033	182	262	8	37	80	0.4625000
NODE_6338_length_1014_cov_67.918033	235	315	4	20	80	0.2500000
NODE_6338_length_1014_cov_67.918033	235	315	8	60	80	0.7500000
NODE_6338_length_1014_cov_67.918033	311	391	0	57	80	0.7125000
NODE_6338_length_1014_cov_67.918033	311	391	4	23	80	0.2875000
NODE_6338_length_1014_cov_67.918033	364	444	0	80	80	1.0000000
NODE_6339_length_1014_cov_44.802186	418	498	0	41	80	0.5125000
NODE_6339_length_1014_cov_44.802186	418	498	4	1	80	0.0125000
NODE_6339_length_1014_cov_44.802186	418	498	6	38	80	0.4750000
NODE_6339_length_1014_cov_44.802186	471	551	6	80	80	1.0000000
NODE_6340_length_1014_cov_36.349727	369	449	0	80	80	1.0000000
NODE_6340_length_1014_cov_36.349727	422	502	0	80	80	1.0000000
NODE_6340_length_1014_cov_36.349727	498	578	0	80	80	1.0000000
NODE_6340_length_1014_cov_36.349727	551	631	0	80	80	1.0000000
NODE_6341_length_1014_cov_35.547541	363	441	2	42	78	0.5384616
NODE_6341_length_1014_cov_35.547541	363	441	4	36	78	0.4615385
NODE_6341_length_1014_cov_35.547541	416	494	2	48	78	0.6153846
NODE_6341_length_1014_cov_35.547541	416	494	4	30	78	0.3846154
NODE_6342_length_1014_cov_32.266667	428	508	0	80	80	1.0000000
NODE_6342_length_1014_cov_32.266667	481	561	0	80	80	1.0000000
NODE_6343_length_1014_cov_28.493989	480	560	0	68	80	0.8500000
NODE_6343_length_1014_cov_28.493989	480	560	2	12	80	0.1500000
NODE_6343_length_1014_cov_28.493989	533	613	0	80	80	1.0000000
NODE_6343_length_1014_cov_28.493989	609	689	0	80	80	1.0000000
NODE_6343_length_1014_cov_28.493989	662	742	0	80	80	1.0000000
NODE_6344_length_1014_cov_25.171585	500	580	0	80	80	1.0000000
NODE_6344_length_1014_cov_25.171585	553	633	0	80	80	1.0000000
NODE_6345_length_1014_cov_22.437158	534	614	0	80	80	1.0000000
NODE_6345_length_1014_cov_22.437158	587	667	0	80	80	1.0000000
NODE_6346_length_1014_cov_19.238251	379	459	0	1	80	0.0125000
NODE_6346_length_1014_cov_19.238251	379	459	4	79	80	0.9875000
NODE_6346_length_1014_cov_19.238251	432	512	0	54	80	0.6750000
NODE_6346_length_1014_cov_19.238251	432	512	4	26	80	0.3250000
NODE_6346_length_1014_cov_19.238251	508	585	0	77	77	1.0000000
NODE_6346_length_1014_cov_19.238251	558	638	0	80	80	1.0000000
NODE_6347_length_1014_cov_15.926776	594	674	4	80	80	1.0000000
NODE_6347_length_1014_cov_15.926776	647	727	0	24	80	0.3000000
NODE_6347_length_1014_cov_15.926776	647	727	4	56	80	0.7000000
NODE_6348_length_1014_cov_8.691803	285	365	0	80	80	1.0000000
NODE_6348_length_1014_cov_8.691803	338	418	0	80	80	1.0000000
NODE_6349_length_1014_cov_7.959563	531	611	0	73	80	0.9125000
NODE_6349_length_1014_cov_7.959563	531	611	2	7	80	0.0875000
NODE_6349_length_1014_cov_7.959563	584	664	0	20	80	0.2500000
NODE_6349_length_1014_cov_7.959563	584	664	2	60	80	0.7500000
NODE_6351_length_1014_cov_7.608743	298	378	2	3	80	0.0375000
NODE_6351_length_1014_cov_7.608743	298	378	6	77	80	0.9625000
NODE_6351_length_1014_cov_7.608743	351	431	0	44	80	0.5500000
NODE_6351_length_1014_cov_7.608743	351	431	2	12	80	0.1500000
NODE_6351_length_1014_cov_7.608743	351	431	6	24	80	0.3000000
NODE_6352_length_1014_cov_6.209836	321	401	0	80	80	1.0000000
NODE_6352_length_1014_cov_6.209836	374	454	0	80	80	1.0000000
NODE_6364_length_1013_cov_32.695842	423	503	0	31	80	0.3875000
NODE_6364_length_1013_cov_32.695842	423	503	2	2	80	0.0250000
NODE_6364_length_1013_cov_32.695842	423	503	4	47	80	0.5875000
NODE_6364_length_1013_cov_32.695842	476	556	4	80	80	1.0000000
NODE_6364_length_1013_cov_32.695842	552	632	0	26	80	0.3250000
NODE_6364_length_1013_cov_32.695842	552	632	2	2	80	0.0250000
NODE_6364_length_1013_cov_32.695842	552	632	4	52	80	0.6500000
NODE_6364_length_1013_cov_32.695842	605	685	0	79	80	0.9875000
NODE_6364_length_1013_cov_32.695842	605	685	2	1	80	0.0125000
NODE_6365_length_1013_cov_21.935449	424	503	0	79	79	1.0000000
NODE_6365_length_1013_cov_21.935449	476	556	0	80	80	1.0000000
NODE_6366_length_1013_cov_17.532823	440	520	0	18	80	0.2250000
NODE_6366_length_1013_cov_17.532823	440	520	2	62	80	0.7750000
NODE_6366_length_1013_cov_17.532823	493	573	0	71	80	0.8875000
NODE_6366_length_1013_cov_17.532823	493	573	2	9	80	0.1125000
NODE_6367_length_1013_cov_14.555799	478	558	0	66	80	0.8250000
NODE_6367_length_1013_cov_14.555799	478	558	2	14	80	0.1750000
NODE_6367_length_1013_cov_14.555799	531	611	0	13	80	0.1625000
NODE_6367_length_1013_cov_14.555799	531	611	2	67	80	0.8375000
NODE_6368_length_1013_cov_13.142232	476	556	5	41	80	0.5125000
NODE_6368_length_1013_cov_13.142232	476	556	6	19	80	0.2375000
NODE_6368_length_1013_cov_13.142232	476	556	8	20	80	0.2500000
NODE_6368_length_1013_cov_13.142232	529	609	2	22	80	0.2750000
NODE_6368_length_1013_cov_13.142232	529	609	5	3	80	0.0375000
NODE_6368_length_1013_cov_13.142232	529	609	6	7	80	0.0875000
NODE_6368_length_1013_cov_13.142232	529	609	7	1	80	0.0125000
NODE_6368_length_1013_cov_13.142232	529	609	8	47	80	0.5875000
NODE_6369_length_1013_cov_7.756018	538	618	0	13	80	0.1625000
NODE_6369_length_1013_cov_7.756018	538	618	2	67	80	0.8375000
NODE_6369_length_1013_cov_7.756018	591	671	0	35	80	0.4375000
NODE_6369_length_1013_cov_7.756018	591	671	2	45	80	0.5625000
NODE_6371_length_1013_cov_4.368709	550	630	0	80	80	1.0000000
NODE_6371_length_1013_cov_4.368709	603	683	0	80	80	1.0000000
NODE_6380_length_1012_cov_91.547645	378	458	0	80	80	1.0000000
NODE_6380_length_1012_cov_91.547645	431	511	0	80	80	1.0000000
NODE_6380_length_1012_cov_91.547645	507	587	0	80	80	1.0000000
NODE_6380_length_1012_cov_91.547645	560	640	0	80	80	1.0000000
NODE_6381_length_1012_cov_64.409639	345	425	0	80	80	1.0000000
NODE_6381_length_1012_cov_64.409639	398	478	0	80	80	1.0000000
NODE_6382_length_1012_cov_63.035049	438	518	0	80	80	1.0000000
NODE_6382_length_1012_cov_63.035049	491	571	0	80	80	1.0000000
NODE_6383_length_1012_cov_53.686747	276	356	0	80	80	1.0000000
NODE_6383_length_1012_cov_53.686747	329	409	0	80	80	1.0000000
NODE_6383_length_1012_cov_53.686747	405	485	0	80	80	1.0000000
NODE_6383_length_1012_cov_53.686747	458	538	0	80	80	1.0000000
NODE_6384_length_1012_cov_35.861993	453	533	0	80	80	1.0000000
NODE_6384_length_1012_cov_35.861993	506	581	0	75	75	1.0000000
NODE_6385_length_1012_cov_16.125958	510	590	0	80	80	1.0000000
NODE_6385_length_1012_cov_16.125958	563	643	0	80	80	1.0000000
NODE_6386_length_1012_cov_15.395400	501	581	0	64	80	0.8000000
NODE_6386_length_1012_cov_15.395400	501	581	2	16	80	0.2000000
NODE_6386_length_1012_cov_15.395400	554	634	0	80	80	1.0000000
NODE_6388_length_1012_cov_6.409639	528	608	0	55	80	0.6875000
NODE_6388_length_1012_cov_6.409639	528	608	4	25	80	0.3125000
NODE_6388_length_1012_cov_6.409639	581	661	0	2	80	0.0250000
NODE_6388_length_1012_cov_6.409639	581	661	4	78	80	0.9750000
NODE_6398_length_1011_cov_53.032895	515	595	0	80	80	1.0000000
NODE_6398_length_1011_cov_53.032895	568	648	0	80	80	1.0000000
NODE_6399_length_1011_cov_25.838816	366	446	0	49	80	0.6125000
NODE_6399_length_1011_cov_25.838816	366	446	2	31	80	0.3875000
NODE_6399_length_1011_cov_25.838816	419	499	0	26	80	0.3250000
NODE_6399_length_1011_cov_25.838816	419	499	2	54	80	0.6750000
NODE_6400_length_1011_cov_22.734649	426	506	0	80	80	1.0000000
NODE_6400_length_1011_cov_22.734649	479	559	0	80	80	1.0000000
NODE_6400_length_1011_cov_22.734649	555	636	0	36	81	0.4444444
NODE_6400_length_1011_cov_22.734649	555	636	2	45	81	0.5555556
NODE_6400_length_1011_cov_22.734649	609	689	0	21	80	0.2625000
NODE_6400_length_1011_cov_22.734649	609	689	2	59	80	0.7375000
NODE_6401_length_1011_cov_18.127193	389	469	0	80	80	1.0000000
NODE_6401_length_1011_cov_18.127193	442	520	0	78	78	1.0000000
NODE_6401_length_1011_cov_18.127193	516	596	0	80	80	1.0000000
NODE_6401_length_1011_cov_18.127193	569	649	0	80	80	1.0000000
NODE_6402_length_1011_cov_12.709430	309	389	0	80	80	1.0000000
NODE_6402_length_1011_cov_12.709430	362	442	0	80	80	1.0000000
NODE_6403_length_1011_cov_8.731360	441	521	0	17	80	0.2125000
NODE_6403_length_1011_cov_8.731360	441	521	3	40	80	0.5000000
NODE_6403_length_1011_cov_8.731360	441	521	4	23	80	0.2875000
NODE_6403_length_1011_cov_8.731360	494	574	0	70	80	0.8750000
NODE_6403_length_1011_cov_8.731360	494	574	3	10	80	0.1250000
NODE_6405_length_1011_cov_7.212719	219	299	2	80	80	1.0000000
NODE_6408_length_1011_cov_3.569079	173	253	0	42	80	0.5250000
NODE_6408_length_1011_cov_3.569079	173	253	2	38	80	0.4750000
NODE_6408_length_1011_cov_3.569079	226	306	2	80	80	1.0000000
NODE_6409_length_1011_cov_1.703947	779	851	15	1	72	0.0138889
NODE_6409_length_1011_cov_1.703947	779	851	19	7	72	0.0972222
NODE_6409_length_1011_cov_1.703947	779	851	21	13	72	0.1805556
NODE_6409_length_1011_cov_1.703947	779	851	23	2	72	0.0277778
NODE_6409_length_1011_cov_1.703947	779	851	25	5	72	0.0694444
NODE_6409_length_1011_cov_1.703947	779	851	27	7	72	0.0972222
NODE_6409_length_1011_cov_1.703947	779	851	29	4	72	0.0555556
NODE_6409_length_1011_cov_1.703947	779	851	31	4	72	0.0555556
NODE_6409_length_1011_cov_1.703947	779	851	33	6	72	0.0833333
NODE_6409_length_1011_cov_1.703947	779	851	34	2	72	0.0277778
NODE_6409_length_1011_cov_1.703947	779	851	36	12	72	0.1666667
NODE_6409_length_1011_cov_1.703947	779	851	37	9	72	0.1250000
NODE_6416_length_1010_cov_51.841932	335	415	0	80	80	1.0000000
NODE_6416_length_1010_cov_51.841932	388	468	0	80	80	1.0000000
NODE_6417_length_1010_cov_35.860593	576	656	0	37	80	0.4625000
NODE_6417_length_1010_cov_35.860593	576	656	2	43	80	0.5375000
NODE_6417_length_1010_cov_35.860593	629	709	2	36	80	0.4500000
NODE_6417_length_1010_cov_35.860593	629	709	4	44	80	0.5500000
NODE_6418_length_1010_cov_30.043908	509	589	0	57	80	0.7125000
NODE_6418_length_1010_cov_30.043908	509	589	2	23	80	0.2875000
NODE_6418_length_1010_cov_30.043908	562	642	0	14	80	0.1750000
NODE_6418_length_1010_cov_30.043908	562	642	2	66	80	0.8250000
NODE_6418_length_1010_cov_30.043908	638	718	0	44	80	0.5500000
NODE_6418_length_1010_cov_30.043908	638	718	2	36	80	0.4500000
NODE_6418_length_1010_cov_30.043908	691	771	2	80	80	1.0000000
NODE_6420_length_1010_cov_15.156970	364	444	0	80	80	1.0000000
NODE_6420_length_1010_cov_15.156970	417	497	0	80	80	1.0000000
NODE_6421_length_1010_cov_13.546652	385	465	0	67	80	0.8375000
NODE_6421_length_1010_cov_13.546652	385	465	2	13	80	0.1625000
NODE_6421_length_1010_cov_13.546652	438	518	0	80	80	1.0000000
NODE_6422_length_1010_cov_13.317234	480	560	2	61	80	0.7625000
NODE_6422_length_1010_cov_13.317234	480	560	4	19	80	0.2375000
NODE_6422_length_1010_cov_13.317234	533	613	2	40	80	0.5000000
NODE_6422_length_1010_cov_13.317234	533	613	4	40	80	0.5000000
NODE_6423_length_1010_cov_12.900110	427	507	2	33	80	0.4125000
NODE_6423_length_1010_cov_12.900110	427	507	4	47	80	0.5875000
NODE_6423_length_1010_cov_12.900110	480	560	2	42	80	0.5250000
NODE_6423_length_1010_cov_12.900110	480	560	4	38	80	0.4750000
NODE_6424_length_1010_cov_11.423710	631	711	0	80	80	1.0000000
NODE_6424_length_1010_cov_11.423710	684	764	0	80	80	1.0000000
NODE_6425_length_1010_cov_11.256861	492	572	0	35	80	0.4375000
NODE_6425_length_1010_cov_11.256861	492	572	4	45	80	0.5625000
NODE_6425_length_1010_cov_11.256861	545	625	4	80	80	1.0000000
NODE_6426_length_1010_cov_11.000000	455	535	0	80	80	1.0000000
NODE_6426_length_1010_cov_11.000000	508	588	0	80	80	1.0000000
NODE_6428_length_1010_cov_4.990121	476	556	0	80	80	1.0000000
NODE_6428_length_1010_cov_4.990121	529	609	0	80	80	1.0000000
NODE_6430_length_1010_cov_4.892426	476	556	0	80	80	1.0000000
NODE_6430_length_1010_cov_4.892426	529	609	0	80	80	1.0000000
NODE_6431_length_1010_cov_3.624588	157	196	0	39	39	1.0000000
NODE_6435_length_1010_cov_1.440176	1	58	0	57	57	1.0000000
NODE_6436_length_1009_cov_44.626374	288	362	0	74	74	1.0000000
NODE_6436_length_1009_cov_44.626374	335	415	0	80	80	1.0000000
NODE_6436_length_1009_cov_44.626374	411	491	0	41	80	0.5125000
NODE_6436_length_1009_cov_44.626374	411	491	2	12	80	0.1500000
NODE_6436_length_1009_cov_44.626374	411	491	6	27	80	0.3375000
NODE_6436_length_1009_cov_44.626374	464	544	0	10	80	0.1250000
NODE_6436_length_1009_cov_44.626374	464	544	4	19	80	0.2375000
NODE_6436_length_1009_cov_44.626374	464	544	6	51	80	0.6375000
NODE_6437_length_1009_cov_31.828571	412	492	4	80	80	1.0000000
NODE_6437_length_1009_cov_31.828571	465	545	0	47	80	0.5875000
NODE_6437_length_1009_cov_31.828571	465	545	4	33	80	0.4125000
NODE_6438_length_1009_cov_28.539560	571	651	0	47	80	0.5875000
NODE_6438_length_1009_cov_28.539560	571	651	1	33	80	0.4125000
NODE_6438_length_1009_cov_28.539560	624	704	1	51	80	0.6375000
NODE_6438_length_1009_cov_28.539560	624	704	2	29	80	0.3625000
NODE_6439_length_1009_cov_20.281319	577	657	0	6	80	0.0750000
NODE_6439_length_1009_cov_20.281319	577	657	2	74	80	0.9250000
NODE_6439_length_1009_cov_20.281319	630	710	0	59	80	0.7375000
NODE_6439_length_1009_cov_20.281319	630	710	2	21	80	0.2625000
NODE_6440_length_1009_cov_18.649451	430	510	0	80	80	1.0000000
NODE_6440_length_1009_cov_18.649451	483	563	0	80	80	1.0000000
NODE_6442_length_1009_cov_3.767033	647	727	0	80	80	1.0000000
NODE_6442_length_1009_cov_3.767033	700	780	0	80	80	1.0000000
NODE_6443_length_1009_cov_2.903297	36	63	0	27	27	1.0000000
NODE_6451_length_1008_cov_44.825083	399	479	0	80	80	1.0000000
NODE_6451_length_1008_cov_44.825083	452	532	0	80	80	1.0000000
NODE_6452_length_1008_cov_41.030803	280	360	0	28	80	0.3500000
NODE_6452_length_1008_cov_41.030803	280	360	2	52	80	0.6500000
NODE_6452_length_1008_cov_41.030803	333	413	0	67	80	0.8375000
NODE_6452_length_1008_cov_41.030803	333	413	4	13	80	0.1625000
NODE_6452_length_1008_cov_41.030803	409	489	0	8	80	0.1000000
NODE_6452_length_1008_cov_41.030803	409	489	2	17	80	0.2125000
NODE_6452_length_1008_cov_41.030803	409	489	4	55	80	0.6875000
NODE_6452_length_1008_cov_41.030803	462	542	0	8	80	0.1000000
NODE_6452_length_1008_cov_41.030803	462	542	2	17	80	0.2125000
NODE_6452_length_1008_cov_41.030803	462	542	4	55	80	0.6875000
NODE_6453_length_1008_cov_39.377338	311	391	6	33	80	0.4125000
NODE_6453_length_1008_cov_39.377338	311	391	8	47	80	0.5875000
NODE_6453_length_1008_cov_39.377338	364	444	2	40	80	0.5000000
NODE_6453_length_1008_cov_39.377338	364	444	8	40	80	0.5000000
NODE_6453_length_1008_cov_39.377338	440	520	2	4	80	0.0500000
NODE_6453_length_1008_cov_39.377338	440	520	6	71	80	0.8875000
NODE_6453_length_1008_cov_39.377338	440	520	7	1	80	0.0125000
NODE_6453_length_1008_cov_39.377338	440	520	8	4	80	0.0500000
NODE_6453_length_1008_cov_39.377338	493	573	6	80	80	1.0000000
NODE_6454_length_1008_cov_27.836084	405	485	0	80	80	1.0000000
NODE_6454_length_1008_cov_27.836084	458	538	0	78	80	0.9750000
NODE_6454_length_1008_cov_27.836084	458	538	2	2	80	0.0250000
NODE_6454_length_1008_cov_27.836084	534	614	0	3	80	0.0375000
NODE_6454_length_1008_cov_27.836084	534	614	2	77	80	0.9625000
NODE_6454_length_1008_cov_27.836084	587	667	0	54	80	0.6750000
NODE_6454_length_1008_cov_27.836084	587	667	2	26	80	0.3250000
NODE_6455_length_1008_cov_24.741474	485	565	0	18	80	0.2250000
NODE_6455_length_1008_cov_24.741474	485	565	2	62	80	0.7750000
NODE_6455_length_1008_cov_24.741474	538	618	0	71	80	0.8875000
NODE_6455_length_1008_cov_24.741474	538	618	2	9	80	0.1125000
NODE_6456_length_1008_cov_20.278328	401	481	0	80	80	1.0000000
NODE_6456_length_1008_cov_20.278328	454	534	0	80	80	1.0000000
NODE_6457_length_1008_cov_6.071507	460	540	0	80	80	1.0000000
NODE_6457_length_1008_cov_6.071507	513	593	0	80	80	1.0000000
NODE_6466_length_1008_cov_1.798680	0	64	0	64	64	1.0000000
NODE_6466_length_1008_cov_1.798680	37	104	0	61	67	0.9104478
NODE_6466_length_1008_cov_1.798680	37	104	2	6	67	0.0895522
NODE_6473_length_1007_cov_27.011013	294	371	0	51	77	0.6623377
NODE_6473_length_1007_cov_27.011013	294	371	4	26	77	0.3376623
NODE_6473_length_1007_cov_27.011013	347	424	0	5	77	0.0649351
NODE_6473_length_1007_cov_27.011013	347	424	2	1	77	0.0129870
NODE_6473_length_1007_cov_27.011013	347	424	3	28	77	0.3636364
NODE_6473_length_1007_cov_27.011013	347	424	4	43	77	0.5584416
NODE_6474_length_1007_cov_24.668502	369	449	0	80	80	1.0000000
NODE_6474_length_1007_cov_24.668502	422	502	0	80	80	1.0000000
NODE_6474_length_1007_cov_24.668502	498	578	0	80	80	1.0000000
NODE_6474_length_1007_cov_24.668502	551	631	0	80	80	1.0000000
NODE_6475_length_1007_cov_21.729075	454	534	0	80	80	1.0000000
NODE_6475_length_1007_cov_21.729075	507	587	0	80	80	1.0000000
NODE_6475_length_1007_cov_21.729075	583	663	0	11	80	0.1375000
NODE_6475_length_1007_cov_21.729075	583	663	4	26	80	0.3250000
NODE_6475_length_1007_cov_21.729075	583	663	6	43	80	0.5375000
NODE_6475_length_1007_cov_21.729075	636	716	6	80	80	1.0000000
NODE_6476_length_1007_cov_14.515419	400	480	0	73	80	0.9125000
NODE_6476_length_1007_cov_14.515419	400	480	2	7	80	0.0875000
NODE_6476_length_1007_cov_14.515419	453	533	0	80	80	1.0000000
NODE_6477_length_1007_cov_13.685022	376	456	0	80	80	1.0000000
NODE_6477_length_1007_cov_13.685022	429	509	0	80	80	1.0000000
NODE_6478_length_1007_cov_9.189427	438	518	6	80	80	1.0000000
NODE_6478_length_1007_cov_9.189427	491	571	0	28	80	0.3500000
NODE_6478_length_1007_cov_9.189427	491	571	6	52	80	0.6500000
NODE_6491_length_1006_cov_59.773980	379	459	0	80	80	1.0000000
NODE_6491_length_1006_cov_59.773980	432	512	0	80	80	1.0000000
NODE_6491_length_1006_cov_59.773980	508	588	0	80	80	1.0000000
NODE_6491_length_1006_cov_59.773980	561	641	0	80	80	1.0000000
NODE_6492_length_1006_cov_34.762955	482	562	2	80	80	1.0000000
NODE_6492_length_1006_cov_34.762955	535	615	0	48	80	0.6000000
NODE_6492_length_1006_cov_34.762955	535	615	2	32	80	0.4000000
NODE_6493_length_1006_cov_21.776185	516	596	0	80	80	1.0000000
NODE_6493_length_1006_cov_21.776185	569	649	0	32	80	0.4000000
NODE_6493_length_1006_cov_21.776185	569	649	1	1	80	0.0125000
NODE_6493_length_1006_cov_21.776185	569	649	2	47	80	0.5875000
NODE_6494_length_1006_cov_19.690187	371	451	0	80	80	1.0000000
NODE_6494_length_1006_cov_19.690187	424	504	0	80	80	1.0000000
NODE_6495_length_1006_cov_19.299890	495	575	0	80	80	1.0000000
NODE_6495_length_1006_cov_19.299890	548	628	0	80	80	1.0000000
NODE_6496_length_1006_cov_13.187431	245	325	2	55	80	0.6875000
NODE_6496_length_1006_cov_13.187431	245	325	6	22	80	0.2750000
NODE_6496_length_1006_cov_13.187431	245	325	8	3	80	0.0375000
NODE_6496_length_1006_cov_13.187431	298	378	2	2	80	0.0250000
NODE_6496_length_1006_cov_13.187431	298	378	5	45	80	0.5625000
NODE_6496_length_1006_cov_13.187431	298	378	6	30	80	0.3750000
NODE_6496_length_1006_cov_13.187431	298	378	8	3	80	0.0375000
NODE_6497_length_1006_cov_12.862183	383	463	0	80	80	1.0000000
NODE_6497_length_1006_cov_12.862183	436	516	0	80	80	1.0000000
NODE_6498_length_1006_cov_10.986770	762	842	0	80	80	1.0000000
NODE_6498_length_1006_cov_10.986770	815	895	0	80	80	1.0000000
NODE_6499_length_1006_cov_8.633958	314	394	0	34	80	0.4250000
NODE_6499_length_1006_cov_8.633958	314	394	1	11	80	0.1375000
NODE_6499_length_1006_cov_8.633958	314	394	2	35	80	0.4375000
NODE_6499_length_1006_cov_8.633958	367	447	0	80	80	1.0000000
NODE_6515_length_1005_cov_80.271523	509	589	2	25	80	0.3125000
NODE_6515_length_1005_cov_80.271523	509	589	9	1	80	0.0125000
NODE_6515_length_1005_cov_80.271523	509	589	16	13	80	0.1625000
NODE_6515_length_1005_cov_80.271523	509	589	17	1	80	0.0125000
NODE_6515_length_1005_cov_80.271523	509	589	18	40	80	0.5000000
NODE_6515_length_1005_cov_80.271523	562	642	2	31	80	0.3875000
NODE_6515_length_1005_cov_80.271523	562	642	3	1	80	0.0125000
NODE_6515_length_1005_cov_80.271523	562	642	4	46	80	0.5750000
NODE_6515_length_1005_cov_80.271523	562	642	9	1	80	0.0125000
NODE_6515_length_1005_cov_80.271523	562	642	17	1	80	0.0125000
NODE_6516_length_1005_cov_45.008830	357	437	0	80	80	1.0000000
NODE_6516_length_1005_cov_45.008830	410	490	0	80	80	1.0000000
NODE_6517_length_1005_cov_36.636865	567	647	0	17	80	0.2125000
NODE_6517_length_1005_cov_36.636865	567	647	4	12	80	0.1500000
NODE_6517_length_1005_cov_36.636865	567	647	17	1	80	0.0125000
NODE_6517_length_1005_cov_36.636865	567	647	18	50	80	0.6250000
NODE_6517_length_1005_cov_36.636865	620	700	18	80	80	1.0000000
NODE_6518_length_1005_cov_21.222958	389	409	0	20	20	1.0000000
NODE_6518_length_1005_cov_21.222958	451	519	0	6	68	0.0882353
NODE_6518_length_1005_cov_21.222958	451	519	7	2	68	0.0294118
NODE_6518_length_1005_cov_21.222958	451	519	8	60	68	0.8823529
NODE_6518_length_1005_cov_21.222958	515	595	0	80	80	1.0000000
NODE_6518_length_1005_cov_21.222958	568	648	0	80	80	1.0000000
NODE_6520_length_1005_cov_14.278146	480	560	4	25	80	0.3125000
NODE_6520_length_1005_cov_14.278146	480	560	8	55	80	0.6875000
NODE_6520_length_1005_cov_14.278146	533	613	8	80	80	1.0000000
NODE_6521_length_1005_cov_13.215232	511	591	0	80	80	1.0000000
NODE_6521_length_1005_cov_13.215232	564	644	0	80	80	1.0000000
NODE_6523_length_1005_cov_5.579470	534	614	0	2	80	0.0250000
NODE_6523_length_1005_cov_5.579470	534	614	2	78	80	0.9750000
NODE_6523_length_1005_cov_5.579470	587	667	0	37	80	0.4625000
NODE_6523_length_1005_cov_5.579470	587	667	2	43	80	0.5375000
NODE_6536_length_1004_cov_45.470718	343	423	0	17	80	0.2125000
NODE_6536_length_1004_cov_45.470718	343	423	4	63	80	0.7875000
NODE_6536_length_1004_cov_45.470718	396	476	0	70	80	0.8750000
NODE_6536_length_1004_cov_45.470718	396	476	4	10	80	0.1250000
NODE_6536_length_1004_cov_45.470718	472	552	0	80	80	1.0000000
NODE_6536_length_1004_cov_45.470718	525	605	0	80	80	1.0000000
NODE_6537_length_1004_cov_34.565746	419	499	0	80	80	1.0000000
NODE_6537_length_1004_cov_34.565746	472	552	0	80	80	1.0000000
NODE_6538_length_1004_cov_28.710497	385	465	4	80	80	1.0000000
NODE_6538_length_1004_cov_28.710497	438	518	4	78	80	0.9750000
NODE_6538_length_1004_cov_28.710497	438	518	8	2	80	0.0250000
NODE_6538_length_1004_cov_28.710497	514	594	4	80	80	1.0000000
NODE_6538_length_1004_cov_28.710497	567	647	0	26	80	0.3250000
NODE_6538_length_1004_cov_28.710497	567	647	4	54	80	0.6750000
NODE_6539_length_1004_cov_12.745856	432	512	0	80	80	1.0000000
NODE_6539_length_1004_cov_12.745856	485	565	0	80	80	1.0000000
NODE_6550_length_1003_cov_47.014381	383	463	0	80	80	1.0000000
NODE_6550_length_1003_cov_47.014381	436	516	0	58	80	0.7250000
NODE_6550_length_1003_cov_47.014381	436	516	2	22	80	0.2750000
NODE_6550_length_1003_cov_47.014381	512	592	2	13	80	0.1625000
NODE_6550_length_1003_cov_47.014381	512	592	4	67	80	0.8375000
NODE_6550_length_1003_cov_47.014381	565	645	2	32	80	0.4000000
NODE_6550_length_1003_cov_47.014381	565	645	4	48	80	0.6000000
NODE_6551_length_1003_cov_35.329646	372	452	9	10	80	0.1250000
NODE_6551_length_1003_cov_35.329646	372	452	10	7	80	0.0875000
NODE_6551_length_1003_cov_35.329646	372	452	11	22	80	0.2750000
NODE_6551_length_1003_cov_35.329646	372	452	12	41	80	0.5125000
NODE_6551_length_1003_cov_35.329646	425	505	0	19	80	0.2375000
NODE_6551_length_1003_cov_35.329646	425	505	9	27	80	0.3375000
NODE_6551_length_1003_cov_35.329646	425	505	10	14	80	0.1750000
NODE_6551_length_1003_cov_35.329646	425	505	12	20	80	0.2500000
NODE_6552_length_1003_cov_32.721239	357	437	0	14	80	0.1750000
NODE_6552_length_1003_cov_32.721239	357	437	2	66	80	0.8250000
NODE_6552_length_1003_cov_32.721239	410	490	0	67	80	0.8375000
NODE_6552_length_1003_cov_32.721239	410	490	2	13	80	0.1625000
NODE_6553_length_1003_cov_23.758850	467	547	0	7	80	0.0875000
NODE_6553_length_1003_cov_23.758850	467	547	2	12	80	0.1500000
NODE_6553_length_1003_cov_23.758850	467	547	4	61	80	0.7625000
NODE_6553_length_1003_cov_23.758850	520	600	4	50	80	0.6250000
NODE_6553_length_1003_cov_23.758850	520	600	6	30	80	0.3750000
NODE_6554_length_1003_cov_19.939159	240	320	0	80	80	1.0000000
NODE_6554_length_1003_cov_19.939159	293	373	0	80	80	1.0000000
NODE_6555_length_1003_cov_16.618363	524	604	0	80	80	1.0000000
NODE_6555_length_1003_cov_16.618363	577	657	0	80	80	1.0000000
NODE_6555_length_1003_cov_16.618363	653	733	0	80	80	1.0000000
NODE_6555_length_1003_cov_16.618363	706	786	0	80	80	1.0000000
NODE_6556_length_1003_cov_13.863938	537	617	0	77	80	0.9625000
NODE_6556_length_1003_cov_13.863938	537	617	2	3	80	0.0375000
NODE_6556_length_1003_cov_13.863938	590	670	0	24	80	0.3000000
NODE_6556_length_1003_cov_13.863938	590	670	2	56	80	0.7000000
NODE_6557_length_1003_cov_12.363938	529	609	0	80	80	1.0000000
NODE_6557_length_1003_cov_12.363938	582	662	0	80	80	1.0000000
NODE_6567_length_1002_cov_65.513843	387	467	6	64	80	0.8000000
NODE_6567_length_1002_cov_65.513843	387	467	10	16	80	0.2000000
NODE_6567_length_1002_cov_65.513843	440	520	4	44	80	0.5500000
NODE_6567_length_1002_cov_65.513843	440	520	6	11	80	0.1375000
NODE_6567_length_1002_cov_65.513843	440	520	10	25	80	0.3125000
NODE_6567_length_1002_cov_65.513843	516	596	4	17	80	0.2125000
NODE_6567_length_1002_cov_65.513843	516	596	8	34	80	0.4250000
NODE_6567_length_1002_cov_65.513843	516	596	10	17	80	0.2125000
NODE_6567_length_1002_cov_65.513843	516	596	13	4	80	0.0500000
NODE_6567_length_1002_cov_65.513843	516	596	14	8	80	0.1000000
NODE_6567_length_1002_cov_65.513843	569	649	6	11	80	0.1375000
NODE_6567_length_1002_cov_65.513843	569	649	10	59	80	0.7375000
NODE_6567_length_1002_cov_65.513843	569	649	13	2	80	0.0250000
NODE_6567_length_1002_cov_65.513843	569	649	14	8	80	0.1000000
NODE_6568_length_1002_cov_41.995570	408	488	0	80	80	1.0000000
NODE_6568_length_1002_cov_41.995570	461	541	0	80	80	1.0000000
NODE_6569_length_1002_cov_19.966777	401	481	0	80	80	1.0000000
NODE_6569_length_1002_cov_19.966777	454	534	0	80	80	1.0000000
NODE_6570_length_1002_cov_19.539313	334	414	0	80	80	1.0000000
NODE_6570_length_1002_cov_19.539313	335	414	0	79	79	1.0000000
NODE_6570_length_1002_cov_19.539313	387	467	0	80	80	1.0000000
NODE_6570_length_1002_cov_19.539313	387	467	0	80	80	1.0000000
NODE_6570_length_1002_cov_19.539313	396	467	0	71	71	1.0000000
NODE_6570_length_1002_cov_19.539313	463	543	0	80	80	1.0000000
NODE_6570_length_1002_cov_19.539313	516	596	0	80	80	1.0000000
NODE_6571_length_1002_cov_17.780731	631	711	0	18	80	0.2250000
NODE_6571_length_1002_cov_17.780731	631	711	2	62	80	0.7750000
NODE_6571_length_1002_cov_17.780731	684	764	0	52	80	0.6500000
NODE_6571_length_1002_cov_17.780731	684	764	2	28	80	0.3500000
NODE_6572_length_1002_cov_17.590255	0	58	0	58	58	1.0000000
NODE_6572_length_1002_cov_17.590255	31	77	0	46	46	1.0000000
NODE_6573_length_1002_cov_17.105205	522	602	0	80	80	1.0000000
NODE_6573_length_1002_cov_17.105205	575	655	0	80	80	1.0000000
NODE_6574_length_1002_cov_11.954596	480	560	0	4	80	0.0500000
NODE_6574_length_1002_cov_11.954596	480	560	2	76	80	0.9500000
NODE_6574_length_1002_cov_11.954596	533	613	0	57	80	0.7125000
NODE_6574_length_1002_cov_11.954596	533	613	2	23	80	0.2875000
NODE_6575_length_1002_cov_11.823920	471	551	0	80	80	1.0000000
NODE_6575_length_1002_cov_11.823920	524	614	0	90	90	1.0000000
NODE_6577_length_1002_cov_6.596899	422	502	0	80	80	1.0000000
NODE_6577_length_1002_cov_6.596899	475	555	0	80	80	1.0000000
NODE_6588_length_1002_cov_2.102990	29	110	0	18	81	0.2222222
NODE_6588_length_1002_cov_2.102990	29	110	2	63	81	0.7777778
NODE_6596_length_1001_cov_41.914634	549	629	0	48	80	0.6000000
NODE_6596_length_1001_cov_41.914634	549	629	4	32	80	0.4000000
NODE_6596_length_1001_cov_41.914634	602	682	0	5	80	0.0625000
NODE_6596_length_1001_cov_41.914634	602	682	4	75	80	0.9375000
NODE_6597_length_1001_cov_30.378049	306	386	0	57	80	0.7125000
NODE_6597_length_1001_cov_30.378049	306	386	2	6	80	0.0750000
NODE_6597_length_1001_cov_30.378049	306	386	4	17	80	0.2125000
NODE_6597_length_1001_cov_30.378049	359	439	0	4	80	0.0500000
NODE_6597_length_1001_cov_30.378049	359	439	2	6	80	0.0750000
NODE_6597_length_1001_cov_30.378049	359	439	4	70	80	0.8750000
NODE_6597_length_1001_cov_30.378049	369	439	4	70	70	1.0000000
NODE_6597_length_1001_cov_30.378049	435	515	0	30	80	0.3750000
NODE_6597_length_1001_cov_30.378049	435	515	2	43	80	0.5375000
NODE_6597_length_1001_cov_30.378049	435	515	4	7	80	0.0875000
NODE_6597_length_1001_cov_30.378049	488	568	0	36	80	0.4500000
NODE_6597_length_1001_cov_30.378049	488	568	2	44	80	0.5500000
NODE_6598_length_1001_cov_22.517738	536	616	4	5	80	0.0625000
NODE_6598_length_1001_cov_22.517738	536	616	6	75	80	0.9375000
NODE_6598_length_1001_cov_22.517738	589	670	0	23	81	0.2839506
NODE_6598_length_1001_cov_22.517738	589	670	2	21	81	0.2592593
NODE_6598_length_1001_cov_22.517738	589	670	6	37	81	0.4567901
NODE_6599_length_1001_cov_17.996674	414	456	0	42	42	1.0000000
NODE_6599_length_1001_cov_17.996674	429	509	0	80	80	1.0000000
NODE_6599_length_1001_cov_17.996674	505	585	0	80	80	1.0000000
NODE_6599_length_1001_cov_17.996674	558	638	0	80	80	1.0000000
NODE_6600_length_1001_cov_16.798226	422	502	2	80	80	1.0000000
NODE_6600_length_1001_cov_16.798226	475	555	0	44	80	0.5500000
NODE_6600_length_1001_cov_16.798226	475	555	2	36	80	0.4500000
NODE_6600_length_1001_cov_16.798226	551	631	0	80	80	1.0000000
NODE_6600_length_1001_cov_16.798226	604	684	0	80	80	1.0000000
NODE_6601_length_1001_cov_12.778271	348	428	0	4	80	0.0500000
NODE_6601_length_1001_cov_12.778271	348	428	2	76	80	0.9500000
NODE_6601_length_1001_cov_12.778271	401	481	0	57	80	0.7125000
NODE_6601_length_1001_cov_12.778271	401	481	2	23	80	0.2875000
NODE_6602_length_1001_cov_12.305987	255	335	0	80	80	1.0000000
NODE_6602_length_1001_cov_12.305987	308	388	0	80	80	1.0000000
NODE_6603_length_1001_cov_11.955654	485	569	0	84	84	1.0000000
NODE_6603_length_1001_cov_11.955654	542	622	0	80	80	1.0000000
NODE_6604_length_1001_cov_10.156319	587	667	0	80	80	1.0000000
NODE_6604_length_1001_cov_10.156319	640	720	0	80	80	1.0000000
NODE_6605_length_1001_cov_9.754989	377	457	0	80	80	1.0000000
NODE_6605_length_1001_cov_9.754989	430	510	0	80	80	1.0000000
NODE_6607_length_1001_cov_4.616408	408	488	0	80	80	1.0000000
NODE_6607_length_1001_cov_4.616408	461	541	0	80	80	1.0000000
NODE_6616_length_1000_cov_55.578246	393	473	0	80	80	1.0000000
NODE_6616_length_1000_cov_55.578246	446	526	0	80	80	1.0000000
NODE_6616_length_1000_cov_55.578246	522	598	0	76	76	1.0000000
NODE_6616_length_1000_cov_55.578246	575	649	0	74	74	1.0000000
NODE_6617_length_1000_cov_51.534961	432	512	0	80	80	1.0000000
NODE_6617_length_1000_cov_51.534961	485	565	0	80	80	1.0000000
NODE_6617_length_1000_cov_51.534961	561	641	0	80	80	1.0000000
NODE_6617_length_1000_cov_51.534961	614	694	0	80	80	1.0000000
NODE_6618_length_1000_cov_39.011099	186	266	1	1	80	0.0125000
NODE_6618_length_1000_cov_39.011099	186	266	2	15	80	0.1875000
NODE_6618_length_1000_cov_39.011099	186	266	3	58	80	0.7250000
NODE_6618_length_1000_cov_39.011099	186	266	4	6	80	0.0750000
NODE_6618_length_1000_cov_39.011099	239	319	1	48	80	0.6000000
NODE_6618_length_1000_cov_39.011099	239	319	3	32	80	0.4000000
NODE_6619_length_1000_cov_19.897891	451	531	4	7	80	0.0875000
NODE_6619_length_1000_cov_19.897891	451	531	6	2	80	0.0250000
NODE_6619_length_1000_cov_19.897891	451	531	10	56	80	0.7000000
NODE_6619_length_1000_cov_19.897891	451	531	12	15	80	0.1875000
NODE_6619_length_1000_cov_19.897891	504	584	0	5	80	0.0625000
NODE_6619_length_1000_cov_19.897891	504	584	2	42	80	0.5250000
NODE_6619_length_1000_cov_19.897891	504	584	4	13	80	0.1625000
NODE_6619_length_1000_cov_19.897891	504	584	6	2	80	0.0250000
NODE_6619_length_1000_cov_19.897891	504	584	10	3	80	0.0375000
NODE_6619_length_1000_cov_19.897891	504	584	12	15	80	0.1875000
NODE_6619_length_1000_cov_19.897891	580	660	0	80	80	1.0000000
NODE_6619_length_1000_cov_19.897891	633	713	0	80	80	1.0000000
NODE_6620_length_1000_cov_13.349612	324	404	0	5	80	0.0625000
NODE_6620_length_1000_cov_13.349612	324	404	2	75	80	0.9375000
NODE_6620_length_1000_cov_13.349612	377	457	2	80	80	1.0000000
NODE_6621_length_1000_cov_11.463929	382	462	0	80	80	1.0000000
NODE_6621_length_1000_cov_11.463929	435	515	0	80	80	1.0000000
NODE_6622_length_1000_cov_9.675916	625	705	0	80	80	1.0000000
NODE_6622_length_1000_cov_9.675916	678	758	0	80	80	1.0000000
NODE_6623_length_1000_cov_7.051054	358	438	0	80	80	1.0000000
NODE_6623_length_1000_cov_7.051054	411	491	0	80	80	1.0000000
NODE_6626_length_1000_cov_3.652608	203	265	0	17	62	0.2741936
NODE_6626_length_1000_cov_3.652608	203	265	2	45	62	0.7258065
NODE_6639_length_999_cov_47.442222	604	684	0	80	80	1.0000000
NODE_6639_length_999_cov_47.442222	657	723	0	66	66	1.0000000
NODE_6640_length_999_cov_33.055556	458	540	0	82	82	1.0000000
NODE_6640_length_999_cov_33.055556	513	593	0	80	80	1.0000000
NODE_6641_length_999_cov_22.755556	493	573	0	80	80	1.0000000
NODE_6641_length_999_cov_22.755556	546	626	0	80	80	1.0000000
NODE_6642_length_999_cov_21.842222	359	439	0	80	80	1.0000000
NODE_6642_length_999_cov_21.842222	412	492	0	80	80	1.0000000
NODE_6643_length_999_cov_20.006667	361	441	0	68	80	0.8500000
NODE_6643_length_999_cov_20.006667	361	441	2	12	80	0.1500000
NODE_6643_length_999_cov_20.006667	414	494	0	15	80	0.1875000
NODE_6643_length_999_cov_20.006667	414	494	2	41	80	0.5125000
NODE_6643_length_999_cov_20.006667	414	494	4	12	80	0.1500000
NODE_6643_length_999_cov_20.006667	414	494	6	12	80	0.1500000
NODE_6643_length_999_cov_20.006667	490	570	2	24	80	0.3000000
NODE_6643_length_999_cov_20.006667	490	570	4	42	80	0.5250000
NODE_6643_length_999_cov_20.006667	490	570	6	14	80	0.1750000
NODE_6643_length_999_cov_20.006667	543	623	0	20	80	0.2500000
NODE_6643_length_999_cov_20.006667	543	623	2	57	80	0.7125000
NODE_6643_length_999_cov_20.006667	543	623	4	3	80	0.0375000
NODE_6645_length_999_cov_16.794444	438	518	0	62	80	0.7750000
NODE_6645_length_999_cov_16.794444	438	518	2	18	80	0.2250000
NODE_6645_length_999_cov_16.794444	491	571	0	10	80	0.1250000
NODE_6645_length_999_cov_16.794444	491	571	2	70	80	0.8750000
NODE_6646_length_999_cov_15.146667	464	544	0	2	80	0.0250000
NODE_6646_length_999_cov_15.146667	464	544	2	7	80	0.0875000
NODE_6646_length_999_cov_15.146667	464	544	4	71	80	0.8875000
NODE_6646_length_999_cov_15.146667	517	597	0	9	80	0.1125000
NODE_6646_length_999_cov_15.146667	517	597	2	20	80	0.2500000
NODE_6646_length_999_cov_15.146667	517	597	4	51	80	0.6375000
NODE_6648_length_999_cov_8.771111	361	441	0	80	80	1.0000000
NODE_6648_length_999_cov_8.771111	414	492	0	78	78	1.0000000
NODE_6649_length_999_cov_5.171111	417	497	0	80	80	1.0000000
NODE_6649_length_999_cov_5.171111	470	550	0	80	80	1.0000000
NODE_6650_length_999_cov_2.854444	35	101	16	62	66	0.9393939
NODE_6650_length_999_cov_2.854444	35	101	19	4	66	0.0606061
NODE_6657_length_998_cov_30.697442	404	484	0	24	80	0.3000000
NODE_6657_length_998_cov_30.697442	404	484	2	56	80	0.7000000
NODE_6657_length_998_cov_30.697442	457	537	0	69	80	0.8625000
NODE_6657_length_998_cov_30.697442	457	537	2	3	80	0.0375000
NODE_6657_length_998_cov_30.697442	457	537	6	8	80	0.1000000
NODE_6657_length_998_cov_30.697442	533	613	6	6	80	0.0750000
NODE_6657_length_998_cov_30.697442	533	613	8	74	80	0.9250000
NODE_6657_length_998_cov_30.697442	586	666	0	33	80	0.4125000
NODE_6657_length_998_cov_30.697442	586	666	2	3	80	0.0375000
NODE_6657_length_998_cov_30.697442	586	666	8	44	80	0.5500000
NODE_6658_length_998_cov_23.703003	235	315	0	21	80	0.2625000
NODE_6658_length_998_cov_23.703003	235	315	2	59	80	0.7375000
NODE_6658_length_998_cov_23.703003	288	368	0	8	80	0.1000000
NODE_6658_length_998_cov_23.703003	288	368	1	1	80	0.0125000
NODE_6658_length_998_cov_23.703003	288	368	2	71	80	0.8875000
NODE_6659_length_998_cov_22.692992	531	611	0	80	80	1.0000000
NODE_6659_length_998_cov_22.692992	584	664	0	64	80	0.8000000
NODE_6659_length_998_cov_22.692992	584	664	2	16	80	0.2000000
NODE_6660_length_998_cov_11.152392	514	594	0	80	80	1.0000000
NODE_6660_length_998_cov_11.152392	567	640	0	51	73	0.6986302
NODE_6660_length_998_cov_11.152392	567	640	1	8	73	0.1095890
NODE_6660_length_998_cov_11.152392	567	640	2	14	73	0.1917808
NODE_6660_length_998_cov_11.152392	636	716	2	80	80	1.0000000
NODE_6660_length_998_cov_11.152392	689	769	1	1	80	0.0125000
NODE_6660_length_998_cov_11.152392	689	769	2	79	80	0.9875000
NODE_6661_length_998_cov_10.061179	422	502	0	15	80	0.1875000
NODE_6661_length_998_cov_10.061179	422	502	2	65	80	0.8125000
NODE_6661_length_998_cov_10.061179	475	555	0	5	80	0.0625000
NODE_6661_length_998_cov_10.061179	475	555	2	75	80	0.9375000
NODE_6662_length_998_cov_7.126808	353	430	0	32	77	0.4155844
NODE_6662_length_998_cov_7.126808	353	430	2	45	77	0.5844156
NODE_6662_length_998_cov_7.126808	403	483	0	7	80	0.0875000
NODE_6662_length_998_cov_7.126808	403	483	2	73	80	0.9125000
NODE_6669_length_997_cov_48.518931	445	525	26	20	80	0.2500000
NODE_6669_length_997_cov_48.518931	445	525	37	7	80	0.0875000
NODE_6669_length_997_cov_48.518931	445	525	38	53	80	0.6625000
NODE_6669_length_997_cov_48.518931	498	578	11	1	80	0.0125000
NODE_6669_length_997_cov_48.518931	498	578	12	3	80	0.0375000
NODE_6669_length_997_cov_48.518931	498	578	24	1	80	0.0125000
NODE_6669_length_997_cov_48.518931	498	578	25	16	80	0.2000000
NODE_6669_length_997_cov_48.518931	498	578	36	1	80	0.0125000
NODE_6669_length_997_cov_48.518931	498	578	37	38	80	0.4750000
NODE_6669_length_997_cov_48.518931	498	578	38	20	80	0.2500000
NODE_6670_length_997_cov_36.721604	400	480	0	80	80	1.0000000
NODE_6670_length_997_cov_36.721604	453	533	0	80	80	1.0000000
NODE_6671_length_997_cov_22.646993	328	408	0	80	80	1.0000000
NODE_6671_length_997_cov_22.646993	381	461	0	80	80	1.0000000
NODE_6672_length_997_cov_19.709354	420	500	2	32	80	0.4000000
NODE_6672_length_997_cov_19.709354	420	500	4	48	80	0.6000000
NODE_6672_length_997_cov_19.709354	473	553	0	14	80	0.1750000
NODE_6672_length_997_cov_19.709354	473	553	2	21	80	0.2625000
NODE_6672_length_997_cov_19.709354	473	553	3	4	80	0.0500000
NODE_6672_length_997_cov_19.709354	473	553	4	41	80	0.5125000
NODE_6672_length_997_cov_19.709354	549	629	0	80	80	1.0000000
NODE_6672_length_997_cov_19.709354	602	682	0	80	80	1.0000000
NODE_6673_length_997_cov_17.947661	465	545	1	6	80	0.0750000
NODE_6673_length_997_cov_17.947661	465	545	2	74	80	0.9250000
NODE_6673_length_997_cov_17.947661	518	598	1	9	80	0.1125000
NODE_6673_length_997_cov_17.947661	518	598	2	71	80	0.8875000
NODE_6673_length_997_cov_17.947661	594	674	0	53	80	0.6625000
NODE_6673_length_997_cov_17.947661	594	674	1	27	80	0.3375000
NODE_6673_length_997_cov_17.947661	647	727	0	80	80	1.0000000
NODE_6674_length_997_cov_14.718263	388	468	0	35	80	0.4375000
NODE_6674_length_997_cov_14.718263	388	468	2	34	80	0.4250000
NODE_6674_length_997_cov_14.718263	388	468	4	11	80	0.1375000
NODE_6674_length_997_cov_14.718263	441	521	0	79	80	0.9875000
NODE_6674_length_997_cov_14.718263	441	521	2	1	80	0.0125000
NODE_6675_length_997_cov_7.114699	307	387	0	80	80	1.0000000
NODE_6675_length_997_cov_7.114699	360	440	0	80	80	1.0000000
NODE_6694_length_996_cov_59.568562	387	467	0	80	80	1.0000000
NODE_6694_length_996_cov_59.568562	440	520	0	80	80	1.0000000
NODE_6695_length_996_cov_32.462653	503	583	0	31	80	0.3875000
NODE_6695_length_996_cov_32.462653	503	583	2	49	80	0.6125000
NODE_6695_length_996_cov_32.462653	556	636	0	49	80	0.6125000
NODE_6695_length_996_cov_32.462653	556	636	2	31	80	0.3875000
NODE_6696_length_996_cov_23.312152	571	651	0	80	80	1.0000000
NODE_6696_length_996_cov_23.312152	624	704	0	80	80	1.0000000
NODE_6697_length_996_cov_20.979933	533	613	0	25	80	0.3125000
NODE_6697_length_996_cov_20.979933	533	613	2	55	80	0.6875000
NODE_6697_length_996_cov_20.979933	586	666	0	15	80	0.1875000
NODE_6697_length_996_cov_20.979933	586	666	1	13	80	0.1625000
NODE_6697_length_996_cov_20.979933	586	666	2	52	80	0.6500000
NODE_6698_length_996_cov_17.865106	535	615	0	7	80	0.0875000
NODE_6698_length_996_cov_17.865106	535	615	7	1	80	0.0125000
NODE_6698_length_996_cov_17.865106	535	615	8	72	80	0.9000000
NODE_6698_length_996_cov_17.865106	588	668	0	29	80	0.3625000
NODE_6698_length_996_cov_17.865106	588	668	8	51	80	0.6375000
NODE_6699_length_996_cov_10.297659	499	579	5	7	80	0.0875000
NODE_6699_length_996_cov_10.297659	499	579	6	27	80	0.3375000
NODE_6699_length_996_cov_10.297659	499	579	8	46	80	0.5750000
NODE_6699_length_996_cov_10.297659	552	630	0	26	78	0.3333333
NODE_6699_length_996_cov_10.297659	552	630	2	25	78	0.3205128
NODE_6699_length_996_cov_10.297659	552	630	5	7	78	0.0897436
NODE_6699_length_996_cov_10.297659	552	630	8	20	78	0.2564103
NODE_6702_length_996_cov_3.205128	499	555	16	33	56	0.5892857
NODE_6702_length_996_cov_3.205128	499	555	17	23	56	0.4107143
NODE_6707_length_995_cov_26.131696	543	623	0	80	80	1.0000000
NODE_6707_length_995_cov_26.131696	596	676	0	80	80	1.0000000
NODE_6708_length_995_cov_20.262277	457	537	8	80	80	1.0000000
NODE_6708_length_995_cov_20.262277	510	590	0	22	80	0.2750000
NODE_6708_length_995_cov_20.262277	510	590	8	58	80	0.7250000
NODE_6709_length_995_cov_19.382812	457	537	0	80	80	1.0000000
NODE_6709_length_995_cov_19.382812	510	590	0	80	80	1.0000000
NODE_6710_length_995_cov_19.034598	453	533	0	80	80	1.0000000
NODE_6710_length_995_cov_19.034598	506	586	0	80	80	1.0000000
NODE_6711_length_995_cov_9.734375	222	323	0	101	101	1.0000000
NODE_6711_length_995_cov_9.734375	296	376	0	80	80	1.0000000
NODE_6723_length_994_cov_74.678212	362	442	0	80	80	1.0000000
NODE_6723_length_994_cov_74.678212	415	495	0	38	80	0.4750000
NODE_6723_length_994_cov_74.678212	415	495	10	42	80	0.5250000
NODE_6723_length_994_cov_74.678212	491	571	0	7	80	0.0875000
NODE_6723_length_994_cov_74.678212	491	571	10	73	80	0.9125000
NODE_6723_length_994_cov_74.678212	544	624	0	60	80	0.7500000
NODE_6723_length_994_cov_74.678212	544	624	10	20	80	0.2500000
NODE_6724_length_994_cov_26.045810	442	522	0	21	80	0.2625000
NODE_6724_length_994_cov_26.045810	442	522	2	31	80	0.3875000
NODE_6724_length_994_cov_26.045810	442	522	6	28	80	0.3500000
NODE_6724_length_994_cov_26.045810	495	575	0	74	80	0.9250000
NODE_6724_length_994_cov_26.045810	495	575	2	6	80	0.0750000
NODE_6725_length_994_cov_25.240223	504	584	0	72	80	0.9000000
NODE_6725_length_994_cov_25.240223	504	584	2	7	80	0.0875000
NODE_6725_length_994_cov_25.240223	504	584	4	1	80	0.0125000
NODE_6725_length_994_cov_25.240223	557	637	0	19	80	0.2375000
NODE_6725_length_994_cov_25.240223	557	637	2	7	80	0.0875000
NODE_6725_length_994_cov_25.240223	557	637	4	54	80	0.6750000
NODE_6726_length_994_cov_24.615642	422	502	0	3	80	0.0375000
NODE_6726_length_994_cov_24.615642	422	502	2	77	80	0.9625000
NODE_6726_length_994_cov_24.615642	475	555	0	40	80	0.5000000
NODE_6726_length_994_cov_24.615642	475	555	2	40	80	0.5000000
NODE_6726_length_994_cov_24.615642	551	631	0	80	80	1.0000000
NODE_6726_length_994_cov_24.615642	604	684	0	80	80	1.0000000
NODE_6727_length_994_cov_22.593296	323	403	0	55	80	0.6875000
NODE_6727_length_994_cov_22.593296	323	403	1	25	80	0.3125000
NODE_6727_length_994_cov_22.593296	376	456	0	2	80	0.0250000
NODE_6727_length_994_cov_22.593296	376	456	1	39	80	0.4875000
NODE_6727_length_994_cov_22.593296	376	456	2	39	80	0.4875000
NODE_6727_length_994_cov_22.593296	452	532	1	4	80	0.0500000
NODE_6727_length_994_cov_22.593296	452	532	2	76	80	0.9500000
NODE_6727_length_994_cov_22.593296	505	585	0	18	80	0.2250000
NODE_6727_length_994_cov_22.593296	505	585	1	39	80	0.4875000
NODE_6727_length_994_cov_22.593296	505	585	2	23	80	0.2875000
NODE_6728_length_994_cov_6.985475	0	58	0	39	58	0.6724138
NODE_6728_length_994_cov_6.985475	0	58	2	19	58	0.3275862
NODE_6728_length_994_cov_6.985475	15	95	0	24	80	0.3000000
NODE_6728_length_994_cov_6.985475	15	95	2	56	80	0.7000000
NODE_6728_length_994_cov_6.985475	68	148	2	80	80	1.0000000
NODE_6740_length_993_cov_56.321029	266	346	2	56	80	0.7000000
NODE_6740_length_993_cov_56.321029	266	346	4	24	80	0.3000000
NODE_6740_length_993_cov_56.321029	319	399	0	23	80	0.2875000
NODE_6740_length_993_cov_56.321029	319	399	2	52	80	0.6500000
NODE_6740_length_993_cov_56.321029	319	399	4	5	80	0.0625000
NODE_6740_length_993_cov_56.321029	400	470	0	70	70	1.0000000
NODE_6740_length_993_cov_56.321029	443	523	0	30	80	0.3750000
NODE_6740_length_993_cov_56.321029	443	523	4	50	80	0.6250000
NODE_6741_length_993_cov_44.695749	385	465	0	14	80	0.1750000
NODE_6741_length_993_cov_44.695749	385	465	3	1	80	0.0125000
NODE_6741_length_993_cov_44.695749	385	465	4	25	80	0.3125000
NODE_6741_length_993_cov_44.695749	385	465	6	40	80	0.5000000
NODE_6741_length_993_cov_44.695749	438	518	2	4	80	0.0500000
NODE_6741_length_993_cov_44.695749	438	518	6	76	80	0.9500000
NODE_6742_length_993_cov_40.574944	417	497	10	80	80	1.0000000
NODE_6742_length_993_cov_40.574944	470	550	0	16	80	0.2000000
NODE_6742_length_993_cov_40.574944	470	550	10	64	80	0.8000000
NODE_6742_length_993_cov_40.574944	546	628	0	82	82	1.0000000
NODE_6742_length_993_cov_40.574944	601	681	0	80	80	1.0000000
NODE_6743_length_993_cov_39.817673	3	83	5	18	80	0.2250000
NODE_6743_length_993_cov_39.817673	3	83	6	62	80	0.7750000
NODE_6744_length_993_cov_30.128635	477	557	0	80	80	1.0000000
NODE_6744_length_993_cov_30.128635	530	610	0	80	80	1.0000000
NODE_6745_length_993_cov_17.435123	573	653	0	80	80	1.0000000
NODE_6745_length_993_cov_17.435123	626	706	0	80	80	1.0000000
NODE_6746_length_993_cov_13.074944	483	563	0	48	80	0.6000000
NODE_6746_length_993_cov_13.074944	483	563	4	32	80	0.4000000
NODE_6746_length_993_cov_13.074944	536	616	4	80	80	1.0000000
NODE_6747_length_993_cov_10.190157	500	580	0	80	80	1.0000000
NODE_6747_length_993_cov_10.190157	553	633	0	80	80	1.0000000
NODE_6756_length_993_cov_0.909396	16	73	0	57	57	1.0000000
NODE_6757_length_992_cov_36.119821	354	434	0	80	80	1.0000000
NODE_6757_length_992_cov_36.119821	407	487	0	80	80	1.0000000
NODE_6757_length_992_cov_36.119821	483	563	0	26	80	0.3250000
NODE_6757_length_992_cov_36.119821	483	563	3	1	80	0.0125000
NODE_6757_length_992_cov_36.119821	483	563	6	34	80	0.4250000
NODE_6757_length_992_cov_36.119821	483	563	8	19	80	0.2375000
NODE_6757_length_992_cov_36.119821	536	616	6	8	80	0.1000000
NODE_6757_length_992_cov_36.119821	536	616	8	72	80	0.9000000
NODE_6758_length_992_cov_34.802912	443	523	0	16	80	0.2000000
NODE_6758_length_992_cov_34.802912	443	523	2	64	80	0.8000000
NODE_6758_length_992_cov_34.802912	496	576	0	8	80	0.1000000
NODE_6758_length_992_cov_34.802912	496	576	2	72	80	0.9000000
NODE_6759_length_992_cov_33.047032	381	461	0	80	80	1.0000000
NODE_6759_length_992_cov_33.047032	434	514	0	80	80	1.0000000
NODE_6759_length_992_cov_33.047032	510	590	0	80	80	1.0000000
NODE_6759_length_992_cov_33.047032	563	643	0	80	80	1.0000000
NODE_6760_length_992_cov_23.543113	435	515	2	80	80	1.0000000
NODE_6760_length_992_cov_23.543113	488	568	0	36	80	0.4500000
NODE_6760_length_992_cov_23.543113	488	568	2	44	80	0.5500000
NODE_6761_length_992_cov_22.608063	440	520	0	80	80	1.0000000
NODE_6761_length_992_cov_22.608063	493	573	0	80	80	1.0000000
NODE_6762_length_992_cov_21.427772	216	296	0	80	80	1.0000000
NODE_6762_length_992_cov_21.427772	269	349	0	80	80	1.0000000
NODE_6763_length_992_cov_20.010078	312	392	0	2	80	0.0250000
NODE_6763_length_992_cov_20.010078	312	392	10	78	80	0.9750000
NODE_6763_length_992_cov_20.010078	365	445	0	4	80	0.0500000
NODE_6763_length_992_cov_20.010078	365	445	7	1	80	0.0125000
NODE_6763_length_992_cov_20.010078	365	445	9	2	80	0.0250000
NODE_6763_length_992_cov_20.010078	365	445	10	73	80	0.9125000
NODE_6764_length_992_cov_16.524076	465	545	0	28	80	0.3500000
NODE_6764_length_992_cov_16.524076	465	545	6	17	80	0.2125000
NODE_6764_length_992_cov_16.524076	465	545	8	35	80	0.4375000
NODE_6764_length_992_cov_16.524076	518	598	2	13	80	0.1625000
NODE_6764_length_992_cov_16.524076	518	598	8	67	80	0.8375000
NODE_6765_length_992_cov_16.266517	396	476	2	80	80	1.0000000
NODE_6765_length_992_cov_16.266517	449	529	0	43	80	0.5375000
NODE_6765_length_992_cov_16.266517	449	529	2	37	80	0.4625000
NODE_6766_length_992_cov_16.146697	272	352	0	11	80	0.1375000
NODE_6766_length_992_cov_16.146697	272	352	2	69	80	0.8625000
NODE_6766_length_992_cov_16.146697	325	405	0	57	80	0.7125000
NODE_6766_length_992_cov_16.146697	325	405	2	23	80	0.2875000
NODE_6767_length_992_cov_15.212766	354	434	3	80	80	1.0000000
NODE_6767_length_992_cov_15.212766	407	487	1	29	80	0.3625000
NODE_6767_length_992_cov_15.212766	407	487	3	43	80	0.5375000
NODE_6767_length_992_cov_15.212766	407	487	9	8	80	0.1000000
NODE_6767_length_992_cov_15.212766	483	563	5	2	80	0.0250000
NODE_6767_length_992_cov_15.212766	483	563	8	6	80	0.0750000
NODE_6767_length_992_cov_15.212766	483	563	9	29	80	0.3625000
NODE_6767_length_992_cov_15.212766	483	563	11	43	80	0.5375000
NODE_6767_length_992_cov_15.212766	536	616	4	38	80	0.4750000
NODE_6767_length_992_cov_15.212766	536	616	5	6	80	0.0750000
NODE_6767_length_992_cov_15.212766	536	616	6	11	80	0.1375000
NODE_6767_length_992_cov_15.212766	536	616	11	25	80	0.3125000
NODE_6781_length_991_cov_48.582960	451	531	0	26	80	0.3250000
NODE_6781_length_991_cov_48.582960	451	531	2	12	80	0.1500000
NODE_6781_length_991_cov_48.582960	451	531	4	39	80	0.4875000
NODE_6781_length_991_cov_48.582960	451	531	6	3	80	0.0375000
NODE_6781_length_991_cov_48.582960	504	584	2	29	80	0.3625000
NODE_6781_length_991_cov_48.582960	504	584	4	26	80	0.3250000
NODE_6781_length_991_cov_48.582960	504	584	6	25	80	0.3125000
NODE_6782_length_991_cov_25.891256	340	420	0	80	80	1.0000000
NODE_6782_length_991_cov_25.891256	393	473	0	80	80	1.0000000
NODE_6782_length_991_cov_25.891256	469	549	0	80	80	1.0000000
NODE_6782_length_991_cov_25.891256	522	602	0	80	80	1.0000000
NODE_6783_length_991_cov_25.392377	377	457	0	29	80	0.3625000
NODE_6783_length_991_cov_25.392377	377	457	4	51	80	0.6375000
NODE_6783_length_991_cov_25.392377	430	510	4	80	80	1.0000000
NODE_6783_length_991_cov_25.392377	506	586	0	10	80	0.1250000
NODE_6783_length_991_cov_25.392377	506	586	4	70	80	0.8750000
NODE_6783_length_991_cov_25.392377	559	639	4	47	80	0.5875000
NODE_6783_length_991_cov_25.392377	559	639	8	33	80	0.4125000
NODE_6784_length_991_cov_22.210762	421	501	0	80	80	1.0000000
NODE_6784_length_991_cov_22.210762	474	554	0	76	80	0.9500000
NODE_6784_length_991_cov_22.210762	474	554	2	4	80	0.0500000
NODE_6785_length_991_cov_18.008969	366	446	0	21	80	0.2625000
NODE_6785_length_991_cov_18.008969	366	446	2	59	80	0.7375000
NODE_6785_length_991_cov_18.008969	419	499	0	58	80	0.7250000
NODE_6785_length_991_cov_18.008969	419	499	2	22	80	0.2750000
NODE_6785_length_991_cov_18.008969	495	575	0	59	80	0.7375000
NODE_6785_length_991_cov_18.008969	495	575	4	21	80	0.2625000
NODE_6785_length_991_cov_18.008969	548	629	0	6	81	0.0740741
NODE_6785_length_991_cov_18.008969	548	629	4	75	81	0.9259259
NODE_6786_length_991_cov_14.727578	426	506	3	22	80	0.2750000
NODE_6786_length_991_cov_14.727578	426	506	4	6	80	0.0750000
NODE_6786_length_991_cov_14.727578	426	506	6	21	80	0.2625000
NODE_6786_length_991_cov_14.727578	426	506	8	31	80	0.3875000
NODE_6786_length_991_cov_14.727578	479	559	6	41	80	0.5125000
NODE_6786_length_991_cov_14.727578	479	559	8	39	80	0.4875000
NODE_6787_length_991_cov_13.081839	240	320	0	76	80	0.9500000
NODE_6787_length_991_cov_13.081839	240	320	2	4	80	0.0500000
NODE_6787_length_991_cov_13.081839	293	373	0	23	80	0.2875000
NODE_6787_length_991_cov_13.081839	293	373	2	10	80	0.1250000
NODE_6787_length_991_cov_13.081839	293	373	8	47	80	0.5875000
NODE_6788_length_991_cov_12.693946	425	505	0	80	80	1.0000000
NODE_6788_length_991_cov_12.693946	478	558	0	80	80	1.0000000
NODE_6789_length_991_cov_9.647982	436	516	5	57	80	0.7125000
NODE_6789_length_991_cov_9.647982	436	516	6	23	80	0.2875000
NODE_6789_length_991_cov_9.647982	489	569	2	41	80	0.5125000
NODE_6789_length_991_cov_9.647982	489	569	4	7	80	0.0875000
NODE_6789_length_991_cov_9.647982	489	569	5	27	80	0.3375000
NODE_6789_length_991_cov_9.647982	489	569	6	5	80	0.0625000
NODE_6790_length_991_cov_5.176009	538	618	0	9	80	0.1125000
NODE_6790_length_991_cov_5.176009	538	618	2	71	80	0.8875000
NODE_6790_length_991_cov_5.176009	591	671	0	17	80	0.2125000
NODE_6790_length_991_cov_5.176009	591	671	2	63	80	0.7875000
NODE_6801_length_990_cov_39.386083	402	482	0	28	80	0.3500000
NODE_6801_length_990_cov_39.386083	402	482	6	52	80	0.6500000
NODE_6801_length_990_cov_39.386083	455	535	0	21	80	0.2625000
NODE_6801_length_990_cov_39.386083	455	535	5	2	80	0.0250000
NODE_6801_length_990_cov_39.386083	455	535	6	57	80	0.7125000
NODE_6802_length_990_cov_35.993266	321	401	0	80	80	1.0000000
NODE_6802_length_990_cov_35.993266	374	454	0	65	80	0.8125000
NODE_6802_length_990_cov_35.993266	374	454	4	15	80	0.1875000
NODE_6802_length_990_cov_35.993266	450	530	4	48	80	0.6000000
NODE_6802_length_990_cov_35.993266	450	530	6	32	80	0.4000000
NODE_6802_length_990_cov_35.993266	503	583	0	13	80	0.1625000
NODE_6802_length_990_cov_35.993266	503	583	2	37	80	0.4625000
NODE_6802_length_990_cov_35.993266	503	583	6	30	80	0.3750000
NODE_6803_length_990_cov_24.445567	588	668	0	80	80	1.0000000
NODE_6803_length_990_cov_24.445567	641	721	0	80	80	1.0000000
NODE_6805_length_990_cov_22.378227	430	510	0	39	80	0.4875000
NODE_6805_length_990_cov_22.378227	430	510	2	41	80	0.5125000
NODE_6805_length_990_cov_22.378227	483	563	0	80	80	1.0000000
NODE_6806_length_990_cov_20.150393	408	488	0	38	80	0.4750000
NODE_6806_length_990_cov_20.150393	408	488	6	42	80	0.5250000
NODE_6806_length_990_cov_20.150393	461	541	6	80	80	1.0000000
NODE_6807_length_990_cov_18.154882	434	514	4	75	80	0.9375000
NODE_6807_length_990_cov_18.154882	434	514	8	5	80	0.0625000
NODE_6807_length_990_cov_18.154882	487	567	4	77	80	0.9625000
NODE_6807_length_990_cov_18.154882	487	567	8	3	80	0.0375000
NODE_6808_length_990_cov_17.250281	329	409	0	80	80	1.0000000
NODE_6808_length_990_cov_17.250281	382	462	0	80	80	1.0000000
NODE_6808_length_990_cov_17.250281	458	538	0	80	80	1.0000000
NODE_6808_length_990_cov_17.250281	511	591	0	80	80	1.0000000
NODE_6809_length_990_cov_14.977553	448	528	0	80	80	1.0000000
NODE_6809_length_990_cov_14.977553	501	581	0	80	80	1.0000000
NODE_6810_length_990_cov_13.846240	482	562	0	80	80	1.0000000
NODE_6810_length_990_cov_13.846240	535	615	0	80	80	1.0000000
NODE_6821_length_990_cov_0.978676	79	151	2	1	72	0.0138889
NODE_6821_length_990_cov_0.978676	79	151	4	11	72	0.1527778
NODE_6821_length_990_cov_0.978676	79	151	6	60	72	0.8333333
NODE_6821_length_990_cov_0.978676	82	152	2	2	70	0.0285714
NODE_6821_length_990_cov_0.978676	82	152	4	11	70	0.1571429
NODE_6821_length_990_cov_0.978676	82	152	6	57	70	0.8142857
NODE_6823_length_989_cov_45.902247	47	127	6	1	80	0.0125000
NODE_6823_length_989_cov_45.902247	47	127	16	2	80	0.0250000
NODE_6823_length_989_cov_45.902247	47	127	22	1	80	0.0125000
NODE_6823_length_989_cov_45.902247	47	127	28	2	80	0.0250000
NODE_6823_length_989_cov_45.902247	47	127	30	1	80	0.0125000
NODE_6823_length_989_cov_45.902247	47	127	31	1	80	0.0125000
NODE_6823_length_989_cov_45.902247	47	127	37	3	80	0.0375000
NODE_6823_length_989_cov_45.902247	47	127	43	4	80	0.0500000
NODE_6823_length_989_cov_45.902247	47	127	45	3	80	0.0375000
NODE_6823_length_989_cov_45.902247	47	127	47	4	80	0.0500000
NODE_6823_length_989_cov_45.902247	47	127	49	26	80	0.3250000
NODE_6823_length_989_cov_45.902247	47	127	50	32	80	0.4000000
NODE_6823_length_989_cov_45.902247	330	410	0	80	80	1.0000000
NODE_6823_length_989_cov_45.902247	383	463	0	80	80	1.0000000
NODE_6824_length_989_cov_35.430337	412	492	0	12	80	0.1500000
NODE_6824_length_989_cov_35.430337	412	492	2	53	80	0.6625000
NODE_6824_length_989_cov_35.430337	412	492	4	15	80	0.1875000
NODE_6824_length_989_cov_35.430337	465	545	2	65	80	0.8125000
NODE_6824_length_989_cov_35.430337	465	545	4	15	80	0.1875000
NODE_6825_length_989_cov_30.124719	477	557	0	17	80	0.2125000
NODE_6825_length_989_cov_30.124719	477	557	2	52	80	0.6500000
NODE_6825_length_989_cov_30.124719	477	557	4	11	80	0.1375000
NODE_6825_length_989_cov_30.124719	530	610	0	70	80	0.8750000
NODE_6825_length_989_cov_30.124719	530	610	2	10	80	0.1250000
NODE_6826_length_989_cov_29.347191	447	527	4	38	80	0.4750000
NODE_6826_length_989_cov_29.347191	447	527	5	33	80	0.4125000
NODE_6826_length_989_cov_29.347191	447	527	6	9	80	0.1125000
NODE_6826_length_989_cov_29.347191	500	580	0	21	80	0.2625000
NODE_6826_length_989_cov_29.347191	500	580	2	21	80	0.2625000
NODE_6826_length_989_cov_29.347191	500	580	4	38	80	0.4750000
NODE_6826_length_989_cov_29.347191	576	656	0	80	80	1.0000000
NODE_6826_length_989_cov_29.347191	629	709	0	70	80	0.8750000
NODE_6826_length_989_cov_29.347191	629	709	2	10	80	0.1250000
NODE_6827_length_989_cov_27.886517	245	325	0	80	80	1.0000000
NODE_6827_length_989_cov_27.886517	298	378	0	80	80	1.0000000
NODE_6827_length_989_cov_27.886517	374	454	0	80	80	1.0000000
NODE_6827_length_989_cov_27.886517	427	507	0	80	80	1.0000000
NODE_6828_length_989_cov_27.515730	393	473	0	5	80	0.0625000
NODE_6828_length_989_cov_27.515730	393	473	2	11	80	0.1375000
NODE_6828_length_989_cov_27.515730	393	473	6	4	80	0.0500000
NODE_6828_length_989_cov_27.515730	393	473	8	55	80	0.6875000
NODE_6828_length_989_cov_27.515730	393	473	9	1	80	0.0125000
NODE_6828_length_989_cov_27.515730	393	473	10	4	80	0.0500000
NODE_6828_length_989_cov_27.515730	446	526	2	7	80	0.0875000
NODE_6828_length_989_cov_27.515730	446	526	6	4	80	0.0500000
NODE_6828_length_989_cov_27.515730	446	526	8	56	80	0.7000000
NODE_6828_length_989_cov_27.515730	446	526	9	1	80	0.0125000
NODE_6828_length_989_cov_27.515730	446	526	10	12	80	0.1500000
NODE_6828_length_989_cov_27.515730	522	602	0	20	80	0.2500000
NODE_6828_length_989_cov_27.515730	522	602	2	60	80	0.7500000
NODE_6828_length_989_cov_27.515730	575	655	0	73	80	0.9125000
NODE_6828_length_989_cov_27.515730	575	655	2	7	80	0.0875000
NODE_6829_length_989_cov_23.844944	312	392	0	42	80	0.5250000
NODE_6829_length_989_cov_23.844944	312	392	8	38	80	0.4750000
NODE_6829_length_989_cov_23.844944	365	445	8	80	80	1.0000000
NODE_6830_length_989_cov_23.131461	475	555	1	80	80	1.0000000
NODE_6830_length_989_cov_23.131461	528	608	1	76	80	0.9500000
NODE_6830_length_989_cov_23.131461	528	608	2	4	80	0.0500000
NODE_6831_length_989_cov_20.189888	500	580	0	4	80	0.0500000
NODE_6831_length_989_cov_20.189888	500	580	2	76	80	0.9500000
NODE_6831_length_989_cov_20.189888	553	633	0	4	80	0.0500000
NODE_6831_length_989_cov_20.189888	553	633	2	76	80	0.9500000
NODE_6832_length_989_cov_18.429213	190	270	0	80	80	1.0000000
NODE_6832_length_989_cov_18.429213	258	323	0	65	65	1.0000000
NODE_6832_length_989_cov_18.429213	319	399	0	16	80	0.2000000
NODE_6832_length_989_cov_18.429213	319	399	1	9	80	0.1125000
NODE_6832_length_989_cov_18.429213	319	399	2	55	80	0.6875000
NODE_6832_length_989_cov_18.429213	372	412	2	40	40	1.0000000
NODE_6833_length_989_cov_10.307865	433	513	0	40	80	0.5000000
NODE_6833_length_989_cov_10.307865	433	513	2	40	80	0.5000000
NODE_6833_length_989_cov_10.307865	486	570	0	17	84	0.2023810
NODE_6833_length_989_cov_10.307865	486	570	2	67	84	0.7976190
NODE_6833_length_989_cov_10.307865	566	642	0	32	76	0.4210526
NODE_6833_length_989_cov_10.307865	566	642	2	44	76	0.5789474
NODE_6833_length_989_cov_10.307865	615	695	2	80	80	1.0000000
NODE_6834_length_989_cov_8.941573	528	608	0	80	80	1.0000000
NODE_6834_length_989_cov_8.941573	581	661	0	80	80	1.0000000
NODE_6835_length_989_cov_5.132584	459	524	0	65	65	1.0000000
NODE_6838_length_989_cov_2.540449	703	783	0	80	80	1.0000000
NODE_6845_length_988_cov_52.168729	361	441	0	68	80	0.8500000
NODE_6845_length_988_cov_52.168729	361	441	2	12	80	0.1500000
NODE_6845_length_988_cov_52.168729	414	494	0	15	80	0.1875000
NODE_6845_length_988_cov_52.168729	414	494	2	65	80	0.8125000
NODE_6845_length_988_cov_52.168729	490	570	0	40	80	0.5000000
NODE_6845_length_988_cov_52.168729	490	570	2	40	80	0.5000000
NODE_6845_length_988_cov_52.168729	543	623	0	80	80	1.0000000
NODE_6846_length_988_cov_36.733408	390	470	0	8	80	0.1000000
NODE_6846_length_988_cov_36.733408	390	470	2	25	80	0.3125000
NODE_6846_length_988_cov_36.733408	390	470	4	47	80	0.5875000
NODE_6846_length_988_cov_36.733408	443	523	0	12	80	0.1500000
NODE_6846_length_988_cov_36.733408	443	523	2	32	80	0.4000000
NODE_6846_length_988_cov_36.733408	443	523	4	36	80	0.4500000
NODE_6847_length_988_cov_36.221597	478	558	0	80	80	1.0000000
NODE_6847_length_988_cov_36.221597	531	611	0	80	80	1.0000000
NODE_6848_length_988_cov_25.895388	389	469	0	38	80	0.4750000
NODE_6848_length_988_cov_25.895388	389	469	2	42	80	0.5250000
NODE_6848_length_988_cov_25.895388	442	522	0	80	80	1.0000000
NODE_6848_length_988_cov_25.895388	518	598	0	80	80	1.0000000
NODE_6848_length_988_cov_25.895388	571	651	0	80	80	1.0000000
NODE_6849_length_988_cov_20.250844	423	503	0	2	80	0.0250000
NODE_6849_length_988_cov_20.250844	423	503	6	78	80	0.9750000
NODE_6849_length_988_cov_20.250844	476	556	0	55	80	0.6875000
NODE_6849_length_988_cov_20.250844	476	556	6	25	80	0.3125000
NODE_6850_length_988_cov_15.812148	474	554	0	38	80	0.4750000
NODE_6850_length_988_cov_15.812148	474	554	2	42	80	0.5250000
NODE_6850_length_988_cov_15.812148	527	607	0	18	80	0.2250000
NODE_6850_length_988_cov_15.812148	527	607	2	62	80	0.7750000
NODE_6851_length_988_cov_15.082115	435	517	0	82	82	1.0000000
NODE_6851_length_988_cov_15.082115	490	570	0	80	80	1.0000000
NODE_6852_length_988_cov_14.697413	467	547	2	28	80	0.3500000
NODE_6852_length_988_cov_14.697413	467	547	4	31	80	0.3875000
NODE_6852_length_988_cov_14.697413	467	547	6	21	80	0.2625000
NODE_6852_length_988_cov_14.697413	520	600	0	41	80	0.5125000
NODE_6852_length_988_cov_14.697413	520	600	2	39	80	0.4875000
NODE_6853_length_988_cov_7.730034	562	642	0	80	80	1.0000000
NODE_6853_length_988_cov_7.730034	615	695	0	80	80	1.0000000
NODE_6862_length_987_cov_42.784910	383	476	0	93	93	1.0000000
NODE_6862_length_987_cov_42.784910	449	529	0	80	80	1.0000000
NODE_6863_length_987_cov_39.716216	290	370	6	80	80	1.0000000
NODE_6863_length_987_cov_39.716216	343	423	2	6	80	0.0750000
NODE_6863_length_987_cov_39.716216	343	423	6	54	80	0.6750000
NODE_6863_length_987_cov_39.716216	343	423	8	20	80	0.2500000
NODE_6863_length_987_cov_39.716216	419	499	0	2	80	0.0250000
NODE_6863_length_987_cov_39.716216	419	499	2	78	80	0.9750000
NODE_6863_length_987_cov_39.716216	472	552	0	2	80	0.0250000
NODE_6863_length_987_cov_39.716216	472	552	2	78	80	0.9750000
NODE_6864_length_987_cov_28.171171	406	486	0	80	80	1.0000000
NODE_6864_length_987_cov_28.171171	459	539	0	80	80	1.0000000
NODE_6864_length_987_cov_28.171171	535	615	0	80	80	1.0000000
NODE_6864_length_987_cov_28.171171	588	668	0	80	80	1.0000000
NODE_6865_length_987_cov_23.627252	331	411	0	15	80	0.1875000
NODE_6865_length_987_cov_23.627252	331	411	2	65	80	0.8125000
NODE_6865_length_987_cov_23.627252	384	464	0	15	80	0.1875000
NODE_6865_length_987_cov_23.627252	384	464	2	65	80	0.8125000
NODE_6866_length_987_cov_18.797297	437	517	0	2	80	0.0250000
NODE_6866_length_987_cov_18.797297	437	517	4	3	80	0.0375000
NODE_6866_length_987_cov_18.797297	437	517	6	75	80	0.9375000
NODE_6866_length_987_cov_18.797297	490	570	0	16	80	0.2000000
NODE_6866_length_987_cov_18.797297	490	570	2	6	80	0.0750000
NODE_6866_length_987_cov_18.797297	490	570	6	58	80	0.7250000
NODE_6867_length_987_cov_15.628378	369	449	0	80	80	1.0000000
NODE_6867_length_987_cov_15.628378	422	502	0	80	80	1.0000000
NODE_6868_length_987_cov_15.439189	438	518	2	80	80	1.0000000
NODE_6868_length_987_cov_15.439189	491	571	0	22	80	0.2750000
NODE_6868_length_987_cov_15.439189	491	571	2	58	80	0.7250000
NODE_6869_length_987_cov_14.343468	506	586	0	80	80	1.0000000
NODE_6869_length_987_cov_14.343468	559	639	0	80	80	1.0000000
NODE_6870_length_987_cov_13.515766	475	555	0	48	80	0.6000000
NODE_6870_length_987_cov_13.515766	475	555	4	32	80	0.4000000
NODE_6870_length_987_cov_13.515766	528	608	4	80	80	1.0000000
NODE_6871_length_987_cov_9.521396	408	482	1	17	74	0.2297297
NODE_6871_length_987_cov_9.521396	408	482	2	57	74	0.7702703
NODE_6871_length_987_cov_9.521396	455	535	0	28	80	0.3500000
NODE_6871_length_987_cov_9.521396	455	535	1	42	80	0.5250000
NODE_6871_length_987_cov_9.521396	455	535	2	10	80	0.1250000
NODE_6872_length_987_cov_9.054054	440	520	0	80	80	1.0000000
NODE_6872_length_987_cov_9.054054	493	573	0	80	80	1.0000000
NODE_6875_length_987_cov_5.378378	509	589	0	80	80	1.0000000
NODE_6875_length_987_cov_5.378378	562	642	0	80	80	1.0000000
NODE_6889_length_986_cov_36.937993	327	407	0	80	80	1.0000000
NODE_6889_length_986_cov_36.937993	380	460	0	80	80	1.0000000
NODE_6889_length_986_cov_36.937993	456	536	0	80	80	1.0000000
NODE_6889_length_986_cov_36.937993	509	589	0	80	80	1.0000000
NODE_6890_length_986_cov_35.130778	325	405	0	36	80	0.4500000
NODE_6890_length_986_cov_35.130778	325	405	3	16	80	0.2000000
NODE_6890_length_986_cov_35.130778	325	405	6	28	80	0.3500000
NODE_6890_length_986_cov_35.130778	378	458	6	80	80	1.0000000
NODE_6890_length_986_cov_35.130778	454	534	2	1	80	0.0125000
NODE_6890_length_986_cov_35.130778	454	534	5	17	80	0.2125000
NODE_6890_length_986_cov_35.130778	454	534	6	24	80	0.3000000
NODE_6890_length_986_cov_35.130778	454	534	8	38	80	0.4750000
NODE_6890_length_986_cov_35.130778	507	587	2	16	80	0.2000000
NODE_6890_length_986_cov_35.130778	507	587	4	38	80	0.4750000
NODE_6890_length_986_cov_35.130778	507	587	5	17	80	0.2125000
NODE_6890_length_986_cov_35.130778	507	587	8	9	80	0.1125000
NODE_6891_length_986_cov_24.037204	602	682	0	80	80	1.0000000
NODE_6891_length_986_cov_24.037204	655	735	0	80	80	1.0000000
NODE_6891_length_986_cov_24.037204	731	811	0	22	80	0.2750000
NODE_6891_length_986_cov_24.037204	731	811	8	58	80	0.7250000
NODE_6891_length_986_cov_24.037204	784	864	0	15	80	0.1875000
NODE_6891_length_986_cov_24.037204	784	864	2	6	80	0.0750000
NODE_6891_length_986_cov_24.037204	784	864	3	1	80	0.0125000
NODE_6891_length_986_cov_24.037204	784	864	4	1	80	0.0125000
NODE_6891_length_986_cov_24.037204	784	864	7	1	80	0.0125000
NODE_6891_length_986_cov_24.037204	784	864	8	56	80	0.7000000
NODE_6892_length_986_cov_20.591883	395	475	2	38	80	0.4750000
NODE_6892_length_986_cov_20.591883	395	475	4	42	80	0.5250000
NODE_6892_length_986_cov_20.591883	448	528	0	48	80	0.6000000
NODE_6892_length_986_cov_20.591883	448	528	2	32	80	0.4000000
NODE_6893_length_986_cov_16.815107	389	469	0	40	80	0.5000000
NODE_6893_length_986_cov_16.815107	389	469	4	40	80	0.5000000
NODE_6893_length_986_cov_16.815107	442	522	4	80	80	1.0000000
NODE_6894_length_986_cov_11.021421	474	554	0	33	80	0.4125000
NODE_6894_length_986_cov_11.021421	474	554	2	47	80	0.5875000
NODE_6894_length_986_cov_11.021421	527	607	0	25	80	0.3125000
NODE_6894_length_986_cov_11.021421	527	607	2	55	80	0.6875000
NODE_6905_length_985_cov_41.707675	443	523	0	63	80	0.7875000
NODE_6905_length_985_cov_41.707675	443	523	2	4	80	0.0500000
NODE_6905_length_985_cov_41.707675	443	523	5	13	80	0.1625000
NODE_6905_length_985_cov_41.707675	496	576	0	10	80	0.1250000
NODE_6905_length_985_cov_41.707675	496	576	2	4	80	0.0500000
NODE_6905_length_985_cov_41.707675	496	576	5	30	80	0.3750000
NODE_6905_length_985_cov_41.707675	496	576	6	36	80	0.4500000
NODE_6911_length_984_cov_64.531073	412	481	0	69	69	1.0000000
NODE_6911_length_984_cov_64.531073	454	534	0	46	80	0.5750000
NODE_6911_length_984_cov_64.531073	454	534	2	34	80	0.4250000
NODE_6911_length_984_cov_64.531073	475	555	0	25	80	0.3125000
NODE_6911_length_984_cov_64.531073	475	555	2	54	80	0.6750000
NODE_6911_length_984_cov_64.531073	475	555	4	1	80	0.0125000
NODE_6911_length_984_cov_64.531073	528	608	2	39	80	0.4875000
NODE_6911_length_984_cov_64.531073	528	608	4	41	80	0.5125000
NODE_6911_length_984_cov_64.531073	549	629	2	39	80	0.4875000
NODE_6911_length_984_cov_64.531073	549	629	4	41	80	0.5125000
NODE_6912_length_984_cov_28.832768	430	510	0	80	80	1.0000000
NODE_6912_length_984_cov_28.832768	483	563	0	80	80	1.0000000
NODE_6913_length_984_cov_27.247458	203	283	0	80	80	1.0000000
NODE_6913_length_984_cov_27.247458	256	336	0	80	80	1.0000000
NODE_6913_length_984_cov_27.247458	332	412	0	80	80	1.0000000
NODE_6913_length_984_cov_27.247458	385	465	0	80	80	1.0000000
NODE_6914_length_984_cov_25.944633	483	563	0	80	80	1.0000000
NODE_6914_length_984_cov_25.944633	536	616	0	29	80	0.3625000
NODE_6914_length_984_cov_25.944633	536	616	2	51	80	0.6375000
NODE_6915_length_984_cov_16.611299	351	431	5	1	80	0.0125000
NODE_6915_length_984_cov_16.611299	351	431	6	79	80	0.9875000
NODE_6915_length_984_cov_16.611299	404	484	0	50	80	0.6250000
NODE_6915_length_984_cov_16.611299	404	484	6	30	80	0.3750000
NODE_6917_length_984_cov_6.414689	415	495	0	80	80	1.0000000
NODE_6917_length_984_cov_6.414689	468	548	0	48	80	0.6000000
NODE_6917_length_984_cov_6.414689	468	548	2	32	80	0.4000000
NODE_6918_length_984_cov_4.720904	494	574	0	80	80	1.0000000
NODE_6918_length_984_cov_4.720904	547	627	0	80	80	1.0000000
NODE_6927_length_984_cov_1.333333	922	971	6	1	49	0.0204082
NODE_6927_length_984_cov_1.333333	922	971	8	4	49	0.0816327
NODE_6927_length_984_cov_1.333333	922	971	10	10	49	0.2040816
NODE_6927_length_984_cov_1.333333	922	971	12	6	49	0.1224490
NODE_6927_length_984_cov_1.333333	922	971	16	28	49	0.5714286
NODE_6931_length_983_cov_34.566742	466	546	0	80	80	1.0000000
NODE_6931_length_983_cov_34.566742	519	599	0	80	80	1.0000000
NODE_6932_length_983_cov_26.011312	449	529	0	80	80	1.0000000
NODE_6932_length_983_cov_26.011312	502	582	0	80	80	1.0000000
NODE_6932_length_983_cov_26.011312	578	658	0	80	80	1.0000000
NODE_6932_length_983_cov_26.011312	631	711	0	36	80	0.4500000
NODE_6932_length_983_cov_26.011312	631	711	4	44	80	0.5500000
NODE_6933_length_983_cov_24.694570	539	619	0	80	80	1.0000000
NODE_6933_length_983_cov_24.694570	592	672	0	80	80	1.0000000
NODE_6934_length_983_cov_22.214932	395	475	0	80	80	1.0000000
NODE_6934_length_983_cov_22.214932	448	528	0	80	80	1.0000000
NODE_6935_length_983_cov_19.132353	377	457	0	80	80	1.0000000
NODE_6935_length_983_cov_19.132353	430	510	0	80	80	1.0000000
NODE_6936_length_983_cov_16.875566	419	499	0	15	80	0.1875000
NODE_6936_length_983_cov_16.875566	419	499	1	16	80	0.2000000
NODE_6936_length_983_cov_16.875566	419	499	2	49	80	0.6125000
NODE_6936_length_983_cov_16.875566	472	552	2	80	80	1.0000000
NODE_6936_length_983_cov_16.875566	548	628	0	19	80	0.2375000
NODE_6936_length_983_cov_16.875566	548	628	1	16	80	0.2000000
NODE_6936_length_983_cov_16.875566	548	628	2	45	80	0.5625000
NODE_6936_length_983_cov_16.875566	601	681	0	18	80	0.2250000
NODE_6936_length_983_cov_16.875566	601	681	2	62	80	0.7750000
NODE_6937_length_983_cov_7.240950	487	567	0	80	80	1.0000000
NODE_6937_length_983_cov_7.240950	540	620	0	80	80	1.0000000
NODE_6949_length_982_cov_30.750849	357	437	0	20	80	0.2500000
NODE_6949_length_982_cov_30.750849	357	437	3	34	80	0.4250000
NODE_6949_length_982_cov_30.750849	357	437	6	26	80	0.3250000
NODE_6949_length_982_cov_30.750849	410	490	3	1	80	0.0125000
NODE_6949_length_982_cov_30.750849	410	490	6	79	80	0.9875000
NODE_6950_length_982_cov_29.901472	516	596	0	80	80	1.0000000
NODE_6950_length_982_cov_29.901472	569	649	0	80	80	1.0000000
NODE_6951_length_982_cov_18.251416	356	436	0	1	80	0.0125000
NODE_6951_length_982_cov_18.251416	356	436	4	79	80	0.9875000
NODE_6951_length_982_cov_18.251416	409	489	2	21	80	0.2625000
NODE_6951_length_982_cov_18.251416	409	489	4	40	80	0.5000000
NODE_6951_length_982_cov_18.251416	409	489	6	19	80	0.2375000
NODE_6951_length_982_cov_18.251416	485	565	0	37	80	0.4625000
NODE_6951_length_982_cov_18.251416	485	565	2	43	80	0.5375000
NODE_6951_length_982_cov_18.251416	538	618	0	80	80	1.0000000
NODE_6952_length_982_cov_13.840317	608	688	0	80	80	1.0000000
NODE_6952_length_982_cov_13.840317	661	741	0	62	80	0.7750000
NODE_6952_length_982_cov_13.840317	661	741	2	18	80	0.2250000
NODE_6953_length_982_cov_13.227633	317	397	0	80	80	1.0000000
NODE_6953_length_982_cov_13.227633	370	450	0	80	80	1.0000000
NODE_6954_length_982_cov_10.918460	209	289	6	46	80	0.5750000
NODE_6954_length_982_cov_10.918460	209	289	8	34	80	0.4250000
NODE_6954_length_982_cov_10.918460	262	342	0	15	80	0.1875000
NODE_6954_length_982_cov_10.918460	262	342	2	5	80	0.0625000
NODE_6954_length_982_cov_10.918460	262	342	5	17	80	0.2125000
NODE_6954_length_982_cov_10.918460	262	342	8	43	80	0.5375000
NODE_6956_length_982_cov_7.210646	216	296	0	80	80	1.0000000
NODE_6956_length_982_cov_7.210646	269	349	0	80	80	1.0000000
NODE_6973_length_981_cov_55.260771	410	490	0	80	80	1.0000000
NODE_6973_length_981_cov_55.260771	463	543	0	80	80	1.0000000
NODE_6973_length_981_cov_55.260771	539	619	0	80	80	1.0000000
NODE_6973_length_981_cov_55.260771	592	672	0	80	80	1.0000000
NODE_6974_length_981_cov_33.287982	362	441	0	79	79	1.0000000
NODE_6974_length_981_cov_33.287982	414	495	0	81	81	1.0000000
NODE_6974_length_981_cov_33.287982	491	571	0	58	80	0.7250000
NODE_6974_length_981_cov_33.287982	491	571	2	22	80	0.2750000
NODE_6974_length_981_cov_33.287982	544	624	0	5	80	0.0625000
NODE_6974_length_981_cov_33.287982	544	624	2	75	80	0.9375000
NODE_6975_length_981_cov_33.121315	269	349	2	52	80	0.6500000
NODE_6975_length_981_cov_33.121315	269	349	4	28	80	0.3500000
NODE_6975_length_981_cov_33.121315	322	402	0	4	80	0.0500000
NODE_6975_length_981_cov_33.121315	322	402	2	56	80	0.7000000
NODE_6975_length_981_cov_33.121315	322	402	4	20	80	0.2500000
NODE_6975_length_981_cov_33.121315	398	478	0	23	80	0.2875000
NODE_6975_length_981_cov_33.121315	398	478	2	57	80	0.7125000
NODE_6975_length_981_cov_33.121315	451	531	0	76	80	0.9500000
NODE_6975_length_981_cov_33.121315	451	531	2	4	80	0.0500000
NODE_6976_length_981_cov_26.732426	397	477	0	52	80	0.6500000
NODE_6976_length_981_cov_26.732426	397	477	2	28	80	0.3500000
NODE_6976_length_981_cov_26.732426	450	530	2	80	80	1.0000000
NODE_6977_length_981_cov_24.304989	390	470	0	76	80	0.9500000
NODE_6977_length_981_cov_24.304989	390	470	4	4	80	0.0500000
NODE_6977_length_981_cov_24.304989	443	523	0	23	80	0.2875000
NODE_6977_length_981_cov_24.304989	443	523	4	57	80	0.7125000
NODE_6978_length_981_cov_10.485261	363	443	0	80	80	1.0000000
NODE_6978_length_981_cov_10.485261	416	496	0	80	80	1.0000000
NODE_6980_length_981_cov_5.328798	821	885	4	54	64	0.8437500
NODE_6980_length_981_cov_5.328798	821	885	6	10	64	0.1562500
NODE_6980_length_981_cov_5.328798	847	884	4	27	37	0.7297297
NODE_6980_length_981_cov_5.328798	847	884	6	10	37	0.2702703
NODE_6998_length_980_cov_40.710556	329	409	0	53	80	0.6625000
NODE_6998_length_980_cov_40.710556	329	409	2	27	80	0.3375000
NODE_6998_length_980_cov_40.710556	382	462	0	80	80	1.0000000
NODE_6998_length_980_cov_40.710556	458	538	0	80	80	1.0000000
NODE_6998_length_980_cov_40.710556	511	591	0	80	80	1.0000000
NODE_6999_length_980_cov_37.634506	666	746	0	39	80	0.4875000
NODE_6999_length_980_cov_37.634506	666	746	10	41	80	0.5125000
NODE_6999_length_980_cov_37.634506	719	799	10	80	80	1.0000000
NODE_7000_length_980_cov_36.261067	331	411	2	80	80	1.0000000
NODE_7000_length_980_cov_36.261067	384	453	2	69	69	1.0000000
NODE_7000_length_980_cov_36.261067	465	545	0	80	80	1.0000000
NODE_7000_length_980_cov_36.261067	518	598	0	80	80	1.0000000
NODE_7001_length_980_cov_28.514188	430	510	0	80	80	1.0000000
NODE_7001_length_980_cov_28.514188	483	563	0	80	80	1.0000000
NODE_7002_length_980_cov_25.205448	497	577	2	80	80	1.0000000
NODE_7002_length_980_cov_25.205448	550	630	0	15	80	0.1875000
NODE_7002_length_980_cov_25.205448	550	630	2	65	80	0.8125000
NODE_7003_length_980_cov_24.321226	417	497	0	80	80	1.0000000
NODE_7003_length_980_cov_24.321226	470	550	0	80	80	1.0000000
NODE_7004_length_980_cov_20.460840	388	468	0	80	80	1.0000000
NODE_7004_length_980_cov_20.460840	441	521	0	80	80	1.0000000
NODE_7005_length_980_cov_19.969353	486	566	0	11	80	0.1375000
NODE_7005_length_980_cov_19.969353	486	566	5	1	80	0.0125000
NODE_7005_length_980_cov_19.969353	486	566	7	17	80	0.2125000
NODE_7005_length_980_cov_19.969353	486	566	14	17	80	0.2125000
NODE_7005_length_980_cov_19.969353	486	566	16	34	80	0.4250000
NODE_7005_length_980_cov_19.969353	539	619	13	17	80	0.2125000
NODE_7005_length_980_cov_19.969353	539	619	15	5	80	0.0625000
NODE_7005_length_980_cov_19.969353	539	619	16	58	80	0.7250000
NODE_7006_length_980_cov_13.736663	350	430	0	80	80	1.0000000
NODE_7006_length_980_cov_13.736663	403	483	0	80	80	1.0000000
NODE_7006_length_980_cov_13.736663	479	559	0	80	80	1.0000000
NODE_7006_length_980_cov_13.736663	532	612	0	80	80	1.0000000
NODE_7008_length_980_cov_10.842225	517	597	0	22	80	0.2750000
NODE_7008_length_980_cov_10.842225	517	597	1	35	80	0.4375000
NODE_7008_length_980_cov_10.842225	517	597	2	23	80	0.2875000
NODE_7008_length_980_cov_10.842225	570	650	1	4	80	0.0500000
NODE_7008_length_980_cov_10.842225	570	650	2	76	80	0.9500000
NODE_7009_length_980_cov_10.087401	341	424	0	83	83	1.0000000
NODE_7009_length_980_cov_10.087401	397	477	0	73	80	0.9125000
NODE_7009_length_980_cov_10.087401	397	477	2	7	80	0.0875000
NODE_7010_length_980_cov_9.643587	267	347	0	80	80	1.0000000
NODE_7010_length_980_cov_9.643587	320	400	0	80	80	1.0000000
NODE_7010_length_980_cov_9.643587	396	476	0	80	80	1.0000000
NODE_7010_length_980_cov_9.643587	449	529	0	80	80	1.0000000
NODE_7026_length_979_cov_22.576136	442	522	0	80	80	1.0000000
NODE_7026_length_979_cov_22.576136	495	575	0	80	80	1.0000000
NODE_7027_length_979_cov_19.739773	445	524	0	38	79	0.4810127
NODE_7027_length_979_cov_19.739773	445	524	2	41	79	0.5189874
NODE_7027_length_979_cov_19.739773	497	577	0	80	80	1.0000000
NODE_7028_length_979_cov_19.480682	436	516	0	57	80	0.7125000
NODE_7028_length_979_cov_19.480682	436	516	10	23	80	0.2875000
NODE_7028_length_979_cov_19.480682	489	569	0	80	80	1.0000000
NODE_7028_length_979_cov_19.480682	565	645	0	4	80	0.0500000
NODE_7028_length_979_cov_19.480682	565	645	2	76	80	0.9500000
NODE_7028_length_979_cov_19.480682	618	698	0	28	80	0.3500000
NODE_7028_length_979_cov_19.480682	618	698	2	52	80	0.6500000
NODE_7029_length_979_cov_18.901136	470	550	0	80	80	1.0000000
NODE_7029_length_979_cov_18.901136	523	603	0	80	80	1.0000000
NODE_7031_length_979_cov_3.519318	101	168	8	23	67	0.3432836
NODE_7031_length_979_cov_3.519318	101	168	10	2	67	0.0298507
NODE_7031_length_979_cov_3.519318	101	168	12	2	67	0.0298507
NODE_7031_length_979_cov_3.519318	101	168	16	34	67	0.5074627
NODE_7031_length_979_cov_3.519318	101	168	18	6	67	0.0895522
NODE_7040_length_978_cov_23.195677	424	504	0	80	80	1.0000000
NODE_7040_length_978_cov_23.195677	477	557	0	80	80	1.0000000
NODE_7041_length_978_cov_18.866894	440	520	0	2	80	0.0250000
NODE_7041_length_978_cov_18.866894	440	520	2	78	80	0.9750000
NODE_7041_length_978_cov_18.866894	493	573	0	55	80	0.6875000
NODE_7041_length_978_cov_18.866894	493	573	2	25	80	0.3125000
NODE_7042_length_978_cov_15.614334	341	421	0	80	80	1.0000000
NODE_7042_length_978_cov_15.614334	394	474	0	80	80	1.0000000
NODE_7042_length_978_cov_15.614334	470	550	0	80	80	1.0000000
NODE_7042_length_978_cov_15.614334	523	603	0	80	80	1.0000000
NODE_7043_length_978_cov_15.253697	327	407	0	80	80	1.0000000
NODE_7043_length_978_cov_15.253697	380	460	0	80	80	1.0000000
NODE_7043_length_978_cov_15.253697	456	536	0	80	80	1.0000000
NODE_7043_length_978_cov_15.253697	509	589	0	80	80	1.0000000
NODE_7044_length_978_cov_14.730375	407	487	0	80	80	1.0000000
NODE_7044_length_978_cov_14.730375	460	540	0	80	80	1.0000000
NODE_7045_length_978_cov_7.257110	571	651	0	80	80	1.0000000
NODE_7045_length_978_cov_7.257110	624	704	0	80	80	1.0000000
NODE_7062_length_977_cov_47.484055	427	507	24	80	80	1.0000000
NODE_7062_length_977_cov_47.484055	480	560	14	1	80	0.0125000
NODE_7062_length_977_cov_47.484055	480	560	23	34	80	0.4250000
NODE_7062_length_977_cov_47.484055	480	560	24	40	80	0.5000000
NODE_7062_length_977_cov_47.484055	480	560	25	5	80	0.0625000
NODE_7063_length_977_cov_47.116173	428	508	0	80	80	1.0000000
NODE_7063_length_977_cov_47.116173	481	561	0	64	80	0.8000000
NODE_7063_length_977_cov_47.116173	481	561	2	16	80	0.2000000
NODE_7063_length_977_cov_47.116173	557	637	0	14	80	0.1750000
NODE_7063_length_977_cov_47.116173	557	637	2	66	80	0.8250000
NODE_7063_length_977_cov_47.116173	610	690	0	67	80	0.8375000
NODE_7063_length_977_cov_47.116173	610	690	2	13	80	0.1625000
NODE_7064_length_977_cov_32.542141	486	566	0	29	80	0.3625000
NODE_7064_length_977_cov_32.542141	486	566	4	51	80	0.6375000
NODE_7064_length_977_cov_32.542141	539	619	0	31	80	0.3875000
NODE_7064_length_977_cov_32.542141	539	619	4	49	80	0.6125000
NODE_7065_length_977_cov_30.676538	361	441	0	80	80	1.0000000
NODE_7065_length_977_cov_30.676538	414	494	0	80	80	1.0000000
NODE_7066_length_977_cov_28.348519	455	535	0	11	80	0.1375000
NODE_7066_length_977_cov_28.348519	455	535	6	69	80	0.8625000
NODE_7066_length_977_cov_28.348519	508	588	0	64	80	0.8000000
NODE_7066_length_977_cov_28.348519	508	588	6	16	80	0.2000000
NODE_7067_length_977_cov_26.571754	343	423	0	80	80	1.0000000
NODE_7067_length_977_cov_26.571754	396	476	0	80	80	1.0000000
NODE_7067_length_977_cov_26.571754	472	552	0	80	80	1.0000000
NODE_7067_length_977_cov_26.571754	525	600	0	75	75	1.0000000
NODE_7068_length_977_cov_24.898633	470	550	0	80	80	1.0000000
NODE_7068_length_977_cov_24.898633	523	603	0	80	80	1.0000000
NODE_7069_length_977_cov_22.986333	313	393	0	52	80	0.6500000
NODE_7069_length_977_cov_22.986333	313	393	6	28	80	0.3500000
NODE_7069_length_977_cov_22.986333	366	446	6	80	80	1.0000000
NODE_7069_length_977_cov_22.986333	442	522	0	56	80	0.7000000
NODE_7069_length_977_cov_22.986333	442	522	6	24	80	0.3000000
NODE_7069_length_977_cov_22.986333	495	575	0	80	80	1.0000000
NODE_7070_length_977_cov_10.753986	290	370	0	80	80	1.0000000
NODE_7070_length_977_cov_10.753986	343	423	0	80	80	1.0000000
NODE_7071_length_977_cov_9.924829	401	456	4	5	55	0.0909091
NODE_7071_length_977_cov_9.924829	401	456	6	20	55	0.3636364
NODE_7071_length_977_cov_9.924829	401	456	10	30	55	0.5454546
NODE_7073_length_977_cov_6.391800	483	563	0	80	80	1.0000000
NODE_7073_length_977_cov_6.391800	536	616	0	80	80	1.0000000
NODE_7075_length_977_cov_2.907745	191	241	4	9	50	0.1800000
NODE_7075_length_977_cov_2.907745	191	241	8	21	50	0.4200000
NODE_7075_length_977_cov_2.907745	191	241	10	20	50	0.4000000
NODE_7085_length_976_cov_38.192702	326	406	0	80	80	1.0000000
NODE_7085_length_976_cov_38.192702	379	459	0	46	80	0.5750000
NODE_7085_length_976_cov_38.192702	379	459	2	34	80	0.4250000
NODE_7085_length_976_cov_38.192702	455	535	2	67	80	0.8375000
NODE_7085_length_976_cov_38.192702	455	535	4	13	80	0.1625000
NODE_7085_length_976_cov_38.192702	455	536	2	68	81	0.8395061
NODE_7085_length_976_cov_38.192702	455	536	4	13	81	0.1604938
NODE_7085_length_976_cov_38.192702	455	519	2	51	64	0.7968750
NODE_7085_length_976_cov_38.192702	455	519	4	13	64	0.2031250
NODE_7085_length_976_cov_38.192702	508	588	0	29	80	0.3625000
NODE_7085_length_976_cov_38.192702	508	588	2	51	80	0.6375000
NODE_7086_length_976_cov_26.275941	499	579	0	80	80	1.0000000
NODE_7086_length_976_cov_26.275941	552	632	0	80	80	1.0000000
NODE_7087_length_976_cov_25.559863	376	456	7	20	80	0.2500000
NODE_7087_length_976_cov_25.559863	376	456	8	60	80	0.7500000
NODE_7087_length_976_cov_25.559863	429	509	0	43	80	0.5375000
NODE_7087_length_976_cov_25.559863	429	509	6	6	80	0.0750000
NODE_7087_length_976_cov_25.559863	429	509	7	24	80	0.3000000
NODE_7087_length_976_cov_25.559863	429	509	8	7	80	0.0875000
NODE_7088_length_976_cov_17.961231	572	652	0	80	80	1.0000000
NODE_7088_length_976_cov_17.961231	625	705	0	80	80	1.0000000
NODE_7089_length_976_cov_5.567845	789	851	6	4	62	0.0645161
NODE_7089_length_976_cov_5.567845	789	851	8	58	62	0.9354839
NODE_7089_length_976_cov_5.567845	842	904	0	5	62	0.0806452
NODE_7089_length_976_cov_5.567845	842	904	1	23	62	0.3709677
NODE_7089_length_976_cov_5.567845	842	904	3	3	62	0.0483871
NODE_7089_length_976_cov_5.567845	842	904	4	15	62	0.2419355
NODE_7089_length_976_cov_5.567845	842	904	8	16	62	0.2580645
NODE_7101_length_975_cov_192.211187	722	802	105	1	80	0.0125000
NODE_7101_length_975_cov_192.211187	722	802	108	2	80	0.0250000
NODE_7101_length_975_cov_192.211187	722	802	109	3	80	0.0375000
NODE_7101_length_975_cov_192.211187	722	802	111	2	80	0.0250000
NODE_7101_length_975_cov_192.211187	722	802	113	5	80	0.0625000
NODE_7101_length_975_cov_192.211187	722	802	114	7	80	0.0875000
NODE_7101_length_975_cov_192.211187	722	802	115	2	80	0.0250000
NODE_7101_length_975_cov_192.211187	722	802	116	4	80	0.0500000
NODE_7101_length_975_cov_192.211187	722	802	117	3	80	0.0375000
NODE_7101_length_975_cov_192.211187	722	802	118	1	80	0.0125000
NODE_7101_length_975_cov_192.211187	722	802	119	3	80	0.0375000
NODE_7101_length_975_cov_192.211187	722	802	120	4	80	0.0500000
NODE_7101_length_975_cov_192.211187	722	802	121	1	80	0.0125000
NODE_7101_length_975_cov_192.211187	722	802	122	5	80	0.0625000
NODE_7101_length_975_cov_192.211187	722	802	123	12	80	0.1500000
NODE_7101_length_975_cov_192.211187	722	802	124	1	80	0.0125000
NODE_7101_length_975_cov_192.211187	722	802	125	7	80	0.0875000
NODE_7101_length_975_cov_192.211187	722	802	126	3	80	0.0375000
NODE_7101_length_975_cov_192.211187	722	802	128	3	80	0.0375000
NODE_7101_length_975_cov_192.211187	722	802	129	1	80	0.0125000
NODE_7101_length_975_cov_192.211187	722	802	131	4	80	0.0500000
NODE_7101_length_975_cov_192.211187	722	802	132	2	80	0.0250000
NODE_7101_length_975_cov_192.211187	722	802	133	2	80	0.0250000
NODE_7101_length_975_cov_192.211187	722	802	134	2	80	0.0250000
NODE_7102_length_975_cov_41.446347	414	494	0	80	80	1.0000000
NODE_7102_length_975_cov_41.446347	467	547	0	80	80	1.0000000
NODE_7103_length_975_cov_37.618721	375	455	0	42	80	0.5250000
NODE_7103_length_975_cov_37.618721	375	455	2	38	80	0.4750000
NODE_7103_length_975_cov_37.618721	428	508	2	47	80	0.5875000
NODE_7103_length_975_cov_37.618721	428	508	4	33	80	0.4125000
NODE_7104_length_975_cov_34.265982	424	504	0	80	80	1.0000000
NODE_7104_length_975_cov_34.265982	477	557	0	80	80	1.0000000
NODE_7105_length_975_cov_31.888128	461	541	0	1	80	0.0125000
NODE_7105_length_975_cov_31.888128	461	541	2	79	80	0.9875000
NODE_7105_length_975_cov_31.888128	514	594	0	54	80	0.6750000
NODE_7105_length_975_cov_31.888128	514	594	2	26	80	0.3250000
NODE_7106_length_975_cov_22.093607	392	472	0	66	80	0.8250000
NODE_7106_length_975_cov_22.093607	392	472	2	14	80	0.1750000
NODE_7106_length_975_cov_22.093607	445	525	0	80	80	1.0000000
NODE_7107_length_975_cov_15.091324	403	483	0	80	80	1.0000000
NODE_7107_length_975_cov_15.091324	456	536	0	80	80	1.0000000
NODE_7108_length_975_cov_15.046804	63	143	0	53	80	0.6625000
NODE_7108_length_975_cov_15.046804	63	143	2	27	80	0.3375000
NODE_7108_length_975_cov_15.046804	116	196	2	80	80	1.0000000
NODE_7109_length_975_cov_12.043379	535	615	0	67	80	0.8375000
NODE_7109_length_975_cov_12.043379	535	615	2	13	80	0.1625000
NODE_7109_length_975_cov_12.043379	588	668	0	24	80	0.3000000
NODE_7109_length_975_cov_12.043379	588	668	2	56	80	0.7000000
NODE_7110_length_975_cov_11.772831	276	354	0	7	78	0.0897436
NODE_7110_length_975_cov_11.772831	276	354	2	71	78	0.9102564
NODE_7110_length_975_cov_11.772831	327	407	2	80	80	1.0000000
NODE_7111_length_975_cov_10.599315	405	485	0	80	80	1.0000000
NODE_7111_length_975_cov_10.599315	458	538	0	80	80	1.0000000
NODE_7112_length_975_cov_8.089041	430	510	0	80	80	1.0000000
NODE_7112_length_975_cov_8.089041	483	563	0	80	80	1.0000000
NODE_7114_length_975_cov_3.728311	254	334	0	80	80	1.0000000
NODE_7114_length_975_cov_3.728311	307	387	0	80	80	1.0000000
NODE_7125_length_974_cov_293.334857	564	642	611	1	78	0.0128205
NODE_7125_length_974_cov_293.334857	564	642	612	1	78	0.0128205
NODE_7125_length_974_cov_293.334857	564	642	613	3	78	0.0384615
NODE_7125_length_974_cov_293.334857	564	642	614	1	78	0.0128205
NODE_7125_length_974_cov_293.334857	564	642	615	1	78	0.0128205
NODE_7125_length_974_cov_293.334857	564	642	619	1	78	0.0128205
NODE_7125_length_974_cov_293.334857	564	642	626	2	78	0.0256410
NODE_7125_length_974_cov_293.334857	564	642	628	2	78	0.0256410
NODE_7125_length_974_cov_293.334857	564	642	629	4	78	0.0512821
NODE_7125_length_974_cov_293.334857	564	642	630	2	78	0.0256410
NODE_7125_length_974_cov_293.334857	564	642	631	4	78	0.0512821
NODE_7125_length_974_cov_293.334857	564	642	632	2	78	0.0256410
NODE_7125_length_974_cov_293.334857	564	642	633	1	78	0.0128205
NODE_7125_length_974_cov_293.334857	564	642	634	1	78	0.0128205
NODE_7125_length_974_cov_293.334857	564	642	636	3	78	0.0384615
NODE_7125_length_974_cov_293.334857	564	642	637	3	78	0.0384615
NODE_7125_length_974_cov_293.334857	564	642	638	1	78	0.0128205
NODE_7125_length_974_cov_293.334857	564	642	639	1	78	0.0128205
NODE_7125_length_974_cov_293.334857	564	642	640	1	78	0.0128205
NODE_7125_length_974_cov_293.334857	564	642	641	3	78	0.0384615
NODE_7125_length_974_cov_293.334857	564	642	642	1	78	0.0128205
NODE_7125_length_974_cov_293.334857	564	642	643	2	78	0.0256410
NODE_7125_length_974_cov_293.334857	564	642	644	2	78	0.0256410
NODE_7125_length_974_cov_293.334857	564	642	645	1	78	0.0128205
NODE_7125_length_974_cov_293.334857	564	642	646	2	78	0.0256410
NODE_7125_length_974_cov_293.334857	564	642	648	4	78	0.0512821
NODE_7125_length_974_cov_293.334857	564	642	649	2	78	0.0256410
NODE_7125_length_974_cov_293.334857	564	642	650	1	78	0.0128205
NODE_7125_length_974_cov_293.334857	564	642	651	2	78	0.0256410
NODE_7125_length_974_cov_293.334857	564	642	653	2	78	0.0256410
NODE_7125_length_974_cov_293.334857	564	642	656	2	78	0.0256410
NODE_7125_length_974_cov_293.334857	564	642	659	1	78	0.0128205
NODE_7125_length_974_cov_293.334857	564	642	667	1	78	0.0128205
NODE_7125_length_974_cov_293.334857	564	642	683	1	78	0.0128205
NODE_7125_length_974_cov_293.334857	564	642	691	1	78	0.0128205
NODE_7125_length_974_cov_293.334857	564	642	708	1	78	0.0128205
NODE_7125_length_974_cov_293.334857	564	642	724	1	78	0.0128205
NODE_7125_length_974_cov_293.334857	564	642	731	1	78	0.0128205
NODE_7125_length_974_cov_293.334857	564	642	733	1	78	0.0128205
NODE_7125_length_974_cov_293.334857	564	642	739	1	78	0.0128205
NODE_7125_length_974_cov_293.334857	564	642	748	1	78	0.0128205
NODE_7125_length_974_cov_293.334857	564	642	768	1	78	0.0128205
NODE_7125_length_974_cov_293.334857	564	642	782	1	78	0.0128205
NODE_7125_length_974_cov_293.334857	564	642	785	1	78	0.0128205
NODE_7125_length_974_cov_293.334857	564	642	787	1	78	0.0128205
NODE_7125_length_974_cov_293.334857	564	642	788	1	78	0.0128205
NODE_7125_length_974_cov_293.334857	564	642	791	2	78	0.0256410
NODE_7125_length_974_cov_293.334857	564	642	794	1	78	0.0128205
NODE_7125_length_974_cov_293.334857	564	642	796	1	78	0.0128205
NODE_7125_length_974_cov_293.334857	564	642	611	1	78	0.0128205
NODE_7125_length_974_cov_293.334857	564	642	612	1	78	0.0128205
NODE_7125_length_974_cov_293.334857	564	642	613	3	78	0.0384615
NODE_7125_length_974_cov_293.334857	564	642	614	1	78	0.0128205
NODE_7125_length_974_cov_293.334857	564	642	615	1	78	0.0128205
NODE_7125_length_974_cov_293.334857	564	642	619	1	78	0.0128205
NODE_7125_length_974_cov_293.334857	564	642	626	2	78	0.0256410
NODE_7125_length_974_cov_293.334857	564	642	628	2	78	0.0256410
NODE_7125_length_974_cov_293.334857	564	642	629	4	78	0.0512821
NODE_7125_length_974_cov_293.334857	564	642	630	2	78	0.0256410
NODE_7125_length_974_cov_293.334857	564	642	631	4	78	0.0512821
NODE_7125_length_974_cov_293.334857	564	642	632	2	78	0.0256410
NODE_7125_length_974_cov_293.334857	564	642	633	1	78	0.0128205
NODE_7125_length_974_cov_293.334857	564	642	634	1	78	0.0128205
NODE_7125_length_974_cov_293.334857	564	642	636	3	78	0.0384615
NODE_7125_length_974_cov_293.334857	564	642	637	3	78	0.0384615
NODE_7125_length_974_cov_293.334857	564	642	638	1	78	0.0128205
NODE_7125_length_974_cov_293.334857	564	642	639	1	78	0.0128205
NODE_7125_length_974_cov_293.334857	564	642	640	1	78	0.0128205
NODE_7125_length_974_cov_293.334857	564	642	641	3	78	0.0384615
NODE_7125_length_974_cov_293.334857	564	642	642	1	78	0.0128205
NODE_7125_length_974_cov_293.334857	564	642	643	2	78	0.0256410
NODE_7125_length_974_cov_293.334857	564	642	644	2	78	0.0256410
NODE_7125_length_974_cov_293.334857	564	642	645	1	78	0.0128205
NODE_7125_length_974_cov_293.334857	564	642	646	2	78	0.0256410
NODE_7125_length_974_cov_293.334857	564	642	648	4	78	0.0512821
NODE_7125_length_974_cov_293.334857	564	642	649	2	78	0.0256410
NODE_7125_length_974_cov_293.334857	564	642	650	1	78	0.0128205
NODE_7125_length_974_cov_293.334857	564	642	651	2	78	0.0256410
NODE_7125_length_974_cov_293.334857	564	642	653	2	78	0.0256410
NODE_7125_length_974_cov_293.334857	564	642	656	2	78	0.0256410
NODE_7125_length_974_cov_293.334857	564	642	659	1	78	0.0128205
NODE_7125_length_974_cov_293.334857	564	642	667	1	78	0.0128205
NODE_7125_length_974_cov_293.334857	564	642	683	1	78	0.0128205
NODE_7125_length_974_cov_293.334857	564	642	691	1	78	0.0128205
NODE_7125_length_974_cov_293.334857	564	642	708	1	78	0.0128205
NODE_7125_length_974_cov_293.334857	564	642	724	1	78	0.0128205
NODE_7125_length_974_cov_293.334857	564	642	731	1	78	0.0128205
NODE_7125_length_974_cov_293.334857	564	642	733	1	78	0.0128205
NODE_7125_length_974_cov_293.334857	564	642	739	1	78	0.0128205
NODE_7125_length_974_cov_293.334857	564	642	748	1	78	0.0128205
NODE_7125_length_974_cov_293.334857	564	642	768	1	78	0.0128205
NODE_7125_length_974_cov_293.334857	564	642	782	1	78	0.0128205
NODE_7125_length_974_cov_293.334857	564	642	785	1	78	0.0128205
NODE_7125_length_974_cov_293.334857	564	642	787	1	78	0.0128205
NODE_7125_length_974_cov_293.334857	564	642	788	1	78	0.0128205
NODE_7125_length_974_cov_293.334857	564	642	791	2	78	0.0256410
NODE_7125_length_974_cov_293.334857	564	642	794	1	78	0.0128205
NODE_7125_length_974_cov_293.334857	564	642	796	1	78	0.0128205
NODE_7125_length_974_cov_293.334857	564	633	611	1	69	0.0144928
NODE_7125_length_974_cov_293.334857	564	633	612	1	69	0.0144928
NODE_7125_length_974_cov_293.334857	564	633	613	3	69	0.0434783
NODE_7125_length_974_cov_293.334857	564	633	614	1	69	0.0144928
NODE_7125_length_974_cov_293.334857	564	633	615	1	69	0.0144928
NODE_7125_length_974_cov_293.334857	564	633	619	1	69	0.0144928
NODE_7125_length_974_cov_293.334857	564	633	626	2	69	0.0289855
NODE_7125_length_974_cov_293.334857	564	633	628	2	69	0.0289855
NODE_7125_length_974_cov_293.334857	564	633	629	3	69	0.0434783
NODE_7125_length_974_cov_293.334857	564	633	630	2	69	0.0289855
NODE_7125_length_974_cov_293.334857	564	633	631	4	69	0.0579710
NODE_7125_length_974_cov_293.334857	564	633	632	2	69	0.0289855
NODE_7125_length_974_cov_293.334857	564	633	634	1	69	0.0144928
NODE_7125_length_974_cov_293.334857	564	633	636	1	69	0.0144928
NODE_7125_length_974_cov_293.334857	564	633	639	1	69	0.0144928
NODE_7125_length_974_cov_293.334857	564	633	640	1	69	0.0144928
NODE_7125_length_974_cov_293.334857	564	633	641	3	69	0.0434783
NODE_7125_length_974_cov_293.334857	564	633	642	1	69	0.0144928
NODE_7125_length_974_cov_293.334857	564	633	643	2	69	0.0289855
NODE_7125_length_974_cov_293.334857	564	633	644	2	69	0.0289855
NODE_7125_length_974_cov_293.334857	564	633	645	1	69	0.0144928
NODE_7125_length_974_cov_293.334857	564	633	646	2	69	0.0289855
NODE_7125_length_974_cov_293.334857	564	633	648	4	69	0.0579710
NODE_7125_length_974_cov_293.334857	564	633	649	1	69	0.0144928
NODE_7125_length_974_cov_293.334857	564	633	650	1	69	0.0144928
NODE_7125_length_974_cov_293.334857	564	633	651	2	69	0.0289855
NODE_7125_length_974_cov_293.334857	564	633	653	2	69	0.0289855
NODE_7125_length_974_cov_293.334857	564	633	656	2	69	0.0289855
NODE_7125_length_974_cov_293.334857	564	633	659	1	69	0.0144928
NODE_7125_length_974_cov_293.334857	564	633	667	1	69	0.0144928
NODE_7125_length_974_cov_293.334857	564	633	683	1	69	0.0144928
NODE_7125_length_974_cov_293.334857	564	633	691	1	69	0.0144928
NODE_7125_length_974_cov_293.334857	564	633	708	1	69	0.0144928
NODE_7125_length_974_cov_293.334857	564	633	724	1	69	0.0144928
NODE_7125_length_974_cov_293.334857	564	633	731	1	69	0.0144928
NODE_7125_length_974_cov_293.334857	564	633	733	1	69	0.0144928
NODE_7125_length_974_cov_293.334857	564	633	739	1	69	0.0144928
NODE_7125_length_974_cov_293.334857	564	633	748	1	69	0.0144928
NODE_7125_length_974_cov_293.334857	564	633	768	1	69	0.0144928
NODE_7125_length_974_cov_293.334857	564	633	782	1	69	0.0144928
NODE_7125_length_974_cov_293.334857	564	633	785	1	69	0.0144928
NODE_7125_length_974_cov_293.334857	564	633	787	1	69	0.0144928
NODE_7125_length_974_cov_293.334857	564	633	788	1	69	0.0144928
NODE_7125_length_974_cov_293.334857	564	633	791	2	69	0.0289855
NODE_7125_length_974_cov_293.334857	564	633	794	1	69	0.0144928
NODE_7125_length_974_cov_293.334857	564	633	796	1	69	0.0144928
NODE_7126_length_974_cov_49.884571	459	539	0	63	80	0.7875000
NODE_7126_length_974_cov_49.884571	459	539	2	17	80	0.2125000
NODE_7126_length_974_cov_49.884571	512	592	0	10	80	0.1250000
NODE_7126_length_974_cov_49.884571	512	592	2	70	80	0.8750000
NODE_7127_length_974_cov_38.384000	430	508	2	78	78	1.0000000
NODE_7127_length_974_cov_38.384000	483	561	0	39	78	0.5000000
NODE_7127_length_974_cov_38.384000	483	561	2	39	78	0.5000000
NODE_7128_length_974_cov_26.008000	391	471	0	80	80	1.0000000
NODE_7128_length_974_cov_26.008000	444	524	0	80	80	1.0000000
NODE_7128_length_974_cov_26.008000	520	600	0	80	80	1.0000000
NODE_7128_length_974_cov_26.008000	573	653	0	80	80	1.0000000
NODE_7129_length_974_cov_21.160000	460	540	15	80	80	1.0000000
NODE_7129_length_974_cov_21.160000	513	593	8	37	80	0.4625000
NODE_7129_length_974_cov_21.160000	513	593	15	43	80	0.5375000
NODE_7131_length_974_cov_11.384000	290	370	0	80	80	1.0000000
NODE_7131_length_974_cov_11.384000	343	423	0	80	80	1.0000000
NODE_7132_length_974_cov_11.216000	543	623	0	80	80	1.0000000
NODE_7132_length_974_cov_11.216000	596	668	0	72	72	1.0000000
NODE_7133_length_974_cov_9.601143	436	516	0	80	80	1.0000000
NODE_7133_length_974_cov_9.601143	489	569	0	80	80	1.0000000
NODE_7134_length_974_cov_7.436571	382	462	0	17	80	0.2125000
NODE_7134_length_974_cov_7.436571	382	462	2	63	80	0.7875000
NODE_7134_length_974_cov_7.436571	436	515	0	29	79	0.3670886
NODE_7134_length_974_cov_7.436571	436	515	2	50	79	0.6329114
NODE_7147_length_973_cov_46.012586	349	429	0	8	80	0.1000000
NODE_7147_length_973_cov_46.012586	349	429	2	72	80	0.9000000
NODE_7147_length_973_cov_46.012586	402	482	0	36	80	0.4500000
NODE_7147_length_973_cov_46.012586	402	482	2	44	80	0.5500000
NODE_7147_length_973_cov_46.012586	478	558	2	6	80	0.0750000
NODE_7147_length_973_cov_46.012586	478	558	4	67	80	0.8375000
NODE_7147_length_973_cov_46.012586	478	558	6	7	80	0.0875000
NODE_7147_length_973_cov_46.012586	531	611	4	20	80	0.2500000
NODE_7147_length_973_cov_46.012586	531	611	6	16	80	0.2000000
NODE_7147_length_973_cov_46.012586	531	611	8	44	80	0.5500000
NODE_7148_length_973_cov_40.305492	364	444	0	16	80	0.2000000
NODE_7148_length_973_cov_40.305492	364	444	7	13	80	0.1625000
NODE_7148_length_973_cov_40.305492	364	444	8	51	80	0.6375000
NODE_7148_length_973_cov_40.305492	417	497	0	16	80	0.2000000
NODE_7148_length_973_cov_40.305492	417	497	7	49	80	0.6125000
NODE_7148_length_973_cov_40.305492	417	497	8	15	80	0.1875000
NODE_7149_length_973_cov_24.105263	460	540	0	24	80	0.3000000
NODE_7149_length_973_cov_24.105263	460	540	4	56	80	0.7000000
NODE_7149_length_973_cov_24.105263	513	593	0	2	80	0.0250000
NODE_7149_length_973_cov_24.105263	513	593	4	78	80	0.9750000
NODE_7150_length_973_cov_22.106407	342	422	0	80	80	1.0000000
NODE_7150_length_973_cov_22.106407	395	475	0	80	80	1.0000000
NODE_7150_length_973_cov_22.106407	471	550	0	79	79	1.0000000
NODE_7150_length_973_cov_22.106407	526	604	0	78	78	1.0000000
NODE_7151_length_973_cov_10.994279	430	510	0	80	80	1.0000000
NODE_7151_length_973_cov_10.994279	483	563	0	80	80	1.0000000
NODE_7151_length_973_cov_10.994279	559	635	0	42	76	0.5526316
NODE_7151_length_973_cov_10.994279	559	635	2	34	76	0.4473684
NODE_7151_length_973_cov_10.994279	608	688	2	80	80	1.0000000
NODE_7153_length_973_cov_2.973684	734	814	0	72	80	0.9000000
NODE_7153_length_973_cov_2.973684	734	814	2	7	80	0.0875000
NODE_7153_length_973_cov_2.973684	734	814	6	1	80	0.0125000
NODE_7153_length_973_cov_2.973684	820	890	4	16	70	0.2285714
NODE_7153_length_973_cov_2.973684	820	890	7	1	70	0.0142857
NODE_7153_length_973_cov_2.973684	820	890	12	8	70	0.1142857
NODE_7153_length_973_cov_2.973684	820	890	14	22	70	0.3142857
NODE_7153_length_973_cov_2.973684	820	890	15	15	70	0.2142857
NODE_7153_length_973_cov_2.973684	820	890	16	8	70	0.1142857
NODE_7153_length_973_cov_2.973684	863	944	0	8	81	0.0987654
NODE_7153_length_973_cov_2.973684	863	944	2	3	81	0.0370370
NODE_7153_length_973_cov_2.973684	863	944	6	7	81	0.0864198
NODE_7153_length_973_cov_2.973684	863	944	8	1	81	0.0123457
NODE_7153_length_973_cov_2.973684	863	944	9	15	81	0.1851852
NODE_7153_length_973_cov_2.973684	863	944	11	2	81	0.0246914
NODE_7153_length_973_cov_2.973684	863	944	13	4	81	0.0493827
NODE_7153_length_973_cov_2.973684	863	944	14	4	81	0.0493827
NODE_7153_length_973_cov_2.973684	863	944	15	29	81	0.3580247
NODE_7153_length_973_cov_2.973684	863	944	16	8	81	0.0987654
NODE_7166_length_972_cov_32.547537	299	379	0	19	80	0.2375000
NODE_7166_length_972_cov_32.547537	299	379	6	20	80	0.2500000
NODE_7166_length_972_cov_32.547537	299	379	8	41	80	0.5125000
NODE_7166_length_972_cov_32.547537	352	432	0	72	80	0.9000000
NODE_7166_length_972_cov_32.547537	352	432	6	8	80	0.1000000
NODE_7166_length_972_cov_32.547537	428	508	0	30	80	0.3750000
NODE_7166_length_972_cov_32.547537	428	508	2	50	80	0.6250000
NODE_7166_length_972_cov_32.547537	481	561	2	80	80	1.0000000
NODE_7167_length_972_cov_31.010309	474	554	0	80	80	1.0000000
NODE_7167_length_972_cov_31.010309	527	607	0	80	80	1.0000000
NODE_7168_length_972_cov_29.810997	481	561	0	22	80	0.2750000
NODE_7168_length_972_cov_29.810997	481	561	2	18	80	0.2250000
NODE_7168_length_972_cov_29.810997	481	561	4	40	80	0.5000000
NODE_7168_length_972_cov_29.810997	534	614	4	80	80	1.0000000
NODE_7169_length_972_cov_23.438717	442	522	0	80	80	1.0000000
NODE_7169_length_972_cov_23.438717	495	575	0	80	80	1.0000000
NODE_7170_length_972_cov_18.886598	453	533	2	80	80	1.0000000
NODE_7170_length_972_cov_18.886598	506	585	0	33	79	0.4177215
NODE_7170_length_972_cov_18.886598	506	585	2	46	79	0.5822785
NODE_7171_length_972_cov_15.100802	329	409	0	7	80	0.0875000
NODE_7171_length_972_cov_15.100802	329	409	1	12	80	0.1500000
NODE_7171_length_972_cov_15.100802	329	409	2	34	80	0.4250000
NODE_7171_length_972_cov_15.100802	329	409	3	27	80	0.3375000
NODE_7171_length_972_cov_15.100802	382	462	1	55	80	0.6875000
NODE_7171_length_972_cov_15.100802	382	462	2	10	80	0.1250000
NODE_7171_length_972_cov_15.100802	382	462	3	15	80	0.1875000
NODE_7172_length_972_cov_12.674685	444	524	0	26	80	0.3250000
NODE_7172_length_972_cov_12.674685	444	524	4	54	80	0.6750000
NODE_7172_length_972_cov_12.674685	497	577	0	79	80	0.9875000
NODE_7172_length_972_cov_12.674685	497	577	4	1	80	0.0125000
NODE_7173_length_972_cov_11.235968	504	584	0	80	80	1.0000000
NODE_7173_length_972_cov_11.235968	557	637	0	35	80	0.4375000
NODE_7173_length_972_cov_11.235968	557	637	2	9	80	0.1125000
NODE_7173_length_972_cov_11.235968	557	637	4	36	80	0.4500000
NODE_7174_length_972_cov_10.983963	402	482	0	80	80	1.0000000
NODE_7174_length_972_cov_10.983963	455	535	0	80	80	1.0000000
NODE_7175_length_972_cov_8.887743	302	382	0	40	80	0.5000000
NODE_7175_length_972_cov_8.887743	302	382	4	40	80	0.5000000
NODE_7175_length_972_cov_8.887743	355	430	4	75	75	1.0000000
NODE_7176_length_972_cov_8.265750	488	568	0	80	80	1.0000000
NODE_7176_length_972_cov_8.265750	541	621	0	80	80	1.0000000
NODE_7182_length_972_cov_2.714777	165	241	0	6	76	0.0789474
NODE_7182_length_972_cov_2.714777	165	241	1	34	76	0.4473684
NODE_7182_length_972_cov_2.714777	165	241	2	3	76	0.0394737
NODE_7182_length_972_cov_2.714777	165	241	4	33	76	0.4342105
NODE_7195_length_971_cov_52.575688	398	478	0	11	80	0.1375000
NODE_7195_length_971_cov_52.575688	398	478	4	69	80	0.8625000
NODE_7195_length_971_cov_52.575688	451	531	4	80	80	1.0000000
NODE_7195_length_971_cov_52.575688	527	607	0	65	80	0.8125000
NODE_7195_length_971_cov_52.575688	527	607	4	15	80	0.1875000
NODE_7195_length_971_cov_52.575688	580	660	0	80	80	1.0000000
NODE_7196_length_971_cov_44.464450	280	360	0	80	80	1.0000000
NODE_7196_length_971_cov_44.464450	333	413	0	80	80	1.0000000
NODE_7196_length_971_cov_44.464450	409	489	0	80	80	1.0000000
NODE_7196_length_971_cov_44.464450	462	542	0	80	80	1.0000000
NODE_7197_length_971_cov_32.721330	509	589	0	80	80	1.0000000
NODE_7197_length_971_cov_32.721330	562	642	0	80	80	1.0000000
NODE_7198_length_971_cov_30.264908	474	554	4	80	80	1.0000000
NODE_7198_length_971_cov_30.264908	527	607	0	21	80	0.2625000
NODE_7198_length_971_cov_30.264908	527	607	4	59	80	0.7375000
NODE_7199_length_971_cov_26.631881	434	514	0	80	80	1.0000000
NODE_7199_length_971_cov_26.631881	487	567	0	80	80	1.0000000
NODE_7200_length_971_cov_25.635321	404	484	0	80	80	1.0000000
NODE_7200_length_971_cov_25.635321	457	537	0	80	80	1.0000000
NODE_7201_length_971_cov_23.334862	363	443	0	55	80	0.6875000
NODE_7201_length_971_cov_23.334862	363	443	2	25	80	0.3125000
NODE_7201_length_971_cov_23.334862	416	497	0	2	81	0.0246914
NODE_7201_length_971_cov_23.334862	416	497	2	79	81	0.9753087
NODE_7202_length_971_cov_18.254587	468	548	0	80	80	1.0000000
NODE_7202_length_971_cov_18.254587	521	601	0	80	80	1.0000000
NODE_7203_length_971_cov_18.229358	392	472	1	74	80	0.9250000
NODE_7203_length_971_cov_18.229358	392	472	2	6	80	0.0750000
NODE_7203_length_971_cov_18.229358	445	525	1	53	80	0.6625000
NODE_7203_length_971_cov_18.229358	445	525	2	27	80	0.3375000
NODE_7204_length_971_cov_16.591743	481	561	2	25	80	0.3125000
NODE_7204_length_971_cov_16.591743	481	561	4	38	80	0.4750000
NODE_7204_length_971_cov_16.591743	481	561	6	17	80	0.2125000
NODE_7204_length_971_cov_16.591743	534	614	0	8	80	0.1000000
NODE_7204_length_971_cov_16.591743	534	614	2	70	80	0.8750000
NODE_7204_length_971_cov_16.591743	534	614	4	2	80	0.0250000
NODE_7205_length_971_cov_15.563073	463	543	4	44	80	0.5500000
NODE_7205_length_971_cov_15.563073	463	543	6	36	80	0.4500000
NODE_7205_length_971_cov_15.563073	516	596	0	13	80	0.1625000
NODE_7205_length_971_cov_15.563073	516	596	2	30	80	0.3750000
NODE_7205_length_971_cov_15.563073	516	596	4	37	80	0.4625000
NODE_7206_length_971_cov_12.141055	415	495	0	80	80	1.0000000
NODE_7206_length_971_cov_12.141055	468	548	0	69	80	0.8625000
NODE_7206_length_971_cov_12.141055	468	548	2	11	80	0.1375000
NODE_7222_length_970_cov_34.928817	438	518	6	19	80	0.2375000
NODE_7222_length_970_cov_34.928817	438	518	8	61	80	0.7625000
NODE_7222_length_970_cov_34.928817	491	571	6	66	80	0.8250000
NODE_7222_length_970_cov_34.928817	491	571	8	14	80	0.1750000
NODE_7223_length_970_cov_34.445465	540	620	0	50	80	0.6250000
NODE_7223_length_970_cov_34.445465	540	620	2	30	80	0.3750000
NODE_7223_length_970_cov_34.445465	593	673	2	80	80	1.0000000
NODE_7224_length_970_cov_34.257176	352	432	1	12	80	0.1500000
NODE_7224_length_970_cov_34.257176	352	432	2	68	80	0.8500000
NODE_7224_length_970_cov_34.257176	405	485	1	47	80	0.5875000
NODE_7224_length_970_cov_34.257176	405	485	2	33	80	0.4125000
NODE_7225_length_970_cov_26.904707	297	372	6	12	75	0.1600000
NODE_7225_length_970_cov_26.904707	297	372	8	43	75	0.5733333
NODE_7225_length_970_cov_26.904707	297	372	12	20	75	0.2666667
NODE_7225_length_970_cov_26.904707	303	376	6	16	73	0.2191781
NODE_7225_length_970_cov_26.904707	303	376	8	43	73	0.5890411
NODE_7225_length_970_cov_26.904707	303	376	12	14	73	0.1917808
NODE_7225_length_970_cov_26.904707	311	377	6	17	66	0.2575758
NODE_7225_length_970_cov_26.904707	311	377	8	43	66	0.6515151
NODE_7225_length_970_cov_26.904707	311	377	12	6	66	0.0909091
NODE_7225_length_970_cov_26.904707	350	429	0	15	79	0.1898734
NODE_7225_length_970_cov_26.904707	350	429	2	31	79	0.3924051
NODE_7225_length_970_cov_26.904707	350	429	6	17	79	0.2151899
NODE_7225_length_970_cov_26.904707	350	429	8	16	79	0.2025317
NODE_7225_length_970_cov_26.904707	350	429	0	15	79	0.1898734
NODE_7225_length_970_cov_26.904707	350	429	2	31	79	0.3924051
NODE_7225_length_970_cov_26.904707	350	429	6	17	79	0.2151899
NODE_7225_length_970_cov_26.904707	350	429	8	16	79	0.2025317
NODE_7225_length_970_cov_26.904707	350	429	0	15	79	0.1898734
NODE_7225_length_970_cov_26.904707	350	429	2	31	79	0.3924051
NODE_7225_length_970_cov_26.904707	350	429	6	17	79	0.2151899
NODE_7225_length_970_cov_26.904707	350	429	8	16	79	0.2025317
NODE_7226_length_970_cov_26.040184	266	346	0	80	80	1.0000000
NODE_7226_length_970_cov_26.040184	319	399	0	80	80	1.0000000
NODE_7226_length_970_cov_26.040184	395	475	0	80	80	1.0000000
NODE_7226_length_970_cov_26.040184	448	528	0	80	80	1.0000000
NODE_7227_length_970_cov_19.291619	415	495	0	80	80	1.0000000
NODE_7227_length_970_cov_19.291619	468	548	0	80	80	1.0000000
NODE_7228_length_970_cov_17.731343	557	637	0	31	80	0.3875000
NODE_7228_length_970_cov_17.731343	557	637	4	49	80	0.6125000
NODE_7228_length_970_cov_17.731343	610	690	0	28	80	0.3500000
NODE_7228_length_970_cov_17.731343	610	690	4	52	80	0.6500000
NODE_7229_length_970_cov_15.135476	407	487	0	80	80	1.0000000
NODE_7229_length_970_cov_15.135476	460	540	0	40	80	0.5000000
NODE_7229_length_970_cov_15.135476	460	540	4	40	80	0.5000000
NODE_7230_length_970_cov_12.675086	534	614	0	8	80	0.1000000
NODE_7230_length_970_cov_12.675086	534	614	4	72	80	0.9000000
NODE_7230_length_970_cov_12.675086	587	667	0	5	80	0.0625000
NODE_7230_length_970_cov_12.675086	587	667	3	1	80	0.0125000
NODE_7230_length_970_cov_12.675086	587	667	4	74	80	0.9250000
NODE_7231_length_970_cov_8.095293	487	567	0	80	80	1.0000000
NODE_7231_length_970_cov_8.095293	540	620	0	74	80	0.9250000
NODE_7231_length_970_cov_8.095293	540	620	2	6	80	0.0750000
NODE_7233_length_970_cov_7.127440	336	416	0	80	80	1.0000000
NODE_7233_length_970_cov_7.127440	389	469	0	80	80	1.0000000
NODE_7234_length_970_cov_5.824340	0	56	0	56	56	1.0000000
NODE_7246_length_969_cov_47.172414	419	499	0	17	80	0.2125000
NODE_7246_length_969_cov_47.172414	419	499	2	30	80	0.3750000
NODE_7246_length_969_cov_47.172414	419	499	45	22	80	0.2750000
NODE_7246_length_969_cov_47.172414	419	499	46	11	80	0.1375000
NODE_7246_length_969_cov_47.172414	472	552	45	16	80	0.2000000
NODE_7246_length_969_cov_47.172414	472	552	46	12	80	0.1500000
NODE_7246_length_969_cov_47.172414	472	552	47	1	80	0.0125000
NODE_7246_length_969_cov_47.172414	472	552	52	3	80	0.0375000
NODE_7246_length_969_cov_47.172414	472	552	53	7	80	0.0875000
NODE_7246_length_969_cov_47.172414	472	552	54	3	80	0.0375000
NODE_7246_length_969_cov_47.172414	472	552	55	2	80	0.0250000
NODE_7246_length_969_cov_47.172414	472	552	57	1	80	0.0125000
NODE_7246_length_969_cov_47.172414	472	552	59	3	80	0.0375000
NODE_7246_length_969_cov_47.172414	472	552	60	1	80	0.0125000
NODE_7246_length_969_cov_47.172414	472	552	62	2	80	0.0250000
NODE_7246_length_969_cov_47.172414	472	552	64	1	80	0.0125000
NODE_7246_length_969_cov_47.172414	472	552	66	2	80	0.0250000
NODE_7246_length_969_cov_47.172414	472	552	68	1	80	0.0125000
NODE_7246_length_969_cov_47.172414	472	552	69	1	80	0.0125000
NODE_7246_length_969_cov_47.172414	472	552	71	1	80	0.0125000
NODE_7246_length_969_cov_47.172414	472	552	77	2	80	0.0250000
NODE_7246_length_969_cov_47.172414	472	552	80	1	80	0.0125000
NODE_7246_length_969_cov_47.172414	472	552	82	15	80	0.1875000
NODE_7246_length_969_cov_47.172414	472	552	83	2	80	0.0250000
NODE_7246_length_969_cov_47.172414	472	552	84	3	80	0.0375000
NODE_7247_length_969_cov_28.234483	327	407	0	11	80	0.1375000
NODE_7247_length_969_cov_28.234483	327	407	2	69	80	0.8625000
NODE_7247_length_969_cov_28.234483	380	460	0	50	80	0.6250000
NODE_7247_length_969_cov_28.234483	380	460	2	30	80	0.3750000
NODE_7248_length_969_cov_27.131034	392	472	0	80	80	1.0000000
NODE_7248_length_969_cov_27.131034	445	525	0	41	80	0.5125000
NODE_7248_length_969_cov_27.131034	445	525	4	9	80	0.1125000
NODE_7248_length_969_cov_27.131034	445	525	8	30	80	0.3750000
NODE_7249_length_969_cov_26.345977	466	542	0	76	76	1.0000000
NODE_7249_length_969_cov_26.345977	515	595	0	80	80	1.0000000
NODE_7250_length_969_cov_18.954023	274	354	0	80	80	1.0000000
NODE_7250_length_969_cov_18.954023	327	407	0	80	80	1.0000000
NODE_7251_length_969_cov_17.952874	410	490	0	80	80	1.0000000
NODE_7251_length_969_cov_17.952874	463	543	0	80	80	1.0000000
NODE_7251_length_969_cov_17.952874	693	773	0	58	80	0.7250000
NODE_7251_length_969_cov_17.952874	693	773	2	22	80	0.2750000
NODE_7251_length_969_cov_17.952874	746	826	0	5	80	0.0625000
NODE_7251_length_969_cov_17.952874	746	826	2	75	80	0.9375000
NODE_7252_length_969_cov_15.942529	446	526	0	80	80	1.0000000
NODE_7252_length_969_cov_15.942529	499	579	0	80	80	1.0000000
NODE_7253_length_969_cov_9.926437	573	653	0	80	80	1.0000000
NODE_7253_length_969_cov_9.926437	626	706	0	80	80	1.0000000
NODE_7265_length_968_cov_59.162255	376	456	0	80	80	1.0000000
NODE_7265_length_968_cov_59.162255	429	509	0	80	80	1.0000000
NODE_7265_length_968_cov_59.162255	505	585	0	80	80	1.0000000
NODE_7265_length_968_cov_59.162255	558	638	0	80	80	1.0000000
NODE_7266_length_968_cov_40.005754	514	594	0	80	80	1.0000000
NODE_7266_length_968_cov_40.005754	567	647	0	80	80	1.0000000
NODE_7267_length_968_cov_36.521289	450	530	0	43	80	0.5375000
NODE_7267_length_968_cov_36.521289	450	530	2	1	80	0.0125000
NODE_7267_length_968_cov_36.521289	450	530	12	36	80	0.4500000
NODE_7267_length_968_cov_36.521289	503	583	0	10	80	0.1250000
NODE_7267_length_968_cov_36.521289	503	583	11	1	80	0.0125000
NODE_7267_length_968_cov_36.521289	503	583	12	69	80	0.8625000
NODE_7268_length_968_cov_34.799770	474	554	16	10	80	0.1250000
NODE_7268_length_968_cov_34.799770	474	554	18	1	80	0.0125000
NODE_7268_length_968_cov_34.799770	474	554	19	40	80	0.5000000
NODE_7268_length_968_cov_34.799770	474	554	20	29	80	0.3625000
NODE_7268_length_968_cov_34.799770	527	607	0	28	80	0.3500000
NODE_7268_length_968_cov_34.799770	527	607	4	21	80	0.2625000
NODE_7268_length_968_cov_34.799770	527	607	19	1	80	0.0125000
NODE_7268_length_968_cov_34.799770	527	607	20	30	80	0.3750000
NODE_7269_length_968_cov_26.929804	293	372	0	67	79	0.8481013
NODE_7269_length_968_cov_26.929804	293	372	1	12	79	0.1518987
NODE_7269_length_968_cov_26.929804	345	425	0	15	80	0.1875000
NODE_7269_length_968_cov_26.929804	345	425	1	19	80	0.2375000
NODE_7269_length_968_cov_26.929804	345	425	4	7	80	0.0875000
NODE_7269_length_968_cov_26.929804	345	425	5	10	80	0.1250000
NODE_7269_length_968_cov_26.929804	345	425	8	29	80	0.3625000
NODE_7269_length_968_cov_26.929804	421	501	8	19	80	0.2375000
NODE_7269_length_968_cov_26.929804	421	501	14	1	80	0.0125000
NODE_7269_length_968_cov_26.929804	421	501	15	18	80	0.2250000
NODE_7269_length_968_cov_26.929804	421	501	21	1	80	0.0125000
NODE_7269_length_968_cov_26.929804	421	501	22	41	80	0.5125000
NODE_7269_length_968_cov_26.929804	474	554	14	8	80	0.1000000
NODE_7269_length_968_cov_26.929804	474	554	17	12	80	0.1500000
NODE_7269_length_968_cov_26.929804	474	554	18	9	80	0.1125000
NODE_7269_length_968_cov_26.929804	474	554	21	15	80	0.1875000
NODE_7269_length_968_cov_26.929804	474	554	22	36	80	0.4500000
NODE_7270_length_968_cov_24.468354	434	514	2	80	80	1.0000000
NODE_7270_length_968_cov_24.468354	487	567	0	7	80	0.0875000
NODE_7270_length_968_cov_24.468354	487	567	1	1	80	0.0125000
NODE_7270_length_968_cov_24.468354	487	567	2	72	80	0.9000000
NODE_7271_length_968_cov_23.204833	344	424	0	80	80	1.0000000
NODE_7271_length_968_cov_23.204833	397	477	0	80	80	1.0000000
NODE_7271_length_968_cov_23.204833	473	553	0	80	80	1.0000000
NODE_7271_length_968_cov_23.204833	526	606	0	80	80	1.0000000
NODE_7272_length_968_cov_22.321059	417	497	0	80	80	1.0000000
NODE_7272_length_968_cov_22.321059	470	550	0	80	80	1.0000000
NODE_7273_length_968_cov_20.897583	313	393	4	80	80	1.0000000
NODE_7273_length_968_cov_20.897583	366	446	0	31	80	0.3875000
NODE_7273_length_968_cov_20.897583	366	446	4	49	80	0.6125000
NODE_7274_length_968_cov_19.296893	401	481	0	80	80	1.0000000
NODE_7274_length_968_cov_19.296893	454	534	0	40	80	0.5000000
NODE_7274_length_968_cov_19.296893	454	534	2	40	80	0.5000000
NODE_7275_length_968_cov_18.100115	573	653	0	30	80	0.3750000
NODE_7275_length_968_cov_18.100115	573	653	2	50	80	0.6250000
NODE_7275_length_968_cov_18.100115	626	706	0	30	80	0.3750000
NODE_7275_length_968_cov_18.100115	626	706	2	50	80	0.6250000
NODE_7276_length_968_cov_15.576525	472	552	0	80	80	1.0000000
NODE_7276_length_968_cov_15.576525	525	605	0	80	80	1.0000000
NODE_7277_length_968_cov_15.024166	329	409	0	3	80	0.0375000
NODE_7277_length_968_cov_15.024166	329	409	5	1	80	0.0125000
NODE_7277_length_968_cov_15.024166	329	409	6	76	80	0.9500000
NODE_7277_length_968_cov_15.024166	382	462	0	30	80	0.3750000
NODE_7277_length_968_cov_15.024166	382	462	6	50	80	0.6250000
NODE_7277_length_968_cov_15.024166	458	538	0	80	80	1.0000000
NODE_7277_length_968_cov_15.024166	511	591	0	80	80	1.0000000
NODE_7278_length_968_cov_13.911392	674	754	2	62	80	0.7750000
NODE_7278_length_968_cov_13.911392	674	754	4	18	80	0.2250000
NODE_7278_length_968_cov_13.911392	727	807	2	32	80	0.4000000
NODE_7278_length_968_cov_13.911392	727	807	4	48	80	0.6000000
NODE_7279_length_968_cov_11.698504	598	678	0	18	80	0.2250000
NODE_7279_length_968_cov_11.698504	598	678	2	5	80	0.0625000
NODE_7279_length_968_cov_11.698504	598	678	9	4	80	0.0500000
NODE_7279_length_968_cov_11.698504	598	678	10	53	80	0.6625000
NODE_7279_length_968_cov_11.698504	651	731	7	30	80	0.3750000
NODE_7279_length_968_cov_11.698504	651	731	9	11	80	0.1375000
NODE_7279_length_968_cov_11.698504	651	731	10	39	80	0.4875000
NODE_7280_length_968_cov_6.490219	538	618	0	80	80	1.0000000
NODE_7280_length_968_cov_6.490219	591	671	0	80	80	1.0000000
NODE_7294_length_967_cov_25.572581	332	412	0	80	80	1.0000000
NODE_7294_length_967_cov_25.572581	385	465	0	80	80	1.0000000
NODE_7295_length_967_cov_24.919355	396	476	0	44	80	0.5500000
NODE_7295_length_967_cov_24.919355	396	476	4	36	80	0.4500000
NODE_7295_length_967_cov_24.919355	449	529	0	21	80	0.2625000
NODE_7295_length_967_cov_24.919355	449	529	4	59	80	0.7375000
NODE_7296_length_967_cov_19.137097	374	454	0	70	80	0.8750000
NODE_7296_length_967_cov_19.137097	374	454	2	10	80	0.1250000
NODE_7296_length_967_cov_19.137097	427	507	0	17	80	0.2125000
NODE_7296_length_967_cov_19.137097	427	507	2	63	80	0.7875000
NODE_7296_length_967_cov_19.137097	503	583	0	17	80	0.2125000
NODE_7296_length_967_cov_19.137097	503	583	2	63	80	0.7875000
NODE_7296_length_967_cov_19.137097	556	636	0	70	80	0.8750000
NODE_7296_length_967_cov_19.137097	556	636	2	10	80	0.1250000
NODE_7297_length_967_cov_14.654378	453	533	0	80	80	1.0000000
NODE_7297_length_967_cov_14.654378	506	586	0	80	80	1.0000000
NODE_7298_length_967_cov_8.027650	280	360	0	80	80	1.0000000
NODE_7298_length_967_cov_8.027650	333	413	0	80	80	1.0000000
NODE_7310_length_966_cov_43.154556	401	474	2	73	73	1.0000000
NODE_7310_length_966_cov_43.154556	447	527	0	36	80	0.4500000
NODE_7310_length_966_cov_43.154556	447	527	2	44	80	0.5500000
NODE_7311_length_966_cov_42.877739	477	557	0	25	80	0.3125000
NODE_7311_length_966_cov_42.877739	477	557	2	12	80	0.1500000
NODE_7311_length_966_cov_42.877739	477	557	4	43	80	0.5375000
NODE_7311_length_966_cov_42.877739	530	610	0	78	80	0.9750000
NODE_7311_length_966_cov_42.877739	530	610	2	2	80	0.0250000
NODE_7312_length_966_cov_39.956171	283	363	0	80	80	1.0000000
NODE_7312_length_966_cov_39.956171	336	416	0	80	80	1.0000000
NODE_7312_length_966_cov_39.956171	412	494	0	8	82	0.0975610
NODE_7312_length_966_cov_39.956171	412	494	7	10	82	0.1219512
NODE_7312_length_966_cov_39.956171	412	494	8	64	82	0.7804878
NODE_7312_length_966_cov_39.956171	467	547	0	4	80	0.0500000
NODE_7312_length_966_cov_39.956171	467	547	8	76	80	0.9500000
NODE_7313_length_966_cov_36.160323	461	541	0	80	80	1.0000000
NODE_7313_length_966_cov_36.160323	461	541	0	80	80	1.0000000
NODE_7313_length_966_cov_36.160323	514	594	0	80	80	1.0000000
NODE_7314_length_966_cov_18.658593	408	488	0	63	80	0.7875000
NODE_7314_length_966_cov_18.658593	408	488	2	17	80	0.2125000
NODE_7314_length_966_cov_18.658593	461	541	0	10	80	0.1250000
NODE_7314_length_966_cov_18.658593	461	541	2	70	80	0.8750000
NODE_7315_length_966_cov_17.606690	341	421	0	80	80	1.0000000
NODE_7315_length_966_cov_17.606690	394	474	0	80	80	1.0000000
NODE_7316_length_966_cov_16.064591	296	376	2	32	80	0.4000000
NODE_7316_length_966_cov_16.064591	296	376	6	43	80	0.5375000
NODE_7316_length_966_cov_16.064591	296	376	8	5	80	0.0625000
NODE_7316_length_966_cov_16.064591	349	429	0	4	80	0.0500000
NODE_7316_length_966_cov_16.064591	349	429	6	76	80	0.9500000
NODE_7317_length_966_cov_15.155709	562	642	0	80	80	1.0000000
NODE_7317_length_966_cov_15.155709	615	695	0	80	80	1.0000000
NODE_7318_length_966_cov_7.726644	280	360	0	80	80	1.0000000
NODE_7318_length_966_cov_7.726644	334	414	0	69	80	0.8625000
NODE_7318_length_966_cov_7.726644	334	414	2	11	80	0.1375000
NODE_7335_length_965_cov_51.524249	197	277	0	80	80	1.0000000
NODE_7335_length_965_cov_51.524249	250	327	0	77	77	1.0000000
NODE_7335_length_965_cov_51.524249	329	406	4	77	77	1.0000000
NODE_7335_length_965_cov_51.524249	379	459	0	34	80	0.4250000
NODE_7335_length_965_cov_51.524249	379	459	4	46	80	0.5750000
NODE_7336_length_965_cov_18.072748	515	595	0	80	80	1.0000000
NODE_7336_length_965_cov_18.072748	568	648	0	80	80	1.0000000
NODE_7337_length_965_cov_14.277136	342	422	0	64	80	0.8000000
NODE_7337_length_965_cov_14.277136	342	422	4	16	80	0.2000000
NODE_7337_length_965_cov_14.277136	395	470	0	75	75	1.0000000
NODE_7338_length_965_cov_7.808314	567	647	0	80	80	1.0000000
NODE_7338_length_965_cov_7.808314	620	700	0	75	80	0.9375000
NODE_7338_length_965_cov_7.808314	620	700	2	5	80	0.0625000
NODE_7344_length_964_cov_60.153757	197	277	23	1	80	0.0125000
NODE_7344_length_964_cov_60.153757	197	277	24	7	80	0.0875000
NODE_7344_length_964_cov_60.153757	197	277	28	10	80	0.1250000
NODE_7344_length_964_cov_60.153757	197	277	29	2	80	0.0250000
NODE_7344_length_964_cov_60.153757	197	277	31	15	80	0.1875000
NODE_7344_length_964_cov_60.153757	197	277	32	4	80	0.0500000
NODE_7344_length_964_cov_60.153757	197	277	38	2	80	0.0250000
NODE_7344_length_964_cov_60.153757	197	277	42	1	80	0.0125000
NODE_7344_length_964_cov_60.153757	197	277	43	1	80	0.0125000
NODE_7344_length_964_cov_60.153757	197	277	45	2	80	0.0250000
NODE_7344_length_964_cov_60.153757	197	277	47	5	80	0.0625000
NODE_7344_length_964_cov_60.153757	197	277	49	6	80	0.0750000
NODE_7344_length_964_cov_60.153757	197	277	57	1	80	0.0125000
NODE_7344_length_964_cov_60.153757	197	277	63	2	80	0.0250000
NODE_7344_length_964_cov_60.153757	197	277	69	1	80	0.0125000
NODE_7344_length_964_cov_60.153757	197	277	71	3	80	0.0375000
NODE_7344_length_964_cov_60.153757	197	277	73	3	80	0.0375000
NODE_7344_length_964_cov_60.153757	197	277	75	1	80	0.0125000
NODE_7344_length_964_cov_60.153757	197	277	77	2	80	0.0250000
NODE_7344_length_964_cov_60.153757	197	277	79	3	80	0.0375000
NODE_7344_length_964_cov_60.153757	197	277	81	1	80	0.0125000
NODE_7344_length_964_cov_60.153757	197	277	85	1	80	0.0125000
NODE_7344_length_964_cov_60.153757	197	277	87	1	80	0.0125000
NODE_7344_length_964_cov_60.153757	197	277	89	1	80	0.0125000
NODE_7344_length_964_cov_60.153757	197	277	93	4	80	0.0500000
NODE_7344_length_964_cov_60.153757	250	314	8	19	64	0.2968750
NODE_7344_length_964_cov_60.153757	250	314	12	10	64	0.1562500
NODE_7344_length_964_cov_60.153757	250	314	14	3	64	0.0468750
NODE_7344_length_964_cov_60.153757	250	314	19	4	64	0.0625000
NODE_7344_length_964_cov_60.153757	250	314	23	2	64	0.0312500
NODE_7344_length_964_cov_60.153757	250	314	24	7	64	0.1093750
NODE_7344_length_964_cov_60.153757	250	314	28	10	64	0.1562500
NODE_7344_length_964_cov_60.153757	250	314	29	2	64	0.0312500
NODE_7344_length_964_cov_60.153757	250	314	31	7	64	0.1093750
NODE_7344_length_964_cov_60.153757	672	752	0	36	80	0.4500000
NODE_7344_length_964_cov_60.153757	672	752	2	44	80	0.5500000
NODE_7344_length_964_cov_60.153757	725	805	0	70	80	0.8750000
NODE_7344_length_964_cov_60.153757	725	805	2	10	80	0.1250000
NODE_7345_length_964_cov_45.564162	314	394	0	80	80	1.0000000
NODE_7345_length_964_cov_45.564162	367	447	0	67	80	0.8375000
NODE_7345_length_964_cov_45.564162	367	447	2	13	80	0.1625000
NODE_7345_length_964_cov_45.564162	443	523	0	13	80	0.1625000
NODE_7345_length_964_cov_45.564162	443	523	2	67	80	0.8375000
NODE_7345_length_964_cov_45.564162	496	566	0	42	70	0.6000000
NODE_7345_length_964_cov_45.564162	496	566	2	28	70	0.4000000
NODE_7346_length_964_cov_33.487861	363	443	0	80	80	1.0000000
NODE_7346_length_964_cov_33.487861	416	496	0	80	80	1.0000000
NODE_7347_length_964_cov_33.077457	408	488	0	80	80	1.0000000
NODE_7347_length_964_cov_33.077457	461	541	0	80	80	1.0000000
NODE_7347_length_964_cov_33.077457	537	617	0	80	80	1.0000000
NODE_7347_length_964_cov_33.077457	590	670	0	80	80	1.0000000
NODE_7348_length_964_cov_29.250867	419	499	0	43	80	0.5375000
NODE_7348_length_964_cov_29.250867	419	499	6	37	80	0.4625000
NODE_7348_length_964_cov_29.250867	472	552	6	80	80	1.0000000
NODE_7349_length_964_cov_20.191908	228	301	2	73	73	1.0000000
NODE_7349_length_964_cov_20.191908	349	429	0	44	80	0.5500000
NODE_7349_length_964_cov_20.191908	349	429	2	36	80	0.4500000
NODE_7349_length_964_cov_20.191908	402	482	2	28	80	0.3500000
NODE_7349_length_964_cov_20.191908	402	482	4	1	80	0.0125000
NODE_7349_length_964_cov_20.191908	402	482	6	51	80	0.6375000
NODE_7350_length_964_cov_18.510983	486	566	0	13	80	0.1625000
NODE_7350_length_964_cov_18.510983	486	566	2	17	80	0.2125000
NODE_7350_length_964_cov_18.510983	486	566	12	50	80	0.6250000
NODE_7350_length_964_cov_18.510983	539	619	0	15	80	0.1875000
NODE_7350_length_964_cov_18.510983	539	619	10	34	80	0.4250000
NODE_7350_length_964_cov_18.510983	539	619	12	31	80	0.3875000
NODE_7351_length_964_cov_16.613873	464	544	2	80	80	1.0000000
NODE_7351_length_964_cov_16.613873	517	597	0	34	80	0.4250000
NODE_7351_length_964_cov_16.613873	517	597	2	46	80	0.5750000
NODE_7352_length_964_cov_15.717919	411	491	0	1	80	0.0125000
NODE_7352_length_964_cov_15.717919	411	491	4	79	80	0.9875000
NODE_7352_length_964_cov_15.717919	464	544	0	51	80	0.6375000
NODE_7352_length_964_cov_15.717919	464	544	4	29	80	0.3625000
NODE_7352_length_964_cov_15.717919	540	620	0	80	80	1.0000000
NODE_7352_length_964_cov_15.717919	593	668	0	75	75	1.0000000
NODE_7353_length_964_cov_14.591908	521	601	0	71	80	0.8875000
NODE_7353_length_964_cov_14.591908	521	601	2	9	80	0.1125000
NODE_7353_length_964_cov_14.591908	574	654	0	18	80	0.2250000
NODE_7353_length_964_cov_14.591908	574	654	2	62	80	0.7750000
NODE_7354_length_964_cov_11.589595	475	555	0	80	80	1.0000000
NODE_7354_length_964_cov_11.589595	528	608	0	80	80	1.0000000
NODE_7355_length_964_cov_7.639306	420	500	7	72	80	0.9000000
NODE_7355_length_964_cov_7.639306	420	500	8	8	80	0.1000000
NODE_7355_length_964_cov_7.639306	473	553	0	45	80	0.5625000
NODE_7355_length_964_cov_7.639306	473	553	4	2	80	0.0250000
NODE_7355_length_964_cov_7.639306	473	553	7	33	80	0.4125000
NODE_7356_length_964_cov_7.596532	534	614	0	80	80	1.0000000
NODE_7356_length_964_cov_7.596532	587	667	0	80	80	1.0000000
NODE_7357_length_964_cov_6.568786	368	448	0	80	80	1.0000000
NODE_7357_length_964_cov_6.568786	421	501	0	80	80	1.0000000
NODE_7359_length_964_cov_6.027746	890	940	18	1	50	0.0200000
NODE_7359_length_964_cov_6.027746	890	940	20	21	50	0.4200000
NODE_7359_length_964_cov_6.027746	890	940	22	15	50	0.3000000
NODE_7359_length_964_cov_6.027746	890	940	24	5	50	0.1000000
NODE_7359_length_964_cov_6.027746	890	940	26	8	50	0.1600000
NODE_7361_length_964_cov_4.665896	706	772	0	66	66	1.0000000
NODE_7376_length_963_cov_66.251157	456	536	0	80	80	1.0000000
NODE_7376_length_963_cov_66.251157	509	589	0	80	80	1.0000000
NODE_7376_length_963_cov_66.251157	585	665	0	80	80	1.0000000
NODE_7376_length_963_cov_66.251157	638	718	0	67	80	0.8375000
NODE_7376_length_963_cov_66.251157	638	718	4	13	80	0.1625000
NODE_7377_length_963_cov_35.638889	381	461	2	2	80	0.0250000
NODE_7377_length_963_cov_35.638889	381	461	5	2	80	0.0250000
NODE_7377_length_963_cov_35.638889	381	461	6	65	80	0.8125000
NODE_7377_length_963_cov_35.638889	381	461	8	11	80	0.1375000
NODE_7377_length_963_cov_35.638889	434	514	0	52	80	0.6500000
NODE_7377_length_963_cov_35.638889	434	514	2	3	80	0.0375000
NODE_7377_length_963_cov_35.638889	434	514	5	2	80	0.0250000
NODE_7377_length_963_cov_35.638889	434	514	6	23	80	0.2875000
NODE_7377_length_963_cov_35.638889	510	590	0	80	80	1.0000000
NODE_7377_length_963_cov_35.638889	563	643	0	80	80	1.0000000
NODE_7378_length_963_cov_33.642361	347	427	0	80	80	1.0000000
NODE_7378_length_963_cov_33.642361	400	480	0	30	80	0.3750000
NODE_7378_length_963_cov_33.642361	400	480	2	50	80	0.6250000
NODE_7379_length_963_cov_18.626157	392	472	0	80	80	1.0000000
NODE_7379_length_963_cov_18.626157	445	525	0	80	80	1.0000000
NODE_7380_length_963_cov_17.750000	402	482	0	23	80	0.2875000
NODE_7380_length_963_cov_17.750000	402	482	4	57	80	0.7125000
NODE_7380_length_963_cov_17.750000	455	535	0	76	80	0.9500000
NODE_7380_length_963_cov_17.750000	455	535	4	4	80	0.0500000
NODE_7381_length_963_cov_17.023148	542	622	0	80	80	1.0000000
NODE_7381_length_963_cov_17.023148	595	675	0	80	80	1.0000000
NODE_7382_length_963_cov_16.642361	481	561	0	32	80	0.4000000
NODE_7382_length_963_cov_16.642361	481	561	6	48	80	0.6000000
NODE_7382_length_963_cov_16.642361	534	614	0	80	80	1.0000000
NODE_7382_length_963_cov_16.642361	572	629	0	57	57	1.0000000
NODE_7383_length_963_cov_14.961806	283	363	0	80	80	1.0000000
NODE_7383_length_963_cov_14.961806	336	416	0	80	80	1.0000000
NODE_7384_length_963_cov_13.341435	558	638	0	11	80	0.1375000
NODE_7384_length_963_cov_13.341435	558	638	2	69	80	0.8625000
NODE_7384_length_963_cov_13.341435	611	691	0	28	80	0.3500000
NODE_7384_length_963_cov_13.341435	611	691	2	52	80	0.6500000
NODE_7386_length_963_cov_9.520833	459	539	0	80	80	1.0000000
NODE_7386_length_963_cov_9.520833	512	592	0	80	80	1.0000000
NODE_7386_length_963_cov_9.520833	588	662	0	74	74	1.0000000
NODE_7386_length_963_cov_9.520833	641	724	0	83	83	1.0000000
NODE_7388_length_963_cov_7.510417	781	842	3	1	61	0.0163934
NODE_7388_length_963_cov_7.510417	781	842	8	1	61	0.0163934
NODE_7388_length_963_cov_7.510417	781	842	10	8	61	0.1311475
NODE_7388_length_963_cov_7.510417	781	842	12	10	61	0.1639344
NODE_7388_length_963_cov_7.510417	781	842	24	1	61	0.0163934
NODE_7388_length_963_cov_7.510417	781	842	25	1	61	0.0163934
NODE_7388_length_963_cov_7.510417	781	842	35	1	61	0.0163934
NODE_7388_length_963_cov_7.510417	781	842	52	1	61	0.0163934
NODE_7388_length_963_cov_7.510417	781	842	53	7	61	0.1147541
NODE_7388_length_963_cov_7.510417	781	842	55	12	61	0.1967213
NODE_7388_length_963_cov_7.510417	781	842	66	3	61	0.0491803
NODE_7388_length_963_cov_7.510417	781	842	68	15	61	0.2459016
NODE_7388_length_963_cov_7.510417	815	894	55	9	79	0.1139240
NODE_7388_length_963_cov_7.510417	815	894	66	14	79	0.1772152
NODE_7388_length_963_cov_7.510417	815	894	67	21	79	0.2658228
NODE_7388_length_963_cov_7.510417	815	894	68	35	79	0.4430380
NODE_7392_length_963_cov_3.755787	378	458	0	80	80	1.0000000
NODE_7392_length_963_cov_3.755787	431	511	0	80	80	1.0000000
NODE_7397_length_963_cov_1.931713	426	485	0	59	59	1.0000000
NODE_7404_length_962_cov_37.169177	356	436	0	41	80	0.5125000
NODE_7404_length_962_cov_37.169177	356	436	2	39	80	0.4875000
NODE_7404_length_962_cov_37.169177	409	489	0	80	80	1.0000000
NODE_7405_length_962_cov_28.852839	474	554	0	80	80	1.0000000
NODE_7405_length_962_cov_28.852839	527	607	0	80	80	1.0000000
NODE_7405_length_962_cov_28.852839	603	683	0	80	80	1.0000000
NODE_7405_length_962_cov_28.852839	656	736	0	80	80	1.0000000
NODE_7406_length_962_cov_27.859791	441	521	0	80	80	1.0000000
NODE_7406_length_962_cov_27.859791	494	574	0	80	80	1.0000000
NODE_7407_length_962_cov_21.019699	318	398	0	27	80	0.3375000
NODE_7407_length_962_cov_21.019699	318	398	4	7	80	0.0875000
NODE_7407_length_962_cov_21.019699	318	398	6	46	80	0.5750000
NODE_7407_length_962_cov_21.019699	371	451	2	24	80	0.3000000
NODE_7407_length_962_cov_21.019699	371	451	6	56	80	0.7000000
NODE_7408_length_962_cov_16.792584	350	430	0	80	80	1.0000000
NODE_7408_length_962_cov_16.792584	403	483	0	80	80	1.0000000
NODE_7409_length_962_cov_14.650058	477	557	2	62	80	0.7750000
NODE_7409_length_962_cov_14.650058	477	557	4	18	80	0.2250000
NODE_7409_length_962_cov_14.650058	530	610	0	32	80	0.4000000
NODE_7409_length_962_cov_14.650058	530	610	2	47	80	0.5875000
NODE_7409_length_962_cov_14.650058	530	610	4	1	80	0.0125000
NODE_7410_length_962_cov_7.993048	308	345	0	37	37	1.0000000
NODE_7411_length_962_cov_7.835458	447	527	0	49	80	0.6125000
NODE_7411_length_962_cov_7.835458	447	527	2	31	80	0.3875000
NODE_7411_length_962_cov_7.835458	500	580	0	2	80	0.0250000
NODE_7411_length_962_cov_7.835458	500	580	2	78	80	0.9750000
NODE_7412_length_962_cov_6.855156	490	570	0	40	80	0.5000000
NODE_7412_length_962_cov_6.855156	490	570	2	40	80	0.5000000
NODE_7412_length_962_cov_6.855156	543	623	2	80	80	1.0000000
NODE_7417_length_962_cov_1.840093	88	151	0	2	63	0.0317460
NODE_7417_length_962_cov_1.840093	88	151	12	1	63	0.0158730
NODE_7417_length_962_cov_1.840093	88	151	22	2	63	0.0317460
NODE_7417_length_962_cov_1.840093	88	151	25	1	63	0.0158730
NODE_7417_length_962_cov_1.840093	88	151	27	1	63	0.0158730
NODE_7417_length_962_cov_1.840093	88	151	30	1	63	0.0158730
NODE_7417_length_962_cov_1.840093	88	151	36	1	63	0.0158730
NODE_7417_length_962_cov_1.840093	88	151	40	2	63	0.0317460
NODE_7417_length_962_cov_1.840093	88	151	44	1	63	0.0158730
NODE_7417_length_962_cov_1.840093	88	151	52	2	63	0.0317460
NODE_7417_length_962_cov_1.840093	88	151	54	3	63	0.0476190
NODE_7417_length_962_cov_1.840093	88	151	60	16	63	0.2539683
NODE_7417_length_962_cov_1.840093	88	151	64	1	63	0.0158730
NODE_7417_length_962_cov_1.840093	88	151	66	4	63	0.0634921
NODE_7417_length_962_cov_1.840093	88	151	68	2	63	0.0317460
NODE_7417_length_962_cov_1.840093	88	151	72	1	63	0.0158730
NODE_7417_length_962_cov_1.840093	88	151	78	4	63	0.0634921
NODE_7417_length_962_cov_1.840093	88	151	80	6	63	0.0952381
NODE_7417_length_962_cov_1.840093	88	151	82	2	63	0.0317460
NODE_7417_length_962_cov_1.840093	88	151	84	5	63	0.0793651
NODE_7417_length_962_cov_1.840093	88	151	86	2	63	0.0317460
NODE_7417_length_962_cov_1.840093	88	151	88	3	63	0.0476190
NODE_7422_length_961_cov_61.019722	453	533	0	69	80	0.8625000
NODE_7422_length_961_cov_61.019722	453	533	2	11	80	0.1375000
NODE_7422_length_961_cov_61.019722	506	586	0	34	80	0.4250000
NODE_7422_length_961_cov_61.019722	506	586	2	46	80	0.5750000
NODE_7422_length_961_cov_61.019722	614	672	0	32	58	0.5517241
NODE_7422_length_961_cov_61.019722	614	672	2	26	58	0.4482759
NODE_7423_length_961_cov_51.005800	334	414	0	60	80	0.7500000
NODE_7423_length_961_cov_51.005800	334	414	2	15	80	0.1875000
NODE_7423_length_961_cov_51.005800	334	414	4	5	80	0.0625000
NODE_7423_length_961_cov_51.005800	387	467	0	7	80	0.0875000
NODE_7423_length_961_cov_51.005800	387	467	2	15	80	0.1875000
NODE_7423_length_961_cov_51.005800	387	467	4	58	80	0.7250000
NODE_7424_length_961_cov_45.923434	391	471	0	12	80	0.1500000
NODE_7424_length_961_cov_45.923434	391	471	11	2	80	0.0250000
NODE_7424_length_961_cov_45.923434	391	471	12	66	80	0.8250000
NODE_7424_length_961_cov_45.923434	444	524	0	34	80	0.4250000
NODE_7424_length_961_cov_45.923434	444	524	11	1	80	0.0125000
NODE_7424_length_961_cov_45.923434	444	524	12	45	80	0.5625000
NODE_7426_length_961_cov_21.410673	313	393	2	30	80	0.3750000
NODE_7426_length_961_cov_21.410673	313	393	4	50	80	0.6250000
NODE_7426_length_961_cov_21.410673	366	446	4	80	80	1.0000000
NODE_7427_length_961_cov_18.592807	403	483	0	80	80	1.0000000
NODE_7427_length_961_cov_18.592807	456	536	0	80	80	1.0000000
NODE_7428_length_961_cov_17.701856	433	513	0	75	80	0.9375000
NODE_7428_length_961_cov_17.701856	433	513	2	5	80	0.0625000
NODE_7428_length_961_cov_17.701856	486	566	0	22	80	0.2750000
NODE_7428_length_961_cov_17.701856	486	566	2	58	80	0.7250000
NODE_7429_length_961_cov_17.020882	505	585	0	80	80	1.0000000
NODE_7429_length_961_cov_17.020882	558	638	0	80	80	1.0000000
NODE_7430_length_961_cov_16.235499	328	408	0	80	80	1.0000000
NODE_7430_length_961_cov_16.235499	381	461	0	80	80	1.0000000
NODE_7432_length_961_cov_12.968677	347	427	0	80	80	1.0000000
NODE_7432_length_961_cov_12.968677	400	480	0	80	80	1.0000000
NODE_7433_length_961_cov_9.875870	439	519	0	80	80	1.0000000
NODE_7433_length_961_cov_9.875870	492	572	0	80	80	1.0000000
NODE_7434_length_961_cov_6.172854	624	704	0	80	80	1.0000000
NODE_7434_length_961_cov_6.172854	677	757	0	80	80	1.0000000
NODE_7435_length_961_cov_4.553364	451	531	0	45	80	0.5625000
NODE_7435_length_961_cov_4.553364	451	531	2	35	80	0.4375000
NODE_7435_length_961_cov_4.553364	504	584	0	80	80	1.0000000
NODE_7440_length_960_cov_35.649245	65	145	0	80	80	1.0000000
NODE_7440_length_960_cov_35.649245	118	198	0	80	80	1.0000000
NODE_7440_length_960_cov_35.649245	446	526	0	80	80	1.0000000
NODE_7440_length_960_cov_35.649245	499	579	0	80	80	1.0000000
NODE_7441_length_960_cov_34.886179	386	466	2	37	80	0.4625000
NODE_7441_length_960_cov_34.886179	386	466	4	43	80	0.5375000
NODE_7441_length_960_cov_34.886179	439	519	2	53	80	0.6625000
NODE_7441_length_960_cov_34.886179	439	519	4	27	80	0.3375000
NODE_7443_length_960_cov_25.133566	413	493	0	80	80	1.0000000
NODE_7443_length_960_cov_25.133566	466	546	0	80	80	1.0000000
NODE_7444_length_960_cov_19.336818	385	465	3	9	80	0.1125000
NODE_7444_length_960_cov_19.336818	385	465	6	33	80	0.4125000
NODE_7444_length_960_cov_19.336818	385	465	10	30	80	0.3750000
NODE_7444_length_960_cov_19.336818	385	465	12	8	80	0.1000000
NODE_7444_length_960_cov_19.336818	438	518	9	9	80	0.1125000
NODE_7444_length_960_cov_19.336818	438	518	10	19	80	0.2375000
NODE_7444_length_960_cov_19.336818	438	518	12	52	80	0.6500000
NODE_7445_length_960_cov_13.221835	460	539	0	14	79	0.1772152
NODE_7445_length_960_cov_13.221835	460	539	2	65	79	0.8227848
NODE_7445_length_960_cov_13.221835	512	592	0	52	80	0.6500000
NODE_7445_length_960_cov_13.221835	512	592	2	28	80	0.3500000
NODE_7446_length_960_cov_12.804878	347	427	10	25	80	0.3125000
NODE_7446_length_960_cov_12.804878	347	427	12	39	80	0.4875000
NODE_7446_length_960_cov_12.804878	347	427	14	16	80	0.2000000
NODE_7446_length_960_cov_12.804878	400	480	2	20	80	0.2500000
NODE_7446_length_960_cov_12.804878	400	480	10	10	80	0.1250000
NODE_7446_length_960_cov_12.804878	400	480	12	7	80	0.0875000
NODE_7446_length_960_cov_12.804878	400	480	14	43	80	0.5375000
NODE_7462_length_959_cov_39.394186	326	406	0	11	80	0.1375000
NODE_7462_length_959_cov_39.394186	326	406	4	69	80	0.8625000
NODE_7462_length_959_cov_39.394186	379	459	0	64	80	0.8000000
NODE_7462_length_959_cov_39.394186	379	459	4	16	80	0.2000000
NODE_7463_length_959_cov_28.895349	327	407	0	53	80	0.6625000
NODE_7463_length_959_cov_28.895349	327	407	2	27	80	0.3375000
NODE_7463_length_959_cov_28.895349	380	460	0	80	80	1.0000000
NODE_7464_length_959_cov_26.634884	563	643	0	80	80	1.0000000
NODE_7464_length_959_cov_26.634884	616	696	0	80	80	1.0000000
NODE_7464_length_959_cov_26.634884	692	772	0	49	80	0.6125000
NODE_7464_length_959_cov_26.634884	692	772	4	31	80	0.3875000
NODE_7464_length_959_cov_26.634884	745	825	2	14	80	0.1750000
NODE_7464_length_959_cov_26.634884	745	825	4	66	80	0.8250000
NODE_7465_length_959_cov_18.862791	320	400	0	33	80	0.4125000
NODE_7465_length_959_cov_18.862791	320	400	2	47	80	0.5875000
NODE_7465_length_959_cov_18.862791	373	453	0	80	80	1.0000000
NODE_7466_length_959_cov_17.910465	358	438	0	80	80	1.0000000
NODE_7466_length_959_cov_17.910465	411	491	0	80	80	1.0000000
NODE_7467_length_959_cov_15.337209	267	347	0	80	80	1.0000000
NODE_7467_length_959_cov_15.337209	320	400	0	80	80	1.0000000
NODE_7468_length_959_cov_9.005814	529	609	0	20	80	0.2500000
NODE_7468_length_959_cov_9.005814	529	609	2	60	80	0.7500000
NODE_7468_length_959_cov_9.005814	582	662	0	40	80	0.5000000
NODE_7468_length_959_cov_9.005814	582	662	2	40	80	0.5000000
NODE_7469_length_959_cov_8.163953	392	472	0	79	80	0.9875000
NODE_7469_length_959_cov_8.163953	392	472	2	1	80	0.0125000
NODE_7469_length_959_cov_8.163953	445	525	0	26	80	0.3250000
NODE_7469_length_959_cov_8.163953	445	525	2	54	80	0.6750000
NODE_7470_length_959_cov_7.097674	401	481	0	65	80	0.8125000
NODE_7470_length_959_cov_7.097674	401	481	2	15	80	0.1875000
NODE_7470_length_959_cov_7.097674	454	534	0	12	80	0.1500000
NODE_7470_length_959_cov_7.097674	454	534	2	68	80	0.8500000
NODE_7472_length_959_cov_4.603488	596	676	0	80	80	1.0000000
NODE_7472_length_959_cov_4.603488	649	729	0	80	80	1.0000000
NODE_7486_length_958_cov_57.015134	328	408	0	80	80	1.0000000
NODE_7486_length_958_cov_57.015134	381	461	0	80	80	1.0000000
NODE_7486_length_958_cov_57.015134	457	537	0	80	80	1.0000000
NODE_7486_length_958_cov_57.015134	510	590	0	80	80	1.0000000
NODE_7487_length_958_cov_42.265425	418	498	0	80	80	1.0000000
NODE_7487_length_958_cov_42.265425	471	551	0	80	80	1.0000000
NODE_7488_length_958_cov_28.618161	336	416	4	36	80	0.4500000
NODE_7488_length_958_cov_28.618161	336	416	8	44	80	0.5500000
NODE_7488_length_958_cov_28.618161	389	469	0	53	80	0.6625000
NODE_7488_length_958_cov_28.618161	389	469	4	27	80	0.3375000
NODE_7488_length_958_cov_28.618161	465	545	0	58	80	0.7250000
NODE_7488_length_958_cov_28.618161	465	545	6	22	80	0.2750000
NODE_7488_length_958_cov_28.618161	518	598	0	26	80	0.3250000
NODE_7488_length_958_cov_28.618161	518	598	6	54	80	0.6750000
NODE_7489_length_958_cov_16.452852	446	526	0	11	80	0.1375000
NODE_7489_length_958_cov_16.452852	446	526	2	69	80	0.8625000
NODE_7489_length_958_cov_16.452852	499	579	0	49	80	0.6125000
NODE_7489_length_958_cov_16.452852	499	579	2	31	80	0.3875000
NODE_7490_length_958_cov_16.008149	446	526	0	17	80	0.2125000
NODE_7490_length_958_cov_16.008149	446	526	2	63	80	0.7875000
NODE_7490_length_958_cov_16.008149	499	579	0	70	80	0.8750000
NODE_7490_length_958_cov_16.008149	499	579	2	10	80	0.1250000
NODE_7491_length_958_cov_14.154831	516	596	4	8	80	0.1000000
NODE_7491_length_958_cov_14.154831	516	596	10	72	80	0.9000000
NODE_7491_length_958_cov_14.154831	569	649	0	13	80	0.1625000
NODE_7491_length_958_cov_14.154831	569	649	9	1	80	0.0125000
NODE_7491_length_958_cov_14.154831	569	649	10	66	80	0.8250000
NODE_7492_length_958_cov_12.381839	454	534	0	28	80	0.3500000
NODE_7492_length_958_cov_12.381839	454	534	1	24	80	0.3000000
NODE_7492_length_958_cov_12.381839	454	534	2	28	80	0.3500000
NODE_7492_length_958_cov_12.381839	507	587	0	80	80	1.0000000
NODE_7493_length_958_cov_11.782305	479	559	0	76	80	0.9500000
NODE_7493_length_958_cov_11.782305	479	559	7	4	80	0.0500000
NODE_7493_length_958_cov_11.782305	532	612	0	23	80	0.2875000
NODE_7493_length_958_cov_11.782305	532	612	7	26	80	0.3250000
NODE_7493_length_958_cov_11.782305	532	612	8	31	80	0.3875000
NODE_7501_length_957_cov_40.837995	746	826	0	8	80	0.1000000
NODE_7501_length_957_cov_40.837995	746	826	1	1	80	0.0125000
NODE_7501_length_957_cov_40.837995	746	826	2	71	80	0.8875000
NODE_7501_length_957_cov_40.837995	799	879	0	20	80	0.2500000
NODE_7501_length_957_cov_40.837995	799	879	2	60	80	0.7500000
NODE_7502_length_957_cov_25.976690	631	711	0	23	80	0.2875000
NODE_7502_length_957_cov_25.976690	631	711	4	21	80	0.2625000
NODE_7502_length_957_cov_25.976690	631	711	8	36	80	0.4500000
NODE_7502_length_957_cov_25.976690	684	764	4	26	80	0.3250000
NODE_7502_length_957_cov_25.976690	684	764	8	54	80	0.6750000
NODE_7503_length_957_cov_25.855478	57	131	2	2	74	0.0270270
NODE_7503_length_957_cov_25.855478	57	131	4	9	74	0.1216216
NODE_7503_length_957_cov_25.855478	57	131	6	1	74	0.0135135
NODE_7503_length_957_cov_25.855478	57	131	8	5	74	0.0675676
NODE_7503_length_957_cov_25.855478	57	131	10	1	74	0.0135135
NODE_7503_length_957_cov_25.855478	57	131	12	1	74	0.0135135
NODE_7503_length_957_cov_25.855478	57	131	14	55	74	0.7432432
NODE_7503_length_957_cov_25.855478	414	494	0	36	80	0.4500000
NODE_7503_length_957_cov_25.855478	414	494	4	44	80	0.5500000
NODE_7503_length_957_cov_25.855478	467	547	0	25	80	0.3125000
NODE_7503_length_957_cov_25.855478	467	547	4	55	80	0.6875000
NODE_7504_length_957_cov_24.625874	445	525	2	22	80	0.2750000
NODE_7504_length_957_cov_24.625874	445	525	4	28	80	0.3500000
NODE_7504_length_957_cov_24.625874	445	525	6	30	80	0.3750000
NODE_7504_length_957_cov_24.625874	498	578	0	46	80	0.5750000
NODE_7504_length_957_cov_24.625874	498	578	2	29	80	0.3625000
NODE_7504_length_957_cov_24.625874	498	578	4	5	80	0.0625000
NODE_7505_length_957_cov_19.955711	286	366	0	80	80	1.0000000
NODE_7505_length_957_cov_19.955711	339	419	0	80	80	1.0000000
NODE_7506_length_957_cov_18.861305	414	494	2	62	80	0.7750000
NODE_7506_length_957_cov_18.861305	414	494	4	12	80	0.1500000
NODE_7506_length_957_cov_18.861305	414	494	6	6	80	0.0750000
NODE_7506_length_957_cov_18.861305	467	547	2	9	80	0.1125000
NODE_7506_length_957_cov_18.861305	467	547	4	65	80	0.8125000
NODE_7506_length_957_cov_18.861305	467	547	6	6	80	0.0750000
NODE_7507_length_957_cov_17.356643	361	441	0	80	80	1.0000000
NODE_7507_length_957_cov_17.356643	414	494	0	80	80	1.0000000
NODE_7508_length_957_cov_13.569930	162	242	2	80	80	1.0000000
NODE_7508_length_957_cov_13.569930	215	299	0	19	84	0.2261905
NODE_7508_length_957_cov_13.569930	215	299	2	65	84	0.7738096
NODE_7509_length_957_cov_12.334499	314	394	0	80	80	1.0000000
NODE_7509_length_957_cov_12.334499	367	447	0	80	80	1.0000000
NODE_7510_length_957_cov_12.017483	173	253	0	80	80	1.0000000
NODE_7510_length_957_cov_12.017483	226	306	0	29	80	0.3625000
NODE_7510_length_957_cov_12.017483	226	306	2	51	80	0.6375000
NODE_7511_length_957_cov_10.026807	446	526	0	80	80	1.0000000
NODE_7511_length_957_cov_10.026807	499	579	0	80	80	1.0000000
NODE_7529_length_956_cov_48.047841	479	559	0	52	80	0.6500000
NODE_7529_length_956_cov_48.047841	479	559	2	28	80	0.3500000
NODE_7529_length_956_cov_48.047841	532	612	0	10	80	0.1250000
NODE_7529_length_956_cov_48.047841	532	612	2	70	80	0.8750000
NODE_7529_length_956_cov_48.047841	608	688	0	80	80	1.0000000
NODE_7529_length_956_cov_48.047841	661	741	0	32	80	0.4000000
NODE_7529_length_956_cov_48.047841	661	741	2	28	80	0.3500000
NODE_7529_length_956_cov_48.047841	661	741	3	1	80	0.0125000
NODE_7529_length_956_cov_48.047841	661	741	6	12	80	0.1500000
NODE_7529_length_956_cov_48.047841	661	741	10	7	80	0.0875000
NODE_7530_length_956_cov_34.539090	298	378	0	80	80	1.0000000
NODE_7530_length_956_cov_34.539090	351	431	0	28	80	0.3500000
NODE_7530_length_956_cov_34.539090	351	431	2	52	80	0.6500000
NODE_7530_length_956_cov_34.539090	427	507	2	6	80	0.0750000
NODE_7530_length_956_cov_34.539090	427	507	6	44	80	0.5500000
NODE_7530_length_956_cov_34.539090	427	507	8	30	80	0.3750000
NODE_7530_length_956_cov_34.539090	480	560	0	13	80	0.1625000
NODE_7530_length_956_cov_34.539090	480	560	2	23	80	0.2875000
NODE_7530_length_956_cov_34.539090	480	560	6	38	80	0.4750000
NODE_7530_length_956_cov_34.539090	480	560	8	6	80	0.0750000
NODE_7531_length_956_cov_24.355893	398	478	0	60	80	0.7500000
NODE_7531_length_956_cov_24.355893	398	478	2	20	80	0.2500000
NODE_7531_length_956_cov_24.355893	451	531	0	16	80	0.2000000
NODE_7531_length_956_cov_24.355893	451	531	2	64	80	0.8000000
NODE_7532_length_956_cov_21.940490	373	453	0	73	80	0.9125000
NODE_7532_length_956_cov_21.940490	373	453	1	7	80	0.0875000
NODE_7532_length_956_cov_21.940490	426	506	0	51	80	0.6375000
NODE_7532_length_956_cov_21.940490	426	506	4	29	80	0.3625000
NODE_7532_length_956_cov_21.940490	502	582	4	80	80	1.0000000
NODE_7532_length_956_cov_21.940490	555	635	0	47	80	0.5875000
NODE_7532_length_956_cov_21.940490	555	635	4	33	80	0.4125000
NODE_7533_length_956_cov_19.435239	274	354	0	80	80	1.0000000
NODE_7533_length_956_cov_19.435239	274	301	0	27	27	1.0000000
NODE_7534_length_956_cov_17.819137	378	458	2	41	80	0.5125000
NODE_7534_length_956_cov_17.819137	378	458	4	39	80	0.4875000
NODE_7534_length_956_cov_17.819137	431	511	0	8	80	0.1000000
NODE_7534_length_956_cov_17.819137	431	511	2	68	80	0.8500000
NODE_7534_length_956_cov_17.819137	431	511	4	4	80	0.0500000
NODE_7535_length_956_cov_16.098016	551	631	0	33	80	0.4125000
NODE_7535_length_956_cov_16.098016	551	631	2	47	80	0.5875000
NODE_7535_length_956_cov_16.098016	604	684	0	27	80	0.3375000
NODE_7535_length_956_cov_16.098016	604	684	2	53	80	0.6625000
NODE_7536_length_956_cov_15.229872	490	570	0	80	80	1.0000000
NODE_7536_length_956_cov_15.229872	543	623	0	80	80	1.0000000
NODE_7537_length_956_cov_7.533256	439	519	0	80	80	1.0000000
NODE_7537_length_956_cov_7.533256	497	572	0	75	75	1.0000000
NODE_7545_length_955_cov_30.821262	438	518	0	80	80	1.0000000
NODE_7545_length_955_cov_30.821262	491	571	0	80	80	1.0000000
NODE_7546_length_955_cov_30.574766	380	460	0	80	80	1.0000000
NODE_7546_length_955_cov_30.574766	433	513	0	80	80	1.0000000
NODE_7546_length_955_cov_30.574766	509	589	0	80	80	1.0000000
NODE_7546_length_955_cov_30.574766	562	642	0	80	80	1.0000000
NODE_7547_length_955_cov_27.734813	373	453	0	13	80	0.1625000
NODE_7547_length_955_cov_27.734813	373	453	4	67	80	0.8375000
NODE_7547_length_955_cov_27.734813	426	506	0	66	80	0.8250000
NODE_7547_length_955_cov_27.734813	426	506	4	14	80	0.1750000
NODE_7548_length_955_cov_24.475467	439	519	0	7	80	0.0875000
NODE_7548_length_955_cov_24.475467	439	519	2	37	80	0.4625000
NODE_7548_length_955_cov_24.475467	439	519	8	8	80	0.1000000
NODE_7548_length_955_cov_24.475467	439	519	14	28	80	0.3500000
NODE_7548_length_955_cov_24.475467	492	572	12	19	80	0.2375000
NODE_7548_length_955_cov_24.475467	492	572	14	61	80	0.7625000
NODE_7549_length_955_cov_22.146028	351	431	0	80	80	1.0000000
NODE_7549_length_955_cov_22.146028	404	484	0	80	80	1.0000000
NODE_7550_length_955_cov_16.212617	441	521	0	80	80	1.0000000
NODE_7550_length_955_cov_16.212617	494	574	0	80	80	1.0000000
NODE_7551_length_955_cov_13.334112	269	349	0	9	80	0.1125000
NODE_7551_length_955_cov_13.334112	269	349	6	71	80	0.8875000
NODE_7551_length_955_cov_13.334112	322	402	0	20	80	0.2500000
NODE_7551_length_955_cov_13.334112	322	402	6	60	80	0.7500000
NODE_7552_length_955_cov_12.544393	363	443	0	80	80	1.0000000
NODE_7552_length_955_cov_12.544393	416	496	0	80	80	1.0000000
NODE_7553_length_955_cov_8.204439	358	438	0	12	80	0.1500000
NODE_7553_length_955_cov_8.204439	358	438	4	68	80	0.8500000
NODE_7553_length_955_cov_8.204439	411	491	0	65	80	0.8125000
NODE_7553_length_955_cov_8.204439	411	491	4	15	80	0.1875000
NODE_7563_length_954_cov_35.691228	381	461	0	19	80	0.2375000
NODE_7563_length_954_cov_35.691228	381	461	2	61	80	0.7625000
NODE_7563_length_954_cov_35.691228	434	514	0	34	80	0.4250000
NODE_7563_length_954_cov_35.691228	434	514	2	46	80	0.5750000
NODE_7564_length_954_cov_30.769591	408	488	0	80	80	1.0000000
NODE_7564_length_954_cov_30.769591	461	541	0	80	80	1.0000000
NODE_7565_length_954_cov_27.247953	418	498	0	62	80	0.7750000
NODE_7565_length_954_cov_27.247953	418	498	4	18	80	0.2250000
NODE_7565_length_954_cov_27.247953	471	551	0	9	80	0.1125000
NODE_7565_length_954_cov_27.247953	471	551	4	71	80	0.8875000
NODE_7566_length_954_cov_22.796491	270	350	0	80	80	1.0000000
NODE_7566_length_954_cov_22.796491	323	403	0	80	80	1.0000000
NODE_7567_length_954_cov_15.645614	337	417	0	80	80	1.0000000
NODE_7567_length_954_cov_15.645614	390	470	0	80	80	1.0000000
NODE_7568_length_954_cov_13.538012	346	426	0	8	80	0.1000000
NODE_7568_length_954_cov_13.538012	346	426	2	72	80	0.9000000
NODE_7568_length_954_cov_13.538012	399	479	0	61	80	0.7625000
NODE_7568_length_954_cov_13.538012	399	479	2	19	80	0.2375000
NODE_7569_length_954_cov_12.162573	155	217	0	36	62	0.5806451
NODE_7569_length_954_cov_12.162573	155	217	2	7	62	0.1129032
NODE_7569_length_954_cov_12.162573	155	217	4	19	62	0.3064516
NODE_7570_length_954_cov_10.714620	239	319	4	78	80	0.9750000
NODE_7570_length_954_cov_10.714620	239	319	6	2	80	0.0250000
NODE_7570_length_954_cov_10.714620	292	372	2	33	80	0.4125000
NODE_7570_length_954_cov_10.714620	292	372	4	25	80	0.3125000
NODE_7570_length_954_cov_10.714620	292	372	6	22	80	0.2750000
NODE_7571_length_954_cov_5.670175	431	511	0	80	80	1.0000000
NODE_7571_length_954_cov_5.670175	484	564	0	29	80	0.3625000
NODE_7571_length_954_cov_5.670175	484	564	2	51	80	0.6375000
NODE_7582_length_953_cov_35.789227	425	505	10	80	80	1.0000000
NODE_7582_length_953_cov_35.789227	478	558	0	16	80	0.2000000
NODE_7582_length_953_cov_35.789227	478	558	10	64	80	0.8000000
NODE_7583_length_953_cov_33.940281	430	510	0	80	80	1.0000000
NODE_7583_length_953_cov_33.940281	483	563	0	80	80	1.0000000
NODE_7584_length_953_cov_26.844262	333	413	0	76	80	0.9500000
NODE_7584_length_953_cov_26.844262	333	413	2	4	80	0.0500000
NODE_7584_length_953_cov_26.844262	386	466	0	80	80	1.0000000
NODE_7584_length_953_cov_26.844262	462	542	0	80	80	1.0000000
NODE_7584_length_953_cov_26.844262	515	595	0	80	80	1.0000000
NODE_7585_length_953_cov_20.770492	301	381	0	80	80	1.0000000
NODE_7585_length_953_cov_20.770492	354	434	0	80	80	1.0000000
NODE_7586_length_953_cov_17.514052	421	501	2	80	80	1.0000000
NODE_7586_length_953_cov_17.514052	474	554	0	52	80	0.6500000
NODE_7586_length_953_cov_17.514052	474	554	2	28	80	0.3500000
NODE_7586_length_953_cov_17.514052	550	630	0	80	80	1.0000000
NODE_7586_length_953_cov_17.514052	603	683	0	80	80	1.0000000
NODE_7587_length_953_cov_11.579625	332	412	0	80	80	1.0000000
NODE_7587_length_953_cov_11.579625	385	465	0	80	80	1.0000000
NODE_7588_length_953_cov_7.281030	276	356	0	80	80	1.0000000
NODE_7588_length_953_cov_7.281030	329	409	0	80	80	1.0000000
NODE_7599_length_952_cov_44.880422	447	527	0	65	80	0.8125000
NODE_7599_length_952_cov_44.880422	447	527	2	15	80	0.1875000
NODE_7599_length_952_cov_44.880422	500	580	0	12	80	0.1500000
NODE_7599_length_952_cov_44.880422	500	580	2	68	80	0.8500000
NODE_7599_length_952_cov_44.880422	871	951	0	80	80	1.0000000
NODE_7600_length_952_cov_42.485346	402	482	0	24	80	0.3000000
NODE_7600_length_952_cov_42.485346	402	482	6	46	80	0.5750000
NODE_7600_length_952_cov_42.485346	402	482	8	5	80	0.0625000
NODE_7600_length_952_cov_42.485346	402	482	11	4	80	0.0500000
NODE_7600_length_952_cov_42.485346	402	482	13	1	80	0.0125000
NODE_7600_length_952_cov_42.485346	455	535	6	17	80	0.2125000
NODE_7600_length_952_cov_42.485346	455	535	8	5	80	0.0625000
NODE_7600_length_952_cov_42.485346	455	535	11	4	80	0.0500000
NODE_7600_length_952_cov_42.485346	455	535	13	54	80	0.6750000
NODE_7601_length_952_cov_40.065651	422	502	0	80	80	1.0000000
NODE_7601_length_952_cov_40.065651	475	555	0	80	80	1.0000000
NODE_7602_length_952_cov_34.813599	308	388	4	80	80	1.0000000
NODE_7602_length_952_cov_34.813599	361	441	0	53	80	0.6625000
NODE_7602_length_952_cov_34.813599	361	441	4	27	80	0.3375000
NODE_7603_length_952_cov_28.055100	661	741	0	80	80	1.0000000
NODE_7603_length_952_cov_28.055100	714	794	0	80	80	1.0000000
NODE_7604_length_952_cov_23.739742	435	515	0	14	80	0.1750000
NODE_7604_length_952_cov_23.739742	435	515	1	6	80	0.0750000
NODE_7604_length_952_cov_23.739742	435	515	2	13	80	0.1625000
NODE_7604_length_952_cov_23.739742	435	515	4	11	80	0.1375000
NODE_7604_length_952_cov_23.739742	435	515	6	15	80	0.1875000
NODE_7604_length_952_cov_23.739742	435	515	11	1	80	0.0125000
NODE_7604_length_952_cov_23.739742	435	515	12	20	80	0.2500000
NODE_7604_length_952_cov_23.739742	488	568	6	6	80	0.0750000
NODE_7604_length_952_cov_23.739742	488	568	9	35	80	0.4375000
NODE_7604_length_952_cov_23.739742	488	568	10	1	80	0.0125000
NODE_7604_length_952_cov_23.739742	488	568	11	6	80	0.0750000
NODE_7604_length_952_cov_23.739742	488	568	12	32	80	0.4000000
NODE_7606_length_952_cov_11.478312	245	324	0	79	79	1.0000000
NODE_7606_length_952_cov_11.478312	297	377	0	80	80	1.0000000
NODE_7607_length_952_cov_11.284877	272	352	0	80	80	1.0000000
NODE_7607_length_952_cov_11.284877	325	405	0	41	80	0.5125000
NODE_7607_length_952_cov_11.284877	325	405	2	39	80	0.4875000
NODE_7608_length_952_cov_10.807737	458	538	0	80	80	1.0000000
NODE_7608_length_952_cov_10.807737	511	591	0	80	80	1.0000000
NODE_7609_length_952_cov_8.770223	375	455	0	80	80	1.0000000
NODE_7609_length_952_cov_8.770223	428	508	0	80	80	1.0000000
NODE_7623_length_951_cov_54.397887	354	434	0	80	80	1.0000000
NODE_7623_length_951_cov_54.397887	407	487	0	61	80	0.7625000
NODE_7623_length_951_cov_54.397887	407	487	2	19	80	0.2375000
NODE_7623_length_951_cov_54.397887	483	563	2	18	80	0.2250000
NODE_7623_length_951_cov_54.397887	483	563	4	5	80	0.0625000
NODE_7623_length_951_cov_54.397887	483	563	6	34	80	0.4250000
NODE_7623_length_951_cov_54.397887	483	563	10	23	80	0.2875000
NODE_7623_length_951_cov_54.397887	544	616	6	17	72	0.2361111
NODE_7623_length_951_cov_54.397887	544	616	8	23	72	0.3194444
NODE_7623_length_951_cov_54.397887	544	616	10	32	72	0.4444444
NODE_7624_length_951_cov_47.881455	355	435	0	80	80	1.0000000
NODE_7624_length_951_cov_47.881455	408	488	0	80	80	1.0000000
NODE_7624_length_951_cov_47.881455	484	564	0	35	80	0.4375000
NODE_7624_length_951_cov_47.881455	484	564	4	45	80	0.5625000
NODE_7624_length_951_cov_47.881455	537	617	0	25	80	0.3125000
NODE_7624_length_951_cov_47.881455	537	617	4	55	80	0.6875000
NODE_7625_length_951_cov_24.322770	479	559	0	80	80	1.0000000
NODE_7625_length_951_cov_24.322770	532	612	0	80	80	1.0000000
NODE_7626_length_951_cov_23.001174	470	550	0	7	80	0.0875000
NODE_7626_length_951_cov_23.001174	470	550	2	73	80	0.9125000
NODE_7626_length_951_cov_23.001174	523	603	0	51	80	0.6375000
NODE_7626_length_951_cov_23.001174	523	603	2	29	80	0.3625000
NODE_7627_length_951_cov_22.059859	562	642	4	80	80	1.0000000
NODE_7627_length_951_cov_22.059859	615	695	2	8	80	0.1000000
NODE_7627_length_951_cov_22.059859	615	695	4	72	80	0.9000000
NODE_7628_length_951_cov_19.413146	456	536	0	80	80	1.0000000
NODE_7628_length_951_cov_19.413146	509	589	0	80	80	1.0000000
NODE_7628_length_951_cov_19.413146	830	877	2	47	47	1.0000000
NODE_7629_length_951_cov_18.970657	384	464	0	32	80	0.4000000
NODE_7629_length_951_cov_18.970657	384	464	2	48	80	0.6000000
NODE_7629_length_951_cov_18.970657	437	517	0	30	80	0.3750000
NODE_7629_length_951_cov_18.970657	437	517	2	50	80	0.6250000
NODE_7629_length_951_cov_18.970657	513	593	0	46	80	0.5750000
NODE_7629_length_951_cov_18.970657	513	593	2	34	80	0.4250000
NODE_7629_length_951_cov_18.970657	566	646	0	21	80	0.2625000
NODE_7629_length_951_cov_18.970657	566	646	2	59	80	0.7375000
NODE_7630_length_951_cov_17.164319	409	490	0	81	81	1.0000000
NODE_7630_length_951_cov_17.164319	463	543	0	80	80	1.0000000
NODE_7631_length_951_cov_17.009390	393	473	0	7	80	0.0875000
NODE_7631_length_951_cov_17.009390	393	473	2	8	80	0.1000000
NODE_7631_length_951_cov_17.009390	393	473	13	65	80	0.8125000
NODE_7631_length_951_cov_17.009390	446	526	10	27	80	0.3375000
NODE_7631_length_951_cov_17.009390	446	526	12	24	80	0.3000000
NODE_7631_length_951_cov_17.009390	446	526	13	27	80	0.3375000
NODE_7631_length_951_cov_17.009390	446	526	14	2	80	0.0250000
NODE_7632_length_951_cov_15.551643	520	600	0	80	80	1.0000000
NODE_7632_length_951_cov_15.551643	573	653	0	80	80	1.0000000
NODE_7633_length_951_cov_13.562207	364	444	0	80	80	1.0000000
NODE_7633_length_951_cov_13.562207	417	497	0	80	80	1.0000000
NODE_7634_length_951_cov_13.086854	450	530	0	80	80	1.0000000
NODE_7634_length_951_cov_13.086854	503	583	0	80	80	1.0000000
NODE_7635_length_951_cov_6.812207	350	430	0	80	80	1.0000000
NODE_7635_length_951_cov_6.812207	403	483	0	80	80	1.0000000
NODE_7636_length_951_cov_5.076291	80	160	0	80	80	1.0000000
NODE_7636_length_951_cov_5.076291	133	213	0	80	80	1.0000000
NODE_7649_length_950_cov_62.151586	731	794	0	29	63	0.4603175
NODE_7649_length_950_cov_62.151586	731	794	6	5	63	0.0793651
NODE_7649_length_950_cov_62.151586	731	794	12	26	63	0.4126984
NODE_7649_length_950_cov_62.151586	731	794	14	3	63	0.0476190
NODE_7650_length_950_cov_56.088132	354	434	0	80	80	1.0000000
NODE_7650_length_950_cov_56.088132	407	487	0	80	80	1.0000000
NODE_7650_length_950_cov_56.088132	483	563	0	64	80	0.8000000
NODE_7650_length_950_cov_56.088132	483	563	4	16	80	0.2000000
NODE_7650_length_950_cov_56.088132	536	616	0	11	80	0.1375000
NODE_7650_length_950_cov_56.088132	536	616	4	69	80	0.8625000
NODE_7651_length_950_cov_29.780259	501	581	0	15	80	0.1875000
NODE_7651_length_950_cov_29.780259	501	581	2	65	80	0.8125000
NODE_7651_length_950_cov_29.780259	554	634	0	16	80	0.2000000
NODE_7651_length_950_cov_29.780259	554	634	2	64	80	0.8000000
NODE_7652_length_950_cov_27.278496	388	468	0	80	80	1.0000000
NODE_7652_length_950_cov_27.278496	441	519	0	78	78	1.0000000
NODE_7653_length_950_cov_26.766157	322	402	0	80	80	1.0000000
NODE_7653_length_950_cov_26.766157	375	455	0	80	80	1.0000000
NODE_7653_length_950_cov_26.766157	451	531	0	80	80	1.0000000
NODE_7653_length_950_cov_26.766157	504	584	0	80	80	1.0000000
NODE_7654_length_950_cov_19.638073	421	501	0	1	80	0.0125000
NODE_7654_length_950_cov_19.638073	421	501	4	79	80	0.9875000
NODE_7654_length_950_cov_19.638073	474	554	0	13	80	0.1625000
NODE_7654_length_950_cov_19.638073	474	554	4	67	80	0.8375000
NODE_7654_length_950_cov_19.638073	550	630	0	71	80	0.8875000
NODE_7654_length_950_cov_19.638073	550	630	2	9	80	0.1125000
NODE_7654_length_950_cov_19.638073	603	683	0	18	80	0.2250000
NODE_7654_length_950_cov_19.638073	603	683	2	62	80	0.7750000
NODE_7655_length_950_cov_14.686251	376	456	0	80	80	1.0000000
NODE_7655_length_950_cov_14.686251	429	509	0	80	80	1.0000000
NODE_7656_length_950_cov_14.215041	339	419	0	80	80	1.0000000
NODE_7656_length_950_cov_14.215041	392	472	0	80	80	1.0000000
NODE_7657_length_950_cov_6.397180	370	450	0	80	80	1.0000000
NODE_7657_length_950_cov_6.397180	423	504	0	81	81	1.0000000
NODE_7659_length_950_cov_4.430082	594	674	0	80	80	1.0000000
NODE_7659_length_950_cov_4.430082	647	727	0	80	80	1.0000000
NODE_7672_length_949_cov_25.550588	371	451	0	17	80	0.2125000
NODE_7672_length_949_cov_25.550588	371	451	2	63	80	0.7875000
NODE_7672_length_949_cov_25.550588	500	580	0	45	80	0.5625000
NODE_7672_length_949_cov_25.550588	500	580	4	1	80	0.0125000
NODE_7672_length_949_cov_25.550588	500	580	6	34	80	0.4250000
NODE_7672_length_949_cov_25.550588	553	633	4	16	80	0.2000000
NODE_7672_length_949_cov_25.550588	553	633	6	64	80	0.8000000
NODE_7673_length_949_cov_20.949412	252	332	0	80	80	1.0000000
NODE_7673_length_949_cov_20.949412	305	385	0	80	80	1.0000000
NODE_7674_length_949_cov_20.601176	364	444	0	80	80	1.0000000
NODE_7674_length_949_cov_20.601176	417	497	0	49	80	0.6125000
NODE_7674_length_949_cov_20.601176	417	497	2	31	80	0.3875000
NODE_7674_length_949_cov_20.601176	493	573	0	2	80	0.0250000
NODE_7674_length_949_cov_20.601176	493	573	2	78	80	0.9750000
NODE_7674_length_949_cov_20.601176	546	626	0	55	80	0.6875000
NODE_7674_length_949_cov_20.601176	546	626	2	25	80	0.3125000
NODE_7675_length_949_cov_20.575294	481	561	0	80	80	1.0000000
NODE_7675_length_949_cov_20.575294	534	614	0	80	80	1.0000000
NODE_7676_length_949_cov_19.483529	340	420	0	80	80	1.0000000
NODE_7676_length_949_cov_19.483529	393	473	0	80	80	1.0000000
NODE_7676_length_949_cov_19.483529	469	549	0	28	80	0.3500000
NODE_7676_length_949_cov_19.483529	469	549	2	18	80	0.2250000
NODE_7676_length_949_cov_19.483529	469	549	3	34	80	0.4250000
NODE_7676_length_949_cov_19.483529	522	602	3	80	80	1.0000000
NODE_7677_length_949_cov_19.407059	433	513	0	22	80	0.2750000
NODE_7677_length_949_cov_19.407059	433	513	2	29	80	0.3625000
NODE_7677_length_949_cov_19.407059	433	513	6	29	80	0.3625000
NODE_7677_length_949_cov_19.407059	486	566	0	75	80	0.9375000
NODE_7677_length_949_cov_19.407059	486	566	2	5	80	0.0625000
NODE_7677_length_949_cov_19.407059	562	642	0	80	80	1.0000000
NODE_7677_length_949_cov_19.407059	615	695	0	80	80	1.0000000
NODE_7678_length_949_cov_10.903529	561	641	0	80	80	1.0000000
NODE_7678_length_949_cov_10.903529	614	694	0	80	80	1.0000000
NODE_7679_length_949_cov_7.245882	0	71	0	71	71	1.0000000
NODE_7679_length_949_cov_7.245882	0	71	0	71	71	1.0000000
NODE_7679_length_949_cov_7.245882	44	124	0	56	80	0.7000000
NODE_7679_length_949_cov_7.245882	44	124	2	24	80	0.3000000
NODE_7680_length_949_cov_6.998824	494	574	0	80	80	1.0000000
NODE_7680_length_949_cov_6.998824	547	627	0	80	80	1.0000000
NODE_7702_length_948_cov_37.201413	510	590	8	49	80	0.6125000
NODE_7702_length_948_cov_37.201413	510	590	10	31	80	0.3875000
NODE_7702_length_948_cov_37.201413	563	643	4	16	80	0.2000000
NODE_7702_length_948_cov_37.201413	563	643	8	51	80	0.6375000
NODE_7702_length_948_cov_37.201413	563	643	10	13	80	0.1625000
NODE_7703_length_948_cov_20.082450	58	99	0	41	41	1.0000000
NODE_7703_length_948_cov_20.082450	113	193	10	4	80	0.0500000
NODE_7703_length_948_cov_20.082450	113	193	12	1	80	0.0125000
NODE_7703_length_948_cov_20.082450	113	193	15	4	80	0.0500000
NODE_7703_length_948_cov_20.082450	113	193	19	1	80	0.0125000
NODE_7703_length_948_cov_20.082450	113	193	21	1	80	0.0125000
NODE_7703_length_948_cov_20.082450	113	193	25	3	80	0.0375000
NODE_7703_length_948_cov_20.082450	113	193	29	12	80	0.1500000
NODE_7703_length_948_cov_20.082450	113	193	34	3	80	0.0375000
NODE_7703_length_948_cov_20.082450	113	193	35	16	80	0.2000000
NODE_7703_length_948_cov_20.082450	113	193	36	18	80	0.2250000
NODE_7703_length_948_cov_20.082450	113	193	37	1	80	0.0125000
NODE_7703_length_948_cov_20.082450	113	193	38	16	80	0.2000000
NODE_7703_length_948_cov_20.082450	166	246	18	11	80	0.1375000
NODE_7703_length_948_cov_20.082450	166	246	20	14	80	0.1750000
NODE_7703_length_948_cov_20.082450	166	246	22	14	80	0.1750000
NODE_7703_length_948_cov_20.082450	166	246	24	4	80	0.0500000
NODE_7703_length_948_cov_20.082450	166	246	26	2	80	0.0250000
NODE_7703_length_948_cov_20.082450	166	246	28	3	80	0.0375000
NODE_7703_length_948_cov_20.082450	166	246	30	2	80	0.0250000
NODE_7703_length_948_cov_20.082450	166	246	34	6	80	0.0750000
NODE_7703_length_948_cov_20.082450	166	246	36	18	80	0.2250000
NODE_7703_length_948_cov_20.082450	166	246	38	6	80	0.0750000
NODE_7704_length_948_cov_16.785630	308	388	0	80	80	1.0000000
NODE_7704_length_948_cov_16.785630	361	441	0	80	80	1.0000000
NODE_7704_length_948_cov_16.785630	437	517	0	80	80	1.0000000
NODE_7704_length_948_cov_16.785630	490	570	0	80	80	1.0000000
NODE_7705_length_948_cov_12.740872	400	480	0	80	80	1.0000000
NODE_7705_length_948_cov_12.740872	453	533	0	80	80	1.0000000
NODE_7706_length_948_cov_10.220259	465	545	0	80	80	1.0000000
NODE_7706_length_948_cov_10.220259	518	598	0	40	80	0.5000000
NODE_7706_length_948_cov_10.220259	518	598	2	40	80	0.5000000
NODE_7707_length_948_cov_8.504122	456	536	2	80	80	1.0000000
NODE_7707_length_948_cov_8.504122	509	589	0	10	80	0.1250000
NODE_7707_length_948_cov_8.504122	509	589	2	70	80	0.8750000
NODE_7709_length_948_cov_5.425206	641	721	0	32	80	0.4000000
NODE_7709_length_948_cov_5.425206	641	721	4	14	80	0.1750000
NODE_7709_length_948_cov_5.425206	641	721	6	34	80	0.4250000
NODE_7709_length_948_cov_5.425206	694	774	2	17	80	0.2125000
NODE_7709_length_948_cov_5.425206	694	774	6	63	80	0.7875000
NODE_7711_length_948_cov_3.586572	696	776	0	80	80	1.0000000
NODE_7715_length_948_cov_2.786808	259	324	0	65	65	1.0000000
NODE_7715_length_948_cov_2.786808	297	377	0	80	80	1.0000000
NODE_7721_length_947_cov_91.466981	393	473	0	80	80	1.0000000
NODE_7721_length_947_cov_91.466981	446	526	0	80	80	1.0000000
NODE_7722_length_947_cov_61.139151	402	482	0	80	80	1.0000000
NODE_7722_length_947_cov_61.139151	455	535	0	80	80	1.0000000
NODE_7723_length_947_cov_50.009434	488	568	0	80	80	1.0000000
NODE_7723_length_947_cov_50.009434	541	621	0	80	80	1.0000000
NODE_7724_length_947_cov_36.271226	511	591	0	80	80	1.0000000
NODE_7724_length_947_cov_36.271226	564	644	0	80	80	1.0000000
NODE_7725_length_947_cov_23.384434	425	505	0	80	80	1.0000000
NODE_7725_length_947_cov_23.384434	478	558	0	80	80	1.0000000
NODE_7726_length_947_cov_19.103774	316	396	0	13	80	0.1625000
NODE_7726_length_947_cov_19.103774	316	396	2	67	80	0.8375000
NODE_7726_length_947_cov_19.103774	369	449	2	80	80	1.0000000
NODE_7727_length_947_cov_18.853774	516	596	0	80	80	1.0000000
NODE_7727_length_947_cov_18.853774	569	649	0	80	80	1.0000000
NODE_7728_length_947_cov_18.077830	315	395	6	39	80	0.4875000
NODE_7728_length_947_cov_18.077830	315	395	12	41	80	0.5125000
NODE_7728_length_947_cov_18.077830	368	448	6	21	80	0.2625000
NODE_7728_length_947_cov_18.077830	368	448	10	1	80	0.0125000
NODE_7728_length_947_cov_18.077830	368	448	12	58	80	0.7250000
NODE_7729_length_947_cov_17.713443	403	483	0	46	80	0.5750000
NODE_7729_length_947_cov_17.713443	403	483	4	34	80	0.4250000
NODE_7729_length_947_cov_17.713443	456	536	4	80	80	1.0000000
NODE_7730_length_947_cov_14.492925	358	438	0	1	80	0.0125000
NODE_7730_length_947_cov_14.492925	358	438	2	79	80	0.9875000
NODE_7730_length_947_cov_14.492925	411	491	0	54	80	0.6750000
NODE_7730_length_947_cov_14.492925	411	491	2	26	80	0.3250000
NODE_7730_length_947_cov_14.492925	487	567	0	60	80	0.7500000
NODE_7730_length_947_cov_14.492925	487	567	1	12	80	0.1500000
NODE_7730_length_947_cov_14.492925	487	567	2	8	80	0.1000000
NODE_7730_length_947_cov_14.492925	540	620	0	7	80	0.0875000
NODE_7730_length_947_cov_14.492925	540	620	1	12	80	0.1500000
NODE_7730_length_947_cov_14.492925	540	620	2	61	80	0.7625000
NODE_7731_length_947_cov_10.573113	550	630	0	80	80	1.0000000
NODE_7731_length_947_cov_10.573113	603	683	0	80	80	1.0000000
NODE_7732_length_947_cov_7.762972	550	630	2	5	80	0.0625000
NODE_7732_length_947_cov_7.762972	550	630	4	75	80	0.9375000
NODE_7732_length_947_cov_7.762972	607	683	0	11	76	0.1447368
NODE_7732_length_947_cov_7.762972	607	683	2	22	76	0.2894737
NODE_7732_length_947_cov_7.762972	607	683	3	1	76	0.0131579
NODE_7732_length_947_cov_7.762972	607	683	4	42	76	0.5526316
NODE_7747_length_946_cov_39.726092	378	458	0	80	80	1.0000000
NODE_7747_length_946_cov_39.726092	431	511	0	80	80	1.0000000
NODE_7747_length_946_cov_39.726092	507	587	0	80	80	1.0000000
NODE_7747_length_946_cov_39.726092	560	640	0	80	80	1.0000000
NODE_7748_length_946_cov_32.728453	404	484	2	66	80	0.8250000
NODE_7748_length_946_cov_32.728453	404	484	4	14	80	0.1750000
NODE_7748_length_946_cov_32.728453	457	537	0	14	80	0.1750000
NODE_7748_length_946_cov_32.728453	457	537	2	66	80	0.8250000
NODE_7749_length_946_cov_27.548996	280	360	0	80	80	1.0000000
NODE_7749_length_946_cov_27.548996	333	413	0	32	80	0.4000000
NODE_7749_length_946_cov_27.548996	333	413	4	48	80	0.6000000
NODE_7750_length_946_cov_24.622196	352	432	0	80	80	1.0000000
NODE_7750_length_946_cov_24.622196	405	486	0	81	81	1.0000000
NODE_7751_length_946_cov_18.082645	492	572	0	80	80	1.0000000
NODE_7751_length_946_cov_18.082645	545	625	0	80	80	1.0000000
NODE_7752_length_946_cov_18.031877	433	513	0	57	80	0.7125000
NODE_7752_length_946_cov_18.031877	433	513	2	23	80	0.2875000
NODE_7752_length_946_cov_18.031877	486	566	0	8	80	0.1000000
NODE_7752_length_946_cov_18.031877	486	566	2	72	80	0.9000000
NODE_7753_length_946_cov_15.188902	472	552	0	6	80	0.0750000
NODE_7753_length_946_cov_15.188902	472	552	2	74	80	0.9250000
NODE_7753_length_946_cov_15.188902	525	605	0	33	80	0.4125000
NODE_7753_length_946_cov_15.188902	525	605	2	47	80	0.5875000
NODE_7754_length_946_cov_11.201889	408	488	2	22	80	0.2750000
NODE_7754_length_946_cov_11.201889	408	488	4	58	80	0.7250000
NODE_7754_length_946_cov_11.201889	461	541	0	40	80	0.5000000
NODE_7754_length_946_cov_11.201889	461	541	2	35	80	0.4375000
NODE_7754_length_946_cov_11.201889	461	541	4	5	80	0.0625000
NODE_7768_length_945_cov_42.997636	361	441	0	80	80	1.0000000
NODE_7768_length_945_cov_42.997636	414	494	0	80	80	1.0000000
NODE_7769_length_945_cov_31.223404	357	437	0	4	80	0.0500000
NODE_7769_length_945_cov_31.223404	357	437	2	15	80	0.1875000
NODE_7769_length_945_cov_31.223404	357	437	4	61	80	0.7625000
NODE_7769_length_945_cov_31.223404	410	490	3	32	80	0.4000000
NODE_7769_length_945_cov_31.223404	410	490	4	48	80	0.6000000
NODE_7770_length_945_cov_26.348700	331	411	0	80	80	1.0000000
NODE_7770_length_945_cov_26.348700	384	464	0	80	80	1.0000000
NODE_7771_length_945_cov_20.349882	435	515	0	40	80	0.5000000
NODE_7771_length_945_cov_20.349882	435	515	8	40	80	0.5000000
NODE_7771_length_945_cov_20.349882	488	568	8	80	80	1.0000000
NODE_7772_length_945_cov_14.771868	386	466	0	80	80	1.0000000
NODE_7772_length_945_cov_14.771868	439	519	0	80	80	1.0000000
NODE_7773_length_945_cov_10.158392	599	679	0	49	80	0.6125000
NODE_7773_length_945_cov_10.158392	599	679	2	31	80	0.3875000
NODE_7773_length_945_cov_10.158392	652	732	0	80	80	1.0000000
NODE_7775_length_945_cov_5.403073	357	437	1	43	80	0.5375000
NODE_7775_length_945_cov_5.403073	357	437	2	37	80	0.4625000
NODE_7775_length_945_cov_5.403073	410	490	2	80	80	1.0000000
NODE_7785_length_944_cov_42.401183	358	438	0	18	80	0.2250000
NODE_7785_length_944_cov_42.401183	358	438	3	1	80	0.0125000
NODE_7785_length_944_cov_42.401183	358	438	4	48	80	0.6000000
NODE_7785_length_944_cov_42.401183	358	438	6	13	80	0.1625000
NODE_7785_length_944_cov_42.401183	411	498	4	14	87	0.1609195
NODE_7785_length_944_cov_42.401183	411	498	6	30	87	0.3448276
NODE_7785_length_944_cov_42.401183	411	498	8	43	87	0.4942529
NODE_7786_length_944_cov_32.712426	377	457	0	80	80	1.0000000
NODE_7786_length_944_cov_32.712426	430	510	0	80	80	1.0000000
NODE_7787_length_944_cov_27.839053	417	497	7	35	80	0.4375000
NODE_7787_length_944_cov_27.839053	417	497	8	45	80	0.5625000
NODE_7787_length_944_cov_27.839053	470	550	0	13	80	0.1625000
NODE_7787_length_944_cov_27.839053	470	550	7	67	80	0.8375000
NODE_7788_length_944_cov_24.702959	413	493	0	80	80	1.0000000
NODE_7788_length_944_cov_24.702959	466	546	0	80	80	1.0000000
NODE_7789_length_944_cov_11.951479	347	427	0	80	80	1.0000000
NODE_7789_length_944_cov_11.951479	400	480	0	80	80	1.0000000
NODE_7789_length_944_cov_11.951479	476	556	0	80	80	1.0000000
NODE_7789_length_944_cov_11.951479	529	609	0	80	80	1.0000000
NODE_7790_length_944_cov_6.745562	366	446	0	54	80	0.6750000
NODE_7790_length_944_cov_6.745562	366	446	2	26	80	0.3250000
NODE_7790_length_944_cov_6.745562	419	499	0	1	80	0.0125000
NODE_7790_length_944_cov_6.745562	419	499	2	79	80	0.9875000
NODE_7792_length_944_cov_4.420118	236	316	0	80	80	1.0000000
NODE_7792_length_944_cov_4.420118	289	369	0	80	80	1.0000000
NODE_7800_length_943_cov_40.111374	536	614	0	78	78	1.0000000
NODE_7800_length_943_cov_40.111374	587	667	0	80	80	1.0000000
NODE_7801_length_943_cov_29.446682	338	418	0	46	80	0.5750000
NODE_7801_length_943_cov_29.446682	338	418	4	34	80	0.4250000
NODE_7801_length_943_cov_29.446682	391	471	4	80	80	1.0000000
NODE_7802_length_943_cov_28.289100	393	473	0	61	80	0.7625000
NODE_7802_length_943_cov_28.289100	393	473	2	19	80	0.2375000
NODE_7802_length_943_cov_28.289100	446	526	0	8	80	0.1000000
NODE_7802_length_943_cov_28.289100	446	526	2	72	80	0.9000000
NODE_7803_length_943_cov_27.225118	343	423	0	80	80	1.0000000
NODE_7803_length_943_cov_27.225118	396	476	0	80	80	1.0000000
NODE_7804_length_943_cov_26.536730	275	303	2	28	28	1.0000000
NODE_7804_length_943_cov_26.536730	299	379	0	15	80	0.1875000
NODE_7804_length_943_cov_26.536730	299	379	2	62	80	0.7750000
NODE_7804_length_943_cov_26.536730	299	379	6	3	80	0.0375000
NODE_7804_length_943_cov_26.536730	352	432	0	15	80	0.1875000
NODE_7804_length_943_cov_26.536730	352	432	2	9	80	0.1125000
NODE_7804_length_943_cov_26.536730	352	432	6	33	80	0.4125000
NODE_7804_length_943_cov_26.536730	352	432	8	23	80	0.2875000
NODE_7805_length_943_cov_24.992891	374	454	0	40	80	0.5000000
NODE_7805_length_943_cov_24.992891	374	454	7	3	80	0.0375000
NODE_7805_length_943_cov_24.992891	374	454	8	37	80	0.4625000
NODE_7805_length_943_cov_24.992891	427	507	7	33	80	0.4125000
NODE_7805_length_943_cov_24.992891	427	507	8	47	80	0.5875000
NODE_7805_length_943_cov_24.992891	503	583	0	60	80	0.7500000
NODE_7805_length_943_cov_24.992891	503	583	6	1	80	0.0125000
NODE_7805_length_943_cov_24.992891	503	583	7	19	80	0.2375000
NODE_7805_length_943_cov_24.992891	556	636	0	78	80	0.9750000
NODE_7805_length_943_cov_24.992891	556	636	2	2	80	0.0250000
NODE_7806_length_943_cov_24.758294	403	483	0	80	80	1.0000000
NODE_7806_length_943_cov_24.758294	456	536	0	80	80	1.0000000
NODE_7807_length_943_cov_22.316351	432	512	0	80	80	1.0000000
NODE_7807_length_943_cov_22.316351	485	565	0	80	80	1.0000000
NODE_7808_length_943_cov_22.149289	393	473	0	80	80	1.0000000
NODE_7808_length_943_cov_22.149289	446	526	0	80	80	1.0000000
NODE_7809_length_943_cov_20.055687	412	492	0	48	80	0.6000000
NODE_7809_length_943_cov_20.055687	412	492	4	32	80	0.4000000
NODE_7809_length_943_cov_20.055687	465	545	0	16	80	0.2000000
NODE_7809_length_943_cov_20.055687	465	545	4	64	80	0.8000000
NODE_7810_length_943_cov_16.022512	338	418	0	25	80	0.3125000
NODE_7810_length_943_cov_16.022512	338	418	2	27	80	0.3375000
NODE_7810_length_943_cov_16.022512	338	418	5	2	80	0.0250000
NODE_7810_length_943_cov_16.022512	338	418	6	26	80	0.3250000
NODE_7810_length_943_cov_16.022512	391	471	4	50	80	0.6250000
NODE_7810_length_943_cov_16.022512	391	471	5	1	80	0.0125000
NODE_7810_length_943_cov_16.022512	391	471	6	29	80	0.3625000
NODE_7811_length_943_cov_10.939573	474	554	0	80	80	1.0000000
NODE_7811_length_943_cov_10.939573	527	607	0	80	80	1.0000000
NODE_7812_length_943_cov_9.483412	422	502	0	42	80	0.5250000
NODE_7812_length_943_cov_9.483412	422	502	4	38	80	0.4750000
NODE_7812_length_943_cov_9.483412	475	555	0	9	80	0.1125000
NODE_7812_length_943_cov_9.483412	475	555	4	71	80	0.8875000
NODE_7830_length_942_cov_58.088968	384	464	0	54	80	0.6750000
NODE_7830_length_942_cov_58.088968	384	464	2	26	80	0.3250000
NODE_7830_length_942_cov_58.088968	437	517	0	8	80	0.1000000
NODE_7830_length_942_cov_58.088968	437	517	2	72	80	0.9000000
NODE_7832_length_942_cov_27.466192	360	440	3	4	80	0.0500000
NODE_7832_length_942_cov_27.466192	360	440	4	50	80	0.6250000
NODE_7832_length_942_cov_27.466192	360	440	5	8	80	0.1000000
NODE_7832_length_942_cov_27.466192	360	440	6	18	80	0.2250000
NODE_7832_length_942_cov_27.466192	413	493	4	9	80	0.1125000
NODE_7832_length_942_cov_27.466192	413	493	6	46	80	0.5750000
NODE_7832_length_942_cov_27.466192	413	493	8	21	80	0.2625000
NODE_7832_length_942_cov_27.466192	413	493	10	4	80	0.0500000
NODE_7833_length_942_cov_26.914591	346	426	0	80	80	1.0000000
NODE_7833_length_942_cov_26.914591	399	479	0	80	80	1.0000000
NODE_7834_length_942_cov_17.911032	390	470	0	80	80	1.0000000
NODE_7834_length_942_cov_17.911032	443	523	0	80	80	1.0000000
NODE_7835_length_942_cov_14.695136	442	522	0	80	80	1.0000000
NODE_7835_length_942_cov_14.695136	495	575	0	80	80	1.0000000
NODE_7836_length_942_cov_14.097272	547	627	0	69	80	0.8625000
NODE_7836_length_942_cov_14.097272	547	627	1	11	80	0.1375000
NODE_7836_length_942_cov_14.097272	600	680	0	16	80	0.2000000
NODE_7836_length_942_cov_14.097272	600	680	1	18	80	0.2250000
NODE_7836_length_942_cov_14.097272	600	680	2	46	80	0.5750000
NODE_7837_length_942_cov_13.174377	322	402	0	66	80	0.8250000
NODE_7837_length_942_cov_13.174377	322	402	4	14	80	0.1750000
NODE_7837_length_942_cov_13.174377	375	455	0	13	80	0.1625000
NODE_7837_length_942_cov_13.174377	375	455	4	67	80	0.8375000
NODE_7858_length_941_cov_36.592637	259	339	0	80	80	1.0000000
NODE_7858_length_941_cov_36.592637	312	392	0	80	80	1.0000000
NODE_7858_length_941_cov_36.592637	388	468	0	80	80	1.0000000
NODE_7858_length_941_cov_36.592637	441	521	0	80	80	1.0000000
NODE_7859_length_941_cov_35.375297	352	432	0	14	80	0.1750000
NODE_7859_length_941_cov_35.375297	352	432	2	66	80	0.8250000
NODE_7859_length_941_cov_35.375297	405	485	0	9	80	0.1125000
NODE_7859_length_941_cov_35.375297	405	485	2	71	80	0.8875000
NODE_7859_length_941_cov_35.375297	481	561	0	80	80	1.0000000
NODE_7859_length_941_cov_35.375297	534	614	0	80	80	1.0000000
NODE_7860_length_941_cov_32.222090	407	487	0	50	80	0.6250000
NODE_7860_length_941_cov_32.222090	407	487	2	30	80	0.3750000
NODE_7860_length_941_cov_32.222090	460	540	2	80	80	1.0000000
NODE_7861_length_941_cov_28.442993	391	471	0	3	80	0.0375000
NODE_7861_length_941_cov_28.442993	391	471	2	77	80	0.9625000
NODE_7861_length_941_cov_28.442993	444	524	0	56	80	0.7000000
NODE_7861_length_941_cov_28.442993	444	524	2	24	80	0.3000000
NODE_7862_length_941_cov_20.788599	341	421	0	57	80	0.7125000
NODE_7862_length_941_cov_20.788599	341	421	4	23	80	0.2875000
NODE_7862_length_941_cov_20.788599	394	474	0	4	80	0.0500000
NODE_7862_length_941_cov_20.788599	394	474	4	76	80	0.9500000
NODE_7863_length_941_cov_18.000000	364	444	2	44	80	0.5500000
NODE_7863_length_941_cov_18.000000	364	444	6	10	80	0.1250000
NODE_7863_length_941_cov_18.000000	364	444	8	19	80	0.2375000
NODE_7863_length_941_cov_18.000000	364	444	13	7	80	0.0875000
NODE_7863_length_941_cov_18.000000	417	497	6	10	80	0.1250000
NODE_7863_length_941_cov_18.000000	417	497	8	10	80	0.1250000
NODE_7863_length_941_cov_18.000000	417	497	13	16	80	0.2000000
NODE_7863_length_941_cov_18.000000	417	497	20	44	80	0.5500000
NODE_7864_length_941_cov_11.020190	325	405	0	80	80	1.0000000
NODE_7864_length_941_cov_11.020190	378	458	0	80	80	1.0000000
NODE_7865_length_941_cov_6.020190	260	287	0	27	27	1.0000000
NODE_7865_length_941_cov_6.020190	260	340	0	38	80	0.4750000
NODE_7865_length_941_cov_6.020190	260	340	1	18	80	0.2250000
NODE_7865_length_941_cov_6.020190	260	340	2	24	80	0.3000000
NODE_7867_length_941_cov_3.745843	867	941	0	5	74	0.0675676
NODE_7867_length_941_cov_3.745843	867	941	2	4	74	0.0540541
NODE_7867_length_941_cov_3.745843	867	941	4	12	74	0.1621622
NODE_7867_length_941_cov_3.745843	867	941	6	3	74	0.0405405
NODE_7867_length_941_cov_3.745843	867	941	8	2	74	0.0270270
NODE_7867_length_941_cov_3.745843	867	941	10	14	74	0.1891892
NODE_7867_length_941_cov_3.745843	867	941	12	2	74	0.0270270
NODE_7867_length_941_cov_3.745843	867	941	14	32	74	0.4324324
NODE_7877_length_940_cov_43.954816	243	323	0	56	80	0.7000000
NODE_7877_length_940_cov_43.954816	243	323	1	3	80	0.0375000
NODE_7877_length_940_cov_43.954816	243	323	2	21	80	0.2625000
NODE_7877_length_940_cov_43.954816	296	376	0	24	80	0.3000000
NODE_7877_length_940_cov_43.954816	296	376	1	7	80	0.0875000
NODE_7877_length_940_cov_43.954816	296	376	2	49	80	0.6125000
NODE_7877_length_940_cov_43.954816	372	452	2	80	80	1.0000000
NODE_7877_length_940_cov_43.954816	425	505	0	52	80	0.6500000
NODE_7877_length_940_cov_43.954816	425	505	2	28	80	0.3500000
NODE_7878_length_940_cov_27.763377	423	503	0	80	80	1.0000000
NODE_7878_length_940_cov_27.763377	476	556	0	80	80	1.0000000
NODE_7897_length_939_cov_58.982143	363	443	6	14	80	0.1750000
NODE_7897_length_939_cov_58.982143	363	443	7	19	80	0.2375000
NODE_7897_length_939_cov_58.982143	363	443	11	36	80	0.4500000
NODE_7897_length_939_cov_58.982143	363	443	12	11	80	0.1375000
NODE_7897_length_939_cov_58.982143	416	496	0	24	80	0.3000000
NODE_7897_length_939_cov_58.982143	416	496	6	32	80	0.4000000
NODE_7897_length_939_cov_58.982143	416	496	7	19	80	0.2375000
NODE_7897_length_939_cov_58.982143	416	496	11	5	80	0.0625000
NODE_7898_length_939_cov_32.469048	327	407	2	2	80	0.0250000
NODE_7898_length_939_cov_32.469048	327	407	4	63	80	0.7875000
NODE_7898_length_939_cov_32.469048	327	407	6	15	80	0.1875000
NODE_7898_length_939_cov_32.469048	380	460	2	55	80	0.6875000
NODE_7898_length_939_cov_32.469048	380	460	4	15	80	0.1875000
NODE_7898_length_939_cov_32.469048	380	460	6	10	80	0.1250000
NODE_7899_length_939_cov_31.895238	265	345	0	80	80	1.0000000
NODE_7899_length_939_cov_31.895238	318	398	0	80	80	1.0000000
NODE_7900_length_939_cov_25.354762	439	519	2	6	80	0.0750000
NODE_7900_length_939_cov_25.354762	439	519	4	74	80	0.9250000
NODE_7900_length_939_cov_25.354762	492	572	0	22	80	0.2750000
NODE_7900_length_939_cov_25.354762	492	572	2	32	80	0.4000000
NODE_7900_length_939_cov_25.354762	492	572	4	26	80	0.3250000
NODE_7901_length_939_cov_24.892857	370	450	2	4	80	0.0500000
NODE_7901_length_939_cov_24.892857	370	450	4	66	80	0.8250000
NODE_7901_length_939_cov_24.892857	370	450	6	10	80	0.1250000
NODE_7901_length_939_cov_24.892857	423	503	2	10	80	0.1250000
NODE_7901_length_939_cov_24.892857	423	503	4	13	80	0.1625000
NODE_7901_length_939_cov_24.892857	423	503	6	10	80	0.1250000
NODE_7901_length_939_cov_24.892857	423	503	10	2	80	0.0250000
NODE_7901_length_939_cov_24.892857	423	503	12	45	80	0.5625000
NODE_7902_length_939_cov_24.246429	422	502	0	80	80	1.0000000
NODE_7902_length_939_cov_24.246429	475	555	0	80	80	1.0000000
NODE_7902_length_939_cov_24.246429	551	631	0	38	80	0.4750000
NODE_7902_length_939_cov_24.246429	551	631	4	1	80	0.0125000
NODE_7902_length_939_cov_24.246429	551	631	5	41	80	0.5125000
NODE_7902_length_939_cov_24.246429	604	684	5	45	80	0.5625000
NODE_7902_length_939_cov_24.246429	604	684	6	35	80	0.4375000
NODE_7903_length_939_cov_21.141667	368	448	0	80	80	1.0000000
NODE_7903_length_939_cov_21.141667	421	501	0	80	80	1.0000000
NODE_7904_length_939_cov_16.425000	327	407	0	80	80	1.0000000
NODE_7904_length_939_cov_16.425000	380	460	0	80	80	1.0000000
NODE_7905_length_939_cov_13.828571	469	548	0	57	79	0.7215190
NODE_7905_length_939_cov_13.828571	469	548	2	22	79	0.2784810
NODE_7905_length_939_cov_13.828571	522	603	0	4	81	0.0493827
NODE_7905_length_939_cov_13.828571	522	603	2	77	81	0.9506173
NODE_7906_length_939_cov_13.521429	402	482	0	80	80	1.0000000
NODE_7906_length_939_cov_13.521429	455	535	0	80	80	1.0000000
NODE_7907_length_939_cov_12.955952	398	478	0	80	80	1.0000000
NODE_7907_length_939_cov_12.955952	451	531	0	80	80	1.0000000
NODE_7908_length_939_cov_6.564286	523	545	0	22	22	1.0000000
NODE_7922_length_938_cov_44.458880	362	442	0	37	80	0.4625000
NODE_7922_length_938_cov_44.458880	362	442	5	2	80	0.0250000
NODE_7922_length_938_cov_44.458880	362	442	6	41	80	0.5125000
NODE_7922_length_938_cov_44.458880	415	495	0	3	80	0.0375000
NODE_7922_length_938_cov_44.458880	415	495	6	77	80	0.9625000
NODE_7923_length_938_cov_44.435042	748	815	0	67	67	1.0000000
NODE_7924_length_938_cov_32.177592	466	546	0	80	80	1.0000000
NODE_7924_length_938_cov_32.177592	519	599	0	80	80	1.0000000
NODE_7925_length_938_cov_21.139452	474	554	0	80	80	1.0000000
NODE_7925_length_938_cov_21.139452	527	607	0	80	80	1.0000000
NODE_7927_length_938_cov_8.791418	300	380	0	80	80	1.0000000
NODE_7927_length_938_cov_8.791418	353	433	0	64	80	0.8000000
NODE_7927_length_938_cov_8.791418	353	433	4	16	80	0.2000000
NODE_7932_length_938_cov_2.693683	59	139	4	4	80	0.0500000
NODE_7932_length_938_cov_2.693683	59	139	6	34	80	0.4250000
NODE_7932_length_938_cov_2.693683	59	139	8	42	80	0.5250000
NODE_7932_length_938_cov_2.693683	112	192	0	20	80	0.2500000
NODE_7932_length_938_cov_2.693683	112	192	2	9	80	0.1125000
NODE_7932_length_938_cov_2.693683	112	192	4	28	80	0.3500000
NODE_7932_length_938_cov_2.693683	112	192	6	3	80	0.0375000
NODE_7932_length_938_cov_2.693683	112	192	8	20	80	0.2500000
NODE_7946_length_937_cov_31.890215	407	487	0	66	80	0.8250000
NODE_7946_length_937_cov_31.890215	407	487	2	14	80	0.1750000
NODE_7946_length_937_cov_31.890215	460	536	0	13	76	0.1710526
NODE_7946_length_937_cov_31.890215	460	536	2	63	76	0.8289474
NODE_7947_length_937_cov_31.198091	425	505	0	67	80	0.8375000
NODE_7947_length_937_cov_31.198091	425	505	4	13	80	0.1625000
NODE_7947_length_937_cov_31.198091	478	558	0	14	80	0.1750000
NODE_7947_length_937_cov_31.198091	478	558	4	66	80	0.8250000
NODE_7948_length_937_cov_29.742243	296	376	0	80	80	1.0000000
NODE_7948_length_937_cov_29.742243	349	429	0	80	80	1.0000000
NODE_7948_length_937_cov_29.742243	425	505	0	80	80	1.0000000
NODE_7948_length_937_cov_29.742243	478	558	0	80	80	1.0000000
NODE_7950_length_937_cov_26.153938	487	567	0	80	80	1.0000000
NODE_7950_length_937_cov_26.153938	540	620	0	80	80	1.0000000
NODE_7951_length_937_cov_20.898568	515	595	0	59	80	0.7375000
NODE_7951_length_937_cov_20.898568	515	595	4	21	80	0.2625000
NODE_7951_length_937_cov_20.898568	568	648	0	6	80	0.0750000
NODE_7951_length_937_cov_20.898568	568	648	4	74	80	0.9250000
NODE_7952_length_937_cov_20.502387	181	261	0	80	80	1.0000000
NODE_7952_length_937_cov_20.502387	234	314	0	80	80	1.0000000
NODE_7952_length_937_cov_20.502387	310	390	0	80	80	1.0000000
NODE_7952_length_937_cov_20.502387	363	443	0	80	80	1.0000000
NODE_7953_length_937_cov_15.219570	526	606	0	75	80	0.9375000
NODE_7953_length_937_cov_15.219570	526	606	2	5	80	0.0625000
NODE_7953_length_937_cov_15.219570	579	659	0	22	80	0.2750000
NODE_7953_length_937_cov_15.219570	579	659	2	58	80	0.7250000
NODE_7954_length_937_cov_9.633652	521	601	0	80	80	1.0000000
NODE_7954_length_937_cov_9.633652	574	654	0	80	80	1.0000000
NODE_7956_length_937_cov_6.630072	305	385	0	80	80	1.0000000
NODE_7956_length_937_cov_6.630072	358	438	0	44	80	0.5500000
NODE_7956_length_937_cov_6.630072	358	438	1	2	80	0.0250000
NODE_7956_length_937_cov_6.630072	358	438	2	34	80	0.4250000
NODE_7957_length_937_cov_4.649165	470	550	0	57	80	0.7125000
NODE_7957_length_937_cov_4.649165	470	550	2	23	80	0.2875000
NODE_7957_length_937_cov_4.649165	523	603	0	80	80	1.0000000
NODE_7969_length_936_cov_57.105137	267	347	0	80	80	1.0000000
NODE_7969_length_936_cov_57.105137	320	400	0	80	80	1.0000000
NODE_7969_length_936_cov_57.105137	396	476	0	80	80	1.0000000
NODE_7969_length_936_cov_57.105137	449	529	0	80	80	1.0000000
NODE_7970_length_936_cov_39.983274	433	513	0	80	80	1.0000000
NODE_7970_length_936_cov_39.983274	486	566	0	80	80	1.0000000
NODE_7971_length_936_cov_22.486260	534	614	0	76	80	0.9500000
NODE_7971_length_936_cov_22.486260	534	614	2	4	80	0.0500000
NODE_7971_length_936_cov_22.486260	587	667	0	80	80	1.0000000
NODE_7972_length_936_cov_19.639188	409	489	0	16	80	0.2000000
NODE_7972_length_936_cov_19.639188	409	489	2	64	80	0.8000000
NODE_7972_length_936_cov_19.639188	462	542	0	69	80	0.8625000
NODE_7972_length_936_cov_19.639188	462	542	2	11	80	0.1375000
NODE_7973_length_936_cov_15.083632	322	402	3	2	80	0.0250000
NODE_7973_length_936_cov_15.083632	322	402	4	5	80	0.0625000
NODE_7973_length_936_cov_15.083632	322	402	5	73	80	0.9125000
NODE_7973_length_936_cov_15.083632	375	455	2	32	80	0.4000000
NODE_7973_length_936_cov_15.083632	375	455	4	26	80	0.3250000
NODE_7973_length_936_cov_15.083632	375	455	5	22	80	0.2750000
NODE_7974_length_936_cov_13.962963	356	424	0	14	68	0.2058824
NODE_7974_length_936_cov_13.962963	356	424	1	54	68	0.7941176
NODE_7975_length_936_cov_12.502987	447	527	0	80	80	1.0000000
NODE_7975_length_936_cov_12.502987	500	580	0	80	80	1.0000000
NODE_7976_length_936_cov_12.279570	340	420	0	80	80	1.0000000
NODE_7976_length_936_cov_12.279570	393	473	0	80	80	1.0000000
NODE_7977_length_936_cov_7.906810	587	667	0	25	80	0.3125000
NODE_7977_length_936_cov_7.906810	587	667	4	18	80	0.2250000
NODE_7977_length_936_cov_7.906810	587	667	8	37	80	0.4625000
NODE_7977_length_936_cov_7.906810	640	720	0	20	80	0.2500000
NODE_7977_length_936_cov_7.906810	640	720	4	20	80	0.2500000
NODE_7977_length_936_cov_7.906810	640	720	8	40	80	0.5000000
NODE_7978_length_936_cov_6.845878	322	402	6	80	80	1.0000000
NODE_7978_length_936_cov_6.845878	375	455	0	44	80	0.5500000
NODE_7978_length_936_cov_6.845878	375	455	3	1	80	0.0125000
NODE_7978_length_936_cov_6.845878	375	455	6	35	80	0.4375000
NODE_7979_length_936_cov_6.434886	556	635	0	79	79	1.0000000
NODE_7979_length_936_cov_6.434886	608	688	0	80	80	1.0000000
NODE_7993_length_935_cov_38.209330	57	137	201	1	80	0.0125000
NODE_7993_length_935_cov_38.209330	57	137	204	1	80	0.0125000
NODE_7993_length_935_cov_38.209330	57	137	214	1	80	0.0125000
NODE_7993_length_935_cov_38.209330	57	137	219	2	80	0.0250000
NODE_7993_length_935_cov_38.209330	57	137	223	1	80	0.0125000
NODE_7993_length_935_cov_38.209330	57	137	225	2	80	0.0250000
NODE_7993_length_935_cov_38.209330	57	137	233	1	80	0.0125000
NODE_7993_length_935_cov_38.209330	57	137	235	1	80	0.0125000
NODE_7993_length_935_cov_38.209330	57	137	243	1	80	0.0125000
NODE_7993_length_935_cov_38.209330	57	137	257	1	80	0.0125000
NODE_7993_length_935_cov_38.209330	57	137	258	1	80	0.0125000
NODE_7993_length_935_cov_38.209330	57	137	261	1	80	0.0125000
NODE_7993_length_935_cov_38.209330	57	137	263	1	80	0.0125000
NODE_7993_length_935_cov_38.209330	57	137	265	1	80	0.0125000
NODE_7993_length_935_cov_38.209330	57	137	269	1	80	0.0125000
NODE_7993_length_935_cov_38.209330	57	137	275	1	80	0.0125000
NODE_7993_length_935_cov_38.209330	57	137	285	1	80	0.0125000
NODE_7993_length_935_cov_38.209330	57	137	287	1	80	0.0125000
NODE_7993_length_935_cov_38.209330	57	137	294	2	80	0.0250000
NODE_7993_length_935_cov_38.209330	57	137	300	1	80	0.0125000
NODE_7993_length_935_cov_38.209330	57	137	301	1	80	0.0125000
NODE_7993_length_935_cov_38.209330	57	137	302	1	80	0.0125000
NODE_7993_length_935_cov_38.209330	57	137	305	1	80	0.0125000
NODE_7993_length_935_cov_38.209330	57	137	307	1	80	0.0125000
NODE_7993_length_935_cov_38.209330	57	137	311	1	80	0.0125000
NODE_7993_length_935_cov_38.209330	57	137	315	1	80	0.0125000
NODE_7993_length_935_cov_38.209330	57	137	317	5	80	0.0625000
NODE_7993_length_935_cov_38.209330	57	137	319	46	80	0.5750000
NODE_7994_length_935_cov_27.306220	439	519	2	46	80	0.5750000
NODE_7994_length_935_cov_27.306220	439	519	22	34	80	0.4250000
NODE_7994_length_935_cov_27.306220	492	572	19	12	80	0.1500000
NODE_7994_length_935_cov_27.306220	492	572	20	14	80	0.1750000
NODE_7994_length_935_cov_27.306220	492	572	21	17	80	0.2125000
NODE_7994_length_935_cov_27.306220	492	572	22	37	80	0.4625000
NODE_7995_length_935_cov_26.562201	321	401	0	80	80	1.0000000
NODE_7995_length_935_cov_26.562201	374	454	0	80	80	1.0000000
NODE_7995_length_935_cov_26.562201	450	530	0	80	80	1.0000000
NODE_7995_length_935_cov_26.562201	503	583	0	80	80	1.0000000
NODE_7996_length_935_cov_25.098086	356	436	4	80	80	1.0000000
NODE_7996_length_935_cov_25.098086	409	489	4	80	80	1.0000000
NODE_7997_length_935_cov_24.316986	467	547	0	80	80	1.0000000
NODE_7997_length_935_cov_24.316986	520	600	0	80	80	1.0000000
NODE_7998_length_935_cov_19.221292	397	477	0	30	80	0.3750000
NODE_7998_length_935_cov_19.221292	397	477	2	44	80	0.5500000
NODE_7998_length_935_cov_19.221292	397	477	20	6	80	0.0750000
NODE_7998_length_935_cov_19.221292	450	530	0	80	80	1.0000000
NODE_7999_length_935_cov_15.016746	404	484	6	80	80	1.0000000
NODE_7999_length_935_cov_15.016746	457	537	2	16	80	0.2000000
NODE_7999_length_935_cov_15.016746	457	537	6	30	80	0.3750000
NODE_7999_length_935_cov_15.016746	457	537	7	10	80	0.1250000
NODE_7999_length_935_cov_15.016746	457	537	8	24	80	0.3000000
NODE_8000_length_935_cov_13.138756	341	421	0	80	80	1.0000000
NODE_8000_length_935_cov_13.138756	394	474	0	80	80	1.0000000
NODE_8002_length_935_cov_6.485646	512	592	0	53	80	0.6625000
NODE_8002_length_935_cov_6.485646	512	592	2	27	80	0.3375000
NODE_8002_length_935_cov_6.485646	565	645	0	8	80	0.1000000
NODE_8002_length_935_cov_6.485646	565	645	2	72	80	0.9000000
NODE_8003_length_935_cov_6.467703	250	330	0	80	80	1.0000000
NODE_8003_length_935_cov_6.467703	303	383	0	80	80	1.0000000
NODE_8004_length_935_cov_6.144737	478	558	0	80	80	1.0000000
NODE_8004_length_935_cov_6.144737	531	611	0	39	80	0.4875000
NODE_8004_length_935_cov_6.144737	531	611	2	41	80	0.5125000
NODE_8005_length_935_cov_3.905502	39	119	24	1	80	0.0125000
NODE_8005_length_935_cov_3.905502	39	119	25	1	80	0.0125000
NODE_8005_length_935_cov_3.905502	39	119	26	1	80	0.0125000
NODE_8005_length_935_cov_3.905502	39	119	27	7	80	0.0875000
NODE_8005_length_935_cov_3.905502	39	119	29	10	80	0.1250000
NODE_8005_length_935_cov_3.905502	39	119	31	7	80	0.0875000
NODE_8005_length_935_cov_3.905502	39	119	32	23	80	0.2875000
NODE_8005_length_935_cov_3.905502	39	119	33	30	80	0.3750000
NODE_8005_length_935_cov_3.905502	92	166	3	1	74	0.0135135
NODE_8005_length_935_cov_3.905502	92	166	5	1	74	0.0135135
NODE_8005_length_935_cov_3.905502	92	166	6	1	74	0.0135135
NODE_8005_length_935_cov_3.905502	92	166	12	2	74	0.0270270
NODE_8005_length_935_cov_3.905502	92	166	13	28	74	0.3783784
NODE_8005_length_935_cov_3.905502	92	166	14	4	74	0.0540541
NODE_8005_length_935_cov_3.905502	92	166	16	1	74	0.0135135
NODE_8005_length_935_cov_3.905502	92	166	20	1	74	0.0135135
NODE_8005_length_935_cov_3.905502	92	166	24	9	74	0.1216216
NODE_8005_length_935_cov_3.905502	92	166	26	1	74	0.0135135
NODE_8005_length_935_cov_3.905502	92	166	29	7	74	0.0945946
NODE_8005_length_935_cov_3.905502	92	166	31	6	74	0.0810811
NODE_8005_length_935_cov_3.905502	92	166	33	12	74	0.1621622
NODE_8028_length_934_cov_22.898204	403	483	0	80	80	1.0000000
NODE_8028_length_934_cov_22.898204	456	536	0	80	80	1.0000000
NODE_8029_length_934_cov_17.746108	246	326	0	80	80	1.0000000
NODE_8029_length_934_cov_17.746108	299	379	0	80	80	1.0000000
NODE_8030_length_934_cov_16.049102	367	447	0	62	80	0.7750000
NODE_8030_length_934_cov_16.049102	367	447	2	18	80	0.2250000
NODE_8030_length_934_cov_16.049102	420	500	0	80	80	1.0000000
NODE_8031_length_934_cov_13.738922	379	459	0	80	80	1.0000000
NODE_8031_length_934_cov_13.738922	432	459	0	27	27	1.0000000
NODE_8031_length_934_cov_13.738922	470	512	0	42	42	1.0000000
NODE_8032_length_934_cov_9.091018	407	487	0	80	80	1.0000000
NODE_8032_length_934_cov_9.091018	460	540	0	80	80	1.0000000
NODE_8034_length_934_cov_5.349701	583	663	0	80	80	1.0000000
NODE_8050_length_933_cov_36.557554	462	542	0	80	80	1.0000000
NODE_8050_length_933_cov_36.557554	515	595	0	80	80	1.0000000
NODE_8051_length_933_cov_27.645084	476	556	0	40	80	0.5000000
NODE_8051_length_933_cov_27.645084	476	556	2	40	80	0.5000000
NODE_8051_length_933_cov_27.645084	529	609	2	58	80	0.7250000
NODE_8051_length_933_cov_27.645084	529	609	4	22	80	0.2750000
NODE_8052_length_933_cov_26.749400	611	691	0	80	80	1.0000000
NODE_8052_length_933_cov_26.749400	664	744	0	80	80	1.0000000
NODE_8053_length_933_cov_26.308153	430	510	0	80	80	1.0000000
NODE_8053_length_933_cov_26.308153	483	563	0	80	80	1.0000000
NODE_8054_length_933_cov_19.966427	444	530	0	86	86	1.0000000
NODE_8054_length_933_cov_19.966427	497	583	0	86	86	1.0000000
NODE_8055_length_933_cov_16.870504	284	364	0	80	80	1.0000000
NODE_8055_length_933_cov_16.870504	337	415	0	78	78	1.0000000
NODE_8056_length_933_cov_16.699041	366	446	0	80	80	1.0000000
NODE_8056_length_933_cov_16.699041	419	499	0	80	80	1.0000000
NODE_8057_length_933_cov_11.171463	197	277	0	80	80	1.0000000
NODE_8057_length_933_cov_11.171463	250	330	0	80	80	1.0000000
NODE_8073_length_932_cov_26.656663	397	477	11	54	80	0.6750000
NODE_8073_length_932_cov_26.656663	397	477	12	26	80	0.3250000
NODE_8073_length_932_cov_26.656663	450	530	0	44	80	0.5500000
NODE_8073_length_932_cov_26.656663	450	530	10	1	80	0.0125000
NODE_8073_length_932_cov_26.656663	450	530	11	35	80	0.4375000
NODE_8074_length_932_cov_16.581032	407	485	0	5	78	0.0641026
NODE_8074_length_932_cov_16.581032	407	485	2	7	78	0.0897436
NODE_8074_length_932_cov_16.581032	407	485	6	66	78	0.8461539
NODE_8074_length_932_cov_16.581032	460	538	0	58	78	0.7435898
NODE_8074_length_932_cov_16.581032	460	538	2	7	78	0.0897436
NODE_8074_length_932_cov_16.581032	460	538	6	13	78	0.1666667
NODE_8075_length_932_cov_13.462185	413	493	0	80	80	1.0000000
NODE_8075_length_932_cov_13.462185	466	546	0	80	80	1.0000000
NODE_8076_length_932_cov_13.442977	386	466	0	80	80	1.0000000
NODE_8076_length_932_cov_13.442977	439	519	0	80	80	1.0000000
NODE_8077_length_932_cov_11.947179	344	424	0	80	80	1.0000000
NODE_8077_length_932_cov_11.947179	397	477	0	29	80	0.3625000
NODE_8077_length_932_cov_11.947179	397	477	2	51	80	0.6375000
NODE_8079_length_932_cov_10.849940	409	489	0	80	80	1.0000000
NODE_8079_length_932_cov_10.849940	462	542	0	80	80	1.0000000
NODE_8080_length_932_cov_10.174070	342	422	0	80	80	1.0000000
NODE_8080_length_932_cov_10.174070	395	475	0	80	80	1.0000000
NODE_8082_length_932_cov_9.200480	184	264	0	80	80	1.0000000
NODE_8082_length_932_cov_9.200480	237	317	0	80	80	1.0000000
NODE_8090_length_932_cov_2.689076	598	676	0	78	78	1.0000000
NODE_8090_length_932_cov_2.689076	798	845	0	47	47	1.0000000
NODE_8103_length_931_cov_51.451923	320	400	0	80	80	1.0000000
NODE_8103_length_931_cov_51.451923	373	453	0	80	80	1.0000000
NODE_8104_length_931_cov_46.621394	527	607	0	80	80	1.0000000
NODE_8104_length_931_cov_46.621394	580	660	0	80	80	1.0000000
NODE_8105_length_931_cov_36.334135	347	427	0	80	80	1.0000000
NODE_8105_length_931_cov_36.334135	400	480	0	80	80	1.0000000
NODE_8106_length_931_cov_32.495192	482	562	2	4	80	0.0500000
NODE_8106_length_931_cov_32.495192	482	562	4	76	80	0.9500000
NODE_8106_length_931_cov_32.495192	535	617	0	37	82	0.4512195
NODE_8106_length_931_cov_32.495192	535	617	2	22	82	0.2682927
NODE_8106_length_931_cov_32.495192	535	617	4	23	82	0.2804878
NODE_8107_length_931_cov_22.100962	375	455	0	55	80	0.6875000
NODE_8107_length_931_cov_22.100962	375	455	2	25	80	0.3125000
NODE_8107_length_931_cov_22.100962	428	508	0	3	80	0.0375000
NODE_8107_length_931_cov_22.100962	428	508	2	77	80	0.9625000
NODE_8108_length_931_cov_21.781250	347	427	1	31	80	0.3875000
NODE_8108_length_931_cov_21.781250	347	427	2	49	80	0.6125000
NODE_8108_length_931_cov_21.781250	400	480	0	28	80	0.3500000
NODE_8108_length_931_cov_21.781250	400	480	1	52	80	0.6500000
NODE_8109_length_931_cov_19.084135	411	491	0	80	80	1.0000000
NODE_8109_length_931_cov_19.084135	464	544	0	80	80	1.0000000
NODE_8110_length_931_cov_14.879808	444	524	0	80	80	1.0000000
NODE_8110_length_931_cov_14.879808	497	577	0	80	80	1.0000000
NODE_8111_length_931_cov_13.087740	759	800	12	6	41	0.1463415
NODE_8111_length_931_cov_13.087740	759	800	14	35	41	0.8536586
NODE_8112_length_931_cov_10.534856	399	479	0	80	80	1.0000000
NODE_8112_length_931_cov_10.534856	452	532	0	80	80	1.0000000
NODE_8113_length_931_cov_9.865385	236	316	0	80	80	1.0000000
NODE_8113_length_931_cov_9.865385	289	369	0	80	80	1.0000000
NODE_8115_length_931_cov_6.201923	479	559	0	20	80	0.2500000
NODE_8115_length_931_cov_6.201923	479	559	1	51	80	0.6375000
NODE_8115_length_931_cov_6.201923	479	559	2	9	80	0.1125000
NODE_8115_length_931_cov_6.201923	532	612	1	18	80	0.2250000
NODE_8115_length_931_cov_6.201923	532	612	2	62	80	0.7750000
NODE_8124_length_931_cov_1.780048	832	902	0	70	70	1.0000000
NODE_8126_length_931_cov_1.433894	220	284	12	11	64	0.1718750
NODE_8126_length_931_cov_1.433894	220	284	14	4	64	0.0625000
NODE_8126_length_931_cov_1.433894	220	284	16	20	64	0.3125000
NODE_8126_length_931_cov_1.433894	220	284	17	1	64	0.0156250
NODE_8126_length_931_cov_1.433894	220	284	18	20	64	0.3125000
NODE_8126_length_931_cov_1.433894	220	284	20	8	64	0.1250000
NODE_8131_length_930_cov_49.052948	252	332	6	5	80	0.0625000
NODE_8131_length_930_cov_49.052948	252	332	12	75	80	0.9375000
NODE_8131_length_930_cov_49.052948	305	385	4	13	80	0.1625000
NODE_8131_length_930_cov_49.052948	305	385	6	3	80	0.0375000
NODE_8131_length_930_cov_49.052948	305	385	8	10	80	0.1250000
NODE_8131_length_930_cov_49.052948	305	385	12	51	80	0.6375000
NODE_8131_length_930_cov_49.052948	305	385	14	3	80	0.0375000
NODE_8131_length_930_cov_49.052948	381	462	2	17	81	0.2098765
NODE_8131_length_930_cov_49.052948	381	462	4	64	81	0.7901235
NODE_8131_length_930_cov_49.052948	435	515	0	41	80	0.5125000
NODE_8131_length_930_cov_49.052948	435	515	2	29	80	0.3625000
NODE_8131_length_930_cov_49.052948	435	515	4	10	80	0.1250000
NODE_8132_length_930_cov_31.510229	400	482	0	82	82	1.0000000
NODE_8132_length_930_cov_31.510229	453	535	0	82	82	1.0000000
NODE_8133_length_930_cov_29.139591	329	409	0	80	80	1.0000000
NODE_8133_length_930_cov_29.139591	382	462	0	80	80	1.0000000
NODE_8134_length_930_cov_24.787004	518	598	0	23	80	0.2875000
NODE_8134_length_930_cov_24.787004	518	598	6	25	80	0.3125000
NODE_8134_length_930_cov_24.787004	518	598	7	12	80	0.1500000
NODE_8134_length_930_cov_24.787004	518	598	8	20	80	0.2500000
NODE_8134_length_930_cov_24.787004	571	651	7	7	80	0.0875000
NODE_8134_length_930_cov_24.787004	571	651	8	73	80	0.9125000
NODE_8135_length_930_cov_24.608905	300	380	0	57	80	0.7125000
NODE_8135_length_930_cov_24.608905	300	380	2	23	80	0.2875000
NODE_8135_length_930_cov_24.608905	353	433	0	22	80	0.2750000
NODE_8135_length_930_cov_24.608905	353	433	2	58	80	0.7250000
NODE_8136_length_930_cov_16.494585	482	562	2	12	80	0.1500000
NODE_8136_length_930_cov_16.494585	482	562	4	68	80	0.8500000
NODE_8136_length_930_cov_16.494585	535	615	0	5	80	0.0625000
NODE_8136_length_930_cov_16.494585	535	615	2	56	80	0.7000000
NODE_8136_length_930_cov_16.494585	535	615	4	19	80	0.2375000
NODE_8137_length_930_cov_13.296029	249	329	0	80	80	1.0000000
NODE_8137_length_930_cov_13.296029	302	382	0	80	80	1.0000000
NODE_8137_length_930_cov_13.296029	378	458	0	80	80	1.0000000
NODE_8137_length_930_cov_13.296029	431	511	0	80	80	1.0000000
NODE_8138_length_930_cov_11.758123	463	543	0	80	80	1.0000000
NODE_8138_length_930_cov_11.758123	516	596	0	80	80	1.0000000
NODE_8139_length_930_cov_7.576414	531	611	0	80	80	1.0000000
NODE_8139_length_930_cov_7.576414	584	664	0	80	80	1.0000000
NODE_8156_length_930_cov_0.821901	676	736	0	35	60	0.5833333
NODE_8156_length_930_cov_0.821901	676	736	2	25	60	0.4166667
NODE_8157_length_929_cov_54.485542	313	393	0	80	80	1.0000000
NODE_8157_length_929_cov_54.485542	366	446	0	80	80	1.0000000
NODE_8157_length_929_cov_54.485542	442	522	0	80	80	1.0000000
NODE_8157_length_929_cov_54.485542	495	575	0	80	80	1.0000000
NODE_8158_length_929_cov_49.865060	429	509	0	7	80	0.0875000
NODE_8158_length_929_cov_49.865060	429	509	1	17	80	0.2125000
NODE_8158_length_929_cov_49.865060	429	509	2	25	80	0.3125000
NODE_8158_length_929_cov_49.865060	429	509	4	31	80	0.3875000
NODE_8158_length_929_cov_49.865060	482	562	0	4	80	0.0500000
NODE_8158_length_929_cov_49.865060	482	562	1	17	80	0.2125000
NODE_8158_length_929_cov_49.865060	482	562	2	59	80	0.7375000
NODE_8159_length_929_cov_34.634940	358	438	0	80	80	1.0000000
NODE_8159_length_929_cov_34.634940	411	491	0	80	80	1.0000000
NODE_8161_length_929_cov_20.815663	365	445	0	80	80	1.0000000
NODE_8161_length_929_cov_20.815663	418	498	0	80	80	1.0000000
NODE_8162_length_929_cov_17.798795	376	456	0	80	80	1.0000000
NODE_8162_length_929_cov_17.798795	429	509	0	80	80	1.0000000
NODE_8163_length_929_cov_16.622892	331	408	8	77	77	1.0000000
NODE_8163_length_929_cov_16.622892	381	461	0	2	80	0.0250000
NODE_8163_length_929_cov_16.622892	381	461	2	8	80	0.1000000
NODE_8163_length_929_cov_16.622892	381	461	6	5	80	0.0625000
NODE_8163_length_929_cov_16.622892	381	461	8	65	80	0.8125000
NODE_8163_length_929_cov_16.622892	457	537	2	68	80	0.8500000
NODE_8163_length_929_cov_16.622892	457	537	4	12	80	0.1500000
NODE_8163_length_929_cov_16.622892	510	590	2	68	80	0.8500000
NODE_8163_length_929_cov_16.622892	510	590	4	12	80	0.1500000
NODE_8164_length_929_cov_15.242169	302	382	0	80	80	1.0000000
NODE_8164_length_929_cov_15.242169	355	435	0	80	80	1.0000000
NODE_8164_length_929_cov_15.242169	431	511	0	80	80	1.0000000
NODE_8164_length_929_cov_15.242169	484	564	0	80	80	1.0000000
NODE_8165_length_929_cov_13.197590	259	339	0	80	80	1.0000000
NODE_8165_length_929_cov_13.197590	312	392	0	80	80	1.0000000
NODE_8167_length_929_cov_7.766265	385	465	2	76	80	0.9500000
NODE_8167_length_929_cov_7.766265	385	465	4	4	80	0.0500000
NODE_8167_length_929_cov_7.766265	438	518	0	35	80	0.4375000
NODE_8167_length_929_cov_7.766265	438	518	2	45	80	0.5625000
NODE_8168_length_929_cov_5.750602	382	462	4	80	80	1.0000000
NODE_8168_length_929_cov_5.750602	435	515	0	4	80	0.0500000
NODE_8168_length_929_cov_5.750602	435	515	4	76	80	0.9500000
NODE_8181_length_928_cov_35.226779	273	353	0	80	80	1.0000000
NODE_8181_length_928_cov_35.226779	326	406	0	80	80	1.0000000
NODE_8181_length_928_cov_35.226779	402	482	0	39	80	0.4875000
NODE_8181_length_928_cov_35.226779	402	482	2	33	80	0.4125000
NODE_8181_length_928_cov_35.226779	402	482	4	8	80	0.1000000
NODE_8181_length_928_cov_35.226779	455	535	2	36	80	0.4500000
NODE_8181_length_928_cov_35.226779	455	535	4	44	80	0.5500000
NODE_8182_length_928_cov_25.218335	299	379	2	38	80	0.4750000
NODE_8182_length_928_cov_25.218335	299	379	4	42	80	0.5250000
NODE_8182_length_928_cov_25.218335	352	432	0	35	80	0.4375000
NODE_8182_length_928_cov_25.218335	352	432	2	20	80	0.2500000
NODE_8182_length_928_cov_25.218335	352	432	4	25	80	0.3125000
NODE_8183_length_928_cov_22.815440	342	422	0	80	80	1.0000000
NODE_8183_length_928_cov_22.815440	395	475	0	80	80	1.0000000
NODE_8183_length_928_cov_22.815440	471	551	0	80	80	1.0000000
NODE_8183_length_928_cov_22.815440	524	604	0	80	80	1.0000000
NODE_8184_length_928_cov_20.718938	365	445	0	34	80	0.4250000
NODE_8184_length_928_cov_20.718938	365	445	4	30	80	0.3750000
NODE_8184_length_928_cov_20.718938	365	445	5	1	80	0.0125000
NODE_8184_length_928_cov_20.718938	365	445	6	13	80	0.1625000
NODE_8184_length_928_cov_20.718938	365	445	8	2	80	0.0250000
NODE_8184_length_928_cov_20.718938	418	498	4	28	80	0.3500000
NODE_8184_length_928_cov_20.718938	418	498	5	1	80	0.0125000
NODE_8184_length_928_cov_20.718938	418	498	6	13	80	0.1625000
NODE_8184_length_928_cov_20.718938	418	498	8	38	80	0.4750000
NODE_8185_length_928_cov_19.418577	420	500	6	8	80	0.1000000
NODE_8185_length_928_cov_19.418577	420	500	8	7	80	0.0875000
NODE_8185_length_928_cov_19.418577	420	500	12	6	80	0.0750000
NODE_8185_length_928_cov_19.418577	420	500	18	1	80	0.0125000
NODE_8185_length_928_cov_19.418577	420	500	22	58	80	0.7250000
NODE_8185_length_928_cov_19.418577	473	553	0	10	80	0.1250000
NODE_8185_length_928_cov_19.418577	473	553	4	1	80	0.0125000
NODE_8185_length_928_cov_19.418577	473	553	10	36	80	0.4500000
NODE_8185_length_928_cov_19.418577	473	553	12	5	80	0.0625000
NODE_8185_length_928_cov_19.418577	473	553	22	28	80	0.3500000
NODE_8185_length_928_cov_19.418577	549	591	0	42	42	1.0000000
NODE_8186_length_928_cov_13.354644	323	403	0	80	80	1.0000000
NODE_8186_length_928_cov_13.354644	376	456	0	80	80	1.0000000
NODE_8187_length_928_cov_13.096502	361	441	0	25	80	0.3125000
NODE_8187_length_928_cov_13.096502	361	441	2	55	80	0.6875000
NODE_8187_length_928_cov_13.096502	414	494	0	78	80	0.9750000
NODE_8187_length_928_cov_13.096502	414	494	2	2	80	0.0250000
NODE_8189_length_928_cov_10.399276	447	527	4	80	80	1.0000000
NODE_8189_length_928_cov_10.399276	500	580	0	38	80	0.4750000
NODE_8189_length_928_cov_10.399276	500	580	4	42	80	0.5250000
NODE_8207_length_927_cov_19.516908	398	478	4	56	80	0.7000000
NODE_8207_length_927_cov_19.516908	398	478	6	24	80	0.3000000
NODE_8207_length_927_cov_19.516908	451	531	0	6	80	0.0750000
NODE_8207_length_927_cov_19.516908	451	531	2	34	80	0.4250000
NODE_8207_length_927_cov_19.516908	451	531	4	3	80	0.0375000
NODE_8207_length_927_cov_19.516908	451	531	6	37	80	0.4625000
NODE_8208_length_927_cov_11.190821	358	438	0	80	80	1.0000000
NODE_8208_length_927_cov_11.190821	411	491	0	80	80	1.0000000
NODE_8209_length_927_cov_8.123188	239	319	0	80	80	1.0000000
NODE_8209_length_927_cov_8.123188	292	372	0	80	80	1.0000000
NODE_8210_length_927_cov_4.585749	515	595	0	80	80	1.0000000
NODE_8210_length_927_cov_4.585749	568	648	0	80	80	1.0000000
NODE_8222_length_927_cov_1.250000	626	706	0	80	80	1.0000000
NODE_8222_length_927_cov_1.250000	679	759	0	80	80	1.0000000
NODE_8227_length_926_cov_78.382104	433	513	0	46	80	0.5750000
NODE_8227_length_926_cov_78.382104	433	513	6	26	80	0.3250000
NODE_8227_length_926_cov_78.382104	433	513	8	8	80	0.1000000
NODE_8227_length_926_cov_78.382104	486	566	6	19	80	0.2375000
NODE_8227_length_926_cov_78.382104	486	566	8	61	80	0.7625000
NODE_8228_length_926_cov_44.385732	383	463	0	80	80	1.0000000
NODE_8228_length_926_cov_44.385732	436	516	0	80	80	1.0000000
NODE_8229_length_926_cov_43.446191	362	442	0	40	80	0.5000000
NODE_8229_length_926_cov_43.446191	362	442	4	32	80	0.4000000
NODE_8229_length_926_cov_43.446191	362	442	12	8	80	0.1000000
NODE_8229_length_926_cov_43.446191	415	495	4	19	80	0.2375000
NODE_8229_length_926_cov_43.446191	415	495	12	17	80	0.2125000
NODE_8229_length_926_cov_43.446191	415	495	14	23	80	0.2875000
NODE_8229_length_926_cov_43.446191	415	495	15	1	80	0.0125000
NODE_8229_length_926_cov_43.446191	415	495	16	20	80	0.2500000
NODE_8229_length_926_cov_43.446191	491	571	12	39	80	0.4875000
NODE_8229_length_926_cov_43.446191	491	571	16	41	80	0.5125000
NODE_8229_length_926_cov_43.446191	544	624	2	22	80	0.2750000
NODE_8229_length_926_cov_43.446191	544	624	3	1	80	0.0125000
NODE_8229_length_926_cov_43.446191	544	624	4	26	80	0.3250000
NODE_8229_length_926_cov_43.446191	544	624	12	31	80	0.3875000
NODE_8230_length_926_cov_40.163241	42	61	0	19	19	1.0000000
NODE_8230_length_926_cov_40.163241	279	359	0	19	80	0.2375000
NODE_8230_length_926_cov_40.163241	279	359	1	1	80	0.0125000
NODE_8230_length_926_cov_40.163241	279	359	2	60	80	0.7500000
NODE_8230_length_926_cov_40.163241	332	412	0	72	80	0.9000000
NODE_8230_length_926_cov_40.163241	332	412	1	1	80	0.0125000
NODE_8230_length_926_cov_40.163241	332	412	2	7	80	0.0875000
NODE_8230_length_926_cov_40.163241	408	488	0	80	80	1.0000000
NODE_8230_length_926_cov_40.163241	461	541	0	80	80	1.0000000
NODE_8231_length_926_cov_29.923821	372	452	0	12	80	0.1500000
NODE_8231_length_926_cov_29.923821	372	452	10	36	80	0.4500000
NODE_8231_length_926_cov_29.923821	372	452	12	32	80	0.4000000
NODE_8231_length_926_cov_29.923821	425	505	11	9	80	0.1125000
NODE_8231_length_926_cov_29.923821	425	505	12	50	80	0.6250000
NODE_8231_length_926_cov_29.923821	425	505	14	21	80	0.2625000
NODE_8232_length_926_cov_24.657799	350	430	0	50	80	0.6250000
NODE_8232_length_926_cov_24.657799	350	430	7	10	80	0.1250000
NODE_8232_length_926_cov_24.657799	350	430	8	20	80	0.2500000
NODE_8232_length_926_cov_24.657799	403	483	7	7	80	0.0875000
NODE_8232_length_926_cov_24.657799	403	483	8	65	80	0.8125000
NODE_8232_length_926_cov_24.657799	403	483	10	8	80	0.1000000
NODE_8233_length_926_cov_17.438936	360	440	0	31	80	0.3875000
NODE_8233_length_926_cov_17.438936	360	440	2	49	80	0.6125000
NODE_8233_length_926_cov_17.438936	413	493	0	80	80	1.0000000
NODE_8234_length_926_cov_12.413543	418	491	0	73	73	1.0000000
NODE_8234_length_926_cov_12.413543	464	544	0	80	80	1.0000000
NODE_8235_length_926_cov_5.771463	453	533	0	80	80	1.0000000
NODE_8235_length_926_cov_5.771463	505	586	0	81	81	1.0000000
NODE_8236_length_926_cov_5.209190	435	515	0	80	80	1.0000000
NODE_8236_length_926_cov_5.209190	488	568	0	80	80	1.0000000
NODE_8247_length_925_cov_40.767554	514	594	0	80	80	1.0000000
NODE_8247_length_925_cov_40.767554	567	647	0	80	80	1.0000000
NODE_8248_length_925_cov_30.226392	262	342	0	80	80	1.0000000
NODE_8248_length_925_cov_30.226392	315	395	0	80	80	1.0000000
NODE_8248_length_925_cov_30.226392	391	471	0	80	80	1.0000000
NODE_8248_length_925_cov_30.226392	444	524	0	80	80	1.0000000
NODE_8249_length_925_cov_22.075061	334	414	0	80	80	1.0000000
NODE_8249_length_925_cov_22.075061	387	467	0	80	80	1.0000000
NODE_8250_length_925_cov_18.164649	410	490	0	80	80	1.0000000
NODE_8250_length_925_cov_18.164649	464	543	0	79	79	1.0000000
NODE_8251_length_925_cov_14.067797	472	548	0	6	76	0.0789474
NODE_8251_length_925_cov_14.067797	472	548	2	56	76	0.7368421
NODE_8251_length_925_cov_14.067797	472	548	4	14	76	0.1842105
NODE_8251_length_925_cov_14.067797	525	601	0	59	76	0.7763158
NODE_8251_length_925_cov_14.067797	525	601	2	17	76	0.2236842
NODE_8252_length_925_cov_7.098063	418	498	0	80	80	1.0000000
NODE_8252_length_925_cov_7.098063	471	551	0	80	80	1.0000000
NODE_8266_length_924_cov_61.292121	397	477	0	80	80	1.0000000
NODE_8266_length_924_cov_61.292121	450	530	0	80	80	1.0000000
NODE_8267_length_924_cov_31.522424	375	455	2	80	80	1.0000000
NODE_8267_length_924_cov_31.522424	428	508	0	51	80	0.6375000
NODE_8267_length_924_cov_31.522424	428	508	2	29	80	0.3625000
NODE_8268_length_924_cov_30.446061	299	379	0	80	80	1.0000000
NODE_8268_length_924_cov_30.446061	352	432	0	80	80	1.0000000
NODE_8268_length_924_cov_30.446061	428	508	0	80	80	1.0000000
NODE_8268_length_924_cov_30.446061	481	561	0	80	80	1.0000000
NODE_8269_length_924_cov_28.877576	542	622	2	80	80	1.0000000
NODE_8269_length_924_cov_28.877576	595	675	0	53	80	0.6625000
NODE_8269_length_924_cov_28.877576	595	675	2	27	80	0.3375000
NODE_8270_length_924_cov_27.261818	506	586	0	80	80	1.0000000
NODE_8270_length_924_cov_27.261818	559	639	0	80	80	1.0000000
NODE_8271_length_924_cov_25.946667	371	451	0	80	80	1.0000000
NODE_8271_length_924_cov_25.946667	424	504	0	72	80	0.9000000
NODE_8271_length_924_cov_25.946667	424	504	4	8	80	0.1000000
NODE_8271_length_924_cov_25.946667	500	580	4	15	80	0.1875000
NODE_8271_length_924_cov_25.946667	500	580	8	65	80	0.8125000
NODE_8271_length_924_cov_25.946667	553	633	0	5	80	0.0625000
NODE_8271_length_924_cov_25.946667	553	633	4	40	80	0.5000000
NODE_8271_length_924_cov_25.946667	553	633	8	35	80	0.4375000
NODE_8272_length_924_cov_25.113939	305	385	0	80	80	1.0000000
NODE_8272_length_924_cov_25.113939	358	438	0	80	80	1.0000000
NODE_8272_length_924_cov_25.113939	434	514	0	80	80	1.0000000
NODE_8272_length_924_cov_25.113939	487	567	0	80	80	1.0000000
NODE_8273_length_924_cov_16.343030	481	561	0	80	80	1.0000000
NODE_8273_length_924_cov_16.343030	534	614	0	80	80	1.0000000
NODE_8274_length_924_cov_14.793939	299	379	0	80	80	1.0000000
NODE_8274_length_924_cov_14.793939	352	432	0	80	80	1.0000000
NODE_8275_length_924_cov_14.209697	485	562	0	77	77	1.0000000
NODE_8275_length_924_cov_14.209697	535	615	0	80	80	1.0000000
NODE_8276_length_924_cov_13.423030	287	367	0	80	80	1.0000000
NODE_8276_length_924_cov_13.423030	340	420	0	80	80	1.0000000
NODE_8277_length_924_cov_12.008485	237	307	0	70	70	1.0000000
NODE_8279_length_924_cov_8.619394	560	640	0	42	80	0.5250000
NODE_8279_length_924_cov_8.619394	560	640	2	38	80	0.4750000
NODE_8279_length_924_cov_8.619394	613	693	0	18	80	0.2250000
NODE_8279_length_924_cov_8.619394	613	693	2	62	80	0.7750000
NODE_8280_length_924_cov_4.640000	426	506	3	6	80	0.0750000
NODE_8280_length_924_cov_4.640000	426	506	4	2	80	0.0250000
NODE_8280_length_924_cov_4.640000	426	506	6	18	80	0.2250000
NODE_8280_length_924_cov_4.640000	426	506	7	51	80	0.6375000
NODE_8280_length_924_cov_4.640000	426	506	8	3	80	0.0375000
NODE_8280_length_924_cov_4.640000	479	559	3	5	80	0.0625000
NODE_8280_length_924_cov_4.640000	479	559	4	14	80	0.1750000
NODE_8280_length_924_cov_4.640000	479	559	6	8	80	0.1000000
NODE_8280_length_924_cov_4.640000	479	559	7	24	80	0.3000000
NODE_8280_length_924_cov_4.640000	479	559	8	29	80	0.3625000
NODE_8290_length_924_cov_1.467879	352	381	0	29	29	1.0000000
NODE_8296_length_924_cov_0.648485	830	890	2	25	60	0.4166667
NODE_8296_length_924_cov_0.648485	830	890	4	35	60	0.5833333
NODE_8296_length_924_cov_0.648485	863	924	0	4	61	0.0655738
NODE_8296_length_924_cov_0.648485	863	924	2	45	61	0.7377049
NODE_8296_length_924_cov_0.648485	863	924	4	12	61	0.1967213
NODE_8297_length_923_cov_43.213592	371	451	0	80	80	1.0000000
NODE_8297_length_923_cov_43.213592	424	504	0	80	80	1.0000000
NODE_8297_length_923_cov_43.213592	500	580	0	14	80	0.1750000
NODE_8297_length_923_cov_43.213592	500	580	2	46	80	0.5750000
NODE_8297_length_923_cov_43.213592	500	580	4	20	80	0.2500000
NODE_8297_length_923_cov_43.213592	553	633	2	27	80	0.3375000
NODE_8297_length_923_cov_43.213592	553	633	4	53	80	0.6625000
NODE_8298_length_923_cov_34.108010	370	450	4	80	80	1.0000000
NODE_8298_length_923_cov_34.108010	423	503	0	40	80	0.5000000
NODE_8298_length_923_cov_34.108010	423	503	4	40	80	0.5000000
NODE_8299_length_923_cov_29.163835	392	472	0	80	80	1.0000000
NODE_8299_length_923_cov_29.163835	445	525	0	80	80	1.0000000
NODE_8300_length_923_cov_19.139563	375	455	0	80	80	1.0000000
NODE_8300_length_923_cov_19.139563	428	508	0	80	80	1.0000000
NODE_8301_length_923_cov_17.433252	512	592	0	17	80	0.2125000
NODE_8301_length_923_cov_17.433252	512	592	1	7	80	0.0875000
NODE_8301_length_923_cov_17.433252	512	592	2	23	80	0.2875000
NODE_8301_length_923_cov_17.433252	512	592	4	33	80	0.4125000
NODE_8301_length_923_cov_17.433252	565	645	2	18	80	0.2250000
NODE_8301_length_923_cov_17.433252	565	645	4	62	80	0.7750000
NODE_8302_length_923_cov_16.597087	279	359	0	10	80	0.1250000
NODE_8302_length_923_cov_16.597087	279	359	4	70	80	0.8750000
NODE_8302_length_923_cov_16.597087	332	412	4	80	80	1.0000000
NODE_8303_length_923_cov_15.229369	446	526	0	80	80	1.0000000
NODE_8303_length_923_cov_15.229369	499	579	0	80	80	1.0000000
NODE_8304_length_923_cov_14.007282	304	349	0	45	45	1.0000000
NODE_8304_length_923_cov_14.007282	345	427	0	23	82	0.2804878
NODE_8304_length_923_cov_14.007282	345	427	2	59	82	0.7195122
NODE_8304_length_923_cov_14.007282	397	480	2	83	83	1.0000000
NODE_8305_length_923_cov_6.500000	308	388	0	80	80	1.0000000
NODE_8305_length_923_cov_6.500000	361	441	0	80	80	1.0000000
NODE_8307_length_923_cov_6.115291	447	527	0	80	80	1.0000000
NODE_8307_length_923_cov_6.115291	500	580	0	80	80	1.0000000
NODE_8308_length_923_cov_5.351942	363	445	0	82	82	1.0000000
NODE_8308_length_923_cov_5.351942	365	445	0	80	80	1.0000000
NODE_8317_length_923_cov_1.059466	63	143	0	36	80	0.4500000
NODE_8317_length_923_cov_1.059466	63	143	4	24	80	0.3000000
NODE_8317_length_923_cov_1.059466	63	143	6	7	80	0.0875000
NODE_8317_length_923_cov_1.059466	63	143	8	13	80	0.1625000
NODE_8320_length_922_cov_40.331713	243	289	78	1	46	0.0217391
NODE_8320_length_922_cov_40.331713	243	289	79	2	46	0.0434783
NODE_8320_length_922_cov_40.331713	243	289	80	1	46	0.0217391
NODE_8320_length_922_cov_40.331713	243	289	81	2	46	0.0434783
NODE_8320_length_922_cov_40.331713	243	289	82	1	46	0.0217391
NODE_8320_length_922_cov_40.331713	243	289	85	3	46	0.0652174
NODE_8320_length_922_cov_40.331713	243	289	86	1	46	0.0217391
NODE_8320_length_922_cov_40.331713	243	289	87	2	46	0.0434783
NODE_8320_length_922_cov_40.331713	243	289	88	1	46	0.0217391
NODE_8320_length_922_cov_40.331713	243	289	89	8	46	0.1739130
NODE_8320_length_922_cov_40.331713	243	289	90	3	46	0.0652174
NODE_8320_length_922_cov_40.331713	243	289	98	1	46	0.0217391
NODE_8320_length_922_cov_40.331713	243	289	99	3	46	0.0652174
NODE_8320_length_922_cov_40.331713	243	289	101	1	46	0.0217391
NODE_8320_length_922_cov_40.331713	243	289	103	1	46	0.0217391
NODE_8320_length_922_cov_40.331713	243	289	105	1	46	0.0217391
NODE_8320_length_922_cov_40.331713	243	289	107	1	46	0.0217391
NODE_8320_length_922_cov_40.331713	243	289	109	3	46	0.0652174
NODE_8320_length_922_cov_40.331713	243	289	117	1	46	0.0217391
NODE_8320_length_922_cov_40.331713	243	289	123	1	46	0.0217391
NODE_8320_length_922_cov_40.331713	243	289	127	1	46	0.0217391
NODE_8320_length_922_cov_40.331713	243	289	128	1	46	0.0217391
NODE_8320_length_922_cov_40.331713	243	289	139	1	46	0.0217391
NODE_8320_length_922_cov_40.331713	243	289	145	1	46	0.0217391
NODE_8320_length_922_cov_40.331713	243	289	151	1	46	0.0217391
NODE_8320_length_922_cov_40.331713	243	289	156	3	46	0.0652174
NODE_8320_length_922_cov_40.331713	262	342	78	1	80	0.0125000
NODE_8320_length_922_cov_40.331713	262	342	81	2	80	0.0250000
NODE_8320_length_922_cov_40.331713	262	342	82	1	80	0.0125000
NODE_8320_length_922_cov_40.331713	262	342	86	1	80	0.0125000
NODE_8320_length_922_cov_40.331713	262	342	88	1	80	0.0125000
NODE_8320_length_922_cov_40.331713	262	342	98	1	80	0.0125000
NODE_8320_length_922_cov_40.331713	262	342	99	3	80	0.0375000
NODE_8320_length_922_cov_40.331713	262	342	101	1	80	0.0125000
NODE_8320_length_922_cov_40.331713	262	342	103	1	80	0.0125000
NODE_8320_length_922_cov_40.331713	262	342	105	1	80	0.0125000
NODE_8320_length_922_cov_40.331713	262	342	107	1	80	0.0125000
NODE_8320_length_922_cov_40.331713	262	342	109	3	80	0.0375000
NODE_8320_length_922_cov_40.331713	262	342	117	1	80	0.0125000
NODE_8320_length_922_cov_40.331713	262	342	123	1	80	0.0125000
NODE_8320_length_922_cov_40.331713	262	342	127	1	80	0.0125000
NODE_8320_length_922_cov_40.331713	262	342	128	1	80	0.0125000
NODE_8320_length_922_cov_40.331713	262	342	139	1	80	0.0125000
NODE_8320_length_922_cov_40.331713	262	342	145	1	80	0.0125000
NODE_8320_length_922_cov_40.331713	262	342	151	1	80	0.0125000
NODE_8320_length_922_cov_40.331713	262	342	156	3	80	0.0375000
NODE_8320_length_922_cov_40.331713	262	342	159	1	80	0.0125000
NODE_8320_length_922_cov_40.331713	262	342	166	1	80	0.0125000
NODE_8320_length_922_cov_40.331713	262	342	176	1	80	0.0125000
NODE_8320_length_922_cov_40.331713	262	342	186	1	80	0.0125000
NODE_8320_length_922_cov_40.331713	262	342	193	1	80	0.0125000
NODE_8320_length_922_cov_40.331713	262	342	196	1	80	0.0125000
NODE_8320_length_922_cov_40.331713	262	342	201	1	80	0.0125000
NODE_8320_length_922_cov_40.331713	262	342	210	1	80	0.0125000
NODE_8320_length_922_cov_40.331713	262	342	223	1	80	0.0125000
NODE_8320_length_922_cov_40.331713	262	342	225	2	80	0.0250000
NODE_8320_length_922_cov_40.331713	262	342	226	1	80	0.0125000
NODE_8320_length_922_cov_40.331713	262	342	234	1	80	0.0125000
NODE_8320_length_922_cov_40.331713	262	342	246	3	80	0.0375000
NODE_8320_length_922_cov_40.331713	262	342	248	1	80	0.0125000
NODE_8320_length_922_cov_40.331713	262	342	252	1	80	0.0125000
NODE_8320_length_922_cov_40.331713	262	342	258	1	80	0.0125000
NODE_8320_length_922_cov_40.331713	262	342	261	1	80	0.0125000
NODE_8320_length_922_cov_40.331713	262	342	272	1	80	0.0125000
NODE_8320_length_922_cov_40.331713	262	342	285	1	80	0.0125000
NODE_8320_length_922_cov_40.331713	262	342	298	1	80	0.0125000
NODE_8320_length_922_cov_40.331713	262	342	302	1	80	0.0125000
NODE_8320_length_922_cov_40.331713	262	342	313	1	80	0.0125000
NODE_8320_length_922_cov_40.331713	262	342	322	1	80	0.0125000
NODE_8320_length_922_cov_40.331713	262	342	324	1	80	0.0125000
NODE_8320_length_922_cov_40.331713	262	342	327	1	80	0.0125000
NODE_8320_length_922_cov_40.331713	262	342	332	1	80	0.0125000
NODE_8320_length_922_cov_40.331713	262	342	342	1	80	0.0125000
NODE_8320_length_922_cov_40.331713	262	342	350	1	80	0.0125000
NODE_8320_length_922_cov_40.331713	262	342	355	1	80	0.0125000
NODE_8320_length_922_cov_40.331713	262	342	366	1	80	0.0125000
NODE_8320_length_922_cov_40.331713	262	342	390	1	80	0.0125000
NODE_8320_length_922_cov_40.331713	262	342	392	1	80	0.0125000
NODE_8320_length_922_cov_40.331713	262	342	400	1	80	0.0125000
NODE_8320_length_922_cov_40.331713	262	342	403	1	80	0.0125000
NODE_8320_length_922_cov_40.331713	262	342	408	1	80	0.0125000
NODE_8320_length_922_cov_40.331713	262	342	416	1	80	0.0125000
NODE_8320_length_922_cov_40.331713	262	342	417	1	80	0.0125000
NODE_8320_length_922_cov_40.331713	262	342	423	1	80	0.0125000
NODE_8320_length_922_cov_40.331713	262	342	428	1	80	0.0125000
NODE_8320_length_922_cov_40.331713	262	342	429	1	80	0.0125000
NODE_8320_length_922_cov_40.331713	262	342	433	1	80	0.0125000
NODE_8320_length_922_cov_40.331713	262	342	446	1	80	0.0125000
NODE_8320_length_922_cov_40.331713	262	342	449	1	80	0.0125000
NODE_8320_length_922_cov_40.331713	262	342	451	1	80	0.0125000
NODE_8320_length_922_cov_40.331713	262	342	454	1	80	0.0125000
NODE_8320_length_922_cov_40.331713	262	342	465	2	80	0.0250000
NODE_8320_length_922_cov_40.331713	262	342	477	1	80	0.0125000
NODE_8320_length_922_cov_40.331713	262	342	481	1	80	0.0125000
NODE_8320_length_922_cov_40.331713	262	342	482	1	80	0.0125000
NODE_8320_length_922_cov_40.331713	780	860	0	17	80	0.2125000
NODE_8320_length_922_cov_40.331713	780	860	4	63	80	0.7875000
NODE_8320_length_922_cov_40.331713	833	913	0	70	80	0.8750000
NODE_8320_length_922_cov_40.331713	833	913	4	10	80	0.1250000
NODE_8321_length_922_cov_38.549210	126	177	167	1	51	0.0196078
NODE_8321_length_922_cov_38.549210	126	177	172	1	51	0.0196078
NODE_8321_length_922_cov_38.549210	126	177	184	1	51	0.0196078
NODE_8321_length_922_cov_38.549210	126	177	195	1	51	0.0196078
NODE_8321_length_922_cov_38.549210	126	177	208	1	51	0.0196078
NODE_8321_length_922_cov_38.549210	126	177	211	1	51	0.0196078
NODE_8321_length_922_cov_38.549210	126	177	220	1	51	0.0196078
NODE_8321_length_922_cov_38.549210	126	177	222	1	51	0.0196078
NODE_8321_length_922_cov_38.549210	126	177	230	1	51	0.0196078
NODE_8321_length_922_cov_38.549210	126	177	238	1	51	0.0196078
NODE_8321_length_922_cov_38.549210	126	177	239	1	51	0.0196078
NODE_8321_length_922_cov_38.549210	126	177	243	1	51	0.0196078
NODE_8321_length_922_cov_38.549210	126	177	264	1	51	0.0196078
NODE_8321_length_922_cov_38.549210	126	177	267	1	51	0.0196078
NODE_8321_length_922_cov_38.549210	126	177	282	1	51	0.0196078
NODE_8321_length_922_cov_38.549210	126	177	286	1	51	0.0196078
NODE_8321_length_922_cov_38.549210	126	177	287	2	51	0.0392157
NODE_8321_length_922_cov_38.549210	126	177	294	1	51	0.0196078
NODE_8321_length_922_cov_38.549210	126	177	302	1	51	0.0196078
NODE_8321_length_922_cov_38.549210	126	177	304	1	51	0.0196078
NODE_8321_length_922_cov_38.549210	126	177	305	1	51	0.0196078
NODE_8321_length_922_cov_38.549210	126	177	313	1	51	0.0196078
NODE_8321_length_922_cov_38.549210	126	177	315	1	51	0.0196078
NODE_8321_length_922_cov_38.549210	126	177	320	1	51	0.0196078
NODE_8321_length_922_cov_38.549210	126	177	324	1	51	0.0196078
NODE_8321_length_922_cov_38.549210	126	177	326	1	51	0.0196078
NODE_8321_length_922_cov_38.549210	126	177	334	1	51	0.0196078
NODE_8321_length_922_cov_38.549210	126	177	336	1	51	0.0196078
NODE_8321_length_922_cov_38.549210	126	177	346	1	51	0.0196078
NODE_8321_length_922_cov_38.549210	126	177	350	1	51	0.0196078
NODE_8321_length_922_cov_38.549210	126	177	353	1	51	0.0196078
NODE_8321_length_922_cov_38.549210	126	177	356	1	51	0.0196078
NODE_8321_length_922_cov_38.549210	126	177	362	1	51	0.0196078
NODE_8321_length_922_cov_38.549210	126	177	367	1	51	0.0196078
NODE_8321_length_922_cov_38.549210	126	177	368	1	51	0.0196078
NODE_8321_length_922_cov_38.549210	126	177	369	1	51	0.0196078
NODE_8321_length_922_cov_38.549210	126	177	370	1	51	0.0196078
NODE_8321_length_922_cov_38.549210	126	177	371	1	51	0.0196078
NODE_8321_length_922_cov_38.549210	126	177	373	1	51	0.0196078
NODE_8321_length_922_cov_38.549210	126	177	374	2	51	0.0392157
NODE_8321_length_922_cov_38.549210	126	177	376	1	51	0.0196078
NODE_8321_length_922_cov_38.549210	126	177	377	1	51	0.0196078
NODE_8321_length_922_cov_38.549210	126	177	389	1	51	0.0196078
NODE_8321_length_922_cov_38.549210	126	177	404	1	51	0.0196078
NODE_8321_length_922_cov_38.549210	126	177	406	1	51	0.0196078
NODE_8321_length_922_cov_38.549210	126	177	409	1	51	0.0196078
NODE_8321_length_922_cov_38.549210	126	177	416	1	51	0.0196078
NODE_8321_length_922_cov_38.549210	126	177	423	1	51	0.0196078
NODE_8321_length_922_cov_38.549210	126	177	428	1	51	0.0196078
NODE_8321_length_922_cov_38.549210	308	383	0	50	75	0.6666667
NODE_8321_length_922_cov_38.549210	308	383	2	25	75	0.3333333
NODE_8321_length_922_cov_38.549210	356	393	0	2	37	0.0540541
NODE_8321_length_922_cov_38.549210	356	393	2	35	37	0.9459459
NODE_8321_length_922_cov_38.549210	818	898	0	7	80	0.0875000
NODE_8321_length_922_cov_38.549210	818	898	2	73	80	0.9125000
NODE_8321_length_922_cov_38.549210	871	908	0	17	37	0.4594595
NODE_8321_length_922_cov_38.549210	871	908	2	20	37	0.5405405
NODE_8322_length_922_cov_35.041312	385	465	0	80	80	1.0000000
NODE_8322_length_922_cov_35.041312	438	518	0	80	80	1.0000000
NODE_8323_length_922_cov_30.749696	426	506	0	12	80	0.1500000
NODE_8323_length_922_cov_30.749696	426	506	2	68	80	0.8500000
NODE_8323_length_922_cov_30.749696	479	559	0	65	80	0.8125000
NODE_8323_length_922_cov_30.749696	479	559	2	15	80	0.1875000
NODE_8324_length_922_cov_25.558931	291	370	0	79	79	1.0000000
NODE_8324_length_922_cov_25.558931	344	423	0	79	79	1.0000000
NODE_8325_length_922_cov_25.527339	391	471	0	45	80	0.5625000
NODE_8325_length_922_cov_25.527339	391	471	2	35	80	0.4375000
NODE_8325_length_922_cov_25.527339	444	524	0	80	80	1.0000000
NODE_8326_length_922_cov_23.630620	224	304	0	78	80	0.9750000
NODE_8326_length_922_cov_23.630620	224	304	2	2	80	0.0250000
NODE_8326_length_922_cov_23.630620	277	357	0	25	80	0.3125000
NODE_8326_length_922_cov_23.630620	277	357	2	55	80	0.6875000
NODE_8326_length_922_cov_23.630620	353	433	0	4	80	0.0500000
NODE_8326_length_922_cov_23.630620	353	433	2	76	80	0.9500000
NODE_8326_length_922_cov_23.630620	406	486	0	57	80	0.7125000
NODE_8326_length_922_cov_23.630620	406	486	2	23	80	0.2875000
NODE_8327_length_922_cov_22.388821	465	545	0	80	80	1.0000000
NODE_8327_length_922_cov_22.388821	518	598	0	80	80	1.0000000
NODE_8328_length_922_cov_20.320778	421	501	0	35	80	0.4375000
NODE_8328_length_922_cov_20.320778	421	501	2	45	80	0.5625000
NODE_8328_length_922_cov_20.320778	474	554	0	17	80	0.2125000
NODE_8328_length_922_cov_20.320778	474	554	2	63	80	0.7875000
NODE_8329_length_922_cov_17.645200	413	479	0	12	66	0.1818182
NODE_8329_length_922_cov_17.645200	413	479	10	1	66	0.0151515
NODE_8329_length_922_cov_17.645200	413	479	11	1	66	0.0151515
NODE_8329_length_922_cov_17.645200	413	479	12	4	66	0.0606061
NODE_8329_length_922_cov_17.645200	413	479	14	48	66	0.7272727
NODE_8330_length_922_cov_12.574727	454	534	0	72	80	0.9000000
NODE_8330_length_922_cov_12.574727	454	534	2	8	80	0.1000000
NODE_8330_length_922_cov_12.574727	507	587	0	19	80	0.2375000
NODE_8330_length_922_cov_12.574727	507	587	2	61	80	0.7625000
NODE_8331_length_922_cov_11.934386	255	335	0	80	80	1.0000000
NODE_8331_length_922_cov_11.934386	308	388	0	80	80	1.0000000
NODE_8332_length_922_cov_11.068044	423	503	0	32	80	0.4000000
NODE_8332_length_922_cov_11.068044	423	503	4	48	80	0.6000000
NODE_8332_length_922_cov_11.068044	476	557	4	81	81	1.0000000
NODE_8333_length_922_cov_7.907655	441	521	0	80	80	1.0000000
NODE_8333_length_922_cov_7.907655	494	574	0	80	80	1.0000000
NODE_8334_length_922_cov_7.737546	463	543	0	80	80	1.0000000
NODE_8334_length_922_cov_7.737546	516	596	0	80	80	1.0000000
NODE_8335_length_922_cov_7.241798	298	378	0	80	80	1.0000000
NODE_8335_length_922_cov_7.241798	351	431	0	80	80	1.0000000
NODE_8347_length_921_cov_21.317518	457	537	0	80	80	1.0000000
NODE_8347_length_921_cov_21.317518	510	590	0	80	80	1.0000000
NODE_8348_length_921_cov_18.462287	519	599	0	80	80	1.0000000
NODE_8348_length_921_cov_18.462287	572	652	0	80	80	1.0000000
NODE_8349_length_921_cov_15.440389	373	453	0	80	80	1.0000000
NODE_8349_length_921_cov_15.440389	426	506	0	80	80	1.0000000
NODE_8350_length_921_cov_13.216545	465	545	0	80	80	1.0000000
NODE_8350_length_921_cov_13.216545	518	598	0	80	80	1.0000000
NODE_8351_length_921_cov_9.283455	399	439	0	40	40	1.0000000
NODE_8351_length_921_cov_9.283455	532	612	0	80	80	1.0000000
NODE_8351_length_921_cov_9.283455	585	665	0	80	80	1.0000000
NODE_8352_length_921_cov_8.253041	289	369	0	80	80	1.0000000
NODE_8352_length_921_cov_8.253041	342	422	0	80	80	1.0000000
NODE_8364_length_920_cov_47.493301	543	623	0	80	80	1.0000000
NODE_8364_length_920_cov_47.493301	596	676	0	80	80	1.0000000
NODE_8365_length_920_cov_30.404385	543	623	0	61	80	0.7625000
NODE_8365_length_920_cov_30.404385	543	623	6	19	80	0.2375000
NODE_8365_length_920_cov_30.404385	596	676	0	8	80	0.1000000
NODE_8365_length_920_cov_30.404385	596	676	6	72	80	0.9000000
NODE_8366_length_920_cov_25.360536	413	493	2	8	80	0.1000000
NODE_8366_length_920_cov_25.360536	413	493	3	19	80	0.2375000
NODE_8366_length_920_cov_25.360536	413	493	4	2	80	0.0250000
NODE_8366_length_920_cov_25.360536	413	493	6	4	80	0.0500000
NODE_8366_length_920_cov_25.360536	413	493	9	47	80	0.5875000
NODE_8366_length_920_cov_25.360536	466	546	2	8	80	0.1000000
NODE_8366_length_920_cov_25.360536	466	546	3	17	80	0.2125000
NODE_8366_length_920_cov_25.360536	466	546	4	42	80	0.5250000
NODE_8366_length_920_cov_25.360536	466	546	6	10	80	0.1250000
NODE_8366_length_920_cov_25.360536	466	546	8	3	80	0.0375000
NODE_8366_length_920_cov_25.360536	542	615	4	48	73	0.6575342
NODE_8366_length_920_cov_25.360536	542	615	6	25	73	0.3424658
NODE_8366_length_920_cov_25.360536	588	668	0	13	80	0.1625000
NODE_8366_length_920_cov_25.360536	588	668	4	67	80	0.8375000
NODE_8367_length_920_cov_24.918392	403	483	0	27	80	0.3375000
NODE_8367_length_920_cov_24.918392	403	483	2	53	80	0.6625000
NODE_8367_length_920_cov_24.918392	456	536	0	28	80	0.3500000
NODE_8367_length_920_cov_24.918392	456	536	2	52	80	0.6500000
NODE_8368_length_920_cov_18.517661	353	433	0	80	80	1.0000000
NODE_8368_length_920_cov_18.517661	406	486	0	80	80	1.0000000
NODE_8369_length_920_cov_17.710110	310	390	0	47	80	0.5875000
NODE_8369_length_920_cov_17.710110	310	390	2	9	80	0.1125000
NODE_8369_length_920_cov_17.710110	310	390	4	24	80	0.3000000
NODE_8369_length_920_cov_17.710110	363	443	2	3	80	0.0375000
NODE_8369_length_920_cov_17.710110	363	443	4	77	80	0.9625000
NODE_8370_length_920_cov_15.650426	403	458	2	35	55	0.6363636
NODE_8370_length_920_cov_15.650426	403	458	3	20	55	0.3636364
NODE_8371_length_920_cov_12.588307	454	534	0	14	80	0.1750000
NODE_8371_length_920_cov_12.588307	454	534	4	66	80	0.8250000
NODE_8371_length_920_cov_12.588307	507	586	0	38	79	0.4810127
NODE_8371_length_920_cov_12.588307	507	586	4	41	79	0.5189874
NODE_8372_length_920_cov_10.822168	354	434	0	45	80	0.5625000
NODE_8372_length_920_cov_10.822168	354	434	4	35	80	0.4375000
NODE_8372_length_920_cov_10.822168	407	487	0	80	80	1.0000000
NODE_8374_length_920_cov_8.297199	453	533	0	80	80	1.0000000
NODE_8374_length_920_cov_8.297199	506	583	0	77	77	1.0000000
NODE_8378_length_920_cov_2.992692	501	581	0	80	80	1.0000000
NODE_8378_length_920_cov_2.992692	554	634	0	80	80	1.0000000
NODE_8389_length_919_cov_44.813415	338	418	0	14	80	0.1750000
NODE_8389_length_919_cov_44.813415	338	418	2	62	80	0.7750000
NODE_8389_length_919_cov_44.813415	338	418	4	4	80	0.0500000
NODE_8389_length_919_cov_44.813415	391	471	0	8	80	0.1000000
NODE_8389_length_919_cov_44.813415	391	471	2	72	80	0.9000000
NODE_8389_length_919_cov_44.813415	467	547	0	80	80	1.0000000
NODE_8389_length_919_cov_44.813415	520	600	0	80	80	1.0000000
NODE_8390_length_919_cov_37.459756	389	469	2	10	80	0.1250000
NODE_8390_length_919_cov_37.459756	389	469	4	21	80	0.2625000
NODE_8390_length_919_cov_37.459756	389	469	6	49	80	0.6125000
NODE_8390_length_919_cov_37.459756	442	522	0	4	80	0.0500000
NODE_8390_length_919_cov_37.459756	442	522	2	59	80	0.7375000
NODE_8390_length_919_cov_37.459756	442	522	6	17	80	0.2125000
NODE_8390_length_919_cov_37.459756	518	598	0	17	80	0.2125000
NODE_8390_length_919_cov_37.459756	518	598	2	63	80	0.7875000
NODE_8390_length_919_cov_37.459756	571	651	0	70	80	0.8750000
NODE_8390_length_919_cov_37.459756	571	651	2	10	80	0.1250000
NODE_8391_length_919_cov_35.002439	474	554	0	80	80	1.0000000
NODE_8391_length_919_cov_35.002439	527	607	0	80	80	1.0000000
NODE_8392_length_919_cov_29.935366	246	326	0	80	80	1.0000000
NODE_8392_length_919_cov_29.935366	299	379	0	80	80	1.0000000
NODE_8393_length_919_cov_28.190244	470	550	2	80	80	1.0000000
NODE_8393_length_919_cov_28.190244	523	603	0	35	80	0.4375000
NODE_8393_length_919_cov_28.190244	523	603	2	45	80	0.5625000
NODE_8394_length_919_cov_27.119512	454	534	2	30	80	0.3750000
NODE_8394_length_919_cov_27.119512	454	534	8	45	80	0.5625000
NODE_8394_length_919_cov_27.119512	454	534	10	5	80	0.0625000
NODE_8394_length_919_cov_27.119512	507	587	2	80	80	1.0000000
NODE_8395_length_919_cov_21.836585	545	625	0	80	80	1.0000000
NODE_8395_length_919_cov_21.836585	598	677	0	79	79	1.0000000
NODE_8396_length_919_cov_17.442683	385	465	0	80	80	1.0000000
NODE_8396_length_919_cov_17.442683	438	518	0	80	80	1.0000000
NODE_8397_length_919_cov_16.685366	309	389	0	12	80	0.1500000
NODE_8397_length_919_cov_16.685366	309	389	4	68	80	0.8500000
NODE_8397_length_919_cov_16.685366	362	442	0	35	80	0.4375000
NODE_8397_length_919_cov_16.685366	362	442	4	45	80	0.5625000
NODE_8398_length_919_cov_14.013415	435	515	0	80	80	1.0000000
NODE_8398_length_919_cov_14.013415	488	568	0	80	80	1.0000000
NODE_8399_length_919_cov_12.013415	340	420	0	80	80	1.0000000
NODE_8399_length_919_cov_12.013415	393	473	0	80	80	1.0000000
NODE_8403_length_919_cov_3.529268	424	504	0	54	80	0.6750000
NODE_8403_length_919_cov_3.529268	424	504	6	26	80	0.3250000
NODE_8403_length_919_cov_3.529268	477	557	0	1	80	0.0125000
NODE_8403_length_919_cov_3.529268	477	557	6	79	80	0.9875000
NODE_8404_length_919_cov_3.200000	444	524	2	67	80	0.8375000
NODE_8404_length_919_cov_3.200000	444	524	4	13	80	0.1625000
NODE_8404_length_919_cov_3.200000	497	577	0	30	80	0.3750000
NODE_8404_length_919_cov_3.200000	497	577	2	50	80	0.6250000
NODE_8415_length_918_cov_41.115995	387	467	0	5	80	0.0625000
NODE_8415_length_918_cov_41.115995	387	467	3	1	80	0.0125000
NODE_8415_length_918_cov_41.115995	387	467	4	74	80	0.9250000
NODE_8415_length_918_cov_41.115995	440	520	0	58	80	0.7250000
NODE_8415_length_918_cov_41.115995	440	520	3	1	80	0.0125000
NODE_8415_length_918_cov_41.115995	440	520	4	21	80	0.2625000
NODE_8416_length_918_cov_37.405372	427	507	2	16	80	0.2000000
NODE_8416_length_918_cov_37.405372	427	507	4	37	80	0.4625000
NODE_8416_length_918_cov_37.405372	427	507	6	27	80	0.3375000
NODE_8416_length_918_cov_37.405372	480	560	0	23	80	0.2875000
NODE_8416_length_918_cov_37.405372	480	560	4	57	80	0.7125000
NODE_8417_length_918_cov_31.559219	289	369	0	9	80	0.1125000
NODE_8417_length_918_cov_31.559219	289	369	4	71	80	0.8875000
NODE_8417_length_918_cov_31.559219	342	422	0	62	80	0.7750000
NODE_8417_length_918_cov_31.559219	342	422	4	18	80	0.2250000
NODE_8417_length_918_cov_31.559219	418	498	0	80	80	1.0000000
NODE_8417_length_918_cov_31.559219	471	551	0	70	80	0.8750000
NODE_8417_length_918_cov_31.559219	471	551	2	10	80	0.1250000
NODE_8418_length_918_cov_25.195360	429	509	15	19	80	0.2375000
NODE_8418_length_918_cov_25.195360	429	509	22	61	80	0.7625000
NODE_8418_length_918_cov_25.195360	482	562	0	16	80	0.2000000
NODE_8418_length_918_cov_25.195360	482	562	8	27	80	0.3375000
NODE_8418_length_918_cov_25.195360	482	562	15	29	80	0.3625000
NODE_8418_length_918_cov_25.195360	482	562	22	8	80	0.1000000
NODE_8420_length_918_cov_10.537241	361	441	0	80	80	1.0000000
NODE_8420_length_918_cov_10.537241	414	492	0	78	78	1.0000000
NODE_8421_length_918_cov_9.821734	283	363	0	80	80	1.0000000
NODE_8421_length_918_cov_9.821734	336	416	0	55	80	0.6875000
NODE_8421_length_918_cov_9.821734	336	416	2	25	80	0.3125000
NODE_8422_length_918_cov_9.714286	365	445	0	80	80	1.0000000
NODE_8422_length_918_cov_9.714286	418	498	0	80	80	1.0000000
NODE_8441_length_917_cov_38.845966	405	476	0	22	71	0.3098592
NODE_8441_length_917_cov_38.845966	405	476	2	49	71	0.6901408
NODE_8441_length_917_cov_38.845966	458	538	1	18	80	0.2250000
NODE_8441_length_917_cov_38.845966	458	538	2	25	80	0.3125000
NODE_8441_length_917_cov_38.845966	458	538	3	37	80	0.4625000
NODE_8442_length_917_cov_37.775061	505	585	0	80	80	1.0000000
NODE_8442_length_917_cov_37.775061	558	638	0	80	80	1.0000000
NODE_8443_length_917_cov_33.195599	335	415	0	80	80	1.0000000
NODE_8443_length_917_cov_33.195599	388	468	0	79	80	0.9875000
NODE_8443_length_917_cov_33.195599	388	468	2	1	80	0.0125000
NODE_8443_length_917_cov_33.195599	464	544	0	3	80	0.0375000
NODE_8443_length_917_cov_33.195599	464	544	2	77	80	0.9625000
NODE_8443_length_917_cov_33.195599	517	597	0	10	80	0.1250000
NODE_8443_length_917_cov_33.195599	517	597	2	70	80	0.8750000
NODE_8444_length_917_cov_22.871638	463	543	0	80	80	1.0000000
NODE_8444_length_917_cov_22.871638	516	593	0	77	77	1.0000000
NODE_8445_length_917_cov_16.899756	321	401	0	80	80	1.0000000
NODE_8445_length_917_cov_16.899756	374	454	0	80	80	1.0000000
NODE_8446_length_917_cov_12.283619	397	477	4	80	80	1.0000000
NODE_8446_length_917_cov_12.283619	450	530	0	51	80	0.6375000
NODE_8446_length_917_cov_12.283619	450	530	4	29	80	0.3625000
NODE_8447_length_917_cov_12.172372	380	460	0	80	80	1.0000000
NODE_8447_length_917_cov_12.172372	433	513	0	80	80	1.0000000
NODE_8447_length_917_cov_12.172372	545	597	0	52	52	1.0000000
NODE_8448_length_917_cov_8.277506	564	644	0	80	80	1.0000000
NODE_8448_length_917_cov_8.277506	617	697	0	80	80	1.0000000
NODE_8449_length_917_cov_8.145477	155	235	0	80	80	1.0000000
NODE_8449_length_917_cov_8.145477	208	288	0	80	80	1.0000000
NODE_8451_length_917_cov_6.073350	366	446	0	80	80	1.0000000
NODE_8451_length_917_cov_6.073350	419	499	0	80	80	1.0000000
NODE_8463_length_916_cov_32.867809	347	427	0	80	80	1.0000000
NODE_8463_length_916_cov_32.867809	400	480	0	80	80	1.0000000
NODE_8464_length_916_cov_27.673195	450	530	0	80	80	1.0000000
NODE_8464_length_916_cov_27.673195	503	583	0	80	80	1.0000000
NODE_8465_length_916_cov_27.146879	223	303	0	80	80	1.0000000
NODE_8465_length_916_cov_27.146879	276	356	0	80	80	1.0000000
NODE_8466_length_916_cov_25.604651	398	478	0	11	80	0.1375000
NODE_8466_length_916_cov_25.604651	398	478	2	69	80	0.8625000
NODE_8466_length_916_cov_25.604651	451	531	0	64	80	0.8000000
NODE_8466_length_916_cov_25.604651	451	531	2	16	80	0.2000000
NODE_8467_length_916_cov_18.035496	456	536	0	7	80	0.0875000
NODE_8467_length_916_cov_18.035496	456	536	2	11	80	0.1375000
NODE_8467_length_916_cov_18.035496	456	536	4	19	80	0.2375000
NODE_8467_length_916_cov_18.035496	456	536	6	5	80	0.0625000
NODE_8467_length_916_cov_18.035496	456	536	8	17	80	0.2125000
NODE_8467_length_916_cov_18.035496	456	536	10	20	80	0.2500000
NODE_8467_length_916_cov_18.035496	456	536	12	1	80	0.0125000
NODE_8467_length_916_cov_18.035496	509	589	6	10	80	0.1250000
NODE_8467_length_916_cov_18.035496	509	589	8	20	80	0.2500000
NODE_8467_length_916_cov_18.035496	509	589	10	49	80	0.6125000
NODE_8467_length_916_cov_18.035496	509	589	12	1	80	0.0125000
NODE_8468_length_916_cov_12.651163	500	580	2	42	80	0.5250000
NODE_8468_length_916_cov_12.651163	500	580	3	7	80	0.0875000
NODE_8468_length_916_cov_12.651163	500	580	4	31	80	0.3875000
NODE_8468_length_916_cov_12.651163	553	633	2	17	80	0.2125000
NODE_8468_length_916_cov_12.651163	553	633	4	63	80	0.7875000
NODE_8469_length_916_cov_11.337821	530	610	0	53	80	0.6625000
NODE_8469_length_916_cov_11.337821	530	610	2	27	80	0.3375000
NODE_8469_length_916_cov_11.337821	583	663	0	6	80	0.0750000
NODE_8469_length_916_cov_11.337821	583	663	2	74	80	0.9250000
NODE_8470_length_916_cov_9.640147	293	373	6	36	80	0.4500000
NODE_8470_length_916_cov_9.640147	293	373	10	44	80	0.5500000
NODE_8470_length_916_cov_9.640147	346	426	0	10	80	0.1250000
NODE_8470_length_916_cov_9.640147	346	426	4	11	80	0.1375000
NODE_8470_length_916_cov_9.640147	346	426	10	59	80	0.7375000
NODE_8472_length_916_cov_8.042840	426	506	0	80	80	1.0000000
NODE_8472_length_916_cov_8.042840	479	559	0	48	80	0.6000000
NODE_8472_length_916_cov_8.042840	479	559	2	32	80	0.4000000
NODE_8473_length_916_cov_7.123623	785	847	20	1	62	0.0161290
NODE_8473_length_916_cov_7.123623	785	847	22	2	62	0.0322581
NODE_8473_length_916_cov_7.123623	785	847	24	3	62	0.0483871
NODE_8473_length_916_cov_7.123623	785	847	30	1	62	0.0161290
NODE_8473_length_916_cov_7.123623	785	847	32	1	62	0.0161290
NODE_8473_length_916_cov_7.123623	785	847	34	4	62	0.0645161
NODE_8473_length_916_cov_7.123623	785	847	36	3	62	0.0483871
NODE_8473_length_916_cov_7.123623	785	847	38	5	62	0.0806452
NODE_8473_length_916_cov_7.123623	785	847	40	1	62	0.0161290
NODE_8473_length_916_cov_7.123623	785	847	42	27	62	0.4354839
NODE_8473_length_916_cov_7.123623	785	847	44	14	62	0.2258064
NODE_8473_length_916_cov_7.123623	820	900	32	4	80	0.0500000
NODE_8473_length_916_cov_7.123623	820	900	34	3	80	0.0375000
NODE_8473_length_916_cov_7.123623	820	900	36	5	80	0.0625000
NODE_8473_length_916_cov_7.123623	820	900	38	3	80	0.0375000
NODE_8473_length_916_cov_7.123623	820	900	40	4	80	0.0500000
NODE_8473_length_916_cov_7.123623	820	900	42	61	80	0.7625000
NODE_8481_length_915_cov_59.289216	398	478	8	14	80	0.1750000
NODE_8481_length_915_cov_59.289216	398	478	10	66	80	0.8250000
NODE_8481_length_915_cov_59.289216	451	531	2	19	80	0.2375000
NODE_8481_length_915_cov_59.289216	451	531	10	32	80	0.4000000
NODE_8481_length_915_cov_59.289216	451	531	22	9	80	0.1125000
NODE_8481_length_915_cov_59.289216	451	531	24	20	80	0.2500000
NODE_8481_length_915_cov_59.289216	527	607	22	7	80	0.0875000
NODE_8481_length_915_cov_59.289216	527	607	24	61	80	0.7625000
NODE_8481_length_915_cov_59.289216	527	607	25	9	80	0.1125000
NODE_8481_length_915_cov_59.289216	527	607	28	3	80	0.0375000
NODE_8481_length_915_cov_59.289216	580	660	4	28	80	0.3500000
NODE_8481_length_915_cov_59.289216	580	660	23	22	80	0.2750000
NODE_8481_length_915_cov_59.289216	580	660	24	30	80	0.3750000
NODE_8482_length_915_cov_45.104167	153	228	4	75	75	1.0000000
NODE_8482_length_915_cov_45.104167	206	286	0	45	80	0.5625000
NODE_8482_length_915_cov_45.104167	206	286	4	35	80	0.4375000
NODE_8482_length_915_cov_45.104167	282	362	0	80	80	1.0000000
NODE_8482_length_915_cov_45.104167	335	415	0	80	80	1.0000000
NODE_8483_length_915_cov_37.599265	397	477	0	25	80	0.3125000
NODE_8483_length_915_cov_37.599265	397	477	5	3	80	0.0375000
NODE_8483_length_915_cov_37.599265	397	477	6	52	80	0.6500000
NODE_8483_length_915_cov_37.599265	450	530	0	7	80	0.0875000
NODE_8483_length_915_cov_37.599265	450	530	6	73	80	0.9125000
NODE_8485_length_915_cov_20.458333	297	377	0	80	80	1.0000000
NODE_8485_length_915_cov_20.458333	350	430	0	80	80	1.0000000
NODE_8485_length_915_cov_20.458333	426	506	0	80	80	1.0000000
NODE_8485_length_915_cov_20.458333	479	559	0	80	80	1.0000000
NODE_8486_length_915_cov_14.397059	175	255	4	2	80	0.0250000
NODE_8486_length_915_cov_14.397059	175	255	9	3	80	0.0375000
NODE_8486_length_915_cov_14.397059	175	255	10	4	80	0.0500000
NODE_8486_length_915_cov_14.397059	175	255	11	34	80	0.4250000
NODE_8486_length_915_cov_14.397059	175	255	12	35	80	0.4375000
NODE_8486_length_915_cov_14.397059	175	255	13	2	80	0.0250000
NODE_8486_length_915_cov_14.397059	228	308	4	55	80	0.6875000
NODE_8486_length_915_cov_14.397059	228	308	12	25	80	0.3125000
NODE_8487_length_915_cov_8.741422	295	375	0	80	80	1.0000000
NODE_8487_length_915_cov_8.741422	348	428	0	80	80	1.0000000
NODE_8488_length_915_cov_7.719363	823	894	4	71	71	1.0000000
NODE_8488_length_915_cov_7.719363	828	894	4	66	66	1.0000000
NODE_8488_length_915_cov_7.719363	867	915	2	3	48	0.0625000
NODE_8488_length_915_cov_7.719363	867	915	4	45	48	0.9375000
NODE_8488_length_915_cov_7.719363	867	915	2	3	48	0.0625000
NODE_8488_length_915_cov_7.719363	867	915	4	45	48	0.9375000
NODE_8488_length_915_cov_7.719363	867	915	2	3	48	0.0625000
NODE_8488_length_915_cov_7.719363	867	915	4	45	48	0.9375000
NODE_8489_length_915_cov_7.648284	370	450	0	80	80	1.0000000
NODE_8489_length_915_cov_7.648284	423	503	0	80	80	1.0000000
NODE_8490_length_915_cov_6.848039	434	514	0	80	80	1.0000000
NODE_8490_length_915_cov_6.848039	487	567	0	80	80	1.0000000
NODE_8497_length_915_cov_2.011029	24	99	6	46	75	0.6133333
NODE_8497_length_915_cov_2.011029	24	99	8	29	75	0.3866667
NODE_8505_length_914_cov_89.814724	0	41	11	1	41	0.0243902
NODE_8505_length_914_cov_89.814724	0	41	19	2	41	0.0487805
NODE_8505_length_914_cov_89.814724	0	41	25	1	41	0.0243902
NODE_8505_length_914_cov_89.814724	0	41	29	1	41	0.0243902
NODE_8505_length_914_cov_89.814724	0	41	33	1	41	0.0243902
NODE_8505_length_914_cov_89.814724	0	41	46	1	41	0.0243902
NODE_8505_length_914_cov_89.814724	0	41	48	1	41	0.0243902
NODE_8505_length_914_cov_89.814724	0	41	67	1	41	0.0243902
NODE_8505_length_914_cov_89.814724	0	41	75	1	41	0.0243902
NODE_8505_length_914_cov_89.814724	0	41	80	1	41	0.0243902
NODE_8505_length_914_cov_89.814724	0	41	92	2	41	0.0487805
NODE_8505_length_914_cov_89.814724	0	41	109	2	41	0.0487805
NODE_8505_length_914_cov_89.814724	0	41	126	1	41	0.0243902
NODE_8505_length_914_cov_89.814724	0	41	130	3	41	0.0731707
NODE_8505_length_914_cov_89.814724	0	41	136	2	41	0.0487805
NODE_8505_length_914_cov_89.814724	0	41	150	1	41	0.0243902
NODE_8505_length_914_cov_89.814724	0	41	180	1	41	0.0243902
NODE_8505_length_914_cov_89.814724	0	41	193	1	41	0.0243902
NODE_8505_length_914_cov_89.814724	0	41	205	1	41	0.0243902
NODE_8505_length_914_cov_89.814724	0	41	217	1	41	0.0243902
NODE_8505_length_914_cov_89.814724	0	41	221	1	41	0.0243902
NODE_8505_length_914_cov_89.814724	0	41	228	1	41	0.0243902
NODE_8505_length_914_cov_89.814724	0	41	230	1	41	0.0243902
NODE_8505_length_914_cov_89.814724	0	41	236	1	41	0.0243902
NODE_8505_length_914_cov_89.814724	0	41	243	1	41	0.0243902
NODE_8505_length_914_cov_89.814724	0	41	246	1	41	0.0243902
NODE_8505_length_914_cov_89.814724	0	41	247	1	41	0.0243902
NODE_8505_length_914_cov_89.814724	0	41	253	1	41	0.0243902
NODE_8505_length_914_cov_89.814724	0	41	257	1	41	0.0243902
NODE_8505_length_914_cov_89.814724	0	41	265	1	41	0.0243902
NODE_8505_length_914_cov_89.814724	0	41	273	1	41	0.0243902
NODE_8505_length_914_cov_89.814724	0	41	281	1	41	0.0243902
NODE_8505_length_914_cov_89.814724	0	41	285	1	41	0.0243902
NODE_8505_length_914_cov_89.814724	0	41	291	1	41	0.0243902
NODE_8505_length_914_cov_89.814724	0	41	306	1	41	0.0243902
NODE_8505_length_914_cov_89.814724	19	94	136	2	75	0.0266667
NODE_8505_length_914_cov_89.814724	19	94	150	1	75	0.0133333
NODE_8505_length_914_cov_89.814724	19	94	180	1	75	0.0133333
NODE_8505_length_914_cov_89.814724	19	94	193	1	75	0.0133333
NODE_8505_length_914_cov_89.814724	19	94	205	1	75	0.0133333
NODE_8505_length_914_cov_89.814724	19	94	217	1	75	0.0133333
NODE_8505_length_914_cov_89.814724	19	94	221	1	75	0.0133333
NODE_8505_length_914_cov_89.814724	19	94	228	1	75	0.0133333
NODE_8505_length_914_cov_89.814724	19	94	230	1	75	0.0133333
NODE_8505_length_914_cov_89.814724	19	94	236	1	75	0.0133333
NODE_8505_length_914_cov_89.814724	19	94	243	1	75	0.0133333
NODE_8505_length_914_cov_89.814724	19	94	246	1	75	0.0133333
NODE_8505_length_914_cov_89.814724	19	94	247	1	75	0.0133333
NODE_8505_length_914_cov_89.814724	19	94	253	1	75	0.0133333
NODE_8505_length_914_cov_89.814724	19	94	257	1	75	0.0133333
NODE_8505_length_914_cov_89.814724	19	94	265	1	75	0.0133333
NODE_8505_length_914_cov_89.814724	19	94	273	1	75	0.0133333
NODE_8505_length_914_cov_89.814724	19	94	281	1	75	0.0133333
NODE_8505_length_914_cov_89.814724	19	94	285	1	75	0.0133333
NODE_8505_length_914_cov_89.814724	19	94	291	1	75	0.0133333
NODE_8505_length_914_cov_89.814724	19	94	306	1	75	0.0133333
NODE_8505_length_914_cov_89.814724	19	94	331	1	75	0.0133333
NODE_8505_length_914_cov_89.814724	19	94	344	1	75	0.0133333
NODE_8505_length_914_cov_89.814724	19	94	350	2	75	0.0266667
NODE_8505_length_914_cov_89.814724	19	94	354	1	75	0.0133333
NODE_8505_length_914_cov_89.814724	19	94	355	2	75	0.0266667
NODE_8505_length_914_cov_89.814724	19	94	357	1	75	0.0133333
NODE_8505_length_914_cov_89.814724	19	94	367	2	75	0.0266667
NODE_8505_length_914_cov_89.814724	19	94	370	2	75	0.0266667
NODE_8505_length_914_cov_89.814724	19	94	379	3	75	0.0400000
NODE_8505_length_914_cov_89.814724	19	94	385	1	75	0.0133333
NODE_8505_length_914_cov_89.814724	19	94	389	1	75	0.0133333
NODE_8505_length_914_cov_89.814724	19	94	391	1	75	0.0133333
NODE_8505_length_914_cov_89.814724	19	94	396	1	75	0.0133333
NODE_8505_length_914_cov_89.814724	19	94	402	1	75	0.0133333
NODE_8505_length_914_cov_89.814724	19	94	408	1	75	0.0133333
NODE_8505_length_914_cov_89.814724	19	94	410	1	75	0.0133333
NODE_8505_length_914_cov_89.814724	19	94	412	7	75	0.0933333
NODE_8505_length_914_cov_89.814724	19	94	421	1	75	0.0133333
NODE_8505_length_914_cov_89.814724	19	94	426	1	75	0.0133333
NODE_8505_length_914_cov_89.814724	19	94	428	1	75	0.0133333
NODE_8505_length_914_cov_89.814724	19	94	432	1	75	0.0133333
NODE_8505_length_914_cov_89.814724	19	94	435	2	75	0.0266667
NODE_8505_length_914_cov_89.814724	19	94	436	2	75	0.0266667
NODE_8505_length_914_cov_89.814724	19	94	437	1	75	0.0133333
NODE_8505_length_914_cov_89.814724	19	94	439	2	75	0.0266667
NODE_8505_length_914_cov_89.814724	19	94	440	8	75	0.1066667
NODE_8505_length_914_cov_89.814724	19	94	441	2	75	0.0266667
NODE_8505_length_914_cov_89.814724	19	94	442	2	75	0.0266667
NODE_8505_length_914_cov_89.814724	19	94	444	1	75	0.0133333
NODE_8506_length_914_cov_33.755828	400	480	0	80	80	1.0000000
NODE_8506_length_914_cov_33.755828	453	533	0	80	80	1.0000000
NODE_8507_length_914_cov_31.557055	368	448	2	8	80	0.1000000
NODE_8507_length_914_cov_31.557055	368	448	4	20	80	0.2500000
NODE_8507_length_914_cov_31.557055	368	448	6	52	80	0.6500000
NODE_8507_length_914_cov_31.557055	421	501	2	61	80	0.7625000
NODE_8507_length_914_cov_31.557055	421	501	6	19	80	0.2375000
NODE_8508_length_914_cov_29.087117	331	411	0	10	80	0.1250000
NODE_8508_length_914_cov_29.087117	331	411	4	70	80	0.8750000
NODE_8508_length_914_cov_29.087117	384	464	0	8	80	0.1000000
NODE_8508_length_914_cov_29.087117	384	464	4	72	80	0.9000000
NODE_8509_length_914_cov_28.490798	273	353	0	3	80	0.0375000
NODE_8509_length_914_cov_28.490798	273	353	5	1	80	0.0125000
NODE_8509_length_914_cov_28.490798	273	353	6	76	80	0.9500000
NODE_8509_length_914_cov_28.490798	326	406	0	27	80	0.3375000
NODE_8509_length_914_cov_28.490798	326	406	4	29	80	0.3625000
NODE_8509_length_914_cov_28.490798	326	406	5	1	80	0.0125000
NODE_8509_length_914_cov_28.490798	326	406	6	23	80	0.2875000
NODE_8509_length_914_cov_28.490798	402	482	4	80	80	1.0000000
NODE_8509_length_914_cov_28.490798	455	535	0	51	80	0.6375000
NODE_8509_length_914_cov_28.490798	455	535	4	29	80	0.3625000
NODE_8510_length_914_cov_25.429448	393	473	0	44	80	0.5500000
NODE_8510_length_914_cov_25.429448	393	473	2	9	80	0.1125000
NODE_8510_length_914_cov_25.429448	393	473	6	27	80	0.3375000
NODE_8510_length_914_cov_25.429448	446	526	2	1	80	0.0125000
NODE_8510_length_914_cov_25.429448	446	526	5	2	80	0.0250000
NODE_8510_length_914_cov_25.429448	446	526	6	77	80	0.9625000
NODE_8510_length_914_cov_25.429448	522	602	0	60	80	0.7500000
NODE_8510_length_914_cov_25.429448	522	602	2	17	80	0.2125000
NODE_8510_length_914_cov_25.429448	522	602	5	2	80	0.0250000
NODE_8510_length_914_cov_25.429448	522	602	6	1	80	0.0125000
NODE_8510_length_914_cov_25.429448	575	655	0	80	80	1.0000000
NODE_8511_length_914_cov_19.111656	354	434	0	20	80	0.2500000
NODE_8511_length_914_cov_19.111656	354	434	10	60	80	0.7500000
NODE_8511_length_914_cov_19.111656	407	487	10	80	80	1.0000000
NODE_8512_length_914_cov_13.423313	603	683	0	80	80	1.0000000
NODE_8512_length_914_cov_13.423313	656	736	0	80	80	1.0000000
NODE_8513_length_914_cov_10.947239	341	411	4	70	70	1.0000000
NODE_8513_length_914_cov_10.947239	384	464	0	41	80	0.5125000
NODE_8513_length_914_cov_10.947239	384	464	4	39	80	0.4875000
NODE_8518_length_914_cov_1.931288	833	873	8	37	40	0.9250000
NODE_8518_length_914_cov_1.931288	833	873	10	3	40	0.0750000
NODE_8526_length_913_cov_49.665848	31	111	91	1	80	0.0125000
NODE_8526_length_913_cov_49.665848	31	111	93	1	80	0.0125000
NODE_8526_length_913_cov_49.665848	31	111	95	1	80	0.0125000
NODE_8526_length_913_cov_49.665848	31	111	99	1	80	0.0125000
NODE_8526_length_913_cov_49.665848	31	111	101	2	80	0.0250000
NODE_8526_length_913_cov_49.665848	31	111	105	1	80	0.0125000
NODE_8526_length_913_cov_49.665848	31	111	107	2	80	0.0250000
NODE_8526_length_913_cov_49.665848	31	111	109	4	80	0.0500000
NODE_8526_length_913_cov_49.665848	31	111	111	1	80	0.0125000
NODE_8526_length_913_cov_49.665848	31	111	112	1	80	0.0125000
NODE_8526_length_913_cov_49.665848	31	111	114	5	80	0.0625000
NODE_8526_length_913_cov_49.665848	31	111	116	3	80	0.0375000
NODE_8526_length_913_cov_49.665848	31	111	122	1	80	0.0125000
NODE_8526_length_913_cov_49.665848	31	111	126	3	80	0.0375000
NODE_8526_length_913_cov_49.665848	31	111	135	5	80	0.0625000
NODE_8526_length_913_cov_49.665848	31	111	137	4	80	0.0500000
NODE_8526_length_913_cov_49.665848	31	111	138	1	80	0.0125000
NODE_8526_length_913_cov_49.665848	31	111	142	1	80	0.0125000
NODE_8526_length_913_cov_49.665848	31	111	143	1	80	0.0125000
NODE_8526_length_913_cov_49.665848	31	111	147	1	80	0.0125000
NODE_8526_length_913_cov_49.665848	31	111	148	2	80	0.0250000
NODE_8526_length_913_cov_49.665848	31	111	150	1	80	0.0125000
NODE_8526_length_913_cov_49.665848	31	111	155	1	80	0.0125000
NODE_8526_length_913_cov_49.665848	31	111	158	1	80	0.0125000
NODE_8526_length_913_cov_49.665848	31	111	160	1	80	0.0125000
NODE_8526_length_913_cov_49.665848	31	111	161	3	80	0.0375000
NODE_8526_length_913_cov_49.665848	31	111	162	1	80	0.0125000
NODE_8526_length_913_cov_49.665848	31	111	165	3	80	0.0375000
NODE_8526_length_913_cov_49.665848	31	111	171	1	80	0.0125000
NODE_8526_length_913_cov_49.665848	31	111	172	2	80	0.0250000
NODE_8526_length_913_cov_49.665848	31	111	173	1	80	0.0125000
NODE_8526_length_913_cov_49.665848	31	111	177	1	80	0.0125000
NODE_8526_length_913_cov_49.665848	31	111	179	1	80	0.0125000
NODE_8526_length_913_cov_49.665848	31	111	180	1	80	0.0125000
NODE_8526_length_913_cov_49.665848	31	111	181	4	80	0.0500000
NODE_8526_length_913_cov_49.665848	31	111	182	1	80	0.0125000
NODE_8526_length_913_cov_49.665848	31	111	184	2	80	0.0250000
NODE_8526_length_913_cov_49.665848	31	111	185	3	80	0.0375000
NODE_8526_length_913_cov_49.665848	31	111	189	6	80	0.0750000
NODE_8526_length_913_cov_49.665848	31	111	190	1	80	0.0125000
NODE_8526_length_913_cov_49.665848	31	111	191	2	80	0.0250000
NODE_8526_length_913_cov_49.665848	31	111	192	1	80	0.0125000
NODE_8526_length_913_cov_49.665848	136	155	148	1	19	0.0526316
NODE_8526_length_913_cov_49.665848	136	155	149	1	19	0.0526316
NODE_8526_length_913_cov_49.665848	136	155	150	2	19	0.1052632
NODE_8526_length_913_cov_49.665848	136	155	152	1	19	0.0526316
NODE_8526_length_913_cov_49.665848	136	155	153	1	19	0.0526316
NODE_8526_length_913_cov_49.665848	136	155	157	1	19	0.0526316
NODE_8526_length_913_cov_49.665848	136	155	160	2	19	0.1052632
NODE_8526_length_913_cov_49.665848	136	155	164	3	19	0.1578947
NODE_8526_length_913_cov_49.665848	136	155	166	1	19	0.0526316
NODE_8526_length_913_cov_49.665848	136	155	167	3	19	0.1578947
NODE_8526_length_913_cov_49.665848	136	155	169	1	19	0.0526316
NODE_8526_length_913_cov_49.665848	136	155	173	2	19	0.1052632
NODE_8527_length_913_cov_47.115479	367	447	0	40	80	0.5000000
NODE_8527_length_913_cov_47.115479	367	447	2	10	80	0.1250000
NODE_8527_length_913_cov_47.115479	367	447	3	5	80	0.0625000
NODE_8527_length_913_cov_47.115479	367	447	6	20	80	0.2500000
NODE_8527_length_913_cov_47.115479	367	447	8	5	80	0.0625000
NODE_8527_length_913_cov_47.115479	420	500	3	2	80	0.0250000
NODE_8527_length_913_cov_47.115479	420	500	6	20	80	0.2500000
NODE_8527_length_913_cov_47.115479	420	500	8	58	80	0.7250000
NODE_8528_length_913_cov_36.541769	502	582	0	80	80	1.0000000
NODE_8528_length_913_cov_36.541769	555	635	0	80	80	1.0000000
NODE_8529_length_913_cov_33.679361	433	513	0	59	80	0.7375000
NODE_8529_length_913_cov_33.679361	433	513	6	21	80	0.2625000
NODE_8529_length_913_cov_33.679361	486	566	0	6	80	0.0750000
NODE_8529_length_913_cov_33.679361	486	566	6	74	80	0.9250000
NODE_8530_length_913_cov_29.675676	408	488	0	80	80	1.0000000
NODE_8530_length_913_cov_29.675676	461	541	0	80	80	1.0000000
NODE_8531_length_913_cov_24.901720	342	422	0	80	80	1.0000000
NODE_8531_length_913_cov_24.901720	395	475	0	80	80	1.0000000
NODE_8532_length_913_cov_24.625307	396	476	27	61	80	0.7625000
NODE_8532_length_913_cov_24.625307	396	476	28	19	80	0.2375000
NODE_8532_length_913_cov_24.625307	449	529	11	13	80	0.1625000
NODE_8532_length_913_cov_24.625307	449	529	14	1	80	0.0125000
NODE_8532_length_913_cov_24.625307	449	529	15	11	80	0.1375000
NODE_8532_length_913_cov_24.625307	449	529	19	11	80	0.1375000
NODE_8532_length_913_cov_24.625307	449	529	20	1	80	0.0125000
NODE_8532_length_913_cov_24.625307	449	529	26	1	80	0.0125000
NODE_8532_length_913_cov_24.625307	449	529	27	24	80	0.3000000
NODE_8532_length_913_cov_24.625307	449	529	28	18	80	0.2250000
NODE_8533_length_913_cov_15.094595	525	589	0	64	64	1.0000000
NODE_8533_length_913_cov_15.094595	562	642	0	80	80	1.0000000
NODE_8534_length_913_cov_8.633907	305	385	0	8	80	0.1000000
NODE_8534_length_913_cov_8.633907	305	385	2	72	80	0.9000000
NODE_8534_length_913_cov_8.633907	358	429	0	18	71	0.2535211
NODE_8534_length_913_cov_8.633907	358	429	2	53	71	0.7464789
NODE_8546_length_912_cov_25.110701	419	499	0	80	80	1.0000000
NODE_8546_length_912_cov_25.110701	472	552	0	80	80	1.0000000
NODE_8547_length_912_cov_20.045510	306	386	0	80	80	1.0000000
NODE_8547_length_912_cov_20.045510	359	439	0	80	80	1.0000000
NODE_8548_length_912_cov_19.635916	326	406	0	80	80	1.0000000
NODE_8548_length_912_cov_19.635916	379	459	0	45	80	0.5625000
NODE_8548_length_912_cov_19.635916	379	459	2	35	80	0.4375000
NODE_8549_length_912_cov_17.714637	395	475	0	80	80	1.0000000
NODE_8549_length_912_cov_17.714637	448	528	0	80	80	1.0000000
NODE_8550_length_912_cov_15.546125	355	435	0	4	80	0.0500000
NODE_8550_length_912_cov_15.546125	355	435	2	26	80	0.3250000
NODE_8550_length_912_cov_15.546125	355	435	8	50	80	0.6250000
NODE_8550_length_912_cov_15.546125	408	488	6	24	80	0.3000000
NODE_8550_length_912_cov_15.546125	408	488	8	56	80	0.7000000
NODE_8551_length_912_cov_15.077491	255	291	2	29	36	0.8055556
NODE_8551_length_912_cov_15.077491	255	291	4	7	36	0.1944444
NODE_8551_length_912_cov_15.077491	264	328	2	33	64	0.5156250
NODE_8551_length_912_cov_15.077491	264	328	3	18	64	0.2812500
NODE_8551_length_912_cov_15.077491	264	328	4	13	64	0.2031250
NODE_8551_length_912_cov_15.077491	415	495	0	80	80	1.0000000
NODE_8551_length_912_cov_15.077491	468	548	0	80	80	1.0000000
NODE_8552_length_912_cov_15.023370	361	441	0	23	80	0.2875000
NODE_8552_length_912_cov_15.023370	361	441	6	57	80	0.7125000
NODE_8552_length_912_cov_15.023370	414	494	0	22	80	0.2750000
NODE_8552_length_912_cov_15.023370	414	494	6	58	80	0.7250000
NODE_8553_length_912_cov_13.600246	61	141	0	80	80	1.0000000
NODE_8553_length_912_cov_13.600246	460	540	2	80	80	1.0000000
NODE_8553_length_912_cov_13.600246	513	593	0	44	80	0.5500000
NODE_8553_length_912_cov_13.600246	513	593	2	36	80	0.4500000
NODE_8554_length_912_cov_13.113161	385	465	2	26	80	0.3250000
NODE_8554_length_912_cov_13.113161	385	465	4	14	80	0.1750000
NODE_8554_length_912_cov_13.113161	385	465	6	40	80	0.5000000
NODE_8554_length_912_cov_13.113161	438	518	4	67	80	0.8375000
NODE_8554_length_912_cov_13.113161	438	518	6	13	80	0.1625000
NODE_8555_length_912_cov_11.110701	353	433	0	80	80	1.0000000
NODE_8555_length_912_cov_11.110701	406	486	0	80	80	1.0000000
NODE_8555_length_912_cov_11.110701	827	907	0	1	80	0.0125000
NODE_8555_length_912_cov_11.110701	827	907	2	8	80	0.1000000
NODE_8555_length_912_cov_11.110701	827	907	6	71	80	0.8875000
NODE_8555_length_912_cov_11.110701	831	854	6	23	23	1.0000000
NODE_8584_length_911_cov_173.171182	580	660	776	3	80	0.0375000
NODE_8584_length_911_cov_173.171182	580	660	779	1	80	0.0125000
NODE_8584_length_911_cov_173.171182	580	660	782	1	80	0.0125000
NODE_8584_length_911_cov_173.171182	580	660	793	1	80	0.0125000
NODE_8584_length_911_cov_173.171182	580	660	810	1	80	0.0125000
NODE_8584_length_911_cov_173.171182	580	660	814	1	80	0.0125000
NODE_8584_length_911_cov_173.171182	580	660	816	1	80	0.0125000
NODE_8584_length_911_cov_173.171182	580	660	818	1	80	0.0125000
NODE_8584_length_911_cov_173.171182	580	660	827	1	80	0.0125000
NODE_8584_length_911_cov_173.171182	580	660	829	1	80	0.0125000
NODE_8584_length_911_cov_173.171182	580	660	835	1	80	0.0125000
NODE_8584_length_911_cov_173.171182	580	660	838	1	80	0.0125000
NODE_8584_length_911_cov_173.171182	580	660	843	1	80	0.0125000
NODE_8584_length_911_cov_173.171182	580	660	847	1	80	0.0125000
NODE_8584_length_911_cov_173.171182	580	660	851	2	80	0.0250000
NODE_8584_length_911_cov_173.171182	580	660	852	2	80	0.0250000
NODE_8584_length_911_cov_173.171182	580	660	853	1	80	0.0125000
NODE_8584_length_911_cov_173.171182	580	660	854	2	80	0.0250000
NODE_8584_length_911_cov_173.171182	580	660	857	1	80	0.0125000
NODE_8584_length_911_cov_173.171182	580	660	859	1	80	0.0125000
NODE_8584_length_911_cov_173.171182	580	660	869	1	80	0.0125000
NODE_8584_length_911_cov_173.171182	580	660	872	1	80	0.0125000
NODE_8584_length_911_cov_173.171182	580	660	874	1	80	0.0125000
NODE_8584_length_911_cov_173.171182	580	660	882	1	80	0.0125000
NODE_8584_length_911_cov_173.171182	580	660	889	1	80	0.0125000
NODE_8584_length_911_cov_173.171182	580	660	904	1	80	0.0125000
NODE_8584_length_911_cov_173.171182	580	660	908	1	80	0.0125000
NODE_8584_length_911_cov_173.171182	580	660	919	1	80	0.0125000
NODE_8584_length_911_cov_173.171182	580	660	929	1	80	0.0125000
NODE_8584_length_911_cov_173.171182	580	660	933	1	80	0.0125000
NODE_8584_length_911_cov_173.171182	580	660	938	1	80	0.0125000
NODE_8584_length_911_cov_173.171182	580	660	949	1	80	0.0125000
NODE_8584_length_911_cov_173.171182	580	660	950	1	80	0.0125000
NODE_8584_length_911_cov_173.171182	580	660	954	1	80	0.0125000
NODE_8584_length_911_cov_173.171182	580	660	955	2	80	0.0250000
NODE_8584_length_911_cov_173.171182	580	660	956	1	80	0.0125000
NODE_8584_length_911_cov_173.171182	580	660	957	1	80	0.0125000
NODE_8584_length_911_cov_173.171182	580	660	961	1	80	0.0125000
NODE_8584_length_911_cov_173.171182	580	660	962	1	80	0.0125000
NODE_8584_length_911_cov_173.171182	580	660	963	1	80	0.0125000
NODE_8584_length_911_cov_173.171182	580	660	977	2	80	0.0250000
NODE_8584_length_911_cov_173.171182	580	660	988	1	80	0.0125000
NODE_8584_length_911_cov_173.171182	580	660	997	1	80	0.0125000
NODE_8584_length_911_cov_173.171182	580	660	1007	1	80	0.0125000
NODE_8584_length_911_cov_173.171182	580	660	1012	1	80	0.0125000
NODE_8584_length_911_cov_173.171182	580	660	1013	1	80	0.0125000
NODE_8584_length_911_cov_173.171182	580	660	1025	1	80	0.0125000
NODE_8584_length_911_cov_173.171182	580	660	1040	1	80	0.0125000
NODE_8584_length_911_cov_173.171182	580	660	1050	1	80	0.0125000
NODE_8584_length_911_cov_173.171182	580	660	1061	1	80	0.0125000
NODE_8584_length_911_cov_173.171182	580	660	1065	1	80	0.0125000
NODE_8584_length_911_cov_173.171182	580	660	1069	1	80	0.0125000
NODE_8584_length_911_cov_173.171182	580	660	1079	1	80	0.0125000
NODE_8584_length_911_cov_173.171182	580	660	1080	1	80	0.0125000
NODE_8584_length_911_cov_173.171182	580	660	1086	1	80	0.0125000
NODE_8584_length_911_cov_173.171182	580	660	1091	1	80	0.0125000
NODE_8584_length_911_cov_173.171182	580	660	1098	1	80	0.0125000
NODE_8584_length_911_cov_173.171182	580	660	1099	1	80	0.0125000
NODE_8584_length_911_cov_173.171182	580	660	1104	1	80	0.0125000
NODE_8584_length_911_cov_173.171182	580	660	1105	2	80	0.0250000
NODE_8584_length_911_cov_173.171182	580	660	1106	1	80	0.0125000
NODE_8584_length_911_cov_173.171182	580	660	1107	1	80	0.0125000
NODE_8584_length_911_cov_173.171182	580	660	1112	1	80	0.0125000
NODE_8584_length_911_cov_173.171182	580	660	1115	1	80	0.0125000
NODE_8584_length_911_cov_173.171182	580	660	1120	1	80	0.0125000
NODE_8584_length_911_cov_173.171182	580	660	1129	1	80	0.0125000
NODE_8584_length_911_cov_173.171182	580	660	1137	1	80	0.0125000
NODE_8584_length_911_cov_173.171182	580	660	1151	1	80	0.0125000
NODE_8584_length_911_cov_173.171182	580	660	1154	2	80	0.0250000
NODE_8584_length_911_cov_173.171182	580	660	1176	1	80	0.0125000
NODE_8584_length_911_cov_173.171182	580	660	1187	1	80	0.0125000
NODE_8584_length_911_cov_173.171182	633	713	1025	1	80	0.0125000
NODE_8584_length_911_cov_173.171182	633	713	1040	1	80	0.0125000
NODE_8584_length_911_cov_173.171182	633	713	1050	1	80	0.0125000
NODE_8584_length_911_cov_173.171182	633	713	1061	1	80	0.0125000
NODE_8584_length_911_cov_173.171182	633	713	1065	1	80	0.0125000
NODE_8584_length_911_cov_173.171182	633	713	1069	1	80	0.0125000
NODE_8584_length_911_cov_173.171182	633	713	1079	1	80	0.0125000
NODE_8584_length_911_cov_173.171182	633	713	1080	1	80	0.0125000
NODE_8584_length_911_cov_173.171182	633	713	1086	1	80	0.0125000
NODE_8584_length_911_cov_173.171182	633	713	1091	1	80	0.0125000
NODE_8584_length_911_cov_173.171182	633	713	1098	1	80	0.0125000
NODE_8584_length_911_cov_173.171182	633	713	1099	1	80	0.0125000
NODE_8584_length_911_cov_173.171182	633	713	1104	1	80	0.0125000
NODE_8584_length_911_cov_173.171182	633	713	1105	2	80	0.0250000
NODE_8584_length_911_cov_173.171182	633	713	1106	1	80	0.0125000
NODE_8584_length_911_cov_173.171182	633	713	1107	1	80	0.0125000
NODE_8584_length_911_cov_173.171182	633	713	1112	1	80	0.0125000
NODE_8584_length_911_cov_173.171182	633	713	1115	1	80	0.0125000
NODE_8584_length_911_cov_173.171182	633	713	1120	1	80	0.0125000
NODE_8584_length_911_cov_173.171182	633	713	1129	1	80	0.0125000
NODE_8584_length_911_cov_173.171182	633	713	1137	1	80	0.0125000
NODE_8584_length_911_cov_173.171182	633	713	1151	1	80	0.0125000
NODE_8584_length_911_cov_173.171182	633	713	1154	2	80	0.0250000
NODE_8584_length_911_cov_173.171182	633	713	1176	1	80	0.0125000
NODE_8584_length_911_cov_173.171182	633	713	1184	1	80	0.0125000
NODE_8584_length_911_cov_173.171182	633	713	1187	1	80	0.0125000
NODE_8584_length_911_cov_173.171182	633	713	1191	1	80	0.0125000
NODE_8584_length_911_cov_173.171182	633	713	1194	2	80	0.0250000
NODE_8584_length_911_cov_173.171182	633	713	1195	2	80	0.0250000
NODE_8584_length_911_cov_173.171182	633	713	1196	2	80	0.0250000
NODE_8584_length_911_cov_173.171182	633	713	1199	1	80	0.0125000
NODE_8584_length_911_cov_173.171182	633	713	1200	3	80	0.0375000
NODE_8584_length_911_cov_173.171182	633	713	1202	2	80	0.0250000
NODE_8584_length_911_cov_173.171182	633	713	1203	1	80	0.0125000
NODE_8584_length_911_cov_173.171182	633	713	1206	3	80	0.0375000
NODE_8584_length_911_cov_173.171182	633	713	1210	1	80	0.0125000
NODE_8584_length_911_cov_173.171182	633	713	1216	3	80	0.0375000
NODE_8584_length_911_cov_173.171182	633	713	1218	1	80	0.0125000
NODE_8584_length_911_cov_173.171182	633	713	1219	1	80	0.0125000
NODE_8584_length_911_cov_173.171182	633	713	1221	2	80	0.0250000
NODE_8584_length_911_cov_173.171182	633	713	1222	1	80	0.0125000
NODE_8584_length_911_cov_173.171182	633	713	1223	2	80	0.0250000
NODE_8584_length_911_cov_173.171182	633	713	1224	2	80	0.0250000
NODE_8584_length_911_cov_173.171182	633	713	1225	2	80	0.0250000
NODE_8584_length_911_cov_173.171182	633	713	1226	1	80	0.0125000
NODE_8584_length_911_cov_173.171182	633	713	1227	2	80	0.0250000
NODE_8584_length_911_cov_173.171182	633	713	1229	2	80	0.0250000
NODE_8584_length_911_cov_173.171182	633	713	1230	1	80	0.0125000
NODE_8584_length_911_cov_173.171182	633	713	1231	1	80	0.0125000
NODE_8584_length_911_cov_173.171182	633	713	1238	1	80	0.0125000
NODE_8584_length_911_cov_173.171182	633	713	1239	1	80	0.0125000
NODE_8584_length_911_cov_173.171182	633	713	1297	1	80	0.0125000
NODE_8584_length_911_cov_173.171182	633	713	1307	1	80	0.0125000
NODE_8584_length_911_cov_173.171182	633	713	1329	1	80	0.0125000
NODE_8584_length_911_cov_173.171182	633	713	1337	1	80	0.0125000
NODE_8584_length_911_cov_173.171182	633	713	1365	1	80	0.0125000
NODE_8584_length_911_cov_173.171182	633	713	1375	1	80	0.0125000
NODE_8584_length_911_cov_173.171182	633	713	1386	1	80	0.0125000
NODE_8584_length_911_cov_173.171182	633	713	1393	1	80	0.0125000
NODE_8584_length_911_cov_173.171182	633	713	1404	1	80	0.0125000
NODE_8584_length_911_cov_173.171182	633	713	1413	1	80	0.0125000
NODE_8584_length_911_cov_173.171182	633	713	1432	1	80	0.0125000
NODE_8585_length_911_cov_88.250000	525	605	0	80	80	1.0000000
NODE_8585_length_911_cov_88.250000	578	658	0	80	80	1.0000000
NODE_8586_length_911_cov_46.854680	255	335	0	7	80	0.0875000
NODE_8586_length_911_cov_46.854680	255	335	1	23	80	0.2875000
NODE_8586_length_911_cov_46.854680	255	335	2	38	80	0.4750000
NODE_8586_length_911_cov_46.854680	255	335	3	12	80	0.1500000
NODE_8586_length_911_cov_46.854680	308	388	2	15	80	0.1875000
NODE_8586_length_911_cov_46.854680	308	388	3	65	80	0.8125000
NODE_8586_length_911_cov_46.854680	384	464	2	29	80	0.3625000
NODE_8586_length_911_cov_46.854680	384	464	3	48	80	0.6000000
NODE_8586_length_911_cov_46.854680	384	464	4	3	80	0.0375000
NODE_8586_length_911_cov_46.854680	437	517	1	44	80	0.5500000
NODE_8586_length_911_cov_46.854680	437	517	2	36	80	0.4500000
NODE_8587_length_911_cov_31.362069	301	381	0	45	80	0.5625000
NODE_8587_length_911_cov_31.362069	301	381	2	35	80	0.4375000
NODE_8587_length_911_cov_31.362069	354	434	0	11	80	0.1375000
NODE_8587_length_911_cov_31.362069	354	434	2	69	80	0.8625000
NODE_8588_length_911_cov_19.235222	445	525	0	80	80	1.0000000
NODE_8588_length_911_cov_19.235222	498	578	0	80	80	1.0000000
NODE_8589_length_911_cov_16.230296	233	313	0	80	80	1.0000000
NODE_8589_length_911_cov_16.230296	286	366	0	80	80	1.0000000
NODE_8590_length_911_cov_14.979064	472	552	0	78	80	0.9750000
NODE_8590_length_911_cov_14.979064	472	552	2	2	80	0.0250000
NODE_8590_length_911_cov_14.979064	525	605	0	80	80	1.0000000
NODE_8591_length_911_cov_12.089901	357	409	9	7	52	0.1346154
NODE_8591_length_911_cov_12.089901	357	409	10	6	52	0.1153846
NODE_8591_length_911_cov_12.089901	357	409	11	9	52	0.1730769
NODE_8591_length_911_cov_12.089901	357	409	13	4	52	0.0769231
NODE_8591_length_911_cov_12.089901	357	409	14	26	52	0.5000000
NODE_8591_length_911_cov_12.089901	401	462	6	20	61	0.3278688
NODE_8591_length_911_cov_12.089901	401	462	8	23	61	0.3770492
NODE_8591_length_911_cov_12.089901	401	462	10	16	61	0.2622951
NODE_8591_length_911_cov_12.089901	401	462	14	2	61	0.0327869
NODE_8606_length_910_cov_27.838471	347	427	0	44	80	0.5500000
NODE_8606_length_910_cov_27.838471	347	427	6	36	80	0.4500000
NODE_8606_length_910_cov_27.838471	400	480	6	80	80	1.0000000
NODE_8607_length_910_cov_25.895191	361	441	0	43	80	0.5375000
NODE_8607_length_910_cov_25.895191	361	441	2	37	80	0.4625000
NODE_8607_length_910_cov_25.895191	414	494	2	78	80	0.9750000
NODE_8607_length_910_cov_25.895191	414	494	5	2	80	0.0250000
NODE_8608_length_910_cov_25.604192	294	374	0	80	80	1.0000000
NODE_8608_length_910_cov_25.604192	347	427	0	80	80	1.0000000
NODE_8608_length_910_cov_25.604192	423	503	0	80	80	1.0000000
NODE_8608_length_910_cov_25.604192	476	556	0	80	80	1.0000000
NODE_8609_length_910_cov_16.066584	656	736	0	24	80	0.3000000
NODE_8609_length_910_cov_16.066584	656	736	4	56	80	0.7000000
NODE_8609_length_910_cov_16.066584	709	789	4	80	80	1.0000000
NODE_8610_length_910_cov_14.696671	417	497	0	16	80	0.2000000
NODE_8610_length_910_cov_14.696671	417	497	2	10	80	0.1250000
NODE_8610_length_910_cov_14.696671	417	497	6	14	80	0.1750000
NODE_8610_length_910_cov_14.696671	417	497	9	6	80	0.0750000
NODE_8610_length_910_cov_14.696671	417	497	10	4	80	0.0500000
NODE_8610_length_910_cov_14.696671	417	497	13	26	80	0.3250000
NODE_8610_length_910_cov_14.696671	417	497	14	4	80	0.0500000
NODE_8610_length_910_cov_14.696671	470	550	8	29	80	0.3625000
NODE_8610_length_910_cov_14.696671	470	550	12	23	80	0.2875000
NODE_8610_length_910_cov_14.696671	470	550	13	27	80	0.3375000
NODE_8610_length_910_cov_14.696671	470	550	14	1	80	0.0125000
NODE_8612_length_910_cov_7.114673	442	522	0	80	80	1.0000000
NODE_8612_length_910_cov_7.114673	495	575	0	80	80	1.0000000
NODE_8614_length_910_cov_2.992602	196	269	10	7	73	0.0958904
NODE_8614_length_910_cov_2.992602	196	269	12	3	73	0.0410959
NODE_8614_length_910_cov_2.992602	196	269	18	5	73	0.0684932
NODE_8614_length_910_cov_2.992602	196	269	24	2	73	0.0273973
NODE_8614_length_910_cov_2.992602	196	269	26	2	73	0.0273973
NODE_8614_length_910_cov_2.992602	196	269	27	4	73	0.0547945
NODE_8614_length_910_cov_2.992602	196	269	29	2	73	0.0273973
NODE_8614_length_910_cov_2.992602	196	269	31	3	73	0.0410959
NODE_8614_length_910_cov_2.992602	196	269	33	4	73	0.0547945
NODE_8614_length_910_cov_2.992602	196	269	36	3	73	0.0410959
NODE_8614_length_910_cov_2.992602	196	269	37	4	73	0.0547945
NODE_8614_length_910_cov_2.992602	196	269	39	1	73	0.0136986
NODE_8614_length_910_cov_2.992602	196	269	41	2	73	0.0273973
NODE_8614_length_910_cov_2.992602	196	269	47	2	73	0.0273973
NODE_8614_length_910_cov_2.992602	196	269	49	2	73	0.0273973
NODE_8614_length_910_cov_2.992602	196	269	52	1	73	0.0136986
NODE_8614_length_910_cov_2.992602	196	269	55	3	73	0.0410959
NODE_8614_length_910_cov_2.992602	196	269	60	6	73	0.0821918
NODE_8614_length_910_cov_2.992602	196	269	61	12	73	0.1643836
NODE_8614_length_910_cov_2.992602	196	269	71	3	73	0.0410959
NODE_8614_length_910_cov_2.992602	196	269	74	1	73	0.0136986
NODE_8614_length_910_cov_2.992602	196	269	75	1	73	0.0136986
NODE_8614_length_910_cov_2.992602	249	329	60	3	80	0.0375000
NODE_8614_length_910_cov_2.992602	249	329	61	12	80	0.1500000
NODE_8614_length_910_cov_2.992602	249	329	71	3	80	0.0375000
NODE_8614_length_910_cov_2.992602	249	329	74	1	80	0.0125000
NODE_8614_length_910_cov_2.992602	249	329	75	1	80	0.0125000
NODE_8614_length_910_cov_2.992602	249	329	77	15	80	0.1875000
NODE_8614_length_910_cov_2.992602	249	329	78	5	80	0.0625000
NODE_8614_length_910_cov_2.992602	249	329	80	5	80	0.0625000
NODE_8614_length_910_cov_2.992602	249	329	82	3	80	0.0375000
NODE_8614_length_910_cov_2.992602	249	329	83	2	80	0.0250000
NODE_8614_length_910_cov_2.992602	249	329	85	3	80	0.0375000
NODE_8614_length_910_cov_2.992602	249	329	86	6	80	0.0750000
NODE_8614_length_910_cov_2.992602	249	329	87	10	80	0.1250000
NODE_8614_length_910_cov_2.992602	249	329	88	1	80	0.0125000
NODE_8614_length_910_cov_2.992602	249	329	89	2	80	0.0250000
NODE_8614_length_910_cov_2.992602	249	329	90	3	80	0.0375000
NODE_8614_length_910_cov_2.992602	249	329	91	5	80	0.0625000
NODE_8614_length_910_cov_2.992602	386	439	15	2	53	0.0377358
NODE_8614_length_910_cov_2.992602	386	439	18	3	53	0.0566038
NODE_8614_length_910_cov_2.992602	386	439	19	6	53	0.1132075
NODE_8614_length_910_cov_2.992602	386	439	23	6	53	0.1132075
NODE_8614_length_910_cov_2.992602	386	439	25	16	53	0.3018868
NODE_8614_length_910_cov_2.992602	386	439	31	4	53	0.0754717
NODE_8614_length_910_cov_2.992602	386	439	32	5	53	0.0943396
NODE_8614_length_910_cov_2.992602	386	439	35	3	53	0.0566038
NODE_8614_length_910_cov_2.992602	386	439	39	1	53	0.0188679
NODE_8614_length_910_cov_2.992602	386	439	40	1	53	0.0188679
NODE_8614_length_910_cov_2.992602	386	439	42	1	53	0.0188679
NODE_8614_length_910_cov_2.992602	386	439	43	3	53	0.0566038
NODE_8614_length_910_cov_2.992602	386	439	50	1	53	0.0188679
NODE_8614_length_910_cov_2.992602	386	439	51	1	53	0.0188679
NODE_8623_length_909_cov_35.291358	426	506	0	17	80	0.2125000
NODE_8623_length_909_cov_35.291358	426	506	2	37	80	0.4625000
NODE_8623_length_909_cov_35.291358	426	506	12	4	80	0.0500000
NODE_8623_length_909_cov_35.291358	426	506	20	22	80	0.2750000
NODE_8623_length_909_cov_35.291358	479	559	2	1	80	0.0125000
NODE_8623_length_909_cov_35.291358	479	559	12	4	80	0.0500000
NODE_8623_length_909_cov_35.291358	479	559	17	1	80	0.0125000
NODE_8623_length_909_cov_35.291358	479	559	18	26	80	0.3250000
NODE_8623_length_909_cov_35.291358	479	559	20	48	80	0.6000000
NODE_8624_length_909_cov_27.449383	311	391	0	79	80	0.9875000
NODE_8624_length_909_cov_27.449383	311	391	4	1	80	0.0125000
NODE_8624_length_909_cov_27.449383	364	444	0	26	80	0.3250000
NODE_8624_length_909_cov_27.449383	364	444	4	54	80	0.6750000
NODE_8625_length_909_cov_25.212346	295	375	0	17	80	0.2125000
NODE_8625_length_909_cov_25.212346	295	375	2	63	80	0.7875000
NODE_8625_length_909_cov_25.212346	348	428	2	80	80	1.0000000
NODE_8626_length_909_cov_23.604938	403	483	2	49	80	0.6125000
NODE_8626_length_909_cov_23.604938	403	483	4	21	80	0.2625000
NODE_8626_length_909_cov_23.604938	403	483	6	10	80	0.1250000
NODE_8626_length_909_cov_23.604938	456	536	2	80	80	1.0000000
NODE_8627_length_909_cov_19.070370	441	521	0	8	80	0.1000000
NODE_8627_length_909_cov_19.070370	441	521	2	10	80	0.1250000
NODE_8627_length_909_cov_19.070370	441	521	4	12	80	0.1500000
NODE_8627_length_909_cov_19.070370	441	521	6	26	80	0.3250000
NODE_8627_length_909_cov_19.070370	441	521	8	24	80	0.3000000
NODE_8627_length_909_cov_19.070370	494	574	6	12	80	0.1500000
NODE_8627_length_909_cov_19.070370	494	574	8	68	80	0.8500000
NODE_8628_length_909_cov_11.533333	332	412	0	32	80	0.4000000
NODE_8628_length_909_cov_11.533333	332	412	2	48	80	0.6000000
NODE_8628_length_909_cov_11.533333	385	465	2	80	80	1.0000000
NODE_8629_length_909_cov_10.229630	497	577	0	80	80	1.0000000
NODE_8629_length_909_cov_10.229630	550	622	0	72	72	1.0000000
NODE_8631_length_909_cov_7.122222	328	408	0	29	80	0.3625000
NODE_8631_length_909_cov_7.122222	328	408	4	51	80	0.6375000
NODE_8631_length_909_cov_7.122222	381	461	4	80	80	1.0000000
NODE_8632_length_909_cov_4.664198	775	855	6	15	80	0.1875000
NODE_8632_length_909_cov_4.664198	775	855	8	14	80	0.1750000
NODE_8632_length_909_cov_4.664198	775	855	9	9	80	0.1125000
NODE_8632_length_909_cov_4.664198	775	855	13	1	80	0.0125000
NODE_8632_length_909_cov_4.664198	775	855	15	11	80	0.1375000
NODE_8632_length_909_cov_4.664198	775	855	16	2	80	0.0250000
NODE_8632_length_909_cov_4.664198	775	855	18	8	80	0.1000000
NODE_8632_length_909_cov_4.664198	775	855	20	19	80	0.2375000
NODE_8632_length_909_cov_4.664198	775	855	21	1	80	0.0125000
NODE_8632_length_909_cov_4.664198	828	885	0	15	57	0.2631579
NODE_8632_length_909_cov_4.664198	828	885	2	11	57	0.1929825
NODE_8632_length_909_cov_4.664198	828	885	6	19	57	0.3333333
NODE_8632_length_909_cov_4.664198	828	885	8	12	57	0.2105263
NODE_8644_length_908_cov_55.546354	409	489	0	12	80	0.1500000
NODE_8644_length_908_cov_55.546354	409	489	2	19	80	0.2375000
NODE_8644_length_908_cov_55.546354	409	489	4	16	80	0.2000000
NODE_8644_length_908_cov_55.546354	409	489	6	33	80	0.4125000
NODE_8644_length_908_cov_55.546354	462	542	0	65	80	0.8125000
NODE_8644_length_908_cov_55.546354	462	542	2	15	80	0.1875000
NODE_8645_length_908_cov_18.720643	329	409	0	22	80	0.2750000
NODE_8645_length_908_cov_18.720643	329	409	2	58	80	0.7250000
NODE_8645_length_908_cov_18.720643	382	462	0	27	80	0.3375000
NODE_8645_length_908_cov_18.720643	382	462	2	53	80	0.6625000
NODE_8646_length_908_cov_14.640297	430	510	0	56	80	0.7000000
NODE_8646_length_908_cov_14.640297	430	510	2	24	80	0.3000000
NODE_8646_length_908_cov_14.640297	483	562	0	3	79	0.0379747
NODE_8646_length_908_cov_14.640297	483	562	2	27	79	0.3417721
NODE_8646_length_908_cov_14.640297	483	562	4	49	79	0.6202531
NODE_8648_length_908_cov_10.789864	370	450	0	74	80	0.9250000
NODE_8648_length_908_cov_10.789864	370	450	2	6	80	0.0750000
NODE_8648_length_908_cov_10.789864	423	503	0	21	80	0.2625000
NODE_8648_length_908_cov_10.789864	423	503	2	59	80	0.7375000
NODE_8651_length_908_cov_3.737948	251	331	0	80	80	1.0000000
NODE_8651_length_908_cov_3.737948	304	384	0	80	80	1.0000000
NODE_8664_length_907_cov_22.110149	459	539	0	80	80	1.0000000
NODE_8664_length_907_cov_22.110149	512	592	0	80	80	1.0000000
NODE_8665_length_907_cov_20.943069	410	490	0	80	80	1.0000000
NODE_8665_length_907_cov_20.943069	463	543	0	80	80	1.0000000
NODE_8666_length_907_cov_19.519802	411	488	0	77	77	1.0000000
NODE_8666_length_907_cov_19.519802	461	541	0	80	80	1.0000000
NODE_8667_length_907_cov_17.928218	329	405	0	39	76	0.5131579
NODE_8667_length_907_cov_17.928218	329	405	6	37	76	0.4868421
NODE_8667_length_907_cov_17.928218	382	462	0	80	80	1.0000000
NODE_8668_length_907_cov_13.060644	293	373	0	80	80	1.0000000
NODE_8668_length_907_cov_13.060644	346	426	0	80	80	1.0000000
NODE_8669_length_907_cov_11.155941	401	462	4	61	61	1.0000000
NODE_8669_length_907_cov_11.155941	607	687	8	80	80	1.0000000
NODE_8670_length_907_cov_9.237624	247	327	0	9	80	0.1125000
NODE_8670_length_907_cov_9.237624	247	327	2	23	80	0.2875000
NODE_8670_length_907_cov_9.237624	247	327	3	1	80	0.0125000
NODE_8670_length_907_cov_9.237624	247	327	4	47	80	0.5875000
NODE_8670_length_907_cov_9.237624	300	380	4	80	80	1.0000000
NODE_8671_length_907_cov_8.686881	275	365	0	90	90	1.0000000
NODE_8671_length_907_cov_8.686881	338	418	0	80	80	1.0000000
NODE_8680_length_907_cov_2.949257	503	526	0	23	23	1.0000000
NODE_8686_length_906_cov_32.369269	447	527	2	80	80	1.0000000
NODE_8686_length_906_cov_32.369269	500	580	0	50	80	0.6250000
NODE_8686_length_906_cov_32.369269	500	580	2	30	80	0.3750000
NODE_8687_length_906_cov_23.594796	196	276	0	79	80	0.9875000
NODE_8687_length_906_cov_23.594796	196	276	2	1	80	0.0125000
NODE_8687_length_906_cov_23.594796	249	329	0	26	80	0.3250000
NODE_8687_length_906_cov_23.594796	249	329	2	54	80	0.6750000
NODE_8688_length_906_cov_21.443618	404	484	0	80	80	1.0000000
NODE_8688_length_906_cov_21.443618	457	537	0	80	80	1.0000000
NODE_8689_length_906_cov_20.596035	593	634	0	10	41	0.2439024
NODE_8689_length_906_cov_20.596035	593	634	1	2	41	0.0487805
NODE_8689_length_906_cov_20.596035	593	634	2	29	41	0.7073171
NODE_8690_length_906_cov_20.429988	410	490	2	42	80	0.5250000
NODE_8690_length_906_cov_20.429988	410	490	4	10	80	0.1250000
NODE_8690_length_906_cov_20.429988	410	490	6	28	80	0.3500000
NODE_8690_length_906_cov_20.429988	463	543	2	26	80	0.3250000
NODE_8690_length_906_cov_20.429988	463	543	4	28	80	0.3500000
NODE_8690_length_906_cov_20.429988	463	543	6	26	80	0.3250000
NODE_8691_length_906_cov_20.395291	523	603	0	80	80	1.0000000
NODE_8691_length_906_cov_20.395291	576	656	0	80	80	1.0000000
NODE_8692_length_906_cov_19.297398	255	335	0	80	80	1.0000000
NODE_8692_length_906_cov_19.297398	308	388	0	80	80	1.0000000
NODE_8693_length_906_cov_18.505576	357	437	0	80	80	1.0000000
NODE_8693_length_906_cov_18.505576	410	490	0	80	80	1.0000000
NODE_8694_length_906_cov_10.068154	191	271	0	80	80	1.0000000
NODE_8694_length_906_cov_10.068154	244	324	0	80	80	1.0000000
NODE_8695_length_906_cov_10.006196	304	384	0	80	80	1.0000000
NODE_8695_length_906_cov_10.006196	357	437	0	80	80	1.0000000
NODE_8696_length_906_cov_8.562577	370	454	0	84	84	1.0000000
NODE_8696_length_906_cov_8.562577	423	507	0	84	84	1.0000000
NODE_8716_length_905_cov_39.203474	406	486	0	80	80	1.0000000
NODE_8716_length_905_cov_39.203474	459	539	0	80	80	1.0000000
NODE_8717_length_905_cov_37.053350	411	491	0	80	80	1.0000000
NODE_8717_length_905_cov_37.053350	464	544	0	80	80	1.0000000
NODE_8718_length_905_cov_27.426799	288	368	0	39	80	0.4875000
NODE_8718_length_905_cov_27.426799	288	368	8	5	80	0.0625000
NODE_8718_length_905_cov_27.426799	288	368	15	1	80	0.0125000
NODE_8718_length_905_cov_27.426799	288	368	16	35	80	0.4375000
NODE_8718_length_905_cov_27.426799	341	421	16	80	80	1.0000000
NODE_8719_length_905_cov_26.332506	375	455	0	52	80	0.6500000
NODE_8719_length_905_cov_26.332506	375	455	2	28	80	0.3500000
NODE_8719_length_905_cov_26.332506	428	508	0	80	80	1.0000000
NODE_8720_length_905_cov_20.651365	377	457	0	80	80	1.0000000
NODE_8720_length_905_cov_20.651365	430	510	0	80	80	1.0000000
NODE_8721_length_905_cov_19.718362	365	445	0	20	80	0.2500000
NODE_8721_length_905_cov_19.718362	365	445	2	60	80	0.7500000
NODE_8721_length_905_cov_19.718362	418	498	0	73	80	0.9125000
NODE_8721_length_905_cov_19.718362	418	498	2	7	80	0.0875000
NODE_8722_length_905_cov_13.696030	366	420	0	54	54	1.0000000
NODE_8723_length_905_cov_9.978908	222	302	0	80	80	1.0000000
NODE_8723_length_905_cov_9.978908	275	355	0	80	80	1.0000000
NODE_8725_length_905_cov_7.980149	321	401	0	80	80	1.0000000
NODE_8725_length_905_cov_7.980149	374	454	0	80	80	1.0000000
NODE_8727_length_905_cov_6.064516	459	539	0	80	80	1.0000000
NODE_8727_length_905_cov_6.064516	512	592	0	52	80	0.6500000
NODE_8727_length_905_cov_6.064516	512	592	2	28	80	0.3500000
NODE_8742_length_905_cov_1.040943	73	119	36	16	46	0.3478261
NODE_8742_length_905_cov_1.040943	73	119	38	30	46	0.6521739
NODE_8742_length_905_cov_1.040943	126	172	5	2	46	0.0434783
NODE_8742_length_905_cov_1.040943	126	172	7	1	46	0.0217391
NODE_8742_length_905_cov_1.040943	126	172	10	3	46	0.0652174
NODE_8742_length_905_cov_1.040943	126	172	12	6	46	0.1304348
NODE_8742_length_905_cov_1.040943	126	172	14	2	46	0.0434783
NODE_8742_length_905_cov_1.040943	126	172	20	2	46	0.0434783
NODE_8742_length_905_cov_1.040943	126	172	21	2	46	0.0434783
NODE_8742_length_905_cov_1.040943	126	172	24	5	46	0.1086956
NODE_8742_length_905_cov_1.040943	126	172	28	4	46	0.0869565
NODE_8742_length_905_cov_1.040943	126	172	32	4	46	0.0869565
NODE_8742_length_905_cov_1.040943	126	172	34	1	46	0.0217391
NODE_8742_length_905_cov_1.040943	126	172	36	14	46	0.3043478
NODE_8743_length_904_cov_29.532919	338	418	0	29	80	0.3625000
NODE_8743_length_904_cov_29.532919	338	418	2	8	80	0.1000000
NODE_8743_length_904_cov_29.532919	338	418	4	43	80	0.5375000
NODE_8743_length_904_cov_29.532919	391	471	0	22	80	0.2750000
NODE_8743_length_904_cov_29.532919	391	471	2	9	80	0.1125000
NODE_8743_length_904_cov_29.532919	391	471	4	49	80	0.6125000
NODE_8743_length_904_cov_29.532919	467	547	0	7	80	0.0875000
NODE_8743_length_904_cov_29.532919	467	547	2	73	80	0.9125000
NODE_8743_length_904_cov_29.532919	520	600	0	47	80	0.5875000
NODE_8743_length_904_cov_29.532919	520	600	2	33	80	0.4125000
NODE_8744_length_904_cov_28.844720	371	451	0	80	80	1.0000000
NODE_8744_length_904_cov_28.844720	424	504	0	80	80	1.0000000
NODE_8745_length_904_cov_26.977640	488	568	0	80	80	1.0000000
NODE_8745_length_904_cov_26.977640	541	621	0	80	80	1.0000000
NODE_8746_length_904_cov_24.529193	464	544	0	80	80	1.0000000
NODE_8746_length_904_cov_24.529193	517	597	0	80	80	1.0000000
NODE_8747_length_904_cov_24.452174	507	587	0	42	80	0.5250000
NODE_8747_length_904_cov_24.452174	507	587	2	38	80	0.4750000
NODE_8747_length_904_cov_24.452174	560	640	0	80	80	1.0000000
NODE_8748_length_904_cov_19.649689	307	387	0	80	80	1.0000000
NODE_8748_length_904_cov_19.649689	360	440	0	80	80	1.0000000
NODE_8748_length_904_cov_19.649689	595	675	0	80	80	1.0000000
NODE_8748_length_904_cov_19.649689	648	728	0	80	80	1.0000000
NODE_8750_length_904_cov_16.608696	252	332	0	49	80	0.6125000
NODE_8750_length_904_cov_16.608696	252	332	2	31	80	0.3875000
NODE_8750_length_904_cov_16.608696	305	385	0	15	80	0.1875000
NODE_8750_length_904_cov_16.608696	305	385	2	65	80	0.8125000
NODE_8750_length_904_cov_16.608696	381	461	0	16	80	0.2000000
NODE_8750_length_904_cov_16.608696	381	461	5	11	80	0.1375000
NODE_8750_length_904_cov_16.608696	381	461	6	53	80	0.6625000
NODE_8750_length_904_cov_16.608696	434	514	5	9	80	0.1125000
NODE_8750_length_904_cov_16.608696	434	514	6	71	80	0.8875000
NODE_8751_length_904_cov_15.811180	431	511	0	51	80	0.6375000
NODE_8751_length_904_cov_15.811180	431	511	4	29	80	0.3625000
NODE_8751_length_904_cov_15.811180	484	564	4	80	80	1.0000000
NODE_8752_length_904_cov_9.249689	581	661	0	80	80	1.0000000
NODE_8752_length_904_cov_9.249689	634	714	0	80	80	1.0000000
NODE_8756_length_904_cov_4.772671	318	398	0	80	80	1.0000000
NODE_8756_length_904_cov_4.772671	371	451	0	80	80	1.0000000
NODE_8773_length_903_cov_58.723881	386	466	9	1	80	0.0125000
NODE_8773_length_903_cov_58.723881	386	466	13	18	80	0.2250000
NODE_8773_length_903_cov_58.723881	386	466	16	2	80	0.0250000
NODE_8773_length_903_cov_58.723881	386	466	18	31	80	0.3875000
NODE_8773_length_903_cov_58.723881	386	466	19	4	80	0.0500000
NODE_8773_length_903_cov_58.723881	386	466	20	16	80	0.2000000
NODE_8773_length_903_cov_58.723881	386	466	23	8	80	0.1000000
NODE_8773_length_903_cov_58.723881	439	519	10	2	80	0.0250000
NODE_8773_length_903_cov_58.723881	439	519	14	14	80	0.1750000
NODE_8773_length_903_cov_58.723881	439	519	16	2	80	0.0250000
NODE_8773_length_903_cov_58.723881	439	519	18	50	80	0.6250000
NODE_8773_length_903_cov_58.723881	439	519	19	1	80	0.0125000
NODE_8773_length_903_cov_58.723881	439	519	20	11	80	0.1375000
NODE_8773_length_903_cov_58.723881	515	595	0	33	80	0.4125000
NODE_8773_length_903_cov_58.723881	515	595	2	11	80	0.1375000
NODE_8773_length_903_cov_58.723881	515	595	4	27	80	0.3375000
NODE_8773_length_903_cov_58.723881	515	595	10	7	80	0.0875000
NODE_8773_length_903_cov_58.723881	515	595	14	2	80	0.0250000
NODE_8773_length_903_cov_58.723881	568	648	0	80	80	1.0000000
NODE_8774_length_903_cov_41.298507	397	477	0	80	80	1.0000000
NODE_8774_length_903_cov_41.298507	450	530	0	80	80	1.0000000
NODE_8775_length_903_cov_28.691542	394	474	4	48	80	0.6000000
NODE_8775_length_903_cov_28.691542	394	474	10	3	80	0.0375000
NODE_8775_length_903_cov_28.691542	394	474	14	29	80	0.3625000
NODE_8775_length_903_cov_28.691542	447	527	8	14	80	0.1750000
NODE_8775_length_903_cov_28.691542	447	527	10	42	80	0.5250000
NODE_8775_length_903_cov_28.691542	447	527	14	24	80	0.3000000
NODE_8776_length_903_cov_26.276119	441	521	0	80	80	1.0000000
NODE_8776_length_903_cov_26.276119	494	574	0	30	80	0.3750000
NODE_8776_length_903_cov_26.276119	494	574	2	50	80	0.6250000
NODE_8778_length_903_cov_18.166667	351	431	0	80	80	1.0000000
NODE_8778_length_903_cov_18.166667	404	484	0	80	80	1.0000000
NODE_8779_length_903_cov_15.460199	440	520	0	12	80	0.1500000
NODE_8779_length_903_cov_15.460199	440	520	4	68	80	0.8500000
NODE_8779_length_903_cov_15.460199	493	573	0	4	80	0.0500000
NODE_8779_length_903_cov_15.460199	493	573	4	76	80	0.9500000
NODE_8780_length_903_cov_15.084577	352	432	2	80	80	1.0000000
NODE_8780_length_903_cov_15.084577	405	485	0	5	80	0.0625000
NODE_8780_length_903_cov_15.084577	405	485	2	75	80	0.9375000
NODE_8781_length_903_cov_15.070896	367	447	0	16	80	0.2000000
NODE_8781_length_903_cov_15.070896	367	447	2	5	80	0.0625000
NODE_8781_length_903_cov_15.070896	367	447	6	59	80	0.7375000
NODE_8781_length_903_cov_15.070896	420	500	0	6	80	0.0750000
NODE_8781_length_903_cov_15.070896	420	500	2	27	80	0.3375000
NODE_8781_length_903_cov_15.070896	420	500	6	47	80	0.5875000
NODE_8782_length_903_cov_14.004975	318	399	0	5	81	0.0617284
NODE_8782_length_903_cov_14.004975	318	399	5	76	81	0.9382716
NODE_8782_length_903_cov_14.004975	372	452	0	7	80	0.0875000
NODE_8782_length_903_cov_14.004975	372	452	5	31	80	0.3875000
NODE_8782_length_903_cov_14.004975	372	452	6	42	80	0.5250000
NODE_8783_length_903_cov_10.546020	150	230	0	80	80	1.0000000
NODE_8783_length_903_cov_10.546020	203	283	0	80	80	1.0000000
NODE_8784_length_903_cov_9.288557	373	453	0	80	80	1.0000000
NODE_8784_length_903_cov_9.288557	426	506	0	80	80	1.0000000
NODE_8785_length_903_cov_8.052239	439	519	0	80	80	1.0000000
NODE_8785_length_903_cov_8.052239	492	572	0	80	80	1.0000000
NODE_8798_length_902_cov_64.459527	355	435	0	80	80	1.0000000
NODE_8798_length_902_cov_64.459527	408	488	0	80	80	1.0000000
NODE_8798_length_902_cov_64.459527	484	564	0	80	80	1.0000000
NODE_8798_length_902_cov_64.459527	537	617	0	80	80	1.0000000
NODE_8799_length_902_cov_60.823163	395	475	0	39	80	0.4875000
NODE_8799_length_902_cov_60.823163	395	475	2	41	80	0.5125000
NODE_8799_length_902_cov_60.823163	448	528	0	21	80	0.2625000
NODE_8799_length_902_cov_60.823163	448	528	2	59	80	0.7375000
NODE_8800_length_902_cov_44.002491	383	463	0	80	80	1.0000000
NODE_8800_length_902_cov_44.002491	436	516	0	80	80	1.0000000
NODE_8801_length_902_cov_41.059776	378	458	1	58	80	0.7250000
NODE_8801_length_902_cov_41.059776	378	458	3	10	80	0.1250000
NODE_8801_length_902_cov_41.059776	378	458	4	12	80	0.1500000
NODE_8801_length_902_cov_41.059776	431	511	1	5	80	0.0625000
NODE_8801_length_902_cov_41.059776	431	511	2	5	80	0.0625000
NODE_8801_length_902_cov_41.059776	431	511	3	10	80	0.1250000
NODE_8801_length_902_cov_41.059776	431	511	4	60	80	0.7500000
NODE_8802_length_902_cov_38.952677	372	452	0	71	80	0.8875000
NODE_8802_length_902_cov_38.952677	372	452	2	9	80	0.1125000
NODE_8802_length_902_cov_38.952677	425	505	0	80	80	1.0000000
NODE_8803_length_902_cov_34.156912	373	453	0	80	80	1.0000000
NODE_8803_length_902_cov_34.156912	426	506	0	80	80	1.0000000
NODE_8804_length_902_cov_23.007472	295	375	0	80	80	1.0000000
NODE_8804_length_902_cov_23.007472	348	428	0	80	80	1.0000000
NODE_8805_length_902_cov_19.491905	238	291	0	47	53	0.8867925
NODE_8805_length_902_cov_19.491905	238	291	2	6	53	0.1132075
NODE_8805_length_902_cov_19.491905	264	344	0	21	80	0.2625000
NODE_8805_length_902_cov_19.491905	264	344	2	59	80	0.7375000
NODE_8806_length_902_cov_10.794521	214	294	0	50	80	0.6250000
NODE_8806_length_902_cov_10.794521	214	294	2	30	80	0.3750000
NODE_8806_length_902_cov_10.794521	267	347	2	80	80	1.0000000
NODE_8807_length_902_cov_9.520548	518	598	0	80	80	1.0000000
NODE_8807_length_902_cov_9.520548	571	651	0	80	80	1.0000000
NODE_8808_length_902_cov_8.323786	337	417	0	80	80	1.0000000
NODE_8808_length_902_cov_8.323786	390	470	0	80	80	1.0000000
NODE_8811_length_902_cov_7.300125	434	514	0	3	80	0.0375000
NODE_8811_length_902_cov_7.300125	434	514	2	77	80	0.9625000
NODE_8811_length_902_cov_7.300125	487	567	0	56	80	0.7000000
NODE_8811_length_902_cov_7.300125	487	567	2	24	80	0.3000000
NODE_8812_length_902_cov_4.185554	505	585	0	80	80	1.0000000
NODE_8812_length_902_cov_4.185554	558	588	0	30	30	1.0000000
NODE_8812_length_902_cov_4.185554	610	662	0	52	52	1.0000000
NODE_8830_length_902_cov_0.963885	82	106	0	24	24	1.0000000
NODE_8832_length_901_cov_36.066085	412	490	0	78	78	1.0000000
NODE_8832_length_901_cov_36.066085	463	543	0	80	80	1.0000000
NODE_8833_length_901_cov_28.129676	377	457	0	33	80	0.4125000
NODE_8833_length_901_cov_28.129676	377	457	2	47	80	0.5875000
NODE_8833_length_901_cov_28.129676	430	510	0	7	80	0.0875000
NODE_8833_length_901_cov_28.129676	430	510	2	21	80	0.2625000
NODE_8833_length_901_cov_28.129676	430	510	8	7	80	0.0875000
NODE_8833_length_901_cov_28.129676	430	510	10	45	80	0.5625000
NODE_8834_length_901_cov_26.763092	272	352	0	80	80	1.0000000
NODE_8834_length_901_cov_26.763092	325	405	0	80	80	1.0000000
NODE_8834_length_901_cov_26.763092	401	481	0	80	80	1.0000000
NODE_8834_length_901_cov_26.763092	454	534	0	80	80	1.0000000
NODE_8835_length_901_cov_25.628429	369	449	0	80	80	1.0000000
NODE_8835_length_901_cov_25.628429	422	502	0	80	80	1.0000000
NODE_8836_length_901_cov_17.857855	408	488	0	80	80	1.0000000
NODE_8836_length_901_cov_17.857855	461	541	0	80	80	1.0000000
NODE_8837_length_901_cov_16.254364	362	442	0	16	80	0.2000000
NODE_8837_length_901_cov_16.254364	362	442	2	64	80	0.8000000
NODE_8837_length_901_cov_16.254364	415	495	0	42	80	0.5250000
NODE_8837_length_901_cov_16.254364	415	495	2	38	80	0.4750000
NODE_8838_length_901_cov_8.346633	321	401	0	80	80	1.0000000
NODE_8838_length_901_cov_8.346633	374	454	0	80	80	1.0000000
NODE_8840_length_901_cov_6.044888	363	443	4	22	80	0.2750000
NODE_8840_length_901_cov_6.044888	363	443	6	58	80	0.7250000
NODE_8840_length_901_cov_6.044888	416	496	2	2	80	0.0250000
NODE_8840_length_901_cov_6.044888	416	496	4	73	80	0.9125000
NODE_8840_length_901_cov_6.044888	416	496	6	5	80	0.0625000
NODE_8845_length_901_cov_3.814214	194	274	0	80	80	1.0000000
NODE_8845_length_901_cov_3.814214	247	326	0	79	79	1.0000000
NODE_8857_length_900_cov_30.284644	407	487	0	80	80	1.0000000
NODE_8857_length_900_cov_30.284644	460	540	0	80	80	1.0000000
NODE_8858_length_900_cov_29.679151	425	505	0	80	80	1.0000000
NODE_8858_length_900_cov_29.679151	478	558	0	67	80	0.8375000
NODE_8858_length_900_cov_29.679151	478	558	2	13	80	0.1625000
NODE_8859_length_900_cov_25.963795	321	401	0	45	80	0.5625000
NODE_8859_length_900_cov_25.963795	321	401	4	35	80	0.4375000
NODE_8859_length_900_cov_25.963795	374	454	4	80	80	1.0000000
NODE_8860_length_900_cov_17.681648	530	606	0	74	76	0.9736842
NODE_8860_length_900_cov_17.681648	530	606	2	2	76	0.0263158
NODE_8860_length_900_cov_17.681648	583	659	0	21	76	0.2763158
NODE_8860_length_900_cov_17.681648	583	659	2	55	76	0.7236842
NODE_8861_length_900_cov_16.294632	316	396	0	80	80	1.0000000
NODE_8861_length_900_cov_16.294632	369	449	0	80	80	1.0000000
NODE_8863_length_900_cov_5.962547	0	70	10	2	70	0.0285714
NODE_8863_length_900_cov_5.962547	0	70	14	2	70	0.0285714
NODE_8863_length_900_cov_5.962547	0	70	20	1	70	0.0142857
NODE_8863_length_900_cov_5.962547	0	70	30	2	70	0.0285714
NODE_8863_length_900_cov_5.962547	0	70	32	2	70	0.0285714
NODE_8863_length_900_cov_5.962547	0	70	36	14	70	0.2000000
NODE_8863_length_900_cov_5.962547	0	70	38	14	70	0.2000000
NODE_8863_length_900_cov_5.962547	0	70	40	3	70	0.0428571
NODE_8863_length_900_cov_5.962547	0	70	42	6	70	0.0857143
NODE_8863_length_900_cov_5.962547	0	70	44	24	70	0.3428572
NODE_8863_length_900_cov_5.962547	43	108	28	1	65	0.0153846
NODE_8863_length_900_cov_5.962547	43	108	32	2	65	0.0307692
NODE_8863_length_900_cov_5.962547	43	108	40	2	65	0.0307692
NODE_8863_length_900_cov_5.962547	43	108	42	3	65	0.0461538
NODE_8863_length_900_cov_5.962547	43	108	44	57	65	0.8769231
NODE_8870_length_900_cov_2.521848	85	165	0	80	80	1.0000000
NODE_8870_length_900_cov_2.521848	138	218	0	80	80	1.0000000
NODE_8879_length_899_cov_45.853750	380	460	0	12	80	0.1500000
NODE_8879_length_899_cov_45.853750	380	460	6	64	80	0.8000000
NODE_8879_length_899_cov_45.853750	380	460	8	4	80	0.0500000
NODE_8879_length_899_cov_45.853750	433	516	6	29	83	0.3493976
NODE_8879_length_899_cov_45.853750	433	516	8	54	83	0.6506024
NODE_8880_length_899_cov_37.758750	381	461	0	80	80	1.0000000
NODE_8880_length_899_cov_37.758750	434	514	0	80	80	1.0000000
NODE_8881_length_899_cov_27.362500	413	493	0	42	80	0.5250000
NODE_8881_length_899_cov_27.362500	413	493	4	32	80	0.4000000
NODE_8881_length_899_cov_27.362500	413	493	6	2	80	0.0250000
NODE_8881_length_899_cov_27.362500	413	493	7	1	80	0.0125000
NODE_8881_length_899_cov_27.362500	413	493	8	3	80	0.0375000
NODE_8881_length_899_cov_27.362500	466	546	0	80	80	1.0000000
NODE_8882_length_899_cov_20.563750	379	459	0	80	80	1.0000000
NODE_8882_length_899_cov_20.563750	432	507	0	75	75	1.0000000
NODE_8884_length_899_cov_17.130000	319	399	0	80	80	1.0000000
NODE_8884_length_899_cov_17.130000	372	452	0	80	80	1.0000000
NODE_8885_length_899_cov_16.317500	270	350	0	80	80	1.0000000
NODE_8885_length_899_cov_16.317500	323	403	0	80	80	1.0000000
NODE_8886_length_899_cov_16.190000	284	364	0	80	80	1.0000000
NODE_8886_length_899_cov_16.190000	337	417	0	80	80	1.0000000
NODE_8887_length_899_cov_13.873750	317	397	2	53	80	0.6625000
NODE_8887_length_899_cov_13.873750	317	397	4	27	80	0.3375000
NODE_8887_length_899_cov_13.873750	370	450	0	36	80	0.4500000
NODE_8887_length_899_cov_13.873750	370	450	2	35	80	0.4375000
NODE_8887_length_899_cov_13.873750	370	450	4	9	80	0.1125000
NODE_8888_length_899_cov_12.957500	240	320	0	5	80	0.0625000
NODE_8888_length_899_cov_12.957500	240	320	1	1	80	0.0125000
NODE_8888_length_899_cov_12.957500	240	320	2	1	80	0.0125000
NODE_8888_length_899_cov_12.957500	240	320	4	73	80	0.9125000
NODE_8888_length_899_cov_12.957500	293	373	0	25	80	0.3125000
NODE_8888_length_899_cov_12.957500	293	373	2	8	80	0.1000000
NODE_8888_length_899_cov_12.957500	293	373	4	47	80	0.5875000
NODE_8889_length_899_cov_12.516250	387	467	0	80	80	1.0000000
NODE_8889_length_899_cov_12.516250	440	520	0	80	80	1.0000000
NODE_8890_length_899_cov_10.846250	348	428	0	40	80	0.5000000
NODE_8890_length_899_cov_10.846250	348	428	3	6	80	0.0750000
NODE_8890_length_899_cov_10.846250	348	428	4	34	80	0.4250000
NODE_8890_length_899_cov_10.846250	401	485	4	84	84	1.0000000
NODE_8891_length_899_cov_9.185000	347	427	0	80	80	1.0000000
NODE_8891_length_899_cov_9.185000	400	480	0	80	80	1.0000000
NODE_8892_length_899_cov_8.655000	498	578	0	80	80	1.0000000
NODE_8892_length_899_cov_8.655000	551	631	0	80	80	1.0000000
NODE_8893_length_899_cov_3.551250	0	54	6	6	54	0.1111111
NODE_8893_length_899_cov_3.551250	0	54	8	1	54	0.0185185
NODE_8893_length_899_cov_3.551250	0	54	10	8	54	0.1481481
NODE_8893_length_899_cov_3.551250	0	54	12	1	54	0.0185185
NODE_8893_length_899_cov_3.551250	0	54	14	1	54	0.0185185
NODE_8893_length_899_cov_3.551250	0	54	16	7	54	0.1296296
NODE_8893_length_899_cov_3.551250	0	54	18	1	54	0.0185185
NODE_8893_length_899_cov_3.551250	0	54	21	1	54	0.0185185
NODE_8893_length_899_cov_3.551250	0	54	26	1	54	0.0185185
NODE_8893_length_899_cov_3.551250	0	54	30	3	54	0.0555556
NODE_8893_length_899_cov_3.551250	0	54	32	1	54	0.0185185
NODE_8893_length_899_cov_3.551250	0	54	34	7	54	0.1296296
NODE_8893_length_899_cov_3.551250	0	54	36	16	54	0.2962963
NODE_8893_length_899_cov_3.551250	27	107	30	3	80	0.0375000
NODE_8893_length_899_cov_3.551250	27	107	32	1	80	0.0125000
NODE_8893_length_899_cov_3.551250	27	107	34	7	80	0.0875000
NODE_8893_length_899_cov_3.551250	27	107	36	16	80	0.2000000
NODE_8893_length_899_cov_3.551250	27	107	38	23	80	0.2875000
NODE_8893_length_899_cov_3.551250	27	107	42	2	80	0.0250000
NODE_8893_length_899_cov_3.551250	27	107	44	1	80	0.0125000
NODE_8893_length_899_cov_3.551250	27	107	46	27	80	0.3375000
NODE_8893_length_899_cov_3.551250	103	183	14	1	80	0.0125000
NODE_8893_length_899_cov_3.551250	103	183	16	3	80	0.0375000
NODE_8893_length_899_cov_3.551250	103	183	18	3	80	0.0375000
NODE_8893_length_899_cov_3.551250	103	183	21	2	80	0.0250000
NODE_8893_length_899_cov_3.551250	103	183	22	18	80	0.2250000
NODE_8893_length_899_cov_3.551250	103	183	24	7	80	0.0875000
NODE_8893_length_899_cov_3.551250	103	183	26	3	80	0.0375000
NODE_8893_length_899_cov_3.551250	103	183	28	10	80	0.1250000
NODE_8893_length_899_cov_3.551250	103	183	30	8	80	0.1000000
NODE_8893_length_899_cov_3.551250	103	183	32	4	80	0.0500000
NODE_8893_length_899_cov_3.551250	103	183	34	4	80	0.0500000
NODE_8893_length_899_cov_3.551250	103	183	38	1	80	0.0125000
NODE_8893_length_899_cov_3.551250	103	183	40	7	80	0.0875000
NODE_8893_length_899_cov_3.551250	103	183	42	7	80	0.0875000
NODE_8893_length_899_cov_3.551250	103	183	44	1	80	0.0125000
NODE_8893_length_899_cov_3.551250	103	183	46	1	80	0.0125000
NODE_8893_length_899_cov_3.551250	156	179	18	3	23	0.1304348
NODE_8893_length_899_cov_3.551250	156	179	21	2	23	0.0869565
NODE_8893_length_899_cov_3.551250	156	179	22	18	23	0.7826087
NODE_8914_length_898_cov_52.405507	299	379	0	2	80	0.0250000
NODE_8914_length_898_cov_52.405507	299	379	2	35	80	0.4375000
NODE_8914_length_898_cov_52.405507	299	379	4	10	80	0.1250000
NODE_8914_length_898_cov_52.405507	299	379	6	33	80	0.4125000
NODE_8914_length_898_cov_52.405507	352	432	0	55	80	0.6875000
NODE_8914_length_898_cov_52.405507	352	432	2	25	80	0.3125000
NODE_8914_length_898_cov_52.405507	428	508	0	80	80	1.0000000
NODE_8914_length_898_cov_52.405507	481	561	0	80	80	1.0000000
NODE_8915_length_898_cov_44.973717	363	443	0	11	80	0.1375000
NODE_8915_length_898_cov_44.973717	363	443	4	41	80	0.5125000
NODE_8915_length_898_cov_44.973717	363	443	6	5	80	0.0625000
NODE_8915_length_898_cov_44.973717	363	443	8	23	80	0.2875000
NODE_8915_length_898_cov_44.973717	416	496	0	5	80	0.0625000
NODE_8915_length_898_cov_44.973717	416	496	2	8	80	0.1000000
NODE_8915_length_898_cov_44.973717	416	496	4	37	80	0.4625000
NODE_8915_length_898_cov_44.973717	416	496	6	4	80	0.0500000
NODE_8915_length_898_cov_44.973717	416	496	8	26	80	0.3250000
NODE_8916_length_898_cov_38.269086	425	505	0	80	80	1.0000000
NODE_8916_length_898_cov_38.269086	478	558	0	80	80	1.0000000
NODE_8917_length_898_cov_27.006258	465	545	2	11	80	0.1375000
NODE_8917_length_898_cov_27.006258	465	545	4	6	80	0.0750000
NODE_8917_length_898_cov_27.006258	465	545	6	3	80	0.0375000
NODE_8917_length_898_cov_27.006258	465	545	7	1	80	0.0125000
NODE_8917_length_898_cov_27.006258	465	545	8	59	80	0.7375000
NODE_8917_length_898_cov_27.006258	518	598	0	6	80	0.0750000
NODE_8917_length_898_cov_27.006258	518	598	4	46	80	0.5750000
NODE_8917_length_898_cov_27.006258	518	598	6	4	80	0.0500000
NODE_8917_length_898_cov_27.006258	518	598	8	24	80	0.3000000
NODE_8918_length_898_cov_25.902378	185	265	6	80	80	1.0000000
NODE_8918_length_898_cov_25.902378	238	318	3	3	80	0.0375000
NODE_8918_length_898_cov_25.902378	238	318	6	77	80	0.9625000
NODE_8918_length_898_cov_25.902378	314	394	0	70	80	0.8750000
NODE_8918_length_898_cov_25.902378	314	394	2	1	80	0.0125000
NODE_8918_length_898_cov_25.902378	314	394	3	8	80	0.1000000
NODE_8918_length_898_cov_25.902378	314	394	6	1	80	0.0125000
NODE_8918_length_898_cov_25.902378	367	447	0	80	80	1.0000000
NODE_8919_length_898_cov_25.209011	368	448	0	80	80	1.0000000
NODE_8919_length_898_cov_25.209011	421	501	0	75	80	0.9375000
NODE_8919_length_898_cov_25.209011	421	501	2	5	80	0.0625000
NODE_8920_length_898_cov_21.923655	325	405	0	5	80	0.0625000
NODE_8920_length_898_cov_21.923655	325	405	2	38	80	0.4750000
NODE_8920_length_898_cov_21.923655	325	405	3	37	80	0.4625000
NODE_8920_length_898_cov_21.923655	378	458	0	58	80	0.7250000
NODE_8920_length_898_cov_21.923655	378	458	2	22	80	0.2750000
NODE_8921_length_898_cov_21.065081	306	386	0	29	80	0.3625000
NODE_8921_length_898_cov_21.065081	306	386	2	51	80	0.6375000
NODE_8921_length_898_cov_21.065081	359	439	0	80	80	1.0000000
NODE_8922_length_898_cov_20.954944	374	454	0	16	80	0.2000000
NODE_8922_length_898_cov_20.954944	374	454	2	26	80	0.3250000
NODE_8922_length_898_cov_20.954944	374	454	6	12	80	0.1500000
NODE_8922_length_898_cov_20.954944	374	454	8	26	80	0.3250000
NODE_8922_length_898_cov_20.954944	427	507	2	16	80	0.2000000
NODE_8922_length_898_cov_20.954944	427	507	6	2	80	0.0250000
NODE_8922_length_898_cov_20.954944	427	507	8	62	80	0.7750000
NODE_8923_length_898_cov_17.387985	398	478	0	24	80	0.3000000
NODE_8923_length_898_cov_17.387985	398	478	4	56	80	0.7000000
NODE_8923_length_898_cov_17.387985	451	531	0	38	80	0.4750000
NODE_8923_length_898_cov_17.387985	451	531	2	5	80	0.0625000
NODE_8923_length_898_cov_17.387985	451	531	4	37	80	0.4625000
NODE_8924_length_898_cov_17.252816	265	345	0	8	80	0.1000000
NODE_8924_length_898_cov_17.252816	265	345	2	72	80	0.9000000
NODE_8924_length_898_cov_17.252816	318	398	0	61	80	0.7625000
NODE_8924_length_898_cov_17.252816	318	398	2	19	80	0.2375000
NODE_8926_length_898_cov_13.152691	455	535	0	15	80	0.1875000
NODE_8926_length_898_cov_13.152691	455	535	2	31	80	0.3875000
NODE_8926_length_898_cov_13.152691	455	535	3	1	80	0.0125000
NODE_8926_length_898_cov_13.152691	455	535	4	33	80	0.4125000
NODE_8926_length_898_cov_13.152691	508	588	2	21	80	0.2625000
NODE_8926_length_898_cov_13.152691	508	588	4	59	80	0.7375000
NODE_8927_length_898_cov_12.612015	375	455	2	31	80	0.3875000
NODE_8927_length_898_cov_12.612015	375	455	3	48	80	0.6000000
NODE_8927_length_898_cov_12.612015	375	455	4	1	80	0.0125000
NODE_8927_length_898_cov_12.612015	428	508	2	80	80	1.0000000
NODE_8928_length_898_cov_12.498123	428	508	0	80	80	1.0000000
NODE_8928_length_898_cov_12.498123	481	561	0	80	80	1.0000000
NODE_8932_length_898_cov_1.790989	0	56	0	56	56	1.0000000
NODE_8932_length_898_cov_1.790989	29	93	0	64	64	1.0000000
NODE_8944_length_897_cov_63.921053	350	430	0	30	80	0.3750000
NODE_8944_length_897_cov_63.921053	350	430	2	50	80	0.6250000
NODE_8944_length_897_cov_63.921053	403	483	0	65	80	0.8125000
NODE_8944_length_897_cov_63.921053	403	483	2	15	80	0.1875000
NODE_8945_length_897_cov_58.921053	316	396	0	42	80	0.5250000
NODE_8945_length_897_cov_58.921053	316	396	4	38	80	0.4750000
NODE_8945_length_897_cov_58.921053	369	449	4	80	80	1.0000000
NODE_8946_length_897_cov_35.946115	324	404	0	57	80	0.7125000
NODE_8946_length_897_cov_35.946115	324	404	2	23	80	0.2875000
NODE_8946_length_897_cov_35.946115	377	457	0	52	80	0.6500000
NODE_8946_length_897_cov_35.946115	377	457	1	8	80	0.1000000
NODE_8946_length_897_cov_35.946115	377	457	2	20	80	0.2500000
NODE_8947_length_897_cov_25.548872	238	318	0	21	80	0.2625000
NODE_8947_length_897_cov_25.548872	238	318	2	3	80	0.0375000
NODE_8947_length_897_cov_25.548872	238	318	12	1	80	0.0125000
NODE_8947_length_897_cov_25.548872	238	318	13	48	80	0.6000000
NODE_8947_length_897_cov_25.548872	238	318	14	7	80	0.0875000
NODE_8947_length_897_cov_25.548872	291	371	12	42	80	0.5250000
NODE_8947_length_897_cov_25.548872	291	371	13	20	80	0.2500000
NODE_8947_length_897_cov_25.548872	291	371	14	18	80	0.2250000
NODE_8948_length_897_cov_24.913534	399	479	0	11	80	0.1375000
NODE_8948_length_897_cov_24.913534	399	479	2	69	80	0.8625000
NODE_8948_length_897_cov_24.913534	452	532	0	30	80	0.3750000
NODE_8948_length_897_cov_24.913534	452	532	2	50	80	0.6250000
NODE_8949_length_897_cov_21.839599	308	388	0	80	80	1.0000000
NODE_8949_length_897_cov_21.839599	361	441	0	29	80	0.3625000
NODE_8949_length_897_cov_21.839599	361	441	2	51	80	0.6375000
NODE_8950_length_897_cov_19.355890	489	569	0	80	80	1.0000000
NODE_8950_length_897_cov_19.355890	542	622	0	80	80	1.0000000
NODE_8951_length_897_cov_16.295739	209	289	0	20	80	0.2500000
NODE_8951_length_897_cov_16.295739	209	289	2	60	80	0.7500000
NODE_8951_length_897_cov_16.295739	262	342	0	73	80	0.9125000
NODE_8951_length_897_cov_16.295739	262	342	2	7	80	0.0875000
NODE_8952_length_897_cov_14.766917	395	475	0	46	80	0.5750000
NODE_8952_length_897_cov_14.766917	395	475	2	34	80	0.4250000
NODE_8952_length_897_cov_14.766917	448	528	2	80	80	1.0000000
NODE_8953_length_897_cov_14.219298	253	333	2	80	80	1.0000000
NODE_8953_length_897_cov_14.219298	306	386	0	30	80	0.3750000
NODE_8953_length_897_cov_14.219298	306	386	2	50	80	0.6250000
NODE_8954_length_897_cov_11.116541	182	262	0	80	80	1.0000000
NODE_8954_length_897_cov_11.116541	235	315	0	80	80	1.0000000
NODE_8955_length_897_cov_8.211779	303	383	0	80	80	1.0000000
NODE_8955_length_897_cov_8.211779	356	436	0	80	80	1.0000000
NODE_8973_length_896_cov_48.249686	397	477	0	29	80	0.3625000
NODE_8973_length_896_cov_48.249686	397	477	7	36	80	0.4500000
NODE_8973_length_896_cov_48.249686	397	477	8	15	80	0.1875000
NODE_8973_length_896_cov_48.249686	450	530	0	80	80	1.0000000
NODE_8974_length_896_cov_24.824341	213	293	0	80	80	1.0000000
NODE_8974_length_896_cov_24.824341	266	346	0	80	80	1.0000000
NODE_8975_length_896_cov_23.130489	333	413	0	80	80	1.0000000
NODE_8975_length_896_cov_23.130489	386	466	0	80	80	1.0000000
NODE_8975_length_896_cov_23.130489	462	542	0	80	80	1.0000000
NODE_8975_length_896_cov_23.130489	515	595	0	40	80	0.5000000
NODE_8975_length_896_cov_23.130489	515	595	2	23	80	0.2875000
NODE_8975_length_896_cov_23.130489	515	595	3	1	80	0.0125000
NODE_8975_length_896_cov_23.130489	515	595	4	16	80	0.2000000
NODE_8976_length_896_cov_20.673777	361	441	0	80	80	1.0000000
NODE_8976_length_896_cov_20.673777	414	497	0	83	83	1.0000000
NODE_8977_length_896_cov_18.979925	418	498	0	38	80	0.4750000
NODE_8977_length_896_cov_18.979925	418	498	4	42	80	0.5250000
NODE_8977_length_896_cov_18.979925	471	551	4	80	80	1.0000000
NODE_8978_length_896_cov_15.875784	340	420	0	41	80	0.5125000
NODE_8978_length_896_cov_15.875784	340	420	2	39	80	0.4875000
NODE_8978_length_896_cov_15.875784	393	473	0	21	80	0.2625000
NODE_8978_length_896_cov_15.875784	393	473	2	59	80	0.7375000
NODE_8980_length_896_cov_10.646173	337	417	0	80	80	1.0000000
NODE_8980_length_896_cov_10.646173	390	470	0	80	80	1.0000000
NODE_8981_length_896_cov_10.351317	327	407	2	34	80	0.4250000
NODE_8981_length_896_cov_10.351317	327	407	4	44	80	0.5500000
NODE_8981_length_896_cov_10.351317	327	407	6	2	80	0.0250000
NODE_8981_length_896_cov_10.351317	380	460	2	53	80	0.6625000
NODE_8981_length_896_cov_10.351317	380	460	4	27	80	0.3375000
NODE_8982_length_896_cov_9.754078	411	491	0	80	80	1.0000000
NODE_8982_length_896_cov_9.754078	464	544	0	80	80	1.0000000
NODE_8983_length_896_cov_8.069009	340	422	0	60	82	0.7317073
NODE_8983_length_896_cov_8.069009	340	422	2	22	82	0.2682927
NODE_8983_length_896_cov_8.069009	395	475	0	5	80	0.0625000
NODE_8983_length_896_cov_8.069009	395	475	2	75	80	0.9375000
NODE_8986_length_896_cov_4.939774	384	464	0	30	80	0.3750000
NODE_8986_length_896_cov_4.939774	384	464	2	50	80	0.6250000
NODE_8986_length_896_cov_4.939774	437	517	0	70	80	0.8750000
NODE_8986_length_896_cov_4.939774	437	517	2	10	80	0.1250000
NODE_9005_length_895_cov_54.949749	378	458	0	80	80	1.0000000
NODE_9005_length_895_cov_54.949749	431	511	0	80	80	1.0000000
NODE_9006_length_895_cov_53.945980	306	386	0	80	80	1.0000000
NODE_9006_length_895_cov_53.945980	359	439	0	80	80	1.0000000
NODE_9007_length_895_cov_48.915829	369	449	0	45	80	0.5625000
NODE_9007_length_895_cov_48.915829	369	449	2	35	80	0.4375000
NODE_9007_length_895_cov_48.915829	422	502	0	80	80	1.0000000
NODE_9007_length_895_cov_48.915829	498	578	0	80	80	1.0000000
NODE_9007_length_895_cov_48.915829	551	631	0	80	80	1.0000000
NODE_9008_length_895_cov_38.347990	452	532	4	13	80	0.1625000
NODE_9008_length_895_cov_38.347990	452	532	11	2	80	0.0250000
NODE_9008_length_895_cov_38.347990	452	532	13	47	80	0.5875000
NODE_9008_length_895_cov_38.347990	452	532	15	10	80	0.1250000
NODE_9008_length_895_cov_38.347990	452	532	16	8	80	0.1000000
NODE_9008_length_895_cov_38.347990	505	585	4	5	80	0.0625000
NODE_9008_length_895_cov_38.347990	505	585	6	11	80	0.1375000
NODE_9008_length_895_cov_38.347990	505	585	13	9	80	0.1125000
NODE_9008_length_895_cov_38.347990	505	585	14	34	80	0.4250000
NODE_9008_length_895_cov_38.347990	505	585	15	10	80	0.1250000
NODE_9008_length_895_cov_38.347990	505	585	16	11	80	0.1375000
NODE_9009_length_895_cov_33.716080	418	499	0	81	81	1.0000000
NODE_9009_length_895_cov_33.716080	472	552	0	80	80	1.0000000
NODE_9010_length_895_cov_21.630653	392	468	0	15	76	0.1973684
NODE_9010_length_895_cov_21.630653	392	468	2	16	76	0.2105263
NODE_9010_length_895_cov_21.630653	392	468	4	45	76	0.5921053
NODE_9010_length_895_cov_21.630653	441	521	0	1	80	0.0125000
NODE_9010_length_895_cov_21.630653	441	521	2	3	80	0.0375000
NODE_9010_length_895_cov_21.630653	441	521	4	76	80	0.9500000
NODE_9011_length_895_cov_19.932161	331	411	0	80	80	1.0000000
NODE_9011_length_895_cov_19.932161	384	464	0	80	80	1.0000000
NODE_9011_length_895_cov_19.932161	460	540	0	80	80	1.0000000
NODE_9011_length_895_cov_19.932161	513	593	0	80	80	1.0000000
NODE_9012_length_895_cov_16.037688	403	479	0	15	76	0.1973684
NODE_9012_length_895_cov_16.037688	403	479	2	61	76	0.8026316
NODE_9012_length_895_cov_16.037688	452	532	0	68	80	0.8500000
NODE_9012_length_895_cov_16.037688	452	532	2	12	80	0.1500000
NODE_9013_length_895_cov_13.003769	372	452	0	80	80	1.0000000
NODE_9013_length_895_cov_13.003769	425	491	0	66	66	1.0000000
NODE_9014_length_895_cov_12.736181	280	360	0	80	80	1.0000000
NODE_9014_length_895_cov_12.736181	333	413	0	80	80	1.0000000
NODE_9015_length_895_cov_11.090452	505	585	0	41	80	0.5125000
NODE_9015_length_895_cov_11.090452	505	585	1	26	80	0.3250000
NODE_9015_length_895_cov_11.090452	505	585	2	13	80	0.1625000
NODE_9015_length_895_cov_11.090452	558	638	1	14	80	0.1750000
NODE_9015_length_895_cov_11.090452	558	638	2	41	80	0.5125000
NODE_9015_length_895_cov_11.090452	558	638	4	25	80	0.3125000
NODE_9016_length_895_cov_9.266332	468	548	0	80	80	1.0000000
NODE_9016_length_895_cov_9.266332	521	601	0	80	80	1.0000000
NODE_9018_length_895_cov_5.659548	472	552	0	16	80	0.2000000
NODE_9018_length_895_cov_5.659548	472	552	2	64	80	0.8000000
NODE_9018_length_895_cov_5.659548	525	605	0	40	80	0.5000000
NODE_9018_length_895_cov_5.659548	525	605	2	40	80	0.5000000
NODE_9019_length_895_cov_5.383166	42	123	16	4	81	0.0493827
NODE_9019_length_895_cov_5.383166	42	123	17	10	81	0.1234568
NODE_9019_length_895_cov_5.383166	42	123	19	2	81	0.0246914
NODE_9019_length_895_cov_5.383166	42	123	20	3	81	0.0370370
NODE_9019_length_895_cov_5.383166	42	123	22	3	81	0.0370370
NODE_9019_length_895_cov_5.383166	42	123	24	20	81	0.2469136
NODE_9019_length_895_cov_5.383166	42	123	26	39	81	0.4814815
NODE_9030_length_894_cov_60.153459	446	526	0	80	80	1.0000000
NODE_9030_length_894_cov_60.153459	499	579	0	80	80	1.0000000
NODE_9031_length_894_cov_49.618868	373	453	4	54	80	0.6750000
NODE_9031_length_894_cov_49.618868	373	453	6	26	80	0.3250000
NODE_9031_length_894_cov_49.618868	426	506	0	6	80	0.0750000
NODE_9031_length_894_cov_49.618868	426	506	2	11	80	0.1375000
NODE_9031_length_894_cov_49.618868	426	506	4	63	80	0.7875000
NODE_9032_length_894_cov_33.228931	459	539	0	80	80	1.0000000
NODE_9032_length_894_cov_33.228931	512	592	0	80	80	1.0000000
NODE_9033_length_894_cov_31.933333	411	491	0	80	80	1.0000000
NODE_9033_length_894_cov_31.933333	464	544	0	80	80	1.0000000
NODE_9034_length_894_cov_30.499371	270	350	0	45	80	0.5625000
NODE_9034_length_894_cov_30.499371	270	350	2	35	80	0.4375000
NODE_9034_length_894_cov_30.499371	323	403	0	80	80	1.0000000
NODE_9034_length_894_cov_30.499371	399	479	0	80	80	1.0000000
NODE_9034_length_894_cov_30.499371	452	532	0	80	80	1.0000000
NODE_9035_length_894_cov_23.046541	79	159	0	80	80	1.0000000
NODE_9035_length_894_cov_23.046541	132	212	0	80	80	1.0000000
NODE_9036_length_894_cov_22.266667	381	461	0	9	80	0.1125000
NODE_9036_length_894_cov_22.266667	381	461	2	71	80	0.8875000
NODE_9036_length_894_cov_22.266667	434	514	0	62	80	0.7750000
NODE_9036_length_894_cov_22.266667	434	514	2	18	80	0.2250000
NODE_9037_length_894_cov_21.997484	332	412	0	80	80	1.0000000
NODE_9037_length_894_cov_21.997484	385	465	0	80	80	1.0000000
NODE_9038_length_894_cov_21.205031	319	399	0	80	80	1.0000000
NODE_9038_length_894_cov_21.205031	372	452	0	80	80	1.0000000
NODE_9038_length_894_cov_21.205031	448	528	0	80	80	1.0000000
NODE_9038_length_894_cov_21.205031	501	581	0	37	80	0.4625000
NODE_9038_length_894_cov_21.205031	501	581	2	43	80	0.5375000
NODE_9039_length_894_cov_21.132075	422	502	2	70	80	0.8750000
NODE_9039_length_894_cov_21.132075	422	502	4	9	80	0.1125000
NODE_9039_length_894_cov_21.132075	422	502	6	1	80	0.0125000
NODE_9039_length_894_cov_21.132075	475	555	2	17	80	0.2125000
NODE_9039_length_894_cov_21.132075	475	555	4	62	80	0.7750000
NODE_9039_length_894_cov_21.132075	475	555	6	1	80	0.0125000
NODE_9040_length_894_cov_15.598742	338	418	2	13	80	0.1625000
NODE_9040_length_894_cov_15.598742	338	418	4	36	80	0.4500000
NODE_9040_length_894_cov_15.598742	338	418	6	31	80	0.3875000
NODE_9040_length_894_cov_15.598742	391	471	2	30	80	0.3750000
NODE_9040_length_894_cov_15.598742	391	471	4	37	80	0.4625000
NODE_9040_length_894_cov_15.598742	391	471	6	13	80	0.1625000
NODE_9041_length_894_cov_14.079245	344	424	0	35	80	0.4375000
NODE_9041_length_894_cov_14.079245	344	424	2	45	80	0.5625000
NODE_9041_length_894_cov_14.079245	397	477	2	29	80	0.3625000
NODE_9041_length_894_cov_14.079245	397	477	4	51	80	0.6375000
NODE_9042_length_894_cov_13.031447	336	416	0	10	80	0.1250000
NODE_9042_length_894_cov_13.031447	336	416	4	6	80	0.0750000
NODE_9042_length_894_cov_13.031447	336	416	10	51	80	0.6375000
NODE_9042_length_894_cov_13.031447	336	416	14	13	80	0.1625000
NODE_9042_length_894_cov_13.031447	389	469	4	28	80	0.3500000
NODE_9042_length_894_cov_13.031447	389	469	10	26	80	0.3250000
NODE_9042_length_894_cov_13.031447	389	469	14	26	80	0.3250000
NODE_9043_length_894_cov_13.031447	353	433	10	35	80	0.4375000
NODE_9043_length_894_cov_13.031447	353	433	12	1	80	0.0125000
NODE_9043_length_894_cov_13.031447	353	433	13	26	80	0.3250000
NODE_9043_length_894_cov_13.031447	353	433	14	18	80	0.2250000
NODE_9043_length_894_cov_13.031447	406	486	0	25	80	0.3125000
NODE_9043_length_894_cov_13.031447	406	486	9	5	80	0.0625000
NODE_9043_length_894_cov_13.031447	406	486	10	50	80	0.6250000
NODE_9044_length_894_cov_9.706918	330	410	0	52	80	0.6500000
NODE_9044_length_894_cov_9.706918	330	410	2	28	80	0.3500000
NODE_9045_length_894_cov_6.963522	378	458	0	27	80	0.3375000
NODE_9045_length_894_cov_6.963522	378	458	2	53	80	0.6625000
NODE_9045_length_894_cov_6.963522	431	511	0	18	80	0.2250000
NODE_9045_length_894_cov_6.963522	431	511	2	62	80	0.7750000
NODE_9046_length_894_cov_4.993711	365	445	0	80	80	1.0000000
NODE_9046_length_894_cov_4.993711	418	498	0	80	80	1.0000000
NODE_9066_length_893_cov_59.134761	261	341	0	80	80	1.0000000
NODE_9066_length_893_cov_59.134761	314	394	0	80	80	1.0000000
NODE_9067_length_893_cov_58.991184	388	468	0	16	80	0.2000000
NODE_9067_length_893_cov_58.991184	388	468	4	16	80	0.2000000
NODE_9067_length_893_cov_58.991184	388	468	6	48	80	0.6000000
NODE_9067_length_893_cov_58.991184	441	521	0	23	80	0.2875000
NODE_9067_length_893_cov_58.991184	441	521	1	1	80	0.0125000
NODE_9067_length_893_cov_58.991184	441	521	2	15	80	0.1875000
NODE_9067_length_893_cov_58.991184	441	521	6	41	80	0.5125000
NODE_9067_length_893_cov_58.991184	517	597	0	80	80	1.0000000
NODE_9067_length_893_cov_58.991184	570	650	0	80	80	1.0000000
NODE_9068_length_893_cov_55.644836	434	514	0	80	80	1.0000000
NODE_9068_length_893_cov_55.644836	487	567	0	80	80	1.0000000
NODE_9068_length_893_cov_55.644836	563	643	0	80	80	1.0000000
NODE_9068_length_893_cov_55.644836	616	696	0	80	80	1.0000000
NODE_9069_length_893_cov_54.803526	479	559	0	48	80	0.6000000
NODE_9069_length_893_cov_54.803526	479	559	7	1	80	0.0125000
NODE_9069_length_893_cov_54.803526	479	559	8	31	80	0.3875000
NODE_9069_length_893_cov_54.803526	532	612	8	80	80	1.0000000
NODE_9070_length_893_cov_38.147355	391	471	0	80	80	1.0000000
NODE_9070_length_893_cov_38.147355	444	524	0	80	80	1.0000000
NODE_9071_length_893_cov_33.690176	387	467	6	80	80	1.0000000
NODE_9071_length_893_cov_33.690176	440	520	5	1	80	0.0125000
NODE_9071_length_893_cov_33.690176	440	520	6	79	80	0.9875000
NODE_9072_length_893_cov_32.162469	524	604	0	39	80	0.4875000
NODE_9072_length_893_cov_32.162469	524	604	3	41	80	0.5125000
NODE_9072_length_893_cov_32.162469	577	657	0	12	80	0.1500000
NODE_9072_length_893_cov_32.162469	577	657	3	68	80	0.8500000
NODE_9073_length_893_cov_31.916877	344	424	0	80	80	1.0000000
NODE_9073_length_893_cov_31.916877	397	477	0	80	80	1.0000000
NODE_9074_length_893_cov_28.693955	437	517	0	8	80	0.1000000
NODE_9074_length_893_cov_28.693955	437	517	2	7	80	0.0875000
NODE_9074_length_893_cov_28.693955	437	517	4	65	80	0.8125000
NODE_9074_length_893_cov_28.693955	490	570	0	40	80	0.5000000
NODE_9074_length_893_cov_28.693955	490	570	4	40	80	0.5000000
NODE_9075_length_893_cov_23.564232	363	443	0	19	80	0.2375000
NODE_9075_length_893_cov_23.564232	363	443	2	61	80	0.7625000
NODE_9075_length_893_cov_23.564232	416	496	0	72	80	0.9000000
NODE_9075_length_893_cov_23.564232	416	496	2	8	80	0.1000000
NODE_9076_length_893_cov_22.633501	272	352	0	60	80	0.7500000
NODE_9076_length_893_cov_22.633501	272	352	2	20	80	0.2500000
NODE_9076_length_893_cov_22.633501	272	352	0	60	80	0.7500000
NODE_9076_length_893_cov_22.633501	272	352	2	20	80	0.2500000
NODE_9076_length_893_cov_22.633501	272	352	0	60	80	0.7500000
NODE_9076_length_893_cov_22.633501	272	352	2	20	80	0.2500000
NODE_9076_length_893_cov_22.633501	325	405	0	7	80	0.0875000
NODE_9076_length_893_cov_22.633501	325	405	2	73	80	0.9125000
NODE_9076_length_893_cov_22.633501	325	405	0	7	80	0.0875000
NODE_9076_length_893_cov_22.633501	325	405	2	73	80	0.9125000
NODE_9076_length_893_cov_22.633501	325	405	0	7	80	0.0875000
NODE_9076_length_893_cov_22.633501	325	405	2	73	80	0.9125000
NODE_9076_length_893_cov_22.633501	401	481	0	63	80	0.7875000
NODE_9076_length_893_cov_22.633501	401	481	2	17	80	0.2125000
NODE_9076_length_893_cov_22.633501	454	534	0	80	80	1.0000000
NODE_9077_length_893_cov_22.403023	453	533	0	2	80	0.0250000
NODE_9077_length_893_cov_22.403023	453	533	2	78	80	0.9750000
NODE_9077_length_893_cov_22.403023	506	586	0	55	80	0.6875000
NODE_9077_length_893_cov_22.403023	506	586	2	25	80	0.3125000
NODE_9078_length_893_cov_19.423174	298	378	0	80	80	1.0000000
NODE_9078_length_893_cov_19.423174	351	431	0	80	80	1.0000000
NODE_9078_length_893_cov_19.423174	427	507	0	80	80	1.0000000
NODE_9078_length_893_cov_19.423174	480	560	0	80	80	1.0000000
NODE_9079_length_893_cov_19.389169	360	440	0	80	80	1.0000000
NODE_9079_length_893_cov_19.389169	413	493	0	80	80	1.0000000
NODE_9079_length_893_cov_19.389169	489	569	0	66	80	0.8250000
NODE_9079_length_893_cov_19.389169	489	569	1	14	80	0.1750000
NODE_9079_length_893_cov_19.389169	542	622	0	17	80	0.2125000
NODE_9079_length_893_cov_19.389169	542	622	1	63	80	0.7875000
NODE_9080_length_893_cov_18.152393	394	474	0	80	80	1.0000000
NODE_9080_length_893_cov_18.152393	447	527	0	80	80	1.0000000
NODE_9081_length_893_cov_15.960957	442	522	0	50	80	0.6250000
NODE_9081_length_893_cov_15.960957	442	522	4	30	80	0.3750000
NODE_9081_length_893_cov_15.960957	495	575	4	80	80	1.0000000
NODE_9082_length_893_cov_13.119647	473	553	1	30	80	0.3750000
NODE_9082_length_893_cov_13.119647	473	553	2	50	80	0.6250000
NODE_9082_length_893_cov_13.119647	526	606	0	46	80	0.5750000
NODE_9082_length_893_cov_13.119647	526	606	1	34	80	0.4250000
NODE_9084_length_893_cov_5.549118	353	415	0	20	62	0.3225806
NODE_9084_length_893_cov_5.549118	353	415	2	42	62	0.6774194
NODE_9100_length_893_cov_1.141058	28	108	10	2	80	0.0250000
NODE_9100_length_893_cov_1.141058	28	108	12	78	80	0.9750000
NODE_9104_length_892_cov_74.968474	333	413	6	22	80	0.2750000
NODE_9104_length_892_cov_74.968474	333	413	8	58	80	0.7250000
NODE_9104_length_892_cov_74.968474	386	466	0	52	80	0.6500000
NODE_9104_length_892_cov_74.968474	386	466	6	23	80	0.2875000
NODE_9104_length_892_cov_74.968474	386	466	8	5	80	0.0625000
NODE_9104_length_892_cov_74.968474	462	542	0	80	80	1.0000000
NODE_9104_length_892_cov_74.968474	515	595	0	80	80	1.0000000
NODE_9105_length_892_cov_54.549811	463	550	0	87	87	1.0000000
NODE_9105_length_892_cov_54.549811	523	603	0	80	80	1.0000000
NODE_9105_length_892_cov_54.549811	599	679	0	80	80	1.0000000
NODE_9106_length_892_cov_37.887768	373	453	0	32	80	0.4000000
NODE_9106_length_892_cov_37.887768	373	453	6	48	80	0.6000000
NODE_9106_length_892_cov_37.887768	426	506	6	80	80	1.0000000
NODE_9107_length_892_cov_19.732661	361	441	0	5	80	0.0625000
NODE_9107_length_892_cov_19.732661	361	441	2	32	80	0.4000000
NODE_9107_length_892_cov_19.732661	361	441	4	43	80	0.5375000
NODE_9107_length_892_cov_19.732661	414	494	0	58	80	0.7250000
NODE_9107_length_892_cov_19.732661	414	494	2	22	80	0.2750000
NODE_9108_length_892_cov_19.052963	290	370	0	69	80	0.8625000
NODE_9108_length_892_cov_19.052963	290	370	1	11	80	0.1375000
NODE_9108_length_892_cov_19.052963	343	423	0	80	80	1.0000000
NODE_9108_length_892_cov_19.052963	419	499	0	80	80	1.0000000
NODE_9108_length_892_cov_19.052963	472	552	0	80	80	1.0000000
NODE_9109_length_892_cov_17.276166	341	421	0	80	80	1.0000000
NODE_9109_length_892_cov_17.276166	394	474	0	80	80	1.0000000
NODE_9110_length_892_cov_16.312736	411	491	1	5	80	0.0625000
NODE_9110_length_892_cov_16.312736	411	491	2	75	80	0.9375000
NODE_9110_length_892_cov_16.312736	464	544	2	27	80	0.3375000
NODE_9110_length_892_cov_16.312736	464	544	5	17	80	0.2125000
NODE_9110_length_892_cov_16.312736	464	544	6	36	80	0.4500000
NODE_9111_length_892_cov_15.808323	395	475	2	11	80	0.1375000
NODE_9111_length_892_cov_15.808323	395	475	4	69	80	0.8625000
NODE_9111_length_892_cov_15.808323	448	528	0	9	80	0.1125000
NODE_9111_length_892_cov_15.808323	448	528	2	37	80	0.4625000
NODE_9111_length_892_cov_15.808323	448	528	4	34	80	0.4250000
NODE_9112_length_892_cov_14.020177	522	602	0	80	80	1.0000000
NODE_9112_length_892_cov_14.020177	575	655	0	80	80	1.0000000
NODE_9114_length_892_cov_8.798235	400	480	0	80	80	1.0000000
NODE_9114_length_892_cov_8.798235	453	533	0	80	80	1.0000000
NODE_9115_length_892_cov_8.413619	428	508	0	12	80	0.1500000
NODE_9115_length_892_cov_8.413619	428	508	2	68	80	0.8500000
NODE_9115_length_892_cov_8.413619	481	561	0	65	80	0.8125000
NODE_9115_length_892_cov_8.413619	481	561	2	15	80	0.1875000
NODE_9116_length_892_cov_6.694830	374	454	0	80	80	1.0000000
NODE_9116_length_892_cov_6.694830	427	507	0	80	80	1.0000000
NODE_9134_length_891_cov_30.166667	295	375	6	80	80	1.0000000
NODE_9134_length_891_cov_30.166667	348	428	0	21	80	0.2625000
NODE_9134_length_891_cov_30.166667	348	428	5	1	80	0.0125000
NODE_9134_length_891_cov_30.166667	348	428	6	58	80	0.7250000
NODE_9135_length_891_cov_26.333333	319	399	0	80	80	1.0000000
NODE_9135_length_891_cov_26.333333	372	452	0	80	80	1.0000000
NODE_9136_length_891_cov_22.228535	336	416	0	80	80	1.0000000
NODE_9136_length_891_cov_22.228535	389	469	0	80	80	1.0000000
NODE_9137_length_891_cov_20.446970	377	457	6	80	80	1.0000000
NODE_9137_length_891_cov_20.446970	430	510	0	25	80	0.3125000
NODE_9137_length_891_cov_20.446970	430	510	6	55	80	0.6875000
NODE_9138_length_891_cov_20.226010	310	390	0	80	80	1.0000000
NODE_9138_length_891_cov_20.226010	363	443	0	80	80	1.0000000
NODE_9140_length_891_cov_13.207071	392	472	0	1	80	0.0125000
NODE_9140_length_891_cov_13.207071	392	472	3	1	80	0.0125000
NODE_9140_length_891_cov_13.207071	392	472	4	78	80	0.9750000
NODE_9140_length_891_cov_13.207071	445	525	0	29	80	0.3625000
NODE_9140_length_891_cov_13.207071	445	525	4	51	80	0.6375000
NODE_9141_length_891_cov_11.579545	379	459	0	80	80	1.0000000
NODE_9141_length_891_cov_11.579545	432	512	0	80	80	1.0000000
NODE_9142_length_891_cov_11.117424	499	579	2	80	80	1.0000000
NODE_9142_length_891_cov_11.117424	552	632	0	52	80	0.6500000
NODE_9142_length_891_cov_11.117424	552	632	2	28	80	0.3500000
NODE_9153_length_890_cov_29.070796	284	364	0	14	80	0.1750000
NODE_9153_length_890_cov_29.070796	284	364	2	66	80	0.8250000
NODE_9153_length_890_cov_29.070796	337	417	2	80	80	1.0000000
NODE_9153_length_890_cov_29.070796	413	497	0	80	84	0.9523810
NODE_9153_length_890_cov_29.070796	413	497	2	4	84	0.0476190
NODE_9153_length_890_cov_29.070796	470	550	0	80	80	1.0000000
NODE_9154_length_890_cov_27.295828	550	630	0	61	80	0.7625000
NODE_9154_length_890_cov_27.295828	550	630	2	19	80	0.2375000
NODE_9154_length_890_cov_27.295828	603	683	0	8	80	0.1000000
NODE_9154_length_890_cov_27.295828	603	683	2	72	80	0.9000000
NODE_9155_length_890_cov_18.088496	80	135	0	55	55	1.0000000
NODE_9155_length_890_cov_18.088496	276	356	0	80	80	1.0000000
NODE_9155_length_890_cov_18.088496	329	406	0	37	77	0.4805195
NODE_9155_length_890_cov_18.088496	329	406	4	40	77	0.5194805
NODE_9156_length_890_cov_16.831858	402	482	0	80	80	1.0000000
NODE_9156_length_890_cov_16.831858	455	535	0	80	80	1.0000000
NODE_9157_length_890_cov_11.881163	222	302	0	80	80	1.0000000
NODE_9157_length_890_cov_11.881163	275	355	0	69	80	0.8625000
NODE_9157_length_890_cov_11.881163	275	355	1	11	80	0.1375000
NODE_9158_length_890_cov_8.676359	335	415	0	64	80	0.8000000
NODE_9158_length_890_cov_8.676359	335	415	2	3	80	0.0375000
NODE_9158_length_890_cov_8.676359	335	415	4	13	80	0.1625000
NODE_9158_length_890_cov_8.676359	388	468	0	11	80	0.1375000
NODE_9158_length_890_cov_8.676359	388	468	2	3	80	0.0375000
NODE_9158_length_890_cov_8.676359	388	468	4	66	80	0.8250000
NODE_9183_length_889_cov_61.520253	334	414	0	63	80	0.7875000
NODE_9183_length_889_cov_61.520253	334	414	2	17	80	0.2125000
NODE_9183_length_889_cov_61.520253	387	467	0	17	80	0.2125000
NODE_9183_length_889_cov_61.520253	387	467	2	63	80	0.7875000
NODE_9183_length_889_cov_61.520253	463	543	0	80	80	1.0000000
NODE_9183_length_889_cov_61.520253	516	596	0	80	80	1.0000000
NODE_9184_length_889_cov_30.012658	311	391	0	80	80	1.0000000
NODE_9184_length_889_cov_30.012658	364	444	0	80	80	1.0000000
NODE_9185_length_889_cov_28.217722	413	483	0	70	70	1.0000000
NODE_9185_length_889_cov_28.217722	466	542	0	76	76	1.0000000
NODE_9186_length_889_cov_27.924051	379	449	4	14	70	0.2000000
NODE_9186_length_889_cov_27.924051	379	449	5	2	70	0.0285714
NODE_9186_length_889_cov_27.924051	379	449	8	18	70	0.2571429
NODE_9186_length_889_cov_27.924051	379	449	10	36	70	0.5142857
NODE_9186_length_889_cov_27.924051	432	512	6	33	80	0.4125000
NODE_9186_length_889_cov_27.924051	432	512	8	47	80	0.5875000
NODE_9187_length_889_cov_25.887342	227	285	0	3	58	0.0517241
NODE_9187_length_889_cov_25.887342	227	285	4	55	58	0.9482759
NODE_9187_length_889_cov_25.887342	258	337	0	10	79	0.1265823
NODE_9187_length_889_cov_25.887342	258	337	4	69	79	0.8734177
NODE_9188_length_889_cov_22.992405	451	531	0	7	80	0.0875000
NODE_9188_length_889_cov_22.992405	451	531	2	73	80	0.9125000
NODE_9188_length_889_cov_22.992405	504	584	0	40	80	0.5000000
NODE_9188_length_889_cov_22.992405	504	584	2	40	80	0.5000000
NODE_9189_length_889_cov_20.703797	331	411	2	80	80	1.0000000
NODE_9189_length_889_cov_20.703797	384	464	0	29	80	0.3625000
NODE_9189_length_889_cov_20.703797	384	464	2	51	80	0.6375000
NODE_9190_length_889_cov_20.226582	234	314	0	7	80	0.0875000
NODE_9190_length_889_cov_20.226582	234	314	4	62	80	0.7750000
NODE_9190_length_889_cov_20.226582	234	314	8	11	80	0.1375000
NODE_9190_length_889_cov_20.226582	287	367	4	67	80	0.8375000
NODE_9190_length_889_cov_20.226582	287	367	8	13	80	0.1625000
NODE_9191_length_889_cov_15.587342	407	487	2	80	80	1.0000000
NODE_9191_length_889_cov_15.587342	460	540	0	15	80	0.1875000
NODE_9191_length_889_cov_15.587342	460	540	2	65	80	0.8125000
NODE_9192_length_889_cov_12.669620	313	393	0	80	80	1.0000000
NODE_9192_length_889_cov_12.669620	366	446	0	80	80	1.0000000
NODE_9193_length_889_cov_12.198734	399	479	0	80	80	1.0000000
NODE_9193_length_889_cov_12.198734	452	532	0	80	80	1.0000000
NODE_9197_length_889_cov_3.841772	187	267	0	80	80	1.0000000
NODE_9197_length_889_cov_3.841772	240	320	0	80	80	1.0000000
NODE_9213_length_888_cov_37.102662	490	570	0	8	80	0.1000000
NODE_9213_length_888_cov_37.102662	490	570	6	72	80	0.9000000
NODE_9213_length_888_cov_37.102662	543	623	0	39	80	0.4875000
NODE_9213_length_888_cov_37.102662	543	623	6	41	80	0.5125000
NODE_9214_length_888_cov_28.230672	366	446	0	69	80	0.8625000
NODE_9214_length_888_cov_28.230672	366	446	2	4	80	0.0500000
NODE_9214_length_888_cov_28.230672	366	446	4	7	80	0.0875000
NODE_9214_length_888_cov_28.230672	419	499	0	16	80	0.2000000
NODE_9214_length_888_cov_28.230672	419	499	2	4	80	0.0500000
NODE_9214_length_888_cov_28.230672	419	499	4	60	80	0.7500000
NODE_9215_length_888_cov_25.243346	391	471	0	80	80	1.0000000
NODE_9215_length_888_cov_25.243346	444	524	0	80	80	1.0000000
NODE_9216_length_888_cov_21.045627	236	316	0	80	80	1.0000000
NODE_9216_length_888_cov_21.045627	289	367	0	78	78	1.0000000
NODE_9218_length_888_cov_13.447402	515	595	0	42	80	0.5250000
NODE_9218_length_888_cov_13.447402	515	595	6	38	80	0.4750000
NODE_9218_length_888_cov_13.447402	568	648	6	80	80	1.0000000
NODE_9219_length_888_cov_12.806084	179	259	0	45	80	0.5625000
NODE_9219_length_888_cov_12.806084	179	259	1	1	80	0.0125000
NODE_9219_length_888_cov_12.806084	179	259	2	34	80	0.4250000
NODE_9219_length_888_cov_12.806084	232	312	0	72	80	0.9000000
NODE_9219_length_888_cov_12.806084	232	312	2	8	80	0.1000000
NODE_9219_length_888_cov_12.806084	308	388	2	80	80	1.0000000
NODE_9219_length_888_cov_12.806084	361	441	0	23	80	0.2875000
NODE_9219_length_888_cov_12.806084	361	441	2	57	80	0.7125000
NODE_9220_length_888_cov_12.551331	365	445	0	42	80	0.5250000
NODE_9220_length_888_cov_12.551331	365	445	4	38	80	0.4750000
NODE_9220_length_888_cov_12.551331	418	498	4	80	80	1.0000000
NODE_9228_length_888_cov_2.041825	42	102	2	60	60	1.0000000
NODE_9237_length_887_cov_32.927665	514	594	4	46	80	0.5750000
NODE_9237_length_887_cov_32.927665	514	594	6	34	80	0.4250000
NODE_9237_length_887_cov_32.927665	567	647	0	2	80	0.0250000
NODE_9237_length_887_cov_32.927665	567	647	2	3	80	0.0375000
NODE_9237_length_887_cov_32.927665	567	647	4	1	80	0.0125000
NODE_9237_length_887_cov_32.927665	567	647	6	29	80	0.3625000
NODE_9237_length_887_cov_32.927665	567	647	8	45	80	0.5625000
NODE_9238_length_887_cov_26.920051	358	438	0	52	80	0.6500000
NODE_9238_length_887_cov_26.920051	358	438	2	28	80	0.3500000
NODE_9238_length_887_cov_26.920051	411	491	0	5	80	0.0625000
NODE_9238_length_887_cov_26.920051	411	491	2	75	80	0.9375000
NODE_9239_length_887_cov_20.714467	304	384	0	72	80	0.9000000
NODE_9239_length_887_cov_20.714467	304	384	2	8	80	0.1000000
NODE_9239_length_887_cov_20.714467	357	433	0	19	76	0.2500000
NODE_9239_length_887_cov_20.714467	357	433	2	57	76	0.7500000
NODE_9240_length_887_cov_19.771574	407	487	0	80	80	1.0000000
NODE_9240_length_887_cov_19.771574	460	540	0	80	80	1.0000000
NODE_9241_length_887_cov_14.535533	333	413	0	80	80	1.0000000
NODE_9241_length_887_cov_14.535533	386	466	0	80	80	1.0000000
NODE_9242_length_887_cov_14.114213	345	425	0	80	80	1.0000000
NODE_9242_length_887_cov_14.114213	398	478	0	80	80	1.0000000
NODE_9243_length_887_cov_9.451777	406	486	0	80	80	1.0000000
NODE_9243_length_887_cov_9.451777	459	539	0	80	80	1.0000000
NODE_9245_length_887_cov_6.656091	473	553	0	80	80	1.0000000
NODE_9245_length_887_cov_6.656091	526	606	0	80	80	1.0000000
NODE_9246_length_887_cov_4.719543	420	500	0	80	80	1.0000000
NODE_9246_length_887_cov_4.719543	473	553	0	80	80	1.0000000
NODE_9250_length_887_cov_2.583756	385	429	0	44	44	1.0000000
NODE_9250_length_887_cov_2.583756	393	428	0	35	35	1.0000000
NODE_9261_length_887_cov_1.087563	754	829	2	4	75	0.0533333
NODE_9261_length_887_cov_1.087563	754	829	4	5	75	0.0666667
NODE_9261_length_887_cov_1.087563	754	829	7	1	75	0.0133333
NODE_9261_length_887_cov_1.087563	754	829	8	6	75	0.0800000
NODE_9261_length_887_cov_1.087563	754	829	10	59	75	0.7866667
NODE_9264_length_886_cov_35.482846	365	445	0	20	80	0.2500000
NODE_9264_length_886_cov_35.482846	365	445	3	26	80	0.3250000
NODE_9264_length_886_cov_35.482846	365	445	6	34	80	0.4250000
NODE_9264_length_886_cov_35.482846	418	498	6	80	80	1.0000000
NODE_9265_length_886_cov_31.939009	438	518	0	80	80	1.0000000
NODE_9265_length_886_cov_31.939009	491	571	0	80	80	1.0000000
NODE_9266_length_886_cov_25.301144	326	406	0	33	80	0.4125000
NODE_9266_length_886_cov_25.301144	326	406	2	12	80	0.1500000
NODE_9266_length_886_cov_25.301144	326	406	4	35	80	0.4375000
NODE_9266_length_886_cov_25.301144	326	406	0	33	80	0.4125000
NODE_9266_length_886_cov_25.301144	326	406	2	12	80	0.1500000
NODE_9266_length_886_cov_25.301144	326	406	4	35	80	0.4375000
NODE_9266_length_886_cov_25.301144	379	459	2	11	80	0.1375000
NODE_9266_length_886_cov_25.301144	379	459	4	69	80	0.8625000
NODE_9266_length_886_cov_25.301144	379	459	2	11	80	0.1375000
NODE_9266_length_886_cov_25.301144	379	459	4	69	80	0.8625000
NODE_9267_length_886_cov_14.463787	327	407	0	35	80	0.4375000
NODE_9267_length_886_cov_14.463787	327	407	2	45	80	0.5625000
NODE_9267_length_886_cov_14.463787	380	460	0	68	80	0.8500000
NODE_9267_length_886_cov_14.463787	380	460	2	12	80	0.1500000
NODE_9286_length_885_cov_35.510178	373	453	0	80	80	1.0000000
NODE_9286_length_885_cov_35.510178	426	506	0	80	80	1.0000000
NODE_9287_length_885_cov_31.857506	368	448	0	44	80	0.5500000
NODE_9287_length_885_cov_31.857506	368	448	2	36	80	0.4500000
NODE_9287_length_885_cov_31.857506	421	501	2	80	80	1.0000000
NODE_9288_length_885_cov_31.195929	395	475	0	27	80	0.3375000
NODE_9288_length_885_cov_31.195929	395	475	4	53	80	0.6625000
NODE_9288_length_885_cov_31.195929	448	528	0	22	80	0.2750000
NODE_9288_length_885_cov_31.195929	448	528	4	58	80	0.7250000
NODE_9289_length_885_cov_23.735369	356	436	0	80	80	1.0000000
NODE_9289_length_885_cov_23.735369	409	489	0	80	80	1.0000000
NODE_9289_length_885_cov_23.735369	485	565	0	80	80	1.0000000
NODE_9289_length_885_cov_23.735369	538	618	0	80	80	1.0000000
NODE_9290_length_885_cov_22.174300	340	420	0	80	80	1.0000000
NODE_9290_length_885_cov_22.174300	393	473	0	80	80	1.0000000
NODE_9290_length_885_cov_22.174300	469	549	0	46	80	0.5750000
NODE_9290_length_885_cov_22.174300	469	549	4	34	80	0.4250000
NODE_9290_length_885_cov_22.174300	522	602	4	80	80	1.0000000
NODE_9291_length_885_cov_17.852417	413	493	0	80	80	1.0000000
NODE_9291_length_885_cov_17.852417	466	546	0	80	80	1.0000000
NODE_9292_length_885_cov_15.652672	346	426	0	28	80	0.3500000
NODE_9292_length_885_cov_15.652672	346	426	2	52	80	0.6500000
NODE_9292_length_885_cov_15.652672	399	479	2	80	80	1.0000000
NODE_9292_length_885_cov_15.652672	475	555	0	54	80	0.6750000
NODE_9292_length_885_cov_15.652672	475	555	2	26	80	0.3250000
NODE_9292_length_885_cov_15.652672	528	608	0	80	80	1.0000000
NODE_9293_length_885_cov_11.648855	530	610	0	80	80	1.0000000
NODE_9293_length_885_cov_11.648855	583	663	0	80	80	1.0000000
NODE_9294_length_885_cov_9.707379	611	691	0	80	80	1.0000000
NODE_9294_length_885_cov_9.707379	664	744	0	52	80	0.6500000
NODE_9294_length_885_cov_9.707379	664	744	2	28	80	0.3500000
NODE_9311_length_884_cov_73.050955	536	616	0	57	80	0.7125000
NODE_9311_length_884_cov_73.050955	536	616	4	23	80	0.2875000
NODE_9311_length_884_cov_73.050955	589	669	0	4	80	0.0500000
NODE_9311_length_884_cov_73.050955	589	669	4	76	80	0.9500000
NODE_9312_length_884_cov_28.373248	381	461	0	80	80	1.0000000
NODE_9312_length_884_cov_28.373248	434	514	0	80	80	1.0000000
NODE_9313_length_884_cov_20.649682	463	543	0	8	80	0.1000000
NODE_9313_length_884_cov_20.649682	463	543	2	18	80	0.2250000
NODE_9313_length_884_cov_20.649682	463	543	4	54	80	0.6750000
NODE_9313_length_884_cov_20.649682	516	596	0	34	80	0.4250000
NODE_9313_length_884_cov_20.649682	516	596	2	20	80	0.2500000
NODE_9313_length_884_cov_20.649682	516	596	4	26	80	0.3250000
NODE_9314_length_884_cov_13.391083	225	305	0	2	80	0.0250000
NODE_9314_length_884_cov_13.391083	225	305	6	78	80	0.9750000
NODE_9314_length_884_cov_13.391083	278	358	0	55	80	0.6875000
NODE_9314_length_884_cov_13.391083	278	358	6	25	80	0.3125000
NODE_9315_length_884_cov_9.192357	278	358	0	15	80	0.1875000
NODE_9315_length_884_cov_9.192357	278	358	6	65	80	0.8125000
NODE_9315_length_884_cov_9.192357	331	411	6	80	80	1.0000000
NODE_9315_length_884_cov_9.192357	407	487	0	74	80	0.9250000
NODE_9315_length_884_cov_9.192357	407	487	5	1	80	0.0125000
NODE_9315_length_884_cov_9.192357	407	487	6	5	80	0.0625000
NODE_9315_length_884_cov_9.192357	460	540	0	80	80	1.0000000
NODE_9335_length_883_cov_46.780612	344	424	0	80	80	1.0000000
NODE_9335_length_883_cov_46.780612	397	477	0	80	80	1.0000000
NODE_9336_length_883_cov_46.304847	387	467	0	80	80	1.0000000
NODE_9336_length_883_cov_46.304847	440	520	0	80	80	1.0000000
NODE_9337_length_883_cov_39.579082	410	490	0	80	80	1.0000000
NODE_9337_length_883_cov_39.579082	463	543	0	80	80	1.0000000
NODE_9338_length_883_cov_28.307398	379	459	0	80	80	1.0000000
NODE_9338_length_883_cov_28.307398	432	512	0	80	80	1.0000000
NODE_9339_length_883_cov_24.927296	429	509	0	10	80	0.1250000
NODE_9339_length_883_cov_24.927296	429	509	2	70	80	0.8750000
NODE_9339_length_883_cov_24.927296	482	562	0	63	80	0.7875000
NODE_9339_length_883_cov_24.927296	482	562	2	17	80	0.2125000
NODE_9341_length_883_cov_17.445153	326	406	0	8	80	0.1000000
NODE_9341_length_883_cov_17.445153	326	406	2	8	80	0.1000000
NODE_9341_length_883_cov_17.445153	326	406	5	42	80	0.5250000
NODE_9341_length_883_cov_17.445153	326	406	8	22	80	0.2750000
NODE_9341_length_883_cov_17.445153	379	459	5	5	80	0.0625000
NODE_9341_length_883_cov_17.445153	379	459	6	23	80	0.2875000
NODE_9341_length_883_cov_17.445153	379	459	8	52	80	0.6500000
NODE_9342_length_883_cov_14.660714	319	395	8	19	76	0.2500000
NODE_9342_length_883_cov_14.660714	319	395	10	7	76	0.0921053
NODE_9342_length_883_cov_14.660714	319	395	12	27	76	0.3552631
NODE_9342_length_883_cov_14.660714	319	395	14	23	76	0.3026316
NODE_9342_length_883_cov_14.660714	740	816	0	76	76	1.0000000
NODE_9343_length_883_cov_11.052296	223	303	6	80	80	1.0000000
NODE_9343_length_883_cov_11.052296	276	356	0	26	80	0.3250000
NODE_9343_length_883_cov_11.052296	276	356	6	54	80	0.6750000
NODE_9344_length_883_cov_6.873724	0	66	0	8	66	0.1212121
NODE_9344_length_883_cov_6.873724	0	66	9	3	66	0.0454545
NODE_9344_length_883_cov_6.873724	0	66	12	9	66	0.1363636
NODE_9344_length_883_cov_6.873724	0	66	18	4	66	0.0606061
NODE_9344_length_883_cov_6.873724	0	66	19	23	66	0.3484848
NODE_9344_length_883_cov_6.873724	0	66	20	19	66	0.2878788
NODE_9345_length_883_cov_3.873724	471	551	0	64	80	0.8000000
NODE_9345_length_883_cov_3.873724	471	551	2	16	80	0.2000000
NODE_9345_length_883_cov_3.873724	524	604	0	11	80	0.1375000
NODE_9345_length_883_cov_3.873724	524	604	2	69	80	0.8625000
NODE_9346_length_883_cov_3.247449	294	374	0	80	80	1.0000000
NODE_9346_length_883_cov_3.247449	347	427	0	80	80	1.0000000
NODE_9370_length_882_cov_24.241379	438	518	2	80	80	1.0000000
NODE_9370_length_882_cov_24.241379	491	571	0	22	80	0.2750000
NODE_9370_length_882_cov_24.241379	491	571	2	58	80	0.7250000
NODE_9371_length_882_cov_23.145594	355	435	0	6	80	0.0750000
NODE_9371_length_882_cov_23.145594	355	435	2	74	80	0.9250000
NODE_9371_length_882_cov_23.145594	408	488	0	42	80	0.5250000
NODE_9371_length_882_cov_23.145594	408	488	2	38	80	0.4750000
NODE_9372_length_882_cov_21.401022	335	415	0	27	80	0.3375000
NODE_9372_length_882_cov_21.401022	335	415	2	53	80	0.6625000
NODE_9372_length_882_cov_21.401022	388	468	0	34	80	0.4250000
NODE_9372_length_882_cov_21.401022	388	468	2	46	80	0.5750000
NODE_9373_length_882_cov_19.579821	456	511	0	55	55	1.0000000
NODE_9373_length_882_cov_19.579821	506	586	0	24	80	0.3000000
NODE_9373_length_882_cov_19.579821	506	586	2	2	80	0.0250000
NODE_9373_length_882_cov_19.579821	506	586	3	6	80	0.0750000
NODE_9373_length_882_cov_19.579821	506	586	9	48	80	0.6000000
NODE_9373_length_882_cov_19.579821	559	639	0	5	80	0.0625000
NODE_9373_length_882_cov_19.579821	559	639	5	1	80	0.0125000
NODE_9373_length_882_cov_19.579821	559	639	8	11	80	0.1375000
NODE_9373_length_882_cov_19.579821	559	639	9	63	80	0.7875000
NODE_9374_length_882_cov_19.342273	298	378	0	80	80	1.0000000
NODE_9374_length_882_cov_19.342273	351	431	0	80	80	1.0000000
NODE_9374_length_882_cov_19.342273	427	508	0	26	81	0.3209876
NODE_9374_length_882_cov_19.342273	427	508	2	39	81	0.4814815
NODE_9374_length_882_cov_19.342273	427	508	4	16	81	0.1975309
NODE_9374_length_882_cov_19.342273	481	561	0	10	80	0.1250000
NODE_9374_length_882_cov_19.342273	481	561	2	34	80	0.4250000
NODE_9374_length_882_cov_19.342273	481	561	4	36	80	0.4500000
NODE_9375_length_882_cov_11.873563	267	347	9	3	80	0.0375000
NODE_9375_length_882_cov_11.873563	267	347	11	4	80	0.0500000
NODE_9375_length_882_cov_11.873563	267	347	12	73	80	0.9125000
NODE_9375_length_882_cov_11.873563	320	400	0	15	80	0.1875000
NODE_9375_length_882_cov_11.873563	320	400	12	65	80	0.8125000
NODE_9376_length_882_cov_8.794381	430	510	0	80	80	1.0000000
NODE_9376_length_882_cov_8.794381	483	563	0	80	80	1.0000000
NODE_9377_length_882_cov_7.537676	527	608	0	81	81	1.0000000
NODE_9379_length_882_cov_6.696041	355	435	0	80	80	1.0000000
NODE_9379_length_882_cov_6.696041	408	488	0	80	80	1.0000000
NODE_9380_length_882_cov_4.734355	585	665	0	11	80	0.1375000
NODE_9380_length_882_cov_4.734355	585	665	2	30	80	0.3750000
NODE_9380_length_882_cov_4.734355	585	665	4	39	80	0.4875000
NODE_9380_length_882_cov_4.734355	638	718	0	64	80	0.8000000
NODE_9380_length_882_cov_4.734355	638	718	2	16	80	0.2000000
NODE_9398_length_881_cov_32.875959	444	524	0	80	80	1.0000000
NODE_9398_length_881_cov_32.875959	497	577	0	80	80	1.0000000
NODE_9399_length_881_cov_25.750639	43	117	2	64	74	0.8648649
NODE_9399_length_881_cov_25.750639	43	117	4	10	74	0.1351351
NODE_9399_length_881_cov_25.750639	116	193	4	20	77	0.2597403
NODE_9399_length_881_cov_25.750639	116	193	5	36	77	0.4675325
NODE_9399_length_881_cov_25.750639	116	193	6	21	77	0.2727273
NODE_9400_length_881_cov_23.897698	286	365	0	79	79	1.0000000
NODE_9400_length_881_cov_23.897698	338	418	0	80	80	1.0000000
NODE_9401_length_881_cov_20.656010	359	439	0	65	80	0.8125000
NODE_9401_length_881_cov_20.656010	359	439	2	15	80	0.1875000
NODE_9401_length_881_cov_20.656010	412	492	0	80	80	1.0000000
NODE_9402_length_881_cov_20.340153	242	322	0	13	80	0.1625000
NODE_9402_length_881_cov_20.340153	242	322	2	47	80	0.5875000
NODE_9402_length_881_cov_20.340153	242	322	4	20	80	0.2500000
NODE_9402_length_881_cov_20.340153	295	375	2	7	80	0.0875000
NODE_9402_length_881_cov_20.340153	295	375	4	73	80	0.9125000
NODE_9403_length_881_cov_18.234015	420	500	0	68	80	0.8500000
NODE_9403_length_881_cov_18.234015	420	500	2	12	80	0.1500000
NODE_9403_length_881_cov_18.234015	473	553	0	15	80	0.1875000
NODE_9403_length_881_cov_18.234015	473	553	2	65	80	0.8125000
NODE_9404_length_881_cov_17.748082	291	371	0	22	80	0.2750000
NODE_9404_length_881_cov_17.748082	291	371	2	58	80	0.7250000
NODE_9404_length_881_cov_17.748082	344	424	0	75	80	0.9375000
NODE_9404_length_881_cov_17.748082	344	424	2	5	80	0.0625000
NODE_9405_length_881_cov_12.884910	332	412	0	80	80	1.0000000
NODE_9405_length_881_cov_12.884910	385	465	0	80	80	1.0000000
NODE_9406_length_881_cov_6.473146	474	553	0	79	79	1.0000000
NODE_9406_length_881_cov_6.473146	514	594	0	80	80	1.0000000
NODE_9406_length_881_cov_6.473146	526	565	0	39	39	1.0000000
NODE_9406_length_881_cov_6.473146	555	606	0	51	51	1.0000000
NODE_9406_length_881_cov_6.473146	567	647	0	80	80	1.0000000
NODE_9407_length_881_cov_5.615090	547	627	0	80	80	1.0000000
NODE_9407_length_881_cov_5.615090	600	680	0	80	80	1.0000000
NODE_9424_length_880_cov_26.663252	320	400	0	75	80	0.9375000
NODE_9424_length_880_cov_26.663252	320	400	2	5	80	0.0625000
NODE_9424_length_880_cov_26.663252	373	453	0	22	80	0.2750000
NODE_9424_length_880_cov_26.663252	373	453	2	58	80	0.7250000
NODE_9425_length_880_cov_21.828425	328	408	0	16	80	0.2000000
NODE_9425_length_880_cov_21.828425	328	408	2	64	80	0.8000000
NODE_9425_length_880_cov_21.828425	381	461	0	52	80	0.6500000
NODE_9425_length_880_cov_21.828425	381	461	2	28	80	0.3500000
NODE_9426_length_880_cov_20.245839	427	507	0	80	80	1.0000000
NODE_9426_length_880_cov_20.245839	480	560	0	80	80	1.0000000
NODE_9427_length_880_cov_19.434059	0	69	0	69	69	1.0000000
NODE_9428_length_880_cov_11.843790	363	430	0	67	67	1.0000000
NODE_9429_length_880_cov_11.544174	185	265	0	74	80	0.9250000
NODE_9429_length_880_cov_11.544174	185	265	4	6	80	0.0750000
NODE_9429_length_880_cov_11.544174	238	318	0	21	80	0.2625000
NODE_9429_length_880_cov_11.544174	238	318	4	59	80	0.7375000
NODE_9430_length_880_cov_10.956466	354	434	0	80	80	1.0000000
NODE_9430_length_880_cov_10.956466	407	487	0	80	80	1.0000000
NODE_9431_length_880_cov_10.008963	395	474	0	79	79	1.0000000
NODE_9431_length_880_cov_10.008963	448	527	0	79	79	1.0000000
NODE_9453_length_879_cov_23.565385	326	406	0	80	80	1.0000000
NODE_9453_length_879_cov_23.565385	379	459	0	41	80	0.5125000
NODE_9453_length_879_cov_23.565385	379	459	2	1	80	0.0125000
NODE_9453_length_879_cov_23.565385	379	459	3	1	80	0.0125000
NODE_9453_length_879_cov_23.565385	379	459	4	18	80	0.2250000
NODE_9453_length_879_cov_23.565385	379	459	7	19	80	0.2375000
NODE_9453_length_879_cov_23.565385	455	535	7	4	80	0.0500000
NODE_9453_length_879_cov_23.565385	455	535	8	12	80	0.1500000
NODE_9453_length_879_cov_23.565385	455	535	10	1	80	0.0125000
NODE_9453_length_879_cov_23.565385	455	535	11	63	80	0.7875000
NODE_9453_length_879_cov_23.565385	508	586	4	21	78	0.2692308
NODE_9453_length_879_cov_23.565385	508	586	8	42	78	0.5384616
NODE_9453_length_879_cov_23.565385	508	586	11	15	78	0.1923077
NODE_9454_length_879_cov_20.758974	355	439	0	84	84	1.0000000
NODE_9454_length_879_cov_20.758974	412	492	0	80	80	1.0000000
NODE_9455_length_879_cov_19.685897	295	375	2	65	80	0.8125000
NODE_9455_length_879_cov_19.685897	295	375	6	15	80	0.1875000
NODE_9455_length_879_cov_19.685897	348	428	2	16	80	0.2000000
NODE_9455_length_879_cov_19.685897	348	428	5	1	80	0.0125000
NODE_9455_length_879_cov_19.685897	348	428	6	35	80	0.4375000
NODE_9455_length_879_cov_19.685897	348	428	8	28	80	0.3500000
NODE_9456_length_879_cov_17.738462	413	488	6	71	75	0.9466667
NODE_9456_length_879_cov_17.738462	413	488	7	1	75	0.0133333
NODE_9456_length_879_cov_17.738462	413	488	8	3	75	0.0400000
NODE_9456_length_879_cov_17.738462	569	649	0	59	80	0.7375000
NODE_9456_length_879_cov_17.738462	569	649	4	21	80	0.2625000
NODE_9456_length_879_cov_17.738462	569	649	0	59	80	0.7375000
NODE_9456_length_879_cov_17.738462	569	649	4	21	80	0.2625000
NODE_9456_length_879_cov_17.738462	569	649	0	59	80	0.7375000
NODE_9456_length_879_cov_17.738462	569	649	4	21	80	0.2625000
NODE_9456_length_879_cov_17.738462	622	676	0	54	54	1.0000000
NODE_9458_length_879_cov_10.756410	335	415	0	80	80	1.0000000
NODE_9458_length_879_cov_10.756410	388	468	0	80	80	1.0000000
NODE_9459_length_879_cov_7.432051	234	314	6	16	80	0.2000000
NODE_9459_length_879_cov_7.432051	234	314	8	47	80	0.5875000
NODE_9459_length_879_cov_7.432051	234	314	9	4	80	0.0500000
NODE_9459_length_879_cov_7.432051	234	314	11	6	80	0.0750000
NODE_9459_length_879_cov_7.432051	234	314	12	7	80	0.0875000
NODE_9459_length_879_cov_7.432051	288	367	3	29	79	0.3670886
NODE_9459_length_879_cov_7.432051	288	367	6	40	79	0.5063291
NODE_9459_length_879_cov_7.432051	288	367	8	10	79	0.1265823
NODE_9473_length_878_cov_230.436457	415	495	4	8	80	0.1000000
NODE_9473_length_878_cov_230.436457	415	495	6	5	80	0.0625000
NODE_9473_length_878_cov_230.436457	415	495	9	1	80	0.0125000
NODE_9473_length_878_cov_230.436457	415	495	10	66	80	0.8250000
NODE_9473_length_878_cov_230.436457	468	548	0	10	80	0.1250000
NODE_9473_length_878_cov_230.436457	468	548	2	32	80	0.4000000
NODE_9473_length_878_cov_230.436457	468	548	4	19	80	0.2375000
NODE_9473_length_878_cov_230.436457	468	548	6	5	80	0.0625000
NODE_9473_length_878_cov_230.436457	468	548	9	1	80	0.0125000
NODE_9473_length_878_cov_230.436457	468	548	10	13	80	0.1625000
NODE_9474_length_878_cov_49.514763	410	490	0	80	80	1.0000000
NODE_9474_length_878_cov_49.514763	463	543	0	80	80	1.0000000
NODE_9475_length_878_cov_38.862644	365	445	0	1	80	0.0125000
NODE_9475_length_878_cov_38.862644	365	445	2	79	80	0.9875000
NODE_9475_length_878_cov_38.862644	418	498	0	54	80	0.6750000
NODE_9475_length_878_cov_38.862644	418	498	2	26	80	0.3250000
NODE_9476_length_878_cov_36.517330	346	426	0	80	80	1.0000000
NODE_9476_length_878_cov_36.517330	399	479	0	80	80	1.0000000
NODE_9476_length_878_cov_36.517330	475	555	0	80	80	1.0000000
NODE_9476_length_878_cov_36.517330	528	608	0	80	80	1.0000000
NODE_9477_length_878_cov_34.404365	627	707	14	9	80	0.1125000
NODE_9477_length_878_cov_34.404365	627	707	16	12	80	0.1500000
NODE_9477_length_878_cov_34.404365	627	707	20	14	80	0.1750000
NODE_9477_length_878_cov_34.404365	627	707	22	2	80	0.0250000
NODE_9477_length_878_cov_34.404365	627	707	24	11	80	0.1375000
NODE_9477_length_878_cov_34.404365	627	707	25	5	80	0.0625000
NODE_9477_length_878_cov_34.404365	627	707	26	7	80	0.0875000
NODE_9477_length_878_cov_34.404365	627	707	32	20	80	0.2500000
NODE_9477_length_878_cov_34.404365	627	695	14	9	68	0.1323529
NODE_9477_length_878_cov_34.404365	627	695	16	12	68	0.1764706
NODE_9477_length_878_cov_34.404365	627	695	20	14	68	0.2058824
NODE_9477_length_878_cov_34.404365	627	695	22	2	68	0.0294118
NODE_9477_length_878_cov_34.404365	627	695	24	11	68	0.1617647
NODE_9477_length_878_cov_34.404365	627	695	25	5	68	0.0735294
NODE_9477_length_878_cov_34.404365	627	695	26	7	68	0.1029412
NODE_9477_length_878_cov_34.404365	627	695	32	8	68	0.1176471
NODE_9477_length_878_cov_34.404365	680	760	26	7	80	0.0875000
NODE_9477_length_878_cov_34.404365	680	760	32	20	80	0.2500000
NODE_9477_length_878_cov_34.404365	680	760	34	1	80	0.0125000
NODE_9477_length_878_cov_34.404365	680	760	38	5	80	0.0625000
NODE_9477_length_878_cov_34.404365	680	760	49	1	80	0.0125000
NODE_9477_length_878_cov_34.404365	680	760	51	1	80	0.0125000
NODE_9477_length_878_cov_34.404365	680	760	55	2	80	0.0250000
NODE_9477_length_878_cov_34.404365	680	760	57	1	80	0.0125000
NODE_9477_length_878_cov_34.404365	680	760	63	3	80	0.0375000
NODE_9477_length_878_cov_34.404365	680	760	65	1	80	0.0125000
NODE_9477_length_878_cov_34.404365	680	760	75	2	80	0.0250000
NODE_9477_length_878_cov_34.404365	680	760	85	3	80	0.0375000
NODE_9477_length_878_cov_34.404365	680	760	87	1	80	0.0125000
NODE_9477_length_878_cov_34.404365	680	760	89	1	80	0.0125000
NODE_9477_length_878_cov_34.404365	680	760	90	5	80	0.0625000
NODE_9477_length_878_cov_34.404365	680	760	96	1	80	0.0125000
NODE_9477_length_878_cov_34.404365	680	760	100	2	80	0.0250000
NODE_9477_length_878_cov_34.404365	680	760	101	1	80	0.0125000
NODE_9477_length_878_cov_34.404365	680	760	103	3	80	0.0375000
NODE_9477_length_878_cov_34.404365	680	760	104	1	80	0.0125000
NODE_9477_length_878_cov_34.404365	680	760	106	1	80	0.0125000
NODE_9477_length_878_cov_34.404365	680	760	107	1	80	0.0125000
NODE_9477_length_878_cov_34.404365	680	760	108	1	80	0.0125000
NODE_9477_length_878_cov_34.404365	680	760	111	1	80	0.0125000
NODE_9477_length_878_cov_34.404365	680	760	112	1	80	0.0125000
NODE_9477_length_878_cov_34.404365	680	760	118	1	80	0.0125000
NODE_9477_length_878_cov_34.404365	680	760	122	6	80	0.0750000
NODE_9477_length_878_cov_34.404365	680	760	125	3	80	0.0375000
NODE_9477_length_878_cov_34.404365	680	760	126	1	80	0.0125000
NODE_9477_length_878_cov_34.404365	680	760	127	2	80	0.0250000
NODE_9478_length_878_cov_28.761232	467	547	0	26	80	0.3250000
NODE_9478_length_878_cov_28.761232	467	547	2	54	80	0.6750000
NODE_9478_length_878_cov_28.761232	520	600	0	72	80	0.9000000
NODE_9478_length_878_cov_28.761232	520	600	2	8	80	0.1000000
NODE_9479_length_878_cov_24.899872	316	396	0	80	80	1.0000000
NODE_9479_length_878_cov_24.899872	369	449	0	80	80	1.0000000
NODE_9479_length_878_cov_24.899872	445	525	0	80	80	1.0000000
NODE_9479_length_878_cov_24.899872	498	578	0	36	80	0.4500000
NODE_9479_length_878_cov_24.899872	498	578	2	44	80	0.5500000
NODE_9480_length_878_cov_21.446727	377	457	0	21	80	0.2625000
NODE_9480_length_878_cov_21.446727	377	457	2	59	80	0.7375000
NODE_9480_length_878_cov_21.446727	430	510	0	74	80	0.9250000
NODE_9480_length_878_cov_21.446727	430	510	2	6	80	0.0750000
NODE_9481_length_878_cov_20.553273	424	504	0	34	80	0.4250000
NODE_9481_length_878_cov_20.553273	424	504	4	46	80	0.5750000
NODE_9481_length_878_cov_20.553273	477	557	4	80	80	1.0000000
NODE_9482_length_878_cov_14.016688	214	294	0	80	80	1.0000000
NODE_9482_length_878_cov_14.016688	267	347	0	80	80	1.0000000
NODE_9483_length_878_cov_9.252888	423	503	0	80	80	1.0000000
NODE_9483_length_878_cov_9.252888	476	556	0	80	80	1.0000000
NODE_9484_length_878_cov_8.695764	333	413	0	80	80	1.0000000
NODE_9484_length_878_cov_8.695764	386	466	0	80	80	1.0000000
NODE_9485_length_878_cov_6.686778	65	145	0	51	80	0.6375000
NODE_9485_length_878_cov_6.686778	65	145	4	29	80	0.3625000
NODE_9485_length_878_cov_6.686778	118	198	4	80	80	1.0000000
NODE_9487_length_878_cov_6.328626	426	506	0	80	80	1.0000000
NODE_9487_length_878_cov_6.328626	479	559	0	80	80	1.0000000
NODE_9488_length_878_cov_5.771502	470	513	0	43	43	1.0000000
NODE_9490_length_878_cov_2.672657	499	579	0	80	80	1.0000000
NODE_9490_length_878_cov_2.672657	552	631	0	79	79	1.0000000
NODE_9507_length_877_cov_59.021851	324	404	0	76	80	0.9500000
NODE_9507_length_877_cov_59.021851	324	404	2	4	80	0.0500000
NODE_9507_length_877_cov_59.021851	377	457	0	23	80	0.2875000
NODE_9507_length_877_cov_59.021851	377	457	2	57	80	0.7125000
NODE_9508_length_877_cov_54.422879	418	498	0	80	80	1.0000000
NODE_9508_length_877_cov_54.422879	471	551	0	80	80	1.0000000
NODE_9509_length_877_cov_47.672237	451	527	0	29	76	0.3815790
NODE_9509_length_877_cov_47.672237	451	527	1	47	76	0.6184211
NODE_9509_length_877_cov_47.672237	500	580	0	80	80	1.0000000
NODE_9510_length_877_cov_29.884319	349	429	0	8	80	0.1000000
NODE_9510_length_877_cov_29.884319	349	429	4	72	80	0.9000000
NODE_9510_length_877_cov_29.884319	402	482	0	24	80	0.3000000
NODE_9510_length_877_cov_29.884319	402	482	4	56	80	0.7000000
NODE_9511_length_877_cov_17.681234	423	503	4	80	80	1.0000000
NODE_9511_length_877_cov_17.681234	476	556	0	39	80	0.4875000
NODE_9511_length_877_cov_17.681234	476	556	4	41	80	0.5125000
NODE_9512_length_877_cov_17.520566	228	308	0	80	80	1.0000000
NODE_9512_length_877_cov_17.520566	281	361	0	80	80	1.0000000
NODE_9513_length_877_cov_17.374036	362	442	0	80	80	1.0000000
NODE_9513_length_877_cov_17.374036	415	495	0	36	80	0.4500000
NODE_9513_length_877_cov_17.374036	415	495	2	44	80	0.5500000
NODE_9515_length_877_cov_9.320051	395	475	0	69	80	0.8625000
NODE_9515_length_877_cov_9.320051	395	475	2	11	80	0.1375000
NODE_9515_length_877_cov_9.320051	448	528	0	16	80	0.2000000
NODE_9515_length_877_cov_9.320051	448	528	2	64	80	0.8000000
NODE_9517_length_877_cov_6.755784	222	302	0	80	80	1.0000000
NODE_9517_length_877_cov_6.755784	275	354	0	79	79	1.0000000
NODE_9537_length_876_cov_46.021879	389	469	3	1	80	0.0125000
NODE_9537_length_876_cov_46.021879	389	469	4	49	80	0.6125000
NODE_9537_length_876_cov_46.021879	389	469	7	30	80	0.3750000
NODE_9537_length_876_cov_46.021879	442	522	4	65	80	0.8125000
NODE_9537_length_876_cov_46.021879	442	522	8	15	80	0.1875000
NODE_9538_length_876_cov_34.441441	379	459	0	80	80	1.0000000
NODE_9538_length_876_cov_34.441441	432	512	0	80	80	1.0000000
NODE_9539_length_876_cov_30.742600	344	424	0	80	80	1.0000000
NODE_9539_length_876_cov_30.742600	397	477	0	80	80	1.0000000
NODE_9540_length_876_cov_28.476190	345	425	5	24	80	0.3000000
NODE_9540_length_876_cov_28.476190	345	425	7	56	80	0.7000000
NODE_9540_length_876_cov_28.476190	398	478	0	30	80	0.3750000
NODE_9540_length_876_cov_28.476190	398	478	5	47	80	0.5875000
NODE_9540_length_876_cov_28.476190	398	478	7	3	80	0.0375000
NODE_9541_length_876_cov_22.722008	324	404	0	80	80	1.0000000
NODE_9541_length_876_cov_22.722008	377	457	0	80	80	1.0000000
NODE_9542_length_876_cov_17.458172	367	447	1	2	80	0.0250000
NODE_9542_length_876_cov_17.458172	367	447	2	78	80	0.9750000
NODE_9542_length_876_cov_17.458172	420	500	1	55	80	0.6875000
NODE_9542_length_876_cov_17.458172	420	500	2	25	80	0.3125000
NODE_9561_length_875_cov_52.965206	190	270	0	80	80	1.0000000
NODE_9561_length_875_cov_52.965206	243	323	0	80	80	1.0000000
NODE_9561_length_875_cov_52.965206	319	399	0	80	80	1.0000000
NODE_9561_length_875_cov_52.965206	372	447	0	75	75	1.0000000
NODE_9562_length_875_cov_35.634021	260	340	0	80	80	1.0000000
NODE_9562_length_875_cov_35.634021	313	393	0	80	80	1.0000000
NODE_9562_length_875_cov_35.634021	389	469	0	80	80	1.0000000
NODE_9562_length_875_cov_35.634021	442	522	0	44	80	0.5500000
NODE_9562_length_875_cov_35.634021	442	522	4	36	80	0.4500000
NODE_9563_length_875_cov_33.771907	363	441	0	78	78	1.0000000
NODE_9563_length_875_cov_33.771907	414	494	0	80	80	1.0000000
NODE_9564_length_875_cov_29.698454	322	402	0	52	80	0.6500000
NODE_9564_length_875_cov_29.698454	322	402	2	28	80	0.3500000
NODE_9564_length_875_cov_29.698454	375	455	0	5	80	0.0625000
NODE_9564_length_875_cov_29.698454	375	455	2	75	80	0.9375000
NODE_9565_length_875_cov_23.041237	364	444	0	80	80	1.0000000
NODE_9565_length_875_cov_23.041237	417	497	0	80	80	1.0000000
NODE_9565_length_875_cov_23.041237	493	573	0	80	80	1.0000000
NODE_9565_length_875_cov_23.041237	546	626	0	80	80	1.0000000
NODE_9566_length_875_cov_9.800258	242	322	0	80	80	1.0000000
NODE_9566_length_875_cov_9.800258	295	376	0	81	81	1.0000000
NODE_9567_length_875_cov_8.195876	407	487	0	8	80	0.1000000
NODE_9567_length_875_cov_8.195876	407	487	1	9	80	0.1125000
NODE_9567_length_875_cov_8.195876	407	487	2	63	80	0.7875000
NODE_9567_length_875_cov_8.195876	460	540	2	48	80	0.6000000
NODE_9567_length_875_cov_8.195876	460	540	4	32	80	0.4000000
NODE_9585_length_874_cov_48.925161	185	265	0	53	80	0.6625000
NODE_9585_length_874_cov_48.925161	185	265	2	27	80	0.3375000
NODE_9585_length_874_cov_48.925161	238	318	0	80	80	1.0000000
NODE_9587_length_874_cov_37.354839	199	279	0	80	80	1.0000000
NODE_9587_length_874_cov_37.354839	252	332	0	80	80	1.0000000
NODE_9588_length_874_cov_35.040000	231	311	0	80	80	1.0000000
NODE_9588_length_874_cov_35.040000	284	364	0	80	80	1.0000000
NODE_9589_length_874_cov_23.415484	327	407	0	72	80	0.9000000
NODE_9589_length_874_cov_23.415484	327	407	2	8	80	0.1000000
NODE_9589_length_874_cov_23.415484	380	460	0	80	80	1.0000000
NODE_9589_length_874_cov_23.415484	456	536	0	80	80	1.0000000
NODE_9589_length_874_cov_23.415484	509	589	0	80	80	1.0000000
NODE_9590_length_874_cov_21.885161	279	359	2	5	80	0.0625000
NODE_9590_length_874_cov_21.885161	279	359	6	58	80	0.7250000
NODE_9590_length_874_cov_21.885161	279	359	8	17	80	0.2125000
NODE_9590_length_874_cov_21.885161	332	412	0	42	80	0.5250000
NODE_9590_length_874_cov_21.885161	332	412	6	38	80	0.4750000
NODE_9591_length_874_cov_11.172903	67	147	0	4	80	0.0500000
NODE_9591_length_874_cov_11.172903	67	147	2	76	80	0.9500000
NODE_9591_length_874_cov_11.172903	120	200	0	57	80	0.7125000
NODE_9591_length_874_cov_11.172903	120	200	2	23	80	0.2875000
NODE_9592_length_874_cov_9.645161	424	504	0	80	80	1.0000000
NODE_9592_length_874_cov_9.645161	477	557	0	80	80	1.0000000
NODE_9593_length_874_cov_8.637419	359	439	0	52	80	0.6500000
NODE_9593_length_874_cov_8.637419	359	439	2	28	80	0.3500000
NODE_9593_length_874_cov_8.637419	412	499	0	87	87	1.0000000
NODE_9596_length_874_cov_4.785806	829	874	0	13	45	0.2888889
NODE_9596_length_874_cov_4.785806	829	874	2	17	45	0.3777778
NODE_9596_length_874_cov_4.785806	829	874	4	15	45	0.3333333
NODE_9618_length_873_cov_100.625323	50	130	42	20	80	0.2500000
NODE_9618_length_873_cov_100.625323	50	130	44	60	80	0.7500000
NODE_9619_length_873_cov_45.633075	226	306	0	9	80	0.1125000
NODE_9619_length_873_cov_45.633075	226	306	1	11	80	0.1375000
NODE_9619_length_873_cov_45.633075	226	306	2	60	80	0.7500000
NODE_9619_length_873_cov_45.633075	279	359	0	62	80	0.7750000
NODE_9619_length_873_cov_45.633075	279	359	1	11	80	0.1375000
NODE_9619_length_873_cov_45.633075	279	359	2	7	80	0.0875000
NODE_9619_length_873_cov_45.633075	693	773	0	80	80	1.0000000
NODE_9619_length_873_cov_45.633075	746	826	0	80	80	1.0000000
NODE_9620_length_873_cov_39.224806	190	270	0	4	80	0.0500000
NODE_9620_length_873_cov_39.224806	190	270	1	68	80	0.8500000
NODE_9620_length_873_cov_39.224806	190	270	3	8	80	0.1000000
NODE_9620_length_873_cov_39.224806	243	307	0	41	64	0.6406250
NODE_9620_length_873_cov_39.224806	243	307	1	23	64	0.3593750
NODE_9620_length_873_cov_39.224806	390	470	2	80	80	1.0000000
NODE_9620_length_873_cov_39.224806	443	523	0	47	80	0.5875000
NODE_9620_length_873_cov_39.224806	443	523	2	33	80	0.4125000
NODE_9620_length_873_cov_39.224806	504	523	0	19	19	1.0000000
NODE_9620_length_873_cov_39.224806	519	599	0	80	80	1.0000000
NODE_9620_length_873_cov_39.224806	572	652	0	80	80	1.0000000
NODE_9621_length_873_cov_27.992248	372	452	0	80	80	1.0000000
NODE_9621_length_873_cov_27.992248	425	505	0	80	80	1.0000000
NODE_9622_length_873_cov_23.270026	390	470	0	13	80	0.1625000
NODE_9622_length_873_cov_23.270026	390	470	6	18	80	0.2250000
NODE_9622_length_873_cov_23.270026	390	470	10	49	80	0.6125000
NODE_9622_length_873_cov_23.270026	443	528	0	71	85	0.8352941
NODE_9622_length_873_cov_23.270026	443	528	6	14	85	0.1647059
NODE_9623_length_873_cov_23.197674	293	373	0	80	80	1.0000000
NODE_9623_length_873_cov_23.197674	346	426	0	80	80	1.0000000
NODE_9624_length_873_cov_20.432817	347	427	0	10	80	0.1250000
NODE_9624_length_873_cov_20.432817	347	427	4	70	80	0.8750000
NODE_9624_length_873_cov_20.432817	400	480	0	59	80	0.7375000
NODE_9624_length_873_cov_20.432817	400	480	4	21	80	0.2625000
NODE_9624_length_873_cov_20.432817	476	556	0	80	80	1.0000000
NODE_9624_length_873_cov_20.432817	529	609	0	80	80	1.0000000
NODE_9625_length_873_cov_19.913437	445	525	2	41	80	0.5125000
NODE_9625_length_873_cov_19.913437	445	525	4	22	80	0.2750000
NODE_9625_length_873_cov_19.913437	445	525	6	17	80	0.2125000
NODE_9625_length_873_cov_19.913437	498	578	4	75	80	0.9375000
NODE_9625_length_873_cov_19.913437	498	578	6	5	80	0.0625000
NODE_9626_length_873_cov_16.718346	276	356	0	20	80	0.2500000
NODE_9626_length_873_cov_16.718346	276	356	3	33	80	0.4125000
NODE_9626_length_873_cov_16.718346	276	356	4	27	80	0.3375000
NODE_9626_length_873_cov_16.718346	329	409	3	80	80	1.0000000
NODE_9627_length_873_cov_16.422481	423	503	0	80	80	1.0000000
NODE_9627_length_873_cov_16.422481	476	556	0	80	80	1.0000000
NODE_9628_length_873_cov_11.198966	410	490	0	80	80	1.0000000
NODE_9628_length_873_cov_11.198966	463	543	0	80	80	1.0000000
NODE_9629_length_873_cov_9.799742	334	414	0	49	80	0.6125000
NODE_9629_length_873_cov_9.799742	334	414	2	31	80	0.3875000
NODE_9629_length_873_cov_9.799742	387	467	0	80	80	1.0000000
NODE_9632_length_873_cov_3.828165	490	570	0	80	80	1.0000000
NODE_9632_length_873_cov_3.828165	543	583	0	40	40	1.0000000
NODE_9632_length_873_cov_3.828165	690	735	2	32	45	0.7111111
NODE_9632_length_873_cov_3.828165	690	735	3	4	45	0.0888889
NODE_9632_length_873_cov_3.828165	690	735	4	9	45	0.2000000
NODE_9633_length_873_cov_3.443152	716	746	0	30	30	1.0000000
NODE_9647_length_873_cov_1.239018	593	658	0	12	65	0.1846154
NODE_9647_length_873_cov_1.239018	593	658	2	53	65	0.8153846
NODE_9651_length_872_cov_47.732212	432	512	0	4	80	0.0500000
NODE_9651_length_872_cov_47.732212	432	512	15	1	80	0.0125000
NODE_9651_length_872_cov_47.732212	432	512	17	33	80	0.4125000
NODE_9651_length_872_cov_47.732212	432	512	18	42	80	0.5250000
NODE_9651_length_872_cov_47.732212	484	564	0	56	80	0.7000000
NODE_9651_length_872_cov_47.732212	484	564	15	1	80	0.0125000
NODE_9651_length_872_cov_47.732212	484	564	17	23	80	0.2875000
NODE_9651_length_872_cov_47.732212	560	640	0	80	80	1.0000000
NODE_9651_length_872_cov_47.732212	613	693	0	80	80	1.0000000
NODE_9652_length_872_cov_16.204398	349	429	0	80	80	1.0000000
NODE_9652_length_872_cov_16.204398	402	482	0	80	80	1.0000000
NODE_9652_length_872_cov_16.204398	478	558	0	80	80	1.0000000
NODE_9652_length_872_cov_16.204398	531	611	0	80	80	1.0000000
NODE_9653_length_872_cov_12.835705	376	456	0	80	80	1.0000000
NODE_9653_length_872_cov_12.835705	429	509	0	80	80	1.0000000
NODE_9654_length_872_cov_9.657180	356	431	0	1	75	0.0133333
NODE_9654_length_872_cov_9.657180	356	431	2	74	75	0.9866667
NODE_9660_length_872_cov_3.531695	425	505	0	80	80	1.0000000
NODE_9660_length_872_cov_3.531695	478	559	0	81	81	1.0000000
NODE_9673_length_871_cov_56.841969	265	345	0	80	80	1.0000000
NODE_9673_length_871_cov_56.841969	318	398	0	63	80	0.7875000
NODE_9673_length_871_cov_56.841969	318	398	2	17	80	0.2125000
NODE_9673_length_871_cov_56.841969	394	474	2	73	80	0.9125000
NODE_9673_length_871_cov_56.841969	394	474	4	7	80	0.0875000
NODE_9673_length_871_cov_56.841969	447	527	0	21	80	0.2625000
NODE_9673_length_871_cov_56.841969	447	527	2	51	80	0.6375000
NODE_9673_length_871_cov_56.841969	447	527	4	8	80	0.1000000
NODE_9674_length_871_cov_47.528497	461	541	2	56	80	0.7000000
NODE_9674_length_871_cov_47.528497	461	541	4	24	80	0.3000000
NODE_9674_length_871_cov_47.528497	514	594	0	28	80	0.3500000
NODE_9674_length_871_cov_47.528497	514	594	2	52	80	0.6500000
NODE_9675_length_871_cov_31.145078	326	406	0	80	80	1.0000000
NODE_9675_length_871_cov_31.145078	379	459	0	31	80	0.3875000
NODE_9675_length_871_cov_31.145078	379	459	2	49	80	0.6125000
NODE_9676_length_871_cov_27.993523	379	459	0	80	80	1.0000000
NODE_9676_length_871_cov_27.993523	432	512	0	80	80	1.0000000
NODE_9677_length_871_cov_25.954663	463	543	0	51	80	0.6375000
NODE_9677_length_871_cov_25.954663	463	543	2	29	80	0.3625000
NODE_9677_length_871_cov_25.954663	516	596	0	66	80	0.8250000
NODE_9677_length_871_cov_25.954663	516	596	4	14	80	0.1750000
NODE_9678_length_871_cov_24.069948	492	558	0	66	66	1.0000000
NODE_9678_length_871_cov_24.069948	558	634	0	76	76	1.0000000
NODE_9679_length_871_cov_23.953368	445	522	35	11	77	0.1428571
NODE_9679_length_871_cov_23.953368	445	522	36	4	77	0.0519481
NODE_9679_length_871_cov_23.953368	445	522	40	3	77	0.0389610
NODE_9679_length_871_cov_23.953368	445	522	42	2	77	0.0259740
NODE_9679_length_871_cov_23.953368	445	522	44	9	77	0.1168831
NODE_9679_length_871_cov_23.953368	445	522	47	10	77	0.1298701
NODE_9679_length_871_cov_23.953368	445	522	49	6	77	0.0779221
NODE_9679_length_871_cov_23.953368	445	522	50	8	77	0.1038961
NODE_9679_length_871_cov_23.953368	445	522	52	4	77	0.0519481
NODE_9679_length_871_cov_23.953368	445	522	54	9	77	0.1168831
NODE_9679_length_871_cov_23.953368	445	522	57	1	77	0.0129870
NODE_9679_length_871_cov_23.953368	445	522	59	10	77	0.1298701
NODE_9680_length_871_cov_19.304404	335	415	0	80	80	1.0000000
NODE_9680_length_871_cov_19.304404	388	468	0	80	80	1.0000000
NODE_9682_length_871_cov_18.108808	370	450	0	23	80	0.2875000
NODE_9682_length_871_cov_18.108808	370	450	4	9	80	0.1125000
NODE_9682_length_871_cov_18.108808	370	450	6	48	80	0.6000000
NODE_9682_length_871_cov_18.108808	423	503	0	25	80	0.3125000
NODE_9682_length_871_cov_18.108808	423	503	6	55	80	0.6875000
NODE_9683_length_871_cov_17.034974	362	442	0	80	80	1.0000000
NODE_9683_length_871_cov_17.034974	415	495	0	80	80	1.0000000
NODE_9684_length_871_cov_16.768135	374	454	6	40	80	0.5000000
NODE_9684_length_871_cov_16.768135	374	454	8	40	80	0.5000000
NODE_9685_length_871_cov_14.196891	267	347	0	31	80	0.3875000
NODE_9685_length_871_cov_14.196891	267	347	2	21	80	0.2625000
NODE_9685_length_871_cov_14.196891	267	347	4	28	80	0.3500000
NODE_9685_length_871_cov_14.196891	320	400	2	19	80	0.2375000
NODE_9685_length_871_cov_14.196891	320	400	4	61	80	0.7625000
NODE_9686_length_871_cov_13.443005	246	326	0	80	80	1.0000000
NODE_9686_length_871_cov_13.443005	299	322	0	23	23	1.0000000
NODE_9687_length_871_cov_11.839378	29	109	0	80	80	1.0000000
NODE_9687_length_871_cov_11.839378	82	149	0	67	67	1.0000000
NODE_9687_length_871_cov_11.839378	331	411	0	80	80	1.0000000
NODE_9687_length_871_cov_11.839378	384	464	0	80	80	1.0000000
NODE_9689_length_871_cov_5.730570	316	373	0	57	57	1.0000000
NODE_9694_length_871_cov_3.544041	428	508	0	80	80	1.0000000
NODE_9694_length_871_cov_3.544041	481	561	0	80	80	1.0000000
NODE_9716_length_870_cov_43.400778	542	622	14	39	80	0.4875000
NODE_9716_length_870_cov_43.400778	542	622	15	2	80	0.0250000
NODE_9716_length_870_cov_43.400778	542	622	16	2	80	0.0250000
NODE_9716_length_870_cov_43.400778	542	622	17	37	80	0.4625000
NODE_9716_length_870_cov_43.400778	595	675	0	12	80	0.1500000
NODE_9716_length_870_cov_43.400778	595	675	14	7	80	0.0875000
NODE_9716_length_870_cov_43.400778	595	675	15	10	80	0.1250000
NODE_9716_length_870_cov_43.400778	595	675	16	11	80	0.1375000
NODE_9716_length_870_cov_43.400778	595	675	17	40	80	0.5000000
NODE_9719_length_870_cov_28.249027	442	524	0	82	82	1.0000000
NODE_9719_length_870_cov_28.249027	497	577	0	80	80	1.0000000
NODE_9720_length_870_cov_26.992218	240	320	0	19	80	0.2375000
NODE_9720_length_870_cov_26.992218	240	320	2	9	80	0.1125000
NODE_9720_length_870_cov_26.992218	240	320	3	2	80	0.0250000
NODE_9720_length_870_cov_26.992218	240	320	4	16	80	0.2000000
NODE_9720_length_870_cov_26.992218	240	320	8	34	80	0.4250000
NODE_9720_length_870_cov_26.992218	293	373	8	80	80	1.0000000
NODE_9720_length_870_cov_26.992218	369	449	0	44	80	0.5500000
NODE_9720_length_870_cov_26.992218	369	449	8	36	80	0.4500000
NODE_9720_length_870_cov_26.992218	422	502	0	80	80	1.0000000
NODE_9721_length_870_cov_25.806744	186	237	4	3	51	0.0588235
NODE_9721_length_870_cov_25.806744	186	237	5	10	51	0.1960784
NODE_9721_length_870_cov_25.806744	186	237	6	33	51	0.6470588
NODE_9721_length_870_cov_25.806744	186	237	8	5	51	0.0980392
NODE_9721_length_870_cov_25.806744	391	471	0	8	80	0.1000000
NODE_9721_length_870_cov_25.806744	391	471	4	72	80	0.9000000
NODE_9721_length_870_cov_25.806744	444	524	0	61	80	0.7625000
NODE_9721_length_870_cov_25.806744	444	524	4	19	80	0.2375000
NODE_9722_length_870_cov_18.862516	345	425	0	80	80	1.0000000
NODE_9722_length_870_cov_18.862516	398	478	0	80	80	1.0000000
NODE_9723_length_870_cov_15.686122	330	410	0	80	80	1.0000000
NODE_9723_length_870_cov_15.686122	383	463	0	80	80	1.0000000
NODE_9725_length_870_cov_13.334630	479	559	0	46	80	0.5750000
NODE_9725_length_870_cov_13.334630	479	559	2	34	80	0.4250000
NODE_9725_length_870_cov_13.334630	532	612	2	80	80	1.0000000
NODE_9726_length_870_cov_9.712062	410	490	0	2	80	0.0250000
NODE_9726_length_870_cov_9.712062	410	490	2	60	80	0.7500000
NODE_9726_length_870_cov_9.712062	410	490	4	18	80	0.2250000
NODE_9726_length_870_cov_9.712062	463	542	0	54	79	0.6835443
NODE_9726_length_870_cov_9.712062	463	542	2	25	79	0.3164557
NODE_9728_length_870_cov_7.556420	448	528	0	80	80	1.0000000
NODE_9728_length_870_cov_7.556420	501	581	0	80	80	1.0000000
NODE_9746_length_869_cov_42.784416	395	475	2	50	80	0.6250000
NODE_9746_length_869_cov_42.784416	395	475	9	29	80	0.3625000
NODE_9746_length_869_cov_42.784416	395	475	10	1	80	0.0125000
NODE_9746_length_869_cov_42.784416	448	528	9	80	80	1.0000000
NODE_9747_length_869_cov_29.525974	211	291	0	80	80	1.0000000
NODE_9747_length_869_cov_29.525974	264	344	0	80	80	1.0000000
NODE_9748_length_869_cov_16.258442	389	469	0	5	80	0.0625000
NODE_9748_length_869_cov_16.258442	389	469	2	75	80	0.9375000
NODE_9748_length_869_cov_16.258442	442	522	0	22	80	0.2750000
NODE_9748_length_869_cov_16.258442	442	522	2	58	80	0.7250000
NODE_9749_length_869_cov_15.940260	321	401	0	80	80	1.0000000
NODE_9749_length_869_cov_15.940260	374	454	0	80	80	1.0000000
NODE_9750_length_869_cov_9.619481	402	442	293	1	40	0.0250000
NODE_9750_length_869_cov_9.619481	402	442	294	6	40	0.1500000
NODE_9750_length_869_cov_9.619481	402	442	295	1	40	0.0250000
NODE_9750_length_869_cov_9.619481	402	442	296	1	40	0.0250000
NODE_9750_length_869_cov_9.619481	402	442	299	4	40	0.1000000
NODE_9750_length_869_cov_9.619481	402	442	300	1	40	0.0250000
NODE_9750_length_869_cov_9.619481	402	442	301	2	40	0.0500000
NODE_9750_length_869_cov_9.619481	402	442	302	2	40	0.0500000
NODE_9750_length_869_cov_9.619481	402	442	303	2	40	0.0500000
NODE_9750_length_869_cov_9.619481	402	442	308	1	40	0.0250000
NODE_9750_length_869_cov_9.619481	402	442	310	1	40	0.0250000
NODE_9750_length_869_cov_9.619481	402	442	316	2	40	0.0500000
NODE_9750_length_869_cov_9.619481	402	442	322	1	40	0.0250000
NODE_9750_length_869_cov_9.619481	402	442	328	2	40	0.0500000
NODE_9750_length_869_cov_9.619481	402	442	329	2	40	0.0500000
NODE_9750_length_869_cov_9.619481	402	442	337	2	40	0.0500000
NODE_9750_length_869_cov_9.619481	402	442	342	1	40	0.0250000
NODE_9750_length_869_cov_9.619481	402	442	352	1	40	0.0250000
NODE_9750_length_869_cov_9.619481	402	442	354	1	40	0.0250000
NODE_9750_length_869_cov_9.619481	402	442	358	1	40	0.0250000
NODE_9750_length_869_cov_9.619481	402	442	369	1	40	0.0250000
NODE_9750_length_869_cov_9.619481	402	442	378	1	40	0.0250000
NODE_9750_length_869_cov_9.619481	402	442	385	2	40	0.0500000
NODE_9750_length_869_cov_9.619481	402	442	386	1	40	0.0250000
NODE_9751_length_869_cov_7.123377	392	472	0	80	80	1.0000000
NODE_9751_length_869_cov_7.123377	445	525	0	80	80	1.0000000
NODE_9753_length_869_cov_3.658442	310	378	0	68	68	1.0000000
NODE_9777_length_868_cov_57.465540	355	435	0	34	80	0.4250000
NODE_9777_length_868_cov_57.465540	355	435	2	24	80	0.3000000
NODE_9777_length_868_cov_57.465540	355	435	4	22	80	0.2750000
NODE_9778_length_868_cov_46.509753	0	65	0	35	65	0.5384616
NODE_9778_length_868_cov_46.509753	0	65	2	30	65	0.4615385
NODE_9778_length_868_cov_46.509753	0	65	0	35	65	0.5384616
NODE_9778_length_868_cov_46.509753	0	65	2	30	65	0.4615385
NODE_9778_length_868_cov_46.509753	0	65	0	35	65	0.5384616
NODE_9778_length_868_cov_46.509753	0	65	2	30	65	0.4615385
NODE_9778_length_868_cov_46.509753	0	65	0	35	65	0.5384616
NODE_9778_length_868_cov_46.509753	0	65	2	30	65	0.4615385
NODE_9778_length_868_cov_46.509753	61	141	0	15	80	0.1875000
NODE_9778_length_868_cov_46.509753	61	141	2	65	80	0.8125000
NODE_9778_length_868_cov_46.509753	61	141	0	15	80	0.1875000
NODE_9778_length_868_cov_46.509753	61	141	2	65	80	0.8125000
NODE_9778_length_868_cov_46.509753	114	194	0	68	80	0.8500000
NODE_9778_length_868_cov_46.509753	114	194	2	12	80	0.1500000
NODE_9778_length_868_cov_46.509753	114	194	0	68	80	0.8500000
NODE_9778_length_868_cov_46.509753	114	194	2	12	80	0.1500000
NODE_9779_length_868_cov_26.092328	318	398	0	22	80	0.2750000
NODE_9779_length_868_cov_26.092328	318	398	8	58	80	0.7250000
NODE_9779_length_868_cov_26.092328	371	451	0	31	80	0.3875000
NODE_9779_length_868_cov_26.092328	371	451	8	49	80	0.6125000
NODE_9781_length_868_cov_22.555267	377	457	2	29	80	0.3625000
NODE_9781_length_868_cov_22.555267	377	457	4	51	80	0.6375000
NODE_9781_length_868_cov_22.555267	430	510	0	33	80	0.4125000
NODE_9781_length_868_cov_22.555267	430	510	2	12	80	0.1500000
NODE_9781_length_868_cov_22.555267	430	510	3	1	80	0.0125000
NODE_9781_length_868_cov_22.555267	430	510	4	34	80	0.4250000
NODE_9782_length_868_cov_20.466840	259	339	2	80	80	1.0000000
NODE_9782_length_868_cov_20.466840	312	392	0	45	80	0.5625000
NODE_9782_length_868_cov_20.466840	312	392	2	35	80	0.4375000
NODE_9782_length_868_cov_20.466840	388	468	0	80	80	1.0000000
NODE_9782_length_868_cov_20.466840	441	521	0	80	80	1.0000000
NODE_9783_length_868_cov_20.414824	311	391	0	80	80	1.0000000
NODE_9783_length_868_cov_20.414824	364	444	0	54	80	0.6750000
NODE_9783_length_868_cov_20.414824	364	444	2	26	80	0.3250000
NODE_9784_length_868_cov_17.613784	340	420	0	80	80	1.0000000
NODE_9784_length_868_cov_17.613784	393	473	0	31	80	0.3875000
NODE_9784_length_868_cov_17.613784	393	473	3	39	80	0.4875000
NODE_9784_length_868_cov_17.613784	393	473	4	10	80	0.1250000
NODE_9785_length_868_cov_15.768531	353	433	0	56	80	0.7000000
NODE_9785_length_868_cov_15.768531	353	433	2	24	80	0.3000000
NODE_9785_length_868_cov_15.768531	406	486	0	3	80	0.0375000
NODE_9785_length_868_cov_15.768531	406	486	2	77	80	0.9625000
NODE_9786_length_868_cov_13.997399	611	691	0	80	80	1.0000000
NODE_9786_length_868_cov_13.997399	664	744	0	80	80	1.0000000
NODE_9787_length_868_cov_13.224967	451	531	0	80	80	1.0000000
NODE_9787_length_868_cov_13.224967	504	583	0	79	79	1.0000000
NODE_9788_length_868_cov_11.851756	363	422	0	59	59	1.0000000
NODE_9788_length_868_cov_11.851756	395	475	0	80	80	1.0000000
NODE_9789_length_868_cov_11.352406	361	441	2	80	80	1.0000000
NODE_9789_length_868_cov_11.352406	414	494	0	18	80	0.2250000
NODE_9789_length_868_cov_11.352406	414	494	2	62	80	0.7750000
NODE_9790_length_868_cov_11.335501	289	369	0	80	80	1.0000000
NODE_9790_length_868_cov_11.335501	342	422	0	80	80	1.0000000
NODE_9791_length_868_cov_8.455137	401	481	0	80	80	1.0000000
NODE_9791_length_868_cov_8.455137	454	534	0	80	80	1.0000000
NODE_9816_length_867_cov_27.756510	333	376	0	43	43	1.0000000
NODE_9816_length_867_cov_27.756510	349	429	0	80	80	1.0000000
NODE_9816_length_867_cov_27.756510	425	505	0	80	80	1.0000000
NODE_9816_length_867_cov_27.756510	478	542	0	64	64	1.0000000
NODE_9817_length_867_cov_25.354167	280	345	0	65	65	1.0000000
NODE_9817_length_867_cov_25.354167	325	397	0	72	72	1.0000000
NODE_9818_length_867_cov_23.968750	369	449	0	23	80	0.2875000
NODE_9818_length_867_cov_23.968750	369	449	1	2	80	0.0250000
NODE_9818_length_867_cov_23.968750	369	449	2	55	80	0.6875000
NODE_9818_length_867_cov_23.968750	422	502	0	14	80	0.1750000
NODE_9818_length_867_cov_23.968750	422	502	1	3	80	0.0375000
NODE_9818_length_867_cov_23.968750	422	502	2	63	80	0.7875000
NODE_9819_length_867_cov_21.220052	524	604	0	80	80	1.0000000
NODE_9819_length_867_cov_21.220052	577	657	0	80	80	1.0000000
NODE_9820_length_867_cov_15.042969	287	364	0	77	77	1.0000000
NODE_9821_length_867_cov_11.057292	305	373	0	68	68	1.0000000
NODE_9821_length_867_cov_11.057292	346	426	0	80	80	1.0000000
NODE_9821_length_867_cov_11.057292	475	555	0	80	80	1.0000000
NODE_9822_length_867_cov_8.127604	347	427	2	80	80	1.0000000
NODE_9822_length_867_cov_8.127604	400	480	0	46	80	0.5750000
NODE_9822_length_867_cov_8.127604	400	480	2	34	80	0.4250000
NODE_9823_length_867_cov_7.621094	292	372	0	80	80	1.0000000
NODE_9823_length_867_cov_7.621094	345	425	0	80	80	1.0000000
NODE_9826_length_867_cov_5.494792	445	525	0	80	80	1.0000000
NODE_9826_length_867_cov_5.494792	498	578	0	80	80	1.0000000
NODE_9857_length_866_cov_49.224250	269	349	7	18	80	0.2250000
NODE_9857_length_866_cov_49.224250	269	349	24	14	80	0.1750000
NODE_9857_length_866_cov_49.224250	269	349	26	15	80	0.1875000
NODE_9857_length_866_cov_49.224250	269	349	27	2	80	0.0250000
NODE_9857_length_866_cov_49.224250	269	349	33	1	80	0.0125000
NODE_9857_length_866_cov_49.224250	269	349	34	30	80	0.3750000
NODE_9857_length_866_cov_49.224250	322	402	7	15	80	0.1875000
NODE_9857_length_866_cov_49.224250	322	402	27	11	80	0.1375000
NODE_9857_length_866_cov_49.224250	322	402	33	1	80	0.0125000
NODE_9857_length_866_cov_49.224250	322	402	34	53	80	0.6625000
NODE_9858_length_866_cov_47.160365	428	508	0	80	80	1.0000000
NODE_9858_length_866_cov_47.160365	481	561	0	80	80	1.0000000
NODE_9858_length_866_cov_47.160365	557	637	0	80	80	1.0000000
NODE_9858_length_866_cov_47.160365	610	690	0	80	80	1.0000000
NODE_9859_length_866_cov_23.398957	281	361	0	80	80	1.0000000
NODE_9859_length_866_cov_23.398957	334	414	0	80	80	1.0000000
NODE_9860_length_866_cov_22.186441	455	535	0	80	80	1.0000000
NODE_9860_length_866_cov_22.186441	508	588	0	80	80	1.0000000
NODE_9861_length_866_cov_18.362451	451	531	0	80	80	1.0000000
NODE_9861_length_866_cov_18.362451	504	584	0	80	80	1.0000000
NODE_9862_length_866_cov_16.830508	372	452	0	17	80	0.2125000
NODE_9862_length_866_cov_16.830508	372	452	2	63	80	0.7875000
NODE_9862_length_866_cov_16.830508	425	505	2	80	80	1.0000000
NODE_9882_length_865_cov_63.137076	288	368	8	2	80	0.0250000
NODE_9882_length_865_cov_63.137076	288	368	14	1	80	0.0125000
NODE_9882_length_865_cov_63.137076	288	368	16	3	80	0.0375000
NODE_9882_length_865_cov_63.137076	288	368	17	5	80	0.0625000
NODE_9882_length_865_cov_63.137076	288	368	18	69	80	0.8625000
NODE_9882_length_865_cov_63.137076	341	421	0	39	80	0.4875000
NODE_9882_length_865_cov_63.137076	341	421	4	1	80	0.0125000
NODE_9882_length_865_cov_63.137076	341	421	14	14	80	0.1750000
NODE_9882_length_865_cov_63.137076	341	421	16	3	80	0.0375000
NODE_9882_length_865_cov_63.137076	341	421	18	23	80	0.2875000
NODE_9883_length_865_cov_19.882507	335	415	0	80	80	1.0000000
NODE_9883_length_865_cov_19.882507	388	468	0	80	80	1.0000000
NODE_9884_length_865_cov_17.784595	306	386	0	80	80	1.0000000
NODE_9884_length_865_cov_17.784595	359	439	0	80	80	1.0000000
NODE_9885_length_865_cov_16.150131	451	531	0	80	80	1.0000000
NODE_9885_length_865_cov_16.150131	504	584	0	80	80	1.0000000
NODE_9886_length_865_cov_14.751958	473	553	0	80	80	1.0000000
NODE_9886_length_865_cov_14.751958	473	553	0	80	80	1.0000000
NODE_9886_length_865_cov_14.751958	526	589	0	63	63	1.0000000
NODE_9886_length_865_cov_14.751958	526	606	0	80	80	1.0000000
NODE_9887_length_865_cov_10.937337	422	502	8	1	80	0.0125000
NODE_9887_length_865_cov_10.937337	422	502	9	1	80	0.0125000
NODE_9887_length_865_cov_10.937337	422	502	10	78	80	0.9750000
NODE_9887_length_865_cov_10.937337	475	555	0	53	80	0.6625000
NODE_9887_length_865_cov_10.937337	475	555	8	1	80	0.0125000
NODE_9887_length_865_cov_10.937337	475	555	9	1	80	0.0125000
NODE_9887_length_865_cov_10.937337	475	555	10	25	80	0.3125000
NODE_9889_length_865_cov_9.167102	389	469	6	80	80	1.0000000
NODE_9889_length_865_cov_9.167102	442	522	0	43	80	0.5375000
NODE_9889_length_865_cov_9.167102	442	522	6	37	80	0.4625000
NODE_9912_length_864_cov_13.398693	491	571	0	27	80	0.3375000
NODE_9912_length_864_cov_13.398693	491	571	2	53	80	0.6625000
NODE_9912_length_864_cov_13.398693	544	624	0	24	80	0.3000000
NODE_9912_length_864_cov_13.398693	544	624	1	1	80	0.0125000
NODE_9912_length_864_cov_13.398693	544	624	2	55	80	0.6875000
NODE_9913_length_864_cov_8.466667	308	388	0	80	80	1.0000000
NODE_9913_length_864_cov_8.466667	361	441	0	80	80	1.0000000
NODE_9917_length_864_cov_3.947712	651	676	2	25	25	1.0000000
NODE_9917_length_864_cov_3.947712	725	805	20	5	80	0.0625000
NODE_9917_length_864_cov_3.947712	725	805	28	3	80	0.0375000
NODE_9917_length_864_cov_3.947712	725	805	30	30	80	0.3750000
NODE_9917_length_864_cov_3.947712	725	805	33	23	80	0.2875000
NODE_9917_length_864_cov_3.947712	725	805	34	19	80	0.2375000
NODE_9917_length_864_cov_3.947712	778	844	29	19	66	0.2878788
NODE_9917_length_864_cov_3.947712	778	844	30	5	66	0.0757576
NODE_9917_length_864_cov_3.947712	778	844	32	3	66	0.0454545
NODE_9917_length_864_cov_3.947712	778	844	33	35	66	0.5303030
NODE_9917_length_864_cov_3.947712	778	844	34	4	66	0.0606061
NODE_9931_length_863_cov_72.856021	241	321	0	4	80	0.0500000
NODE_9931_length_863_cov_72.856021	241	321	2	76	80	0.9500000
NODE_9931_length_863_cov_72.856021	294	374	0	7	80	0.0875000
NODE_9931_length_863_cov_72.856021	294	374	2	73	80	0.9125000
NODE_9931_length_863_cov_72.856021	370	450	0	80	80	1.0000000
NODE_9931_length_863_cov_72.856021	423	503	0	80	80	1.0000000
NODE_9932_length_863_cov_37.130890	363	443	0	80	80	1.0000000
NODE_9932_length_863_cov_37.130890	416	496	0	58	80	0.7250000
NODE_9932_length_863_cov_37.130890	416	496	2	22	80	0.2750000
NODE_9932_length_863_cov_37.130890	492	572	0	15	80	0.1875000
NODE_9932_length_863_cov_37.130890	492	572	2	65	80	0.8125000
NODE_9932_length_863_cov_37.130890	545	617	0	56	72	0.7777778
NODE_9932_length_863_cov_37.130890	545	617	2	12	72	0.1666667
NODE_9932_length_863_cov_37.130890	545	617	4	1	72	0.0138889
NODE_9932_length_863_cov_37.130890	545	617	11	1	72	0.0138889
NODE_9932_length_863_cov_37.130890	545	617	22	1	72	0.0138889
NODE_9932_length_863_cov_37.130890	545	617	67	1	72	0.0138889
NODE_9933_length_863_cov_33.159686	287	367	0	60	80	0.7500000
NODE_9933_length_863_cov_33.159686	287	367	2	20	80	0.2500000
NODE_9933_length_863_cov_33.159686	340	420	0	7	80	0.0875000
NODE_9933_length_863_cov_33.159686	340	420	2	21	80	0.2625000
NODE_9933_length_863_cov_33.159686	340	420	4	52	80	0.6500000
NODE_9934_length_863_cov_24.714660	370	450	0	72	80	0.9000000
NODE_9934_length_863_cov_24.714660	370	450	2	8	80	0.1000000
NODE_9934_length_863_cov_24.714660	423	503	0	19	80	0.2375000
NODE_9934_length_863_cov_24.714660	423	503	2	22	80	0.2750000
NODE_9934_length_863_cov_24.714660	423	503	4	39	80	0.4875000
NODE_9935_length_863_cov_21.945026	341	421	4	38	80	0.4750000
NODE_9935_length_863_cov_21.945026	341	421	10	42	80	0.5250000
NODE_9935_length_863_cov_21.945026	394	474	0	7	80	0.0875000
NODE_9935_length_863_cov_21.945026	394	474	6	46	80	0.5750000
NODE_9935_length_863_cov_21.945026	394	474	10	27	80	0.3375000
NODE_9936_length_863_cov_19.794503	393	473	0	80	80	1.0000000
NODE_9936_length_863_cov_19.794503	446	526	0	80	80	1.0000000
NODE_9937_length_863_cov_11.778796	303	383	0	24	80	0.3000000
NODE_9937_length_863_cov_11.778796	303	383	4	56	80	0.7000000
NODE_9937_length_863_cov_11.778796	356	436	0	12	80	0.1500000
NODE_9937_length_863_cov_11.778796	356	436	4	68	80	0.8500000
NODE_9938_length_863_cov_10.026178	283	363	0	80	80	1.0000000
NODE_9938_length_863_cov_10.026178	336	416	0	80	80	1.0000000
NODE_9957_length_862_cov_46.811271	272	352	0	80	80	1.0000000
NODE_9957_length_862_cov_46.811271	325	405	0	80	80	1.0000000
NODE_9957_length_862_cov_46.811271	401	481	0	80	80	1.0000000
NODE_9957_length_862_cov_46.811271	454	534	0	80	80	1.0000000
NODE_9958_length_862_cov_34.638270	259	339	0	80	80	1.0000000
NODE_9958_length_862_cov_34.638270	312	392	0	80	80	1.0000000
NODE_9958_length_862_cov_34.638270	388	468	0	20	80	0.2500000
NODE_9958_length_862_cov_34.638270	388	468	2	60	80	0.7500000
NODE_9958_length_862_cov_34.638270	441	521	2	80	80	1.0000000
NODE_9959_length_862_cov_32.068152	468	548	2	80	80	1.0000000
NODE_9959_length_862_cov_32.068152	521	601	0	48	80	0.6000000
NODE_9959_length_862_cov_32.068152	521	601	2	32	80	0.4000000
NODE_9960_length_862_cov_23.584535	526	606	0	80	80	1.0000000
NODE_9960_length_862_cov_23.584535	579	659	0	80	80	1.0000000
NODE_9961_length_862_cov_19.980341	347	427	0	56	80	0.7000000
NODE_9961_length_862_cov_19.980341	347	427	2	24	80	0.3000000
NODE_9961_length_862_cov_19.980341	400	480	0	3	80	0.0375000
NODE_9961_length_862_cov_19.980341	400	480	2	77	80	0.9625000
NODE_9962_length_862_cov_19.079948	379	459	0	80	80	1.0000000
NODE_9962_length_862_cov_19.079948	432	512	0	80	80	1.0000000
NODE_9963_length_862_cov_18.425950	94	174	0	80	80	1.0000000
NODE_9963_length_862_cov_18.425950	147	201	0	54	54	1.0000000
NODE_9963_length_862_cov_18.425950	392	472	0	80	80	1.0000000
NODE_9963_length_862_cov_18.425950	445	525	0	80	80	1.0000000
NODE_9964_length_862_cov_11.740498	348	428	0	10	80	0.1250000
NODE_9964_length_862_cov_11.740498	348	428	6	70	80	0.8750000
NODE_9964_length_862_cov_11.740498	401	481	0	28	80	0.3500000
NODE_9964_length_862_cov_11.740498	401	481	6	52	80	0.6500000
NODE_9965_length_862_cov_11.685452	292	372	0	80	80	1.0000000
NODE_9965_length_862_cov_11.685452	345	425	0	80	80	1.0000000
NODE_9966_length_862_cov_8.259502	385	465	0	80	80	1.0000000
NODE_9966_length_862_cov_8.259502	438	518	0	80	80	1.0000000
NODE_9970_length_862_cov_2.895151	388	468	0	80	80	1.0000000
NODE_9970_length_862_cov_2.895151	441	521	0	54	80	0.6750000
NODE_9970_length_862_cov_2.895151	441	521	2	26	80	0.3250000
NODE_9984_length_861_cov_52.679790	450	530	0	65	80	0.8125000
NODE_9984_length_861_cov_52.679790	450	530	2	15	80	0.1875000
NODE_9984_length_861_cov_52.679790	503	583	0	12	80	0.1500000
NODE_9984_length_861_cov_52.679790	503	583	2	68	80	0.8500000
NODE_9985_length_861_cov_34.868766	470	550	0	46	80	0.5750000
NODE_9985_length_861_cov_34.868766	470	550	2	34	80	0.4250000
NODE_9985_length_861_cov_34.868766	523	603	0	65	80	0.8125000
NODE_9985_length_861_cov_34.868766	523	603	4	15	80	0.1875000
NODE_9986_length_861_cov_25.622047	145	225	0	58	80	0.7250000
NODE_9986_length_861_cov_25.622047	145	225	1	1	80	0.0125000
NODE_9986_length_861_cov_25.622047	145	225	2	21	80	0.2625000
NODE_9986_length_861_cov_25.622047	198	278	0	13	80	0.1625000
NODE_9986_length_861_cov_25.622047	198	278	1	1	80	0.0125000
NODE_9986_length_861_cov_25.622047	198	278	2	66	80	0.8250000
NODE_9987_length_861_cov_22.052493	401	481	0	19	80	0.2375000
NODE_9987_length_861_cov_22.052493	401	481	4	61	80	0.7625000
NODE_9987_length_861_cov_22.052493	454	534	0	72	80	0.9000000
NODE_9987_length_861_cov_22.052493	454	534	4	8	80	0.1000000
NODE_9988_length_861_cov_19.913386	400	480	0	60	80	0.7500000
NODE_9988_length_861_cov_19.913386	400	480	2	20	80	0.2500000
NODE_9988_length_861_cov_19.913386	453	533	0	7	80	0.0875000
NODE_9988_length_861_cov_19.913386	453	533	2	73	80	0.9125000
NODE_9989_length_861_cov_15.237533	492	572	0	80	80	1.0000000
NODE_9989_length_861_cov_15.237533	545	625	0	80	80	1.0000000
NODE_9990_length_861_cov_12.460630	451	531	0	80	80	1.0000000
NODE_9990_length_861_cov_12.460630	504	584	0	80	80	1.0000000
NODE_9991_length_861_cov_9.463255	446	526	0	80	80	1.0000000
NODE_9991_length_861_cov_9.463255	499	579	0	80	80	1.0000000
NODE_9992_length_861_cov_9.435696	348	423	0	75	75	1.0000000
NODE_9993_length_861_cov_7.009186	51	91	0	40	40	1.0000000
NODE_9993_length_861_cov_7.009186	185	265	0	43	80	0.5375000
NODE_9993_length_861_cov_7.009186	185	265	2	37	80	0.4625000
NODE_9993_length_861_cov_7.009186	238	318	2	80	80	1.0000000
NODE_10019_length_860_cov_54.315375	245	325	0	1	80	0.0125000
NODE_10019_length_860_cov_54.315375	245	325	2	66	80	0.8250000
NODE_10019_length_860_cov_54.315375	245	325	6	13	80	0.1625000
NODE_10019_length_860_cov_54.315375	298	378	0	1	80	0.0125000
NODE_10019_length_860_cov_54.315375	298	378	2	13	80	0.1625000
NODE_10019_length_860_cov_54.315375	298	378	6	66	80	0.8250000
NODE_10019_length_860_cov_54.315375	374	454	0	36	80	0.4500000
NODE_10019_length_860_cov_54.315375	374	454	6	44	80	0.5500000
NODE_10019_length_860_cov_54.315375	427	507	0	80	80	1.0000000
NODE_10020_length_860_cov_29.618922	356	436	0	25	80	0.3125000
NODE_10020_length_860_cov_29.618922	356	436	2	55	80	0.6875000
NODE_10020_length_860_cov_29.618922	409	489	0	78	80	0.9750000
NODE_10020_length_860_cov_29.618922	409	489	2	2	80	0.0250000
NODE_10021_length_860_cov_15.152431	393	473	0	21	80	0.2625000
NODE_10021_length_860_cov_15.152431	393	473	1	46	80	0.5750000
NODE_10021_length_860_cov_15.152431	393	473	3	5	80	0.0625000
NODE_10021_length_860_cov_15.152431	393	473	5	8	80	0.1000000
NODE_10021_length_860_cov_15.152431	446	526	1	14	80	0.1750000
NODE_10021_length_860_cov_15.152431	446	526	3	11	80	0.1375000
NODE_10021_length_860_cov_15.152431	446	526	5	55	80	0.6875000
NODE_10022_length_860_cov_11.320631	343	423	0	80	80	1.0000000
NODE_10022_length_860_cov_11.320631	396	476	0	80	80	1.0000000
NODE_10049_length_859_cov_48.173684	432	512	0	80	80	1.0000000
NODE_10049_length_859_cov_48.173684	485	565	0	80	80	1.0000000
NODE_10050_length_859_cov_24.957895	402	482	0	80	80	1.0000000
NODE_10050_length_859_cov_24.957895	455	535	0	80	80	1.0000000
NODE_10051_length_859_cov_23.431579	251	331	0	18	80	0.2250000
NODE_10051_length_859_cov_23.431579	251	331	2	52	80	0.6500000
NODE_10051_length_859_cov_23.431579	251	331	4	10	80	0.1250000
NODE_10051_length_859_cov_23.431579	304	384	2	17	80	0.2125000
NODE_10051_length_859_cov_23.431579	304	384	4	52	80	0.6500000
NODE_10051_length_859_cov_23.431579	304	384	6	6	80	0.0750000
NODE_10051_length_859_cov_23.431579	304	384	8	5	80	0.0625000
NODE_10052_length_859_cov_20.523684	341	421	0	80	80	1.0000000
NODE_10052_length_859_cov_20.523684	394	474	0	80	80	1.0000000
NODE_10053_length_859_cov_17.996053	316	396	0	80	80	1.0000000
NODE_10053_length_859_cov_17.996053	369	449	0	28	80	0.3500000
NODE_10053_length_859_cov_17.996053	369	449	2	52	80	0.6500000
NODE_10054_length_859_cov_16.757895	404	484	4	6	80	0.0750000
NODE_10054_length_859_cov_16.757895	404	484	6	74	80	0.9250000
NODE_10054_length_859_cov_16.757895	457	537	0	32	80	0.4000000
NODE_10054_length_859_cov_16.757895	457	537	4	27	80	0.3375000
NODE_10054_length_859_cov_16.757895	457	537	6	21	80	0.2625000
NODE_10055_length_859_cov_15.852632	346	426	0	16	80	0.2000000
NODE_10055_length_859_cov_15.852632	346	426	2	40	80	0.5000000
NODE_10055_length_859_cov_15.852632	346	426	4	24	80	0.3000000
NODE_10055_length_859_cov_15.852632	399	479	2	32	80	0.4000000
NODE_10055_length_859_cov_15.852632	399	479	4	48	80	0.6000000
NODE_10056_length_859_cov_11.584211	407	487	2	7	80	0.0875000
NODE_10056_length_859_cov_11.584211	407	487	8	5	80	0.0625000
NODE_10056_length_859_cov_11.584211	407	487	9	1	80	0.0125000
NODE_10056_length_859_cov_11.584211	407	487	10	67	80	0.8375000
NODE_10056_length_859_cov_11.584211	460	540	0	18	80	0.2250000
NODE_10056_length_859_cov_11.584211	460	540	2	4	80	0.0500000
NODE_10056_length_859_cov_11.584211	460	540	10	58	80	0.7250000
NODE_10057_length_859_cov_10.296053	368	448	0	16	80	0.2000000
NODE_10057_length_859_cov_10.296053	368	448	2	64	80	0.8000000
NODE_10057_length_859_cov_10.296053	421	501	2	80	80	1.0000000
NODE_10066_length_859_cov_2.359211	498	578	0	80	80	1.0000000
NODE_10066_length_859_cov_2.359211	551	631	0	80	80	1.0000000
NODE_10079_length_858_cov_54.677207	277	357	0	80	80	1.0000000
NODE_10079_length_858_cov_54.677207	330	410	0	80	80	1.0000000
NODE_10080_length_858_cov_40.584980	500	580	5	23	80	0.2875000
NODE_10080_length_858_cov_40.584980	500	580	10	57	80	0.7125000
NODE_10080_length_858_cov_40.584980	553	633	0	50	80	0.6250000
NODE_10080_length_858_cov_40.584980	553	633	3	2	80	0.0250000
NODE_10080_length_858_cov_40.584980	553	633	5	24	80	0.3000000
NODE_10080_length_858_cov_40.584980	553	633	10	4	80	0.0500000
NODE_10081_length_858_cov_30.177866	363	443	0	80	80	1.0000000
NODE_10081_length_858_cov_30.177866	416	496	0	80	80	1.0000000
NODE_10081_length_858_cov_30.177866	492	572	0	80	80	1.0000000
NODE_10081_length_858_cov_30.177866	545	625	0	80	80	1.0000000
NODE_10082_length_858_cov_18.534914	371	451	0	15	80	0.1875000
NODE_10082_length_858_cov_18.534914	371	451	2	65	80	0.8125000
NODE_10082_length_858_cov_18.534914	424	504	0	42	80	0.5250000
NODE_10082_length_858_cov_18.534914	424	504	2	38	80	0.4750000
NODE_10083_length_858_cov_15.378129	232	312	0	3	80	0.0375000
NODE_10083_length_858_cov_15.378129	232	312	2	46	80	0.5750000
NODE_10083_length_858_cov_15.378129	232	312	4	31	80	0.3875000
NODE_10083_length_858_cov_15.378129	285	365	2	80	80	1.0000000
NODE_10084_length_858_cov_12.310935	335	415	0	7	80	0.0875000
NODE_10084_length_858_cov_12.310935	335	415	1	44	80	0.5500000
NODE_10084_length_858_cov_12.310935	335	415	2	29	80	0.3625000
NODE_10084_length_858_cov_12.310935	388	468	0	60	80	0.7500000
NODE_10084_length_858_cov_12.310935	388	468	1	20	80	0.2500000
NODE_10085_length_858_cov_7.835310	396	479	0	83	83	1.0000000
NODE_10085_length_858_cov_7.835310	452	532	0	80	80	1.0000000
NODE_10088_length_858_cov_4.953887	474	554	0	80	80	1.0000000
NODE_10088_length_858_cov_4.953887	527	607	0	80	80	1.0000000
NODE_10091_length_858_cov_3.475626	428	502	0	11	74	0.1486486
NODE_10091_length_858_cov_3.475626	428	502	6	57	74	0.7702703
NODE_10091_length_858_cov_3.475626	428	502	7	6	74	0.0810811
NODE_10091_length_858_cov_3.475626	498	578	4	14	80	0.1750000
NODE_10091_length_858_cov_3.475626	498	578	5	13	80	0.1625000
NODE_10091_length_858_cov_3.475626	498	578	7	4	80	0.0500000
NODE_10091_length_858_cov_3.475626	498	578	8	45	80	0.5625000
NODE_10091_length_858_cov_3.475626	498	578	10	4	80	0.0500000
NODE_10091_length_858_cov_3.475626	551	631	4	14	80	0.1750000
NODE_10091_length_858_cov_3.475626	551	631	5	65	80	0.8125000
NODE_10091_length_858_cov_3.475626	551	631	6	1	80	0.0125000
NODE_10108_length_857_cov_33.449868	384	455	0	71	71	1.0000000
NODE_10108_length_857_cov_33.449868	437	518	0	81	81	1.0000000
NODE_10109_length_857_cov_32.527704	391	471	0	2	80	0.0250000
NODE_10109_length_857_cov_32.527704	391	471	2	7	80	0.0875000
NODE_10109_length_857_cov_32.527704	391	471	8	19	80	0.2375000
NODE_10109_length_857_cov_32.527704	391	471	9	1	80	0.0125000
NODE_10109_length_857_cov_32.527704	391	471	10	51	80	0.6375000
NODE_10109_length_857_cov_32.527704	444	524	0	13	80	0.1625000
NODE_10109_length_857_cov_32.527704	444	524	8	58	80	0.7250000
NODE_10109_length_857_cov_32.527704	444	524	10	9	80	0.1125000
NODE_10110_length_857_cov_27.853562	310	390	0	28	80	0.3500000
NODE_10110_length_857_cov_27.853562	310	390	2	52	80	0.6500000
NODE_10110_length_857_cov_27.853562	363	443	0	23	80	0.2875000
NODE_10110_length_857_cov_27.853562	363	443	2	57	80	0.7125000
NODE_10111_length_857_cov_24.654354	282	362	6	80	80	1.0000000
NODE_10111_length_857_cov_24.654354	335	415	0	33	80	0.4125000
NODE_10111_length_857_cov_24.654354	335	415	3	14	80	0.1750000
NODE_10111_length_857_cov_24.654354	335	415	6	33	80	0.4125000
NODE_10112_length_857_cov_22.604222	374	456	0	82	82	1.0000000
NODE_10112_length_857_cov_22.604222	427	509	0	82	82	1.0000000
NODE_10113_length_857_cov_17.399736	320	400	0	30	80	0.3750000
NODE_10113_length_857_cov_17.399736	320	400	4	50	80	0.6250000
NODE_10113_length_857_cov_17.399736	373	453	4	80	80	1.0000000
NODE_10114_length_857_cov_17.069921	388	468	0	27	80	0.3375000
NODE_10114_length_857_cov_17.069921	388	468	4	53	80	0.6625000
NODE_10114_length_857_cov_17.069921	441	521	4	80	80	1.0000000
NODE_10115_length_857_cov_11.816623	433	513	0	80	80	1.0000000
NODE_10115_length_857_cov_11.816623	486	566	0	80	80	1.0000000
NODE_10116_length_857_cov_6.733509	513	593	0	80	80	1.0000000
NODE_10117_length_857_cov_6.251979	298	378	0	80	80	1.0000000
NODE_10117_length_857_cov_6.251979	351	431	0	80	80	1.0000000
NODE_10118_length_857_cov_5.827177	323	403	0	80	80	1.0000000
NODE_10118_length_857_cov_5.827177	376	456	0	80	80	1.0000000
NODE_10120_length_857_cov_4.530343	362	442	0	80	80	1.0000000
NODE_10120_length_857_cov_4.530343	415	495	0	80	80	1.0000000
NODE_10128_length_857_cov_1.464380	179	249	6	11	70	0.1571429
NODE_10128_length_857_cov_1.464380	179	249	7	1	70	0.0142857
NODE_10128_length_857_cov_1.464380	179	249	8	2	70	0.0285714
NODE_10128_length_857_cov_1.464380	179	249	10	2	70	0.0285714
NODE_10128_length_857_cov_1.464380	179	249	12	9	70	0.1285714
NODE_10128_length_857_cov_1.464380	179	249	14	45	70	0.6428571
NODE_10128_length_857_cov_1.464380	222	288	6	4	66	0.0606061
NODE_10128_length_857_cov_1.464380	222	288	8	6	66	0.0909091
NODE_10128_length_857_cov_1.464380	222	288	12	11	66	0.1666667
NODE_10128_length_857_cov_1.464380	222	288	14	45	66	0.6818182
NODE_10138_length_856_cov_39.147952	157	237	0	80	80	1.0000000
NODE_10138_length_856_cov_39.147952	210	290	0	80	80	1.0000000
NODE_10138_length_856_cov_39.147952	286	366	0	80	80	1.0000000
NODE_10138_length_856_cov_39.147952	339	419	0	80	80	1.0000000
NODE_10139_length_856_cov_21.937913	353	433	0	80	80	1.0000000
NODE_10139_length_856_cov_21.937913	406	486	0	80	80	1.0000000
NODE_10140_length_856_cov_20.227213	375	459	0	84	84	1.0000000
NODE_10140_length_856_cov_20.227213	432	512	0	80	80	1.0000000
NODE_10141_length_856_cov_18.445178	340	420	0	75	80	0.9375000
NODE_10141_length_856_cov_18.445178	340	420	6	5	80	0.0625000
NODE_10141_length_856_cov_18.445178	393	473	0	22	80	0.2750000
NODE_10141_length_856_cov_18.445178	393	473	6	58	80	0.7250000
NODE_10142_length_856_cov_16.564069	462	543	0	81	81	1.0000000
NODE_10142_length_856_cov_16.564069	516	596	0	80	80	1.0000000
NODE_10142_length_856_cov_16.564069	516	593	0	77	77	1.0000000
NODE_10143_length_856_cov_15.803170	403	483	0	80	80	1.0000000
NODE_10143_length_856_cov_15.803170	456	536	0	80	80	1.0000000
NODE_10144_length_856_cov_12.904888	345	425	0	80	80	1.0000000
NODE_10144_length_856_cov_12.904888	398	478	0	80	80	1.0000000
NODE_10145_length_856_cov_9.881110	338	418	0	67	80	0.8375000
NODE_10145_length_856_cov_9.881110	338	418	2	13	80	0.1625000
NODE_10145_length_856_cov_9.881110	391	471	0	14	80	0.1750000
NODE_10145_length_856_cov_9.881110	391	471	2	66	80	0.8250000
NODE_10146_length_856_cov_5.875826	405	485	0	80	80	1.0000000
NODE_10146_length_856_cov_5.875826	458	538	0	80	80	1.0000000
NODE_10149_length_856_cov_4.821664	466	546	0	46	80	0.5750000
NODE_10149_length_856_cov_4.821664	466	546	2	34	80	0.4250000
NODE_10149_length_856_cov_4.821664	519	599	2	80	80	1.0000000
NODE_10151_length_856_cov_4.195509	248	328	0	80	80	1.0000000
NODE_10151_length_856_cov_4.195509	301	381	0	27	80	0.3375000
NODE_10151_length_856_cov_4.195509	301	381	2	53	80	0.6625000
NODE_10152_length_856_cov_3.899604	262	339	0	77	77	1.0000000
NODE_10152_length_856_cov_3.899604	312	392	0	80	80	1.0000000
NODE_10176_length_855_cov_28.312169	541	621	0	57	80	0.7125000
NODE_10176_length_855_cov_28.312169	541	621	2	23	80	0.2875000
NODE_10176_length_855_cov_28.312169	594	674	0	80	80	1.0000000
NODE_10177_length_855_cov_19.392857	692	772	0	80	80	1.0000000
NODE_10177_length_855_cov_19.392857	745	825	0	80	80	1.0000000
NODE_10178_length_855_cov_13.402116	343	423	4	43	80	0.5375000
NODE_10178_length_855_cov_13.402116	343	423	6	37	80	0.4625000
NODE_10178_length_855_cov_13.402116	396	476	2	42	80	0.5250000
NODE_10178_length_855_cov_13.402116	396	476	6	38	80	0.4750000
NODE_10179_length_855_cov_13.116402	295	375	0	80	80	1.0000000
NODE_10179_length_855_cov_13.116402	348	428	0	80	80	1.0000000
NODE_10180_length_855_cov_11.179894	360	436	0	76	76	1.0000000
NODE_10180_length_855_cov_11.179894	409	489	0	80	80	1.0000000
NODE_10183_length_855_cov_8.593915	339	419	0	80	80	1.0000000
NODE_10183_length_855_cov_8.593915	392	472	0	80	80	1.0000000
NODE_10206_length_854_cov_64.200000	586	666	0	15	80	0.1875000
NODE_10206_length_854_cov_64.200000	586	666	8	2	80	0.0250000
NODE_10206_length_854_cov_64.200000	586	666	9	16	80	0.2000000
NODE_10206_length_854_cov_64.200000	586	666	11	12	80	0.1500000
NODE_10206_length_854_cov_64.200000	586	666	13	35	80	0.4375000
NODE_10206_length_854_cov_64.200000	639	719	13	29	80	0.3625000
NODE_10206_length_854_cov_64.200000	639	719	15	6	80	0.0750000
NODE_10206_length_854_cov_64.200000	639	719	17	17	80	0.2125000
NODE_10206_length_854_cov_64.200000	639	719	19	22	80	0.2750000
NODE_10206_length_854_cov_64.200000	639	719	21	6	80	0.0750000
NODE_10207_length_854_cov_46.037086	348	428	0	41	80	0.5125000
NODE_10207_length_854_cov_46.037086	348	428	2	39	80	0.4875000
NODE_10207_length_854_cov_46.037086	401	481	0	4	80	0.0500000
NODE_10207_length_854_cov_46.037086	401	481	2	76	80	0.9500000
NODE_10207_length_854_cov_46.037086	458	481	0	4	23	0.1739130
NODE_10207_length_854_cov_46.037086	458	481	2	19	23	0.8260869
NODE_10208_length_854_cov_45.633113	393	473	0	1	80	0.0125000
NODE_10208_length_854_cov_45.633113	393	473	9	5	80	0.0625000
NODE_10208_length_854_cov_45.633113	393	473	10	74	80	0.9250000
NODE_10208_length_854_cov_45.633113	446	526	0	14	80	0.1750000
NODE_10208_length_854_cov_45.633113	446	526	10	66	80	0.8250000
NODE_10209_length_854_cov_40.407947	489	569	2	42	80	0.5250000
NODE_10209_length_854_cov_40.407947	489	569	4	20	80	0.2500000
NODE_10209_length_854_cov_40.407947	489	569	6	14	80	0.1750000
NODE_10209_length_854_cov_40.407947	489	569	8	3	80	0.0375000
NODE_10209_length_854_cov_40.407947	489	569	10	1	80	0.0125000
NODE_10209_length_854_cov_40.407947	542	622	4	9	80	0.1125000
NODE_10209_length_854_cov_40.407947	542	622	6	14	80	0.1750000
NODE_10209_length_854_cov_40.407947	542	622	8	38	80	0.4750000
NODE_10209_length_854_cov_40.407947	542	622	10	1	80	0.0125000
NODE_10209_length_854_cov_40.407947	542	622	12	18	80	0.2250000
NODE_10210_length_854_cov_29.773510	450	530	0	9	80	0.1125000
NODE_10210_length_854_cov_29.773510	450	530	2	71	80	0.8875000
NODE_10210_length_854_cov_29.773510	503	583	0	17	80	0.2125000
NODE_10210_length_854_cov_29.773510	503	583	2	63	80	0.7875000
NODE_10211_length_854_cov_22.968212	318	398	0	71	80	0.8875000
NODE_10211_length_854_cov_22.968212	318	398	2	9	80	0.1125000
NODE_10211_length_854_cov_22.968212	371	451	0	18	80	0.2250000
NODE_10211_length_854_cov_22.968212	371	451	2	62	80	0.7750000
NODE_10212_length_854_cov_18.038411	387	467	0	73	80	0.9125000
NODE_10212_length_854_cov_18.038411	387	467	2	7	80	0.0875000
NODE_10212_length_854_cov_18.038411	440	520	0	20	80	0.2500000
NODE_10212_length_854_cov_18.038411	440	520	2	60	80	0.7500000
NODE_10213_length_854_cov_13.774834	330	410	0	9	80	0.1125000
NODE_10213_length_854_cov_13.774834	330	410	2	30	80	0.3750000
NODE_10213_length_854_cov_13.774834	330	410	4	27	80	0.3375000
NODE_10213_length_854_cov_13.774834	330	410	6	14	80	0.1750000
NODE_10213_length_854_cov_13.774834	383	463	2	22	80	0.2750000
NODE_10213_length_854_cov_13.774834	383	463	3	1	80	0.0125000
NODE_10213_length_854_cov_13.774834	383	463	4	22	80	0.2750000
NODE_10213_length_854_cov_13.774834	383	463	6	35	80	0.4375000
NODE_10214_length_854_cov_11.998675	366	446	0	80	80	1.0000000
NODE_10214_length_854_cov_11.998675	419	499	0	80	80	1.0000000
NODE_10215_length_854_cov_7.600000	298	378	0	80	80	1.0000000
NODE_10215_length_854_cov_7.600000	351	431	0	80	80	1.0000000
NODE_10218_length_854_cov_4.939073	603	633	0	1	30	0.0333333
NODE_10218_length_854_cov_4.939073	603	633	2	12	30	0.4000000
NODE_10218_length_854_cov_4.939073	603	633	6	17	30	0.5666667
NODE_10226_length_854_cov_2.354967	613	633	0	20	20	1.0000000
NODE_10239_length_853_cov_61.988064	380	460	0	80	80	1.0000000
NODE_10239_length_853_cov_61.988064	433	513	0	80	80	1.0000000
NODE_10240_length_853_cov_33.683024	384	464	1	27	80	0.3375000
NODE_10240_length_853_cov_33.683024	384	464	2	53	80	0.6625000
NODE_10240_length_853_cov_33.683024	437	517	0	49	80	0.6125000
NODE_10240_length_853_cov_33.683024	437	517	1	31	80	0.3875000
NODE_10241_length_853_cov_31.965517	224	305	0	23	81	0.2839506
NODE_10241_length_853_cov_31.965517	224	305	2	58	81	0.7160494
NODE_10241_length_853_cov_31.965517	278	358	0	76	80	0.9500000
NODE_10241_length_853_cov_31.965517	278	358	2	4	80	0.0500000
NODE_10241_length_853_cov_31.965517	354	434	0	80	80	1.0000000
NODE_10241_length_853_cov_31.965517	407	466	0	59	59	1.0000000
NODE_10242_length_853_cov_16.551724	247	327	2	19	80	0.2375000
NODE_10242_length_853_cov_16.551724	247	327	4	61	80	0.7625000
NODE_10242_length_853_cov_16.551724	300	380	0	30	80	0.3750000
NODE_10242_length_853_cov_16.551724	300	380	2	27	80	0.3375000
NODE_10242_length_853_cov_16.551724	300	380	4	23	80	0.2875000
NODE_10242_length_853_cov_16.551724	376	456	0	80	80	1.0000000
NODE_10242_length_853_cov_16.551724	429	509	0	80	80	1.0000000
NODE_10243_length_853_cov_15.395225	395	475	0	80	80	1.0000000
NODE_10243_length_853_cov_15.395225	448	528	0	80	80	1.0000000
NODE_10244_length_853_cov_15.086207	355	434	0	79	79	1.0000000
NODE_10244_length_853_cov_15.086207	408	488	0	80	80	1.0000000
NODE_10245_length_853_cov_14.929708	160	240	2	1	80	0.0125000
NODE_10245_length_853_cov_14.929708	160	240	4	47	80	0.5875000
NODE_10245_length_853_cov_14.929708	160	240	6	32	80	0.4000000
NODE_10245_length_853_cov_14.929708	213	293	0	34	80	0.4250000
NODE_10245_length_853_cov_14.929708	213	293	2	20	80	0.2500000
NODE_10245_length_853_cov_14.929708	213	293	6	26	80	0.3250000
NODE_10246_length_853_cov_11.299735	395	475	0	66	80	0.8250000
NODE_10246_length_853_cov_11.299735	395	475	2	14	80	0.1750000
NODE_10246_length_853_cov_11.299735	448	528	0	13	80	0.1625000
NODE_10246_length_853_cov_11.299735	448	528	2	67	80	0.8375000
NODE_10247_length_853_cov_9.571618	479	559	0	80	80	1.0000000
NODE_10247_length_853_cov_9.571618	532	612	0	80	80	1.0000000
NODE_10248_length_853_cov_7.828912	265	345	0	42	80	0.5250000
NODE_10248_length_853_cov_7.828912	265	345	2	38	80	0.4750000
NODE_10248_length_853_cov_7.828912	318	398	0	80	80	1.0000000
NODE_10249_length_853_cov_7.623342	255	335	0	80	80	1.0000000
NODE_10249_length_853_cov_7.623342	308	388	0	80	80	1.0000000
NODE_10253_length_853_cov_3.173740	212	292	0	7	80	0.0875000
NODE_10253_length_853_cov_3.173740	212	292	2	73	80	0.9125000
NODE_10253_length_853_cov_3.173740	265	343	0	26	78	0.3333333
NODE_10253_length_853_cov_3.173740	265	343	2	52	78	0.6666667
NODE_10258_length_853_cov_1.823607	710	773	0	63	63	1.0000000
NODE_10258_length_853_cov_1.823607	711	773	0	62	62	1.0000000
NODE_10258_length_853_cov_1.823607	711	773	0	62	62	1.0000000
NODE_10258_length_853_cov_1.823607	746	826	0	80	80	1.0000000
NODE_10267_length_852_cov_30.022576	279	359	0	80	80	1.0000000
NODE_10267_length_852_cov_30.022576	332	412	0	67	80	0.8375000
NODE_10267_length_852_cov_30.022576	332	412	2	13	80	0.1625000
NODE_10268_length_852_cov_19.373174	353	433	0	80	80	1.0000000
NODE_10268_length_852_cov_19.373174	406	486	0	80	80	1.0000000
NODE_10269_length_852_cov_18.853918	297	377	0	80	80	1.0000000
NODE_10269_length_852_cov_18.853918	350	430	0	80	80	1.0000000
NODE_10269_length_852_cov_18.853918	426	506	0	80	80	1.0000000
NODE_10269_length_852_cov_18.853918	489	559	0	70	70	1.0000000
NODE_10270_length_852_cov_17.391766	472	552	0	24	80	0.3000000
NODE_10270_length_852_cov_17.391766	472	552	2	56	80	0.7000000
NODE_10270_length_852_cov_17.391766	525	605	2	80	80	1.0000000
NODE_10271_length_852_cov_8.818061	513	593	2	13	80	0.1625000
NODE_10271_length_852_cov_8.818061	513	593	4	52	80	0.6500000
NODE_10271_length_852_cov_8.818061	513	593	6	15	80	0.1875000
NODE_10271_length_852_cov_8.818061	566	646	0	19	80	0.2375000
NODE_10271_length_852_cov_8.818061	566	646	2	47	80	0.5875000
NODE_10271_length_852_cov_8.818061	566	646	4	14	80	0.1750000
NODE_10274_length_852_cov_4.403718	493	573	0	80	80	1.0000000
NODE_10274_length_852_cov_4.403718	546	626	0	80	80	1.0000000
NODE_10285_length_851_cov_33.953457	329	409	0	62	80	0.7750000
NODE_10285_length_851_cov_33.953457	329	409	4	18	80	0.2250000
NODE_10285_length_851_cov_33.953457	382	462	0	9	80	0.1125000
NODE_10285_length_851_cov_33.953457	382	462	4	71	80	0.8875000
NODE_10286_length_851_cov_30.488032	395	475	0	80	80	1.0000000
NODE_10286_length_851_cov_30.488032	448	528	0	80	80	1.0000000
NODE_10287_length_851_cov_27.481383	353	433	0	80	80	1.0000000
NODE_10287_length_851_cov_27.481383	406	486	0	80	80	1.0000000
NODE_10288_length_851_cov_23.656915	345	425	0	57	80	0.7125000
NODE_10288_length_851_cov_23.656915	345	425	2	23	80	0.2875000
NODE_10288_length_851_cov_23.656915	398	478	0	80	80	1.0000000
NODE_10289_length_851_cov_19.769947	298	378	0	29	80	0.3625000
NODE_10289_length_851_cov_19.769947	298	378	2	51	80	0.6375000
NODE_10289_length_851_cov_19.769947	351	431	0	28	80	0.3500000
NODE_10289_length_851_cov_19.769947	351	431	2	52	80	0.6500000
NODE_10290_length_851_cov_17.386968	459	539	2	80	80	1.0000000
NODE_10290_length_851_cov_17.386968	512	592	0	36	80	0.4500000
NODE_10290_length_851_cov_17.386968	512	592	2	44	80	0.5500000
NODE_10291_length_851_cov_13.519947	323	403	0	49	80	0.6125000
NODE_10291_length_851_cov_13.519947	323	403	2	17	80	0.2125000
NODE_10291_length_851_cov_13.519947	323	403	4	14	80	0.1750000
NODE_10291_length_851_cov_13.519947	376	456	2	13	80	0.1625000
NODE_10291_length_851_cov_13.519947	376	456	4	67	80	0.8375000
NODE_10292_length_851_cov_11.771277	403	483	0	80	80	1.0000000
NODE_10292_length_851_cov_11.771277	456	536	0	80	80	1.0000000
NODE_10293_length_851_cov_11.698138	227	307	4	44	80	0.5500000
NODE_10293_length_851_cov_11.698138	227	307	6	3	80	0.0375000
NODE_10293_length_851_cov_11.698138	227	307	8	18	80	0.2250000
NODE_10293_length_851_cov_11.698138	227	307	12	15	80	0.1875000
NODE_10293_length_851_cov_11.698138	280	360	8	46	80	0.5750000
NODE_10293_length_851_cov_11.698138	280	360	12	34	80	0.4250000
NODE_10293_length_851_cov_11.698138	356	436	8	16	80	0.2000000
NODE_10293_length_851_cov_11.698138	356	436	12	46	80	0.5750000
NODE_10293_length_851_cov_11.698138	356	436	16	18	80	0.2250000
NODE_10293_length_851_cov_11.698138	409	489	0	3	80	0.0375000
NODE_10293_length_851_cov_11.698138	409	489	4	42	80	0.5250000
NODE_10293_length_851_cov_11.698138	409	489	8	24	80	0.3000000
NODE_10293_length_851_cov_11.698138	409	489	16	11	80	0.1375000
NODE_10294_length_851_cov_11.672872	372	452	0	72	80	0.9000000
NODE_10294_length_851_cov_11.672872	372	452	2	8	80	0.1000000
NODE_10294_length_851_cov_11.672872	425	505	0	32	80	0.4000000
NODE_10294_length_851_cov_11.672872	425	505	2	48	80	0.6000000
NODE_10295_length_851_cov_10.938830	418	499	0	70	81	0.8641976
NODE_10295_length_851_cov_10.938830	418	499	6	11	81	0.1358025
NODE_10296_length_851_cov_10.074468	454	534	0	47	80	0.5875000
NODE_10296_length_851_cov_10.074468	454	534	2	9	80	0.1125000
NODE_10296_length_851_cov_10.074468	454	534	4	24	80	0.3000000
NODE_10296_length_851_cov_10.074468	507	587	2	4	80	0.0500000
NODE_10296_length_851_cov_10.074468	507	587	4	76	80	0.9500000
NODE_10297_length_851_cov_7.599734	330	410	0	80	80	1.0000000
NODE_10297_length_851_cov_7.599734	383	463	0	80	80	1.0000000
NODE_10298_length_851_cov_5.639628	379	459	0	80	80	1.0000000
NODE_10298_length_851_cov_5.639628	432	512	0	80	80	1.0000000
NODE_10300_length_851_cov_3.880319	729	765	0	36	36	1.0000000
NODE_10300_length_851_cov_3.880319	743	824	0	81	81	1.0000000
NODE_10301_length_851_cov_3.823138	380	460	0	80	80	1.0000000
NODE_10301_length_851_cov_3.823138	433	513	0	80	80	1.0000000
NODE_10318_length_851_cov_1.130319	33	103	0	6	70	0.0857143
NODE_10318_length_851_cov_1.130319	33	103	2	64	70	0.9142857
NODE_10326_length_850_cov_36.527297	360	440	0	80	80	1.0000000
NODE_10326_length_850_cov_36.527297	413	493	0	80	80	1.0000000
NODE_10327_length_850_cov_31.006658	330	410	0	80	80	1.0000000
NODE_10327_length_850_cov_31.006658	383	463	0	80	80	1.0000000
NODE_10328_length_850_cov_30.460719	251	331	0	80	80	1.0000000
NODE_10328_length_850_cov_30.460719	304	384	0	80	80	1.0000000
NODE_10329_length_850_cov_25.263648	355	435	0	22	80	0.2750000
NODE_10329_length_850_cov_25.263648	355	435	10	58	80	0.7250000
NODE_10329_length_850_cov_25.263648	408	488	10	80	80	1.0000000
NODE_10330_length_850_cov_21.368842	290	370	0	80	80	1.0000000
NODE_10330_length_850_cov_21.368842	343	423	0	80	80	1.0000000
NODE_10331_length_850_cov_20.500666	318	398	2	59	80	0.7375000
NODE_10331_length_850_cov_20.500666	318	398	4	21	80	0.2625000
NODE_10331_length_850_cov_20.500666	371	451	2	17	80	0.2125000
NODE_10331_length_850_cov_20.500666	371	451	3	32	80	0.4000000
NODE_10331_length_850_cov_20.500666	371	451	4	31	80	0.3875000
NODE_10332_length_850_cov_17.268975	398	478	0	80	80	1.0000000
NODE_10332_length_850_cov_17.268975	451	531	0	80	80	1.0000000
NODE_10333_length_850_cov_14.728362	379	459	0	45	80	0.5625000
NODE_10333_length_850_cov_14.728362	379	459	2	35	80	0.4375000
NODE_10333_length_850_cov_14.728362	432	512	0	80	80	1.0000000
NODE_10334_length_850_cov_14.230360	313	393	0	80	80	1.0000000
NODE_10334_length_850_cov_14.230360	366	446	0	80	80	1.0000000
NODE_10335_length_850_cov_12.387483	337	417	0	31	80	0.3875000
NODE_10335_length_850_cov_12.387483	337	417	2	49	80	0.6125000
NODE_10335_length_850_cov_12.387483	390	470	0	26	80	0.3250000
NODE_10335_length_850_cov_12.387483	390	470	2	54	80	0.6750000
NODE_10335_length_850_cov_12.387483	466	545	0	79	79	1.0000000
NODE_10335_length_850_cov_12.387483	518	598	0	80	80	1.0000000
NODE_10336_length_850_cov_11.402130	329	409	0	80	80	1.0000000
NODE_10336_length_850_cov_11.402130	382	462	0	80	80	1.0000000
NODE_10337_length_850_cov_10.326232	330	410	0	80	80	1.0000000
NODE_10337_length_850_cov_10.326232	383	463	0	80	80	1.0000000
NODE_10338_length_850_cov_9.675100	464	544	0	20	80	0.2500000
NODE_10338_length_850_cov_9.675100	464	544	2	14	80	0.1750000
NODE_10338_length_850_cov_9.675100	464	544	4	46	80	0.5750000
NODE_10338_length_850_cov_9.675100	517	597	0	73	80	0.9125000
NODE_10338_length_850_cov_9.675100	517	597	2	7	80	0.0875000
NODE_10367_length_849_cov_43.137333	336	416	0	80	80	1.0000000
NODE_10367_length_849_cov_43.137333	389	469	0	80	80	1.0000000
NODE_10368_length_849_cov_36.562667	326	406	0	80	80	1.0000000
NODE_10368_length_849_cov_36.562667	379	459	0	80	80	1.0000000
NODE_10369_length_849_cov_35.449333	408	488	0	2	80	0.0250000
NODE_10369_length_849_cov_35.449333	408	488	2	78	80	0.9750000
NODE_10369_length_849_cov_35.449333	461	541	0	2	80	0.0250000
NODE_10369_length_849_cov_35.449333	461	541	2	78	80	0.9750000
NODE_10370_length_849_cov_29.989333	332	412	0	71	80	0.8875000
NODE_10370_length_849_cov_29.989333	332	412	4	3	80	0.0375000
NODE_10370_length_849_cov_29.989333	332	412	5	6	80	0.0750000
NODE_10370_length_849_cov_29.989333	385	465	0	18	80	0.2250000
NODE_10370_length_849_cov_29.989333	385	465	4	3	80	0.0375000
NODE_10370_length_849_cov_29.989333	385	465	5	59	80	0.7375000
NODE_10371_length_849_cov_17.974667	343	423	0	36	80	0.4500000
NODE_10371_length_849_cov_17.974667	343	423	2	44	80	0.5500000
NODE_10371_length_849_cov_17.974667	396	476	0	80	80	1.0000000
NODE_10372_length_849_cov_17.018667	360	440	0	80	80	1.0000000
NODE_10372_length_849_cov_17.018667	416	493	0	77	77	1.0000000
NODE_10373_length_849_cov_15.581333	287	367	2	15	80	0.1875000
NODE_10373_length_849_cov_15.581333	287	367	4	65	80	0.8125000
NODE_10373_length_849_cov_15.581333	340	420	0	19	80	0.2375000
NODE_10373_length_849_cov_15.581333	340	420	2	45	80	0.5625000
NODE_10373_length_849_cov_15.581333	340	420	4	16	80	0.2000000
NODE_10373_length_849_cov_15.581333	416	496	2	77	80	0.9625000
NODE_10373_length_849_cov_15.581333	416	496	4	3	80	0.0375000
NODE_10373_length_849_cov_15.581333	469	549	2	69	80	0.8625000
NODE_10373_length_849_cov_15.581333	469	549	4	11	80	0.1375000
NODE_10374_length_849_cov_9.460000	370	450	0	80	80	1.0000000
NODE_10374_length_849_cov_9.460000	423	503	0	80	80	1.0000000
NODE_10375_length_849_cov_4.893333	427	507	0	80	80	1.0000000
NODE_10375_length_849_cov_4.893333	480	560	0	80	80	1.0000000
NODE_10376_length_849_cov_4.860000	380	460	0	80	80	1.0000000
NODE_10376_length_849_cov_4.860000	433	513	0	80	80	1.0000000
NODE_10379_length_849_cov_2.761333	254	334	0	80	80	1.0000000
NODE_10396_length_848_cov_27.287049	253	333	0	80	80	1.0000000
NODE_10396_length_848_cov_27.287049	306	386	0	80	80	1.0000000
NODE_10396_length_848_cov_27.287049	382	458	0	76	76	1.0000000
NODE_10396_length_848_cov_27.287049	435	513	0	78	78	1.0000000
NODE_10397_length_848_cov_23.511348	248	328	0	45	80	0.5625000
NODE_10397_length_848_cov_23.511348	248	328	2	35	80	0.4375000
NODE_10397_length_848_cov_23.511348	301	381	2	80	80	1.0000000
NODE_10397_length_848_cov_23.511348	377	457	0	31	80	0.3875000
NODE_10397_length_848_cov_23.511348	377	457	2	49	80	0.6125000
NODE_10397_length_848_cov_23.511348	430	508	2	78	78	1.0000000
NODE_10398_length_848_cov_21.939920	295	375	0	80	80	1.0000000
NODE_10398_length_848_cov_21.939920	348	428	0	80	80	1.0000000
NODE_10399_length_848_cov_21.937250	434	514	0	54	80	0.6750000
NODE_10399_length_848_cov_21.937250	434	514	6	22	80	0.2750000
NODE_10399_length_848_cov_21.937250	434	514	11	4	80	0.0500000
NODE_10399_length_848_cov_21.937250	487	567	0	1	80	0.0125000
NODE_10399_length_848_cov_21.937250	487	567	6	22	80	0.2750000
NODE_10399_length_848_cov_21.937250	487	567	11	24	80	0.3000000
NODE_10399_length_848_cov_21.937250	487	567	12	12	80	0.1500000
NODE_10399_length_848_cov_21.937250	487	567	14	21	80	0.2625000
NODE_10400_length_848_cov_19.500668	367	392	0	25	25	1.0000000
NODE_10400_length_848_cov_19.500668	388	468	0	27	80	0.3375000
NODE_10400_length_848_cov_19.500668	388	468	4	11	80	0.1375000
NODE_10400_length_848_cov_19.500668	388	468	18	42	80	0.5250000
NODE_10400_length_848_cov_19.500668	441	521	13	4	80	0.0500000
NODE_10400_length_848_cov_19.500668	441	521	14	29	80	0.3625000
NODE_10400_length_848_cov_19.500668	441	521	18	47	80	0.5875000
NODE_10400_length_848_cov_19.500668	443	512	14	24	69	0.3478261
NODE_10400_length_848_cov_19.500668	443	512	18	45	69	0.6521739
NODE_10400_length_848_cov_19.500668	443	472	18	29	29	1.0000000
NODE_10401_length_848_cov_16.566088	323	403	0	17	80	0.2125000
NODE_10401_length_848_cov_16.566088	323	403	2	63	80	0.7875000
NODE_10401_length_848_cov_16.566088	376	456	0	39	80	0.4875000
NODE_10401_length_848_cov_16.566088	376	456	2	41	80	0.5125000
NODE_10402_length_848_cov_16.109479	256	336	2	76	80	0.9500000
NODE_10402_length_848_cov_16.109479	256	336	4	4	80	0.0500000
NODE_10402_length_848_cov_16.109479	309	389	0	10	80	0.1250000
NODE_10402_length_848_cov_16.109479	309	389	2	66	80	0.8250000
NODE_10402_length_848_cov_16.109479	309	389	4	4	80	0.0500000
NODE_10402_length_848_cov_16.109479	385	465	0	2	80	0.0250000
NODE_10402_length_848_cov_16.109479	385	465	2	3	80	0.0375000
NODE_10402_length_848_cov_16.109479	385	465	6	75	80	0.9375000
NODE_10402_length_848_cov_16.109479	438	518	4	41	80	0.5125000
NODE_10402_length_848_cov_16.109479	438	518	6	39	80	0.4875000
NODE_10403_length_848_cov_15.919893	492	568	0	76	76	1.0000000
NODE_10403_length_848_cov_15.919893	541	621	0	80	80	1.0000000
NODE_10404_length_848_cov_13.979973	269	349	0	27	80	0.3375000
NODE_10404_length_848_cov_13.979973	269	349	2	53	80	0.6625000
NODE_10404_length_848_cov_13.979973	322	402	2	80	80	1.0000000
NODE_10405_length_848_cov_13.073431	343	423	0	80	80	1.0000000
NODE_10405_length_848_cov_13.073431	396	476	0	80	80	1.0000000
NODE_10406_length_848_cov_8.523364	232	312	0	80	80	1.0000000
NODE_10406_length_848_cov_8.523364	285	365	0	80	80	1.0000000
NODE_10406_length_848_cov_8.523364	361	441	0	80	80	1.0000000
NODE_10406_length_848_cov_8.523364	414	494	0	80	80	1.0000000
NODE_10408_length_848_cov_5.903872	251	331	0	80	80	1.0000000
NODE_10408_length_848_cov_5.903872	304	383	0	79	79	1.0000000
NODE_10409_length_848_cov_5.236315	378	458	0	80	80	1.0000000
NODE_10409_length_848_cov_5.236315	431	507	0	76	76	1.0000000
NODE_10424_length_847_cov_56.417112	576	656	0	4	80	0.0500000
NODE_10424_length_847_cov_56.417112	576	656	6	2	80	0.0250000
NODE_10424_length_847_cov_56.417112	576	656	10	7	80	0.0875000
NODE_10424_length_847_cov_56.417112	576	656	16	3	80	0.0375000
NODE_10424_length_847_cov_56.417112	576	656	18	16	80	0.2000000
NODE_10424_length_847_cov_56.417112	576	656	20	10	80	0.1250000
NODE_10424_length_847_cov_56.417112	576	656	22	38	80	0.4750000
NODE_10424_length_847_cov_56.417112	629	709	0	57	80	0.7125000
NODE_10424_length_847_cov_56.417112	629	709	6	2	80	0.0250000
NODE_10424_length_847_cov_56.417112	629	709	10	7	80	0.0875000
NODE_10424_length_847_cov_56.417112	629	709	16	3	80	0.0375000
NODE_10424_length_847_cov_56.417112	629	709	20	10	80	0.1250000
NODE_10424_length_847_cov_56.417112	629	709	22	1	80	0.0125000
NODE_10425_length_847_cov_27.292781	390	470	0	60	80	0.7500000
NODE_10425_length_847_cov_27.292781	390	470	2	20	80	0.2500000
NODE_10425_length_847_cov_27.292781	443	523	0	7	80	0.0875000
NODE_10425_length_847_cov_27.292781	443	523	2	73	80	0.9125000
NODE_10426_length_847_cov_24.954545	342	422	4	80	80	1.0000000
NODE_10426_length_847_cov_24.954545	395	475	0	47	80	0.5875000
NODE_10426_length_847_cov_24.954545	395	475	4	33	80	0.4125000
NODE_10427_length_847_cov_20.310160	341	421	0	80	80	1.0000000
NODE_10427_length_847_cov_20.310160	394	474	0	80	80	1.0000000
NODE_10428_length_847_cov_19.002674	368	448	0	16	80	0.2000000
NODE_10428_length_847_cov_19.002674	368	448	2	64	80	0.8000000
NODE_10428_length_847_cov_19.002674	421	501	2	80	80	1.0000000
NODE_10429_length_847_cov_16.879679	218	298	0	7	80	0.0875000
NODE_10429_length_847_cov_16.879679	218	298	2	73	80	0.9125000
NODE_10429_length_847_cov_16.879679	271	351	0	60	80	0.7500000
NODE_10429_length_847_cov_16.879679	271	351	2	20	80	0.2500000
NODE_10431_length_847_cov_11.784759	298	378	0	49	80	0.6125000
NODE_10431_length_847_cov_11.784759	298	378	4	31	80	0.3875000
NODE_10431_length_847_cov_11.784759	351	431	4	80	80	1.0000000
NODE_10431_length_847_cov_11.784759	427	507	2	41	80	0.5125000
NODE_10431_length_847_cov_11.784759	427	507	4	31	80	0.3875000
NODE_10431_length_847_cov_11.784759	427	507	6	8	80	0.1000000
NODE_10431_length_847_cov_11.784759	480	560	2	80	80	1.0000000
NODE_10432_length_847_cov_11.604278	407	487	0	7	80	0.0875000
NODE_10432_length_847_cov_11.604278	407	487	2	73	80	0.9125000
NODE_10432_length_847_cov_11.604278	460	540	0	60	80	0.7500000
NODE_10432_length_847_cov_11.604278	460	540	2	20	80	0.2500000
NODE_10433_length_847_cov_10.221925	395	475	3	17	80	0.2125000
NODE_10433_length_847_cov_10.221925	395	475	4	31	80	0.3875000
NODE_10433_length_847_cov_10.221925	395	475	5	32	80	0.4000000
NODE_10433_length_847_cov_10.221925	448	528	3	54	80	0.6750000
NODE_10433_length_847_cov_10.221925	448	528	4	9	80	0.1125000
NODE_10433_length_847_cov_10.221925	448	528	5	17	80	0.2125000
NODE_10434_length_847_cov_4.602941	97	154	21	1	57	0.0175439
NODE_10434_length_847_cov_4.602941	97	154	23	3	57	0.0526316
NODE_10434_length_847_cov_4.602941	97	154	25	4	57	0.0701754
NODE_10434_length_847_cov_4.602941	97	154	27	6	57	0.1052632
NODE_10434_length_847_cov_4.602941	97	154	29	15	57	0.2631579
NODE_10434_length_847_cov_4.602941	97	154	32	28	57	0.4912281
NODE_10434_length_847_cov_4.602941	127	207	4	11	80	0.1375000
NODE_10434_length_847_cov_4.602941	127	207	6	21	80	0.2625000
NODE_10434_length_847_cov_4.602941	127	207	8	11	80	0.1375000
NODE_10434_length_847_cov_4.602941	127	207	10	1	80	0.0125000
NODE_10434_length_847_cov_4.602941	127	207	15	3	80	0.0375000
NODE_10434_length_847_cov_4.602941	127	207	17	4	80	0.0500000
NODE_10434_length_847_cov_4.602941	127	207	21	3	80	0.0375000
NODE_10434_length_847_cov_4.602941	127	207	23	3	80	0.0375000
NODE_10434_length_847_cov_4.602941	127	207	25	4	80	0.0500000
NODE_10434_length_847_cov_4.602941	127	207	27	6	80	0.0750000
NODE_10434_length_847_cov_4.602941	127	207	29	13	80	0.1625000
NODE_10456_length_846_cov_39.476573	336	416	0	80	80	1.0000000
NODE_10456_length_846_cov_39.476573	389	469	0	38	80	0.4750000
NODE_10456_length_846_cov_39.476573	389	469	2	42	80	0.5250000
NODE_10456_length_846_cov_39.476573	465	545	2	37	80	0.4625000
NODE_10456_length_846_cov_39.476573	465	545	14	1	80	0.0125000
NODE_10456_length_846_cov_39.476573	465	545	16	42	80	0.5250000
NODE_10456_length_846_cov_39.476573	518	598	0	10	80	0.1250000
NODE_10456_length_846_cov_39.476573	518	598	11	2	80	0.0250000
NODE_10456_length_846_cov_39.476573	518	598	12	31	80	0.3875000
NODE_10456_length_846_cov_39.476573	518	598	13	3	80	0.0375000
NODE_10456_length_846_cov_39.476573	518	598	14	8	80	0.1000000
NODE_10456_length_846_cov_39.476573	518	598	16	26	80	0.3250000
NODE_10457_length_846_cov_37.297189	312	392	2	12	80	0.1500000
NODE_10457_length_846_cov_37.297189	312	392	3	23	80	0.2875000
NODE_10457_length_846_cov_37.297189	312	392	4	13	80	0.1625000
NODE_10457_length_846_cov_37.297189	312	392	5	19	80	0.2375000
NODE_10457_length_846_cov_37.297189	312	392	6	9	80	0.1125000
NODE_10457_length_846_cov_37.297189	312	392	7	4	80	0.0500000
NODE_10457_length_846_cov_37.297189	365	445	4	35	80	0.4375000
NODE_10457_length_846_cov_37.297189	365	445	5	37	80	0.4625000
NODE_10457_length_846_cov_37.297189	365	445	6	8	80	0.1000000
NODE_10458_length_846_cov_32.852744	279	359	0	80	80	1.0000000
NODE_10458_length_846_cov_32.852744	332	412	0	80	80	1.0000000
NODE_10459_length_846_cov_31.717537	290	370	0	6	80	0.0750000
NODE_10459_length_846_cov_31.717537	290	370	2	74	80	0.9250000
NODE_10459_length_846_cov_31.717537	343	423	0	59	80	0.7375000
NODE_10459_length_846_cov_31.717537	343	423	2	21	80	0.2625000
NODE_10460_length_846_cov_24.380187	350	430	0	56	80	0.7000000
NODE_10460_length_846_cov_24.380187	350	430	2	24	80	0.3000000
NODE_10460_length_846_cov_24.380187	403	483	0	80	80	1.0000000
NODE_10461_length_846_cov_16.155288	364	444	2	23	80	0.2875000
NODE_10461_length_846_cov_16.155288	364	444	4	37	80	0.4625000
NODE_10461_length_846_cov_16.155288	364	444	6	20	80	0.2500000
NODE_10461_length_846_cov_16.155288	417	497	2	43	80	0.5375000
NODE_10461_length_846_cov_16.155288	417	497	4	37	80	0.4625000
NODE_10462_length_846_cov_15.917001	398	478	0	1	80	0.0125000
NODE_10462_length_846_cov_15.917001	398	478	3	79	80	0.9875000
NODE_10462_length_846_cov_15.917001	451	531	0	54	80	0.6750000
NODE_10462_length_846_cov_15.917001	451	531	3	26	80	0.3250000
NODE_10463_length_846_cov_15.275770	355	435	0	80	80	1.0000000
NODE_10463_length_846_cov_15.275770	408	488	0	80	80	1.0000000
NODE_10464_length_846_cov_13.618474	216	296	0	51	80	0.6375000
NODE_10464_length_846_cov_13.618474	216	296	2	29	80	0.3625000
NODE_10464_length_846_cov_13.618474	269	349	2	28	80	0.3500000
NODE_10464_length_846_cov_13.618474	269	349	8	52	80	0.6500000
NODE_10464_length_846_cov_13.618474	345	425	0	3	80	0.0375000
NODE_10464_length_846_cov_13.618474	345	425	6	44	80	0.5500000
NODE_10464_length_846_cov_13.618474	345	425	8	33	80	0.4125000
NODE_10464_length_846_cov_13.618474	398	478	0	56	80	0.7000000
NODE_10464_length_846_cov_13.618474	398	478	6	24	80	0.3000000
NODE_10465_length_846_cov_12.878179	425	505	0	80	80	1.0000000
NODE_10465_length_846_cov_12.878179	478	558	0	80	80	1.0000000
NODE_10467_length_846_cov_7.232932	407	487	0	61	80	0.7625000
NODE_10467_length_846_cov_7.232932	407	487	1	19	80	0.2375000
NODE_10467_length_846_cov_7.232932	460	540	0	80	80	1.0000000
NODE_10468_length_846_cov_6.776439	320	400	0	80	80	1.0000000
NODE_10468_length_846_cov_6.776439	373	453	0	80	80	1.0000000
NODE_10472_length_846_cov_3.025435	190	270	0	80	80	1.0000000
NODE_10472_length_846_cov_3.025435	243	323	0	80	80	1.0000000
NODE_10488_length_845_cov_34.458445	213	293	0	51	80	0.6375000
NODE_10488_length_845_cov_34.458445	213	293	2	29	80	0.3625000
NODE_10488_length_845_cov_34.458445	266	346	0	17	80	0.2125000
NODE_10488_length_845_cov_34.458445	266	346	2	63	80	0.7875000
NODE_10489_length_845_cov_33.025469	309	389	0	59	80	0.7375000
NODE_10489_length_845_cov_33.025469	309	389	2	21	80	0.2625000
NODE_10489_length_845_cov_33.025469	362	442	0	6	80	0.0750000
NODE_10489_length_845_cov_33.025469	362	442	2	74	80	0.9250000
NODE_10490_length_845_cov_30.331099	288	368	0	80	80	1.0000000
NODE_10490_length_845_cov_30.331099	341	421	0	80	80	1.0000000
NODE_10491_length_845_cov_22.042895	455	535	4	80	80	1.0000000
NODE_10491_length_845_cov_22.042895	508	588	0	28	80	0.3500000
NODE_10491_length_845_cov_22.042895	508	588	4	52	80	0.6500000
NODE_10492_length_845_cov_20.662198	325	406	0	81	81	1.0000000
NODE_10492_length_845_cov_20.662198	379	459	0	80	80	1.0000000
NODE_10493_length_845_cov_17.214477	352	432	0	33	80	0.4125000
NODE_10493_length_845_cov_17.214477	352	432	2	47	80	0.5875000
NODE_10493_length_845_cov_17.214477	405	485	0	44	80	0.5500000
NODE_10493_length_845_cov_17.214477	405	485	2	36	80	0.4500000
NODE_10494_length_845_cov_15.805630	409	489	0	31	80	0.3875000
NODE_10494_length_845_cov_15.805630	409	489	2	49	80	0.6125000
NODE_10494_length_845_cov_15.805630	462	542	0	68	80	0.8500000
NODE_10494_length_845_cov_15.805630	462	542	2	12	80	0.1500000
NODE_10495_length_845_cov_13.443700	329	409	0	80	80	1.0000000
NODE_10495_length_845_cov_13.443700	382	462	0	80	80	1.0000000
NODE_10496_length_845_cov_12.301609	334	414	0	80	80	1.0000000
NODE_10496_length_845_cov_12.301609	387	467	0	80	80	1.0000000
NODE_10497_length_845_cov_11.836461	389	469	0	30	80	0.3750000
NODE_10497_length_845_cov_11.836461	389	469	2	50	80	0.6250000
NODE_10497_length_845_cov_11.836461	442	522	2	30	80	0.3750000
NODE_10497_length_845_cov_11.836461	442	522	4	19	80	0.2375000
NODE_10497_length_845_cov_11.836461	442	522	6	31	80	0.3875000
NODE_10499_length_845_cov_8.140751	439	519	0	80	80	1.0000000
NODE_10499_length_845_cov_8.140751	492	572	0	75	80	0.9375000
NODE_10499_length_845_cov_8.140751	492	572	4	5	80	0.0625000
NODE_10516_length_845_cov_1.680965	447	491	2	44	44	1.0000000
NODE_10528_length_844_cov_43.778523	313	393	0	80	80	1.0000000
NODE_10528_length_844_cov_43.778523	366	446	0	80	80	1.0000000
NODE_10528_length_844_cov_43.778523	442	522	0	80	80	1.0000000
NODE_10528_length_844_cov_43.778523	495	575	0	80	80	1.0000000
NODE_10529_length_844_cov_36.762416	381	461	0	80	80	1.0000000
NODE_10529_length_844_cov_36.762416	434	514	0	80	80	1.0000000
NODE_10529_length_844_cov_36.762416	510	590	0	80	80	1.0000000
NODE_10529_length_844_cov_36.762416	563	644	0	81	81	1.0000000
NODE_10530_length_844_cov_35.765101	424	504	4	4	80	0.0500000
NODE_10530_length_844_cov_35.765101	424	504	8	26	80	0.3250000
NODE_10530_length_844_cov_35.765101	424	504	10	50	80	0.6250000
NODE_10530_length_844_cov_35.765101	477	557	0	22	80	0.2750000
NODE_10530_length_844_cov_35.765101	477	557	2	5	80	0.0625000
NODE_10530_length_844_cov_35.765101	477	557	4	30	80	0.3750000
NODE_10530_length_844_cov_35.765101	477	557	8	23	80	0.2875000
NODE_10531_length_844_cov_18.445638	353	420	0	67	67	1.0000000
NODE_10531_length_844_cov_18.445638	393	473	0	80	80	1.0000000
NODE_10532_length_844_cov_12.616107	363	443	0	80	80	1.0000000
NODE_10532_length_844_cov_12.616107	416	496	0	56	80	0.7000000
NODE_10532_length_844_cov_12.616107	416	496	3	24	80	0.3000000
NODE_10533_length_844_cov_12.092617	171	251	0	80	80	1.0000000
NODE_10533_length_844_cov_12.092617	224	304	0	80	80	1.0000000
NODE_10534_length_844_cov_11.883221	341	421	0	80	80	1.0000000
NODE_10534_length_844_cov_11.883221	394	474	0	80	80	1.0000000
NODE_10535_length_844_cov_10.571812	390	448	2	33	58	0.5689655
NODE_10535_length_844_cov_10.571812	390	448	4	7	58	0.1206897
NODE_10535_length_844_cov_10.571812	390	448	6	18	58	0.3103448
NODE_10537_length_844_cov_9.357047	370	450	0	29	80	0.3625000
NODE_10537_length_844_cov_9.357047	370	450	2	51	80	0.6375000
NODE_10537_length_844_cov_9.357047	423	503	0	9	80	0.1125000
NODE_10537_length_844_cov_9.357047	423	503	2	59	80	0.7375000
NODE_10537_length_844_cov_9.357047	423	503	4	12	80	0.1500000
NODE_10538_length_844_cov_8.975839	355	435	0	34	80	0.4250000
NODE_10538_length_844_cov_8.975839	355	435	2	46	80	0.5750000
NODE_10538_length_844_cov_8.975839	408	488	2	80	80	1.0000000
NODE_10539_length_844_cov_7.347651	357	438	0	81	81	1.0000000
NODE_10539_length_844_cov_7.347651	410	491	0	81	81	1.0000000
NODE_10540_length_844_cov_6.975839	444	524	0	4	80	0.0500000
NODE_10540_length_844_cov_6.975839	444	524	2	76	80	0.9500000
NODE_10540_length_844_cov_6.975839	497	577	0	57	80	0.7125000
NODE_10540_length_844_cov_6.975839	497	577	2	23	80	0.2875000
NODE_10567_length_843_cov_48.258065	203	262	244	1	59	0.0169492
NODE_10567_length_843_cov_48.258065	203	262	245	1	59	0.0169492
NODE_10567_length_843_cov_48.258065	203	262	246	1	59	0.0169492
NODE_10567_length_843_cov_48.258065	203	262	251	1	59	0.0169492
NODE_10567_length_843_cov_48.258065	203	262	252	1	59	0.0169492
NODE_10567_length_843_cov_48.258065	203	262	253	4	59	0.0677966
NODE_10567_length_843_cov_48.258065	203	262	254	6	59	0.1016949
NODE_10567_length_843_cov_48.258065	203	262	255	5	59	0.0847458
NODE_10567_length_843_cov_48.258065	203	262	257	5	59	0.0847458
NODE_10567_length_843_cov_48.258065	203	262	258	2	59	0.0338983
NODE_10567_length_843_cov_48.258065	203	262	259	3	59	0.0508475
NODE_10567_length_843_cov_48.258065	203	262	260	2	59	0.0338983
NODE_10567_length_843_cov_48.258065	203	262	262	2	59	0.0338983
NODE_10567_length_843_cov_48.258065	203	262	263	1	59	0.0169492
NODE_10567_length_843_cov_48.258065	203	262	265	1	59	0.0169492
NODE_10567_length_843_cov_48.258065	203	262	267	2	59	0.0338983
NODE_10567_length_843_cov_48.258065	203	262	268	4	59	0.0677966
NODE_10567_length_843_cov_48.258065	203	262	269	1	59	0.0169492
NODE_10567_length_843_cov_48.258065	203	262	270	2	59	0.0338983
NODE_10567_length_843_cov_48.258065	203	262	271	1	59	0.0169492
NODE_10567_length_843_cov_48.258065	203	262	272	3	59	0.0508475
NODE_10567_length_843_cov_48.258065	203	262	273	1	59	0.0169492
NODE_10567_length_843_cov_48.258065	203	262	274	1	59	0.0169492
NODE_10567_length_843_cov_48.258065	203	262	275	1	59	0.0169492
NODE_10567_length_843_cov_48.258065	203	262	277	2	59	0.0338983
NODE_10567_length_843_cov_48.258065	203	262	282	2	59	0.0338983
NODE_10567_length_843_cov_48.258065	203	262	283	2	59	0.0338983
NODE_10567_length_843_cov_48.258065	203	262	284	1	59	0.0169492
NODE_10568_length_843_cov_31.279570	351	431	0	80	80	1.0000000
NODE_10568_length_843_cov_31.279570	404	484	0	30	80	0.3750000
NODE_10568_length_843_cov_31.279570	404	484	2	50	80	0.6250000
NODE_10569_length_843_cov_27.060484	423	503	0	22	80	0.2750000
NODE_10569_length_843_cov_27.060484	423	503	4	8	80	0.1000000
NODE_10569_length_843_cov_27.060484	423	503	5	7	80	0.0875000
NODE_10569_length_843_cov_27.060484	423	503	6	43	80	0.5375000
NODE_10569_length_843_cov_27.060484	476	556	0	14	80	0.1750000
NODE_10569_length_843_cov_27.060484	476	556	3	18	80	0.2250000
NODE_10569_length_843_cov_27.060484	476	556	5	28	80	0.3500000
NODE_10569_length_843_cov_27.060484	476	556	6	20	80	0.2500000
NODE_10570_length_843_cov_22.725806	334	414	0	80	80	1.0000000
NODE_10570_length_843_cov_22.725806	339	396	0	57	57	1.0000000
NODE_10570_length_843_cov_22.725806	356	427	0	71	71	1.0000000
NODE_10570_length_843_cov_22.725806	387	455	0	68	68	1.0000000
NODE_10570_length_843_cov_22.725806	401	476	0	75	75	1.0000000
NODE_10570_length_843_cov_22.725806	418	486	0	68	68	1.0000000
NODE_10570_length_843_cov_22.725806	449	529	0	75	80	0.9375000
NODE_10570_length_843_cov_22.725806	449	529	2	5	80	0.0625000
NODE_10571_length_843_cov_22.387097	412	492	0	80	80	1.0000000
NODE_10571_length_843_cov_22.387097	465	545	0	80	80	1.0000000
NODE_10572_length_843_cov_16.326613	551	631	0	5	80	0.0625000
NODE_10572_length_843_cov_16.326613	551	631	1	29	80	0.3625000
NODE_10572_length_843_cov_16.326613	551	631	2	46	80	0.5750000
NODE_10572_length_843_cov_16.326613	604	684	0	38	80	0.4750000
NODE_10572_length_843_cov_16.326613	604	684	1	22	80	0.2750000
NODE_10572_length_843_cov_16.326613	604	684	2	20	80	0.2500000
NODE_10573_length_843_cov_13.478495	381	461	0	80	80	1.0000000
NODE_10573_length_843_cov_13.478495	434	514	0	80	80	1.0000000
NODE_10574_length_843_cov_13.150538	448	528	0	80	80	1.0000000
NODE_10574_length_843_cov_13.150538	501	581	0	80	80	1.0000000
NODE_10575_length_843_cov_12.510753	360	440	0	9	80	0.1125000
NODE_10575_length_843_cov_12.510753	360	440	2	71	80	0.8875000
NODE_10575_length_843_cov_12.510753	413	493	2	80	80	1.0000000
NODE_10576_length_843_cov_11.090054	457	537	0	80	80	1.0000000
NODE_10576_length_843_cov_11.090054	510	590	0	80	80	1.0000000
NODE_10577_length_843_cov_7.672043	472	552	0	80	80	1.0000000
NODE_10577_length_843_cov_7.672043	525	605	0	80	80	1.0000000
NODE_10601_length_842_cov_39.518170	390	470	0	33	80	0.4125000
NODE_10601_length_842_cov_39.518170	390	470	2	47	80	0.5875000
NODE_10601_length_842_cov_39.518170	443	523	0	80	80	1.0000000
NODE_10602_length_842_cov_21.567968	331	411	0	80	80	1.0000000
NODE_10602_length_842_cov_21.567968	384	464	0	80	80	1.0000000
NODE_10603_length_842_cov_19.761777	228	308	0	80	80	1.0000000
NODE_10603_length_842_cov_19.761777	281	361	0	80	80	1.0000000
NODE_10605_length_842_cov_8.703903	641	722	0	81	81	1.0000000
NODE_10608_length_842_cov_5.305518	287	367	0	13	80	0.1625000
NODE_10608_length_842_cov_5.305518	287	367	1	11	80	0.1375000
NODE_10608_length_842_cov_5.305518	287	367	2	56	80	0.7000000
NODE_10608_length_842_cov_5.305518	340	420	0	66	80	0.8250000
NODE_10608_length_842_cov_5.305518	340	420	1	11	80	0.1375000
NODE_10608_length_842_cov_5.305518	340	420	2	3	80	0.0375000
NODE_10617_length_842_cov_1.751009	35	66	0	31	31	1.0000000
NODE_10622_length_841_cov_23.815364	292	372	16	80	80	1.0000000
NODE_10622_length_841_cov_23.815364	345	425	9	17	80	0.2125000
NODE_10622_length_841_cov_23.815364	345	425	14	1	80	0.0125000
NODE_10622_length_841_cov_23.815364	345	425	15	1	80	0.0125000
NODE_10622_length_841_cov_23.815364	345	425	16	32	80	0.4000000
NODE_10622_length_841_cov_23.815364	345	425	17	29	80	0.3625000
NODE_10623_length_841_cov_18.871968	338	418	2	80	80	1.0000000
NODE_10623_length_841_cov_18.871968	391	471	0	30	80	0.3750000
NODE_10623_length_841_cov_18.871968	391	471	1	7	80	0.0875000
NODE_10623_length_841_cov_18.871968	391	471	2	43	80	0.5375000
NODE_10624_length_841_cov_14.663073	345	425	0	80	80	1.0000000
NODE_10624_length_841_cov_14.663073	398	478	0	80	80	1.0000000
NODE_10625_length_841_cov_14.149596	341	421	0	80	80	1.0000000
NODE_10625_length_841_cov_14.149596	394	474	0	80	80	1.0000000
NODE_10626_length_841_cov_12.452830	240	320	0	80	80	1.0000000
NODE_10626_length_841_cov_12.452830	293	373	0	80	80	1.0000000
NODE_10628_length_841_cov_9.925876	394	474	0	80	80	1.0000000
NODE_10628_length_841_cov_9.925876	447	527	0	80	80	1.0000000
NODE_10629_length_841_cov_7.407008	317	397	0	80	80	1.0000000
NODE_10629_length_841_cov_7.407008	370	450	0	80	80	1.0000000
NODE_10632_length_841_cov_3.865229	305	356	3	11	51	0.2156863
NODE_10632_length_841_cov_3.865229	305	356	4	40	51	0.7843137
NODE_10651_length_840_cov_63.726046	461	541	0	80	80	1.0000000
NODE_10651_length_840_cov_63.726046	514	594	0	80	80	1.0000000
NODE_10652_length_840_cov_35.874494	486	566	20	80	80	1.0000000
NODE_10652_length_840_cov_35.874494	539	619	2	19	80	0.2375000
NODE_10652_length_840_cov_35.874494	539	619	12	12	80	0.1500000
NODE_10652_length_840_cov_35.874494	539	619	20	27	80	0.3375000
NODE_10652_length_840_cov_35.874494	539	619	22	22	80	0.2750000
NODE_10653_length_840_cov_24.499325	224	304	0	80	80	1.0000000
NODE_10653_length_840_cov_24.499325	277	357	0	80	80	1.0000000
NODE_10653_length_840_cov_24.499325	353	433	0	80	80	1.0000000
NODE_10653_length_840_cov_24.499325	406	486	0	80	80	1.0000000
NODE_10654_length_840_cov_23.272605	309	389	0	80	80	1.0000000
NODE_10654_length_840_cov_23.272605	362	442	0	80	80	1.0000000
NODE_10655_length_840_cov_22.221323	293	373	0	45	80	0.5625000
NODE_10655_length_840_cov_22.221323	293	373	6	35	80	0.4375000
NODE_10655_length_840_cov_22.221323	346	426	0	13	80	0.1625000
NODE_10655_length_840_cov_22.221323	346	426	6	67	80	0.8375000
NODE_10656_length_840_cov_17.026991	348	432	0	69	84	0.8214286
NODE_10656_length_840_cov_17.026991	348	432	2	15	84	0.1785714
NODE_10656_length_840_cov_17.026991	405	485	0	12	80	0.1500000
NODE_10656_length_840_cov_17.026991	405	485	2	68	80	0.8500000
NODE_10657_length_840_cov_16.635628	347	427	0	80	80	1.0000000
NODE_10657_length_840_cov_16.635628	400	480	0	80	80	1.0000000
NODE_10658_length_840_cov_12.133603	336	416	0	80	80	1.0000000
NODE_10658_length_840_cov_12.133603	389	469	0	80	80	1.0000000
NODE_10659_length_840_cov_12.041835	332	412	0	21	80	0.2625000
NODE_10659_length_840_cov_12.041835	332	412	2	21	80	0.2625000
NODE_10659_length_840_cov_12.041835	332	412	4	38	80	0.4750000
NODE_10659_length_840_cov_12.041835	385	465	0	74	80	0.9250000
NODE_10659_length_840_cov_12.041835	385	465	2	6	80	0.0750000
NODE_10660_length_840_cov_10.719298	275	354	0	79	79	1.0000000
NODE_10660_length_840_cov_10.719298	327	407	0	80	80	1.0000000
NODE_10663_length_840_cov_5.207827	427	507	0	80	80	1.0000000
NODE_10663_length_840_cov_5.207827	480	560	0	80	80	1.0000000
NODE_10683_length_839_cov_274.987838	450	530	104	1	80	0.0125000
NODE_10683_length_839_cov_274.987838	450	530	106	1	80	0.0125000
NODE_10683_length_839_cov_274.987838	450	530	112	2	80	0.0250000
NODE_10683_length_839_cov_274.987838	450	530	116	1	80	0.0125000
NODE_10683_length_839_cov_274.987838	450	530	121	1	80	0.0125000
NODE_10683_length_839_cov_274.987838	450	530	132	2	80	0.0250000
NODE_10683_length_839_cov_274.987838	450	530	133	1	80	0.0125000
NODE_10683_length_839_cov_274.987838	450	530	134	1	80	0.0125000
NODE_10683_length_839_cov_274.987838	450	530	135	1	80	0.0125000
NODE_10683_length_839_cov_274.987838	450	530	136	1	80	0.0125000
NODE_10683_length_839_cov_274.987838	450	530	146	1	80	0.0125000
NODE_10683_length_839_cov_274.987838	450	530	156	1	80	0.0125000
NODE_10683_length_839_cov_274.987838	450	530	157	2	80	0.0250000
NODE_10683_length_839_cov_274.987838	450	530	158	4	80	0.0500000
NODE_10683_length_839_cov_274.987838	450	530	159	1	80	0.0125000
NODE_10683_length_839_cov_274.987838	450	530	163	2	80	0.0250000
NODE_10683_length_839_cov_274.987838	450	530	165	2	80	0.0250000
NODE_10683_length_839_cov_274.987838	450	530	168	2	80	0.0250000
NODE_10683_length_839_cov_274.987838	450	530	173	1	80	0.0125000
NODE_10683_length_839_cov_274.987838	450	530	177	1	80	0.0125000
NODE_10683_length_839_cov_274.987838	450	530	187	1	80	0.0125000
NODE_10683_length_839_cov_274.987838	450	530	193	2	80	0.0250000
NODE_10683_length_839_cov_274.987838	450	530	198	1	80	0.0125000
NODE_10683_length_839_cov_274.987838	450	530	202	1	80	0.0125000
NODE_10683_length_839_cov_274.987838	450	530	206	1	80	0.0125000
NODE_10683_length_839_cov_274.987838	450	530	220	2	80	0.0250000
NODE_10683_length_839_cov_274.987838	450	530	233	1	80	0.0125000
NODE_10683_length_839_cov_274.987838	450	530	238	2	80	0.0250000
NODE_10683_length_839_cov_274.987838	450	530	240	2	80	0.0250000
NODE_10683_length_839_cov_274.987838	450	530	242	1	80	0.0125000
NODE_10683_length_839_cov_274.987838	450	530	247	1	80	0.0125000
NODE_10683_length_839_cov_274.987838	450	530	249	3	80	0.0375000
NODE_10683_length_839_cov_274.987838	450	530	250	1	80	0.0125000
NODE_10683_length_839_cov_274.987838	450	530	254	1	80	0.0125000
NODE_10683_length_839_cov_274.987838	450	530	261	1	80	0.0125000
NODE_10683_length_839_cov_274.987838	450	530	262	1	80	0.0125000
NODE_10683_length_839_cov_274.987838	450	530	264	3	80	0.0375000
NODE_10683_length_839_cov_274.987838	450	530	271	1	80	0.0125000
NODE_10683_length_839_cov_274.987838	450	530	273	3	80	0.0375000
NODE_10683_length_839_cov_274.987838	450	530	277	1	80	0.0125000
NODE_10683_length_839_cov_274.987838	450	530	278	2	80	0.0250000
NODE_10683_length_839_cov_274.987838	450	530	279	1	80	0.0125000
NODE_10683_length_839_cov_274.987838	450	530	280	1	80	0.0125000
NODE_10683_length_839_cov_274.987838	450	530	281	1	80	0.0125000
NODE_10683_length_839_cov_274.987838	450	530	282	2	80	0.0250000
NODE_10683_length_839_cov_274.987838	450	530	284	2	80	0.0250000
NODE_10683_length_839_cov_274.987838	450	530	286	1	80	0.0125000
NODE_10683_length_839_cov_274.987838	450	530	288	1	80	0.0125000
NODE_10683_length_839_cov_274.987838	450	530	292	1	80	0.0125000
NODE_10683_length_839_cov_274.987838	450	530	293	1	80	0.0125000
NODE_10683_length_839_cov_274.987838	450	530	294	1	80	0.0125000
NODE_10683_length_839_cov_274.987838	450	530	295	1	80	0.0125000
NODE_10683_length_839_cov_274.987838	450	530	298	1	80	0.0125000
NODE_10683_length_839_cov_274.987838	450	530	299	1	80	0.0125000
NODE_10683_length_839_cov_274.987838	450	530	301	1	80	0.0125000
NODE_10683_length_839_cov_274.987838	450	530	302	1	80	0.0125000
NODE_10683_length_839_cov_274.987838	450	530	308	1	80	0.0125000
NODE_10683_length_839_cov_274.987838	450	530	315	1	80	0.0125000
NODE_10683_length_839_cov_274.987838	503	583	264	1	80	0.0125000
NODE_10683_length_839_cov_274.987838	503	583	271	1	80	0.0125000
NODE_10683_length_839_cov_274.987838	503	583	273	3	80	0.0375000
NODE_10683_length_839_cov_274.987838	503	583	277	1	80	0.0125000
NODE_10683_length_839_cov_274.987838	503	583	278	2	80	0.0250000
NODE_10683_length_839_cov_274.987838	503	583	279	1	80	0.0125000
NODE_10683_length_839_cov_274.987838	503	583	280	1	80	0.0125000
NODE_10683_length_839_cov_274.987838	503	583	281	1	80	0.0125000
NODE_10683_length_839_cov_274.987838	503	583	282	2	80	0.0250000
NODE_10683_length_839_cov_274.987838	503	583	283	2	80	0.0250000
NODE_10683_length_839_cov_274.987838	503	583	284	2	80	0.0250000
NODE_10683_length_839_cov_274.987838	503	583	286	1	80	0.0125000
NODE_10683_length_839_cov_274.987838	503	583	288	1	80	0.0125000
NODE_10683_length_839_cov_274.987838	503	583	289	1	80	0.0125000
NODE_10683_length_839_cov_274.987838	503	583	292	1	80	0.0125000
NODE_10683_length_839_cov_274.987838	503	583	293	2	80	0.0250000
NODE_10683_length_839_cov_274.987838	503	583	294	1	80	0.0125000
NODE_10683_length_839_cov_274.987838	503	583	295	1	80	0.0125000
NODE_10683_length_839_cov_274.987838	503	583	296	1	80	0.0125000
NODE_10683_length_839_cov_274.987838	503	583	298	1	80	0.0125000
NODE_10683_length_839_cov_274.987838	503	583	299	1	80	0.0125000
NODE_10683_length_839_cov_274.987838	503	583	301	1	80	0.0125000
NODE_10683_length_839_cov_274.987838	503	583	302	4	80	0.0500000
NODE_10683_length_839_cov_274.987838	503	583	308	2	80	0.0250000
NODE_10683_length_839_cov_274.987838	503	583	310	1	80	0.0125000
NODE_10683_length_839_cov_274.987838	503	583	311	1	80	0.0125000
NODE_10683_length_839_cov_274.987838	503	583	312	1	80	0.0125000
NODE_10683_length_839_cov_274.987838	503	583	314	1	80	0.0125000
NODE_10683_length_839_cov_274.987838	503	583	315	1	80	0.0125000
NODE_10683_length_839_cov_274.987838	503	583	318	1	80	0.0125000
NODE_10683_length_839_cov_274.987838	503	583	323	2	80	0.0250000
NODE_10683_length_839_cov_274.987838	503	583	325	1	80	0.0125000
NODE_10683_length_839_cov_274.987838	503	583	327	1	80	0.0125000
NODE_10683_length_839_cov_274.987838	503	583	328	1	80	0.0125000
NODE_10683_length_839_cov_274.987838	503	583	334	1	80	0.0125000
NODE_10683_length_839_cov_274.987838	503	583	335	1	80	0.0125000
NODE_10683_length_839_cov_274.987838	503	583	337	1	80	0.0125000
NODE_10683_length_839_cov_274.987838	503	583	338	1	80	0.0125000
NODE_10683_length_839_cov_274.987838	503	583	343	1	80	0.0125000
NODE_10683_length_839_cov_274.987838	503	583	344	1	80	0.0125000
NODE_10683_length_839_cov_274.987838	503	583	345	1	80	0.0125000
NODE_10683_length_839_cov_274.987838	503	583	349	1	80	0.0125000
NODE_10683_length_839_cov_274.987838	503	583	350	1	80	0.0125000
NODE_10683_length_839_cov_274.987838	503	583	351	1	80	0.0125000
NODE_10683_length_839_cov_274.987838	503	583	352	2	80	0.0250000
NODE_10683_length_839_cov_274.987838	503	583	353	1	80	0.0125000
NODE_10683_length_839_cov_274.987838	503	583	357	1	80	0.0125000
NODE_10683_length_839_cov_274.987838	503	583	359	2	80	0.0250000
NODE_10683_length_839_cov_274.987838	503	583	360	1	80	0.0125000
NODE_10683_length_839_cov_274.987838	503	583	361	1	80	0.0125000
NODE_10683_length_839_cov_274.987838	503	583	363	1	80	0.0125000
NODE_10683_length_839_cov_274.987838	503	583	364	2	80	0.0250000
NODE_10683_length_839_cov_274.987838	503	583	365	3	80	0.0375000
NODE_10683_length_839_cov_274.987838	503	583	367	1	80	0.0125000
NODE_10683_length_839_cov_274.987838	503	583	370	3	80	0.0375000
NODE_10683_length_839_cov_274.987838	503	583	371	4	80	0.0500000
NODE_10683_length_839_cov_274.987838	503	583	373	1	80	0.0125000
NODE_10683_length_839_cov_274.987838	503	583	374	1	80	0.0125000
NODE_10684_length_839_cov_24.500000	303	383	4	21	80	0.2625000
NODE_10684_length_839_cov_24.500000	303	383	6	52	80	0.6500000
NODE_10684_length_839_cov_24.500000	303	383	8	3	80	0.0375000
NODE_10684_length_839_cov_24.500000	303	383	10	4	80	0.0500000
NODE_10684_length_839_cov_24.500000	356	436	0	41	80	0.5125000
NODE_10684_length_839_cov_24.500000	356	436	2	10	80	0.1250000
NODE_10684_length_839_cov_24.500000	356	436	4	23	80	0.2875000
NODE_10684_length_839_cov_24.500000	356	436	6	6	80	0.0750000
NODE_10685_length_839_cov_16.390541	477	557	0	80	80	1.0000000
NODE_10685_length_839_cov_16.390541	530	610	0	80	80	1.0000000
NODE_10686_length_839_cov_10.006757	383	463	0	80	80	1.0000000
NODE_10686_length_839_cov_10.006757	436	516	0	80	80	1.0000000
NODE_10688_length_839_cov_7.612162	308	388	0	61	80	0.7625000
NODE_10688_length_839_cov_7.612162	308	388	10	19	80	0.2375000
NODE_10688_length_839_cov_7.612162	361	441	0	8	80	0.1000000
NODE_10688_length_839_cov_7.612162	361	441	9	9	80	0.1125000
NODE_10688_length_839_cov_7.612162	361	441	10	33	80	0.4125000
NODE_10688_length_839_cov_7.612162	361	441	11	7	80	0.0875000
NODE_10688_length_839_cov_7.612162	361	441	12	23	80	0.2875000
NODE_10689_length_839_cov_6.693243	343	423	0	15	80	0.1875000
NODE_10689_length_839_cov_6.693243	343	423	2	34	80	0.4250000
NODE_10689_length_839_cov_6.693243	343	423	5	25	80	0.3125000
NODE_10689_length_839_cov_6.693243	343	423	6	6	80	0.0750000
NODE_10706_length_838_cov_39.263870	383	463	0	80	80	1.0000000
NODE_10706_length_838_cov_39.263870	436	516	0	80	80	1.0000000
NODE_10707_length_838_cov_27.843031	473	553	8	80	80	1.0000000
NODE_10707_length_838_cov_27.843031	526	606	0	32	80	0.4000000
NODE_10707_length_838_cov_27.843031	526	606	8	48	80	0.6000000
NODE_10708_length_838_cov_27.238160	432	512	0	18	80	0.2250000
NODE_10708_length_838_cov_27.238160	432	512	2	62	80	0.7750000
NODE_10708_length_838_cov_27.238160	485	565	2	80	80	1.0000000
NODE_10709_length_838_cov_22.691475	380	460	0	80	80	1.0000000
NODE_10709_length_838_cov_22.691475	433	513	0	80	80	1.0000000
NODE_10710_length_838_cov_16.169147	312	392	0	76	80	0.9500000
NODE_10710_length_838_cov_16.169147	312	392	1	2	80	0.0250000
NODE_10710_length_838_cov_16.169147	312	392	2	2	80	0.0250000
NODE_10710_length_838_cov_16.169147	365	445	0	23	80	0.2875000
NODE_10710_length_838_cov_16.169147	365	445	1	2	80	0.0250000
NODE_10710_length_838_cov_16.169147	365	445	2	55	80	0.6875000
NODE_10711_length_838_cov_15.753721	328	408	0	7	80	0.0875000
NODE_10711_length_838_cov_15.753721	328	408	2	73	80	0.9125000
NODE_10711_length_838_cov_15.753721	381	461	0	60	80	0.7500000
NODE_10711_length_838_cov_15.753721	381	461	2	20	80	0.2500000
NODE_10712_length_838_cov_15.514208	294	374	0	8	80	0.1000000
NODE_10712_length_838_cov_15.514208	294	374	2	72	80	0.9000000
NODE_10712_length_838_cov_15.514208	347	427	0	61	80	0.7625000
NODE_10712_length_838_cov_15.514208	347	427	2	19	80	0.2375000
NODE_10713_length_838_cov_7.733424	350	430	0	80	80	1.0000000
NODE_10713_length_838_cov_7.733424	403	483	0	80	80	1.0000000
NODE_10716_length_838_cov_4.511502	131	213	0	62	82	0.7560976
NODE_10716_length_838_cov_4.511502	131	213	2	20	82	0.2439024
NODE_10716_length_838_cov_4.511502	184	252	0	68	68	1.0000000
NODE_10722_length_838_cov_2.247632	359	405	0	46	46	1.0000000
NODE_10727_length_838_cov_1.843031	732	752	0	20	20	1.0000000
NODE_10740_length_837_cov_32.691057	401	481	0	80	80	1.0000000
NODE_10740_length_837_cov_32.691057	454	534	0	80	80	1.0000000
NODE_10741_length_837_cov_30.995935	399	479	0	80	80	1.0000000
NODE_10741_length_837_cov_30.995935	452	532	0	80	80	1.0000000
NODE_10742_length_837_cov_30.883469	278	358	0	60	80	0.7500000
NODE_10742_length_837_cov_30.883469	278	358	2	20	80	0.2500000
NODE_10742_length_837_cov_30.883469	331	411	0	7	80	0.0875000
NODE_10742_length_837_cov_30.883469	331	411	2	70	80	0.8750000
NODE_10742_length_837_cov_30.883469	331	411	4	3	80	0.0375000
NODE_10742_length_837_cov_30.883469	407	487	2	44	80	0.5500000
NODE_10742_length_837_cov_30.883469	407	487	4	36	80	0.4500000
NODE_10742_length_837_cov_30.883469	460	540	0	50	80	0.6250000
NODE_10742_length_837_cov_30.883469	460	540	2	30	80	0.3750000
NODE_10743_length_837_cov_14.573171	205	280	0	75	75	1.0000000
NODE_10743_length_837_cov_14.573171	258	337	0	79	79	1.0000000
NODE_10743_length_837_cov_14.573171	333	413	0	80	80	1.0000000
NODE_10743_length_837_cov_14.573171	386	466	0	80	80	1.0000000
NODE_10744_length_837_cov_12.582656	226	306	0	80	80	1.0000000
NODE_10744_length_837_cov_12.582656	279	359	0	80	80	1.0000000
NODE_10745_length_837_cov_6.998645	389	474	0	85	85	1.0000000
NODE_10745_length_837_cov_6.998645	447	527	0	80	80	1.0000000
NODE_10750_length_837_cov_3.119241	373	453	0	80	80	1.0000000
NODE_10750_length_837_cov_3.119241	426	506	0	80	80	1.0000000
NODE_10769_length_836_cov_40.141113	224	304	0	35	80	0.4375000
NODE_10769_length_836_cov_40.141113	224	304	6	45	80	0.5625000
NODE_10769_length_836_cov_40.141113	277	357	0	27	80	0.3375000
NODE_10769_length_836_cov_40.141113	277	357	4	12	80	0.1500000
NODE_10769_length_836_cov_40.141113	277	357	6	41	80	0.5125000
NODE_10769_length_836_cov_40.141113	353	433	0	10	80	0.1250000
NODE_10769_length_836_cov_40.141113	353	433	3	4	80	0.0500000
NODE_10769_length_836_cov_40.141113	353	433	5	66	80	0.8250000
NODE_10769_length_836_cov_40.141113	406	486	5	55	80	0.6875000
NODE_10769_length_836_cov_40.141113	406	486	6	25	80	0.3125000
NODE_10770_length_836_cov_27.610583	344	424	2	2	80	0.0250000
NODE_10770_length_836_cov_27.610583	344	424	4	2	80	0.0250000
NODE_10770_length_836_cov_27.610583	344	424	11	1	80	0.0125000
NODE_10770_length_836_cov_27.610583	344	424	12	4	80	0.0500000
NODE_10770_length_836_cov_27.610583	344	424	14	18	80	0.2250000
NODE_10770_length_836_cov_27.610583	344	424	16	53	80	0.6625000
NODE_10770_length_836_cov_27.610583	397	477	4	54	80	0.6750000
NODE_10770_length_836_cov_27.610583	397	477	11	1	80	0.0125000
NODE_10770_length_836_cov_27.610583	397	477	14	1	80	0.0125000
NODE_10770_length_836_cov_27.610583	397	477	16	24	80	0.3000000
NODE_10771_length_836_cov_15.719132	295	375	0	80	80	1.0000000
NODE_10771_length_836_cov_15.719132	348	428	0	51	80	0.6375000
NODE_10771_length_836_cov_15.719132	348	428	1	29	80	0.3625000
NODE_10772_length_836_cov_9.309362	295	375	2	10	80	0.1250000
NODE_10772_length_836_cov_9.309362	295	375	4	65	80	0.8125000
NODE_10772_length_836_cov_9.309362	295	375	6	5	80	0.0625000
NODE_10772_length_836_cov_9.309362	348	428	0	16	80	0.2000000
NODE_10772_length_836_cov_9.309362	348	428	4	64	80	0.8000000
NODE_10773_length_836_cov_6.283582	336	416	0	80	80	1.0000000
NODE_10773_length_836_cov_6.283582	389	469	0	80	80	1.0000000
NODE_10774_length_836_cov_4.979647	371	451	0	80	80	1.0000000
NODE_10774_length_836_cov_4.979647	424	504	0	80	80	1.0000000
NODE_10787_length_835_cov_61.033967	253	333	0	80	80	1.0000000
NODE_10787_length_835_cov_61.033967	306	386	0	80	80	1.0000000
NODE_10788_length_835_cov_32.380435	390	470	0	80	80	1.0000000
NODE_10788_length_835_cov_32.380435	443	523	0	80	80	1.0000000
NODE_10789_length_835_cov_20.779891	415	495	0	80	80	1.0000000
NODE_10789_length_835_cov_20.779891	468	548	0	80	80	1.0000000
NODE_10808_length_835_cov_1.694293	18	80	2	62	62	1.0000000
NODE_10820_length_834_cov_13.689796	213	293	0	80	80	1.0000000
NODE_10820_length_834_cov_13.689796	266	346	0	80	80	1.0000000
NODE_10822_length_834_cov_12.609524	406	486	0	80	80	1.0000000
NODE_10822_length_834_cov_12.609524	459	539	0	80	80	1.0000000
NODE_10823_length_834_cov_11.492517	248	328	0	80	80	1.0000000
NODE_10823_length_834_cov_11.492517	301	381	0	80	80	1.0000000
NODE_10824_length_834_cov_9.957823	212	292	2	80	80	1.0000000
NODE_10824_length_834_cov_9.957823	265	345	0	34	80	0.4250000
NODE_10824_length_834_cov_9.957823	265	345	2	46	80	0.5750000
NODE_10825_length_834_cov_6.448980	482	546	0	64	64	1.0000000
NODE_10833_length_834_cov_2.658503	589	641	0	52	52	1.0000000
NODE_10846_length_833_cov_57.702997	338	418	0	80	80	1.0000000
NODE_10846_length_833_cov_57.702997	391	471	0	80	80	1.0000000
NODE_10847_length_833_cov_38.153951	364	444	0	59	80	0.7375000
NODE_10847_length_833_cov_38.153951	364	444	2	21	80	0.2625000
NODE_10847_length_833_cov_38.153951	417	497	0	13	80	0.1625000
NODE_10847_length_833_cov_38.153951	417	497	2	67	80	0.8375000
NODE_10848_length_833_cov_34.302452	368	448	0	80	80	1.0000000
NODE_10848_length_833_cov_34.302452	421	501	0	80	80	1.0000000
NODE_10849_length_833_cov_20.452316	311	392	0	16	81	0.1975309
NODE_10849_length_833_cov_20.452316	311	392	5	1	81	0.0123457
NODE_10849_length_833_cov_20.452316	311	392	10	64	81	0.7901235
NODE_10849_length_833_cov_20.452316	365	445	0	69	80	0.8625000
NODE_10849_length_833_cov_20.452316	365	445	5	1	80	0.0125000
NODE_10849_length_833_cov_20.452316	365	445	10	10	80	0.1250000
NODE_10850_length_833_cov_16.643052	238	318	0	14	80	0.1750000
NODE_10850_length_833_cov_16.643052	238	318	3	29	80	0.3625000
NODE_10850_length_833_cov_16.643052	238	318	4	37	80	0.4625000
NODE_10851_length_833_cov_16.536785	84	164	0	1	80	0.0125000
NODE_10851_length_833_cov_16.536785	84	164	4	79	80	0.9875000
NODE_10851_length_833_cov_16.536785	137	217	0	54	80	0.6750000
NODE_10851_length_833_cov_16.536785	137	217	4	26	80	0.3250000
NODE_10865_length_833_cov_3.089918	467	547	0	80	80	1.0000000
NODE_10865_length_833_cov_3.089918	520	600	0	80	80	1.0000000
NODE_10891_length_832_cov_35.728513	460	540	0	17	80	0.2125000
NODE_10891_length_832_cov_35.728513	460	540	2	63	80	0.7875000
NODE_10891_length_832_cov_35.728513	513	593	0	49	80	0.6125000
NODE_10891_length_832_cov_35.728513	513	593	2	31	80	0.3875000
NODE_10892_length_832_cov_25.450205	292	372	0	49	80	0.6125000
NODE_10892_length_832_cov_25.450205	292	372	1	10	80	0.1250000
NODE_10892_length_832_cov_25.450205	292	372	2	21	80	0.2625000
NODE_10892_length_832_cov_25.450205	345	425	1	6	80	0.0750000
NODE_10892_length_832_cov_25.450205	345	425	2	27	80	0.3375000
NODE_10892_length_832_cov_25.450205	345	425	6	47	80	0.5875000
NODE_10893_length_832_cov_18.858117	428	508	0	80	80	1.0000000
NODE_10893_length_832_cov_18.858117	481	561	0	80	80	1.0000000
NODE_10894_length_832_cov_17.799454	314	394	0	32	80	0.4000000
NODE_10894_length_832_cov_17.799454	314	394	2	48	80	0.6000000
NODE_10894_length_832_cov_17.799454	367	447	2	80	80	1.0000000
NODE_10895_length_832_cov_14.811733	353	433	0	80	80	1.0000000
NODE_10896_length_832_cov_14.770805	259	339	12	80	80	1.0000000
NODE_10896_length_832_cov_14.770805	312	392	0	36	80	0.4500000
NODE_10896_length_832_cov_14.770805	312	392	12	44	80	0.5500000
NODE_10897_length_832_cov_8.305593	266	346	0	80	80	1.0000000
NODE_10897_length_832_cov_8.305593	319	399	0	80	80	1.0000000
NODE_10918_length_831_cov_18.403005	371	451	0	80	80	1.0000000
NODE_10918_length_831_cov_18.403005	424	504	0	80	80	1.0000000
NODE_10919_length_831_cov_16.017760	357	437	0	80	80	1.0000000
NODE_10919_length_831_cov_16.017760	410	490	0	40	80	0.5000000
NODE_10919_length_831_cov_16.017760	410	490	4	40	80	0.5000000
NODE_10920_length_831_cov_13.740437	405	485	0	57	80	0.7125000
NODE_10920_length_831_cov_13.740437	405	485	2	23	80	0.2875000
NODE_10920_length_831_cov_13.740437	458	538	0	4	80	0.0500000
NODE_10920_length_831_cov_13.740437	458	538	2	76	80	0.9500000
NODE_10921_length_831_cov_9.595628	281	361	0	51	80	0.6375000
NODE_10921_length_831_cov_9.595628	281	361	2	29	80	0.3625000
NODE_10921_length_831_cov_9.595628	334	414	2	80	80	1.0000000
NODE_10922_length_831_cov_8.199454	433	482	0	49	49	1.0000000
NODE_10923_length_831_cov_7.607923	216	296	0	40	80	0.5000000
NODE_10923_length_831_cov_7.607923	216	296	11	37	80	0.4625000
NODE_10923_length_831_cov_7.607923	216	296	12	3	80	0.0375000
NODE_10923_length_831_cov_7.607923	269	349	11	24	80	0.3000000
NODE_10923_length_831_cov_7.607923	269	349	12	56	80	0.7000000
NODE_10924_length_831_cov_6.454918	334	409	2	40	75	0.5333334
NODE_10924_length_831_cov_6.454918	334	409	4	35	75	0.4666667
NODE_10924_length_831_cov_6.454918	382	462	2	2	80	0.0250000
NODE_10924_length_831_cov_6.454918	382	462	4	78	80	0.9750000
NODE_10960_length_830_cov_40.856361	238	318	0	80	80	1.0000000
NODE_10960_length_830_cov_40.856361	291	371	0	80	80	1.0000000
NODE_10961_length_830_cov_32.170999	302	378	0	76	76	1.0000000
NODE_10961_length_830_cov_32.170999	303	383	0	80	80	1.0000000
NODE_10961_length_830_cov_32.170999	356	436	0	80	80	1.0000000
NODE_10962_length_830_cov_28.041040	393	473	0	80	80	1.0000000
NODE_10962_length_830_cov_28.041040	446	526	0	80	80	1.0000000
NODE_10963_length_830_cov_20.280438	360	440	0	80	80	1.0000000
NODE_10963_length_830_cov_20.280438	413	492	0	79	79	1.0000000
NODE_10964_length_830_cov_19.495212	274	354	2	80	80	1.0000000
NODE_10964_length_830_cov_19.495212	327	407	0	45	80	0.5625000
NODE_10964_length_830_cov_19.495212	327	407	2	35	80	0.4375000
NODE_10965_length_830_cov_18.522572	368	448	0	80	80	1.0000000
NODE_10965_length_830_cov_18.522572	421	501	0	80	80	1.0000000
NODE_10966_length_830_cov_13.830369	278	358	0	6	80	0.0750000
NODE_10966_length_830_cov_13.830369	278	358	2	57	80	0.7125000
NODE_10966_length_830_cov_13.830369	278	358	4	17	80	0.2125000
NODE_10966_length_830_cov_13.830369	331	411	0	59	80	0.7375000
NODE_10966_length_830_cov_13.830369	331	411	2	21	80	0.2625000
NODE_10967_length_830_cov_12.459644	201	281	0	80	80	1.0000000
NODE_10967_length_830_cov_12.459644	254	334	0	80	80	1.0000000
NODE_10968_length_830_cov_8.344733	450	530	0	80	80	1.0000000
NODE_10968_length_830_cov_8.344733	503	583	0	80	80	1.0000000
NODE_10969_length_830_cov_8.227086	634	714	6	10	80	0.1250000
NODE_10969_length_830_cov_8.227086	634	714	7	2	80	0.0250000
NODE_10969_length_830_cov_8.227086	634	714	8	68	80	0.8500000
NODE_10969_length_830_cov_8.227086	687	767	3	44	80	0.5500000
NODE_10969_length_830_cov_8.227086	687	767	4	1	80	0.0125000
NODE_10969_length_830_cov_8.227086	687	767	7	10	80	0.1250000
NODE_10969_length_830_cov_8.227086	687	767	8	25	80	0.3125000
NODE_10995_length_829_cov_74.910959	271	351	0	5	80	0.0625000
NODE_10995_length_829_cov_74.910959	271	351	3	39	80	0.4875000
NODE_10995_length_829_cov_74.910959	271	351	4	36	80	0.4500000
NODE_10995_length_829_cov_74.910959	324	404	0	24	80	0.3000000
NODE_10995_length_829_cov_74.910959	324	404	3	56	80	0.7000000
NODE_10996_length_829_cov_34.068493	302	382	0	80	80	1.0000000
NODE_10996_length_829_cov_34.068493	355	435	0	37	80	0.4625000
NODE_10996_length_829_cov_34.068493	355	435	2	43	80	0.5375000
NODE_10997_length_829_cov_24.027397	441	521	0	80	80	1.0000000
NODE_10997_length_829_cov_24.027397	494	574	0	80	80	1.0000000
NODE_10998_length_829_cov_21.735616	420	500	0	80	80	1.0000000
NODE_10998_length_829_cov_21.735616	473	553	0	80	80	1.0000000
NODE_10999_length_829_cov_18.446575	407	487	3	4	80	0.0500000
NODE_10999_length_829_cov_18.446575	407	487	4	11	80	0.1375000
NODE_10999_length_829_cov_18.446575	407	487	5	33	80	0.4125000
NODE_10999_length_829_cov_18.446575	407	487	6	32	80	0.4000000
NODE_10999_length_829_cov_18.446575	460	540	1	16	80	0.2000000
NODE_10999_length_829_cov_18.446575	460	540	2	16	80	0.2000000
NODE_10999_length_829_cov_18.446575	460	540	4	32	80	0.4000000
NODE_10999_length_829_cov_18.446575	460	540	6	16	80	0.2000000
NODE_11000_length_829_cov_10.971233	368	448	0	18	80	0.2250000
NODE_11000_length_829_cov_10.971233	368	448	2	62	80	0.7750000
NODE_11000_length_829_cov_10.971233	421	501	2	80	80	1.0000000
NODE_11001_length_829_cov_10.035616	387	467	0	43	80	0.5375000
NODE_11001_length_829_cov_10.035616	387	467	2	37	80	0.4625000
NODE_11001_length_829_cov_10.035616	440	520	2	80	80	1.0000000
NODE_11002_length_829_cov_9.906849	326	406	0	80	80	1.0000000
NODE_11002_length_829_cov_9.906849	379	459	0	80	80	1.0000000
NODE_11003_length_829_cov_8.809589	450	530	0	21	80	0.2625000
NODE_11003_length_829_cov_8.809589	450	530	2	6	80	0.0750000
NODE_11003_length_829_cov_8.809589	450	530	4	53	80	0.6625000
NODE_11003_length_829_cov_8.809589	503	583	0	30	80	0.3750000
NODE_11003_length_829_cov_8.809589	503	583	2	16	80	0.2000000
NODE_11003_length_829_cov_8.809589	503	583	4	34	80	0.4250000
NODE_11006_length_829_cov_4.310959	473	553	0	80	80	1.0000000
NODE_11006_length_829_cov_4.310959	526	606	0	80	80	1.0000000
NODE_11008_length_829_cov_3.079452	507	587	10	80	80	1.0000000
NODE_11008_length_829_cov_3.079452	507	587	10	80	80	1.0000000
NODE_11008_length_829_cov_3.079452	560	640	0	21	80	0.2625000
NODE_11008_length_829_cov_3.079452	560	640	4	1	80	0.0125000
NODE_11008_length_829_cov_3.079452	560	640	5	18	80	0.2250000
NODE_11008_length_829_cov_3.079452	560	640	10	40	80	0.5000000
NODE_11025_length_828_cov_41.116598	436	516	0	80	80	1.0000000
NODE_11025_length_828_cov_41.116598	489	569	0	80	80	1.0000000
NODE_11026_length_828_cov_36.459534	372	452	0	80	80	1.0000000
NODE_11026_length_828_cov_36.459534	425	505	0	80	80	1.0000000
NODE_11027_length_828_cov_33.515775	443	523	0	55	80	0.6875000
NODE_11027_length_828_cov_33.515775	443	523	2	25	80	0.3125000
NODE_11027_length_828_cov_33.515775	496	576	0	80	80	1.0000000
NODE_11028_length_828_cov_21.123457	380	460	0	18	80	0.2250000
NODE_11028_length_828_cov_21.123457	380	460	2	62	80	0.7750000
NODE_11028_length_828_cov_21.123457	433	513	0	71	80	0.8875000
NODE_11028_length_828_cov_21.123457	433	513	2	9	80	0.1125000
NODE_11029_length_828_cov_17.406036	304	392	2	21	88	0.2386364
NODE_11029_length_828_cov_17.406036	304	392	9	3	88	0.0340909
NODE_11029_length_828_cov_17.406036	304	392	11	2	88	0.0227273
NODE_11029_length_828_cov_17.406036	304	392	12	62	88	0.7045454
NODE_11029_length_828_cov_17.406036	369	445	0	4	76	0.0526316
NODE_11029_length_828_cov_17.406036	369	445	8	3	76	0.0394737
NODE_11029_length_828_cov_17.406036	369	445	9	49	76	0.6447368
NODE_11029_length_828_cov_17.406036	369	445	11	2	76	0.0263158
NODE_11029_length_828_cov_17.406036	369	445	12	18	76	0.2368421
NODE_11030_length_828_cov_14.606310	287	367	0	80	80	1.0000000
NODE_11030_length_828_cov_14.606310	340	420	0	80	80	1.0000000
NODE_11031_length_828_cov_14.493827	326	406	2	80	80	1.0000000
NODE_11031_length_828_cov_14.493827	379	459	0	17	80	0.2125000
NODE_11031_length_828_cov_14.493827	379	459	2	30	80	0.3750000
NODE_11031_length_828_cov_14.493827	379	459	3	20	80	0.2500000
NODE_11031_length_828_cov_14.493827	379	459	5	13	80	0.1625000
NODE_11031_length_828_cov_14.493827	455	535	5	20	80	0.2500000
NODE_11031_length_828_cov_14.493827	455	535	6	60	80	0.7500000
NODE_11031_length_828_cov_14.493827	508	588	3	12	80	0.1500000
NODE_11031_length_828_cov_14.493827	508	588	6	68	80	0.8500000
NODE_11032_length_828_cov_10.550069	280	360	0	80	80	1.0000000
NODE_11032_length_828_cov_10.550069	333	413	0	80	80	1.0000000
NODE_11033_length_828_cov_9.292181	594	674	0	23	80	0.2875000
NODE_11033_length_828_cov_9.292181	594	674	2	57	80	0.7125000
NODE_11033_length_828_cov_9.292181	647	727	2	80	80	1.0000000
NODE_11034_length_828_cov_8.747599	298	378	0	80	80	1.0000000
NODE_11034_length_828_cov_8.747599	351	431	0	80	80	1.0000000
NODE_11035_length_828_cov_8.098765	199	279	0	80	80	1.0000000
NODE_11035_length_828_cov_8.098765	252	332	0	80	80	1.0000000
NODE_11037_length_828_cov_7.473251	300	380	0	80	80	1.0000000
NODE_11037_length_828_cov_7.473251	353	433	0	80	80	1.0000000
NODE_11039_length_828_cov_5.481481	543	623	0	80	80	1.0000000
NODE_11039_length_828_cov_5.481481	596	676	0	66	80	0.8250000
NODE_11039_length_828_cov_5.481481	596	676	2	14	80	0.1750000
NODE_11041_length_828_cov_5.069959	259	339	0	80	80	1.0000000
NODE_11066_length_827_cov_34.567308	269	349	4	80	80	1.0000000
NODE_11066_length_827_cov_34.567308	322	402	0	8	80	0.1000000
NODE_11066_length_827_cov_34.567308	322	402	4	72	80	0.9000000
NODE_11066_length_827_cov_34.567308	398	478	0	80	80	1.0000000
NODE_11066_length_827_cov_34.567308	451	531	0	80	80	1.0000000
NODE_11067_length_827_cov_31.538462	320	400	4	80	80	1.0000000
NODE_11067_length_827_cov_31.538462	373	453	4	80	80	1.0000000
NODE_11068_length_827_cov_19.548077	464	544	2	80	80	1.0000000
NODE_11068_length_827_cov_19.548077	517	597	0	47	80	0.5875000
NODE_11068_length_827_cov_19.548077	517	597	2	33	80	0.4125000
NODE_11069_length_827_cov_17.490385	320	400	0	80	80	1.0000000
NODE_11069_length_827_cov_17.490385	373	453	0	80	80	1.0000000
NODE_11070_length_827_cov_15.247253	205	285	0	80	80	1.0000000
NODE_11070_length_827_cov_15.247253	258	338	0	80	80	1.0000000
NODE_11071_length_827_cov_14.151099	372	452	2	48	80	0.6000000
NODE_11071_length_827_cov_14.151099	372	452	4	32	80	0.4000000
NODE_11071_length_827_cov_14.151099	425	505	0	9	80	0.1125000
NODE_11071_length_827_cov_14.151099	425	505	2	56	80	0.7000000
NODE_11071_length_827_cov_14.151099	425	505	4	15	80	0.1875000
NODE_11072_length_827_cov_12.157967	262	342	0	80	80	1.0000000
NODE_11072_length_827_cov_12.157967	315	395	0	80	80	1.0000000
NODE_11073_length_827_cov_11.777473	316	396	0	80	80	1.0000000
NODE_11073_length_827_cov_11.777473	369	449	0	52	80	0.6500000
NODE_11073_length_827_cov_11.777473	369	449	1	8	80	0.1000000
NODE_11073_length_827_cov_11.777473	369	449	2	20	80	0.2500000
NODE_11074_length_827_cov_11.651099	393	473	0	16	80	0.2000000
NODE_11074_length_827_cov_11.651099	393	473	4	64	80	0.8000000
NODE_11074_length_827_cov_11.651099	446	526	0	16	80	0.2000000
NODE_11074_length_827_cov_11.651099	446	526	4	64	80	0.8000000
NODE_11075_length_827_cov_10.711538	286	366	0	78	80	0.9750000
NODE_11075_length_827_cov_10.711538	286	366	2	2	80	0.0250000
NODE_11075_length_827_cov_10.711538	339	419	0	25	80	0.3125000
NODE_11075_length_827_cov_10.711538	339	419	2	55	80	0.6875000
NODE_11076_length_827_cov_10.262363	273	353	0	80	80	1.0000000
NODE_11076_length_827_cov_10.262363	326	406	0	80	80	1.0000000
NODE_11077_length_827_cov_10.221154	256	336	8	1	80	0.0125000
NODE_11077_length_827_cov_10.221154	256	336	10	79	80	0.9875000
NODE_11078_length_827_cov_9.576923	359	439	0	80	80	1.0000000
NODE_11078_length_827_cov_9.576923	412	492	0	80	80	1.0000000
NODE_11079_length_827_cov_8.780220	361	441	0	80	80	1.0000000
NODE_11079_length_827_cov_8.780220	414	494	0	80	80	1.0000000
NODE_11093_length_827_cov_1.412088	736	784	2	11	48	0.2291667
NODE_11093_length_827_cov_1.412088	736	784	4	37	48	0.7708333
NODE_11106_length_826_cov_34.026135	211	291	0	80	80	1.0000000
NODE_11106_length_826_cov_34.026135	264	344	0	80	80	1.0000000
NODE_11107_length_826_cov_24.093535	282	362	0	80	80	1.0000000
NODE_11107_length_826_cov_24.093535	335	415	0	80	80	1.0000000
NODE_11108_length_826_cov_20.943604	207	287	3	15	80	0.1875000
NODE_11108_length_826_cov_20.943604	207	287	6	50	80	0.6250000
NODE_11108_length_826_cov_20.943604	207	287	9	15	80	0.1875000
NODE_11108_length_826_cov_20.943604	260	340	6	80	80	1.0000000
NODE_11109_length_826_cov_20.437414	413	493	0	80	80	1.0000000
NODE_11109_length_826_cov_20.437414	466	546	0	80	80	1.0000000
NODE_11110_length_826_cov_20.200825	432	512	0	80	80	1.0000000
NODE_11110_length_826_cov_20.200825	485	565	0	80	80	1.0000000
NODE_11111_length_826_cov_18.489684	345	425	0	80	80	1.0000000
NODE_11111_length_826_cov_18.489684	398	478	0	80	80	1.0000000
NODE_11112_length_826_cov_17.998624	336	416	0	80	80	1.0000000
NODE_11112_length_826_cov_17.998624	389	469	0	80	80	1.0000000
NODE_11113_length_826_cov_17.038514	358	438	2	23	80	0.2875000
NODE_11113_length_826_cov_17.038514	358	438	4	57	80	0.7125000
NODE_11113_length_826_cov_17.038514	411	491	0	44	80	0.5500000
NODE_11113_length_826_cov_17.038514	411	491	2	32	80	0.4000000
NODE_11113_length_826_cov_17.038514	411	491	4	4	80	0.0500000
NODE_11114_length_826_cov_16.777166	514	603	0	89	89	1.0000000
NODE_11115_length_826_cov_16.177442	361	441	0	80	80	1.0000000
NODE_11115_length_826_cov_16.177442	414	494	0	80	80	1.0000000
NODE_11116_length_826_cov_15.134801	346	426	0	80	80	1.0000000
NODE_11116_length_826_cov_15.134801	399	479	0	80	80	1.0000000
NODE_11117_length_826_cov_9.943604	320	400	0	48	80	0.6000000
NODE_11117_length_826_cov_9.943604	320	400	2	32	80	0.4000000
NODE_11117_length_826_cov_9.943604	373	453	2	80	80	1.0000000
NODE_11120_length_826_cov_4.852820	501	579	1	35	78	0.4487180
NODE_11120_length_826_cov_4.852820	501	579	2	43	78	0.5512820
NODE_11120_length_826_cov_4.852820	552	632	1	4	80	0.0500000
NODE_11120_length_826_cov_4.852820	552	632	2	76	80	0.9500000
NODE_11161_length_825_cov_61.804408	382	462	0	80	80	1.0000000
NODE_11161_length_825_cov_61.804408	435	514	0	79	79	1.0000000
NODE_11162_length_825_cov_43.825069	488	568	0	30	80	0.3750000
NODE_11162_length_825_cov_43.825069	488	568	2	7	80	0.0875000
NODE_11162_length_825_cov_43.825069	488	568	4	43	80	0.5375000
NODE_11162_length_825_cov_43.825069	541	621	0	80	80	1.0000000
NODE_11162_length_825_cov_43.825069	617	697	0	80	80	1.0000000
NODE_11162_length_825_cov_43.825069	670	750	0	34	80	0.4250000
NODE_11162_length_825_cov_43.825069	670	750	2	46	80	0.5750000
NODE_11163_length_825_cov_43.389807	496	576	0	80	80	1.0000000
NODE_11163_length_825_cov_43.389807	549	629	0	80	80	1.0000000
NODE_11164_length_825_cov_39.603306	386	466	0	80	80	1.0000000
NODE_11164_length_825_cov_39.603306	439	519	0	80	80	1.0000000
NODE_11165_length_825_cov_32.205234	354	434	38	48	80	0.6000000
NODE_11165_length_825_cov_32.205234	354	434	40	2	80	0.0250000
NODE_11165_length_825_cov_32.205234	354	434	47	3	80	0.0375000
NODE_11165_length_825_cov_32.205234	354	434	48	2	80	0.0250000
NODE_11165_length_825_cov_32.205234	354	434	49	25	80	0.3125000
NODE_11165_length_825_cov_32.205234	407	487	0	39	80	0.4875000
NODE_11165_length_825_cov_32.205234	407	487	48	2	80	0.0250000
NODE_11165_length_825_cov_32.205234	407	487	49	39	80	0.4875000
NODE_11166_length_825_cov_29.411846	503	583	4	80	80	1.0000000
NODE_11166_length_825_cov_29.411846	556	636	2	45	80	0.5625000
NODE_11166_length_825_cov_29.411846	556	636	4	31	80	0.3875000
NODE_11166_length_825_cov_29.411846	556	636	6	4	80	0.0500000
NODE_11167_length_825_cov_22.428375	312	392	2	76	80	0.9500000
NODE_11167_length_825_cov_22.428375	312	392	4	4	80	0.0500000
NODE_11167_length_825_cov_22.428375	365	445	2	80	80	1.0000000
NODE_11167_length_825_cov_22.428375	441	521	2	8	80	0.1000000
NODE_11167_length_825_cov_22.428375	441	521	8	45	80	0.5625000
NODE_11167_length_825_cov_22.428375	441	521	9	1	80	0.0125000
NODE_11167_length_825_cov_22.428375	441	521	10	26	80	0.3250000
NODE_11167_length_825_cov_22.428375	494	574	0	14	80	0.1750000
NODE_11167_length_825_cov_22.428375	494	574	8	66	80	0.8250000
NODE_11168_length_825_cov_19.964187	249	329	27	1	80	0.0125000
NODE_11168_length_825_cov_19.964187	249	329	28	2	80	0.0250000
NODE_11168_length_825_cov_19.964187	249	329	30	77	80	0.9625000
NODE_11168_length_825_cov_19.964187	302	382	0	28	80	0.3500000
NODE_11168_length_825_cov_19.964187	302	382	26	19	80	0.2375000
NODE_11168_length_825_cov_19.964187	302	382	30	33	80	0.4125000
NODE_11169_length_825_cov_13.790634	273	353	0	80	80	1.0000000
NODE_11169_length_825_cov_13.790634	326	406	0	80	80	1.0000000
NODE_11170_length_825_cov_11.834711	331	411	0	18	80	0.2250000
NODE_11170_length_825_cov_11.834711	331	411	2	62	80	0.7750000
NODE_11170_length_825_cov_11.834711	384	464	0	34	80	0.4250000
NODE_11170_length_825_cov_11.834711	384	464	2	46	80	0.5750000
NODE_11171_length_825_cov_11.477961	392	472	0	4	80	0.0500000
NODE_11171_length_825_cov_11.477961	392	472	2	76	80	0.9500000
NODE_11172_length_825_cov_8.947658	259	339	0	80	80	1.0000000
NODE_11172_length_825_cov_8.947658	312	392	0	80	80	1.0000000
NODE_11173_length_825_cov_7.811295	379	459	0	80	80	1.0000000
NODE_11173_length_825_cov_7.811295	432	512	0	39	80	0.4875000
NODE_11173_length_825_cov_7.811295	432	512	2	41	80	0.5125000
NODE_11174_length_825_cov_7.104683	464	544	0	80	80	1.0000000
NODE_11174_length_825_cov_7.104683	517	597	0	80	80	1.0000000
NODE_11176_length_825_cov_6.252066	542	622	0	80	80	1.0000000
NODE_11176_length_825_cov_6.252066	595	675	0	80	80	1.0000000
NODE_11178_length_825_cov_5.230028	264	344	0	80	80	1.0000000
NODE_11178_length_825_cov_5.230028	317	372	0	55	55	1.0000000
NODE_11178_length_825_cov_5.230028	383	463	0	25	80	0.3125000
NODE_11178_length_825_cov_5.230028	383	463	2	55	80	0.6875000
NODE_11178_length_825_cov_5.230028	436	516	0	26	80	0.3250000
NODE_11178_length_825_cov_5.230028	436	516	2	54	80	0.6750000
NODE_11205_length_825_cov_0.765840	0	50	0	50	50	1.0000000
NODE_11207_length_824_cov_27.074483	337	412	0	75	75	1.0000000
NODE_11207_length_824_cov_27.074483	390	470	0	80	80	1.0000000
NODE_11208_length_824_cov_23.936552	365	445	0	24	80	0.3000000
NODE_11208_length_824_cov_23.936552	365	445	4	56	80	0.7000000
NODE_11208_length_824_cov_23.936552	418	493	4	27	75	0.3600000
NODE_11208_length_824_cov_23.936552	418	493	6	22	75	0.2933333
NODE_11208_length_824_cov_23.936552	418	493	8	26	75	0.3466667
NODE_11209_length_824_cov_22.129655	377	457	2	80	80	1.0000000
NODE_11209_length_824_cov_22.129655	430	510	0	13	80	0.1625000
NODE_11209_length_824_cov_22.129655	430	510	2	67	80	0.8375000
NODE_11210_length_824_cov_17.914483	387	467	0	80	80	1.0000000
NODE_11210_length_824_cov_17.914483	440	520	0	80	80	1.0000000
NODE_11211_length_824_cov_16.662069	362	442	4	80	80	1.0000000
NODE_11211_length_824_cov_16.662069	415	495	0	30	80	0.3750000
NODE_11211_length_824_cov_16.662069	415	495	4	50	80	0.6250000
NODE_11212_length_824_cov_16.306207	352	432	0	26	80	0.3250000
NODE_11212_length_824_cov_16.306207	352	432	2	54	80	0.6750000
NODE_11212_length_824_cov_16.306207	405	485	0	79	80	0.9875000
NODE_11212_length_824_cov_16.306207	405	485	2	1	80	0.0125000
NODE_11213_length_824_cov_15.891034	342	422	0	43	80	0.5375000
NODE_11213_length_824_cov_15.891034	342	422	2	8	80	0.1000000
NODE_11213_length_824_cov_15.891034	342	422	4	29	80	0.3625000
NODE_11213_length_824_cov_15.891034	395	475	4	80	80	1.0000000
NODE_11214_length_824_cov_12.485517	280	360	0	51	80	0.6375000
NODE_11214_length_824_cov_12.485517	280	360	2	24	80	0.3000000
NODE_11214_length_824_cov_12.485517	280	360	4	5	80	0.0625000
NODE_11214_length_824_cov_12.485517	333	413	2	22	80	0.2750000
NODE_11214_length_824_cov_12.485517	333	413	4	58	80	0.7250000
NODE_11216_length_824_cov_5.924138	269	349	0	2	80	0.0250000
NODE_11216_length_824_cov_5.924138	269	349	6	78	80	0.9750000
NODE_11216_length_824_cov_5.924138	322	402	0	55	80	0.6875000
NODE_11216_length_824_cov_5.924138	322	402	6	25	80	0.3125000
NODE_11222_length_824_cov_3.849655	191	271	0	80	80	1.0000000
NODE_11251_length_823_cov_75.169890	207	287	0	30	80	0.3750000
NODE_11251_length_823_cov_75.169890	207	287	2	34	80	0.4250000
NODE_11251_length_823_cov_75.169890	207	287	4	16	80	0.2000000
NODE_11251_length_823_cov_75.169890	260	340	2	13	80	0.1625000
NODE_11251_length_823_cov_75.169890	260	340	4	67	80	0.8375000
NODE_11251_length_823_cov_75.169890	336	416	0	48	80	0.6000000
NODE_11251_length_823_cov_75.169890	336	416	2	30	80	0.3750000
NODE_11251_length_823_cov_75.169890	336	416	4	2	80	0.0250000
NODE_11251_length_823_cov_75.169890	389	469	0	80	80	1.0000000
NODE_11253_length_823_cov_37.738950	332	412	10	7	80	0.0875000
NODE_11253_length_823_cov_37.738950	332	412	19	1	80	0.0125000
NODE_11253_length_823_cov_37.738950	332	412	20	72	80	0.9000000
NODE_11253_length_823_cov_37.738950	385	466	20	61	81	0.7530864
NODE_11253_length_823_cov_37.738950	385	466	22	20	81	0.2469136
NODE_11254_length_823_cov_29.349448	400	480	0	36	80	0.4500000
NODE_11254_length_823_cov_29.349448	400	480	2	44	80	0.5500000
NODE_11254_length_823_cov_29.349448	453	533	0	80	80	1.0000000
NODE_11255_length_823_cov_25.730663	338	418	0	80	80	1.0000000
NODE_11255_length_823_cov_25.730663	391	471	0	80	80	1.0000000
NODE_11256_length_823_cov_24.599448	349	429	0	7	80	0.0875000
NODE_11256_length_823_cov_24.599448	349	429	4	73	80	0.9125000
NODE_11256_length_823_cov_24.599448	402	482	2	15	80	0.1875000
NODE_11256_length_823_cov_24.599448	402	482	4	65	80	0.8125000
NODE_11257_length_823_cov_22.149171	356	436	0	80	80	1.0000000
NODE_11257_length_823_cov_22.149171	409	489	0	80	80	1.0000000
NODE_11257_length_823_cov_22.149171	485	565	0	80	80	1.0000000
NODE_11257_length_823_cov_22.149171	538	618	0	80	80	1.0000000
NODE_11258_length_823_cov_20.892265	329	409	0	30	80	0.3750000
NODE_11258_length_823_cov_20.892265	329	409	2	50	80	0.6250000
NODE_11258_length_823_cov_20.892265	382	462	0	23	80	0.2875000
NODE_11258_length_823_cov_20.892265	382	462	2	57	80	0.7125000
NODE_11259_length_823_cov_19.281768	305	385	0	80	80	1.0000000
NODE_11259_length_823_cov_19.281768	358	438	0	80	80	1.0000000
NODE_11260_length_823_cov_15.738950	409	489	0	80	80	1.0000000
NODE_11260_length_823_cov_15.738950	462	542	0	80	80	1.0000000
NODE_11261_length_823_cov_10.729282	362	437	0	75	75	1.0000000
NODE_11261_length_823_cov_10.729282	410	484	0	74	74	1.0000000
NODE_11262_length_823_cov_9.110497	394	474	6	30	80	0.3750000
NODE_11262_length_823_cov_9.110497	394	474	8	3	80	0.0375000
NODE_11262_length_823_cov_9.110497	394	474	10	9	80	0.1125000
NODE_11262_length_823_cov_9.110497	394	474	12	38	80	0.4750000
NODE_11262_length_823_cov_9.110497	447	527	4	6	80	0.0750000
NODE_11262_length_823_cov_9.110497	447	527	8	11	80	0.1375000
NODE_11262_length_823_cov_9.110497	447	527	11	1	80	0.0125000
NODE_11262_length_823_cov_9.110497	447	527	12	62	80	0.7750000
NODE_11265_length_823_cov_5.511050	168	248	18	4	80	0.0500000
NODE_11265_length_823_cov_5.511050	168	248	19	8	80	0.1000000
NODE_11265_length_823_cov_5.511050	168	248	27	1	80	0.0125000
NODE_11265_length_823_cov_5.511050	168	248	28	1	80	0.0125000
NODE_11265_length_823_cov_5.511050	168	248	30	2	80	0.0250000
NODE_11265_length_823_cov_5.511050	168	248	31	8	80	0.1000000
NODE_11265_length_823_cov_5.511050	168	248	32	42	80	0.5250000
NODE_11265_length_823_cov_5.511050	168	248	36	14	80	0.1750000
NODE_11265_length_823_cov_5.511050	434	485	0	11	51	0.2156863
NODE_11265_length_823_cov_5.511050	434	485	1	7	51	0.1372549
NODE_11265_length_823_cov_5.511050	434	485	4	33	51	0.6470588
NODE_11292_length_823_cov_0.968232	86	154	3	2	68	0.0294118
NODE_11292_length_823_cov_0.968232	86	154	4	5	68	0.0735294
NODE_11292_length_823_cov_0.968232	86	154	6	11	68	0.1617647
NODE_11292_length_823_cov_0.968232	86	154	8	20	68	0.2941177
NODE_11292_length_823_cov_0.968232	86	154	10	6	68	0.0882353
NODE_11292_length_823_cov_0.968232	86	154	12	23	68	0.3382353
NODE_11292_length_823_cov_0.968232	86	154	14	1	68	0.0147059
NODE_11298_length_822_cov_25.423237	377	459	0	82	82	1.0000000
NODE_11298_length_822_cov_25.423237	432	512	0	80	80	1.0000000
NODE_11299_length_822_cov_16.381743	394	474	0	15	80	0.1875000
NODE_11299_length_822_cov_16.381743	394	474	4	65	80	0.8125000
NODE_11299_length_822_cov_16.381743	447	527	0	10	80	0.1250000
NODE_11299_length_822_cov_16.381743	447	527	4	70	80	0.8750000
NODE_11300_length_822_cov_12.426003	223	296	0	70	73	0.9589041
NODE_11300_length_822_cov_12.426003	223	296	2	3	73	0.0410959
NODE_11300_length_822_cov_12.426003	278	349	0	18	71	0.2535211
NODE_11300_length_822_cov_12.426003	278	349	2	53	71	0.7464789
NODE_11301_length_822_cov_10.608575	464	544	0	80	80	1.0000000
NODE_11301_length_822_cov_10.608575	517	597	0	80	80	1.0000000
NODE_11302_length_822_cov_9.496542	363	443	0	80	80	1.0000000
NODE_11302_length_822_cov_9.496542	416	496	0	80	80	1.0000000
NODE_11333_length_821_cov_39.818560	341	420	0	79	79	1.0000000
NODE_11333_length_821_cov_39.818560	393	473	0	60	80	0.7500000
NODE_11333_length_821_cov_39.818560	393	473	2	10	80	0.1250000
NODE_11333_length_821_cov_39.818560	393	473	4	1	80	0.0125000
NODE_11333_length_821_cov_39.818560	393	473	6	9	80	0.1125000
NODE_11334_length_821_cov_27.721607	299	379	0	2	80	0.0250000
NODE_11334_length_821_cov_27.721607	299	379	2	41	80	0.5125000
NODE_11334_length_821_cov_27.721607	299	379	4	37	80	0.4625000
NODE_11334_length_821_cov_27.721607	352	432	0	2	80	0.0250000
NODE_11334_length_821_cov_27.721607	352	432	2	30	80	0.3750000
NODE_11334_length_821_cov_27.721607	352	432	4	48	80	0.6000000
NODE_11335_length_821_cov_26.252078	386	466	0	80	80	1.0000000
NODE_11335_length_821_cov_26.252078	439	519	0	28	80	0.3500000
NODE_11335_length_821_cov_26.252078	439	519	2	33	80	0.4125000
NODE_11335_length_821_cov_26.252078	439	519	4	19	80	0.2375000
NODE_11336_length_821_cov_19.603878	353	433	0	26	80	0.3250000
NODE_11336_length_821_cov_19.603878	353	433	4	15	80	0.1875000
NODE_11336_length_821_cov_19.603878	353	433	8	5	80	0.0625000
NODE_11336_length_821_cov_19.603878	353	433	12	34	80	0.4250000
NODE_11336_length_821_cov_19.603878	406	486	12	80	80	1.0000000
NODE_11337_length_821_cov_15.945983	310	390	2	80	80	1.0000000
NODE_11337_length_821_cov_15.945983	363	443	0	5	80	0.0625000
NODE_11337_length_821_cov_15.945983	363	443	2	75	80	0.9375000
NODE_11339_length_821_cov_8.711911	288	368	0	80	80	1.0000000
NODE_11339_length_821_cov_8.711911	341	421	0	80	80	1.0000000
NODE_11349_length_821_cov_3.026316	310	390	4	17	80	0.2125000
NODE_11349_length_821_cov_3.026316	310	390	6	63	80	0.7875000
NODE_11349_length_821_cov_3.026316	363	443	0	26	80	0.3250000
NODE_11349_length_821_cov_3.026316	363	443	3	2	80	0.0250000
NODE_11349_length_821_cov_3.026316	363	443	4	8	80	0.1000000
NODE_11349_length_821_cov_3.026316	363	443	6	44	80	0.5500000
NODE_11361_length_820_cov_67.292649	328	408	0	80	80	1.0000000
NODE_11361_length_820_cov_67.292649	381	461	0	80	80	1.0000000
NODE_11362_length_820_cov_26.915395	308	388	4	19	80	0.2375000
NODE_11362_length_820_cov_26.915395	308	388	5	61	80	0.7625000
NODE_11363_length_820_cov_25.253814	301	381	8	2	80	0.0250000
NODE_11363_length_820_cov_25.253814	301	381	13	45	80	0.5625000
NODE_11363_length_820_cov_25.253814	301	381	14	13	80	0.1625000
NODE_11363_length_820_cov_25.253814	301	381	16	20	80	0.2500000
NODE_11363_length_820_cov_25.253814	354	434	12	27	80	0.3375000
NODE_11363_length_820_cov_25.253814	354	434	14	7	80	0.0875000
NODE_11363_length_820_cov_25.253814	354	434	16	46	80	0.5750000
NODE_11363_length_820_cov_25.253814	430	510	2	57	80	0.7125000
NODE_11363_length_820_cov_25.253814	430	510	6	2	80	0.0250000
NODE_11363_length_820_cov_25.253814	430	510	7	2	80	0.0250000
NODE_11363_length_820_cov_25.253814	430	510	9	1	80	0.0125000
NODE_11363_length_820_cov_25.253814	430	510	12	12	80	0.1500000
NODE_11363_length_820_cov_25.253814	430	510	14	6	80	0.0750000
NODE_11363_length_820_cov_25.253814	483	563	0	25	80	0.3125000
NODE_11363_length_820_cov_25.253814	483	563	2	55	80	0.6875000
NODE_11364_length_820_cov_16.015257	325	405	0	80	80	1.0000000
NODE_11364_length_820_cov_16.015257	378	458	0	80	80	1.0000000
NODE_11365_length_820_cov_14.703190	371	451	0	26	80	0.3250000
NODE_11365_length_820_cov_14.703190	371	451	4	54	80	0.6750000
NODE_11365_length_820_cov_14.703190	424	504	0	39	80	0.4875000
NODE_11365_length_820_cov_14.703190	424	504	2	40	80	0.5000000
NODE_11365_length_820_cov_14.703190	424	504	4	1	80	0.0125000
NODE_11366_length_820_cov_14.527046	249	329	0	37	80	0.4625000
NODE_11366_length_820_cov_14.527046	249	329	4	43	80	0.5375000
NODE_11366_length_820_cov_14.527046	302	382	4	80	80	1.0000000
NODE_11367_length_820_cov_14.284327	286	366	0	11	80	0.1375000
NODE_11367_length_820_cov_14.284327	286	366	2	69	80	0.8625000
NODE_11367_length_820_cov_14.284327	339	419	2	66	80	0.8250000
NODE_11367_length_820_cov_14.284327	339	419	4	14	80	0.1750000
NODE_11367_length_820_cov_14.284327	619	699	8	6	80	0.0750000
NODE_11367_length_820_cov_14.284327	619	699	9	8	80	0.1000000
NODE_11367_length_820_cov_14.284327	619	699	10	4	80	0.0500000
NODE_11367_length_820_cov_14.284327	619	699	11	62	80	0.7750000
NODE_11368_length_820_cov_13.036061	364	444	0	16	80	0.2000000
NODE_11368_length_820_cov_13.036061	364	444	8	64	80	0.8000000
NODE_11368_length_820_cov_13.036061	417	497	0	69	80	0.8625000
NODE_11368_length_820_cov_13.036061	417	497	8	11	80	0.1375000
NODE_11369_length_820_cov_12.830791	313	393	0	80	80	1.0000000
NODE_11369_length_820_cov_12.830791	366	446	0	80	80	1.0000000
NODE_11370_length_820_cov_12.768377	366	443	0	77	77	1.0000000
NODE_11370_length_820_cov_12.768377	496	525	0	29	29	1.0000000
NODE_11371_length_820_cov_12.223301	452	519	6	67	67	1.0000000
NODE_11371_length_820_cov_12.223301	492	572	0	50	80	0.6250000
NODE_11371_length_820_cov_12.223301	492	572	6	30	80	0.3750000
NODE_11396_length_819_cov_43.027778	403	483	0	80	80	1.0000000
NODE_11396_length_819_cov_43.027778	456	536	0	80	80	1.0000000
NODE_11396_length_819_cov_43.027778	532	612	0	70	80	0.8750000
NODE_11396_length_819_cov_43.027778	532	612	9	10	80	0.1250000
NODE_11396_length_819_cov_43.027778	585	665	0	17	80	0.2125000
NODE_11396_length_819_cov_43.027778	585	665	9	42	80	0.5250000
NODE_11396_length_819_cov_43.027778	585	665	10	21	80	0.2625000
NODE_11397_length_819_cov_42.758333	391	471	0	5	80	0.0625000
NODE_11397_length_819_cov_42.758333	391	471	4	5	80	0.0625000
NODE_11397_length_819_cov_42.758333	391	471	8	70	80	0.8750000
NODE_11397_length_819_cov_42.758333	444	524	2	29	80	0.3625000
NODE_11397_length_819_cov_42.758333	444	524	6	6	80	0.0750000
NODE_11397_length_819_cov_42.758333	444	524	8	30	80	0.3750000
NODE_11397_length_819_cov_42.758333	444	524	10	15	80	0.1875000
NODE_11398_length_819_cov_41.341667	86	166	0	48	80	0.6000000
NODE_11398_length_819_cov_41.341667	86	166	6	13	80	0.1625000
NODE_11398_length_819_cov_41.341667	86	166	8	19	80	0.2375000
NODE_11398_length_819_cov_41.341667	139	219	6	35	80	0.4375000
NODE_11398_length_819_cov_41.341667	139	219	8	45	80	0.5625000
NODE_11398_length_819_cov_41.341667	215	295	6	35	80	0.4375000
NODE_11398_length_819_cov_41.341667	215	295	10	11	80	0.1375000
NODE_11398_length_819_cov_41.341667	215	295	11	2	80	0.0250000
NODE_11398_length_819_cov_41.341667	215	295	12	32	80	0.4000000
NODE_11398_length_819_cov_41.341667	268	348	4	49	80	0.6125000
NODE_11398_length_819_cov_41.341667	268	348	6	27	80	0.3375000
NODE_11398_length_819_cov_41.341667	268	348	11	1	80	0.0125000
NODE_11398_length_819_cov_41.341667	268	348	12	3	80	0.0375000
NODE_11399_length_819_cov_23.656944	335	415	6	6	80	0.0750000
NODE_11399_length_819_cov_23.656944	335	415	8	74	80	0.9250000
NODE_11399_length_819_cov_23.656944	388	468	0	19	80	0.2375000
NODE_11399_length_819_cov_23.656944	388	468	2	16	80	0.2000000
NODE_11399_length_819_cov_23.656944	388	468	6	3	80	0.0375000
NODE_11399_length_819_cov_23.656944	388	468	8	42	80	0.5250000
NODE_11400_length_819_cov_20.633333	475	555	4	6	80	0.0750000
NODE_11400_length_819_cov_20.633333	475	555	5	44	80	0.5500000
NODE_11400_length_819_cov_20.633333	475	555	7	28	80	0.3500000
NODE_11400_length_819_cov_20.633333	475	555	9	2	80	0.0250000
NODE_11400_length_819_cov_20.633333	528	608	7	78	80	0.9750000
NODE_11400_length_819_cov_20.633333	528	608	9	2	80	0.0250000
NODE_11401_length_819_cov_18.941667	307	387	0	80	80	1.0000000
NODE_11401_length_819_cov_18.941667	360	440	0	77	80	0.9625000
NODE_11401_length_819_cov_18.941667	360	440	4	3	80	0.0375000
NODE_11401_length_819_cov_18.941667	436	516	0	1	80	0.0125000
NODE_11401_length_819_cov_18.941667	436	516	4	79	80	0.9875000
NODE_11401_length_819_cov_18.941667	489	569	0	20	80	0.2500000
NODE_11401_length_819_cov_18.941667	489	569	4	60	80	0.7500000
NODE_11402_length_819_cov_12.225000	431	511	0	47	80	0.5875000
NODE_11402_length_819_cov_12.225000	431	511	2	33	80	0.4125000
NODE_11402_length_819_cov_12.225000	484	564	1	14	80	0.1750000
NODE_11402_length_819_cov_12.225000	484	564	2	29	80	0.3625000
NODE_11402_length_819_cov_12.225000	484	564	3	37	80	0.4625000
NODE_11403_length_819_cov_11.562500	273	353	0	80	80	1.0000000
NODE_11403_length_819_cov_11.562500	326	406	0	80	80	1.0000000
NODE_11404_length_819_cov_8.905556	477	557	0	80	80	1.0000000
NODE_11404_length_819_cov_8.905556	530	610	0	80	80	1.0000000
NODE_11405_length_819_cov_5.675000	232	312	0	80	80	1.0000000
NODE_11405_length_819_cov_5.675000	285	365	0	80	80	1.0000000
NODE_11431_length_818_cov_21.979138	342	422	0	26	80	0.3250000
NODE_11431_length_818_cov_21.979138	342	422	2	54	80	0.6750000
NODE_11431_length_818_cov_21.979138	395	475	0	79	80	0.9875000
NODE_11431_length_818_cov_21.979138	395	475	2	1	80	0.0125000
NODE_11432_length_818_cov_15.326843	334	414	0	80	80	1.0000000
NODE_11432_length_818_cov_15.326843	387	467	0	80	80	1.0000000
NODE_11433_length_818_cov_14.880389	392	472	0	17	80	0.2125000
NODE_11433_length_818_cov_14.880389	392	472	4	63	80	0.7875000
NODE_11433_length_818_cov_14.880389	445	525	0	46	80	0.5750000
NODE_11433_length_818_cov_14.880389	445	525	4	34	80	0.4250000
NODE_11434_length_818_cov_12.369958	390	470	0	80	80	1.0000000
NODE_11434_length_818_cov_12.369958	443	523	0	80	80	1.0000000
NODE_11436_length_818_cov_8.421419	370	450	0	80	80	1.0000000
NODE_11436_length_818_cov_8.421419	423	503	0	80	80	1.0000000
NODE_11437_length_818_cov_6.439499	706	741	0	34	35	0.9714286
NODE_11437_length_818_cov_6.439499	706	741	2	1	35	0.0285714
NODE_11439_length_818_cov_4.098748	320	390	0	31	70	0.4428571
NODE_11439_length_818_cov_4.098748	320	390	16	39	70	0.5571429
NODE_11439_length_818_cov_4.098748	416	472	10	38	56	0.6785714
NODE_11439_length_818_cov_4.098748	416	472	12	18	56	0.3214286
NODE_11457_length_817_cov_7.238162	494	574	0	80	80	1.0000000
NODE_11457_length_817_cov_7.238162	547	627	0	80	80	1.0000000
NODE_11458_length_817_cov_5.789694	400	480	0	80	80	1.0000000
NODE_11458_length_817_cov_5.789694	476	555	0	79	79	1.0000000
NODE_11458_length_817_cov_5.789694	528	608	0	80	80	1.0000000
NODE_11462_length_817_cov_4.357939	433	513	0	80	80	1.0000000
NODE_11462_length_817_cov_4.357939	486	566	0	80	80	1.0000000
NODE_11486_length_817_cov_0.692201	626	696	7	4	70	0.0571429
NODE_11486_length_817_cov_0.692201	626	696	9	2	70	0.0285714
NODE_11486_length_817_cov_0.692201	626	696	11	7	70	0.1000000
NODE_11486_length_817_cov_0.692201	626	696	15	3	70	0.0428571
NODE_11486_length_817_cov_0.692201	626	696	17	2	70	0.0285714
NODE_11486_length_817_cov_0.692201	626	696	18	1	70	0.0142857
NODE_11486_length_817_cov_0.692201	626	696	23	13	70	0.1857143
NODE_11486_length_817_cov_0.692201	626	696	24	6	70	0.0857143
NODE_11486_length_817_cov_0.692201	626	696	26	32	70	0.4571429
NODE_11488_length_816_cov_69.800558	395	475	0	80	80	1.0000000
NODE_11488_length_816_cov_69.800558	448	520	0	72	72	1.0000000
NODE_11489_length_816_cov_19.044630	77	154	0	77	77	1.0000000
NODE_11489_length_816_cov_19.044630	130	212	0	82	82	1.0000000
NODE_11490_length_816_cov_16.418410	381	461	0	80	80	1.0000000
NODE_11490_length_816_cov_16.418410	434	514	0	80	80	1.0000000
NODE_11491_length_816_cov_15.945607	319	399	0	80	80	1.0000000
NODE_11491_length_816_cov_15.945607	372	452	0	80	80	1.0000000
NODE_11492_length_816_cov_12.797768	358	438	0	80	80	1.0000000
NODE_11492_length_816_cov_12.797768	411	491	0	80	80	1.0000000
NODE_11493_length_816_cov_12.086471	242	322	0	22	80	0.2750000
NODE_11493_length_816_cov_12.086471	242	322	2	58	80	0.7250000
NODE_11493_length_816_cov_12.086471	295	375	2	80	80	1.0000000
NODE_11495_length_816_cov_3.873082	412	492	0	33	80	0.4125000
NODE_11495_length_816_cov_3.873082	412	492	2	47	80	0.5875000
NODE_11495_length_816_cov_3.873082	465	545	0	80	80	1.0000000
NODE_11516_length_815_cov_48.090782	334	414	0	80	80	1.0000000
NODE_11516_length_815_cov_48.090782	387	467	0	80	80	1.0000000
NODE_11517_length_815_cov_27.748603	290	370	4	19	80	0.2375000
NODE_11517_length_815_cov_27.748603	290	370	6	8	80	0.1000000
NODE_11517_length_815_cov_27.748603	290	370	10	53	80	0.6625000
NODE_11517_length_815_cov_27.748603	343	423	10	57	80	0.7125000
NODE_11517_length_815_cov_27.748603	343	423	12	23	80	0.2875000
NODE_11518_length_815_cov_23.748603	429	509	0	80	80	1.0000000
NODE_11518_length_815_cov_23.748603	482	562	0	80	80	1.0000000
NODE_11519_length_815_cov_14.870112	318	398	2	40	80	0.5000000
NODE_11519_length_815_cov_14.870112	318	398	4	40	80	0.5000000
NODE_11519_length_815_cov_14.870112	371	451	0	23	80	0.2875000
NODE_11519_length_815_cov_14.870112	371	451	2	41	80	0.5125000
NODE_11519_length_815_cov_14.870112	371	451	4	16	80	0.2000000
NODE_11520_length_815_cov_13.317039	338	418	0	80	80	1.0000000
NODE_11520_length_815_cov_13.317039	391	471	0	80	80	1.0000000
NODE_11521_length_815_cov_12.270950	315	395	0	10	80	0.1250000
NODE_11521_length_815_cov_12.270950	315	395	2	70	80	0.8750000
NODE_11521_length_815_cov_12.270950	368	448	0	19	80	0.2375000
NODE_11521_length_815_cov_12.270950	368	448	2	61	80	0.7625000
NODE_11522_length_815_cov_9.304469	150	230	0	80	80	1.0000000
NODE_11522_length_815_cov_9.304469	203	283	0	80	80	1.0000000
NODE_11524_length_815_cov_8.117318	437	517	0	80	80	1.0000000
NODE_11524_length_815_cov_8.117318	490	570	0	80	80	1.0000000
NODE_11530_length_815_cov_3.963687	275	355	2	80	80	1.0000000
NODE_11530_length_815_cov_3.963687	328	408	2	71	80	0.8875000
NODE_11530_length_815_cov_3.963687	328	408	4	9	80	0.1125000
NODE_11532_length_815_cov_2.976257	441	508	0	67	67	1.0000000
NODE_11554_length_814_cov_55.545455	304	384	0	80	80	1.0000000
NODE_11554_length_814_cov_55.545455	357	437	0	80	80	1.0000000
NODE_11554_length_814_cov_55.545455	517	559	0	42	42	1.0000000
NODE_11554_length_814_cov_55.545455	724	804	15	1	80	0.0125000
NODE_11554_length_814_cov_55.545455	724	804	16	3	80	0.0375000
NODE_11554_length_814_cov_55.545455	724	804	20	1	80	0.0125000
NODE_11554_length_814_cov_55.545455	724	804	21	1	80	0.0125000
NODE_11554_length_814_cov_55.545455	724	804	24	3	80	0.0375000
NODE_11554_length_814_cov_55.545455	724	804	26	3	80	0.0375000
NODE_11554_length_814_cov_55.545455	724	804	32	1	80	0.0125000
NODE_11554_length_814_cov_55.545455	724	804	33	1	80	0.0125000
NODE_11554_length_814_cov_55.545455	724	804	34	2	80	0.0250000
NODE_11554_length_814_cov_55.545455	724	804	43	2	80	0.0250000
NODE_11554_length_814_cov_55.545455	724	804	47	2	80	0.0250000
NODE_11554_length_814_cov_55.545455	724	804	49	2	80	0.0250000
NODE_11554_length_814_cov_55.545455	724	804	50	1	80	0.0125000
NODE_11554_length_814_cov_55.545455	724	804	52	1	80	0.0125000
NODE_11554_length_814_cov_55.545455	724	804	56	1	80	0.0125000
NODE_11554_length_814_cov_55.545455	724	804	59	1	80	0.0125000
NODE_11554_length_814_cov_55.545455	724	804	62	2	80	0.0250000
NODE_11554_length_814_cov_55.545455	724	804	63	8	80	0.1000000
NODE_11554_length_814_cov_55.545455	724	804	65	20	80	0.2500000
NODE_11554_length_814_cov_55.545455	724	804	66	6	80	0.0750000
NODE_11554_length_814_cov_55.545455	724	804	67	1	80	0.0125000
NODE_11554_length_814_cov_55.545455	724	804	68	9	80	0.1125000
NODE_11554_length_814_cov_55.545455	724	804	70	2	80	0.0250000
NODE_11554_length_814_cov_55.545455	724	804	71	4	80	0.0500000
NODE_11554_length_814_cov_55.545455	724	804	73	2	80	0.0250000
NODE_11555_length_814_cov_32.216783	317	397	0	9	80	0.1125000
NODE_11555_length_814_cov_32.216783	317	397	2	71	80	0.8875000
NODE_11555_length_814_cov_32.216783	370	450	0	62	80	0.7750000
NODE_11555_length_814_cov_32.216783	370	450	2	18	80	0.2250000
NODE_11556_length_814_cov_19.507692	174	254	0	80	80	1.0000000
NODE_11556_length_814_cov_19.507692	227	307	0	80	80	1.0000000
NODE_11556_length_814_cov_19.507692	303	383	0	80	80	1.0000000
NODE_11556_length_814_cov_19.507692	356	436	0	80	80	1.0000000
NODE_11557_length_814_cov_18.579021	433	513	0	16	80	0.2000000
NODE_11557_length_814_cov_18.579021	433	513	2	33	80	0.4125000
NODE_11557_length_814_cov_18.579021	433	513	4	31	80	0.3875000
NODE_11557_length_814_cov_18.579021	486	566	2	34	80	0.4250000
NODE_11557_length_814_cov_18.579021	486	566	4	46	80	0.5750000
NODE_11558_length_814_cov_17.183217	339	419	0	24	80	0.3000000
NODE_11558_length_814_cov_17.183217	339	419	4	56	80	0.7000000
NODE_11558_length_814_cov_17.183217	392	472	4	80	80	1.0000000
NODE_11559_length_814_cov_15.306294	238	318	0	80	80	1.0000000
NODE_11559_length_814_cov_15.306294	291	371	0	80	80	1.0000000
NODE_11560_length_814_cov_11.511888	397	477	2	68	80	0.8500000
NODE_11560_length_814_cov_11.511888	397	477	4	12	80	0.1500000
NODE_11560_length_814_cov_11.511888	459	530	0	14	71	0.1971831
NODE_11560_length_814_cov_11.511888	459	530	2	57	71	0.8028169
NODE_11561_length_814_cov_10.395804	305	385	0	80	80	1.0000000
NODE_11561_length_814_cov_10.395804	358	438	0	80	80	1.0000000
NODE_11562_length_814_cov_9.692308	347	427	6	20	80	0.2500000
NODE_11562_length_814_cov_9.692308	347	427	8	19	80	0.2375000
NODE_11562_length_814_cov_9.692308	347	427	10	41	80	0.5125000
NODE_11562_length_814_cov_9.692308	400	480	0	48	80	0.6000000
NODE_11562_length_814_cov_9.692308	400	480	6	25	80	0.3125000
NODE_11562_length_814_cov_9.692308	400	480	8	7	80	0.0875000
NODE_11564_length_814_cov_9.274126	245	325	0	80	80	1.0000000
NODE_11564_length_814_cov_9.274126	298	378	0	80	80	1.0000000
NODE_11565_length_814_cov_8.973427	271	351	0	45	80	0.5625000
NODE_11565_length_814_cov_8.973427	271	351	2	35	80	0.4375000
NODE_11565_length_814_cov_8.973427	324	404	2	80	80	1.0000000
NODE_11573_length_814_cov_2.145455	273	327	0	54	54	1.0000000
NODE_11573_length_814_cov_2.145455	307	371	0	64	64	1.0000000
NODE_11587_length_813_cov_39.228291	225	305	0	80	80	1.0000000
NODE_11587_length_813_cov_39.228291	278	358	0	80	80	1.0000000
NODE_11588_length_813_cov_36.570028	406	486	0	32	80	0.4000000
NODE_11588_length_813_cov_36.570028	406	486	8	48	80	0.6000000
NODE_11588_length_813_cov_36.570028	459	539	0	17	80	0.2125000
NODE_11588_length_813_cov_36.570028	459	539	8	63	80	0.7875000
NODE_11589_length_813_cov_26.718487	209	289	0	80	80	1.0000000
NODE_11589_length_813_cov_26.718487	262	342	0	80	80	1.0000000
NODE_11590_length_813_cov_17.537815	335	415	0	12	80	0.1500000
NODE_11590_length_813_cov_17.537815	335	415	6	68	80	0.8500000
NODE_11590_length_813_cov_17.537815	388	468	0	21	80	0.2625000
NODE_11590_length_813_cov_17.537815	388	468	6	59	80	0.7375000
NODE_11591_length_813_cov_14.243697	279	359	0	80	80	1.0000000
NODE_11591_length_813_cov_14.243697	332	412	0	80	80	1.0000000
NODE_11592_length_813_cov_13.984594	307	387	0	80	80	1.0000000
NODE_11592_length_813_cov_13.984594	360	440	0	80	80	1.0000000
NODE_11593_length_813_cov_13.242297	336	416	0	80	80	1.0000000
NODE_11593_length_813_cov_13.242297	389	469	0	80	80	1.0000000
NODE_11594_length_813_cov_11.985994	374	454	0	40	80	0.5000000
NODE_11594_length_813_cov_11.985994	374	454	2	40	80	0.5000000
NODE_11594_length_813_cov_11.985994	427	507	0	24	80	0.3000000
NODE_11594_length_813_cov_11.985994	427	507	2	56	80	0.7000000
NODE_11595_length_813_cov_11.668067	279	359	0	80	80	1.0000000
NODE_11595_length_813_cov_11.668067	332	412	0	80	80	1.0000000
NODE_11596_length_813_cov_8.149860	538	618	0	80	80	1.0000000
NODE_11596_length_813_cov_8.149860	591	671	0	80	80	1.0000000
NODE_11597_length_813_cov_7.098039	234	314	0	80	80	1.0000000
NODE_11597_length_813_cov_7.098039	287	367	0	80	80	1.0000000
NODE_11613_length_812_cov_45.183731	435	515	0	7	80	0.0875000
NODE_11613_length_812_cov_45.183731	435	515	2	73	80	0.9125000
NODE_11613_length_812_cov_45.183731	488	568	0	60	80	0.7500000
NODE_11613_length_812_cov_45.183731	488	568	2	20	80	0.2500000
NODE_11614_length_812_cov_23.862553	386	466	0	6	80	0.0750000
NODE_11614_length_812_cov_23.862553	386	466	8	74	80	0.9250000
NODE_11614_length_812_cov_23.862553	439	519	8	80	80	1.0000000
NODE_11615_length_812_cov_23.516129	295	375	0	80	80	1.0000000
NODE_11615_length_812_cov_23.516129	348	428	0	80	80	1.0000000
NODE_11616_length_812_cov_15.577840	509	589	0	80	80	1.0000000
NODE_11616_length_812_cov_15.577840	562	644	0	82	82	1.0000000
NODE_11617_length_812_cov_13.277700	257	331	0	74	74	1.0000000
NODE_11617_length_812_cov_13.277700	304	384	0	80	80	1.0000000
NODE_11619_length_812_cov_6.697055	309	389	0	80	80	1.0000000
NODE_11619_length_812_cov_6.697055	362	442	0	80	80	1.0000000
NODE_11642_length_811_cov_65.762640	418	492	5	22	74	0.2972973
NODE_11642_length_811_cov_65.762640	418	492	6	23	74	0.3108108
NODE_11642_length_811_cov_65.762640	418	492	8	29	74	0.3918919
NODE_11642_length_811_cov_65.762640	471	545	0	6	74	0.0810811
NODE_11642_length_811_cov_65.762640	471	545	2	31	74	0.4189189
NODE_11642_length_811_cov_65.762640	471	545	3	4	74	0.0540541
NODE_11642_length_811_cov_65.762640	471	545	5	33	74	0.4459459
NODE_11643_length_811_cov_62.933989	457	537	0	80	80	1.0000000
NODE_11643_length_811_cov_62.933989	510	590	0	80	80	1.0000000
NODE_11644_length_811_cov_26.401685	397	477	0	66	80	0.8250000
NODE_11644_length_811_cov_26.401685	397	477	6	14	80	0.1750000
NODE_11644_length_811_cov_26.401685	450	530	0	13	80	0.1625000
NODE_11644_length_811_cov_26.401685	450	530	6	67	80	0.8375000
NODE_11645_length_811_cov_23.009831	189	269	0	80	80	1.0000000
NODE_11645_length_811_cov_23.009831	242	322	0	80	80	1.0000000
NODE_11646_length_811_cov_20.523876	375	455	0	80	80	1.0000000
NODE_11646_length_811_cov_20.523876	428	508	0	80	80	1.0000000
NODE_11647_length_811_cov_17.386236	421	501	0	80	80	1.0000000
NODE_11647_length_811_cov_17.386236	474	554	0	80	80	1.0000000
NODE_11648_length_811_cov_15.279494	368	448	0	52	80	0.6500000
NODE_11648_length_811_cov_15.279494	368	448	2	13	80	0.1625000
NODE_11648_length_811_cov_15.279494	368	448	4	15	80	0.1875000
NODE_11648_length_811_cov_15.279494	421	502	2	12	81	0.1481481
NODE_11648_length_811_cov_15.279494	421	502	3	3	81	0.0370370
NODE_11648_length_811_cov_15.279494	421	502	4	66	81	0.8148148
NODE_11649_length_811_cov_14.543539	222	302	0	80	80	1.0000000
NODE_11649_length_811_cov_14.543539	275	355	0	80	80	1.0000000
NODE_11650_length_811_cov_12.196629	402	482	0	15	80	0.1875000
NODE_11650_length_811_cov_12.196629	402	482	4	14	80	0.1750000
NODE_11650_length_811_cov_12.196629	402	482	8	51	80	0.6375000
NODE_11650_length_811_cov_12.196629	455	535	0	68	80	0.8500000
NODE_11650_length_811_cov_12.196629	455	535	4	12	80	0.1500000
NODE_11651_length_811_cov_12.117978	289	369	0	35	80	0.4375000
NODE_11651_length_811_cov_12.117978	289	369	2	45	80	0.5625000
NODE_11651_length_811_cov_12.117978	342	422	0	80	80	1.0000000
NODE_11652_length_811_cov_11.886236	330	410	0	20	80	0.2500000
NODE_11652_length_811_cov_11.886236	330	410	2	60	80	0.7500000
NODE_11652_length_811_cov_11.886236	383	463	0	5	80	0.0625000
NODE_11652_length_811_cov_11.886236	383	463	2	75	80	0.9375000
NODE_11653_length_811_cov_10.602528	342	422	2	80	80	1.0000000
NODE_11653_length_811_cov_10.602528	395	461	0	2	66	0.0303030
NODE_11653_length_811_cov_10.602528	395	461	2	64	66	0.9696970
NODE_11653_length_811_cov_10.602528	452	519	0	60	67	0.8955224
NODE_11653_length_811_cov_10.602528	452	519	2	7	67	0.1044776
NODE_11653_length_811_cov_10.602528	492	572	0	80	80	1.0000000
NODE_11654_length_811_cov_7.539326	324	404	0	80	80	1.0000000
NODE_11654_length_811_cov_7.539326	377	457	0	80	80	1.0000000
NODE_11655_length_811_cov_6.398876	419	499	0	80	80	1.0000000
NODE_11655_length_811_cov_6.398876	472	552	0	80	80	1.0000000
NODE_11657_length_811_cov_5.939607	496	527	0	31	31	1.0000000
NODE_11657_length_811_cov_5.939607	528	603	0	22	75	0.2933333
NODE_11657_length_811_cov_5.939607	528	603	2	53	75	0.7066666
NODE_11669_length_811_cov_1.501404	645	676	0	17	31	0.5483871
NODE_11669_length_811_cov_1.501404	645	676	2	14	31	0.4516129
NODE_11684_length_810_cov_42.358650	484	564	0	80	80	1.0000000
NODE_11684_length_810_cov_42.358650	537	617	0	80	80	1.0000000
NODE_11685_length_810_cov_38.604782	370	450	0	80	80	1.0000000
NODE_11685_length_810_cov_38.604782	423	499	0	76	76	1.0000000
NODE_11686_length_810_cov_20.354430	338	418	0	80	80	1.0000000
NODE_11686_length_810_cov_20.354430	391	471	0	80	80	1.0000000
NODE_11688_length_810_cov_12.367089	144	224	0	26	80	0.3250000
NODE_11688_length_810_cov_12.367089	144	224	2	54	80	0.6750000
NODE_11688_length_810_cov_12.367089	197	277	2	80	80	1.0000000
NODE_11689_length_810_cov_8.886076	333	399	0	66	66	1.0000000
NODE_11690_length_810_cov_8.291139	446	526	0	80	80	1.0000000
NODE_11690_length_810_cov_8.291139	499	579	0	80	80	1.0000000
NODE_11692_length_810_cov_7.213783	335	406	0	58	71	0.8169014
NODE_11692_length_810_cov_7.213783	335	406	2	13	71	0.1830986
NODE_11692_length_810_cov_7.213783	335	416	0	58	81	0.7160494
NODE_11692_length_810_cov_7.213783	335	416	2	23	81	0.2839506
NODE_11692_length_810_cov_7.213783	379	459	0	14	80	0.1750000
NODE_11692_length_810_cov_7.213783	379	459	2	66	80	0.8250000
NODE_11714_length_809_cov_40.536620	428	500	0	72	72	1.0000000
NODE_11714_length_809_cov_40.536620	473	553	0	32	80	0.4000000
NODE_11714_length_809_cov_40.536620	473	553	2	48	80	0.6000000
NODE_11715_length_809_cov_15.871831	385	465	0	69	80	0.8625000
NODE_11715_length_809_cov_15.871831	385	465	2	11	80	0.1375000
NODE_11715_length_809_cov_15.871831	402	465	0	52	63	0.8253968
NODE_11715_length_809_cov_15.871831	402	465	2	11	63	0.1746032
NODE_11715_length_809_cov_15.871831	438	518	0	16	80	0.2000000
NODE_11715_length_809_cov_15.871831	438	518	2	64	80	0.8000000
NODE_11715_length_809_cov_15.871831	438	518	0	16	80	0.2000000
NODE_11715_length_809_cov_15.871831	438	518	2	64	80	0.8000000
NODE_11716_length_809_cov_15.019718	286	366	0	80	80	1.0000000
NODE_11716_length_809_cov_15.019718	339	419	0	41	80	0.5125000
NODE_11716_length_809_cov_15.019718	339	419	2	39	80	0.4875000
NODE_11718_length_809_cov_4.483099	244	324	5	11	80	0.1375000
NODE_11718_length_809_cov_4.483099	244	324	6	43	80	0.5375000
NODE_11718_length_809_cov_4.483099	244	324	8	26	80	0.3250000
NODE_11718_length_809_cov_4.483099	278	324	5	11	46	0.2391304
NODE_11718_length_809_cov_4.483099	278	324	6	32	46	0.6956522
NODE_11718_length_809_cov_4.483099	278	324	8	3	46	0.0652174
NODE_11718_length_809_cov_4.483099	298	377	2	25	79	0.3164557
NODE_11718_length_809_cov_4.483099	298	377	3	9	79	0.1139240
NODE_11718_length_809_cov_4.483099	298	377	4	10	79	0.1265823
NODE_11718_length_809_cov_4.483099	298	377	5	20	79	0.2531646
NODE_11718_length_809_cov_4.483099	298	377	6	15	79	0.1898734
NODE_11718_length_809_cov_4.483099	308	377	2	25	69	0.3623188
NODE_11718_length_809_cov_4.483099	308	377	3	9	69	0.1304348
NODE_11718_length_809_cov_4.483099	308	377	4	10	69	0.1449275
NODE_11718_length_809_cov_4.483099	308	377	5	20	69	0.2898551
NODE_11718_length_809_cov_4.483099	308	377	6	5	69	0.0724638
NODE_11738_length_808_cov_45.023977	325	405	0	80	80	1.0000000
NODE_11738_length_808_cov_45.023977	378	458	0	80	80	1.0000000
NODE_11739_length_808_cov_24.087447	287	367	4	80	80	1.0000000
NODE_11739_length_808_cov_24.087447	340	420	0	39	80	0.4875000
NODE_11739_length_808_cov_24.087447	340	420	4	41	80	0.5125000
NODE_11740_length_808_cov_21.867419	324	404	2	72	80	0.9000000
NODE_11740_length_808_cov_21.867419	324	404	3	1	80	0.0125000
NODE_11740_length_808_cov_21.867419	324	404	4	7	80	0.0875000
NODE_11740_length_808_cov_21.867419	377	457	0	49	80	0.6125000
NODE_11740_length_808_cov_21.867419	377	457	2	31	80	0.3875000
NODE_11741_length_808_cov_16.289140	333	413	0	80	80	1.0000000
NODE_11741_length_808_cov_16.289140	386	466	0	80	80	1.0000000
NODE_11742_length_808_cov_14.489422	307	387	0	80	80	1.0000000
NODE_11742_length_808_cov_14.489422	360	440	0	80	80	1.0000000
NODE_11744_length_808_cov_10.507757	317	397	0	80	80	1.0000000
NODE_11744_length_808_cov_10.507757	370	450	0	80	80	1.0000000
NODE_11745_length_808_cov_10.066291	483	563	0	80	80	1.0000000
NODE_11745_length_808_cov_10.066291	536	616	0	80	80	1.0000000
NODE_11746_length_808_cov_7.581100	358	438	0	80	80	1.0000000
NODE_11746_length_808_cov_7.581100	411	491	0	80	80	1.0000000
NODE_11756_length_808_cov_3.283498	471	551	0	21	80	0.2625000
NODE_11756_length_808_cov_3.283498	471	551	2	59	80	0.7375000
NODE_11756_length_808_cov_3.283498	524	604	0	49	80	0.6125000
NODE_11756_length_808_cov_3.283498	524	604	2	31	80	0.3875000
NODE_11783_length_807_cov_67.341808	2	25	75	1	23	0.0434783
NODE_11783_length_807_cov_67.341808	2	25	84	1	23	0.0434783
NODE_11783_length_807_cov_67.341808	2	25	86	1	23	0.0434783
NODE_11783_length_807_cov_67.341808	2	25	94	1	23	0.0434783
NODE_11783_length_807_cov_67.341808	2	25	101	1	23	0.0434783
NODE_11783_length_807_cov_67.341808	2	25	105	1	23	0.0434783
NODE_11783_length_807_cov_67.341808	2	25	114	1	23	0.0434783
NODE_11783_length_807_cov_67.341808	2	25	126	1	23	0.0434783
NODE_11783_length_807_cov_67.341808	2	25	138	1	23	0.0434783
NODE_11783_length_807_cov_67.341808	2	25	160	1	23	0.0434783
NODE_11783_length_807_cov_67.341808	2	25	166	1	23	0.0434783
NODE_11783_length_807_cov_67.341808	2	25	175	1	23	0.0434783
NODE_11783_length_807_cov_67.341808	2	25	187	1	23	0.0434783
NODE_11783_length_807_cov_67.341808	2	25	194	1	23	0.0434783
NODE_11783_length_807_cov_67.341808	2	25	203	1	23	0.0434783
NODE_11783_length_807_cov_67.341808	2	25	207	1	23	0.0434783
NODE_11783_length_807_cov_67.341808	2	25	214	1	23	0.0434783
NODE_11783_length_807_cov_67.341808	2	25	220	1	23	0.0434783
NODE_11783_length_807_cov_67.341808	2	25	235	1	23	0.0434783
NODE_11783_length_807_cov_67.341808	2	25	239	1	23	0.0434783
NODE_11783_length_807_cov_67.341808	2	25	243	1	23	0.0434783
NODE_11783_length_807_cov_67.341808	2	25	260	1	23	0.0434783
NODE_11783_length_807_cov_67.341808	2	25	264	1	23	0.0434783
NODE_11783_length_807_cov_67.341808	339	370	473	1	31	0.0322581
NODE_11783_length_807_cov_67.341808	339	370	477	1	31	0.0322581
NODE_11783_length_807_cov_67.341808	339	370	485	1	31	0.0322581
NODE_11783_length_807_cov_67.341808	339	370	497	1	31	0.0322581
NODE_11783_length_807_cov_67.341808	339	370	499	3	31	0.0967742
NODE_11783_length_807_cov_67.341808	339	370	515	1	31	0.0322581
NODE_11783_length_807_cov_67.341808	339	370	537	1	31	0.0322581
NODE_11783_length_807_cov_67.341808	339	370	560	1	31	0.0322581
NODE_11783_length_807_cov_67.341808	339	370	563	1	31	0.0322581
NODE_11783_length_807_cov_67.341808	339	370	576	1	31	0.0322581
NODE_11783_length_807_cov_67.341808	339	370	591	2	31	0.0645161
NODE_11783_length_807_cov_67.341808	339	370	593	1	31	0.0322581
NODE_11783_length_807_cov_67.341808	339	370	615	1	31	0.0322581
NODE_11783_length_807_cov_67.341808	339	370	616	1	31	0.0322581
NODE_11783_length_807_cov_67.341808	339	370	637	1	31	0.0322581
NODE_11783_length_807_cov_67.341808	339	370	640	1	31	0.0322581
NODE_11783_length_807_cov_67.341808	339	370	646	1	31	0.0322581
NODE_11783_length_807_cov_67.341808	339	370	663	1	31	0.0322581
NODE_11783_length_807_cov_67.341808	339	370	670	1	31	0.0322581
NODE_11783_length_807_cov_67.341808	339	370	681	1	31	0.0322581
NODE_11783_length_807_cov_67.341808	339	370	682	2	31	0.0645161
NODE_11783_length_807_cov_67.341808	339	370	685	1	31	0.0322581
NODE_11783_length_807_cov_67.341808	339	370	686	1	31	0.0322581
NODE_11783_length_807_cov_67.341808	339	370	691	2	31	0.0645161
NODE_11783_length_807_cov_67.341808	339	370	693	1	31	0.0322581
NODE_11783_length_807_cov_67.341808	339	370	700	1	31	0.0322581
NODE_11783_length_807_cov_67.341808	343	423	499	3	80	0.0375000
NODE_11783_length_807_cov_67.341808	343	423	515	1	80	0.0125000
NODE_11783_length_807_cov_67.341808	343	423	537	1	80	0.0125000
NODE_11783_length_807_cov_67.341808	343	423	560	1	80	0.0125000
NODE_11783_length_807_cov_67.341808	343	423	563	1	80	0.0125000
NODE_11783_length_807_cov_67.341808	343	423	576	1	80	0.0125000
NODE_11783_length_807_cov_67.341808	343	423	591	2	80	0.0250000
NODE_11783_length_807_cov_67.341808	343	423	593	1	80	0.0125000
NODE_11783_length_807_cov_67.341808	343	423	615	1	80	0.0125000
NODE_11783_length_807_cov_67.341808	343	423	616	1	80	0.0125000
NODE_11783_length_807_cov_67.341808	343	423	637	1	80	0.0125000
NODE_11783_length_807_cov_67.341808	343	423	640	1	80	0.0125000
NODE_11783_length_807_cov_67.341808	343	423	646	1	80	0.0125000
NODE_11783_length_807_cov_67.341808	343	423	663	1	80	0.0125000
NODE_11783_length_807_cov_67.341808	343	423	670	1	80	0.0125000
NODE_11783_length_807_cov_67.341808	343	423	681	1	80	0.0125000
NODE_11783_length_807_cov_67.341808	343	423	682	2	80	0.0250000
NODE_11783_length_807_cov_67.341808	343	423	685	1	80	0.0125000
NODE_11783_length_807_cov_67.341808	343	423	686	1	80	0.0125000
NODE_11783_length_807_cov_67.341808	343	423	691	2	80	0.0250000
NODE_11783_length_807_cov_67.341808	343	423	693	1	80	0.0125000
NODE_11783_length_807_cov_67.341808	343	423	700	1	80	0.0125000
NODE_11783_length_807_cov_67.341808	343	423	701	5	80	0.0625000
NODE_11783_length_807_cov_67.341808	343	423	703	2	80	0.0250000
NODE_11783_length_807_cov_67.341808	343	423	705	2	80	0.0250000
NODE_11783_length_807_cov_67.341808	343	423	707	2	80	0.0250000
NODE_11783_length_807_cov_67.341808	343	423	708	1	80	0.0125000
NODE_11783_length_807_cov_67.341808	343	423	710	1	80	0.0125000
NODE_11783_length_807_cov_67.341808	343	423	712	1	80	0.0125000
NODE_11783_length_807_cov_67.341808	343	423	714	1	80	0.0125000
NODE_11783_length_807_cov_67.341808	343	423	716	1	80	0.0125000
NODE_11783_length_807_cov_67.341808	343	423	717	1	80	0.0125000
NODE_11783_length_807_cov_67.341808	343	423	718	2	80	0.0250000
NODE_11783_length_807_cov_67.341808	343	423	720	3	80	0.0375000
NODE_11783_length_807_cov_67.341808	343	423	722	1	80	0.0125000
NODE_11783_length_807_cov_67.341808	343	423	724	1	80	0.0125000
NODE_11783_length_807_cov_67.341808	343	423	731	1	80	0.0125000
NODE_11783_length_807_cov_67.341808	343	423	734	1	80	0.0125000
NODE_11783_length_807_cov_67.341808	343	423	740	1	80	0.0125000
NODE_11783_length_807_cov_67.341808	343	423	743	1	80	0.0125000
NODE_11783_length_807_cov_67.341808	343	423	744	2	80	0.0250000
NODE_11783_length_807_cov_67.341808	343	423	746	1	80	0.0125000
NODE_11783_length_807_cov_67.341808	343	423	749	1	80	0.0125000
NODE_11783_length_807_cov_67.341808	343	423	750	1	80	0.0125000
NODE_11783_length_807_cov_67.341808	343	423	752	1	80	0.0125000
NODE_11783_length_807_cov_67.341808	343	423	753	1	80	0.0125000
NODE_11783_length_807_cov_67.341808	343	423	755	2	80	0.0250000
NODE_11783_length_807_cov_67.341808	343	423	756	2	80	0.0250000
NODE_11783_length_807_cov_67.341808	343	423	759	1	80	0.0125000
NODE_11783_length_807_cov_67.341808	343	423	763	1	80	0.0125000
NODE_11783_length_807_cov_67.341808	343	423	764	1	80	0.0125000
NODE_11783_length_807_cov_67.341808	343	423	766	1	80	0.0125000
NODE_11783_length_807_cov_67.341808	343	423	767	1	80	0.0125000
NODE_11783_length_807_cov_67.341808	343	423	771	1	80	0.0125000
NODE_11783_length_807_cov_67.341808	343	423	773	2	80	0.0250000
NODE_11783_length_807_cov_67.341808	343	423	774	1	80	0.0125000
NODE_11783_length_807_cov_67.341808	343	423	775	1	80	0.0125000
NODE_11783_length_807_cov_67.341808	343	423	777	1	80	0.0125000
NODE_11783_length_807_cov_67.341808	343	423	783	1	80	0.0125000
NODE_11783_length_807_cov_67.341808	343	423	788	1	80	0.0125000
NODE_11783_length_807_cov_67.341808	343	423	790	1	80	0.0125000
NODE_11784_length_807_cov_54.980226	683	749	185	2	66	0.0303030
NODE_11784_length_807_cov_54.980226	683	749	186	3	66	0.0454545
NODE_11784_length_807_cov_54.980226	683	749	188	1	66	0.0151515
NODE_11784_length_807_cov_54.980226	683	749	190	1	66	0.0151515
NODE_11784_length_807_cov_54.980226	683	749	191	1	66	0.0151515
NODE_11784_length_807_cov_54.980226	683	749	194	1	66	0.0151515
NODE_11784_length_807_cov_54.980226	683	749	196	2	66	0.0303030
NODE_11784_length_807_cov_54.980226	683	749	201	7	66	0.1060606
NODE_11784_length_807_cov_54.980226	683	749	205	3	66	0.0454545
NODE_11784_length_807_cov_54.980226	683	749	207	1	66	0.0151515
NODE_11784_length_807_cov_54.980226	683	749	209	2	66	0.0303030
NODE_11784_length_807_cov_54.980226	683	749	216	1	66	0.0151515
NODE_11784_length_807_cov_54.980226	683	749	221	1	66	0.0151515
NODE_11784_length_807_cov_54.980226	683	749	228	2	66	0.0303030
NODE_11784_length_807_cov_54.980226	683	749	230	2	66	0.0303030
NODE_11784_length_807_cov_54.980226	683	749	231	1	66	0.0151515
NODE_11784_length_807_cov_54.980226	683	749	233	1	66	0.0151515
NODE_11784_length_807_cov_54.980226	683	749	235	1	66	0.0151515
NODE_11784_length_807_cov_54.980226	683	749	251	1	66	0.0151515
NODE_11784_length_807_cov_54.980226	683	749	252	2	66	0.0303030
NODE_11784_length_807_cov_54.980226	683	749	255	7	66	0.1060606
NODE_11784_length_807_cov_54.980226	683	749	256	2	66	0.0303030
NODE_11784_length_807_cov_54.980226	683	749	260	2	66	0.0303030
NODE_11784_length_807_cov_54.980226	683	749	262	1	66	0.0151515
NODE_11784_length_807_cov_54.980226	683	749	263	1	66	0.0151515
NODE_11784_length_807_cov_54.980226	683	749	264	2	66	0.0303030
NODE_11784_length_807_cov_54.980226	683	749	266	2	66	0.0303030
NODE_11784_length_807_cov_54.980226	683	749	267	5	66	0.0757576
NODE_11784_length_807_cov_54.980226	683	749	268	2	66	0.0303030
NODE_11784_length_807_cov_54.980226	683	749	269	4	66	0.0606061
NODE_11784_length_807_cov_54.980226	683	749	270	1	66	0.0151515
NODE_11784_length_807_cov_54.980226	683	749	272	1	66	0.0151515
NODE_11784_length_807_cov_54.980226	727	802	38	1	75	0.0133333
NODE_11784_length_807_cov_54.980226	727	802	42	1	75	0.0133333
NODE_11784_length_807_cov_54.980226	727	802	45	1	75	0.0133333
NODE_11784_length_807_cov_54.980226	727	802	47	1	75	0.0133333
NODE_11784_length_807_cov_54.980226	727	802	49	1	75	0.0133333
NODE_11784_length_807_cov_54.980226	727	802	51	1	75	0.0133333
NODE_11784_length_807_cov_54.980226	727	802	55	2	75	0.0266667
NODE_11784_length_807_cov_54.980226	727	802	59	1	75	0.0133333
NODE_11784_length_807_cov_54.980226	727	802	63	1	75	0.0133333
NODE_11784_length_807_cov_54.980226	727	802	65	2	75	0.0266667
NODE_11784_length_807_cov_54.980226	727	802	66	1	75	0.0133333
NODE_11784_length_807_cov_54.980226	727	802	73	1	75	0.0133333
NODE_11784_length_807_cov_54.980226	727	802	77	1	75	0.0133333
NODE_11784_length_807_cov_54.980226	727	802	83	2	75	0.0266667
NODE_11784_length_807_cov_54.980226	727	802	85	1	75	0.0133333
NODE_11784_length_807_cov_54.980226	727	802	93	2	75	0.0266667
NODE_11784_length_807_cov_54.980226	727	802	110	1	75	0.0133333
NODE_11784_length_807_cov_54.980226	727	802	113	1	75	0.0133333
NODE_11784_length_807_cov_54.980226	727	802	114	1	75	0.0133333
NODE_11784_length_807_cov_54.980226	727	802	120	1	75	0.0133333
NODE_11784_length_807_cov_54.980226	727	802	130	2	75	0.0266667
NODE_11784_length_807_cov_54.980226	727	802	132	2	75	0.0266667
NODE_11784_length_807_cov_54.980226	727	802	137	3	75	0.0400000
NODE_11784_length_807_cov_54.980226	727	802	141	2	75	0.0266667
NODE_11784_length_807_cov_54.980226	727	802	143	2	75	0.0266667
NODE_11784_length_807_cov_54.980226	727	802	152	3	75	0.0400000
NODE_11784_length_807_cov_54.980226	727	802	158	1	75	0.0133333
NODE_11784_length_807_cov_54.980226	727	802	160	2	75	0.0266667
NODE_11784_length_807_cov_54.980226	727	802	164	3	75	0.0400000
NODE_11784_length_807_cov_54.980226	727	802	169	1	75	0.0133333
NODE_11784_length_807_cov_54.980226	727	802	171	1	75	0.0133333
NODE_11784_length_807_cov_54.980226	727	802	176	3	75	0.0400000
NODE_11784_length_807_cov_54.980226	727	802	178	1	75	0.0133333
NODE_11784_length_807_cov_54.980226	727	802	184	3	75	0.0400000
NODE_11784_length_807_cov_54.980226	727	802	185	2	75	0.0266667
NODE_11784_length_807_cov_54.980226	727	802	186	3	75	0.0400000
NODE_11784_length_807_cov_54.980226	727	802	188	1	75	0.0133333
NODE_11784_length_807_cov_54.980226	727	802	190	1	75	0.0133333
NODE_11784_length_807_cov_54.980226	727	802	191	1	75	0.0133333
NODE_11784_length_807_cov_54.980226	727	802	194	1	75	0.0133333
NODE_11784_length_807_cov_54.980226	727	802	196	2	75	0.0266667
NODE_11784_length_807_cov_54.980226	727	802	201	7	75	0.0933333
NODE_11784_length_807_cov_54.980226	727	802	205	3	75	0.0400000
NODE_11784_length_807_cov_54.980226	727	802	207	1	75	0.0133333
NODE_11785_length_807_cov_37.306497	435	515	0	80	80	1.0000000
NODE_11785_length_807_cov_37.306497	488	568	0	80	80	1.0000000
NODE_11786_length_807_cov_31.177966	287	367	0	14	80	0.1750000
NODE_11786_length_807_cov_31.177966	287	367	2	66	80	0.8250000
NODE_11786_length_807_cov_31.177966	340	420	0	36	80	0.4500000
NODE_11786_length_807_cov_31.177966	340	420	2	44	80	0.5500000
NODE_11787_length_807_cov_30.638418	250	329	4	2	79	0.0253165
NODE_11787_length_807_cov_30.638418	250	329	9	5	79	0.0632911
NODE_11787_length_807_cov_30.638418	250	329	10	72	79	0.9113924
NODE_11787_length_807_cov_30.638418	302	382	6	17	80	0.2125000
NODE_11787_length_807_cov_30.638418	302	382	8	4	80	0.0500000
NODE_11787_length_807_cov_30.638418	302	382	9	37	80	0.4625000
NODE_11787_length_807_cov_30.638418	302	382	10	22	80	0.2750000
NODE_11787_length_807_cov_30.638418	378	458	0	38	80	0.4750000
NODE_11787_length_807_cov_30.638418	378	458	4	18	80	0.2250000
NODE_11787_length_807_cov_30.638418	378	458	6	24	80	0.3000000
NODE_11787_length_807_cov_30.638418	431	511	0	9	80	0.1125000
NODE_11787_length_807_cov_30.638418	431	511	4	71	80	0.8875000
NODE_11788_length_807_cov_29.725989	362	442	0	46	80	0.5750000
NODE_11788_length_807_cov_29.725989	362	442	4	34	80	0.4250000
NODE_11788_length_807_cov_29.725989	415	495	4	80	80	1.0000000
NODE_11789_length_807_cov_23.200565	441	521	0	80	80	1.0000000
NODE_11789_length_807_cov_23.200565	494	574	0	80	80	1.0000000
NODE_11790_length_807_cov_21.888418	319	386	0	67	67	1.0000000
NODE_11790_length_807_cov_21.888418	390	440	0	50	50	1.0000000
NODE_11791_length_807_cov_17.480226	339	419	0	80	80	1.0000000
NODE_11791_length_807_cov_17.480226	392	472	0	80	80	1.0000000
NODE_11792_length_807_cov_14.895480	350	430	0	80	80	1.0000000
NODE_11792_length_807_cov_14.895480	403	483	0	80	80	1.0000000
NODE_11794_length_807_cov_12.255650	440	520	0	80	80	1.0000000
NODE_11794_length_807_cov_12.255650	493	573	0	80	80	1.0000000
NODE_11795_length_807_cov_11.129944	359	439	0	80	80	1.0000000
NODE_11795_length_807_cov_11.129944	412	492	0	71	80	0.8875000
NODE_11795_length_807_cov_11.129944	412	492	2	9	80	0.1125000
NODE_11801_length_807_cov_3.847458	322	385	0	63	63	1.0000000
NODE_11822_length_806_cov_35.650636	397	477	0	80	80	1.0000000
NODE_11822_length_806_cov_35.650636	450	530	0	80	80	1.0000000
NODE_11822_length_806_cov_35.650636	526	606	0	27	80	0.3375000
NODE_11822_length_806_cov_35.650636	526	606	11	17	80	0.2125000
NODE_11822_length_806_cov_35.650636	526	606	12	36	80	0.4500000
NODE_11822_length_806_cov_35.650636	579	667	11	78	88	0.8863636
NODE_11822_length_806_cov_35.650636	579	667	12	10	88	0.1136364
NODE_11823_length_806_cov_29.615276	377	457	6	4	80	0.0500000
NODE_11823_length_806_cov_29.615276	377	457	20	12	80	0.1500000
NODE_11823_length_806_cov_29.615276	377	457	24	64	80	0.8000000
NODE_11823_length_806_cov_29.615276	430	510	0	22	80	0.2750000
NODE_11823_length_806_cov_29.615276	430	510	4	8	80	0.1000000
NODE_11823_length_806_cov_29.615276	430	510	18	13	80	0.1625000
NODE_11823_length_806_cov_29.615276	430	510	20	16	80	0.2000000
NODE_11823_length_806_cov_29.615276	430	510	24	21	80	0.2625000
NODE_11824_length_806_cov_23.680339	394	474	0	80	80	1.0000000
NODE_11824_length_806_cov_23.680339	447	527	0	80	80	1.0000000
NODE_11825_length_806_cov_19.107496	239	293	0	54	54	1.0000000
NODE_11825_length_806_cov_19.107496	248	293	0	45	45	1.0000000
NODE_11825_length_806_cov_19.107496	266	345	0	79	79	1.0000000
NODE_11825_length_806_cov_19.107496	266	345	0	79	79	1.0000000
NODE_11825_length_806_cov_19.107496	421	501	8	8	80	0.1000000
NODE_11825_length_806_cov_19.107496	421	501	14	72	80	0.9000000
NODE_11826_length_806_cov_17.551627	308	388	2	80	80	1.0000000
NODE_11826_length_806_cov_17.551627	361	441	0	5	80	0.0625000
NODE_11826_length_806_cov_17.551627	361	441	2	75	80	0.9375000
NODE_11827_length_806_cov_15.608204	408	488	6	1	80	0.0125000
NODE_11827_length_806_cov_15.608204	408	488	8	1	80	0.0125000
NODE_11827_length_806_cov_15.608204	408	488	11	5	80	0.0625000
NODE_11827_length_806_cov_15.608204	408	488	12	20	80	0.2500000
NODE_11827_length_806_cov_15.608204	408	488	14	18	80	0.2250000
NODE_11827_length_806_cov_15.608204	408	488	16	35	80	0.4375000
NODE_11827_length_806_cov_15.608204	461	543	0	23	82	0.2804878
NODE_11827_length_806_cov_15.608204	461	543	1	11	82	0.1341463
NODE_11827_length_806_cov_15.608204	461	543	3	3	82	0.0365854
NODE_11827_length_806_cov_15.608204	461	543	7	1	82	0.0121951
NODE_11827_length_806_cov_15.608204	461	543	11	22	82	0.2682927
NODE_11827_length_806_cov_15.608204	461	543	12	1	82	0.0121951
NODE_11827_length_806_cov_15.608204	461	543	14	6	82	0.0731707
NODE_11827_length_806_cov_15.608204	461	543	16	15	82	0.1829268
NODE_11864_length_805_cov_94.121813	398	478	0	10	80	0.1250000
NODE_11864_length_805_cov_94.121813	398	478	4	52	80	0.6500000
NODE_11864_length_805_cov_94.121813	398	478	7	18	80	0.2250000
NODE_11864_length_805_cov_94.121813	451	531	0	2	80	0.0250000
NODE_11864_length_805_cov_94.121813	451	531	3	4	80	0.0500000
NODE_11864_length_805_cov_94.121813	451	531	4	45	80	0.5625000
NODE_11864_length_805_cov_94.121813	451	531	7	29	80	0.3625000
NODE_11865_length_805_cov_54.001416	284	364	0	80	80	1.0000000
NODE_11865_length_805_cov_54.001416	337	417	0	80	80	1.0000000
NODE_11865_length_805_cov_54.001416	413	493	0	80	80	1.0000000
NODE_11865_length_805_cov_54.001416	466	546	0	80	80	1.0000000
NODE_11866_length_805_cov_42.325779	377	457	0	80	80	1.0000000
NODE_11866_length_805_cov_42.325779	430	510	0	58	80	0.7250000
NODE_11866_length_805_cov_42.325779	430	510	2	22	80	0.2750000
NODE_11867_length_805_cov_36.742210	345	425	0	10	80	0.1250000
NODE_11867_length_805_cov_36.742210	345	425	2	70	80	0.8750000
NODE_11867_length_805_cov_36.742210	398	478	0	8	80	0.1000000
NODE_11867_length_805_cov_36.742210	398	478	2	72	80	0.9000000
NODE_11868_length_805_cov_25.879603	361	441	0	2	80	0.0250000
NODE_11868_length_805_cov_25.879603	361	441	2	78	80	0.9750000
NODE_11868_length_805_cov_25.879603	414	494	2	80	80	1.0000000
NODE_11869_length_805_cov_25.048159	306	386	0	33	80	0.4125000
NODE_11869_length_805_cov_25.048159	306	386	2	47	80	0.5875000
NODE_11869_length_805_cov_25.048159	359	439	0	25	80	0.3125000
NODE_11869_length_805_cov_25.048159	359	439	2	55	80	0.6875000
NODE_11870_length_805_cov_15.453258	311	391	0	80	80	1.0000000
NODE_11870_length_805_cov_15.453258	364	444	0	80	80	1.0000000
NODE_11871_length_805_cov_14.930595	264	344	0	35	80	0.4375000
NODE_11871_length_805_cov_14.930595	264	344	2	19	80	0.2375000
NODE_11871_length_805_cov_14.930595	264	344	4	26	80	0.3250000
NODE_11871_length_805_cov_14.930595	317	397	0	13	80	0.1625000
NODE_11871_length_805_cov_14.930595	317	397	2	67	80	0.8375000
NODE_11872_length_805_cov_10.888102	259	339	0	80	80	1.0000000
NODE_11872_length_805_cov_10.888102	312	392	0	80	80	1.0000000
NODE_11873_length_805_cov_10.716714	348	428	0	80	80	1.0000000
NODE_11873_length_805_cov_10.716714	401	481	0	80	80	1.0000000
NODE_11876_length_805_cov_7.212465	374	454	0	80	80	1.0000000
NODE_11876_length_805_cov_7.212465	427	507	0	80	80	1.0000000
NODE_11877_length_805_cov_5.637394	323	403	0	80	80	1.0000000
NODE_11877_length_805_cov_5.637394	376	456	0	80	80	1.0000000
NODE_11878_length_805_cov_4.001416	304	384	0	50	80	0.6250000
NODE_11878_length_805_cov_4.001416	304	384	2	30	80	0.3750000
NODE_11878_length_805_cov_4.001416	357	437	2	80	80	1.0000000
NODE_11903_length_804_cov_26.204255	319	399	0	80	80	1.0000000
NODE_11903_length_804_cov_26.204255	372	452	0	80	80	1.0000000
NODE_11904_length_804_cov_25.978723	242	322	0	34	80	0.4250000
NODE_11904_length_804_cov_25.978723	242	322	8	16	80	0.2000000
NODE_11904_length_804_cov_25.978723	242	322	9	30	80	0.3750000
NODE_11904_length_804_cov_25.978723	295	375	3	2	80	0.0250000
NODE_11904_length_804_cov_25.978723	295	375	9	51	80	0.6375000
NODE_11904_length_804_cov_25.978723	295	375	11	27	80	0.3375000
NODE_11904_length_804_cov_25.978723	371	451	1	9	80	0.1125000
NODE_11904_length_804_cov_25.978723	371	451	2	8	80	0.1000000
NODE_11904_length_804_cov_25.978723	371	451	3	12	80	0.1500000
NODE_11904_length_804_cov_25.978723	371	451	4	49	80	0.6125000
NODE_11904_length_804_cov_25.978723	371	451	11	2	80	0.0250000
NODE_11904_length_804_cov_25.978723	424	504	1	62	80	0.7750000
NODE_11904_length_804_cov_25.978723	424	504	2	8	80	0.1000000
NODE_11904_length_804_cov_25.978723	424	504	4	10	80	0.1250000
NODE_11905_length_804_cov_25.628369	444	524	0	24	80	0.3000000
NODE_11905_length_804_cov_25.628369	444	524	2	56	80	0.7000000
NODE_11905_length_804_cov_25.628369	497	577	0	12	80	0.1500000
NODE_11905_length_804_cov_25.628369	497	577	2	68	80	0.8500000
NODE_11906_length_804_cov_22.438298	269	349	0	20	80	0.2500000
NODE_11906_length_804_cov_22.438298	269	349	1	13	80	0.1625000
NODE_11906_length_804_cov_22.438298	269	349	2	47	80	0.5875000
NODE_11906_length_804_cov_22.438298	322	402	2	80	80	1.0000000
NODE_11907_length_804_cov_17.425532	273	353	0	80	80	1.0000000
NODE_11907_length_804_cov_17.425532	326	406	0	38	80	0.4750000
NODE_11907_length_804_cov_17.425532	326	406	2	42	80	0.5250000
NODE_11908_length_804_cov_16.849645	229	309	0	80	80	1.0000000
NODE_11908_length_804_cov_16.849645	282	362	0	80	80	1.0000000
NODE_11909_length_804_cov_16.024113	499	579	0	80	80	1.0000000
NODE_11909_length_804_cov_16.024113	552	632	0	80	80	1.0000000
NODE_11910_length_804_cov_14.567376	375	455	0	2	80	0.0250000
NODE_11910_length_804_cov_14.567376	375	455	2	17	80	0.2125000
NODE_11910_length_804_cov_14.567376	375	455	4	3	80	0.0375000
NODE_11910_length_804_cov_14.567376	375	455	8	32	80	0.4000000
NODE_11910_length_804_cov_14.567376	375	455	12	26	80	0.3250000
NODE_11910_length_804_cov_14.567376	428	508	6	5	80	0.0625000
NODE_11910_length_804_cov_14.567376	428	508	8	20	80	0.2500000
NODE_11910_length_804_cov_14.567376	428	508	12	55	80	0.6875000
NODE_11911_length_804_cov_14.011348	262	342	0	7	80	0.0875000
NODE_11911_length_804_cov_14.011348	262	342	2	73	80	0.9125000
NODE_11911_length_804_cov_14.011348	315	395	0	55	80	0.6875000
NODE_11911_length_804_cov_14.011348	315	395	2	25	80	0.3125000
NODE_11912_length_804_cov_13.800000	289	318	0	29	29	1.0000000
NODE_11913_length_804_cov_12.585816	396	476	0	80	80	1.0000000
NODE_11913_length_804_cov_12.585816	449	529	0	80	80	1.0000000
NODE_11914_length_804_cov_12.375887	190	270	0	80	80	1.0000000
NODE_11914_length_804_cov_12.375887	243	323	0	80	80	1.0000000
NODE_11915_length_804_cov_10.947518	363	443	0	80	80	1.0000000
NODE_11915_length_804_cov_10.947518	416	496	0	80	80	1.0000000
NODE_11916_length_804_cov_8.164539	427	507	0	80	80	1.0000000
NODE_11916_length_804_cov_8.164539	480	560	0	80	80	1.0000000
NODE_11917_length_804_cov_7.462411	345	425	0	80	80	1.0000000
NODE_11917_length_804_cov_7.462411	398	478	0	80	80	1.0000000
NODE_11919_length_804_cov_3.663830	736	799	0	63	63	1.0000000
NODE_11933_length_804_cov_1.303546	480	560	2	80	80	1.0000000
NODE_11933_length_804_cov_1.303546	533	613	0	53	80	0.6625000
NODE_11933_length_804_cov_1.303546	533	613	2	27	80	0.3375000
NODE_11942_length_803_cov_40.930398	374	454	0	40	80	0.5000000
NODE_11942_length_803_cov_40.930398	374	454	2	5	80	0.0625000
NODE_11942_length_803_cov_40.930398	374	454	8	35	80	0.4375000
NODE_11942_length_803_cov_40.930398	427	507	8	80	80	1.0000000
NODE_11944_length_803_cov_28.346591	242	322	0	55	80	0.6875000
NODE_11944_length_803_cov_28.346591	242	322	9	1	80	0.0125000
NODE_11944_length_803_cov_28.346591	242	322	10	24	80	0.3000000
NODE_11944_length_803_cov_28.346591	295	375	0	2	80	0.0250000
NODE_11944_length_803_cov_28.346591	295	375	9	1	80	0.0125000
NODE_11944_length_803_cov_28.346591	295	375	10	77	80	0.9625000
NODE_11945_length_803_cov_23.420455	288	368	2	16	80	0.2000000
NODE_11945_length_803_cov_23.420455	288	368	4	64	80	0.8000000
NODE_11945_length_803_cov_23.420455	341	421	2	25	80	0.3125000
NODE_11945_length_803_cov_23.420455	341	421	4	55	80	0.6875000
NODE_11946_length_803_cov_20.977273	316	396	0	74	80	0.9250000
NODE_11946_length_803_cov_20.977273	316	396	2	6	80	0.0750000
NODE_11946_length_803_cov_20.977273	369	449	0	80	80	1.0000000
NODE_11947_length_803_cov_18.458807	307	387	0	19	80	0.2375000
NODE_11947_length_803_cov_18.458807	307	387	2	61	80	0.7625000
NODE_11947_length_803_cov_18.458807	360	440	0	72	80	0.9000000
NODE_11947_length_803_cov_18.458807	360	440	2	8	80	0.1000000
NODE_11948_length_803_cov_14.411932	386	466	0	80	80	1.0000000
NODE_11948_length_803_cov_14.411932	439	519	0	80	80	1.0000000
NODE_11949_length_803_cov_10.157670	319	399	0	80	80	1.0000000
NODE_11949_length_803_cov_10.157670	372	452	0	80	80	1.0000000
NODE_11950_length_803_cov_8.977273	362	442	0	80	80	1.0000000
NODE_11950_length_803_cov_8.977273	415	485	0	70	70	1.0000000
NODE_11951_length_803_cov_7.735795	195	275	0	80	80	1.0000000
NODE_11951_length_803_cov_7.735795	248	328	0	80	80	1.0000000
NODE_11955_length_803_cov_4.613636	266	346	0	80	80	1.0000000
NODE_11955_length_803_cov_4.613636	319	399	0	80	80	1.0000000
NODE_11957_length_803_cov_4.220170	72	152	0	80	80	1.0000000
NODE_11957_length_803_cov_4.220170	130	207	0	77	77	1.0000000
NODE_11985_length_802_cov_42.294452	289	369	2	23	80	0.2875000
NODE_11985_length_802_cov_42.294452	289	369	4	57	80	0.7125000
NODE_11985_length_802_cov_42.294452	342	422	0	52	80	0.6500000
NODE_11985_length_802_cov_42.294452	342	422	4	28	80	0.3500000
NODE_11986_length_802_cov_31.896159	246	326	0	80	80	1.0000000
NODE_11986_length_802_cov_31.896159	299	379	0	80	80	1.0000000
NODE_11987_length_802_cov_30.786629	419	499	0	5	80	0.0625000
NODE_11987_length_802_cov_30.786629	419	499	2	75	80	0.9375000
NODE_11987_length_802_cov_30.786629	472	552	0	23	80	0.2875000
NODE_11987_length_802_cov_30.786629	472	552	2	57	80	0.7125000
NODE_11988_length_802_cov_19.540541	368	448	6	80	80	1.0000000
NODE_11988_length_802_cov_19.540541	421	501	0	42	80	0.5250000
NODE_11988_length_802_cov_19.540541	421	501	2	1	80	0.0125000
NODE_11988_length_802_cov_19.540541	421	501	5	1	80	0.0125000
NODE_11988_length_802_cov_19.540541	421	501	6	36	80	0.4500000
NODE_11989_length_802_cov_17.689900	268	348	0	80	80	1.0000000
NODE_11989_length_802_cov_17.689900	321	401	0	80	80	1.0000000
NODE_11990_length_802_cov_16.432432	364	444	0	80	80	1.0000000
NODE_11990_length_802_cov_16.432432	417	497	0	80	80	1.0000000
NODE_11991_length_802_cov_15.409673	317	397	0	7	80	0.0875000
NODE_11991_length_802_cov_15.409673	317	397	4	73	80	0.9125000
NODE_11991_length_802_cov_15.409673	370	450	4	80	80	1.0000000
NODE_11992_length_802_cov_12.507824	340	420	0	80	80	1.0000000
NODE_11992_length_802_cov_12.507824	393	473	0	80	80	1.0000000
NODE_11993_length_802_cov_9.310100	374	454	0	80	80	1.0000000
NODE_11993_length_802_cov_9.310100	427	507	0	80	80	1.0000000
NODE_11994_length_802_cov_8.421053	272	351	0	79	79	1.0000000
NODE_11994_length_802_cov_8.421053	324	404	0	80	80	1.0000000
NODE_11997_length_802_cov_5.576102	294	374	0	80	80	1.0000000
NODE_11997_length_802_cov_5.576102	347	427	0	80	80	1.0000000
NODE_12025_length_801_cov_35.199430	334	414	0	80	80	1.0000000
NODE_12025_length_801_cov_35.199430	387	467	0	80	80	1.0000000
NODE_12026_length_801_cov_20.096866	347	427	0	28	80	0.3500000
NODE_12026_length_801_cov_20.096866	347	427	2	52	80	0.6500000
NODE_12026_length_801_cov_20.096866	400	480	0	12	80	0.1500000
NODE_12026_length_801_cov_20.096866	400	480	2	19	80	0.2375000
NODE_12026_length_801_cov_20.096866	400	480	4	49	80	0.6125000
NODE_12027_length_801_cov_18.643875	355	435	0	80	80	1.0000000
NODE_12027_length_801_cov_18.643875	408	488	0	80	80	1.0000000
NODE_12028_length_801_cov_16.099715	427	507	5	11	80	0.1375000
NODE_12028_length_801_cov_16.099715	427	507	9	3	80	0.0375000
NODE_12028_length_801_cov_16.099715	427	507	11	66	80	0.8250000
NODE_12028_length_801_cov_16.099715	480	560	3	30	80	0.3750000
NODE_12028_length_801_cov_16.099715	480	560	5	34	80	0.4250000
NODE_12028_length_801_cov_16.099715	480	560	11	16	80	0.2000000
NODE_12029_length_801_cov_12.307692	332	412	0	80	80	1.0000000
NODE_12029_length_801_cov_12.307692	385	465	0	80	80	1.0000000
NODE_12030_length_801_cov_11.464387	293	373	0	64	80	0.8000000
NODE_12030_length_801_cov_11.464387	293	373	4	16	80	0.2000000
NODE_12030_length_801_cov_11.464387	346	426	0	11	80	0.1375000
NODE_12030_length_801_cov_11.464387	346	426	4	69	80	0.8625000
NODE_12031_length_801_cov_8.562678	309	389	2	58	80	0.7250000
NODE_12031_length_801_cov_8.562678	309	389	4	22	80	0.2750000
NODE_12031_length_801_cov_8.562678	362	442	2	37	80	0.4625000
NODE_12031_length_801_cov_8.562678	362	442	4	43	80	0.5375000
NODE_12032_length_801_cov_3.927350	339	419	0	80	80	1.0000000
NODE_12032_length_801_cov_3.927350	392	472	0	80	80	1.0000000
NODE_12053_length_800_cov_72.029957	245	325	0	80	80	1.0000000
NODE_12053_length_800_cov_72.029957	298	378	0	80	80	1.0000000
NODE_12054_length_800_cov_22.631954	297	377	0	80	80	1.0000000
NODE_12054_length_800_cov_22.631954	350	430	0	80	80	1.0000000
NODE_12055_length_800_cov_9.457917	409	489	0	46	80	0.5750000
NODE_12055_length_800_cov_9.457917	409	489	2	34	80	0.4250000
NODE_12055_length_800_cov_9.457917	462	542	2	80	80	1.0000000
NODE_12084_length_799_cov_101.640000	101	132	108	1	31	0.0322581
NODE_12084_length_799_cov_101.640000	101	132	124	1	31	0.0322581
NODE_12084_length_799_cov_101.640000	101	132	128	1	31	0.0322581
NODE_12084_length_799_cov_101.640000	101	132	138	1	31	0.0322581
NODE_12084_length_799_cov_101.640000	101	132	140	1	31	0.0322581
NODE_12084_length_799_cov_101.640000	101	132	142	2	31	0.0645161
NODE_12084_length_799_cov_101.640000	101	132	148	1	31	0.0322581
NODE_12084_length_799_cov_101.640000	101	132	150	1	31	0.0322581
NODE_12084_length_799_cov_101.640000	101	132	151	1	31	0.0322581
NODE_12084_length_799_cov_101.640000	101	132	164	1	31	0.0322581
NODE_12084_length_799_cov_101.640000	101	132	170	1	31	0.0322581
NODE_12084_length_799_cov_101.640000	101	132	173	1	31	0.0322581
NODE_12084_length_799_cov_101.640000	101	132	181	1	31	0.0322581
NODE_12084_length_799_cov_101.640000	101	132	192	1	31	0.0322581
NODE_12084_length_799_cov_101.640000	101	132	196	1	31	0.0322581
NODE_12084_length_799_cov_101.640000	101	132	209	2	31	0.0645161
NODE_12084_length_799_cov_101.640000	101	132	211	1	31	0.0322581
NODE_12084_length_799_cov_101.640000	101	132	213	1	31	0.0322581
NODE_12084_length_799_cov_101.640000	101	132	225	1	31	0.0322581
NODE_12084_length_799_cov_101.640000	101	132	228	1	31	0.0322581
NODE_12084_length_799_cov_101.640000	101	132	235	1	31	0.0322581
NODE_12084_length_799_cov_101.640000	101	132	246	1	31	0.0322581
NODE_12084_length_799_cov_101.640000	101	132	260	1	31	0.0322581
NODE_12084_length_799_cov_101.640000	101	132	264	1	31	0.0322581
NODE_12084_length_799_cov_101.640000	101	132	277	1	31	0.0322581
NODE_12084_length_799_cov_101.640000	101	132	283	1	31	0.0322581
NODE_12084_length_799_cov_101.640000	101	132	296	1	31	0.0322581
NODE_12084_length_799_cov_101.640000	101	132	306	1	31	0.0322581
NODE_12084_length_799_cov_101.640000	101	132	321	1	31	0.0322581
NODE_12085_length_799_cov_33.630000	367	447	0	80	80	1.0000000
NODE_12085_length_799_cov_33.630000	420	500	0	80	80	1.0000000
NODE_12086_length_799_cov_15.717143	408	488	0	25	80	0.3125000
NODE_12086_length_799_cov_15.717143	408	488	4	55	80	0.6875000
NODE_12086_length_799_cov_15.717143	461	541	4	72	80	0.9000000
NODE_12086_length_799_cov_15.717143	461	541	6	8	80	0.1000000
NODE_12087_length_799_cov_15.175714	293	373	0	62	80	0.7750000
NODE_12087_length_799_cov_15.175714	293	373	2	18	80	0.2250000
NODE_12087_length_799_cov_15.175714	346	426	0	9	80	0.1125000
NODE_12087_length_799_cov_15.175714	346	426	2	71	80	0.8875000
NODE_12088_length_799_cov_8.444286	408	488	0	80	80	1.0000000
NODE_12088_length_799_cov_8.444286	461	541	0	80	80	1.0000000
NODE_12120_length_798_cov_42.629471	148	228	2	20	80	0.2500000
NODE_12120_length_798_cov_42.629471	148	228	8	56	80	0.7000000
NODE_12120_length_798_cov_42.629471	148	228	10	4	80	0.0500000
NODE_12120_length_798_cov_42.629471	201	281	0	6	80	0.0750000
NODE_12120_length_798_cov_42.629471	201	281	2	67	80	0.8375000
NODE_12120_length_798_cov_42.629471	201	281	8	5	80	0.0625000
NODE_12120_length_798_cov_42.629471	201	281	10	2	80	0.0250000
NODE_12121_length_798_cov_23.658083	368	448	0	80	80	1.0000000
NODE_12121_length_798_cov_23.658083	421	501	0	80	80	1.0000000
NODE_12122_length_798_cov_15.037196	341	421	0	61	80	0.7625000
NODE_12122_length_798_cov_15.037196	341	421	2	19	80	0.2375000
NODE_12122_length_798_cov_15.037196	394	474	0	80	80	1.0000000
NODE_12123_length_798_cov_6.816881	404	483	0	79	79	1.0000000
NODE_12123_length_798_cov_6.816881	457	536	0	79	79	1.0000000
NODE_12129_length_798_cov_2.796853	246	326	0	43	80	0.5375000
NODE_12129_length_798_cov_2.796853	246	326	2	37	80	0.4625000
NODE_12129_length_798_cov_2.796853	299	379	2	80	80	1.0000000
NODE_12151_length_797_cov_24.340974	207	287	2	1	80	0.0125000
NODE_12151_length_797_cov_24.340974	207	287	4	46	80	0.5750000
NODE_12151_length_797_cov_24.340974	207	287	6	33	80	0.4125000
NODE_12151_length_797_cov_24.340974	260	340	6	80	80	1.0000000
NODE_12152_length_797_cov_21.071633	372	452	0	76	80	0.9500000
NODE_12152_length_797_cov_21.071633	372	452	2	4	80	0.0500000
NODE_12152_length_797_cov_21.071633	425	505	0	23	80	0.2875000
NODE_12152_length_797_cov_21.071633	425	505	2	57	80	0.7125000
NODE_12153_length_797_cov_18.286533	346	426	0	80	80	1.0000000
NODE_12153_length_797_cov_18.286533	399	479	0	80	80	1.0000000
NODE_12154_length_797_cov_16.628940	322	402	16	52	80	0.6500000
NODE_12154_length_797_cov_16.628940	322	402	18	28	80	0.3500000
NODE_12154_length_797_cov_16.628940	375	455	0	26	80	0.3250000
NODE_12154_length_797_cov_16.628940	375	455	4	12	80	0.1500000
NODE_12154_length_797_cov_16.628940	375	455	8	7	80	0.0875000
NODE_12154_length_797_cov_16.628940	375	455	16	35	80	0.4375000
NODE_12155_length_797_cov_15.266476	299	379	0	44	80	0.5500000
NODE_12155_length_797_cov_15.266476	299	379	4	36	80	0.4500000
NODE_12155_length_797_cov_15.266476	352	432	0	25	80	0.3125000
NODE_12155_length_797_cov_15.266476	352	432	4	55	80	0.6875000
NODE_12156_length_797_cov_15.035817	263	343	0	80	80	1.0000000
NODE_12156_length_797_cov_15.035817	316	396	0	80	80	1.0000000
NODE_12157_length_797_cov_12.934097	403	484	4	35	81	0.4320988
NODE_12157_length_797_cov_12.934097	403	484	6	46	81	0.5679013
NODE_12157_length_797_cov_12.934097	457	537	0	45	80	0.5625000
NODE_12157_length_797_cov_12.934097	457	537	4	35	80	0.4375000
NODE_12158_length_797_cov_11.140401	201	281	0	80	80	1.0000000
NODE_12158_length_797_cov_11.140401	254	334	0	80	80	1.0000000
NODE_12159_length_797_cov_8.681948	284	364	0	73	80	0.9125000
NODE_12159_length_797_cov_8.681948	284	364	2	7	80	0.0875000
NODE_12159_length_797_cov_8.681948	337	417	0	20	80	0.2500000
NODE_12159_length_797_cov_8.681948	337	417	2	60	80	0.7500000
NODE_12160_length_797_cov_7.616046	314	397	0	83	83	1.0000000
NODE_12160_length_797_cov_7.616046	370	450	0	80	80	1.0000000
NODE_12161_length_797_cov_7.487106	275	347	0	72	72	1.0000000
NODE_12161_length_797_cov_7.487106	320	400	0	80	80	1.0000000
NODE_12163_length_797_cov_6.068768	357	437	0	14	80	0.1750000
NODE_12163_length_797_cov_6.068768	357	437	2	66	80	0.8250000
NODE_12163_length_797_cov_6.068768	410	490	0	47	80	0.5875000
NODE_12163_length_797_cov_6.068768	410	490	2	33	80	0.4125000
NODE_12186_length_796_cov_20.862267	262	342	0	80	80	1.0000000
NODE_12186_length_796_cov_20.862267	315	395	0	80	80	1.0000000
NODE_12187_length_796_cov_18.291248	283	363	0	12	80	0.1500000
NODE_12187_length_796_cov_18.291248	283	363	33	20	80	0.2500000
NODE_12187_length_796_cov_18.291248	283	363	58	3	80	0.0375000
NODE_12187_length_796_cov_18.291248	283	363	64	5	80	0.0625000
NODE_12187_length_796_cov_18.291248	283	363	66	40	80	0.5000000
NODE_12187_length_796_cov_18.291248	336	416	40	24	80	0.3000000
NODE_12187_length_796_cov_18.291248	336	416	41	3	80	0.0375000
NODE_12187_length_796_cov_18.291248	336	416	42	3	80	0.0375000
NODE_12187_length_796_cov_18.291248	336	416	43	4	80	0.0500000
NODE_12187_length_796_cov_18.291248	336	416	45	3	80	0.0375000
NODE_12187_length_796_cov_18.291248	336	416	46	4	80	0.0500000
NODE_12187_length_796_cov_18.291248	336	416	47	4	80	0.0500000
NODE_12187_length_796_cov_18.291248	336	416	48	3	80	0.0375000
NODE_12187_length_796_cov_18.291248	336	416	54	2	80	0.0250000
NODE_12187_length_796_cov_18.291248	336	416	57	2	80	0.0250000
NODE_12187_length_796_cov_18.291248	336	416	58	4	80	0.0500000
NODE_12187_length_796_cov_18.291248	336	416	64	5	80	0.0625000
NODE_12187_length_796_cov_18.291248	336	416	66	19	80	0.2375000
NODE_12189_length_796_cov_7.880918	388	460	0	18	72	0.2500000
NODE_12189_length_796_cov_7.880918	388	460	2	54	72	0.7500000
NODE_12189_length_796_cov_7.880918	442	513	0	27	71	0.3802817
NODE_12189_length_796_cov_7.880918	442	513	2	44	71	0.6197183
NODE_12216_length_795_cov_31.729885	298	378	0	31	80	0.3875000
NODE_12216_length_795_cov_31.729885	298	378	8	49	80	0.6125000
NODE_12216_length_795_cov_31.729885	351	431	0	14	80	0.1750000
NODE_12216_length_795_cov_31.729885	351	431	7	23	80	0.2875000
NODE_12216_length_795_cov_31.729885	351	431	8	43	80	0.5375000
NODE_12217_length_795_cov_26.760057	367	447	2	14	80	0.1750000
NODE_12217_length_795_cov_26.760057	367	447	4	50	80	0.6250000
NODE_12217_length_795_cov_26.760057	367	447	6	16	80	0.2000000
NODE_12217_length_795_cov_26.760057	420	500	0	33	80	0.4125000
NODE_12217_length_795_cov_26.760057	420	500	2	10	80	0.1250000
NODE_12217_length_795_cov_26.760057	420	500	4	37	80	0.4625000
NODE_12218_length_795_cov_24.522989	352	432	0	45	80	0.5625000
NODE_12218_length_795_cov_24.522989	352	432	2	35	80	0.4375000
NODE_12218_length_795_cov_24.522989	405	485	2	80	80	1.0000000
NODE_12219_length_795_cov_22.747126	363	443	0	80	80	1.0000000
NODE_12219_length_795_cov_22.747126	416	496	0	80	80	1.0000000
NODE_12220_length_795_cov_9.439655	425	505	0	80	80	1.0000000
NODE_12220_length_795_cov_9.439655	478	558	0	80	80	1.0000000
NODE_12232_length_795_cov_3.359195	349	429	0	22	80	0.2750000
NODE_12232_length_795_cov_3.359195	349	429	2	52	80	0.6500000
NODE_12232_length_795_cov_3.359195	349	429	4	6	80	0.0750000
NODE_12232_length_795_cov_3.359195	402	482	2	45	80	0.5625000
NODE_12232_length_795_cov_3.359195	402	482	4	35	80	0.4375000
NODE_12256_length_794_cov_24.680576	326	406	0	25	80	0.3125000
NODE_12256_length_794_cov_24.680576	326	406	2	55	80	0.6875000
NODE_12256_length_794_cov_24.680576	379	459	0	78	80	0.9750000
NODE_12256_length_794_cov_24.680576	379	459	2	2	80	0.0250000
NODE_12257_length_794_cov_20.057554	153	233	0	80	80	1.0000000
NODE_12257_length_794_cov_20.057554	206	286	0	80	80	1.0000000
NODE_12257_length_794_cov_20.057554	282	362	0	7	80	0.0875000
NODE_12257_length_794_cov_20.057554	282	362	2	73	80	0.9125000
NODE_12257_length_794_cov_20.057554	335	415	0	12	80	0.1500000
NODE_12257_length_794_cov_20.057554	335	415	2	68	80	0.8500000
NODE_12258_length_794_cov_16.602878	361	441	0	80	80	1.0000000
NODE_12258_length_794_cov_16.602878	414	494	0	80	80	1.0000000
NODE_12259_length_794_cov_16.362590	337	417	0	80	80	1.0000000
NODE_12259_length_794_cov_16.362590	390	470	0	80	80	1.0000000
NODE_12260_length_794_cov_14.444604	101	160	0	59	59	1.0000000
NODE_12260_length_794_cov_14.444604	409	489	0	80	80	1.0000000
NODE_12260_length_794_cov_14.444604	462	542	0	80	80	1.0000000
NODE_12261_length_794_cov_12.866187	442	522	0	80	80	1.0000000
NODE_12261_length_794_cov_12.866187	495	575	0	80	80	1.0000000
NODE_12262_length_794_cov_12.287770	235	315	0	67	80	0.8375000
NODE_12262_length_794_cov_12.287770	235	315	2	13	80	0.1625000
NODE_12262_length_794_cov_12.287770	288	368	0	14	80	0.1750000
NODE_12262_length_794_cov_12.287770	288	368	2	66	80	0.8250000
NODE_12263_length_794_cov_11.210072	315	395	0	80	80	1.0000000
NODE_12263_length_794_cov_11.210072	368	448	0	80	80	1.0000000
NODE_12264_length_794_cov_10.638849	325	406	0	8	81	0.0987654
NODE_12264_length_794_cov_10.638849	325	406	4	73	81	0.9012346
NODE_12264_length_794_cov_10.638849	379	459	0	45	80	0.5625000
NODE_12264_length_794_cov_10.638849	379	459	4	35	80	0.4375000
NODE_12266_length_794_cov_6.274820	412	492	0	26	80	0.3250000
NODE_12266_length_794_cov_6.274820	412	492	4	54	80	0.6750000
NODE_12266_length_794_cov_6.274820	465	545	0	79	80	0.9875000
NODE_12266_length_794_cov_6.274820	465	545	4	1	80	0.0125000
NODE_12271_length_794_cov_3.197122	273	338	0	65	65	1.0000000
NODE_12282_length_794_cov_1.848921	246	326	0	16	80	0.2000000
NODE_12282_length_794_cov_1.848921	246	326	2	64	80	0.8000000
NODE_12282_length_794_cov_1.848921	299	379	2	80	80	1.0000000
NODE_12295_length_793_cov_29.878963	326	406	0	80	80	1.0000000
NODE_12295_length_793_cov_29.878963	379	459	0	80	80	1.0000000
NODE_12296_length_793_cov_25.981268	310	390	0	26	80	0.3250000
NODE_12296_length_793_cov_25.981268	310	390	2	54	80	0.6750000
NODE_12296_length_793_cov_25.981268	363	445	0	39	82	0.4756097
NODE_12296_length_793_cov_25.981268	363	445	2	43	82	0.5243902
NODE_12297_length_793_cov_24.840058	331	411	0	35	80	0.4375000
NODE_12297_length_793_cov_24.840058	331	411	4	45	80	0.5625000
NODE_12297_length_793_cov_24.840058	384	464	0	29	80	0.3625000
NODE_12297_length_793_cov_24.840058	384	464	4	51	80	0.6375000
NODE_12298_length_793_cov_21.707493	398	478	6	80	80	1.0000000
NODE_12298_length_793_cov_21.707493	451	531	0	41	80	0.5125000
NODE_12298_length_793_cov_21.707493	451	531	2	1	80	0.0125000
NODE_12298_length_793_cov_21.707493	451	531	6	38	80	0.4750000
NODE_12299_length_793_cov_8.358790	257	337	0	80	80	1.0000000
NODE_12299_length_793_cov_8.358790	310	390	0	80	80	1.0000000
NODE_12300_length_793_cov_8.236311	477	557	0	80	80	1.0000000
NODE_12300_length_793_cov_8.236311	530	610	0	80	80	1.0000000
NODE_12302_length_793_cov_6.763689	461	541	0	80	80	1.0000000
NODE_12302_length_793_cov_6.763689	514	594	0	80	80	1.0000000
NODE_12307_length_793_cov_4.465418	501	549	0	48	48	1.0000000
NODE_12311_length_793_cov_4.138329	174	254	0	80	80	1.0000000
NODE_12311_length_793_cov_4.138329	227	307	0	80	80	1.0000000
NODE_12338_length_792_cov_40.025974	198	278	0	80	80	1.0000000
NODE_12338_length_792_cov_40.025974	251	331	0	80	80	1.0000000
NODE_12338_length_792_cov_40.025974	327	408	0	81	81	1.0000000
NODE_12338_length_792_cov_40.025974	381	461	0	80	80	1.0000000
NODE_12339_length_792_cov_31.176046	331	411	0	80	80	1.0000000
NODE_12339_length_792_cov_31.176046	384	463	0	79	79	1.0000000
NODE_12339_length_792_cov_31.176046	459	539	0	38	80	0.4750000
NODE_12339_length_792_cov_31.176046	459	539	2	42	80	0.5250000
NODE_12339_length_792_cov_31.176046	512	546	2	34	34	1.0000000
NODE_12340_length_792_cov_21.347763	303	383	0	80	80	1.0000000
NODE_12340_length_792_cov_21.347763	356	436	0	80	80	1.0000000
NODE_12341_length_792_cov_20.142857	361	441	0	80	80	1.0000000
NODE_12341_length_792_cov_20.142857	414	494	0	80	80	1.0000000
NODE_12342_length_792_cov_18.733045	320	400	0	80	80	1.0000000
NODE_12342_length_792_cov_18.733045	373	453	0	58	80	0.7250000
NODE_12342_length_792_cov_18.733045	373	453	2	22	80	0.2750000
NODE_12343_length_792_cov_12.024531	369	449	0	80	80	1.0000000
NODE_12343_length_792_cov_12.024531	422	502	0	80	80	1.0000000
NODE_12372_length_791_cov_53.573699	287	359	0	39	72	0.5416667
NODE_12372_length_791_cov_53.573699	287	359	4	29	72	0.4027778
NODE_12372_length_791_cov_53.573699	287	359	6	4	72	0.0555556
NODE_12372_length_791_cov_53.573699	332	412	2	6	80	0.0750000
NODE_12372_length_791_cov_53.573699	332	412	4	23	80	0.2875000
NODE_12372_length_791_cov_53.573699	332	412	6	51	80	0.6375000
NODE_12373_length_791_cov_40.416185	238	318	0	46	80	0.5750000
NODE_12373_length_791_cov_40.416185	238	318	2	34	80	0.4250000
NODE_12373_length_791_cov_40.416185	291	371	0	80	80	1.0000000
NODE_12374_length_791_cov_38.791908	309	389	0	46	80	0.5750000
NODE_12374_length_791_cov_38.791908	309	389	11	1	80	0.0125000
NODE_12374_length_791_cov_38.791908	309	389	12	33	80	0.4125000
NODE_12374_length_791_cov_38.791908	362	442	12	80	80	1.0000000
NODE_12375_length_791_cov_23.468208	328	408	0	15	80	0.1875000
NODE_12375_length_791_cov_23.468208	328	408	2	65	80	0.8125000
NODE_12375_length_791_cov_23.468208	381	461	0	47	80	0.5875000
NODE_12375_length_791_cov_23.468208	381	461	2	33	80	0.4125000
NODE_12376_length_791_cov_20.897399	299	379	0	54	80	0.6750000
NODE_12376_length_791_cov_20.897399	299	379	2	26	80	0.3250000
NODE_12376_length_791_cov_20.897399	352	432	0	80	80	1.0000000
NODE_12377_length_791_cov_13.504335	339	419	0	16	80	0.2000000
NODE_12377_length_791_cov_13.504335	339	419	2	64	80	0.8000000
NODE_12377_length_791_cov_13.504335	392	472	0	51	80	0.6375000
NODE_12377_length_791_cov_13.504335	392	472	2	29	80	0.3625000
NODE_12379_length_791_cov_12.547688	338	418	0	10	80	0.1250000
NODE_12379_length_791_cov_12.547688	338	418	2	70	80	0.8750000
NODE_12379_length_791_cov_12.547688	391	471	0	63	80	0.7875000
NODE_12379_length_791_cov_12.547688	391	471	2	17	80	0.2125000
NODE_12380_length_791_cov_11.791908	440	520	0	9	80	0.1125000
NODE_12380_length_791_cov_11.791908	440	520	2	71	80	0.8875000
NODE_12380_length_791_cov_11.791908	493	573	0	62	80	0.7750000
NODE_12380_length_791_cov_11.791908	493	573	2	18	80	0.2250000
NODE_12381_length_791_cov_11.011561	337	417	0	5	80	0.0625000
NODE_12381_length_791_cov_11.011561	337	417	2	75	80	0.9375000
NODE_12381_length_791_cov_11.011561	390	470	0	27	80	0.3375000
NODE_12381_length_791_cov_11.011561	390	470	2	53	80	0.6625000
NODE_12382_length_791_cov_8.757225	325	405	0	80	80	1.0000000
NODE_12382_length_791_cov_8.757225	378	458	0	80	80	1.0000000
NODE_12384_length_791_cov_8.125723	416	496	0	40	80	0.5000000
NODE_12384_length_791_cov_8.125723	416	496	2	40	80	0.5000000
NODE_12384_length_791_cov_8.125723	469	549	0	80	80	1.0000000
NODE_12409_length_790_cov_48.021708	526	606	0	80	80	1.0000000
NODE_12409_length_790_cov_48.021708	579	659	0	80	80	1.0000000
NODE_12410_length_790_cov_44.151954	343	423	0	80	80	1.0000000
NODE_12410_length_790_cov_44.151954	396	438	0	42	42	1.0000000
NODE_12410_length_790_cov_44.151954	696	776	0	13	80	0.1625000
NODE_12410_length_790_cov_44.151954	696	776	4	53	80	0.6625000
NODE_12410_length_790_cov_44.151954	696	776	6	14	80	0.1750000
NODE_12411_length_790_cov_27.144718	291	371	0	80	80	1.0000000
NODE_12411_length_790_cov_27.144718	344	424	0	80	80	1.0000000
NODE_12412_length_790_cov_16.973951	232	312	0	51	80	0.6375000
NODE_12412_length_790_cov_16.973951	232	312	2	29	80	0.3625000
NODE_12412_length_790_cov_16.973951	285	365	0	22	80	0.2750000
NODE_12412_length_790_cov_16.973951	285	365	2	58	80	0.7250000
NODE_12413_length_790_cov_13.374819	204	284	0	80	80	1.0000000
NODE_12413_length_790_cov_13.374819	257	337	0	80	80	1.0000000
NODE_12415_length_790_cov_10.613603	302	382	0	2	80	0.0250000
NODE_12415_length_790_cov_10.613603	302	382	4	78	80	0.9750000
NODE_12415_length_790_cov_10.613603	355	435	0	23	80	0.2875000
NODE_12415_length_790_cov_10.613603	355	435	4	57	80	0.7125000
NODE_12418_length_790_cov_5.493488	271	351	0	8	80	0.1000000
NODE_12418_length_790_cov_5.493488	271	351	2	57	80	0.7125000
NODE_12418_length_790_cov_5.493488	271	351	4	15	80	0.1875000
NODE_12418_length_790_cov_5.493488	324	404	0	61	80	0.7625000
NODE_12418_length_790_cov_5.493488	324	404	2	19	80	0.2375000
NODE_12434_length_790_cov_1.463097	313	376	0	63	63	1.0000000
NODE_12452_length_789_cov_39.123188	226	306	0	47	80	0.5875000
NODE_12452_length_789_cov_39.123188	226	306	6	33	80	0.4125000
NODE_12452_length_789_cov_39.123188	279	359	6	80	80	1.0000000
NODE_12453_length_789_cov_37.205797	423	503	0	80	80	1.0000000
NODE_12453_length_789_cov_37.205797	476	556	0	80	80	1.0000000
NODE_12454_length_789_cov_31.311594	223	303	0	80	80	1.0000000
NODE_12454_length_789_cov_31.311594	276	356	0	80	80	1.0000000
NODE_12455_length_789_cov_30.536232	306	386	7	5	80	0.0625000
NODE_12455_length_789_cov_30.536232	306	386	10	21	80	0.2625000
NODE_12455_length_789_cov_30.536232	306	386	11	10	80	0.1250000
NODE_12455_length_789_cov_30.536232	306	386	12	44	80	0.5500000
NODE_12455_length_789_cov_30.536232	359	439	4	24	80	0.3000000
NODE_12455_length_789_cov_30.536232	359	439	7	5	80	0.0625000
NODE_12455_length_789_cov_30.536232	359	439	8	1	80	0.0125000
NODE_12455_length_789_cov_30.536232	359	439	9	2	80	0.0250000
NODE_12455_length_789_cov_30.536232	359	439	11	36	80	0.4500000
NODE_12455_length_789_cov_30.536232	359	439	12	12	80	0.1500000
NODE_12456_length_789_cov_24.886957	343	423	0	80	80	1.0000000
NODE_12456_length_789_cov_24.886957	396	476	0	80	80	1.0000000
NODE_12457_length_789_cov_23.539130	357	437	2	73	80	0.9125000
NODE_12457_length_789_cov_23.539130	357	437	4	7	80	0.0875000
NODE_12457_length_789_cov_23.539130	410	490	2	62	80	0.7750000
NODE_12457_length_789_cov_23.539130	410	490	4	18	80	0.2250000
NODE_12458_length_789_cov_16.169565	392	472	0	80	80	1.0000000
NODE_12458_length_789_cov_16.169565	445	525	0	80	80	1.0000000
NODE_12459_length_789_cov_15.175362	242	322	0	14	80	0.1750000
NODE_12459_length_789_cov_15.175362	242	322	2	66	80	0.8250000
NODE_12459_length_789_cov_15.175362	295	375	0	30	80	0.3750000
NODE_12459_length_789_cov_15.175362	295	375	2	50	80	0.6250000
NODE_12459_length_789_cov_15.175362	371	451	0	80	80	1.0000000
NODE_12459_length_789_cov_15.175362	424	504	0	46	80	0.5750000
NODE_12459_length_789_cov_15.175362	424	504	2	34	80	0.4250000
NODE_12460_length_789_cov_7.276812	306	386	0	80	80	1.0000000
NODE_12460_length_789_cov_7.276812	359	439	0	80	80	1.0000000
NODE_12482_length_788_cov_43.091437	335	415	0	80	80	1.0000000
NODE_12482_length_788_cov_43.091437	388	460	0	32	72	0.4444444
NODE_12482_length_788_cov_43.091437	388	460	4	40	72	0.5555556
NODE_12483_length_788_cov_38.914369	345	425	0	1	80	0.0125000
NODE_12483_length_788_cov_38.914369	345	425	2	40	80	0.5000000
NODE_12483_length_788_cov_38.914369	345	425	4	39	80	0.4875000
NODE_12483_length_788_cov_38.914369	398	478	0	1	80	0.0125000
NODE_12483_length_788_cov_38.914369	398	478	2	14	80	0.1750000
NODE_12483_length_788_cov_38.914369	398	478	4	65	80	0.8125000
NODE_12484_length_788_cov_36.148041	320	400	0	14	80	0.1750000
NODE_12484_length_788_cov_36.148041	320	400	1	22	80	0.2750000
NODE_12484_length_788_cov_36.148041	320	400	2	44	80	0.5500000
NODE_12484_length_788_cov_36.148041	373	453	0	67	80	0.8375000
NODE_12484_length_788_cov_36.148041	373	453	1	13	80	0.1625000
NODE_12485_length_788_cov_35.460087	346	426	0	80	80	1.0000000
NODE_12485_length_788_cov_35.460087	399	479	0	80	80	1.0000000
NODE_12486_length_788_cov_30.785196	278	358	0	80	80	1.0000000
NODE_12486_length_788_cov_30.785196	331	411	0	34	80	0.4250000
NODE_12486_length_788_cov_30.785196	331	411	2	46	80	0.5750000
NODE_12488_length_788_cov_20.867925	300	380	0	80	80	1.0000000
NODE_12488_length_788_cov_20.867925	353	430	0	77	77	1.0000000
NODE_12489_length_788_cov_20.821480	322	402	0	80	80	1.0000000
NODE_12489_length_788_cov_20.821480	375	455	0	80	80	1.0000000
NODE_12490_length_788_cov_15.570392	342	422	0	80	80	1.0000000
NODE_12490_length_788_cov_15.570392	395	475	0	80	80	1.0000000
NODE_12491_length_788_cov_12.235123	241	321	0	80	80	1.0000000
NODE_12491_length_788_cov_12.235123	294	374	0	68	80	0.8500000
NODE_12491_length_788_cov_12.235123	294	374	2	12	80	0.1500000
NODE_12492_length_788_cov_10.509434	405	480	0	40	75	0.5333334
NODE_12492_length_788_cov_10.509434	405	480	6	35	75	0.4666667
NODE_12493_length_788_cov_9.737300	310	390	0	80	80	1.0000000
NODE_12493_length_788_cov_9.737300	363	443	0	49	80	0.6125000
NODE_12493_length_788_cov_9.737300	363	443	2	31	80	0.3875000
NODE_12494_length_788_cov_8.872279	280	360	0	30	80	0.3750000
NODE_12494_length_788_cov_8.872279	280	360	1	32	80	0.4000000
NODE_12494_length_788_cov_8.872279	280	360	2	18	80	0.2250000
NODE_12494_length_788_cov_8.872279	333	413	1	9	80	0.1125000
NODE_12494_length_788_cov_8.872279	333	413	2	51	80	0.6375000
NODE_12494_length_788_cov_8.872279	333	413	4	20	80	0.2500000
NODE_12516_length_787_cov_34.683140	274	335	0	61	61	1.0000000
NODE_12516_length_787_cov_34.683140	319	380	0	61	61	1.0000000
NODE_12517_length_787_cov_28.039244	252	329	2	77	77	1.0000000
NODE_12517_length_787_cov_28.039244	302	370	0	28	68	0.4117647
NODE_12517_length_787_cov_28.039244	302	370	2	40	68	0.5882353
NODE_12518_length_787_cov_25.422965	351	431	0	80	80	1.0000000
NODE_12518_length_787_cov_25.422965	404	484	0	80	80	1.0000000
NODE_12519_length_787_cov_24.857558	319	399	0	80	80	1.0000000
NODE_12519_length_787_cov_24.857558	372	452	0	80	80	1.0000000
NODE_12520_length_787_cov_21.357558	291	371	0	80	80	1.0000000
NODE_12520_length_787_cov_21.357558	344	424	0	80	80	1.0000000
NODE_12521_length_787_cov_17.360465	396	476	0	13	80	0.1625000
NODE_12521_length_787_cov_17.360465	396	476	6	1	80	0.0125000
NODE_12521_length_787_cov_17.360465	396	476	7	45	80	0.5625000
NODE_12521_length_787_cov_17.360465	396	476	8	21	80	0.2625000
NODE_12521_length_787_cov_17.360465	449	529	7	6	80	0.0750000
NODE_12521_length_787_cov_17.360465	449	529	8	74	80	0.9250000
NODE_12522_length_787_cov_14.677326	178	258	1	48	80	0.6000000
NODE_12522_length_787_cov_14.677326	178	258	2	6	80	0.0750000
NODE_12522_length_787_cov_14.677326	178	258	3	6	80	0.0750000
NODE_12522_length_787_cov_14.677326	178	258	5	15	80	0.1875000
NODE_12522_length_787_cov_14.677326	178	258	7	5	80	0.0625000
NODE_12522_length_787_cov_14.677326	231	311	1	1	80	0.0125000
NODE_12522_length_787_cov_14.677326	231	311	3	6	80	0.0750000
NODE_12522_length_787_cov_14.677326	231	311	5	15	80	0.1875000
NODE_12522_length_787_cov_14.677326	231	311	6	9	80	0.1125000
NODE_12522_length_787_cov_14.677326	231	311	7	16	80	0.2000000
NODE_12522_length_787_cov_14.677326	231	311	8	30	80	0.3750000
NODE_12522_length_787_cov_14.677326	231	311	9	3	80	0.0375000
NODE_12523_length_787_cov_12.959302	331	411	0	60	80	0.7500000
NODE_12523_length_787_cov_12.959302	331	411	2	20	80	0.2500000
NODE_12523_length_787_cov_12.959302	384	464	0	16	80	0.2000000
NODE_12523_length_787_cov_12.959302	384	464	2	64	80	0.8000000
NODE_12524_length_787_cov_12.748547	426	506	0	4	80	0.0500000
NODE_12524_length_787_cov_12.748547	426	506	2	76	80	0.9500000
NODE_12524_length_787_cov_12.748547	479	559	0	57	80	0.7125000
NODE_12524_length_787_cov_12.748547	479	559	2	23	80	0.2875000
NODE_12525_length_787_cov_12.369186	338	418	0	73	80	0.9125000
NODE_12525_length_787_cov_12.369186	338	418	2	7	80	0.0875000
NODE_12525_length_787_cov_12.369186	391	471	0	20	80	0.2500000
NODE_12525_length_787_cov_12.369186	391	471	2	60	80	0.7500000
NODE_12526_length_787_cov_9.213663	376	456	0	80	80	1.0000000
NODE_12527_length_787_cov_8.857558	344	424	0	80	80	1.0000000
NODE_12527_length_787_cov_8.857558	397	477	0	80	80	1.0000000
NODE_12529_length_787_cov_8.186047	508	552	0	44	44	1.0000000
NODE_12541_length_787_cov_2.188953	505	552	0	46	47	0.9787234
NODE_12541_length_787_cov_2.188953	505	552	4	1	47	0.0212766
NODE_12562_length_786_cov_36.441048	431	511	0	80	80	1.0000000
NODE_12562_length_786_cov_36.441048	484	564	0	80	80	1.0000000
NODE_12563_length_786_cov_23.771470	235	315	0	80	80	1.0000000
NODE_12563_length_786_cov_23.771470	288	368	0	80	80	1.0000000
NODE_12564_length_786_cov_23.333333	361	436	0	18	75	0.2400000
NODE_12564_length_786_cov_23.333333	361	436	2	57	75	0.7600000
NODE_12564_length_786_cov_23.333333	362	436	0	17	74	0.2297297
NODE_12564_length_786_cov_23.333333	362	436	2	57	74	0.7702703
NODE_12564_length_786_cov_23.333333	375	436	0	4	61	0.0655738
NODE_12564_length_786_cov_23.333333	375	436	2	57	61	0.9344262
NODE_12564_length_786_cov_23.333333	414	489	2	35	75	0.4666667
NODE_12564_length_786_cov_23.333333	414	489	5	15	75	0.2000000
NODE_12564_length_786_cov_23.333333	414	489	6	8	75	0.1066667
NODE_12564_length_786_cov_23.333333	414	489	7	3	75	0.0400000
NODE_12564_length_786_cov_23.333333	414	489	8	14	75	0.1866667
NODE_12564_length_786_cov_23.333333	414	489	2	35	75	0.4666667
NODE_12564_length_786_cov_23.333333	414	489	5	15	75	0.2000000
NODE_12564_length_786_cov_23.333333	414	489	6	8	75	0.1066667
NODE_12564_length_786_cov_23.333333	414	489	7	3	75	0.0400000
NODE_12564_length_786_cov_23.333333	414	489	8	14	75	0.1866667
NODE_12564_length_786_cov_23.333333	414	489	2	35	75	0.4666667
NODE_12564_length_786_cov_23.333333	414	489	5	15	75	0.2000000
NODE_12564_length_786_cov_23.333333	414	489	6	8	75	0.1066667
NODE_12564_length_786_cov_23.333333	414	489	7	3	75	0.0400000
NODE_12564_length_786_cov_23.333333	414	489	8	14	75	0.1866667
NODE_12564_length_786_cov_23.333333	490	564	6	5	74	0.0675676
NODE_12564_length_786_cov_23.333333	490	564	8	29	74	0.3918919
NODE_12564_length_786_cov_23.333333	490	564	10	40	74	0.5405405
NODE_12565_length_786_cov_19.279476	310	375	0	65	65	1.0000000
NODE_12565_length_786_cov_19.279476	371	441	0	70	70	1.0000000
NODE_12565_length_786_cov_19.279476	371	451	0	80	80	1.0000000
NODE_12565_length_786_cov_19.279476	424	491	0	67	67	1.0000000
NODE_12566_length_786_cov_18.652111	251	331	0	80	80	1.0000000
NODE_12566_length_786_cov_18.652111	304	384	0	80	80	1.0000000
NODE_12567_length_786_cov_16.704512	319	399	0	44	80	0.5500000
NODE_12567_length_786_cov_16.704512	319	399	4	36	80	0.4500000
NODE_12567_length_786_cov_16.704512	372	452	0	6	80	0.0750000
NODE_12567_length_786_cov_16.704512	372	452	4	74	80	0.9250000
NODE_12568_length_786_cov_16.254731	378	458	2	80	80	1.0000000
NODE_12568_length_786_cov_16.254731	431	511	0	39	80	0.4875000
NODE_12568_length_786_cov_16.254731	431	511	2	41	80	0.5125000
NODE_12571_length_786_cov_10.053857	381	461	0	42	80	0.5250000
NODE_12571_length_786_cov_10.053857	381	461	4	38	80	0.4750000
NODE_12571_length_786_cov_10.053857	434	514	4	80	80	1.0000000
NODE_12572_length_786_cov_7.455604	400	473	0	73	73	1.0000000
NODE_12572_length_786_cov_7.455604	453	533	0	80	80	1.0000000
NODE_12573_length_786_cov_7.119360	276	356	0	80	80	1.0000000
NODE_12573_length_786_cov_7.119360	329	409	0	80	80	1.0000000
NODE_12575_length_786_cov_6.771470	382	462	0	16	80	0.2000000
NODE_12575_length_786_cov_6.771470	382	462	2	64	80	0.8000000
NODE_12575_length_786_cov_6.771470	435	515	0	69	80	0.8625000
NODE_12575_length_786_cov_6.771470	435	515	2	11	80	0.1375000
NODE_12603_length_785_cov_83.972303	315	395	2	24	80	0.3000000
NODE_12603_length_785_cov_83.972303	315	395	4	14	80	0.1750000
NODE_12603_length_785_cov_83.972303	315	395	6	42	80	0.5250000
NODE_12603_length_785_cov_83.972303	368	448	0	23	80	0.2875000
NODE_12603_length_785_cov_83.972303	368	448	2	54	80	0.6750000
NODE_12603_length_785_cov_83.972303	368	448	4	3	80	0.0375000
NODE_12604_length_785_cov_33.911079	477	557	0	80	80	1.0000000
NODE_12604_length_785_cov_33.911079	530	610	0	80	80	1.0000000
NODE_12605_length_785_cov_21.174927	265	299	0	34	34	1.0000000
NODE_12605_length_785_cov_21.174927	295	375	0	80	80	1.0000000
NODE_12605_length_785_cov_21.174927	348	428	0	80	80	1.0000000
NODE_12606_length_785_cov_18.612245	291	371	0	80	80	1.0000000
NODE_12606_length_785_cov_18.612245	344	424	0	80	80	1.0000000
NODE_12606_length_785_cov_18.612245	684	705	0	21	21	1.0000000
NODE_12607_length_785_cov_9.893586	153	233	0	80	80	1.0000000
NODE_12607_length_785_cov_9.893586	206	286	0	80	80	1.0000000
NODE_12645_length_784_cov_203.604380	5	85	45	2	80	0.0250000
NODE_12645_length_784_cov_203.604380	5	85	58	1	80	0.0125000
NODE_12645_length_784_cov_203.604380	5	85	62	1	80	0.0125000
NODE_12645_length_784_cov_203.604380	5	85	66	1	80	0.0125000
NODE_12645_length_784_cov_203.604380	5	85	70	1	80	0.0125000
NODE_12645_length_784_cov_203.604380	5	85	73	1	80	0.0125000
NODE_12645_length_784_cov_203.604380	5	85	81	1	80	0.0125000
NODE_12645_length_784_cov_203.604380	5	85	97	2	80	0.0250000
NODE_12645_length_784_cov_203.604380	5	85	103	1	80	0.0125000
NODE_12645_length_784_cov_203.604380	5	85	114	1	80	0.0125000
NODE_12645_length_784_cov_203.604380	5	85	117	1	80	0.0125000
NODE_12645_length_784_cov_203.604380	5	85	125	1	80	0.0125000
NODE_12645_length_784_cov_203.604380	5	85	126	1	80	0.0125000
NODE_12645_length_784_cov_203.604380	5	85	128	1	80	0.0125000
NODE_12645_length_784_cov_203.604380	5	85	134	4	80	0.0500000
NODE_12645_length_784_cov_203.604380	5	85	138	1	80	0.0125000
NODE_12645_length_784_cov_203.604380	5	85	148	2	80	0.0250000
NODE_12645_length_784_cov_203.604380	5	85	151	1	80	0.0125000
NODE_12645_length_784_cov_203.604380	5	85	152	1	80	0.0125000
NODE_12645_length_784_cov_203.604380	5	85	154	2	80	0.0250000
NODE_12645_length_784_cov_203.604380	5	85	156	2	80	0.0250000
NODE_12645_length_784_cov_203.604380	5	85	158	2	80	0.0250000
NODE_12645_length_784_cov_203.604380	5	85	164	1	80	0.0125000
NODE_12645_length_784_cov_203.604380	5	85	172	3	80	0.0375000
NODE_12645_length_784_cov_203.604380	5	85	177	1	80	0.0125000
NODE_12645_length_784_cov_203.604380	5	85	185	1	80	0.0125000
NODE_12645_length_784_cov_203.604380	5	85	190	1	80	0.0125000
NODE_12645_length_784_cov_203.604380	5	85	207	1	80	0.0125000
NODE_12645_length_784_cov_203.604380	5	85	208	2	80	0.0250000
NODE_12645_length_784_cov_203.604380	5	85	214	1	80	0.0125000
NODE_12645_length_784_cov_203.604380	5	85	216	2	80	0.0250000
NODE_12645_length_784_cov_203.604380	5	85	217	1	80	0.0125000
NODE_12645_length_784_cov_203.604380	5	85	221	1	80	0.0125000
NODE_12645_length_784_cov_203.604380	5	85	223	1	80	0.0125000
NODE_12645_length_784_cov_203.604380	5	85	233	1	80	0.0125000
NODE_12645_length_784_cov_203.604380	5	85	237	2	80	0.0250000
NODE_12645_length_784_cov_203.604380	5	85	247	2	80	0.0250000
NODE_12645_length_784_cov_203.604380	5	85	248	1	80	0.0125000
NODE_12645_length_784_cov_203.604380	5	85	250	1	80	0.0125000
NODE_12645_length_784_cov_203.604380	5	85	251	5	80	0.0625000
NODE_12645_length_784_cov_203.604380	5	85	256	4	80	0.0500000
NODE_12645_length_784_cov_203.604380	5	85	258	2	80	0.0250000
NODE_12645_length_784_cov_203.604380	5	85	259	3	80	0.0375000
NODE_12645_length_784_cov_203.604380	5	85	263	1	80	0.0125000
NODE_12645_length_784_cov_203.604380	5	85	265	2	80	0.0250000
NODE_12645_length_784_cov_203.604380	5	85	269	1	80	0.0125000
NODE_12645_length_784_cov_203.604380	5	85	281	1	80	0.0125000
NODE_12645_length_784_cov_203.604380	5	85	283	1	80	0.0125000
NODE_12645_length_784_cov_203.604380	5	85	287	1	80	0.0125000
NODE_12645_length_784_cov_203.604380	5	85	289	1	80	0.0125000
NODE_12645_length_784_cov_203.604380	5	85	293	1	80	0.0125000
NODE_12645_length_784_cov_203.604380	5	85	295	1	80	0.0125000
NODE_12645_length_784_cov_203.604380	5	85	297	1	80	0.0125000
NODE_12645_length_784_cov_203.604380	5	85	299	1	80	0.0125000
NODE_12645_length_784_cov_203.604380	58	138	250	1	80	0.0125000
NODE_12645_length_784_cov_203.604380	58	138	251	5	80	0.0625000
NODE_12645_length_784_cov_203.604380	58	138	256	4	80	0.0500000
NODE_12645_length_784_cov_203.604380	58	138	258	2	80	0.0250000
NODE_12645_length_784_cov_203.604380	58	138	259	3	80	0.0375000
NODE_12645_length_784_cov_203.604380	58	138	263	1	80	0.0125000
NODE_12645_length_784_cov_203.604380	58	138	265	2	80	0.0250000
NODE_12645_length_784_cov_203.604380	58	138	269	1	80	0.0125000
NODE_12645_length_784_cov_203.604380	58	138	281	1	80	0.0125000
NODE_12645_length_784_cov_203.604380	58	138	283	1	80	0.0125000
NODE_12645_length_784_cov_203.604380	58	138	287	1	80	0.0125000
NODE_12645_length_784_cov_203.604380	58	138	289	1	80	0.0125000
NODE_12645_length_784_cov_203.604380	58	138	293	1	80	0.0125000
NODE_12645_length_784_cov_203.604380	58	138	295	1	80	0.0125000
NODE_12645_length_784_cov_203.604380	58	138	297	1	80	0.0125000
NODE_12645_length_784_cov_203.604380	58	138	299	1	80	0.0125000
NODE_12645_length_784_cov_203.604380	58	138	301	1	80	0.0125000
NODE_12645_length_784_cov_203.604380	58	138	302	1	80	0.0125000
NODE_12645_length_784_cov_203.604380	58	138	305	1	80	0.0125000
NODE_12645_length_784_cov_203.604380	58	138	309	1	80	0.0125000
NODE_12645_length_784_cov_203.604380	58	138	311	1	80	0.0125000
NODE_12645_length_784_cov_203.604380	58	138	313	3	80	0.0375000
NODE_12645_length_784_cov_203.604380	58	138	315	2	80	0.0250000
NODE_12645_length_784_cov_203.604380	58	138	321	2	80	0.0250000
NODE_12645_length_784_cov_203.604380	58	138	323	1	80	0.0125000
NODE_12645_length_784_cov_203.604380	58	138	327	1	80	0.0125000
NODE_12645_length_784_cov_203.604380	58	138	328	1	80	0.0125000
NODE_12645_length_784_cov_203.604380	58	138	330	1	80	0.0125000
NODE_12645_length_784_cov_203.604380	58	138	332	2	80	0.0250000
NODE_12645_length_784_cov_203.604380	58	138	333	2	80	0.0250000
NODE_12645_length_784_cov_203.604380	58	138	334	3	80	0.0375000
NODE_12645_length_784_cov_203.604380	58	138	335	2	80	0.0250000
NODE_12645_length_784_cov_203.604380	58	138	336	2	80	0.0250000
NODE_12645_length_784_cov_203.604380	58	138	337	2	80	0.0250000
NODE_12645_length_784_cov_203.604380	58	138	338	6	80	0.0750000
NODE_12645_length_784_cov_203.604380	58	138	339	2	80	0.0250000
NODE_12645_length_784_cov_203.604380	58	138	340	4	80	0.0500000
NODE_12645_length_784_cov_203.604380	58	138	341	5	80	0.0625000
NODE_12645_length_784_cov_203.604380	58	138	342	4	80	0.0500000
NODE_12645_length_784_cov_203.604380	58	138	343	1	80	0.0125000
NODE_12645_length_784_cov_203.604380	58	138	345	2	80	0.0250000
NODE_12646_length_784_cov_45.210219	49	129	0	2	80	0.0250000
NODE_12646_length_784_cov_45.210219	49	129	2	78	80	0.9750000
NODE_12646_length_784_cov_45.210219	102	182	0	27	80	0.3375000
NODE_12646_length_784_cov_45.210219	102	182	1	9	80	0.1125000
NODE_12646_length_784_cov_45.210219	102	182	2	44	80	0.5500000
NODE_12646_length_784_cov_45.210219	218	298	0	80	80	1.0000000
NODE_12646_length_784_cov_45.210219	271	351	0	57	80	0.7125000
NODE_12646_length_784_cov_45.210219	271	351	2	23	80	0.2875000
NODE_12646_length_784_cov_45.210219	347	427	0	14	80	0.1750000
NODE_12646_length_784_cov_45.210219	347	427	2	66	80	0.8250000
NODE_12646_length_784_cov_45.210219	347	427	0	14	80	0.1750000
NODE_12646_length_784_cov_45.210219	347	427	2	66	80	0.8250000
NODE_12646_length_784_cov_45.210219	347	427	0	14	80	0.1750000
NODE_12646_length_784_cov_45.210219	347	427	2	66	80	0.8250000
NODE_12646_length_784_cov_45.210219	400	447	0	34	47	0.7234042
NODE_12646_length_784_cov_45.210219	400	447	2	13	47	0.2765957
NODE_12646_length_784_cov_45.210219	400	480	0	67	80	0.8375000
NODE_12646_length_784_cov_45.210219	400	480	2	13	80	0.1625000
NODE_12646_length_784_cov_45.210219	400	455	0	42	55	0.7636364
NODE_12646_length_784_cov_45.210219	400	455	2	13	55	0.2363636
NODE_12647_length_784_cov_33.543066	405	485	0	80	80	1.0000000
NODE_12647_length_784_cov_33.543066	458	538	0	80	80	1.0000000
NODE_12648_length_784_cov_21.762044	318	398	2	1	80	0.0125000
NODE_12648_length_784_cov_21.762044	318	398	3	1	80	0.0125000
NODE_12648_length_784_cov_21.762044	318	398	4	78	80	0.9750000
NODE_12648_length_784_cov_21.762044	371	451	0	41	80	0.5125000
NODE_12648_length_784_cov_21.762044	371	451	2	13	80	0.1625000
NODE_12648_length_784_cov_21.762044	371	451	3	1	80	0.0125000
NODE_12648_length_784_cov_21.762044	371	451	4	25	80	0.3125000
NODE_12649_length_784_cov_20.583942	286	366	0	80	80	1.0000000
NODE_12649_length_784_cov_20.583942	339	419	0	80	80	1.0000000
NODE_12649_length_784_cov_20.583942	415	495	0	16	80	0.2000000
NODE_12649_length_784_cov_20.583942	415	495	2	64	80	0.8000000
NODE_12649_length_784_cov_20.583942	468	548	0	49	80	0.6125000
NODE_12649_length_784_cov_20.583942	468	548	2	31	80	0.3875000
NODE_12650_length_784_cov_19.448175	217	297	2	80	80	1.0000000
NODE_12650_length_784_cov_19.448175	270	350	0	44	80	0.5500000
NODE_12650_length_784_cov_19.448175	270	350	2	36	80	0.4500000
NODE_12652_length_784_cov_12.480292	297	377	0	80	80	1.0000000
NODE_12652_length_784_cov_12.480292	350	430	0	80	80	1.0000000
NODE_12653_length_784_cov_9.296350	250	330	0	5	80	0.0625000
NODE_12653_length_784_cov_9.296350	250	330	2	9	80	0.1125000
NODE_12653_length_784_cov_9.296350	250	330	4	66	80	0.8250000
NODE_12653_length_784_cov_9.296350	303	383	0	58	80	0.7250000
NODE_12653_length_784_cov_9.296350	303	383	2	9	80	0.1125000
NODE_12653_length_784_cov_9.296350	303	383	4	13	80	0.1625000
NODE_12653_length_784_cov_9.296350	379	459	0	80	80	1.0000000
NODE_12653_length_784_cov_9.296350	432	512	0	80	80	1.0000000
NODE_12654_length_784_cov_6.316788	274	354	0	80	80	1.0000000
NODE_12654_length_784_cov_6.316788	327	407	0	80	80	1.0000000
NODE_12688_length_783_cov_41.849415	459	539	0	80	80	1.0000000
NODE_12688_length_783_cov_41.849415	512	592	0	80	80	1.0000000
NODE_12689_length_783_cov_39.881579	230	310	0	80	80	1.0000000
NODE_12689_length_783_cov_39.881579	283	363	0	80	80	1.0000000
NODE_12689_length_783_cov_39.881579	359	439	0	80	80	1.0000000
NODE_12689_length_783_cov_39.881579	412	492	0	80	80	1.0000000
NODE_12690_length_783_cov_35.967836	229	309	0	80	80	1.0000000
NODE_12690_length_783_cov_35.967836	282	362	0	80	80	1.0000000
NODE_12691_length_783_cov_28.203216	292	372	0	80	80	1.0000000
NODE_12691_length_783_cov_28.203216	345	425	0	80	80	1.0000000
NODE_12692_length_783_cov_16.695906	393	473	0	80	80	1.0000000
NODE_12692_length_783_cov_16.695906	446	526	0	29	80	0.3625000
NODE_12692_length_783_cov_16.695906	446	526	2	51	80	0.6375000
NODE_12693_length_783_cov_15.656433	418	498	0	80	80	1.0000000
NODE_12693_length_783_cov_15.656433	471	551	0	80	80	1.0000000
NODE_12694_length_783_cov_14.904971	321	401	0	80	80	1.0000000
NODE_12694_length_783_cov_14.904971	374	454	0	80	80	1.0000000
NODE_12728_length_782_cov_22.461201	347	427	0	80	80	1.0000000
NODE_12728_length_782_cov_22.461201	400	480	0	80	80	1.0000000
NODE_12729_length_782_cov_19.163982	306	386	0	6	80	0.0750000
NODE_12729_length_782_cov_19.163982	306	386	1	3	80	0.0375000
NODE_12729_length_782_cov_19.163982	306	386	2	11	80	0.1375000
NODE_12729_length_782_cov_19.163982	306	386	4	60	80	0.7500000
NODE_12729_length_782_cov_19.163982	382	462	0	46	80	0.5750000
NODE_12729_length_782_cov_19.163982	382	462	4	34	80	0.4250000
NODE_12729_length_782_cov_19.163982	435	515	0	80	80	1.0000000
NODE_12730_length_782_cov_19.090776	295	375	0	27	80	0.3375000
NODE_12730_length_782_cov_19.090776	295	375	2	53	80	0.6625000
NODE_12730_length_782_cov_19.090776	348	428	0	33	80	0.4125000
NODE_12730_length_782_cov_19.090776	348	428	2	47	80	0.5875000
NODE_12731_length_782_cov_13.509517	323	403	7	16	80	0.2000000
NODE_12731_length_782_cov_13.509517	323	403	9	1	80	0.0125000
NODE_12731_length_782_cov_13.509517	323	403	10	63	80	0.7875000
NODE_12731_length_782_cov_13.509517	376	456	3	1	80	0.0125000
NODE_12731_length_782_cov_13.509517	376	456	6	52	80	0.6500000
NODE_12731_length_782_cov_13.509517	376	456	9	1	80	0.0125000
NODE_12731_length_782_cov_13.509517	376	456	10	26	80	0.3250000
NODE_12732_length_782_cov_11.364568	367	447	16	24	80	0.3000000
NODE_12732_length_782_cov_11.364568	367	447	18	4	80	0.0500000
NODE_12732_length_782_cov_11.364568	367	447	19	5	80	0.0625000
NODE_12732_length_782_cov_11.364568	367	447	20	1	80	0.0125000
NODE_12732_length_782_cov_11.364568	367	447	21	46	80	0.5750000
NODE_12732_length_782_cov_11.364568	420	500	0	49	80	0.6125000
NODE_12732_length_782_cov_11.364568	420	500	20	1	80	0.0125000
NODE_12732_length_782_cov_11.364568	420	500	21	30	80	0.3750000
NODE_12735_length_782_cov_7.976574	245	325	0	44	80	0.5500000
NODE_12735_length_782_cov_7.976574	245	325	2	10	80	0.1250000
NODE_12735_length_782_cov_7.976574	245	325	4	26	80	0.3250000
NODE_12735_length_782_cov_7.976574	298	378	2	1	80	0.0125000
NODE_12735_length_782_cov_7.976574	298	378	4	79	80	0.9875000
NODE_12737_length_782_cov_5.500732	384	464	0	80	80	1.0000000
NODE_12737_length_782_cov_5.500732	437	517	0	80	80	1.0000000
NODE_12739_length_782_cov_4.434846	309	389	0	80	80	1.0000000
NODE_12739_length_782_cov_4.434846	362	442	0	80	80	1.0000000
NODE_12740_length_782_cov_3.352855	177	196	0	19	19	1.0000000
NODE_12741_length_782_cov_3.231332	160	240	0	80	80	1.0000000
NODE_12741_length_782_cov_3.231332	213	298	0	85	85	1.0000000
NODE_12765_length_781_cov_34.247801	174	254	0	80	80	1.0000000
NODE_12765_length_781_cov_34.247801	227	307	0	80	80	1.0000000
NODE_12766_length_781_cov_27.530792	490	570	4	22	80	0.2750000
NODE_12766_length_781_cov_27.530792	490	570	6	19	80	0.2375000
NODE_12766_length_781_cov_27.530792	490	570	10	39	80	0.4875000
NODE_12766_length_781_cov_27.530792	543	623	4	18	80	0.2250000
NODE_12766_length_781_cov_27.530792	543	623	6	37	80	0.4625000
NODE_12766_length_781_cov_27.530792	543	623	10	25	80	0.3125000
NODE_12766_length_781_cov_27.530792	619	699	0	61	80	0.7625000
NODE_12766_length_781_cov_27.530792	619	699	4	19	80	0.2375000
NODE_12766_length_781_cov_27.530792	672	752	0	80	80	1.0000000
NODE_12767_length_781_cov_22.768328	427	507	2	80	80	1.0000000
NODE_12767_length_781_cov_22.768328	480	560	2	80	80	1.0000000
NODE_12768_length_781_cov_17.894428	411	491	0	80	80	1.0000000
NODE_12768_length_781_cov_17.894428	464	544	0	80	80	1.0000000
NODE_12769_length_781_cov_14.922287	486	565	4	10	79	0.1265823
NODE_12769_length_781_cov_14.922287	486	565	10	25	79	0.3164557
NODE_12769_length_781_cov_14.922287	486	565	16	44	79	0.5569620
NODE_12769_length_781_cov_14.922287	538	618	12	24	80	0.3000000
NODE_12769_length_781_cov_14.922287	538	618	14	5	80	0.0625000
NODE_12769_length_781_cov_14.922287	538	618	16	51	80	0.6375000
NODE_12770_length_781_cov_12.529326	318	398	0	80	80	1.0000000
NODE_12770_length_781_cov_12.529326	371	451	0	80	80	1.0000000
NODE_12771_length_781_cov_10.303519	444	524	6	1	80	0.0125000
NODE_12771_length_781_cov_10.303519	444	524	12	69	80	0.8625000
NODE_12771_length_781_cov_10.303519	444	524	16	10	80	0.1250000
NODE_12772_length_781_cov_9.851906	374	454	0	31	80	0.3875000
NODE_12772_length_781_cov_9.851906	374	454	4	49	80	0.6125000
NODE_12772_length_781_cov_9.851906	427	507	0	80	80	1.0000000
NODE_12775_length_781_cov_8.557185	113	194	0	81	81	1.0000000
NODE_12775_length_781_cov_8.557185	166	239	0	73	73	1.0000000
NODE_12778_length_781_cov_4.734604	30	110	0	20	80	0.2500000
NODE_12778_length_781_cov_4.734604	30	110	3	2	80	0.0250000
NODE_12778_length_781_cov_4.734604	30	110	4	16	80	0.2000000
NODE_12778_length_781_cov_4.734604	30	110	6	42	80	0.5250000
NODE_12778_length_781_cov_4.734604	83	163	0	10	80	0.1250000
NODE_12778_length_781_cov_4.734604	83	163	4	1	80	0.0125000
NODE_12778_length_781_cov_4.734604	83	163	6	69	80	0.8625000
NODE_12780_length_781_cov_4.077713	269	349	0	80	80	1.0000000
NODE_12780_length_781_cov_4.077713	322	402	0	80	80	1.0000000
NODE_12812_length_780_cov_37.693098	165	245	0	80	80	1.0000000
NODE_12812_length_780_cov_37.693098	218	298	0	80	80	1.0000000
NODE_12813_length_780_cov_22.132159	407	487	2	80	80	1.0000000
NODE_12813_length_780_cov_22.132159	460	540	0	48	80	0.6000000
NODE_12813_length_780_cov_22.132159	460	540	2	32	80	0.4000000
NODE_12814_length_780_cov_21.831131	299	379	2	80	80	1.0000000
NODE_12814_length_780_cov_21.831131	352	432	0	29	80	0.3625000
NODE_12814_length_780_cov_21.831131	352	432	2	51	80	0.6375000
NODE_12815_length_780_cov_16.722467	165	245	0	80	80	1.0000000
NODE_12815_length_780_cov_16.722467	218	298	0	80	80	1.0000000
NODE_12816_length_780_cov_13.189427	150	254	0	104	104	1.0000000
NODE_12816_length_780_cov_13.189427	227	307	0	80	80	1.0000000
NODE_12817_length_780_cov_12.910426	276	356	0	80	80	1.0000000
NODE_12817_length_780_cov_12.910426	329	409	0	80	80	1.0000000
NODE_12818_length_780_cov_8.455213	141	221	0	7	80	0.0875000
NODE_12818_length_780_cov_8.455213	141	221	2	73	80	0.9125000
NODE_12818_length_780_cov_8.455213	194	274	0	60	80	0.7500000
NODE_12818_length_780_cov_8.455213	194	274	2	20	80	0.2500000
NODE_12848_length_779_cov_51.022059	8	43	0	35	35	1.0000000
NODE_12848_length_779_cov_51.022059	53	96	0	43	43	1.0000000
NODE_12848_length_779_cov_51.022059	97	177	0	30	80	0.3750000
NODE_12848_length_779_cov_51.022059	97	177	2	50	80	0.6250000
NODE_12848_length_779_cov_51.022059	150	230	0	5	80	0.0625000
NODE_12848_length_779_cov_51.022059	150	230	2	75	80	0.9375000
NODE_12849_length_779_cov_23.682353	362	442	10	80	80	1.0000000
NODE_12849_length_779_cov_23.682353	415	495	8	47	80	0.5875000
NODE_12849_length_779_cov_23.682353	415	495	10	33	80	0.4125000
NODE_12850_length_779_cov_15.994118	320	400	0	80	80	1.0000000
NODE_12850_length_779_cov_15.994118	373	453	0	80	80	1.0000000
NODE_12851_length_779_cov_14.386765	258	320	19	16	62	0.2580645
NODE_12851_length_779_cov_14.386765	258	320	23	5	62	0.0806452
NODE_12851_length_779_cov_14.386765	258	320	26	1	62	0.0161290
NODE_12851_length_779_cov_14.386765	258	320	27	2	62	0.0322581
NODE_12851_length_779_cov_14.386765	258	320	29	15	62	0.2419355
NODE_12851_length_779_cov_14.386765	258	320	30	23	62	0.3709677
NODE_12851_length_779_cov_14.386765	293	368	10	2	75	0.0266667
NODE_12851_length_779_cov_14.386765	293	368	16	11	75	0.1466667
NODE_12851_length_779_cov_14.386765	293	368	18	2	75	0.0266667
NODE_12851_length_779_cov_14.386765	293	368	22	20	75	0.2666667
NODE_12851_length_779_cov_14.386765	293	368	26	11	75	0.1466667
NODE_12851_length_779_cov_14.386765	293	368	29	4	75	0.0533333
NODE_12851_length_779_cov_14.386765	293	368	30	25	75	0.3333333
NODE_12851_length_779_cov_14.386765	369	443	12	7	74	0.0945946
NODE_12851_length_779_cov_14.386765	369	443	13	2	74	0.0270270
NODE_12851_length_779_cov_14.386765	369	443	14	21	74	0.2837838
NODE_12851_length_779_cov_14.386765	369	443	16	3	74	0.0405405
NODE_12851_length_779_cov_14.386765	369	443	18	7	74	0.0945946
NODE_12851_length_779_cov_14.386765	369	443	19	9	74	0.1216216
NODE_12851_length_779_cov_14.386765	369	443	20	2	74	0.0270270
NODE_12851_length_779_cov_14.386765	369	443	21	1	74	0.0135135
NODE_12851_length_779_cov_14.386765	369	443	22	9	74	0.1216216
NODE_12851_length_779_cov_14.386765	369	443	24	6	74	0.0810811
NODE_12851_length_779_cov_14.386765	369	443	26	7	74	0.0945946
NODE_12852_length_779_cov_11.861765	180	263	0	83	83	1.0000000
NODE_12852_length_779_cov_11.861765	236	316	0	80	80	1.0000000
NODE_12852_length_779_cov_11.861765	312	392	0	80	80	1.0000000
NODE_12852_length_779_cov_11.861765	365	445	0	80	80	1.0000000
NODE_12853_length_779_cov_11.735294	285	365	0	80	80	1.0000000
NODE_12853_length_779_cov_11.735294	338	418	0	80	80	1.0000000
NODE_12854_length_779_cov_7.211765	333	413	0	26	80	0.3250000
NODE_12854_length_779_cov_7.211765	333	413	2	54	80	0.6750000
NODE_12854_length_779_cov_7.211765	386	466	0	79	80	0.9875000
NODE_12854_length_779_cov_7.211765	386	466	2	1	80	0.0125000
NODE_12857_length_779_cov_5.611765	271	351	0	33	80	0.4125000
NODE_12857_length_779_cov_5.611765	271	351	2	47	80	0.5875000
NODE_12857_length_779_cov_5.611765	324	404	2	80	80	1.0000000
NODE_12859_length_779_cov_4.695588	216	296	0	80	80	1.0000000
NODE_12859_length_779_cov_4.695588	269	349	0	80	80	1.0000000
NODE_12863_length_779_cov_2.329412	615	672	15	2	57	0.0350877
NODE_12863_length_779_cov_2.329412	615	672	16	55	57	0.9649123
NODE_12883_length_778_cov_21.615611	325	405	0	9	80	0.1125000
NODE_12883_length_778_cov_21.615611	325	405	2	65	80	0.8125000
NODE_12883_length_778_cov_21.615611	325	405	4	6	80	0.0750000
NODE_12883_length_778_cov_21.615611	378	458	2	48	80	0.6000000
NODE_12883_length_778_cov_21.615611	378	458	4	32	80	0.4000000
NODE_12884_length_778_cov_19.549337	348	428	0	28	80	0.3500000
NODE_12884_length_778_cov_19.549337	348	428	2	52	80	0.6500000
NODE_12884_length_778_cov_19.549337	401	481	0	80	80	1.0000000
NODE_12885_length_778_cov_15.403535	312	392	0	11	80	0.1375000
NODE_12885_length_778_cov_15.403535	312	392	4	69	80	0.8625000
NODE_12885_length_778_cov_15.403535	365	445	0	22	80	0.2750000
NODE_12885_length_778_cov_15.403535	365	445	4	58	80	0.7250000
NODE_12886_length_778_cov_14.614138	101	181	0	80	80	1.0000000
NODE_12886_length_778_cov_14.614138	154	234	0	80	80	1.0000000
NODE_12887_length_778_cov_13.368189	256	336	0	80	80	1.0000000
NODE_12887_length_778_cov_13.368189	309	389	0	80	80	1.0000000
NODE_12891_length_778_cov_6.307806	349	429	2	80	80	1.0000000
NODE_12891_length_778_cov_6.307806	402	482	0	42	80	0.5250000
NODE_12891_length_778_cov_6.307806	402	482	2	38	80	0.4750000
NODE_12893_length_778_cov_5.985272	385	465	0	80	80	1.0000000
NODE_12893_length_778_cov_5.985272	438	518	0	80	80	1.0000000
NODE_12928_length_777_cov_25.504425	323	403	0	80	80	1.0000000
NODE_12928_length_777_cov_25.504425	376	456	0	80	80	1.0000000
NODE_12929_length_777_cov_25.410029	346	426	0	80	80	1.0000000
NODE_12929_length_777_cov_25.410029	399	479	0	80	80	1.0000000
NODE_12930_length_777_cov_25.333333	97	177	0	3	80	0.0375000
NODE_12930_length_777_cov_25.333333	97	177	2	77	80	0.9625000
NODE_12930_length_777_cov_25.333333	150	230	0	42	80	0.5250000
NODE_12930_length_777_cov_25.333333	150	230	2	38	80	0.4750000
NODE_12931_length_777_cov_21.600295	408	485	8	77	77	1.0000000
NODE_12931_length_777_cov_21.600295	458	538	0	14	80	0.1750000
NODE_12931_length_777_cov_21.600295	458	538	8	66	80	0.8250000
NODE_12932_length_777_cov_19.561947	343	423	0	48	80	0.6000000
NODE_12932_length_777_cov_19.561947	343	423	2	32	80	0.4000000
NODE_12932_length_777_cov_19.561947	396	476	0	27	80	0.3375000
NODE_12932_length_777_cov_19.561947	396	476	2	53	80	0.6625000
NODE_12933_length_777_cov_16.961652	264	344	0	71	80	0.8875000
NODE_12933_length_777_cov_16.961652	264	344	2	9	80	0.1125000
NODE_12933_length_777_cov_16.961652	317	397	0	18	80	0.2250000
NODE_12933_length_777_cov_16.961652	317	397	2	62	80	0.7750000
NODE_12934_length_777_cov_16.081121	299	379	0	80	80	1.0000000
NODE_12934_length_777_cov_16.081121	352	432	0	80	80	1.0000000
NODE_12935_length_777_cov_13.827434	380	460	2	1	80	0.0125000
NODE_12935_length_777_cov_13.827434	380	460	4	12	80	0.1500000
NODE_12935_length_777_cov_13.827434	380	460	6	67	80	0.8375000
NODE_12935_length_777_cov_13.827434	433	513	1	20	80	0.2500000
NODE_12935_length_777_cov_13.827434	433	513	2	34	80	0.4250000
NODE_12935_length_777_cov_13.827434	433	513	4	12	80	0.1500000
NODE_12935_length_777_cov_13.827434	433	513	6	14	80	0.1750000
NODE_12936_length_777_cov_12.497050	413	493	0	80	80	1.0000000
NODE_12936_length_777_cov_12.497050	466	546	0	80	80	1.0000000
NODE_12937_length_777_cov_10.787611	213	286	0	43	73	0.5890411
NODE_12937_length_777_cov_10.787611	213	286	2	30	73	0.4109589
NODE_12938_length_777_cov_8.530973	362	422	0	60	60	1.0000000
NODE_12939_length_777_cov_7.634218	79	159	4	80	80	1.0000000
NODE_12939_length_777_cov_7.634218	132	212	0	46	80	0.5750000
NODE_12939_length_777_cov_7.634218	132	212	4	34	80	0.4250000
NODE_12940_length_777_cov_6.963127	256	336	0	47	80	0.5875000
NODE_12940_length_777_cov_6.963127	256	336	2	33	80	0.4125000
NODE_12940_length_777_cov_6.963127	309	389	2	80	80	1.0000000
NODE_12941_length_777_cov_6.417404	565	638	0	73	73	1.0000000
NODE_12942_length_777_cov_5.868732	443	523	11	12	80	0.1500000
NODE_12942_length_777_cov_5.868732	443	523	13	14	80	0.1750000
NODE_12942_length_777_cov_5.868732	443	523	14	54	80	0.6750000
NODE_12942_length_777_cov_5.868732	496	576	0	20	80	0.2500000
NODE_12942_length_777_cov_5.868732	496	576	1	3	80	0.0375000
NODE_12942_length_777_cov_5.868732	496	576	2	4	80	0.0500000
NODE_12942_length_777_cov_5.868732	496	576	7	10	80	0.1250000
NODE_12942_length_777_cov_5.868732	496	576	9	2	80	0.0250000
NODE_12942_length_777_cov_5.868732	496	576	10	10	80	0.1250000
NODE_12942_length_777_cov_5.868732	496	576	11	16	80	0.2000000
NODE_12942_length_777_cov_5.868732	496	576	13	14	80	0.1750000
NODE_12942_length_777_cov_5.868732	496	576	14	1	80	0.0125000
NODE_12971_length_776_cov_81.002954	237	317	0	62	80	0.7750000
NODE_12971_length_776_cov_81.002954	237	317	2	4	80	0.0500000
NODE_12971_length_776_cov_81.002954	237	317	10	1	80	0.0125000
NODE_12971_length_776_cov_81.002954	237	317	26	1	80	0.0125000
NODE_12971_length_776_cov_81.002954	237	317	39	1	80	0.0125000
NODE_12971_length_776_cov_81.002954	237	317	45	1	80	0.0125000
NODE_12971_length_776_cov_81.002954	237	317	50	1	80	0.0125000
NODE_12971_length_776_cov_81.002954	237	317	71	1	80	0.0125000
NODE_12971_length_776_cov_81.002954	237	317	75	1	80	0.0125000
NODE_12971_length_776_cov_81.002954	237	317	83	1	80	0.0125000
NODE_12971_length_776_cov_81.002954	237	317	96	1	80	0.0125000
NODE_12971_length_776_cov_81.002954	237	317	102	1	80	0.0125000
NODE_12971_length_776_cov_81.002954	237	317	107	1	80	0.0125000
NODE_12971_length_776_cov_81.002954	237	317	110	1	80	0.0125000
NODE_12971_length_776_cov_81.002954	237	317	126	2	80	0.0250000
NODE_12971_length_776_cov_81.002954	290	370	0	80	80	1.0000000
NODE_12972_length_776_cov_40.502216	345	425	0	80	80	1.0000000
NODE_12972_length_776_cov_40.502216	398	478	0	80	80	1.0000000
NODE_12973_length_776_cov_34.921713	204	284	0	80	80	1.0000000
NODE_12973_length_776_cov_34.921713	257	337	0	80	80	1.0000000
NODE_12974_length_776_cov_29.998523	177	257	0	2	80	0.0250000
NODE_12974_length_776_cov_29.998523	177	257	1	37	80	0.4625000
NODE_12974_length_776_cov_29.998523	177	257	2	15	80	0.1875000
NODE_12974_length_776_cov_29.998523	177	257	6	26	80	0.3250000
NODE_12974_length_776_cov_29.998523	230	310	0	1	80	0.0125000
NODE_12974_length_776_cov_29.998523	230	310	6	79	80	0.9875000
NODE_12975_length_776_cov_25.683900	417	497	0	80	80	1.0000000
NODE_12975_length_776_cov_25.683900	470	550	0	80	80	1.0000000
NODE_12976_length_776_cov_22.276219	367	447	0	80	80	1.0000000
NODE_12976_length_776_cov_22.276219	420	500	0	80	80	1.0000000
NODE_12977_length_776_cov_19.574594	242	322	2	11	80	0.1375000
NODE_12977_length_776_cov_19.574594	242	322	4	31	80	0.3875000
NODE_12977_length_776_cov_19.574594	242	322	6	38	80	0.4750000
NODE_12977_length_776_cov_19.574594	295	375	0	4	80	0.0500000
NODE_12977_length_776_cov_19.574594	295	375	4	76	80	0.9500000
NODE_12978_length_776_cov_18.262925	384	464	0	80	80	1.0000000
NODE_12978_length_776_cov_18.262925	437	517	0	80	80	1.0000000
NODE_12979_length_776_cov_16.023634	334	414	0	8	80	0.1000000
NODE_12979_length_776_cov_16.023634	334	414	2	72	80	0.9000000
NODE_12979_length_776_cov_16.023634	387	467	0	61	80	0.7625000
NODE_12979_length_776_cov_16.023634	387	467	2	19	80	0.2375000
NODE_12980_length_776_cov_15.841950	282	362	0	80	80	1.0000000
NODE_12980_length_776_cov_15.841950	335	415	0	80	80	1.0000000
NODE_12981_length_776_cov_14.131462	240	320	0	80	80	1.0000000
NODE_12981_length_776_cov_14.131462	293	373	0	80	80	1.0000000
NODE_12981_length_776_cov_14.131462	369	449	0	80	80	1.0000000
NODE_12981_length_776_cov_14.131462	422	502	0	33	80	0.4125000
NODE_12981_length_776_cov_14.131462	422	502	2	47	80	0.5875000
NODE_12983_length_776_cov_13.890694	302	382	0	80	80	1.0000000
NODE_12983_length_776_cov_13.890694	355	435	0	80	80	1.0000000
NODE_12984_length_776_cov_12.097489	488	568	0	80	80	1.0000000
NODE_12984_length_776_cov_12.097489	541	621	0	80	80	1.0000000
NODE_12985_length_776_cov_11.923191	422	498	0	76	76	1.0000000
NODE_12985_length_776_cov_11.923191	475	551	0	76	76	1.0000000
NODE_12986_length_776_cov_11.163959	312	392	0	80	80	1.0000000
NODE_12986_length_776_cov_11.163959	365	445	0	46	80	0.5750000
NODE_12986_length_776_cov_11.163959	365	445	2	34	80	0.4250000
NODE_12987_length_776_cov_9.754801	370	450	0	13	80	0.1625000
NODE_12987_length_776_cov_9.754801	370	450	2	15	80	0.1875000
NODE_12987_length_776_cov_9.754801	370	450	6	52	80	0.6500000
NODE_12987_length_776_cov_9.754801	423	503	0	6	80	0.0750000
NODE_12987_length_776_cov_9.754801	423	503	2	16	80	0.2000000
NODE_12987_length_776_cov_9.754801	423	503	6	58	80	0.7250000
NODE_12989_length_776_cov_8.271787	332	412	0	67	80	0.8375000
NODE_12989_length_776_cov_8.271787	332	412	2	13	80	0.1625000
NODE_12989_length_776_cov_8.271787	385	465	0	14	80	0.1750000
NODE_12989_length_776_cov_8.271787	385	465	2	66	80	0.8250000
NODE_12990_length_776_cov_4.874446	330	410	0	80	80	1.0000000
NODE_12990_length_776_cov_4.874446	383	463	0	80	80	1.0000000
NODE_13022_length_775_cov_33.612426	372	452	0	80	80	1.0000000
NODE_13022_length_775_cov_33.612426	425	505	0	80	80	1.0000000
NODE_13023_length_775_cov_25.500000	361	434	6	73	73	1.0000000
NODE_13023_length_775_cov_25.500000	413	487	0	25	74	0.3378378
NODE_13023_length_775_cov_25.500000	413	487	6	49	74	0.6621622
NODE_13024_length_775_cov_24.128698	220	300	4	53	80	0.6625000
NODE_13024_length_775_cov_24.128698	220	300	6	13	80	0.1625000
NODE_13024_length_775_cov_24.128698	220	300	7	14	80	0.1750000
NODE_13024_length_775_cov_24.128698	273	353	4	27	80	0.3375000
NODE_13024_length_775_cov_24.128698	273	353	6	13	80	0.1625000
NODE_13024_length_775_cov_24.128698	273	353	7	14	80	0.1750000
NODE_13024_length_775_cov_24.128698	273	353	8	26	80	0.3250000
NODE_13026_length_775_cov_16.165680	358	438	0	80	80	1.0000000
NODE_13026_length_775_cov_16.165680	411	491	0	80	80	1.0000000
NODE_13027_length_775_cov_8.522189	440	520	6	43	80	0.5375000
NODE_13027_length_775_cov_8.522189	440	520	8	37	80	0.4625000
NODE_13027_length_775_cov_8.522189	493	573	0	11	80	0.1375000
NODE_13027_length_775_cov_8.522189	493	573	2	26	80	0.3250000
NODE_13027_length_775_cov_8.522189	493	573	6	9	80	0.1125000
NODE_13027_length_775_cov_8.522189	493	573	8	34	80	0.4250000
NODE_13028_length_775_cov_8.258876	247	327	0	80	80	1.0000000
NODE_13028_length_775_cov_8.258876	300	380	0	80	80	1.0000000
NODE_13031_length_775_cov_3.786982	299	379	0	80	80	1.0000000
NODE_13031_length_775_cov_3.786982	352	432	0	80	80	1.0000000
NODE_13059_length_774_cov_27.386667	433	514	0	19	81	0.2345679
NODE_13059_length_774_cov_27.386667	433	514	4	62	81	0.7654321
NODE_13059_length_774_cov_27.386667	487	567	0	29	80	0.3625000
NODE_13059_length_774_cov_27.386667	487	567	4	51	80	0.6375000
NODE_13060_length_774_cov_19.721481	239	319	0	80	80	1.0000000
NODE_13060_length_774_cov_19.721481	292	372	0	80	80	1.0000000
NODE_13063_length_774_cov_4.594074	216	294	2	14	78	0.1794872
NODE_13063_length_774_cov_4.594074	216	294	6	17	78	0.2179487
NODE_13063_length_774_cov_4.594074	216	294	8	1	78	0.0128205
NODE_13063_length_774_cov_4.594074	216	294	10	4	78	0.0512821
NODE_13063_length_774_cov_4.594074	216	294	18	42	78	0.5384616
NODE_13063_length_774_cov_4.594074	269	347	8	1	78	0.0128205
NODE_13063_length_774_cov_4.594074	269	347	10	15	78	0.1923077
NODE_13063_length_774_cov_4.594074	269	347	14	7	78	0.0897436
NODE_13063_length_774_cov_4.594074	269	347	16	30	78	0.3846154
NODE_13063_length_774_cov_4.594074	269	347	18	25	78	0.3205128
NODE_13063_length_774_cov_4.594074	405	485	2	16	80	0.2000000
NODE_13063_length_774_cov_4.594074	405	485	4	64	80	0.8000000
NODE_13103_length_773_cov_60.566766	249	328	0	79	79	1.0000000
NODE_13103_length_773_cov_60.566766	304	381	0	77	77	1.0000000
NODE_13104_length_773_cov_27.299703	230	310	4	80	80	1.0000000
NODE_13104_length_773_cov_27.299703	283	363	0	24	80	0.3000000
NODE_13104_length_773_cov_27.299703	283	363	4	56	80	0.7000000
NODE_13105_length_773_cov_24.250742	392	470	0	24	78	0.3076923
NODE_13105_length_773_cov_24.250742	392	470	4	48	78	0.6153846
NODE_13105_length_773_cov_24.250742	392	470	9	1	78	0.0128205
NODE_13105_length_773_cov_24.250742	392	470	10	5	78	0.0641026
NODE_13105_length_773_cov_24.250742	443	523	4	21	80	0.2625000
NODE_13105_length_773_cov_24.250742	443	523	9	1	80	0.0125000
NODE_13105_length_773_cov_24.250742	443	523	10	58	80	0.7250000
NODE_13106_length_773_cov_20.683976	367	447	0	61	80	0.7625000
NODE_13106_length_773_cov_20.683976	367	447	2	19	80	0.2375000
NODE_13106_length_773_cov_20.683976	420	500	0	8	80	0.1000000
NODE_13106_length_773_cov_20.683976	420	500	2	72	80	0.9000000
NODE_13107_length_773_cov_18.498516	248	328	1	8	80	0.1000000
NODE_13107_length_773_cov_18.498516	248	328	2	72	80	0.9000000
NODE_13107_length_773_cov_18.498516	301	381	2	80	80	1.0000000
NODE_13108_length_773_cov_14.063798	405	485	0	24	80	0.3000000
NODE_13108_length_773_cov_14.063798	405	485	2	56	80	0.7000000
NODE_13108_length_773_cov_14.063798	458	538	0	53	80	0.6625000
NODE_13108_length_773_cov_14.063798	458	538	2	27	80	0.3375000
NODE_13109_length_773_cov_12.482196	421	501	0	26	80	0.3250000
NODE_13109_length_773_cov_12.482196	421	501	2	54	80	0.6750000
NODE_13109_length_773_cov_12.482196	474	554	2	80	80	1.0000000
NODE_13114_length_773_cov_9.136499	214	294	0	21	80	0.2625000
NODE_13114_length_773_cov_9.136499	214	294	2	16	80	0.2000000
NODE_13114_length_773_cov_9.136499	214	294	8	43	80	0.5375000
NODE_13114_length_773_cov_9.136499	267	347	6	21	80	0.2625000
NODE_13114_length_773_cov_9.136499	267	347	8	59	80	0.7375000
NODE_13115_length_773_cov_8.609792	461	541	4	76	80	0.9500000
NODE_13115_length_773_cov_8.609792	461	541	5	2	80	0.0250000
NODE_13115_length_773_cov_8.609792	461	541	6	2	80	0.0250000
NODE_13115_length_773_cov_8.609792	514	594	2	24	80	0.3000000
NODE_13115_length_773_cov_8.609792	514	594	4	56	80	0.7000000
NODE_13116_length_773_cov_7.224036	200	280	0	32	80	0.4000000
NODE_13116_length_773_cov_7.224036	200	280	2	48	80	0.6000000
NODE_13116_length_773_cov_7.224036	253	333	0	9	80	0.1125000
NODE_13116_length_773_cov_7.224036	253	333	2	71	80	0.8875000
NODE_13117_length_773_cov_6.910979	522	615	0	93	93	1.0000000
NODE_13117_length_773_cov_6.910979	588	668	0	52	80	0.6500000
NODE_13117_length_773_cov_6.910979	588	668	2	28	80	0.3500000
NODE_13147_length_772_cov_28.044577	231	311	5	23	80	0.2875000
NODE_13147_length_772_cov_28.044577	231	311	33	11	80	0.1375000
NODE_13147_length_772_cov_28.044577	231	311	34	46	80	0.5750000
NODE_13147_length_772_cov_28.044577	284	364	23	29	80	0.3625000
NODE_13147_length_772_cov_28.044577	284	364	24	1	80	0.0125000
NODE_13147_length_772_cov_28.044577	284	364	25	1	80	0.0125000
NODE_13147_length_772_cov_28.044577	284	364	27	1	80	0.0125000
NODE_13147_length_772_cov_28.044577	284	364	33	3	80	0.0375000
NODE_13147_length_772_cov_28.044577	284	364	34	45	80	0.5625000
NODE_13149_length_772_cov_9.523031	288	368	0	80	80	1.0000000
NODE_13149_length_772_cov_9.523031	341	421	0	80	80	1.0000000
NODE_13150_length_772_cov_8.778603	133	213	0	67	80	0.8375000
NODE_13150_length_772_cov_8.778603	133	213	2	13	80	0.1625000
NODE_13150_length_772_cov_8.778603	186	266	0	14	80	0.1750000
NODE_13150_length_772_cov_8.778603	186	266	2	66	80	0.8250000
NODE_13151_length_772_cov_7.921248	351	431	0	80	80	1.0000000
NODE_13151_length_772_cov_7.921248	404	480	0	44	76	0.5789474
NODE_13151_length_772_cov_7.921248	404	480	1	17	76	0.2236842
NODE_13151_length_772_cov_7.921248	404	480	2	15	76	0.1973684
NODE_13152_length_772_cov_7.059435	276	356	0	80	80	1.0000000
NODE_13152_length_772_cov_7.059435	329	409	0	80	80	1.0000000
NODE_13153_length_772_cov_5.536404	269	299	0	30	30	1.0000000
NODE_13153_length_772_cov_5.536404	272	341	0	68	69	0.9855072
NODE_13153_length_772_cov_5.536404	272	341	1	1	69	0.0144928
NODE_13156_length_772_cov_4.838039	430	510	0	80	80	1.0000000
NODE_13156_length_772_cov_4.838039	483	563	0	80	80	1.0000000
NODE_13162_length_772_cov_3.041605	339	419	0	33	80	0.4125000
NODE_13162_length_772_cov_3.041605	339	419	2	47	80	0.5875000
NODE_13162_length_772_cov_3.041605	392	472	0	31	80	0.3875000
NODE_13162_length_772_cov_3.041605	392	472	2	49	80	0.6125000
NODE_13195_length_771_cov_36.729167	223	304	0	81	81	1.0000000
NODE_13195_length_771_cov_36.729167	277	357	0	80	80	1.0000000
NODE_13195_length_771_cov_36.729167	353	434	0	81	81	1.0000000
NODE_13195_length_771_cov_36.729167	407	487	0	80	80	1.0000000
NODE_13196_length_771_cov_28.903274	337	417	2	9	80	0.1125000
NODE_13196_length_771_cov_28.903274	337	417	3	37	80	0.4625000
NODE_13196_length_771_cov_28.903274	337	417	5	34	80	0.4250000
NODE_13196_length_771_cov_28.903274	390	470	3	80	80	1.0000000
NODE_13197_length_771_cov_28.165179	453	533	0	80	80	1.0000000
NODE_13197_length_771_cov_28.165179	506	586	0	80	80	1.0000000
NODE_13198_length_771_cov_14.336310	259	339	0	80	80	1.0000000
NODE_13198_length_771_cov_14.336310	312	392	0	80	80	1.0000000
NODE_13199_length_771_cov_13.592262	428	508	0	80	80	1.0000000
NODE_13199_length_771_cov_13.592262	481	561	0	80	80	1.0000000
NODE_13200_length_771_cov_12.226190	407	487	0	61	80	0.7625000
NODE_13200_length_771_cov_12.226190	407	487	2	19	80	0.2375000
NODE_13200_length_771_cov_12.226190	460	540	0	8	80	0.1000000
NODE_13200_length_771_cov_12.226190	460	540	2	72	80	0.9000000
NODE_13201_length_771_cov_11.188988	348	428	0	80	80	1.0000000
NODE_13201_length_771_cov_11.188988	401	481	0	62	80	0.7750000
NODE_13201_length_771_cov_11.188988	401	481	2	18	80	0.2250000
NODE_13202_length_771_cov_10.525298	171	251	0	80	80	1.0000000
NODE_13202_length_771_cov_10.525298	224	304	0	80	80	1.0000000
NODE_13207_length_771_cov_3.357143	238	318	0	80	80	1.0000000
NODE_13207_length_771_cov_3.357143	291	371	0	71	80	0.8875000
NODE_13207_length_771_cov_3.357143	291	371	2	9	80	0.1125000
NODE_13209_length_771_cov_3.129464	476	518	0	42	42	1.0000000
NODE_13238_length_770_cov_45.312966	212	292	2	58	80	0.7250000
NODE_13238_length_770_cov_45.312966	212	292	4	18	80	0.2250000
NODE_13238_length_770_cov_45.312966	212	292	6	4	80	0.0500000
NODE_13238_length_770_cov_45.312966	265	345	0	33	80	0.4125000
NODE_13238_length_770_cov_45.312966	265	345	2	47	80	0.5875000
NODE_13239_length_770_cov_23.153502	348	428	0	6	80	0.0750000
NODE_13239_length_770_cov_23.153502	348	428	2	74	80	0.9250000
NODE_13239_length_770_cov_23.153502	401	481	0	59	80	0.7375000
NODE_13239_length_770_cov_23.153502	401	481	2	21	80	0.2625000
NODE_13240_length_770_cov_22.463487	340	420	0	80	80	1.0000000
NODE_13240_length_770_cov_22.463487	393	473	0	80	80	1.0000000
NODE_13241_length_770_cov_18.594635	335	416	0	81	81	1.0000000
NODE_13241_length_770_cov_18.594635	389	469	0	80	80	1.0000000
NODE_13242_length_770_cov_18.092399	292	372	0	16	80	0.2000000
NODE_13242_length_770_cov_18.092399	292	372	2	64	80	0.8000000
NODE_13242_length_770_cov_18.092399	345	425	0	45	80	0.5625000
NODE_13242_length_770_cov_18.092399	345	425	2	35	80	0.4375000
NODE_13243_length_770_cov_7.064083	294	374	0	80	80	1.0000000
NODE_13243_length_770_cov_7.064083	347	426	0	79	79	1.0000000
NODE_13246_length_770_cov_5.184799	341	421	0	80	80	1.0000000
NODE_13246_length_770_cov_5.184799	394	474	0	80	80	1.0000000
NODE_13250_length_770_cov_4.120715	325	405	0	80	80	1.0000000
NODE_13250_length_770_cov_4.120715	378	458	0	80	80	1.0000000
NODE_13272_length_769_cov_11.008955	355	435	4	9	80	0.1125000
NODE_13272_length_769_cov_11.008955	355	435	6	20	80	0.2500000
NODE_13272_length_769_cov_11.008955	355	435	8	19	80	0.2375000
NODE_13272_length_769_cov_11.008955	355	435	10	32	80	0.4000000
NODE_13272_length_769_cov_11.008955	408	488	6	4	80	0.0500000
NODE_13272_length_769_cov_11.008955	408	488	8	14	80	0.1750000
NODE_13272_length_769_cov_11.008955	408	488	10	62	80	0.7750000
NODE_13274_length_769_cov_9.077612	263	343	0	80	80	1.0000000
NODE_13274_length_769_cov_9.077612	316	396	0	80	80	1.0000000
NODE_13275_length_769_cov_7.034328	289	367	4	78	78	1.0000000
NODE_13275_length_769_cov_7.034328	340	420	4	80	80	1.0000000
NODE_13307_length_769_cov_1.262687	620	668	0	48	48	1.0000000
NODE_13316_length_768_cov_19.195815	266	346	0	80	80	1.0000000
NODE_13316_length_768_cov_19.195815	319	399	0	80	80	1.0000000
NODE_13316_length_768_cov_19.195815	395	475	0	80	80	1.0000000
NODE_13316_length_768_cov_19.195815	448	528	0	80	80	1.0000000
NODE_13317_length_768_cov_16.420030	246	326	0	14	80	0.1750000
NODE_13317_length_768_cov_16.420030	246	326	4	66	80	0.8250000
NODE_13317_length_768_cov_16.420030	299	379	0	19	80	0.2375000
NODE_13317_length_768_cov_16.420030	299	379	3	1	80	0.0125000
NODE_13317_length_768_cov_16.420030	299	379	4	60	80	0.7500000
NODE_13318_length_768_cov_14.508221	309	389	0	80	80	1.0000000
NODE_13318_length_768_cov_14.508221	362	442	0	80	80	1.0000000
NODE_13319_length_768_cov_11.635277	309	389	0	80	80	1.0000000
NODE_13319_length_768_cov_11.635277	362	442	0	80	80	1.0000000
NODE_13321_length_768_cov_9.064275	392	472	0	80	80	1.0000000
NODE_13321_length_768_cov_9.064275	445	525	0	80	80	1.0000000
NODE_13324_length_768_cov_3.605381	512	592	0	80	80	1.0000000
NODE_13324_length_768_cov_3.605381	565	645	0	80	80	1.0000000
NODE_13354_length_767_cov_38.161677	28	108	14	1	80	0.0125000
NODE_13354_length_767_cov_38.161677	28	108	20	2	80	0.0250000
NODE_13354_length_767_cov_38.161677	28	108	22	4	80	0.0500000
NODE_13354_length_767_cov_38.161677	28	108	24	7	80	0.0875000
NODE_13354_length_767_cov_38.161677	28	108	26	66	80	0.8250000
NODE_13354_length_767_cov_38.161677	254	334	0	80	80	1.0000000
NODE_13354_length_767_cov_38.161677	307	387	0	80	80	1.0000000
NODE_13355_length_767_cov_24.107784	279	359	0	80	80	1.0000000
NODE_13355_length_767_cov_24.107784	332	412	0	80	80	1.0000000
NODE_13356_length_767_cov_22.823353	286	366	0	39	80	0.4875000
NODE_13356_length_767_cov_22.823353	286	366	6	41	80	0.5125000
NODE_13356_length_767_cov_22.823353	339	419	6	80	80	1.0000000
NODE_13357_length_767_cov_20.898204	312	392	0	80	80	1.0000000
NODE_13357_length_767_cov_20.898204	365	445	0	30	80	0.3750000
NODE_13357_length_767_cov_20.898204	365	445	2	50	80	0.6250000
NODE_13358_length_767_cov_20.058383	357	439	0	82	82	1.0000000
NODE_13358_length_767_cov_20.058383	410	490	0	80	80	1.0000000
NODE_13359_length_767_cov_20.020958	191	271	0	35	80	0.4375000
NODE_13359_length_767_cov_20.020958	191	271	2	45	80	0.5625000
NODE_13359_length_767_cov_20.020958	244	324	0	25	80	0.3125000
NODE_13359_length_767_cov_20.020958	244	324	2	55	80	0.6875000
NODE_13360_length_767_cov_18.687126	270	350	0	78	80	0.9750000
NODE_13360_length_767_cov_18.687126	270	350	2	2	80	0.0250000
NODE_13360_length_767_cov_18.687126	323	403	0	80	80	1.0000000
NODE_13362_length_767_cov_13.323353	45	125	0	80	80	1.0000000
NODE_13362_length_767_cov_13.323353	98	178	0	80	80	1.0000000
NODE_13366_length_767_cov_8.787425	377	447	0	70	70	1.0000000
NODE_13366_length_767_cov_8.787425	420	500	0	67	80	0.8375000
NODE_13366_length_767_cov_8.787425	420	500	1	1	80	0.0125000
NODE_13366_length_767_cov_8.787425	420	500	2	12	80	0.1500000
NODE_13367_length_767_cov_7.206587	306	386	6	20	80	0.2500000
NODE_13367_length_767_cov_7.206587	306	386	8	60	80	0.7500000
NODE_13367_length_767_cov_7.206587	359	440	0	44	81	0.5432099
NODE_13367_length_767_cov_7.206587	359	440	6	30	81	0.3703704
NODE_13367_length_767_cov_7.206587	359	440	8	7	81	0.0864198
NODE_13403_length_766_cov_59.388306	322	402	0	9	80	0.1125000
NODE_13403_length_766_cov_59.388306	322	402	2	71	80	0.8875000
NODE_13403_length_766_cov_59.388306	375	455	0	62	80	0.7750000
NODE_13403_length_766_cov_59.388306	375	455	2	18	80	0.2250000
NODE_13403_length_766_cov_59.388306	451	531	0	80	80	1.0000000
NODE_13403_length_766_cov_59.388306	504	584	0	80	80	1.0000000
NODE_13404_length_766_cov_23.361319	308	388	4	3	80	0.0375000
NODE_13404_length_766_cov_23.361319	308	388	8	77	80	0.9625000
NODE_13404_length_766_cov_23.361319	361	441	0	17	80	0.2125000
NODE_13404_length_766_cov_23.361319	361	441	4	39	80	0.4875000
NODE_13404_length_766_cov_23.361319	361	441	8	24	80	0.3000000
NODE_13405_length_766_cov_22.751124	229	309	0	66	80	0.8250000
NODE_13405_length_766_cov_22.751124	229	309	3	7	80	0.0875000
NODE_13405_length_766_cov_22.751124	229	309	6	7	80	0.0875000
NODE_13405_length_766_cov_22.751124	282	362	0	80	80	1.0000000
NODE_13406_length_766_cov_20.011994	285	363	0	78	78	1.0000000
NODE_13406_length_766_cov_20.011994	336	416	0	80	80	1.0000000
NODE_13407_length_766_cov_18.685157	288	368	0	42	80	0.5250000
NODE_13407_length_766_cov_18.685157	288	368	21	1	80	0.0125000
NODE_13407_length_766_cov_18.685157	288	368	22	23	80	0.2875000
NODE_13407_length_766_cov_18.685157	288	368	24	2	80	0.0250000
NODE_13407_length_766_cov_18.685157	288	368	26	12	80	0.1500000
NODE_13407_length_766_cov_18.685157	341	421	22	13	80	0.1625000
NODE_13407_length_766_cov_18.685157	341	421	24	2	80	0.0250000
NODE_13407_length_766_cov_18.685157	341	421	25	53	80	0.6625000
NODE_13407_length_766_cov_18.685157	341	421	26	12	80	0.1500000
NODE_13408_length_766_cov_13.131934	271	351	0	80	80	1.0000000
NODE_13408_length_766_cov_13.131934	324	404	0	80	80	1.0000000
NODE_13410_length_766_cov_9.479760	274	354	0	80	80	1.0000000
NODE_13410_length_766_cov_9.479760	327	407	0	80	80	1.0000000
NODE_13415_length_766_cov_4.500750	333	413	2	9	80	0.1125000
NODE_13415_length_766_cov_4.500750	333	413	4	71	80	0.8875000
NODE_13415_length_766_cov_4.500750	369	404	4	35	35	1.0000000
NODE_13415_length_766_cov_4.500750	371	413	4	42	42	1.0000000
NODE_13415_length_766_cov_4.500750	397	466	0	14	69	0.2028985
NODE_13415_length_766_cov_4.500750	397	466	1	11	69	0.1594203
NODE_13415_length_766_cov_4.500750	397	466	2	28	69	0.4057971
NODE_13415_length_766_cov_4.500750	397	466	4	16	69	0.2318841
NODE_13447_length_765_cov_92.851351	16	96	4	9	80	0.1125000
NODE_13447_length_765_cov_92.851351	16	96	6	13	80	0.1625000
NODE_13447_length_765_cov_92.851351	16	96	14	6	80	0.0750000
NODE_13447_length_765_cov_92.851351	16	96	16	3	80	0.0375000
NODE_13447_length_765_cov_92.851351	16	96	18	7	80	0.0875000
NODE_13447_length_765_cov_92.851351	16	96	20	3	80	0.0375000
NODE_13447_length_765_cov_92.851351	16	96	22	3	80	0.0375000
NODE_13447_length_765_cov_92.851351	16	96	24	6	80	0.0750000
NODE_13447_length_765_cov_92.851351	16	96	26	5	80	0.0625000
NODE_13447_length_765_cov_92.851351	16	96	28	4	80	0.0500000
NODE_13447_length_765_cov_92.851351	16	96	30	21	80	0.2625000
NODE_13448_length_765_cov_36.345345	504	584	0	80	80	1.0000000
NODE_13448_length_765_cov_36.345345	557	637	0	31	80	0.3875000
NODE_13448_length_765_cov_36.345345	557	637	2	49	80	0.6125000
NODE_13449_length_765_cov_27.334835	370	450	0	23	80	0.2875000
NODE_13449_length_765_cov_27.334835	370	450	2	57	80	0.7125000
NODE_13449_length_765_cov_27.334835	423	503	0	76	80	0.9500000
NODE_13449_length_765_cov_27.334835	423	503	2	4	80	0.0500000
NODE_13450_length_765_cov_23.355856	251	331	0	80	80	1.0000000
NODE_13450_length_765_cov_23.355856	304	384	0	80	80	1.0000000
NODE_13450_length_765_cov_23.355856	380	460	0	80	80	1.0000000
NODE_13450_length_765_cov_23.355856	433	506	0	73	73	1.0000000
NODE_13451_length_765_cov_23.322823	256	336	0	80	80	1.0000000
NODE_13451_length_765_cov_23.322823	309	389	0	80	80	1.0000000
NODE_13452_length_765_cov_21.741742	379	452	0	73	73	1.0000000
NODE_13452_length_765_cov_21.741742	425	505	0	80	80	1.0000000
NODE_13453_length_765_cov_14.253754	450	530	0	9	80	0.1125000
NODE_13453_length_765_cov_14.253754	450	530	2	71	80	0.8875000
NODE_13453_length_765_cov_14.253754	503	583	0	37	80	0.4625000
NODE_13453_length_765_cov_14.253754	503	583	2	43	80	0.5375000
NODE_13454_length_765_cov_13.627628	313	393	0	9	80	0.1125000
NODE_13454_length_765_cov_13.627628	313	393	2	71	80	0.8875000
NODE_13454_length_765_cov_13.627628	366	446	0	62	80	0.7750000
NODE_13454_length_765_cov_13.627628	366	446	2	18	80	0.2250000
NODE_13455_length_765_cov_5.561562	319	349	0	30	30	1.0000000
NODE_13458_length_765_cov_4.367868	433	513	0	33	80	0.4125000
NODE_13458_length_765_cov_4.367868	433	513	4	47	80	0.5875000
NODE_13458_length_765_cov_4.367868	486	566	0	11	80	0.1375000
NODE_13458_length_765_cov_4.367868	486	566	4	69	80	0.8625000
NODE_13483_length_764_cov_30.096241	436	516	0	40	80	0.5000000
NODE_13483_length_764_cov_30.096241	436	516	2	40	80	0.5000000
NODE_13483_length_764_cov_30.096241	489	569	0	80	80	1.0000000
NODE_13484_length_764_cov_29.218045	304	384	0	1	80	0.0125000
NODE_13484_length_764_cov_29.218045	304	384	1	21	80	0.2625000
NODE_13484_length_764_cov_29.218045	304	384	2	58	80	0.7250000
NODE_13484_length_764_cov_29.218045	357	437	2	80	80	1.0000000
NODE_13485_length_764_cov_25.951880	421	501	0	80	80	1.0000000
NODE_13485_length_764_cov_25.951880	474	554	0	80	80	1.0000000
NODE_13486_length_764_cov_23.590977	204	284	0	45	80	0.5625000
NODE_13486_length_764_cov_23.590977	204	284	6	1	80	0.0125000
NODE_13486_length_764_cov_23.590977	204	284	7	34	80	0.4250000
NODE_13486_length_764_cov_23.590977	257	337	7	72	80	0.9000000
NODE_13486_length_764_cov_23.590977	257	337	8	8	80	0.1000000
NODE_13488_length_764_cov_6.804511	281	361	0	80	80	1.0000000
NODE_13488_length_764_cov_6.804511	334	414	0	80	80	1.0000000
NODE_13489_length_764_cov_6.700752	392	458	2	13	66	0.1969697
NODE_13489_length_764_cov_6.700752	392	458	6	5	66	0.0757576
NODE_13489_length_764_cov_6.700752	392	458	8	14	66	0.2121212
NODE_13489_length_764_cov_6.700752	392	458	12	34	66	0.5151515
NODE_13508_length_764_cov_1.171429	475	537	0	62	62	1.0000000
NODE_13520_length_763_cov_28.807229	311	391	0	80	80	1.0000000
NODE_13520_length_763_cov_28.807229	364	444	0	80	80	1.0000000
NODE_13521_length_763_cov_25.299699	598	673	0	22	75	0.2933333
NODE_13521_length_763_cov_25.299699	598	673	2	3	75	0.0400000
NODE_13521_length_763_cov_25.299699	598	673	4	14	75	0.1866667
NODE_13521_length_763_cov_25.299699	598	673	6	36	75	0.4800000
NODE_13521_length_763_cov_25.299699	598	678	0	22	80	0.2750000
NODE_13521_length_763_cov_25.299699	598	678	2	3	80	0.0375000
NODE_13521_length_763_cov_25.299699	598	678	4	14	80	0.1750000
NODE_13521_length_763_cov_25.299699	598	678	6	41	80	0.5125000
NODE_13521_length_763_cov_25.299699	605	675	0	15	70	0.2142857
NODE_13521_length_763_cov_25.299699	605	675	2	3	70	0.0428571
NODE_13521_length_763_cov_25.299699	605	675	4	14	70	0.2000000
NODE_13521_length_763_cov_25.299699	605	675	6	38	70	0.5428572
NODE_13521_length_763_cov_25.299699	607	678	0	13	71	0.1830986
NODE_13521_length_763_cov_25.299699	607	678	2	3	71	0.0422535
NODE_13521_length_763_cov_25.299699	607	678	4	14	71	0.1971831
NODE_13521_length_763_cov_25.299699	607	678	6	41	71	0.5774648
NODE_13521_length_763_cov_25.299699	651	731	0	26	80	0.3250000
NODE_13521_length_763_cov_25.299699	651	731	4	1	80	0.0125000
NODE_13521_length_763_cov_25.299699	651	731	5	16	80	0.2000000
NODE_13521_length_763_cov_25.299699	651	731	6	37	80	0.4625000
NODE_13521_length_763_cov_25.299699	651	731	0	26	80	0.3250000
NODE_13521_length_763_cov_25.299699	651	731	4	1	80	0.0125000
NODE_13521_length_763_cov_25.299699	651	731	5	16	80	0.2000000
NODE_13521_length_763_cov_25.299699	651	731	6	37	80	0.4625000
NODE_13521_length_763_cov_25.299699	651	731	0	26	80	0.3250000
NODE_13521_length_763_cov_25.299699	651	731	4	1	80	0.0125000
NODE_13521_length_763_cov_25.299699	651	731	5	16	80	0.2000000
NODE_13521_length_763_cov_25.299699	651	731	6	37	80	0.4625000
NODE_13521_length_763_cov_25.299699	651	731	0	26	80	0.3250000
NODE_13521_length_763_cov_25.299699	651	731	4	1	80	0.0125000
NODE_13521_length_763_cov_25.299699	651	731	5	16	80	0.2000000
NODE_13521_length_763_cov_25.299699	651	731	6	37	80	0.4625000
NODE_13522_length_763_cov_12.887048	336	416	0	80	80	1.0000000
NODE_13522_length_763_cov_12.887048	389	469	0	80	80	1.0000000
NODE_13523_length_763_cov_11.599398	547	627	0	15	80	0.1875000
NODE_13523_length_763_cov_11.599398	547	627	2	24	80	0.3000000
NODE_13523_length_763_cov_11.599398	547	627	4	41	80	0.5125000
NODE_13523_length_763_cov_11.599398	600	680	0	68	80	0.8500000
NODE_13523_length_763_cov_11.599398	600	680	2	12	80	0.1500000
NODE_13524_length_763_cov_9.378012	297	377	0	7	80	0.0875000
NODE_13524_length_763_cov_9.378012	297	377	2	73	80	0.9125000
NODE_13524_length_763_cov_9.378012	350	430	0	7	80	0.0875000
NODE_13524_length_763_cov_9.378012	350	430	2	73	80	0.9125000
NODE_13526_length_763_cov_7.246988	368	448	0	6	80	0.0750000
NODE_13526_length_763_cov_7.246988	368	448	2	74	80	0.9250000
NODE_13526_length_763_cov_7.246988	421	501	0	30	80	0.3750000
NODE_13526_length_763_cov_7.246988	421	501	2	50	80	0.6250000
NODE_13527_length_763_cov_6.414157	371	451	0	80	80	1.0000000
NODE_13527_length_763_cov_6.414157	424	504	0	80	80	1.0000000
NODE_13558_length_762_cov_21.236802	368	448	0	80	80	1.0000000
NODE_13558_length_762_cov_21.236802	421	501	0	80	80	1.0000000
NODE_13559_length_762_cov_19.984917	327	407	0	8	80	0.1000000
NODE_13559_length_762_cov_19.984917	327	407	17	72	80	0.9000000
NODE_13559_length_762_cov_19.984917	380	460	16	13	80	0.1625000
NODE_13559_length_762_cov_19.984917	380	460	17	48	80	0.6000000
NODE_13559_length_762_cov_19.984917	380	460	19	9	80	0.1125000
NODE_13559_length_762_cov_19.984917	380	460	20	1	80	0.0125000
NODE_13559_length_762_cov_19.984917	380	460	23	4	80	0.0500000
NODE_13559_length_762_cov_19.984917	380	460	24	3	80	0.0375000
NODE_13559_length_762_cov_19.984917	380	460	27	1	80	0.0125000
NODE_13559_length_762_cov_19.984917	380	460	34	1	80	0.0125000
NODE_13560_length_762_cov_15.975867	318	398	0	80	80	1.0000000
NODE_13560_length_762_cov_15.975867	371	439	0	68	68	1.0000000
NODE_13561_length_762_cov_12.728507	381	461	0	80	80	1.0000000
NODE_13561_length_762_cov_12.728507	434	514	0	80	80	1.0000000
NODE_13562_length_762_cov_10.078431	277	357	0	80	80	1.0000000
NODE_13562_length_762_cov_10.078431	330	410	0	80	80	1.0000000
NODE_13563_length_762_cov_9.705882	339	419	0	46	80	0.5750000
NODE_13563_length_762_cov_9.705882	339	419	2	34	80	0.4250000
NODE_13563_length_762_cov_9.705882	392	472	0	8	80	0.1000000
NODE_13563_length_762_cov_9.705882	392	472	1	1	80	0.0125000
NODE_13563_length_762_cov_9.705882	392	472	2	71	80	0.8875000
NODE_13564_length_762_cov_7.276018	316	395	0	79	79	1.0000000
NODE_13564_length_762_cov_7.276018	368	448	0	41	80	0.5125000
NODE_13564_length_762_cov_7.276018	368	448	2	39	80	0.4875000
NODE_13565_length_762_cov_6.168929	222	302	0	80	80	1.0000000
NODE_13565_length_762_cov_6.168929	275	355	0	80	80	1.0000000
NODE_13613_length_761_cov_44.243202	531	582	6	51	51	1.0000000
NODE_13614_length_761_cov_38.809668	342	422	0	80	80	1.0000000
NODE_13614_length_761_cov_38.809668	395	475	0	80	80	1.0000000
NODE_13615_length_761_cov_38.694864	314	394	0	14	80	0.1750000
NODE_13615_length_761_cov_38.694864	314	394	2	66	80	0.8250000
NODE_13615_length_761_cov_38.694864	367	447	0	67	80	0.8375000
NODE_13615_length_761_cov_38.694864	367	447	2	13	80	0.1625000
NODE_13616_length_761_cov_32.382175	432	512	0	15	80	0.1875000
NODE_13616_length_761_cov_32.382175	432	512	8	65	80	0.8125000
NODE_13616_length_761_cov_32.382175	485	565	0	42	80	0.5250000
NODE_13616_length_761_cov_32.382175	485	565	8	38	80	0.4750000
NODE_13617_length_761_cov_31.444109	323	403	0	23	80	0.2875000
NODE_13617_length_761_cov_31.444109	323	403	2	57	80	0.7125000
NODE_13617_length_761_cov_31.444109	376	467	0	43	91	0.4725275
NODE_13617_length_761_cov_31.444109	376	467	2	48	91	0.5274726
NODE_13618_length_761_cov_14.004532	366	446	5	1	80	0.0125000
NODE_13618_length_761_cov_14.004532	366	446	6	35	80	0.4375000
NODE_13618_length_761_cov_14.004532	366	446	10	44	80	0.5500000
NODE_13618_length_761_cov_14.004532	419	499	0	24	80	0.3000000
NODE_13618_length_761_cov_14.004532	419	499	4	27	80	0.3375000
NODE_13618_length_761_cov_14.004532	419	499	5	3	80	0.0375000
NODE_13618_length_761_cov_14.004532	419	499	6	20	80	0.2500000
NODE_13618_length_761_cov_14.004532	419	499	10	6	80	0.0750000
NODE_13619_length_761_cov_13.287009	336	415	0	79	79	1.0000000
NODE_13619_length_761_cov_13.287009	388	468	0	80	80	1.0000000
NODE_13621_length_761_cov_9.654079	274	354	0	28	80	0.3500000
NODE_13621_length_761_cov_9.654079	274	354	4	18	80	0.2250000
NODE_13621_length_761_cov_9.654079	274	354	6	10	80	0.1250000
NODE_13621_length_761_cov_9.654079	274	354	8	3	80	0.0375000
NODE_13621_length_761_cov_9.654079	274	354	12	21	80	0.2625000
NODE_13621_length_761_cov_9.654079	327	407	6	3	80	0.0375000
NODE_13621_length_761_cov_9.654079	327	407	8	27	80	0.3375000
NODE_13621_length_761_cov_9.654079	327	407	11	2	80	0.0250000
NODE_13621_length_761_cov_9.654079	327	407	12	48	80	0.6000000
NODE_13622_length_761_cov_7.306647	308	388	0	80	80	1.0000000
NODE_13622_length_761_cov_7.306647	361	441	0	80	80	1.0000000
NODE_13625_length_761_cov_4.314199	354	434	0	80	80	1.0000000
NODE_13625_length_761_cov_4.314199	407	487	0	80	80	1.0000000
NODE_13658_length_760_cov_48.290469	215	295	0	80	80	1.0000000
NODE_13658_length_760_cov_48.290469	268	348	0	80	80	1.0000000
NODE_13658_length_760_cov_48.290469	344	424	0	17	80	0.2125000
NODE_13658_length_760_cov_48.290469	344	424	2	63	80	0.7875000
NODE_13658_length_760_cov_48.290469	397	477	2	80	80	1.0000000
NODE_13659_length_760_cov_28.314675	384	464	0	68	80	0.8500000
NODE_13659_length_760_cov_28.314675	384	464	1	1	80	0.0125000
NODE_13659_length_760_cov_28.314675	384	464	8	11	80	0.1375000
NODE_13659_length_760_cov_28.314675	437	517	0	15	80	0.1875000
NODE_13659_length_760_cov_28.314675	437	517	1	1	80	0.0125000
NODE_13659_length_760_cov_28.314675	437	517	8	64	80	0.8000000
NODE_13660_length_760_cov_27.981846	432	512	0	2	80	0.0250000
NODE_13660_length_760_cov_27.981846	432	512	2	42	80	0.5250000
NODE_13660_length_760_cov_27.981846	432	512	16	5	80	0.0625000
NODE_13660_length_760_cov_27.981846	432	512	17	5	80	0.0625000
NODE_13660_length_760_cov_27.981846	432	512	18	26	80	0.3250000
NODE_13660_length_760_cov_27.981846	485	565	16	5	80	0.0625000
NODE_13660_length_760_cov_27.981846	485	565	17	45	80	0.5625000
NODE_13660_length_760_cov_27.981846	485	565	18	20	80	0.2500000
NODE_13660_length_760_cov_27.981846	485	565	19	10	80	0.1250000
NODE_13661_length_760_cov_17.500756	372	452	2	22	80	0.2750000
NODE_13661_length_760_cov_17.500756	372	452	4	6	80	0.0750000
NODE_13661_length_760_cov_17.500756	372	452	10	52	80	0.6500000
NODE_13661_length_760_cov_17.500756	425	505	0	24	80	0.3000000
NODE_13661_length_760_cov_17.500756	425	505	2	12	80	0.1500000
NODE_13661_length_760_cov_17.500756	425	505	4	15	80	0.1875000
NODE_13661_length_760_cov_17.500756	425	505	10	29	80	0.3625000
NODE_13662_length_760_cov_17.420575	183	263	0	80	80	1.0000000
NODE_13662_length_760_cov_17.420575	236	316	0	80	80	1.0000000
NODE_13663_length_760_cov_13.444781	357	437	0	80	80	1.0000000
NODE_13663_length_760_cov_13.444781	410	490	0	32	80	0.4000000
NODE_13663_length_760_cov_13.444781	410	490	4	48	80	0.6000000
NODE_13664_length_760_cov_13.196672	282	362	0	80	80	1.0000000
NODE_13664_length_760_cov_13.196672	335	415	0	80	80	1.0000000
NODE_13665_length_760_cov_12.692890	295	375	0	80	80	1.0000000
NODE_13665_length_760_cov_12.692890	348	428	0	80	80	1.0000000
NODE_13671_length_760_cov_4.282905	388	468	0	80	80	1.0000000
NODE_13671_length_760_cov_4.282905	441	521	0	80	80	1.0000000
NODE_13671_length_760_cov_4.282905	517	597	0	80	80	1.0000000
NODE_13683_length_760_cov_1.990923	490	570	0	7	80	0.0875000
NODE_13683_length_760_cov_1.990923	490	570	2	62	80	0.7750000
NODE_13683_length_760_cov_1.990923	490	570	4	11	80	0.1375000
NODE_13683_length_760_cov_1.990923	543	623	2	47	80	0.5875000
NODE_13683_length_760_cov_1.990923	543	623	4	33	80	0.4125000
NODE_13709_length_759_cov_24.757576	376	456	0	80	80	1.0000000
NODE_13709_length_759_cov_24.757576	429	509	0	41	80	0.5125000
NODE_13709_length_759_cov_24.757576	429	509	2	39	80	0.4875000
NODE_13710_length_759_cov_14.356061	210	290	0	80	80	1.0000000
NODE_13710_length_759_cov_14.356061	263	343	0	80	80	1.0000000
NODE_13711_length_759_cov_10.956061	328	408	0	80	80	1.0000000
NODE_13711_length_759_cov_10.956061	381	461	0	80	80	1.0000000
NODE_13712_length_759_cov_10.639394	330	410	0	80	80	1.0000000
NODE_13712_length_759_cov_10.639394	383	463	0	80	80	1.0000000
NODE_13713_length_759_cov_9.192424	209	290	28	3	81	0.0370370
NODE_13713_length_759_cov_9.192424	209	290	30	2	81	0.0246914
NODE_13713_length_759_cov_9.192424	209	290	32	2	81	0.0246914
NODE_13713_length_759_cov_9.192424	209	290	34	6	81	0.0740741
NODE_13713_length_759_cov_9.192424	209	290	36	2	81	0.0246914
NODE_13713_length_759_cov_9.192424	209	290	38	4	81	0.0493827
NODE_13713_length_759_cov_9.192424	209	290	40	2	81	0.0246914
NODE_13713_length_759_cov_9.192424	209	290	42	1	81	0.0123457
NODE_13713_length_759_cov_9.192424	209	290	44	2	81	0.0246914
NODE_13713_length_759_cov_9.192424	209	290	47	1	81	0.0123457
NODE_13713_length_759_cov_9.192424	209	290	50	1	81	0.0123457
NODE_13713_length_759_cov_9.192424	209	290	53	6	81	0.0740741
NODE_13713_length_759_cov_9.192424	209	290	55	5	81	0.0617284
NODE_13713_length_759_cov_9.192424	209	290	57	1	81	0.0123457
NODE_13713_length_759_cov_9.192424	209	290	59	1	81	0.0123457
NODE_13713_length_759_cov_9.192424	209	290	61	1	81	0.0123457
NODE_13713_length_759_cov_9.192424	209	290	62	4	81	0.0493827
NODE_13713_length_759_cov_9.192424	209	290	66	1	81	0.0123457
NODE_13713_length_759_cov_9.192424	209	290	68	1	81	0.0123457
NODE_13713_length_759_cov_9.192424	209	290	74	11	81	0.1358025
NODE_13713_length_759_cov_9.192424	209	290	76	4	81	0.0493827
NODE_13713_length_759_cov_9.192424	209	290	78	2	81	0.0246914
NODE_13713_length_759_cov_9.192424	209	290	80	4	81	0.0493827
NODE_13713_length_759_cov_9.192424	209	290	82	3	81	0.0370370
NODE_13713_length_759_cov_9.192424	209	290	84	7	81	0.0864198
NODE_13713_length_759_cov_9.192424	209	290	85	1	81	0.0123457
NODE_13713_length_759_cov_9.192424	209	290	86	3	81	0.0370370
NODE_13713_length_759_cov_9.192424	262	310	13	1	48	0.0208333
NODE_13713_length_759_cov_9.192424	262	310	15	5	48	0.1041667
NODE_13713_length_759_cov_9.192424	262	310	17	1	48	0.0208333
NODE_13713_length_759_cov_9.192424	262	310	18	4	48	0.0833333
NODE_13713_length_759_cov_9.192424	262	310	21	5	48	0.1041667
NODE_13713_length_759_cov_9.192424	262	310	22	1	48	0.0208333
NODE_13713_length_759_cov_9.192424	262	310	23	1	48	0.0208333
NODE_13713_length_759_cov_9.192424	262	310	28	5	48	0.1041667
NODE_13713_length_759_cov_9.192424	262	310	30	2	48	0.0416667
NODE_13713_length_759_cov_9.192424	262	310	32	2	48	0.0416667
NODE_13713_length_759_cov_9.192424	262	310	34	6	48	0.1250000
NODE_13713_length_759_cov_9.192424	262	310	36	2	48	0.0416667
NODE_13713_length_759_cov_9.192424	262	310	38	4	48	0.0833333
NODE_13713_length_759_cov_9.192424	262	310	40	2	48	0.0416667
NODE_13713_length_759_cov_9.192424	262	310	42	1	48	0.0208333
NODE_13713_length_759_cov_9.192424	262	310	44	2	48	0.0416667
NODE_13713_length_759_cov_9.192424	262	310	47	1	48	0.0208333
NODE_13713_length_759_cov_9.192424	262	310	50	1	48	0.0208333
NODE_13713_length_759_cov_9.192424	262	310	53	2	48	0.0416667
NODE_13714_length_759_cov_8.771212	292	372	0	80	80	1.0000000
NODE_13714_length_759_cov_8.771212	345	425	0	80	80	1.0000000
NODE_13715_length_759_cov_8.650000	324	404	0	80	80	1.0000000
NODE_13715_length_759_cov_8.650000	377	457	0	80	80	1.0000000
NODE_13716_length_759_cov_8.268182	604	684	0	80	80	1.0000000
NODE_13716_length_759_cov_8.268182	657	737	0	80	80	1.0000000
NODE_13717_length_759_cov_6.833333	381	461	0	43	80	0.5375000
NODE_13717_length_759_cov_6.833333	381	461	2	37	80	0.4625000
NODE_13717_length_759_cov_6.833333	434	515	0	20	81	0.2469136
NODE_13717_length_759_cov_6.833333	434	515	2	61	81	0.7530864
NODE_13718_length_759_cov_6.407576	319	399	2	74	80	0.9250000
NODE_13718_length_759_cov_6.407576	319	399	4	6	80	0.0750000
NODE_13718_length_759_cov_6.407576	372	452	2	74	80	0.9250000
NODE_13718_length_759_cov_6.407576	372	452	4	6	80	0.0750000
NODE_13725_length_759_cov_3.400000	355	435	0	78	80	0.9750000
NODE_13725_length_759_cov_3.400000	355	435	2	2	80	0.0250000
NODE_13725_length_759_cov_3.400000	408	488	0	80	80	1.0000000
NODE_13726_length_759_cov_3.346970	240	322	0	19	82	0.2317073
NODE_13726_length_759_cov_3.346970	240	322	2	63	82	0.7682927
NODE_13760_length_758_cov_38.414264	215	295	0	80	80	1.0000000
NODE_13760_length_758_cov_38.414264	268	348	0	80	80	1.0000000
NODE_13760_length_758_cov_38.414264	344	424	0	80	80	1.0000000
NODE_13760_length_758_cov_38.414264	397	477	0	80	80	1.0000000
NODE_13761_length_758_cov_36.722307	331	411	0	80	80	1.0000000
NODE_13761_length_758_cov_36.722307	384	464	0	80	80	1.0000000
NODE_13762_length_758_cov_29.910470	235	315	0	80	80	1.0000000
NODE_13762_length_758_cov_29.910470	288	368	0	50	80	0.6250000
NODE_13762_length_758_cov_29.910470	288	368	2	30	80	0.3750000
NODE_13763_length_758_cov_16.226100	386	466	0	80	80	1.0000000
NODE_13763_length_758_cov_16.226100	439	519	0	80	80	1.0000000
NODE_13764_length_758_cov_16.097117	311	391	0	80	80	1.0000000
NODE_13764_length_758_cov_16.097117	364	444	0	80	80	1.0000000
NODE_13765_length_758_cov_15.525038	260	340	0	80	80	1.0000000
NODE_13765_length_758_cov_15.525038	313	393	0	80	80	1.0000000
NODE_13768_length_758_cov_9.153263	224	299	0	75	75	1.0000000
NODE_13771_length_758_cov_4.241275	508	588	6	14	80	0.1750000
NODE_13771_length_758_cov_4.241275	508	588	8	5	80	0.0625000
NODE_13771_length_758_cov_4.241275	508	588	12	51	80	0.6375000
NODE_13771_length_758_cov_4.241275	508	588	13	2	80	0.0250000
NODE_13771_length_758_cov_4.241275	508	588	14	4	80	0.0500000
NODE_13771_length_758_cov_4.241275	508	588	17	4	80	0.0500000
NODE_13772_length_758_cov_3.902883	346	426	0	80	80	1.0000000
NODE_13772_length_758_cov_3.902883	399	479	0	80	80	1.0000000
NODE_13794_length_757_cov_49.057751	155	235	2	14	80	0.1750000
NODE_13794_length_757_cov_49.057751	155	235	4	66	80	0.8250000
NODE_13794_length_757_cov_49.057751	208	288	2	34	80	0.4250000
NODE_13794_length_757_cov_49.057751	208	288	4	22	80	0.2750000
NODE_13794_length_757_cov_49.057751	208	288	6	24	80	0.3000000
NODE_13795_length_757_cov_29.954407	181	262	0	81	81	1.0000000
NODE_13795_length_757_cov_29.954407	235	315	0	80	80	1.0000000
NODE_13795_length_757_cov_29.954407	311	391	0	80	80	1.0000000
NODE_13795_length_757_cov_29.954407	364	444	0	80	80	1.0000000
NODE_13796_length_757_cov_25.565350	352	432	0	51	80	0.6375000
NODE_13796_length_757_cov_25.565350	352	432	2	29	80	0.3625000
NODE_13796_length_757_cov_25.565350	405	483	0	78	78	1.0000000
NODE_13797_length_757_cov_18.338906	264	344	4	58	80	0.7250000
NODE_13797_length_757_cov_18.338906	264	344	6	22	80	0.2750000
NODE_13797_length_757_cov_18.338906	317	397	0	4	80	0.0500000
NODE_13797_length_757_cov_18.338906	317	397	2	47	80	0.5875000
NODE_13797_length_757_cov_18.338906	317	397	4	5	80	0.0625000
NODE_13797_length_757_cov_18.338906	317	397	6	24	80	0.3000000
NODE_13798_length_757_cov_15.879939	58	138	0	80	80	1.0000000
NODE_13798_length_757_cov_15.879939	111	191	0	80	80	1.0000000
NODE_13800_length_757_cov_15.291793	314	394	0	80	80	1.0000000
NODE_13800_length_757_cov_15.291793	367	447	0	69	80	0.8625000
NODE_13800_length_757_cov_15.291793	367	447	2	11	80	0.1375000
NODE_13807_length_757_cov_3.182371	423	503	0	80	80	1.0000000
NODE_13807_length_757_cov_3.182371	476	556	0	80	80	1.0000000
NODE_13832_length_756_cov_26.441400	287	367	4	24	80	0.3000000
NODE_13832_length_756_cov_26.441400	287	367	6	16	80	0.2000000
NODE_13832_length_756_cov_26.441400	287	367	8	40	80	0.5000000
NODE_13832_length_756_cov_26.441400	340	420	4	57	80	0.7125000
NODE_13832_length_756_cov_26.441400	340	420	6	16	80	0.2000000
NODE_13832_length_756_cov_26.441400	340	420	8	7	80	0.0875000
NODE_13834_length_756_cov_13.097412	154	234	0	80	80	1.0000000
NODE_13834_length_756_cov_13.097412	207	287	0	80	80	1.0000000
NODE_13835_length_756_cov_12.732116	377	457	0	15	80	0.1875000
NODE_13835_length_756_cov_12.732116	377	457	2	30	80	0.3750000
NODE_13835_length_756_cov_12.732116	377	457	4	35	80	0.4375000
NODE_13836_length_756_cov_9.254186	241	321	0	80	80	1.0000000
NODE_13836_length_756_cov_9.254186	294	374	0	80	80	1.0000000
NODE_13837_length_756_cov_8.304414	363	409	0	46	46	1.0000000
NODE_13838_length_756_cov_8.105023	271	351	0	73	80	0.9125000
NODE_13838_length_756_cov_8.105023	271	351	2	7	80	0.0875000
NODE_13838_length_756_cov_8.105023	324	404	0	80	80	1.0000000
NODE_13840_length_756_cov_6.622527	431	511	0	80	80	1.0000000
NODE_13840_length_756_cov_6.622527	484	565	0	81	81	1.0000000
NODE_13888_length_755_cov_64.705793	303	383	0	35	80	0.4375000
NODE_13888_length_755_cov_64.705793	303	383	2	45	80	0.5625000
NODE_13888_length_755_cov_64.705793	356	436	0	5	80	0.0625000
NODE_13888_length_755_cov_64.705793	356	436	2	75	80	0.9375000
NODE_13889_length_755_cov_58.214939	425	505	0	28	80	0.3500000
NODE_13889_length_755_cov_58.214939	425	505	2	7	80	0.0875000
NODE_13889_length_755_cov_58.214939	425	505	4	45	80	0.5625000
NODE_13889_length_755_cov_58.214939	425	505	0	28	80	0.3500000
NODE_13889_length_755_cov_58.214939	425	505	2	7	80	0.0875000
NODE_13889_length_755_cov_58.214939	425	505	4	45	80	0.5625000
NODE_13889_length_755_cov_58.214939	478	556	0	78	78	1.0000000
NODE_13889_length_755_cov_58.214939	478	556	0	78	78	1.0000000
NODE_13890_length_755_cov_25.945122	237	317	0	42	80	0.5250000
NODE_13890_length_755_cov_25.945122	237	317	2	38	80	0.4750000
NODE_13890_length_755_cov_25.945122	290	370	0	29	80	0.3625000
NODE_13890_length_755_cov_25.945122	290	370	2	51	80	0.6375000
NODE_13891_length_755_cov_24.263720	334	414	0	24	80	0.3000000
NODE_13891_length_755_cov_24.263720	334	414	4	56	80	0.7000000
NODE_13891_length_755_cov_24.263720	387	467	0	77	80	0.9625000
NODE_13891_length_755_cov_24.263720	387	467	4	3	80	0.0375000
NODE_13892_length_755_cov_15.559451	306	386	0	80	80	1.0000000
NODE_13892_length_755_cov_15.559451	359	439	0	80	80	1.0000000
NODE_13894_length_755_cov_10.196646	332	412	1	11	80	0.1375000
NODE_13894_length_755_cov_10.196646	332	412	2	33	80	0.4125000
NODE_13894_length_755_cov_10.196646	332	412	4	36	80	0.4500000
NODE_13894_length_755_cov_10.196646	385	465	0	1	80	0.0125000
NODE_13894_length_755_cov_10.196646	385	465	1	63	80	0.7875000
NODE_13894_length_755_cov_10.196646	385	465	2	16	80	0.2000000
NODE_13895_length_755_cov_9.772866	210	290	0	80	80	1.0000000
NODE_13895_length_755_cov_9.772866	263	343	0	80	80	1.0000000
NODE_13936_length_754_cov_87.432061	208	288	0	80	80	1.0000000
NODE_13936_length_754_cov_87.432061	261	341	0	80	80	1.0000000
NODE_13937_length_754_cov_16.549618	156	236	0	80	80	1.0000000
NODE_13937_length_754_cov_16.549618	209	289	0	80	80	1.0000000
NODE_13939_length_754_cov_9.068702	316	396	0	10	80	0.1250000
NODE_13939_length_754_cov_9.068702	316	396	2	70	80	0.8750000
NODE_13939_length_754_cov_9.068702	369	449	0	3	80	0.0375000
NODE_13939_length_754_cov_9.068702	369	449	2	77	80	0.9625000
NODE_13940_length_754_cov_5.925191	287	367	2	15	80	0.1875000
NODE_13940_length_754_cov_5.925191	287	367	4	27	80	0.3375000
NODE_13940_length_754_cov_5.925191	287	367	6	38	80	0.4750000
NODE_13940_length_754_cov_5.925191	340	420	0	18	80	0.2250000
NODE_13940_length_754_cov_5.925191	340	420	2	50	80	0.6250000
NODE_13940_length_754_cov_5.925191	340	420	4	6	80	0.0750000
NODE_13940_length_754_cov_5.925191	340	420	6	6	80	0.0750000
NODE_13974_length_753_cov_10.434251	386	466	2	80	80	1.0000000
NODE_13974_length_753_cov_10.434251	439	519	0	48	80	0.6000000
NODE_13974_length_753_cov_10.434251	439	519	2	32	80	0.4000000
NODE_13976_length_753_cov_7.056575	344	424	0	54	80	0.6750000
NODE_13976_length_753_cov_7.056575	344	424	2	26	80	0.3250000
NODE_13976_length_753_cov_7.056575	397	477	0	1	80	0.0125000
NODE_13976_length_753_cov_7.056575	397	477	2	79	80	0.9875000
NODE_13977_length_753_cov_4.597859	321	401	0	39	80	0.4875000
NODE_13977_length_753_cov_4.597859	321	401	2	41	80	0.5125000
NODE_13977_length_753_cov_4.597859	374	454	0	17	80	0.2125000
NODE_13977_length_753_cov_4.597859	374	454	2	63	80	0.7875000
NODE_14003_length_752_cov_66.281776	617	697	2	24	80	0.3000000
NODE_14003_length_752_cov_66.281776	617	697	6	3	80	0.0375000
NODE_14003_length_752_cov_66.281776	617	697	8	1	80	0.0125000
NODE_14003_length_752_cov_66.281776	617	697	10	52	80	0.6500000
NODE_14003_length_752_cov_66.281776	670	751	0	52	81	0.6419753
NODE_14003_length_752_cov_66.281776	670	751	2	26	81	0.3209876
NODE_14003_length_752_cov_66.281776	670	751	6	3	81	0.0370370
NODE_14004_length_752_cov_60.274119	193	273	0	75	80	0.9375000
NODE_14004_length_752_cov_60.274119	193	273	2	5	80	0.0625000
NODE_14004_length_752_cov_60.274119	246	326	0	22	80	0.2750000
NODE_14004_length_752_cov_60.274119	246	326	2	58	80	0.7250000
NODE_14005_length_752_cov_19.811639	299	379	0	80	80	1.0000000
NODE_14005_length_752_cov_19.811639	352	432	0	80	80	1.0000000
NODE_14006_length_752_cov_17.661562	118	198	4	80	80	1.0000000
NODE_14006_length_752_cov_17.661562	171	251	0	45	80	0.5625000
NODE_14006_length_752_cov_17.661562	171	251	4	35	80	0.4375000
NODE_14007_length_752_cov_13.275651	241	321	2	4	80	0.0500000
NODE_14007_length_752_cov_13.275651	241	321	4	35	80	0.4375000
NODE_14007_length_752_cov_13.275651	241	321	5	5	80	0.0625000
NODE_14007_length_752_cov_13.275651	241	321	6	36	80	0.4500000
NODE_14007_length_752_cov_13.275651	294	374	2	15	80	0.1875000
NODE_14007_length_752_cov_13.275651	294	374	4	9	80	0.1125000
NODE_14007_length_752_cov_13.275651	294	374	5	18	80	0.2250000
NODE_14007_length_752_cov_13.275651	294	374	6	25	80	0.3125000
NODE_14007_length_752_cov_13.275651	294	374	7	13	80	0.1625000
NODE_14008_length_752_cov_10.928025	313	393	0	19	80	0.2375000
NODE_14008_length_752_cov_10.928025	313	393	1	13	80	0.1625000
NODE_14008_length_752_cov_10.928025	313	393	2	3	80	0.0375000
NODE_14008_length_752_cov_10.928025	313	393	4	12	80	0.1500000
NODE_14008_length_752_cov_10.928025	313	393	6	33	80	0.4125000
NODE_14011_length_752_cov_9.558959	249	329	0	31	80	0.3875000
NODE_14011_length_752_cov_9.558959	249	329	4	49	80	0.6125000
NODE_14011_length_752_cov_9.558959	302	382	0	21	80	0.2625000
NODE_14011_length_752_cov_9.558959	302	382	4	59	80	0.7375000
NODE_14014_length_752_cov_8.281776	237	317	0	80	80	1.0000000
NODE_14014_length_752_cov_8.281776	290	370	0	80	80	1.0000000
NODE_14015_length_752_cov_8.082695	352	432	0	80	80	1.0000000
NODE_14015_length_752_cov_8.082695	405	485	0	80	80	1.0000000
NODE_14044_length_751_cov_20.730061	238	318	0	80	80	1.0000000
NODE_14044_length_751_cov_20.730061	291	371	0	80	80	1.0000000
NODE_14045_length_751_cov_18.478528	328	409	0	81	81	1.0000000
NODE_14045_length_751_cov_18.478528	382	462	0	40	80	0.5000000
NODE_14045_length_751_cov_18.478528	382	462	2	40	80	0.5000000
NODE_14046_length_751_cov_13.016871	172	252	2	80	80	1.0000000
NODE_14046_length_751_cov_13.016871	225	305	0	18	80	0.2250000
NODE_14046_length_751_cov_13.016871	225	305	1	16	80	0.2000000
NODE_14046_length_751_cov_13.016871	225	305	2	46	80	0.5750000
NODE_14047_length_751_cov_12.363497	397	477	0	80	80	1.0000000
NODE_14047_length_751_cov_12.363497	450	530	0	80	80	1.0000000
NODE_14085_length_750_cov_46.371736	396	476	11	31	80	0.3875000
NODE_14085_length_750_cov_46.371736	396	476	22	49	80	0.6125000
NODE_14085_length_750_cov_46.371736	449	529	22	80	80	1.0000000
NODE_14086_length_750_cov_24.428571	524	604	4	1	80	0.0125000
NODE_14086_length_750_cov_24.428571	524	604	12	1	80	0.0125000
NODE_14086_length_750_cov_24.428571	524	604	14	1	80	0.0125000
NODE_14086_length_750_cov_24.428571	524	604	16	1	80	0.0125000
NODE_14086_length_750_cov_24.428571	524	604	22	2	80	0.0250000
NODE_14086_length_750_cov_24.428571	524	604	26	11	80	0.1375000
NODE_14086_length_750_cov_24.428571	524	604	28	1	80	0.0125000
NODE_14086_length_750_cov_24.428571	524	604	32	4	80	0.0500000
NODE_14086_length_750_cov_24.428571	524	604	38	1	80	0.0125000
NODE_14086_length_750_cov_24.428571	524	604	44	6	80	0.0750000
NODE_14086_length_750_cov_24.428571	524	604	46	4	80	0.0500000
NODE_14086_length_750_cov_24.428571	524	604	48	8	80	0.1000000
NODE_14086_length_750_cov_24.428571	524	604	50	7	80	0.0875000
NODE_14086_length_750_cov_24.428571	524	604	52	1	80	0.0125000
NODE_14086_length_750_cov_24.428571	524	604	54	18	80	0.2250000
NODE_14086_length_750_cov_24.428571	524	604	60	3	80	0.0375000
NODE_14086_length_750_cov_24.428571	524	604	62	6	80	0.0750000
NODE_14086_length_750_cov_24.428571	524	604	64	4	80	0.0500000
NODE_14086_length_750_cov_24.428571	683	746	0	63	63	1.0000000
NODE_14087_length_750_cov_24.311828	325	405	8	6	80	0.0750000
NODE_14087_length_750_cov_24.311828	325	405	10	15	80	0.1875000
NODE_14087_length_750_cov_24.311828	325	405	12	31	80	0.3875000
NODE_14087_length_750_cov_24.311828	325	405	14	28	80	0.3500000
NODE_14087_length_750_cov_24.311828	378	458	10	1	80	0.0125000
NODE_14087_length_750_cov_24.311828	378	458	14	51	80	0.6375000
NODE_14087_length_750_cov_24.311828	378	458	16	28	80	0.3500000
NODE_14089_length_750_cov_8.529954	336	416	0	80	80	1.0000000
NODE_14089_length_750_cov_8.529954	395	469	0	74	74	1.0000000
NODE_14137_length_749_cov_18.986154	221	301	0	80	80	1.0000000
NODE_14137_length_749_cov_18.986154	274	354	0	80	80	1.0000000
NODE_14138_length_749_cov_18.836923	273	355	0	82	82	1.0000000
NODE_14138_length_749_cov_18.836923	328	408	0	80	80	1.0000000
NODE_14138_length_749_cov_18.836923	404	484	0	80	80	1.0000000
NODE_14138_length_749_cov_18.836923	457	535	0	78	78	1.0000000
NODE_14139_length_749_cov_16.160000	232	253	0	21	21	1.0000000
NODE_14139_length_749_cov_16.160000	232	306	0	74	74	1.0000000
NODE_14140_length_749_cov_16.115385	307	387	0	80	80	1.0000000
NODE_14140_length_749_cov_16.115385	360	440	0	80	80	1.0000000
NODE_14141_length_749_cov_11.210769	340	420	0	48	80	0.6000000
NODE_14141_length_749_cov_11.210769	340	420	4	32	80	0.4000000
NODE_14141_length_749_cov_11.210769	393	473	4	80	80	1.0000000
NODE_14142_length_749_cov_8.424615	372	452	0	7	80	0.0875000
NODE_14142_length_749_cov_8.424615	372	452	2	73	80	0.9125000
NODE_14142_length_749_cov_8.424615	425	505	0	28	80	0.3500000
NODE_14142_length_749_cov_8.424615	425	505	2	52	80	0.6500000
NODE_14145_length_749_cov_4.521538	550	630	0	80	80	1.0000000
NODE_14145_length_749_cov_4.521538	603	683	0	80	80	1.0000000
NODE_14185_length_748_cov_55.348228	393	473	0	80	80	1.0000000
NODE_14185_length_748_cov_55.348228	446	526	0	80	80	1.0000000
NODE_14186_length_748_cov_51.838213	369	449	0	60	80	0.7500000
NODE_14186_length_748_cov_51.838213	369	449	8	20	80	0.2500000
NODE_14186_length_748_cov_51.838213	422	502	0	7	80	0.0875000
NODE_14186_length_748_cov_51.838213	422	502	8	60	80	0.7500000
NODE_14186_length_748_cov_51.838213	422	502	9	13	80	0.1625000
NODE_14187_length_748_cov_46.952234	293	373	0	8	80	0.1000000
NODE_14187_length_748_cov_46.952234	293	373	11	1	80	0.0125000
NODE_14187_length_748_cov_46.952234	293	373	12	1	80	0.0125000
NODE_14187_length_748_cov_46.952234	293	373	13	47	80	0.5875000
NODE_14187_length_748_cov_46.952234	293	373	14	23	80	0.2875000
NODE_14187_length_748_cov_46.952234	346	426	0	13	80	0.1625000
NODE_14187_length_748_cov_46.952234	346	426	13	4	80	0.0500000
NODE_14187_length_748_cov_46.952234	346	426	14	63	80	0.7875000
NODE_14188_length_748_cov_45.001541	272	352	0	20	80	0.2500000
NODE_14188_length_748_cov_45.001541	272	352	2	15	80	0.1875000
NODE_14188_length_748_cov_45.001541	272	352	10	45	80	0.5625000
NODE_14188_length_748_cov_45.001541	325	405	8	19	80	0.2375000
NODE_14188_length_748_cov_45.001541	325	405	10	61	80	0.7625000
NODE_14189_length_748_cov_34.355932	488	568	0	12	80	0.1500000
NODE_14189_length_748_cov_34.355932	488	568	2	68	80	0.8500000
NODE_14189_length_748_cov_34.355932	541	621	0	52	80	0.6500000
NODE_14189_length_748_cov_34.355932	541	621	2	28	80	0.3500000
NODE_14190_length_748_cov_25.972265	297	377	2	50	80	0.6250000
NODE_14190_length_748_cov_25.972265	297	377	3	26	80	0.3250000
NODE_14190_length_748_cov_25.972265	297	377	4	4	80	0.0500000
NODE_14190_length_748_cov_25.972265	350	430	2	72	80	0.9000000
NODE_14190_length_748_cov_25.972265	350	430	3	4	80	0.0500000
NODE_14190_length_748_cov_25.972265	350	430	4	4	80	0.0500000
NODE_14191_length_748_cov_21.050847	362	442	0	80	80	1.0000000
NODE_14191_length_748_cov_21.050847	415	495	0	80	80	1.0000000
NODE_14192_length_748_cov_20.682589	353	433	0	80	80	1.0000000
NODE_14192_length_748_cov_20.682589	406	486	0	80	80	1.0000000
NODE_14193_length_748_cov_19.081664	261	341	0	80	80	1.0000000
NODE_14193_length_748_cov_19.081664	314	394	0	80	80	1.0000000
NODE_14193_length_748_cov_19.081664	390	470	0	80	80	1.0000000
NODE_14193_length_748_cov_19.081664	443	522	0	79	79	1.0000000
NODE_14194_length_748_cov_16.579353	81	161	4	80	80	1.0000000
NODE_14194_length_748_cov_16.579353	134	214	0	13	80	0.1625000
NODE_14194_length_748_cov_16.579353	134	214	4	67	80	0.8375000
NODE_14194_length_748_cov_16.579353	210	290	0	80	80	1.0000000
NODE_14194_length_748_cov_16.579353	263	343	0	80	80	1.0000000
NODE_14196_length_748_cov_11.983051	375	455	0	80	80	1.0000000
NODE_14196_length_748_cov_11.983051	428	508	0	80	80	1.0000000
NODE_14197_length_748_cov_11.474576	257	337	0	80	80	1.0000000
NODE_14197_length_748_cov_11.474576	310	390	0	80	80	1.0000000
NODE_14200_length_748_cov_7.979969	223	303	0	80	80	1.0000000
NODE_14200_length_748_cov_7.979969	276	356	0	80	80	1.0000000
NODE_14240_length_747_cov_24.279321	205	285	0	80	80	1.0000000
NODE_14240_length_747_cov_24.279321	258	338	0	32	80	0.4000000
NODE_14240_length_747_cov_24.279321	258	338	6	48	80	0.6000000
NODE_14241_length_747_cov_15.438272	352	432	0	37	80	0.4625000
NODE_14241_length_747_cov_15.438272	352	432	2	43	80	0.5375000
NODE_14241_length_747_cov_15.438272	405	485	0	80	80	1.0000000
NODE_14244_length_747_cov_7.979938	237	317	0	80	80	1.0000000
NODE_14244_length_747_cov_7.979938	290	370	0	80	80	1.0000000
NODE_14248_length_747_cov_4.918210	157	237	0	8	80	0.1000000
NODE_14248_length_747_cov_4.918210	157	237	2	72	80	0.9000000
NODE_14248_length_747_cov_4.918210	210	290	0	34	80	0.4250000
NODE_14248_length_747_cov_4.918210	210	290	2	46	80	0.5750000
NODE_14277_length_746_cov_44.041731	153	233	0	28	80	0.3500000
NODE_14277_length_746_cov_44.041731	153	233	2	52	80	0.6500000
NODE_14277_length_746_cov_44.041731	206	286	0	80	80	1.0000000
NODE_14278_length_746_cov_24.435858	334	414	0	16	80	0.2000000
NODE_14278_length_746_cov_24.435858	334	414	2	64	80	0.8000000
NODE_14278_length_746_cov_24.435858	387	467	0	37	80	0.4625000
NODE_14278_length_746_cov_24.435858	387	467	2	43	80	0.5375000
NODE_14279_length_746_cov_20.225657	114	194	0	80	80	1.0000000
NODE_14279_length_746_cov_20.225657	167	247	0	80	80	1.0000000
NODE_14280_length_746_cov_17.919629	330	410	0	80	80	1.0000000
NODE_14280_length_746_cov_17.919629	383	463	0	80	80	1.0000000
NODE_14281_length_746_cov_17.523957	292	372	0	80	80	1.0000000
NODE_14281_length_746_cov_17.523957	345	425	0	80	80	1.0000000
NODE_14282_length_746_cov_17.214838	306	386	0	80	80	1.0000000
NODE_14282_length_746_cov_17.214838	359	439	0	80	80	1.0000000
NODE_14283_length_746_cov_16.765070	344	424	0	80	80	1.0000000
NODE_14283_length_746_cov_16.765070	397	477	0	80	80	1.0000000
NODE_14284_length_746_cov_13.153014	126	206	0	15	80	0.1875000
NODE_14284_length_746_cov_13.153014	126	206	2	65	80	0.8125000
NODE_14284_length_746_cov_13.153014	179	259	0	68	80	0.8500000
NODE_14284_length_746_cov_13.153014	179	259	2	12	80	0.1500000
NODE_14284_length_746_cov_13.153014	244	263	0	19	19	1.0000000
NODE_14285_length_746_cov_12.316847	364	442	0	78	78	1.0000000
NODE_14286_length_746_cov_11.301391	349	429	0	80	80	1.0000000
NODE_14286_length_746_cov_11.301391	402	482	0	80	80	1.0000000
NODE_14302_length_746_cov_2.639876	331	411	9	20	80	0.2500000
NODE_14302_length_746_cov_2.639876	331	411	11	10	80	0.1250000
NODE_14302_length_746_cov_2.639876	331	411	12	37	80	0.4625000
NODE_14302_length_746_cov_2.639876	331	411	13	13	80	0.1625000
NODE_14307_length_746_cov_1.879444	435	502	0	67	67	1.0000000
NODE_14310_length_746_cov_1.727975	65	121	0	56	56	1.0000000
NODE_14310_length_746_cov_1.727975	494	540	0	46	46	1.0000000
NODE_14329_length_745_cov_40.360681	257	337	0	51	80	0.6375000
NODE_14329_length_745_cov_40.360681	257	337	2	29	80	0.3625000
NODE_14329_length_745_cov_40.360681	310	390	2	55	80	0.6875000
NODE_14329_length_745_cov_40.360681	310	390	4	25	80	0.3125000
NODE_14330_length_745_cov_30.817337	339	419	0	80	80	1.0000000
NODE_14330_length_745_cov_30.817337	392	459	0	67	67	1.0000000
NODE_14335_length_745_cov_8.620743	225	275	0	50	50	1.0000000
NODE_14335_length_745_cov_8.620743	248	328	0	80	80	1.0000000
NODE_14343_length_745_cov_3.922601	249	280	63	1	31	0.0322581
NODE_14343_length_745_cov_3.922601	249	280	65	2	31	0.0645161
NODE_14343_length_745_cov_3.922601	249	280	68	4	31	0.1290323
NODE_14343_length_745_cov_3.922601	249	280	71	1	31	0.0322581
NODE_14343_length_745_cov_3.922601	249	280	72	7	31	0.2258064
NODE_14343_length_745_cov_3.922601	249	280	74	7	31	0.2258064
NODE_14343_length_745_cov_3.922601	249	280	75	6	31	0.1935484
NODE_14343_length_745_cov_3.922601	249	280	76	3	31	0.0967742
NODE_14343_length_745_cov_3.922601	253	333	51	4	80	0.0500000
NODE_14343_length_745_cov_3.922601	253	333	52	3	80	0.0375000
NODE_14343_length_745_cov_3.922601	253	333	53	4	80	0.0500000
NODE_14343_length_745_cov_3.922601	253	333	55	2	80	0.0250000
NODE_14343_length_745_cov_3.922601	253	333	59	7	80	0.0875000
NODE_14343_length_745_cov_3.922601	253	333	61	2	80	0.0250000
NODE_14343_length_745_cov_3.922601	253	333	63	1	80	0.0125000
NODE_14343_length_745_cov_3.922601	253	333	65	2	80	0.0250000
NODE_14343_length_745_cov_3.922601	253	333	67	4	80	0.0500000
NODE_14343_length_745_cov_3.922601	253	333	68	4	80	0.0500000
NODE_14343_length_745_cov_3.922601	253	333	69	11	80	0.1375000
NODE_14343_length_745_cov_3.922601	253	333	72	7	80	0.0875000
NODE_14343_length_745_cov_3.922601	253	333	74	14	80	0.1750000
NODE_14343_length_745_cov_3.922601	253	333	75	6	80	0.0750000
NODE_14343_length_745_cov_3.922601	253	333	76	9	80	0.1125000
NODE_14381_length_744_cov_44.953488	553	633	0	58	80	0.7250000
NODE_14381_length_744_cov_44.953488	553	633	2	22	80	0.2750000
NODE_14381_length_744_cov_44.953488	553	633	0	58	80	0.7250000
NODE_14381_length_744_cov_44.953488	553	633	2	22	80	0.2750000
NODE_14381_length_744_cov_44.953488	553	633	0	58	80	0.7250000
NODE_14381_length_744_cov_44.953488	553	633	2	22	80	0.2750000
NODE_14381_length_744_cov_44.953488	553	633	0	58	80	0.7250000
NODE_14381_length_744_cov_44.953488	553	633	2	22	80	0.2750000
NODE_14382_length_744_cov_35.333333	163	243	0	13	80	0.1625000
NODE_14382_length_744_cov_35.333333	163	243	2	67	80	0.8375000
NODE_14382_length_744_cov_35.333333	216	296	0	54	80	0.6750000
NODE_14382_length_744_cov_35.333333	216	296	2	26	80	0.3250000
NODE_14382_length_744_cov_35.333333	292	372	2	21	80	0.2625000
NODE_14382_length_744_cov_35.333333	292	372	3	7	80	0.0875000
NODE_14382_length_744_cov_35.333333	292	372	4	52	80	0.6500000
NODE_14382_length_744_cov_35.333333	345	425	2	52	80	0.6500000
NODE_14382_length_744_cov_35.333333	345	425	3	7	80	0.0875000
NODE_14382_length_744_cov_35.333333	345	425	4	21	80	0.2625000
NODE_14383_length_744_cov_34.503876	294	374	0	29	80	0.3625000
NODE_14383_length_744_cov_34.503876	294	374	2	17	80	0.2125000
NODE_14383_length_744_cov_34.503876	294	374	4	34	80	0.4250000
NODE_14383_length_744_cov_34.503876	347	427	0	80	80	1.0000000
NODE_14384_length_744_cov_32.282171	333	403	0	49	70	0.7000000
NODE_14384_length_744_cov_32.282171	333	403	2	21	70	0.3000000
NODE_14384_length_744_cov_32.282171	440	520	0	80	80	1.0000000
NODE_14384_length_744_cov_32.282171	493	573	0	80	80	1.0000000
NODE_14390_length_744_cov_4.537984	260	340	0	58	80	0.7250000
NODE_14390_length_744_cov_4.537984	260	340	2	22	80	0.2750000
NODE_14390_length_744_cov_4.537984	313	393	0	5	80	0.0625000
NODE_14390_length_744_cov_4.537984	313	393	2	75	80	0.9375000
NODE_14396_length_744_cov_2.784496	335	387	2	5	52	0.0961538
NODE_14396_length_744_cov_2.784496	335	387	8	3	52	0.0576923
NODE_14396_length_744_cov_2.784496	335	387	9	27	52	0.5192308
NODE_14396_length_744_cov_2.784496	335	387	10	10	52	0.1923077
NODE_14396_length_744_cov_2.784496	335	387	14	7	52	0.1346154
NODE_14396_length_744_cov_2.784496	360	437	8	29	77	0.3766234
NODE_14396_length_744_cov_2.784496	360	437	9	10	77	0.1298701
NODE_14396_length_744_cov_2.784496	360	437	10	10	77	0.1298701
NODE_14396_length_744_cov_2.784496	360	437	12	13	77	0.1688312
NODE_14396_length_744_cov_2.784496	360	437	14	15	77	0.1948052
NODE_14427_length_743_cov_26.369565	354	434	0	80	80	1.0000000
NODE_14427_length_743_cov_26.369565	407	487	0	80	80	1.0000000
NODE_14428_length_743_cov_21.759317	138	218	0	53	80	0.6625000
NODE_14428_length_743_cov_21.759317	138	218	4	27	80	0.3375000
NODE_14428_length_743_cov_21.759317	191	271	4	35	80	0.4375000
NODE_14428_length_743_cov_21.759317	191	271	6	45	80	0.5625000
NODE_14429_length_743_cov_18.173913	213	293	0	80	80	1.0000000
NODE_14429_length_743_cov_18.173913	266	346	0	80	80	1.0000000
NODE_14431_length_743_cov_17.066770	400	480	0	80	80	1.0000000
NODE_14431_length_743_cov_17.066770	453	532	0	79	79	1.0000000
NODE_14432_length_743_cov_16.354037	350	430	0	11	80	0.1375000
NODE_14432_length_743_cov_16.354037	350	430	2	69	80	0.8625000
NODE_14432_length_743_cov_16.354037	403	483	0	64	80	0.8000000
NODE_14432_length_743_cov_16.354037	403	483	2	16	80	0.2000000
NODE_14433_length_743_cov_15.667702	220	300	0	40	80	0.5000000
NODE_14433_length_743_cov_15.667702	220	300	2	40	80	0.5000000
NODE_14433_length_743_cov_15.667702	273	353	0	16	80	0.2000000
NODE_14433_length_743_cov_15.667702	273	353	2	64	80	0.8000000
NODE_14433_length_743_cov_15.667702	349	429	0	80	80	1.0000000
NODE_14433_length_743_cov_15.667702	402	482	0	80	80	1.0000000
NODE_14434_length_743_cov_14.975155	289	362	0	14	73	0.1917808
NODE_14434_length_743_cov_14.975155	289	362	1	1	73	0.0136986
NODE_14434_length_743_cov_14.975155	289	362	2	10	73	0.1369863
NODE_14434_length_743_cov_14.975155	289	362	4	11	73	0.1506849
NODE_14434_length_743_cov_14.975155	289	362	6	37	73	0.5068493
NODE_14435_length_743_cov_14.100932	232	312	0	80	80	1.0000000
NODE_14435_length_743_cov_14.100932	285	365	0	80	80	1.0000000
NODE_14435_length_743_cov_14.100932	361	441	0	80	80	1.0000000
NODE_14435_length_743_cov_14.100932	414	494	0	80	80	1.0000000
NODE_14436_length_743_cov_12.968944	268	348	0	48	80	0.6000000
NODE_14436_length_743_cov_12.968944	268	348	2	9	80	0.1125000
NODE_14436_length_743_cov_12.968944	268	348	3	21	80	0.2625000
NODE_14436_length_743_cov_12.968944	268	348	4	2	80	0.0250000
NODE_14436_length_743_cov_12.968944	321	401	2	4	80	0.0500000
NODE_14436_length_743_cov_12.968944	321	401	3	21	80	0.2625000
NODE_14436_length_743_cov_12.968944	321	401	4	55	80	0.6875000
NODE_14437_length_743_cov_12.847826	485	565	0	80	80	1.0000000
NODE_14437_length_743_cov_12.847826	538	618	0	80	80	1.0000000
NODE_14438_length_743_cov_11.871118	403	483	0	80	80	1.0000000
NODE_14438_length_743_cov_11.871118	456	536	0	80	80	1.0000000
NODE_14439_length_743_cov_11.760870	337	417	5	80	80	1.0000000
NODE_14439_length_743_cov_11.760870	390	470	0	48	80	0.6000000
NODE_14439_length_743_cov_11.760870	390	470	2	4	80	0.0500000
NODE_14439_length_743_cov_11.760870	390	470	5	28	80	0.3500000
NODE_14440_length_743_cov_9.006211	351	431	0	80	80	1.0000000
NODE_14440_length_743_cov_9.006211	404	484	0	80	80	1.0000000
NODE_14441_length_743_cov_8.063665	290	370	0	80	80	1.0000000
NODE_14441_length_743_cov_8.063665	343	423	0	80	80	1.0000000
NODE_14456_length_743_cov_2.029503	260	284	0	24	24	1.0000000
NODE_14456_length_743_cov_2.029503	301	363	0	62	62	1.0000000
NODE_14473_length_743_cov_0.989130	592	670	16	6	78	0.0769231
NODE_14473_length_743_cov_0.989130	592	670	20	9	78	0.1153846
NODE_14473_length_743_cov_0.989130	592	670	36	2	78	0.0256410
NODE_14473_length_743_cov_0.989130	592	670	38	1	78	0.0128205
NODE_14473_length_743_cov_0.989130	592	670	44	8	78	0.1025641
NODE_14473_length_743_cov_0.989130	592	670	45	1	78	0.0128205
NODE_14473_length_743_cov_0.989130	592	670	46	4	78	0.0512821
NODE_14473_length_743_cov_0.989130	592	670	48	2	78	0.0256410
NODE_14473_length_743_cov_0.989130	592	670	50	3	78	0.0384615
NODE_14473_length_743_cov_0.989130	592	670	51	3	78	0.0384615
NODE_14473_length_743_cov_0.989130	592	670	53	2	78	0.0256410
NODE_14473_length_743_cov_0.989130	592	670	54	11	78	0.1410256
NODE_14473_length_743_cov_0.989130	592	670	56	3	78	0.0384615
NODE_14473_length_743_cov_0.989130	592	670	58	23	78	0.2948718
NODE_14477_length_742_cov_23.664075	271	351	0	3	80	0.0375000
NODE_14477_length_742_cov_23.664075	271	351	1	16	80	0.2000000
NODE_14477_length_742_cov_23.664075	271	351	2	14	80	0.1750000
NODE_14477_length_742_cov_23.664075	271	351	6	47	80	0.5875000
NODE_14477_length_742_cov_23.664075	324	404	2	25	80	0.3125000
NODE_14477_length_742_cov_23.664075	324	404	6	55	80	0.6875000
NODE_14478_length_742_cov_19.488336	288	368	0	29	80	0.3625000
NODE_14478_length_742_cov_19.488336	288	368	2	1	80	0.0125000
NODE_14478_length_742_cov_19.488336	288	368	8	50	80	0.6250000
NODE_14478_length_742_cov_19.488336	341	421	8	80	80	1.0000000
NODE_14479_length_742_cov_18.528771	319	399	4	61	80	0.7625000
NODE_14479_length_742_cov_18.528771	319	399	8	19	80	0.2375000
NODE_14479_length_742_cov_18.528771	372	452	4	29	80	0.3625000
NODE_14479_length_742_cov_18.528771	372	452	8	51	80	0.6375000
NODE_14480_length_742_cov_17.401244	126	206	0	80	80	1.0000000
NODE_14480_length_742_cov_17.401244	179	259	0	80	80	1.0000000
NODE_14482_length_742_cov_7.679627	274	354	0	80	80	1.0000000
NODE_14482_length_742_cov_7.679627	327	407	0	80	80	1.0000000
NODE_14521_length_741_cov_12.168224	316	392	0	76	76	1.0000000
NODE_14521_length_741_cov_12.168224	598	663	0	35	65	0.5384616
NODE_14521_length_741_cov_12.168224	598	663	2	30	65	0.4615385
NODE_14522_length_741_cov_8.542056	198	278	2	80	80	1.0000000
NODE_14522_length_741_cov_8.542056	251	331	0	43	80	0.5375000
NODE_14522_length_741_cov_8.542056	251	331	2	37	80	0.4625000
NODE_14525_length_741_cov_5.989097	457	538	0	12	81	0.1481481
NODE_14525_length_741_cov_5.989097	457	538	1	8	81	0.0987654
NODE_14525_length_741_cov_5.989097	457	538	2	48	81	0.5925926
NODE_14525_length_741_cov_5.989097	457	538	4	13	81	0.1604938
NODE_14536_length_741_cov_2.556075	212	289	2	69	77	0.8961039
NODE_14536_length_741_cov_2.556075	212	289	4	7	77	0.0909091
NODE_14536_length_741_cov_2.556075	212	289	7	1	77	0.0129870
NODE_14571_length_740_cov_54.372855	192	272	0	30	80	0.3750000
NODE_14571_length_740_cov_54.372855	192	272	1	50	80	0.6250000
NODE_14571_length_740_cov_54.372855	245	325	1	64	80	0.8000000
NODE_14571_length_740_cov_54.372855	245	325	2	16	80	0.2000000
NODE_14571_length_740_cov_54.372855	321	401	1	29	80	0.3625000
NODE_14571_length_740_cov_54.372855	321	401	2	51	80	0.6375000
NODE_14571_length_740_cov_54.372855	374	454	1	80	80	1.0000000
NODE_14572_length_740_cov_51.758190	194	274	0	23	80	0.2875000
NODE_14572_length_740_cov_51.758190	194	274	4	57	80	0.7125000
NODE_14572_length_740_cov_51.758190	247	327	0	76	80	0.9500000
NODE_14572_length_740_cov_51.758190	247	327	4	4	80	0.0500000
NODE_14573_length_740_cov_34.185647	359	439	2	21	80	0.2625000
NODE_14573_length_740_cov_34.185647	359	439	6	59	80	0.7375000
NODE_14573_length_740_cov_34.185647	412	492	0	28	80	0.3500000
NODE_14573_length_740_cov_34.185647	412	492	2	46	80	0.5750000
NODE_14573_length_740_cov_34.185647	412	492	6	6	80	0.0750000
NODE_14574_length_740_cov_24.794072	286	366	0	80	80	1.0000000
NODE_14574_length_740_cov_24.794072	339	419	0	80	80	1.0000000
NODE_14575_length_740_cov_20.361934	316	396	0	80	80	1.0000000
NODE_14575_length_740_cov_20.361934	369	449	0	80	80	1.0000000
NODE_14576_length_740_cov_18.982839	266	348	0	82	82	1.0000000
NODE_14576_length_740_cov_18.982839	321	401	0	80	80	1.0000000
NODE_14577_length_740_cov_16.755070	354	434	2	17	80	0.2125000
NODE_14577_length_740_cov_16.755070	354	434	4	22	80	0.2750000
NODE_14577_length_740_cov_16.755070	354	434	6	41	80	0.5125000
NODE_14577_length_740_cov_16.755070	407	487	4	19	80	0.2375000
NODE_14577_length_740_cov_16.755070	407	487	6	61	80	0.7625000
NODE_14579_length_740_cov_7.585023	206	286	2	80	80	1.0000000
NODE_14579_length_740_cov_7.585023	259	339	0	43	80	0.5375000
NODE_14579_length_740_cov_7.585023	259	339	2	37	80	0.4625000
NODE_14580_length_740_cov_7.174727	165	245	0	54	80	0.6750000
NODE_14580_length_740_cov_7.174727	165	245	4	26	80	0.3250000
NODE_14580_length_740_cov_7.174727	218	298	0	80	80	1.0000000
NODE_14614_length_739_cov_52.970312	346	426	0	80	80	1.0000000
NODE_14614_length_739_cov_52.970312	399	479	0	80	80	1.0000000
NODE_14615_length_739_cov_31.175000	204	284	0	80	80	1.0000000
NODE_14615_length_739_cov_31.175000	257	337	0	80	80	1.0000000
NODE_14616_length_739_cov_25.482813	487	567	6	80	80	1.0000000
NODE_14616_length_739_cov_25.482813	540	620	0	45	80	0.5625000
NODE_14616_length_739_cov_25.482813	540	620	6	35	80	0.4375000
NODE_14617_length_739_cov_24.871875	191	271	0	77	80	0.9625000
NODE_14617_length_739_cov_24.871875	191	271	2	3	80	0.0375000
NODE_14617_length_739_cov_24.871875	244	324	0	24	80	0.3000000
NODE_14617_length_739_cov_24.871875	244	324	2	56	80	0.7000000
NODE_14618_length_739_cov_18.360937	146	226	0	24	80	0.3000000
NODE_14618_length_739_cov_18.360937	146	226	2	56	80	0.7000000
NODE_14618_length_739_cov_18.360937	199	279	0	10	80	0.1250000
NODE_14618_length_739_cov_18.360937	199	279	2	70	80	0.8750000
NODE_14619_length_739_cov_13.195312	273	353	0	80	80	1.0000000
NODE_14619_length_739_cov_13.195312	326	406	0	80	80	1.0000000
NODE_14620_length_739_cov_10.314063	231	311	0	30	80	0.3750000
NODE_14620_length_739_cov_10.314063	231	311	2	2	80	0.0250000
NODE_14620_length_739_cov_10.314063	231	311	4	48	80	0.6000000
NODE_14620_length_739_cov_10.314063	284	364	0	15	80	0.1875000
NODE_14620_length_739_cov_10.314063	284	364	2	9	80	0.1125000
NODE_14620_length_739_cov_10.314063	284	364	4	56	80	0.7000000
NODE_14622_length_739_cov_8.523438	468	548	0	80	80	1.0000000
NODE_14622_length_739_cov_8.523438	521	600	0	79	79	1.0000000
NODE_14623_length_739_cov_7.398438	342	422	0	80	80	1.0000000
NODE_14623_length_739_cov_7.398438	395	475	0	80	80	1.0000000
NODE_14625_length_739_cov_5.826562	252	332	0	80	80	1.0000000
NODE_14625_length_739_cov_5.826562	305	385	0	80	80	1.0000000
NODE_14634_length_739_cov_3.232813	355	435	0	80	80	1.0000000
NODE_14634_length_739_cov_3.232813	408	488	0	80	80	1.0000000
NODE_14679_length_738_cov_35.278560	274	318	100	1	44	0.0227273
NODE_14679_length_738_cov_35.278560	274	318	101	2	44	0.0454545
NODE_14679_length_738_cov_35.278560	274	318	103	1	44	0.0227273
NODE_14679_length_738_cov_35.278560	274	318	107	2	44	0.0454545
NODE_14679_length_738_cov_35.278560	274	318	109	3	44	0.0681818
NODE_14679_length_738_cov_35.278560	274	318	111	2	44	0.0454545
NODE_14679_length_738_cov_35.278560	274	318	113	2	44	0.0454545
NODE_14679_length_738_cov_35.278560	274	318	115	1	44	0.0227273
NODE_14679_length_738_cov_35.278560	274	318	117	2	44	0.0454545
NODE_14679_length_738_cov_35.278560	274	318	119	2	44	0.0454545
NODE_14679_length_738_cov_35.278560	274	318	123	4	44	0.0909091
NODE_14679_length_738_cov_35.278560	274	318	124	3	44	0.0681818
NODE_14679_length_738_cov_35.278560	274	318	125	1	44	0.0227273
NODE_14679_length_738_cov_35.278560	274	318	126	4	44	0.0909091
NODE_14679_length_738_cov_35.278560	274	318	127	1	44	0.0227273
NODE_14679_length_738_cov_35.278560	274	318	128	2	44	0.0454545
NODE_14679_length_738_cov_35.278560	274	318	130	2	44	0.0454545
NODE_14679_length_738_cov_35.278560	274	318	132	3	44	0.0681818
NODE_14679_length_738_cov_35.278560	274	318	133	3	44	0.0681818
NODE_14679_length_738_cov_35.278560	274	318	134	2	44	0.0454545
NODE_14679_length_738_cov_35.278560	274	318	135	1	44	0.0227273
NODE_14680_length_738_cov_21.672926	208	288	0	80	80	1.0000000
NODE_14680_length_738_cov_21.672926	261	341	0	80	80	1.0000000
NODE_14681_length_738_cov_15.665102	302	382	0	80	80	1.0000000
NODE_14681_length_738_cov_15.665102	355	435	0	80	80	1.0000000
NODE_14682_length_738_cov_15.661972	338	418	0	24	80	0.3000000
NODE_14682_length_738_cov_15.661972	338	418	2	11	80	0.1375000
NODE_14682_length_738_cov_15.661972	338	418	4	45	80	0.5625000
NODE_14682_length_738_cov_15.661972	391	471	2	46	80	0.5750000
NODE_14682_length_738_cov_15.661972	391	471	4	34	80	0.4250000
NODE_14683_length_738_cov_12.594679	49	129	0	51	80	0.6375000
NODE_14683_length_738_cov_12.594679	49	129	2	29	80	0.3625000
NODE_14683_length_738_cov_12.594679	102	182	0	20	80	0.2500000
NODE_14683_length_738_cov_12.594679	102	182	2	60	80	0.7500000
NODE_14683_length_738_cov_12.594679	178	258	0	80	80	1.0000000
NODE_14683_length_738_cov_12.594679	231	311	0	80	80	1.0000000
NODE_14691_length_738_cov_4.056338	254	326	0	72	72	1.0000000
NODE_14691_length_738_cov_4.056338	437	528	0	46	91	0.5054945
NODE_14691_length_738_cov_4.056338	437	528	2	11	91	0.1208791
NODE_14691_length_738_cov_4.056338	437	528	4	33	91	0.3626374
NODE_14691_length_738_cov_4.056338	437	528	6	1	91	0.0109890
NODE_14724_length_737_cov_22.363636	303	383	6	80	80	1.0000000
NODE_14724_length_737_cov_22.363636	356	436	2	35	80	0.4375000
NODE_14724_length_737_cov_22.363636	356	436	4	9	80	0.1125000
NODE_14724_length_737_cov_22.363636	356	436	6	36	80	0.4500000
NODE_14725_length_737_cov_21.318182	208	288	4	23	80	0.2875000
NODE_14725_length_737_cov_21.318182	208	288	6	27	80	0.3375000
NODE_14725_length_737_cov_21.318182	208	288	8	30	80	0.3750000
NODE_14725_length_737_cov_21.318182	261	341	0	51	80	0.6375000
NODE_14725_length_737_cov_21.318182	261	341	4	25	80	0.3125000
NODE_14725_length_737_cov_21.318182	261	341	6	4	80	0.0500000
NODE_14726_length_737_cov_17.161442	346	426	0	80	80	1.0000000
NODE_14726_length_737_cov_17.161442	399	479	0	80	80	1.0000000
NODE_14727_length_737_cov_11.835423	211	291	0	80	80	1.0000000
NODE_14727_length_737_cov_11.835423	264	344	0	43	80	0.5375000
NODE_14727_length_737_cov_11.835423	264	344	2	37	80	0.4625000
NODE_14729_length_737_cov_6.782132	488	548	0	60	60	1.0000000
NODE_14732_length_737_cov_6.089342	241	321	0	80	80	1.0000000
NODE_14732_length_737_cov_6.089342	294	374	0	80	80	1.0000000
NODE_14747_length_737_cov_2.548589	386	416	0	30	30	1.0000000
NODE_14781_length_736_cov_46.601256	226	306	0	80	80	1.0000000
NODE_14781_length_736_cov_46.601256	279	359	0	80	80	1.0000000
NODE_14782_length_736_cov_32.442700	215	295	0	80	80	1.0000000
NODE_14782_length_736_cov_32.442700	268	350	0	82	82	1.0000000
NODE_14783_length_736_cov_26.364207	220	300	0	80	80	1.0000000
NODE_14783_length_736_cov_26.364207	273	353	0	80	80	1.0000000
NODE_14785_length_736_cov_10.317111	313	393	0	80	80	1.0000000
NODE_14785_length_736_cov_10.317111	366	446	0	80	80	1.0000000
NODE_14786_length_736_cov_9.188383	292	372	0	11	80	0.1375000
NODE_14786_length_736_cov_9.188383	292	372	1	1	80	0.0125000
NODE_14786_length_736_cov_9.188383	292	372	2	68	80	0.8500000
NODE_14786_length_736_cov_9.188383	345	425	0	43	80	0.5375000
NODE_14786_length_736_cov_9.188383	345	425	2	37	80	0.4625000
NODE_14787_length_736_cov_8.149137	315	391	0	76	76	1.0000000
NODE_14787_length_736_cov_8.149137	365	445	0	80	80	1.0000000
NODE_14788_length_736_cov_8.103611	295	375	0	80	80	1.0000000
NODE_14788_length_736_cov_8.103611	348	428	0	80	80	1.0000000
NODE_14789_length_736_cov_7.513344	239	319	0	80	80	1.0000000
NODE_14789_length_736_cov_7.513344	292	372	0	80	80	1.0000000
NODE_14792_length_736_cov_5.967033	253	333	0	1	80	0.0125000
NODE_14792_length_736_cov_5.967033	253	333	6	79	80	0.9875000
NODE_14792_length_736_cov_5.967033	306	386	6	80	80	1.0000000
NODE_14795_length_736_cov_4.908948	258	338	0	80	80	1.0000000
NODE_14795_length_736_cov_4.908948	311	391	0	80	80	1.0000000
NODE_14825_length_735_cov_21.099057	265	345	0	74	80	0.9250000
NODE_14825_length_735_cov_21.099057	265	345	4	6	80	0.0750000
NODE_14825_length_735_cov_21.099057	318	398	0	21	80	0.2625000
NODE_14825_length_735_cov_21.099057	318	398	4	59	80	0.7375000
NODE_14826_length_735_cov_16.696541	190	270	3	16	80	0.2000000
NODE_14826_length_735_cov_16.696541	190	270	5	2	80	0.0250000
NODE_14826_length_735_cov_16.696541	190	270	6	50	80	0.6250000
NODE_14826_length_735_cov_16.696541	190	270	8	12	80	0.1500000
NODE_14826_length_735_cov_16.696541	243	323	5	4	80	0.0500000
NODE_14826_length_735_cov_16.696541	243	323	6	22	80	0.2750000
NODE_14826_length_735_cov_16.696541	243	323	7	22	80	0.2750000
NODE_14826_length_735_cov_16.696541	243	323	8	32	80	0.4000000
NODE_14826_length_735_cov_16.696541	479	538	0	59	59	1.0000000
NODE_14827_length_735_cov_13.143082	231	311	0	80	80	1.0000000
NODE_14827_length_735_cov_13.143082	284	364	0	80	80	1.0000000
NODE_14828_length_735_cov_12.415094	434	514	2	58	80	0.7250000
NODE_14828_length_735_cov_12.415094	434	514	4	22	80	0.2750000
NODE_14828_length_735_cov_12.415094	487	567	2	15	80	0.1875000
NODE_14828_length_735_cov_12.415094	487	567	4	15	80	0.1875000
NODE_14828_length_735_cov_12.415094	487	567	6	11	80	0.1375000
NODE_14828_length_735_cov_12.415094	487	567	8	39	80	0.4875000
NODE_14836_length_735_cov_5.603774	326	394	0	68	68	1.0000000
NODE_14836_length_735_cov_5.603774	367	409	0	42	42	1.0000000
NODE_14880_length_734_cov_26.787402	209	289	0	55	80	0.6875000
NODE_14880_length_734_cov_26.787402	209	289	4	25	80	0.3125000
NODE_14880_length_734_cov_26.787402	262	342	0	2	80	0.0250000
NODE_14880_length_734_cov_26.787402	262	342	4	78	80	0.9750000
NODE_14881_length_734_cov_23.214173	200	280	0	80	80	1.0000000
NODE_14881_length_734_cov_23.214173	253	333	0	80	80	1.0000000
NODE_14883_length_734_cov_21.645669	245	325	0	22	80	0.2750000
NODE_14883_length_734_cov_21.645669	245	325	2	6	80	0.0750000
NODE_14883_length_734_cov_21.645669	245	325	4	52	80	0.6500000
NODE_14883_length_734_cov_21.645669	298	378	0	75	80	0.9375000
NODE_14883_length_734_cov_21.645669	298	378	2	5	80	0.0625000
NODE_14884_length_734_cov_14.393701	249	329	0	11	80	0.1375000
NODE_14884_length_734_cov_14.393701	249	329	2	69	80	0.8625000
NODE_14884_length_734_cov_14.393701	302	382	0	10	80	0.1250000
NODE_14884_length_734_cov_14.393701	302	382	2	70	80	0.8750000
NODE_14885_length_734_cov_11.324409	133	196	0	63	63	1.0000000
NODE_14885_length_734_cov_11.324409	169	229	0	60	60	1.0000000
NODE_14886_length_734_cov_10.872441	302	331	0	23	29	0.7931035
NODE_14886_length_734_cov_10.872441	302	331	4	6	29	0.2068966
NODE_14890_length_734_cov_6.352756	371	451	0	80	80	1.0000000
NODE_14890_length_734_cov_6.352756	424	504	0	80	80	1.0000000
NODE_14896_length_734_cov_2.705512	231	302	0	71	71	1.0000000
NODE_14934_length_733_cov_35.041009	268	348	0	80	80	1.0000000
NODE_14934_length_733_cov_35.041009	321	402	0	81	81	1.0000000
NODE_14935_length_733_cov_29.810726	28	108	0	80	80	1.0000000
NODE_14935_length_733_cov_29.810726	81	161	0	54	80	0.6750000
NODE_14935_length_733_cov_29.810726	81	161	5	1	80	0.0125000
NODE_14935_length_733_cov_29.810726	81	161	6	25	80	0.3125000
NODE_14935_length_733_cov_29.810726	157	237	0	8	80	0.1000000
NODE_14935_length_733_cov_29.810726	157	237	6	72	80	0.9000000
NODE_14935_length_733_cov_29.810726	210	290	0	61	80	0.7625000
NODE_14935_length_733_cov_29.810726	210	290	6	19	80	0.2375000
NODE_14936_length_733_cov_13.738170	333	413	0	80	80	1.0000000
NODE_14936_length_733_cov_13.738170	386	466	0	80	80	1.0000000
NODE_14937_length_733_cov_11.471609	314	389	0	3	75	0.0400000
NODE_14937_length_733_cov_11.471609	314	389	2	26	75	0.3466667
NODE_14937_length_733_cov_11.471609	314	389	4	46	75	0.6133333
NODE_14938_length_733_cov_11.321767	245	325	0	41	80	0.5125000
NODE_14938_length_733_cov_11.321767	245	325	2	39	80	0.4875000
NODE_14938_length_733_cov_11.321767	298	378	2	80	80	1.0000000
NODE_14940_length_733_cov_8.481073	318	395	0	77	77	1.0000000
NODE_14940_length_733_cov_8.481073	371	451	0	80	80	1.0000000
NODE_14944_length_733_cov_5.485804	659	715	22	3	56	0.0535714
NODE_14944_length_733_cov_5.485804	659	715	23	2	56	0.0357143
NODE_14944_length_733_cov_5.485804	659	715	24	5	56	0.0892857
NODE_14944_length_733_cov_5.485804	659	715	25	5	56	0.0892857
NODE_14944_length_733_cov_5.485804	659	715	27	4	56	0.0714286
NODE_14944_length_733_cov_5.485804	659	715	29	1	56	0.0178571
NODE_14944_length_733_cov_5.485804	659	715	31	1	56	0.0178571
NODE_14944_length_733_cov_5.485804	659	715	32	2	56	0.0357143
NODE_14944_length_733_cov_5.485804	659	715	34	6	56	0.1071429
NODE_14944_length_733_cov_5.485804	659	715	36	8	56	0.1428571
NODE_14944_length_733_cov_5.485804	659	715	40	1	56	0.0178571
NODE_14944_length_733_cov_5.485804	659	715	41	10	56	0.1785714
NODE_14944_length_733_cov_5.485804	659	715	43	8	56	0.1428571
NODE_14944_length_733_cov_5.485804	696	733	8	3	37	0.0810811
NODE_14944_length_733_cov_5.485804	696	733	10	1	37	0.0270270
NODE_14944_length_733_cov_5.485804	696	733	12	1	37	0.0270270
NODE_14944_length_733_cov_5.485804	696	733	14	2	37	0.0540541
NODE_14944_length_733_cov_5.485804	696	733	16	2	37	0.0540541
NODE_14944_length_733_cov_5.485804	696	733	18	1	37	0.0270270
NODE_14944_length_733_cov_5.485804	696	733	20	7	37	0.1891892
NODE_14944_length_733_cov_5.485804	696	733	22	4	37	0.1081081
NODE_14944_length_733_cov_5.485804	696	733	23	2	37	0.0540541
NODE_14944_length_733_cov_5.485804	696	733	24	5	37	0.1351351
NODE_14944_length_733_cov_5.485804	696	733	25	5	37	0.1351351
NODE_14944_length_733_cov_5.485804	696	733	27	4	37	0.1081081
NODE_14957_length_733_cov_2.272871	312	392	0	80	80	1.0000000
NODE_14957_length_733_cov_2.272871	365	445	0	80	80	1.0000000
NODE_14975_length_732_cov_19.519747	229	309	0	43	80	0.5375000
NODE_14975_length_732_cov_19.519747	229	309	4	37	80	0.4625000
NODE_14975_length_732_cov_19.519747	282	362	4	80	80	1.0000000
NODE_14976_length_732_cov_10.846761	247	327	0	80	80	1.0000000
NODE_14976_length_732_cov_10.846761	300	380	0	80	80	1.0000000
NODE_14977_length_732_cov_9.807267	276	356	0	80	80	1.0000000
NODE_14977_length_732_cov_9.807267	329	409	0	80	80	1.0000000
NODE_14978_length_732_cov_8.053712	415	495	4	80	80	1.0000000
NODE_14978_length_732_cov_8.053712	468	548	0	45	80	0.5625000
NODE_14978_length_732_cov_8.053712	468	548	4	35	80	0.4375000
NODE_14980_length_732_cov_5.194313	319	399	0	80	80	1.0000000
NODE_14980_length_732_cov_5.194313	372	452	0	80	80	1.0000000
NODE_14981_length_732_cov_4.998420	293	373	0	80	80	1.0000000
NODE_14981_length_732_cov_4.998420	346	426	0	80	80	1.0000000
NODE_14983_length_732_cov_4.758294	483	524	0	41	41	1.0000000
NODE_15021_length_731_cov_36.123418	464	544	0	12	80	0.1500000
NODE_15021_length_731_cov_36.123418	464	544	2	12	80	0.1500000
NODE_15021_length_731_cov_36.123418	464	544	4	56	80	0.7000000
NODE_15021_length_731_cov_36.123418	517	597	0	65	80	0.8125000
NODE_15021_length_731_cov_36.123418	517	597	2	12	80	0.1500000
NODE_15021_length_731_cov_36.123418	517	597	4	3	80	0.0375000
NODE_15022_length_731_cov_27.721519	294	374	6	80	80	1.0000000
NODE_15022_length_731_cov_27.721519	347	427	0	38	80	0.4750000
NODE_15022_length_731_cov_27.721519	347	427	6	42	80	0.5250000
NODE_15023_length_731_cov_19.655063	394	474	0	1	80	0.0125000
NODE_15023_length_731_cov_19.655063	394	474	2	2	80	0.0250000
NODE_15023_length_731_cov_19.655063	394	474	4	77	80	0.9625000
NODE_15023_length_731_cov_19.655063	447	527	2	55	80	0.6875000
NODE_15023_length_731_cov_19.655063	447	527	4	25	80	0.3125000
NODE_15024_length_731_cov_16.346519	429	509	0	80	80	1.0000000
NODE_15024_length_731_cov_16.346519	482	562	0	33	80	0.4125000
NODE_15024_length_731_cov_16.346519	482	562	2	47	80	0.5875000
NODE_15025_length_731_cov_13.892405	321	401	0	80	80	1.0000000
NODE_15025_length_731_cov_13.892405	374	454	0	80	80	1.0000000
NODE_15027_length_731_cov_8.800633	218	298	2	68	80	0.8500000
NODE_15027_length_731_cov_8.800633	218	298	4	12	80	0.1500000
NODE_15027_length_731_cov_8.800633	271	352	2	69	81	0.8518519
NODE_15027_length_731_cov_8.800633	271	352	4	12	81	0.1481481
NODE_15028_length_731_cov_7.658228	335	406	0	53	71	0.7464789
NODE_15028_length_731_cov_7.658228	335	406	2	9	71	0.1267606
NODE_15028_length_731_cov_7.658228	335	406	4	9	71	0.1267606
NODE_15028_length_731_cov_7.658228	387	468	0	1	81	0.0123457
NODE_15028_length_731_cov_7.658228	387	468	2	9	81	0.1111111
NODE_15028_length_731_cov_7.658228	387	468	4	71	81	0.8765432
NODE_15031_length_731_cov_5.471519	261	341	0	22	80	0.2750000
NODE_15031_length_731_cov_5.471519	261	341	2	58	80	0.7250000
NODE_15031_length_731_cov_5.471519	314	394	0	15	80	0.1875000
NODE_15031_length_731_cov_5.471519	314	394	2	65	80	0.8125000
NODE_15034_length_731_cov_4.083861	361	441	0	80	80	1.0000000
NODE_15034_length_731_cov_4.083861	458	482	0	24	24	1.0000000
NODE_15050_length_731_cov_2.226266	466	548	0	3	82	0.0365854
NODE_15050_length_731_cov_2.226266	466	548	2	14	82	0.1707317
NODE_15050_length_731_cov_2.226266	466	548	4	65	82	0.7926829
NODE_15077_length_730_cov_51.556260	349	429	0	27	80	0.3375000
NODE_15077_length_730_cov_51.556260	349	429	2	53	80	0.6625000
NODE_15077_length_730_cov_51.556260	402	482	0	80	80	1.0000000
NODE_15078_length_730_cov_39.862124	370	450	0	80	80	1.0000000
NODE_15078_length_730_cov_39.862124	423	503	0	80	80	1.0000000
NODE_15079_length_730_cov_15.801902	261	341	0	80	80	1.0000000
NODE_15079_length_730_cov_15.801902	314	394	0	33	80	0.4125000
NODE_15079_length_730_cov_15.801902	314	394	2	47	80	0.5875000
NODE_15080_length_730_cov_11.746434	242	322	0	80	80	1.0000000
NODE_15080_length_730_cov_11.746434	295	375	0	80	80	1.0000000
NODE_15081_length_730_cov_9.209192	358	438	0	80	80	1.0000000
NODE_15081_length_730_cov_9.209192	411	483	0	45	72	0.6250000
NODE_15081_length_730_cov_9.209192	411	483	2	27	72	0.3750000
NODE_15131_length_729_cov_44.188889	418	498	0	80	80	1.0000000
NODE_15131_length_729_cov_44.188889	471	551	0	50	80	0.6250000
NODE_15131_length_729_cov_44.188889	471	551	2	30	80	0.3750000
NODE_15132_length_729_cov_40.390476	330	410	0	80	80	1.0000000
NODE_15132_length_729_cov_40.390476	383	463	0	80	80	1.0000000
NODE_15133_length_729_cov_35.973016	231	311	0	80	80	1.0000000
NODE_15133_length_729_cov_35.973016	284	363	0	79	79	1.0000000
NODE_15134_length_729_cov_18.357143	170	250	8	80	80	1.0000000
NODE_15134_length_729_cov_18.357143	223	303	4	7	80	0.0875000
NODE_15134_length_729_cov_18.357143	223	303	8	73	80	0.9125000
NODE_15135_length_729_cov_17.928571	194	274	2	3	80	0.0375000
NODE_15135_length_729_cov_17.928571	194	274	7	77	80	0.9625000
NODE_15135_length_729_cov_17.928571	247	327	6	44	80	0.5500000
NODE_15135_length_729_cov_17.928571	247	327	7	29	80	0.3625000
NODE_15135_length_729_cov_17.928571	247	327	8	7	80	0.0875000
NODE_15136_length_729_cov_17.373016	369	449	0	3	80	0.0375000
NODE_15136_length_729_cov_17.373016	369	449	2	77	80	0.9625000
NODE_15136_length_729_cov_17.373016	422	502	0	46	80	0.5750000
NODE_15136_length_729_cov_17.373016	422	502	2	34	80	0.4250000
NODE_15137_length_729_cov_12.452381	347	427	0	61	80	0.7625000
NODE_15137_length_729_cov_12.452381	347	427	2	19	80	0.2375000
NODE_15137_length_729_cov_12.452381	400	480	0	80	80	1.0000000
NODE_15138_length_729_cov_10.388889	296	376	2	80	80	1.0000000
NODE_15138_length_729_cov_10.388889	349	429	0	27	80	0.3375000
NODE_15138_length_729_cov_10.388889	349	429	2	53	80	0.6625000
NODE_15185_length_728_cov_23.503975	338	418	0	80	80	1.0000000
NODE_15185_length_728_cov_23.503975	391	471	0	72	80	0.9000000
NODE_15185_length_728_cov_23.503975	391	471	2	8	80	0.1000000
NODE_15186_length_728_cov_22.496025	310	390	0	80	80	1.0000000
NODE_15186_length_728_cov_22.496025	363	443	0	80	80	1.0000000
NODE_15187_length_728_cov_16.596184	257	337	0	60	80	0.7500000
NODE_15187_length_728_cov_16.596184	257	337	2	20	80	0.2500000
NODE_15187_length_728_cov_16.596184	310	387	0	7	77	0.0909091
NODE_15187_length_728_cov_16.596184	310	387	2	70	77	0.9090909
NODE_15188_length_728_cov_16.114467	192	272	0	74	80	0.9250000
NODE_15188_length_728_cov_16.114467	192	272	2	6	80	0.0750000
NODE_15188_length_728_cov_16.114467	245	325	0	80	80	1.0000000
NODE_15189_length_728_cov_15.128776	298	377	0	79	79	1.0000000
NODE_15189_length_728_cov_15.128776	350	430	0	80	80	1.0000000
NODE_15190_length_728_cov_10.613672	269	349	2	80	80	1.0000000
NODE_15190_length_728_cov_10.613672	322	402	0	51	80	0.6375000
NODE_15190_length_728_cov_10.613672	322	402	2	29	80	0.3625000
NODE_15191_length_728_cov_7.613672	408	488	0	80	80	1.0000000
NODE_15191_length_728_cov_7.613672	461	541	0	30	80	0.3750000
NODE_15191_length_728_cov_7.613672	461	541	2	50	80	0.6250000
NODE_15196_length_728_cov_3.405405	335	415	2	25	80	0.3125000
NODE_15196_length_728_cov_3.405405	335	415	4	55	80	0.6875000
NODE_15244_length_727_cov_34.883758	57	137	6	80	80	1.0000000
NODE_15244_length_727_cov_34.883758	57	137	6	80	80	1.0000000
NODE_15244_length_727_cov_34.883758	57	137	6	80	80	1.0000000
NODE_15244_length_727_cov_34.883758	110	190	0	7	80	0.0875000
NODE_15244_length_727_cov_34.883758	110	190	3	1	80	0.0125000
NODE_15244_length_727_cov_34.883758	110	190	4	7	80	0.0875000
NODE_15244_length_727_cov_34.883758	110	190	6	65	80	0.8125000
NODE_15244_length_727_cov_34.883758	110	190	0	7	80	0.0875000
NODE_15244_length_727_cov_34.883758	110	190	3	1	80	0.0125000
NODE_15244_length_727_cov_34.883758	110	190	4	7	80	0.0875000
NODE_15244_length_727_cov_34.883758	110	190	6	65	80	0.8125000
NODE_15245_length_727_cov_32.025478	275	355	12	10	80	0.1250000
NODE_15245_length_727_cov_32.025478	275	355	16	13	80	0.1625000
NODE_15245_length_727_cov_32.025478	275	355	17	14	80	0.1750000
NODE_15245_length_727_cov_32.025478	275	355	22	2	80	0.0250000
NODE_15245_length_727_cov_32.025478	275	355	23	41	80	0.5125000
NODE_15245_length_727_cov_32.025478	328	408	6	17	80	0.2125000
NODE_15245_length_727_cov_32.025478	328	408	17	1	80	0.0125000
NODE_15245_length_727_cov_32.025478	328	408	19	9	80	0.1125000
NODE_15245_length_727_cov_32.025478	328	408	23	53	80	0.6625000
NODE_15246_length_727_cov_28.523885	307	381	0	31	74	0.4189189
NODE_15246_length_727_cov_28.523885	307	381	1	43	74	0.5810811
NODE_15246_length_727_cov_28.523885	360	381	1	21	21	1.0000000
NODE_15246_length_727_cov_28.523885	378	415	0	34	37	0.9189189
NODE_15246_length_727_cov_28.523885	378	415	1	3	37	0.0810811
NODE_15247_length_727_cov_25.826433	325	405	0	80	80	1.0000000
NODE_15247_length_727_cov_25.826433	378	458	0	80	80	1.0000000
NODE_15248_length_727_cov_22.253185	150	230	0	66	80	0.8250000
NODE_15248_length_727_cov_22.253185	150	230	2	14	80	0.1750000
NODE_15248_length_727_cov_22.253185	203	283	0	13	80	0.1625000
NODE_15248_length_727_cov_22.253185	203	283	2	67	80	0.8375000
NODE_15249_length_727_cov_18.972930	263	343	0	34	80	0.4250000
NODE_15249_length_727_cov_18.972930	263	343	2	12	80	0.1500000
NODE_15249_length_727_cov_18.972930	263	343	3	1	80	0.0125000
NODE_15249_length_727_cov_18.972930	263	343	4	33	80	0.4125000
NODE_15249_length_727_cov_18.972930	316	396	0	80	80	1.0000000
NODE_15250_length_727_cov_15.531847	269	349	0	80	80	1.0000000
NODE_15250_length_727_cov_15.531847	322	402	0	80	80	1.0000000
NODE_15252_length_727_cov_10.178344	280	360	0	80	80	1.0000000
NODE_15252_length_727_cov_10.178344	333	413	0	80	80	1.0000000
NODE_15258_length_727_cov_4.955414	360	440	0	80	80	1.0000000
NODE_15258_length_727_cov_4.955414	413	493	0	80	80	1.0000000
NODE_15287_length_726_cov_52.923445	415	495	0	80	80	1.0000000
NODE_15287_length_726_cov_52.923445	468	548	0	80	80	1.0000000
NODE_15288_length_726_cov_35.896332	108	188	0	63	80	0.7875000
NODE_15288_length_726_cov_35.896332	108	188	2	17	80	0.2125000
NODE_15288_length_726_cov_35.896332	161	241	0	10	80	0.1250000
NODE_15288_length_726_cov_35.896332	161	241	2	70	80	0.8750000
NODE_15288_length_726_cov_35.896332	237	317	0	43	80	0.5375000
NODE_15288_length_726_cov_35.896332	237	317	2	37	80	0.4625000
NODE_15288_length_726_cov_35.896332	290	370	0	80	80	1.0000000
NODE_15291_length_726_cov_8.534290	355	435	0	80	80	1.0000000
NODE_15291_length_726_cov_8.534290	408	488	0	80	80	1.0000000
NODE_15330_length_725_cov_40.856230	203	283	0	80	80	1.0000000
NODE_15330_length_725_cov_40.856230	256	336	0	79	80	0.9875000
NODE_15330_length_725_cov_40.856230	256	336	2	1	80	0.0125000
NODE_15330_length_725_cov_40.856230	332	412	0	3	80	0.0375000
NODE_15330_length_725_cov_40.856230	332	412	2	77	80	0.9625000
NODE_15330_length_725_cov_40.856230	385	465	0	5	80	0.0625000
NODE_15330_length_725_cov_40.856230	385	465	2	75	80	0.9375000
NODE_15331_length_725_cov_25.036741	366	446	0	80	80	1.0000000
NODE_15331_length_725_cov_25.036741	419	499	0	80	80	1.0000000
NODE_15332_length_725_cov_23.009585	455	536	2	10	81	0.1234568
NODE_15332_length_725_cov_23.009585	455	536	6	15	81	0.1851852
NODE_15332_length_725_cov_23.009585	455	536	10	14	81	0.1728395
NODE_15332_length_725_cov_23.009585	455	536	14	42	81	0.5185185
NODE_15333_length_725_cov_20.474441	112	192	0	80	80	1.0000000
NODE_15333_length_725_cov_20.474441	165	245	0	45	80	0.5625000
NODE_15333_length_725_cov_20.474441	165	245	2	35	80	0.4375000
NODE_15334_length_725_cov_15.455272	106	186	0	80	80	1.0000000
NODE_15334_length_725_cov_15.455272	159	239	0	49	80	0.6125000
NODE_15334_length_725_cov_15.455272	159	239	4	31	80	0.3875000
NODE_15334_length_725_cov_15.455272	235	315	4	53	80	0.6625000
NODE_15334_length_725_cov_15.455272	235	315	6	27	80	0.3375000
NODE_15334_length_725_cov_15.455272	288	368	4	17	80	0.2125000
NODE_15334_length_725_cov_15.455272	288	368	6	47	80	0.5875000
NODE_15334_length_725_cov_15.455272	288	368	8	6	80	0.0750000
NODE_15334_length_725_cov_15.455272	288	368	10	10	80	0.1250000
NODE_15335_length_725_cov_10.426518	289	369	0	15	80	0.1875000
NODE_15335_length_725_cov_10.426518	289	369	1	5	80	0.0625000
NODE_15335_length_725_cov_10.426518	289	369	2	60	80	0.7500000
NODE_15335_length_725_cov_10.426518	342	422	0	30	80	0.3750000
NODE_15335_length_725_cov_10.426518	342	422	2	50	80	0.6250000
NODE_15337_length_725_cov_7.781150	189	269	0	62	80	0.7750000
NODE_15337_length_725_cov_7.781150	189	269	4	18	80	0.2250000
NODE_15337_length_725_cov_7.781150	242	322	0	9	80	0.1125000
NODE_15337_length_725_cov_7.781150	242	322	4	71	80	0.8875000
NODE_15388_length_724_cov_28.132800	354	434	0	5	80	0.0625000
NODE_15388_length_724_cov_28.132800	354	434	2	75	80	0.9375000
NODE_15388_length_724_cov_28.132800	407	473	0	42	66	0.6363636
NODE_15388_length_724_cov_28.132800	407	473	2	24	66	0.3636364
NODE_15389_length_724_cov_24.710400	376	461	0	85	85	1.0000000
NODE_15389_length_724_cov_24.710400	434	514	0	80	80	1.0000000
NODE_15390_length_724_cov_13.960000	152	232	0	80	80	1.0000000
NODE_15390_length_724_cov_13.960000	205	248	0	43	43	1.0000000
NODE_15390_length_724_cov_13.960000	237	286	0	49	49	1.0000000
NODE_15390_length_724_cov_13.960000	259	302	0	43	43	1.0000000
NODE_15390_length_724_cov_13.960000	288	340	0	52	52	1.0000000
NODE_15390_length_724_cov_13.960000	313	393	0	80	80	1.0000000
NODE_15391_length_724_cov_13.065600	215	295	0	80	80	1.0000000
NODE_15391_length_724_cov_13.065600	268	347	0	79	79	1.0000000
NODE_15393_length_724_cov_10.358400	257	337	6	80	80	1.0000000
NODE_15393_length_724_cov_10.358400	310	385	0	27	75	0.3600000
NODE_15393_length_724_cov_10.358400	310	385	1	1	75	0.0133333
NODE_15393_length_724_cov_10.358400	310	385	2	12	75	0.1600000
NODE_15393_length_724_cov_10.358400	310	385	6	35	75	0.4666667
NODE_15396_length_724_cov_6.451200	151	231	0	80	80	1.0000000
NODE_15396_length_724_cov_6.451200	202	282	0	80	80	1.0000000
NODE_15397_length_724_cov_5.921600	165	213	2	48	48	1.0000000
NODE_15399_length_724_cov_5.028800	416	469	0	53	53	1.0000000
NODE_15399_length_724_cov_5.028800	488	526	0	38	38	1.0000000
NODE_15403_length_724_cov_3.315200	166	246	0	80	80	1.0000000
NODE_15403_length_724_cov_3.315200	219	299	0	80	80	1.0000000
NODE_15442_length_723_cov_81.453526	205	285	0	23	80	0.2875000
NODE_15442_length_723_cov_81.453526	205	285	2	57	80	0.7125000
NODE_15442_length_723_cov_81.453526	258	338	0	76	80	0.9500000
NODE_15442_length_723_cov_81.453526	258	338	2	4	80	0.0500000
NODE_15443_length_723_cov_33.075321	254	329	0	75	75	1.0000000
NODE_15443_length_723_cov_33.075321	307	387	0	80	80	1.0000000
NODE_15444_length_723_cov_25.410256	291	371	0	80	80	1.0000000
NODE_15444_length_723_cov_25.410256	344	424	0	39	80	0.4875000
NODE_15444_length_723_cov_25.410256	344	424	2	41	80	0.5125000
NODE_15445_length_723_cov_18.097756	233	313	0	80	80	1.0000000
NODE_15445_length_723_cov_18.097756	286	351	0	65	65	1.0000000
NODE_15446_length_723_cov_14.113782	311	391	0	80	80	1.0000000
NODE_15446_length_723_cov_14.113782	364	444	0	80	80	1.0000000
NODE_15447_length_723_cov_11.634615	299	379	0	24	80	0.3000000
NODE_15447_length_723_cov_11.634615	299	379	1	1	80	0.0125000
NODE_15447_length_723_cov_11.634615	299	379	2	55	80	0.6875000
NODE_15447_length_723_cov_11.634615	352	432	2	80	80	1.0000000
NODE_15448_length_723_cov_8.342949	357	437	0	69	80	0.8625000
NODE_15448_length_723_cov_8.342949	357	437	2	11	80	0.1375000
NODE_15448_length_723_cov_8.342949	410	490	0	16	80	0.2000000
NODE_15448_length_723_cov_8.342949	410	490	2	64	80	0.8000000
NODE_15455_length_723_cov_2.711538	379	422	0	43	43	1.0000000
NODE_15459_length_723_cov_2.573718	383	413	4	30	30	1.0000000
NODE_15495_length_722_cov_19.182986	180	260	0	55	80	0.6875000
NODE_15495_length_722_cov_19.182986	180	260	2	25	80	0.3125000
NODE_15495_length_722_cov_19.182986	233	313	0	13	80	0.1625000
NODE_15495_length_722_cov_19.182986	233	313	2	67	80	0.8375000
NODE_15496_length_722_cov_13.582665	192	272	0	6	80	0.0750000
NODE_15496_length_722_cov_13.582665	192	272	2	74	80	0.9250000
NODE_15496_length_722_cov_13.582665	245	326	0	8	81	0.0987654
NODE_15496_length_722_cov_13.582665	245	326	2	73	81	0.9012346
NODE_15497_length_722_cov_9.202247	347	427	0	14	80	0.1750000
NODE_15497_length_722_cov_9.202247	347	427	2	18	80	0.2250000
NODE_15497_length_722_cov_9.202247	347	427	4	7	80	0.0875000
NODE_15497_length_722_cov_9.202247	347	427	6	41	80	0.5125000
NODE_15497_length_722_cov_9.202247	400	480	4	23	80	0.2875000
NODE_15497_length_722_cov_9.202247	400	480	6	57	80	0.7125000
NODE_15500_length_722_cov_6.707865	343	423	0	63	80	0.7875000
NODE_15500_length_722_cov_6.707865	343	423	2	17	80	0.2125000
NODE_15500_length_722_cov_6.707865	396	476	0	10	80	0.1250000
NODE_15500_length_722_cov_6.707865	396	476	2	70	80	0.8750000
NODE_15504_length_722_cov_4.985554	332	393	0	61	61	1.0000000
NODE_15508_length_722_cov_3.977528	217	297	0	48	80	0.6000000
NODE_15508_length_722_cov_3.977528	217	297	2	32	80	0.4000000
NODE_15508_length_722_cov_3.977528	270	350	0	80	80	1.0000000
NODE_15553_length_721_cov_105.927653	425	505	0	80	80	1.0000000
NODE_15553_length_721_cov_105.927653	478	558	0	80	80	1.0000000
NODE_15554_length_721_cov_49.660772	304	384	0	63	80	0.7875000
NODE_15554_length_721_cov_49.660772	304	384	2	17	80	0.2125000
NODE_15554_length_721_cov_49.660772	357	437	0	10	80	0.1250000
NODE_15554_length_721_cov_49.660772	357	437	2	70	80	0.8750000
NODE_15555_length_721_cov_46.991961	341	421	0	80	80	1.0000000
NODE_15555_length_721_cov_46.991961	394	474	0	80	80	1.0000000
NODE_15556_length_721_cov_38.864952	208	288	0	80	80	1.0000000
NODE_15556_length_721_cov_38.864952	269	341	0	72	72	1.0000000
NODE_15556_length_721_cov_38.864952	337	417	0	80	80	1.0000000
NODE_15556_length_721_cov_38.864952	390	467	0	77	77	1.0000000
NODE_15557_length_721_cov_29.016077	192	272	2	80	80	1.0000000
NODE_15557_length_721_cov_29.016077	251	325	0	45	74	0.6081081
NODE_15557_length_721_cov_29.016077	251	325	2	29	74	0.3918919
NODE_15558_length_721_cov_26.196141	398	478	0	80	80	1.0000000
NODE_15558_length_721_cov_26.196141	451	531	0	80	80	1.0000000
NODE_15560_length_721_cov_20.054662	178	258	0	80	80	1.0000000
NODE_15560_length_721_cov_20.054662	231	311	0	80	80	1.0000000
NODE_15561_length_721_cov_13.670418	263	343	0	44	80	0.5500000
NODE_15561_length_721_cov_13.670418	263	343	2	36	80	0.4500000
NODE_15561_length_721_cov_13.670418	316	396	2	80	80	1.0000000
NODE_15562_length_721_cov_13.652733	268	350	0	8	82	0.0975610
NODE_15562_length_721_cov_13.652733	268	350	2	74	82	0.9024390
NODE_15562_length_721_cov_13.652733	321	403	0	36	82	0.4390244
NODE_15562_length_721_cov_13.652733	321	403	2	46	82	0.5609756
NODE_15563_length_721_cov_13.120579	312	392	0	15	80	0.1875000
NODE_15563_length_721_cov_13.120579	312	392	2	14	80	0.1750000
NODE_15563_length_721_cov_13.120579	312	392	11	1	80	0.0125000
NODE_15563_length_721_cov_13.120579	312	392	12	50	80	0.6250000
NODE_15563_length_721_cov_13.120579	365	445	10	18	80	0.2250000
NODE_15563_length_721_cov_13.120579	365	445	12	62	80	0.7750000
NODE_15572_length_721_cov_4.491961	210	280	2	70	70	1.0000000
NODE_15572_length_721_cov_4.491961	253	333	2	80	80	1.0000000
NODE_15572_length_721_cov_4.491961	470	521	0	51	51	1.0000000
NODE_15608_length_720_cov_17.449275	267	347	0	80	80	1.0000000
NODE_15608_length_720_cov_17.449275	320	400	0	80	80	1.0000000
NODE_15609_length_720_cov_14.814815	261	341	2	80	80	1.0000000
NODE_15609_length_720_cov_14.814815	314	394	0	40	80	0.5000000
NODE_15609_length_720_cov_14.814815	314	394	2	40	80	0.5000000
NODE_15610_length_720_cov_14.107890	290	370	0	80	80	1.0000000
NODE_15610_length_720_cov_14.107890	343	423	0	80	80	1.0000000
NODE_15612_length_720_cov_12.924316	314	394	0	8	80	0.1000000
NODE_15612_length_720_cov_12.924316	314	394	2	72	80	0.9000000
NODE_15612_length_720_cov_12.924316	367	447	0	61	80	0.7625000
NODE_15612_length_720_cov_12.924316	367	447	2	19	80	0.2375000
NODE_15614_length_720_cov_10.389694	435	515	0	80	80	1.0000000
NODE_15614_length_720_cov_10.389694	488	568	0	80	80	1.0000000
NODE_15620_length_720_cov_5.278583	309	389	0	80	80	1.0000000
NODE_15620_length_720_cov_5.278583	362	442	0	80	80	1.0000000
NODE_15624_length_720_cov_3.792271	157	235	0	44	78	0.5641026
NODE_15624_length_720_cov_3.792271	157	235	2	34	78	0.4358974
NODE_15624_length_720_cov_3.792271	215	265	2	50	50	1.0000000
NODE_15658_length_719_cov_30.256452	279	359	0	80	80	1.0000000
NODE_15658_length_719_cov_30.256452	332	412	0	80	80	1.0000000
NODE_15659_length_719_cov_29.093548	310	390	3	10	80	0.1250000
NODE_15659_length_719_cov_29.093548	310	390	4	52	80	0.6500000
NODE_15659_length_719_cov_29.093548	310	390	6	2	80	0.0250000
NODE_15659_length_719_cov_29.093548	310	390	7	16	80	0.2000000
NODE_15659_length_719_cov_29.093548	363	443	4	80	80	1.0000000
NODE_15660_length_719_cov_10.988710	195	275	0	80	80	1.0000000
NODE_15660_length_719_cov_10.988710	248	328	0	80	80	1.0000000
NODE_15661_length_719_cov_10.837097	259	339	0	57	80	0.7125000
NODE_15661_length_719_cov_10.837097	259	339	2	23	80	0.2875000
NODE_15661_length_719_cov_10.837097	312	392	0	80	80	1.0000000
NODE_15662_length_719_cov_7.622581	288	368	0	80	80	1.0000000
NODE_15662_length_719_cov_7.622581	341	421	0	80	80	1.0000000
NODE_15663_length_719_cov_7.570968	351	431	0	66	80	0.8250000
NODE_15663_length_719_cov_7.570968	351	431	2	14	80	0.1750000
NODE_15663_length_719_cov_7.570968	404	484	0	13	80	0.1625000
NODE_15663_length_719_cov_7.570968	404	484	2	67	80	0.8375000
NODE_15672_length_719_cov_4.264516	251	281	0	2	30	0.0666667
NODE_15672_length_719_cov_4.264516	251	281	2	28	30	0.9333333
NODE_15684_length_719_cov_1.629032	88	163	10	1	75	0.0133333
NODE_15684_length_719_cov_1.629032	88	163	12	14	75	0.1866667
NODE_15684_length_719_cov_1.629032	88	163	15	1	75	0.0133333
NODE_15684_length_719_cov_1.629032	88	163	18	26	75	0.3466667
NODE_15684_length_719_cov_1.629032	88	163	20	11	75	0.1466667
NODE_15684_length_719_cov_1.629032	88	163	22	10	75	0.1333333
NODE_15684_length_719_cov_1.629032	88	163	24	1	75	0.0133333
NODE_15684_length_719_cov_1.629032	88	163	26	11	75	0.1466667
NODE_15706_length_718_cov_35.382876	296	376	0	9	80	0.1125000
NODE_15706_length_718_cov_35.382876	296	376	2	71	80	0.8875000
NODE_15706_length_718_cov_35.382876	296	376	0	9	80	0.1125000
NODE_15706_length_718_cov_35.382876	296	376	2	71	80	0.8875000
NODE_15706_length_718_cov_35.382876	349	429	0	30	80	0.3750000
NODE_15706_length_718_cov_35.382876	349	429	2	50	80	0.6250000
NODE_15706_length_718_cov_35.382876	349	429	0	30	80	0.3750000
NODE_15706_length_718_cov_35.382876	349	429	2	50	80	0.6250000
NODE_15707_length_718_cov_24.211632	313	393	0	80	80	1.0000000
NODE_15707_length_718_cov_24.211632	366	446	0	80	80	1.0000000
NODE_15708_length_718_cov_18.300485	217	297	0	38	80	0.4750000
NODE_15708_length_718_cov_18.300485	217	297	3	42	80	0.5250000
NODE_15708_length_718_cov_18.300485	270	350	3	31	80	0.3875000
NODE_15708_length_718_cov_18.300485	270	350	6	49	80	0.6125000
NODE_15709_length_718_cov_14.757674	383	463	0	6	80	0.0750000
NODE_15709_length_718_cov_14.757674	383	463	2	74	80	0.9250000
NODE_15709_length_718_cov_14.757674	436	516	0	23	80	0.2875000
NODE_15709_length_718_cov_14.757674	436	516	1	15	80	0.1875000
NODE_15709_length_718_cov_14.757674	436	516	2	42	80	0.5250000
NODE_15710_length_718_cov_14.355412	254	334	0	80	80	1.0000000
NODE_15710_length_718_cov_14.355412	307	387	0	80	80	1.0000000
NODE_15715_length_718_cov_4.804523	263	343	0	37	80	0.4625000
NODE_15715_length_718_cov_4.804523	263	343	2	43	80	0.5375000
NODE_15715_length_718_cov_4.804523	316	396	0	6	80	0.0750000
NODE_15715_length_718_cov_4.804523	316	396	2	74	80	0.9250000
NODE_15750_length_717_cov_28.377023	335	415	2	14	80	0.1750000
NODE_15750_length_717_cov_28.377023	335	415	16	66	80	0.8250000
NODE_15750_length_717_cov_28.377023	388	468	0	10	80	0.1250000
NODE_15750_length_717_cov_28.377023	388	468	2	57	80	0.7125000
NODE_15750_length_717_cov_28.377023	388	468	16	13	80	0.1625000
NODE_15751_length_717_cov_23.275081	162	242	0	80	80	1.0000000
NODE_15751_length_717_cov_23.275081	215	295	0	80	80	1.0000000
NODE_15752_length_717_cov_18.564725	319	399	0	10	80	0.1250000
NODE_15752_length_717_cov_18.564725	319	399	2	55	80	0.6875000
NODE_15752_length_717_cov_18.564725	319	399	6	15	80	0.1875000
NODE_15752_length_717_cov_18.564725	372	452	2	12	80	0.1500000
NODE_15752_length_717_cov_18.564725	372	452	4	12	80	0.1500000
NODE_15752_length_717_cov_18.564725	372	452	6	56	80	0.7000000
NODE_15753_length_717_cov_18.389968	358	438	0	80	80	1.0000000
NODE_15753_length_717_cov_18.389968	411	491	0	80	80	1.0000000
NODE_15754_length_717_cov_17.932039	241	321	0	28	80	0.3500000
NODE_15754_length_717_cov_17.932039	241	321	2	52	80	0.6500000
NODE_15754_length_717_cov_17.932039	294	374	0	28	80	0.3500000
NODE_15754_length_717_cov_17.932039	294	374	2	52	80	0.6500000
NODE_15755_length_717_cov_14.637540	298	378	0	80	80	1.0000000
NODE_15755_length_717_cov_14.637540	351	431	0	80	80	1.0000000
NODE_15756_length_717_cov_12.279935	113	196	0	83	83	1.0000000
NODE_15756_length_717_cov_12.279935	169	249	0	80	80	1.0000000
NODE_15757_length_717_cov_10.711974	353	431	0	78	78	1.0000000
NODE_15758_length_717_cov_9.399676	331	411	0	80	80	1.0000000
NODE_15758_length_717_cov_9.399676	384	464	0	80	80	1.0000000
NODE_15762_length_717_cov_5.341424	475	555	0	80	80	1.0000000
NODE_15762_length_717_cov_5.341424	528	608	0	80	80	1.0000000
NODE_15770_length_717_cov_3.187702	285	322	0	37	37	1.0000000
NODE_15805_length_716_cov_16.800648	430	510	10	37	80	0.4625000
NODE_15805_length_716_cov_16.800648	430	510	12	43	80	0.5375000
NODE_15805_length_716_cov_16.800648	483	563	0	26	80	0.3250000
NODE_15805_length_716_cov_16.800648	483	563	2	9	80	0.1125000
NODE_15805_length_716_cov_16.800648	483	563	12	45	80	0.5625000
NODE_15806_length_716_cov_12.565640	356	436	0	80	80	1.0000000
NODE_15806_length_716_cov_12.565640	409	489	0	80	80	1.0000000
NODE_15807_length_716_cov_9.277147	385	465	0	6	80	0.0750000
NODE_15807_length_716_cov_9.277147	385	465	4	74	80	0.9250000
NODE_15807_length_716_cov_9.277147	438	518	3	1	80	0.0125000
NODE_15807_length_716_cov_9.277147	438	518	4	79	80	0.9875000
NODE_15808_length_716_cov_9.257699	302	382	0	36	80	0.4500000
NODE_15808_length_716_cov_9.257699	302	382	2	44	80	0.5500000
NODE_15808_length_716_cov_9.257699	355	435	2	80	80	1.0000000
NODE_15809_length_716_cov_6.761750	263	343	0	80	80	1.0000000
NODE_15809_length_716_cov_6.761750	316	396	0	80	80	1.0000000
NODE_15812_length_716_cov_4.909238	236	316	0	80	80	1.0000000
NODE_15812_length_716_cov_4.909238	289	369	0	80	80	1.0000000
NODE_15824_length_716_cov_2.068071	453	481	0	28	28	1.0000000
NODE_15853_length_715_cov_38.795455	260	340	0	51	80	0.6375000
NODE_15853_length_715_cov_38.795455	260	340	2	29	80	0.3625000
NODE_15853_length_715_cov_38.795455	313	393	0	80	80	1.0000000
NODE_15854_length_715_cov_30.344156	316	396	0	80	80	1.0000000
NODE_15854_length_715_cov_30.344156	369	449	0	80	80	1.0000000
NODE_15857_length_715_cov_11.209416	484	564	0	80	80	1.0000000
NODE_15857_length_715_cov_11.209416	537	617	0	80	80	1.0000000
NODE_15858_length_715_cov_10.894481	189	242	7	23	53	0.4339623
NODE_15858_length_715_cov_10.894481	189	242	9	30	53	0.5660377
NODE_15859_length_715_cov_10.628247	502	582	0	80	80	1.0000000
NODE_15859_length_715_cov_10.628247	555	635	0	80	80	1.0000000
NODE_15860_length_715_cov_8.647727	138	218	0	80	80	1.0000000
NODE_15860_length_715_cov_8.647727	191	271	0	80	80	1.0000000
NODE_15861_length_715_cov_8.412338	364	444	0	80	80	1.0000000
NODE_15861_length_715_cov_8.412338	417	497	0	80	80	1.0000000
NODE_15864_length_715_cov_5.373377	318	398	0	80	80	1.0000000
NODE_15864_length_715_cov_5.373377	371	451	0	80	80	1.0000000
NODE_15898_length_715_cov_1.271104	331	397	0	66	66	1.0000000
NODE_15910_length_714_cov_18.621138	297	377	0	9	80	0.1125000
NODE_15910_length_714_cov_18.621138	297	377	1	6	80	0.0750000
NODE_15910_length_714_cov_18.621138	297	377	2	65	80	0.8125000
NODE_15910_length_714_cov_18.621138	350	430	2	80	80	1.0000000
NODE_15911_length_714_cov_15.468293	268	348	0	80	80	1.0000000
NODE_15911_length_714_cov_15.468293	321	401	0	80	80	1.0000000
NODE_15913_length_714_cov_10.530081	218	298	0	30	80	0.3750000
NODE_15913_length_714_cov_10.530081	218	298	2	50	80	0.6250000
NODE_15913_length_714_cov_10.530081	271	351	0	80	80	1.0000000
NODE_15913_length_714_cov_10.530081	354	434	0	80	80	1.0000000
NODE_15913_length_714_cov_10.530081	407	487	0	80	80	1.0000000
NODE_15914_length_714_cov_8.365854	285	365	0	80	80	1.0000000
NODE_15914_length_714_cov_8.365854	338	418	0	80	80	1.0000000
NODE_15919_length_714_cov_6.993496	263	343	4	42	80	0.5250000
NODE_15919_length_714_cov_6.993496	263	343	5	15	80	0.1875000
NODE_15919_length_714_cov_6.993496	263	343	6	23	80	0.2875000
NODE_15919_length_714_cov_6.993496	316	384	1	12	68	0.1764706
NODE_15919_length_714_cov_6.993496	316	384	2	5	68	0.0735294
NODE_15919_length_714_cov_6.993496	316	384	3	15	68	0.2205882
NODE_15919_length_714_cov_6.993496	316	384	4	29	68	0.4264706
NODE_15919_length_714_cov_6.993496	316	384	5	7	68	0.1029412
NODE_15921_length_714_cov_4.224390	218	288	0	70	70	1.0000000
NODE_15921_length_714_cov_4.224390	271	351	0	80	80	1.0000000
NODE_15969_length_713_cov_19.304560	271	351	0	39	80	0.4875000
NODE_15969_length_713_cov_19.304560	271	351	2	20	80	0.2500000
NODE_15969_length_713_cov_19.304560	271	351	4	21	80	0.2625000
NODE_15969_length_713_cov_19.304560	324	404	0	5	80	0.0625000
NODE_15969_length_713_cov_19.304560	324	404	2	8	80	0.1000000
NODE_15969_length_713_cov_19.304560	324	404	4	67	80	0.8375000
NODE_15970_length_713_cov_16.926710	262	342	0	80	80	1.0000000
NODE_15970_length_713_cov_16.926710	315	395	0	80	80	1.0000000
NODE_15973_length_713_cov_7.159609	351	431	0	41	80	0.5125000
NODE_15973_length_713_cov_7.159609	351	431	2	39	80	0.4875000
NODE_15973_length_713_cov_7.159609	404	484	0	80	80	1.0000000
NODE_15974_length_713_cov_6.723127	379	427	14	38	48	0.7916667
NODE_15974_length_713_cov_6.723127	379	427	17	1	48	0.0208333
NODE_15974_length_713_cov_6.723127	379	427	18	9	48	0.1875000
NODE_15975_length_713_cov_4.954397	90	171	0	22	81	0.2716049
NODE_15975_length_713_cov_4.954397	90	171	2	59	81	0.7283950
NODE_15975_length_713_cov_4.954397	144	224	0	10	80	0.1250000
NODE_15975_length_713_cov_4.954397	144	224	2	70	80	0.8750000
NODE_15980_length_713_cov_4.302932	402	482	0	9	80	0.1125000
NODE_15980_length_713_cov_4.302932	402	482	2	71	80	0.8875000
NODE_15980_length_713_cov_4.302932	455	535	0	34	80	0.4250000
NODE_15980_length_713_cov_4.302932	455	535	2	46	80	0.5750000
NODE_16004_length_713_cov_1.939739	15	75	2	60	60	1.0000000
NODE_16010_length_713_cov_1.605863	81	161	0	80	80	1.0000000
NODE_16010_length_713_cov_1.605863	134	214	0	60	80	0.7500000
NODE_16010_length_713_cov_1.605863	134	214	2	20	80	0.2500000
NODE_16052_length_712_cov_32.931485	289	369	0	80	80	1.0000000
NODE_16052_length_712_cov_32.931485	342	422	0	80	80	1.0000000
NODE_16053_length_712_cov_31.752039	185	251	0	66	66	1.0000000
NODE_16053_length_712_cov_31.752039	228	307	0	79	79	1.0000000
NODE_16054_length_712_cov_22.567700	228	308	0	80	80	1.0000000
NODE_16054_length_712_cov_22.567700	281	361	0	80	80	1.0000000
NODE_16055_length_712_cov_19.306688	238	318	0	80	80	1.0000000
NODE_16055_length_712_cov_19.306688	291	371	0	80	80	1.0000000
NODE_16056_length_712_cov_14.929853	332	412	0	39	80	0.4875000
NODE_16056_length_712_cov_14.929853	332	412	2	1	80	0.0125000
NODE_16056_length_712_cov_14.929853	332	412	4	37	80	0.4625000
NODE_16056_length_712_cov_14.929853	332	412	6	3	80	0.0375000
NODE_16056_length_712_cov_14.929853	385	465	4	24	80	0.3000000
NODE_16056_length_712_cov_14.929853	385	465	6	56	80	0.7000000
NODE_16057_length_712_cov_14.228385	250	330	0	14	80	0.1750000
NODE_16057_length_712_cov_14.228385	250	330	4	66	80	0.8250000
NODE_16057_length_712_cov_14.228385	303	383	4	80	80	1.0000000
NODE_16059_length_712_cov_9.221860	326	406	2	80	80	1.0000000
NODE_16059_length_712_cov_9.221860	379	463	0	22	84	0.2619048
NODE_16059_length_712_cov_9.221860	379	463	2	62	84	0.7380952
NODE_16060_length_712_cov_8.368679	331	411	0	80	80	1.0000000
NODE_16060_length_712_cov_8.368679	384	464	0	80	80	1.0000000
NODE_16079_length_712_cov_2.350734	466	510	7	44	44	1.0000000
NODE_16118_length_711_cov_36.459150	146	223	0	77	77	1.0000000
NODE_16118_length_711_cov_36.459150	199	280	0	34	81	0.4197531
NODE_16118_length_711_cov_36.459150	199	280	2	22	81	0.2716049
NODE_16118_length_711_cov_36.459150	199	280	3	2	81	0.0246914
NODE_16118_length_711_cov_36.459150	199	280	4	23	81	0.2839506
NODE_16119_length_711_cov_26.702614	460	540	0	80	80	1.0000000
NODE_16119_length_711_cov_26.702614	513	593	0	80	80	1.0000000
NODE_16120_length_711_cov_19.632353	329	409	0	80	80	1.0000000
NODE_16120_length_711_cov_19.632353	382	462	0	80	80	1.0000000
NODE_16121_length_711_cov_19.267974	283	363	0	34	80	0.4250000
NODE_16121_length_711_cov_19.267974	283	363	2	46	80	0.5750000
NODE_16121_length_711_cov_19.267974	336	416	0	27	80	0.3375000
NODE_16121_length_711_cov_19.267974	336	416	2	53	80	0.6625000
NODE_16122_length_711_cov_12.813725	255	334	0	7	79	0.0886076
NODE_16122_length_711_cov_12.813725	255	334	2	11	79	0.1392405
NODE_16122_length_711_cov_12.813725	255	334	4	61	79	0.7721519
NODE_16123_length_711_cov_12.147059	314	394	0	80	80	1.0000000
NODE_16123_length_711_cov_12.147059	367	447	0	80	80	1.0000000
NODE_16124_length_711_cov_10.009804	336	415	0	79	79	1.0000000
NODE_16127_length_711_cov_5.619281	276	356	0	80	80	1.0000000
NODE_16127_length_711_cov_5.619281	329	409	0	80	80	1.0000000
NODE_16130_length_711_cov_4.040850	165	245	0	58	80	0.7250000
NODE_16130_length_711_cov_4.040850	165	245	4	22	80	0.2750000
NODE_16130_length_711_cov_4.040850	218	298	0	5	80	0.0625000
NODE_16130_length_711_cov_4.040850	218	298	4	75	80	0.9375000
NODE_16167_length_710_cov_73.721768	626	706	0	80	80	1.0000000
NODE_16168_length_710_cov_21.772504	292	372	0	80	80	1.0000000
NODE_16168_length_710_cov_21.772504	345	425	0	80	80	1.0000000
NODE_16169_length_710_cov_21.597381	18	54	0	33	36	0.9166667
NODE_16169_length_710_cov_21.597381	18	54	1	1	36	0.0277778
NODE_16169_length_710_cov_21.597381	18	54	3	2	36	0.0555556
NODE_16170_length_710_cov_13.155483	306	386	2	11	80	0.1375000
NODE_16170_length_710_cov_13.155483	306	386	4	58	80	0.7250000
NODE_16170_length_710_cov_13.155483	306	386	6	11	80	0.1375000
NODE_16170_length_710_cov_13.155483	359	439	4	80	80	1.0000000
NODE_16173_length_710_cov_8.031097	316	396	0	80	80	1.0000000
NODE_16173_length_710_cov_8.031097	369	449	0	80	80	1.0000000
NODE_16175_length_710_cov_6.664484	264	344	0	40	80	0.5000000
NODE_16175_length_710_cov_6.664484	264	344	2	40	80	0.5000000
NODE_16178_length_710_cov_5.590835	352	421	0	35	69	0.5072464
NODE_16178_length_710_cov_5.590835	352	421	2	34	69	0.4927536
NODE_16178_length_710_cov_5.590835	394	474	0	80	80	1.0000000
NODE_16180_length_710_cov_5.356792	248	328	0	26	80	0.3250000
NODE_16180_length_710_cov_5.356792	248	328	2	54	80	0.6750000
NODE_16180_length_710_cov_5.356792	301	381	2	80	80	1.0000000
NODE_16233_length_709_cov_12.227869	347	427	0	80	80	1.0000000
NODE_16233_length_709_cov_12.227869	400	480	0	80	80	1.0000000
NODE_16234_length_709_cov_10.531148	279	359	0	8	80	0.1000000
NODE_16234_length_709_cov_10.531148	279	359	2	72	80	0.9000000
NODE_16234_length_709_cov_10.531148	332	412	2	70	80	0.8750000
NODE_16234_length_709_cov_10.531148	332	412	4	10	80	0.1250000
NODE_16238_length_709_cov_7.181967	225	305	0	45	80	0.5625000
NODE_16238_length_709_cov_7.181967	225	305	2	35	80	0.4375000
NODE_16238_length_709_cov_7.181967	279	312	0	33	33	1.0000000
NODE_16241_length_709_cov_5.888525	239	319	0	80	80	1.0000000
NODE_16241_length_709_cov_5.888525	292	372	0	80	80	1.0000000
NODE_16294_length_708_cov_42.435140	307	387	0	38	80	0.4750000
NODE_16294_length_708_cov_42.435140	307	387	2	42	80	0.5250000
NODE_16294_length_708_cov_42.435140	360	440	0	19	80	0.2375000
NODE_16294_length_708_cov_42.435140	360	440	2	61	80	0.7625000
NODE_16296_length_708_cov_33.412151	235	315	2	11	80	0.1375000
NODE_16296_length_708_cov_33.412151	235	315	4	40	80	0.5000000
NODE_16296_length_708_cov_33.412151	235	315	6	29	80	0.3625000
NODE_16296_length_708_cov_33.412151	288	368	0	18	80	0.2250000
NODE_16296_length_708_cov_33.412151	288	368	2	46	80	0.5750000
NODE_16296_length_708_cov_33.412151	288	368	6	16	80	0.2000000
NODE_16297_length_708_cov_23.034483	316	396	0	80	80	1.0000000
NODE_16297_length_708_cov_23.034483	369	449	0	80	80	1.0000000
NODE_16298_length_708_cov_20.449918	254	334	0	26	80	0.3250000
NODE_16298_length_708_cov_20.449918	254	334	6	6	80	0.0750000
NODE_16298_length_708_cov_20.449918	254	334	10	48	80	0.6000000
NODE_16298_length_708_cov_20.449918	307	387	6	22	80	0.2750000
NODE_16298_length_708_cov_20.449918	307	387	10	58	80	0.7250000
NODE_16299_length_708_cov_19.998358	238	318	0	30	80	0.3750000
NODE_16299_length_708_cov_19.998358	238	318	2	50	80	0.6250000
NODE_16299_length_708_cov_19.998358	291	371	0	80	80	1.0000000
NODE_16300_length_708_cov_19.021346	366	446	0	80	80	1.0000000
NODE_16300_length_708_cov_19.021346	419	499	0	80	80	1.0000000
NODE_16302_length_708_cov_12.228243	181	263	6	25	82	0.3048781
NODE_16302_length_708_cov_12.228243	181	263	7	2	82	0.0243902
NODE_16302_length_708_cov_12.228243	181	263	8	32	82	0.3902439
NODE_16302_length_708_cov_12.228243	181	263	10	23	82	0.2804878
NODE_16302_length_708_cov_12.228243	188	268	6	18	80	0.2250000
NODE_16302_length_708_cov_12.228243	188	268	7	2	80	0.0250000
NODE_16302_length_708_cov_12.228243	188	268	8	32	80	0.4000000
NODE_16302_length_708_cov_12.228243	188	268	10	28	80	0.3500000
NODE_16302_length_708_cov_12.228243	236	316	4	2	80	0.0250000
NODE_16302_length_708_cov_12.228243	236	316	7	37	80	0.4625000
NODE_16302_length_708_cov_12.228243	236	316	8	4	80	0.0500000
NODE_16302_length_708_cov_12.228243	236	316	10	37	80	0.4625000
NODE_16302_length_708_cov_12.228243	312	392	0	33	80	0.4125000
NODE_16302_length_708_cov_12.228243	312	392	1	2	80	0.0250000
NODE_16302_length_708_cov_12.228243	312	392	2	3	80	0.0375000
NODE_16302_length_708_cov_12.228243	312	392	4	40	80	0.5000000
NODE_16302_length_708_cov_12.228243	312	392	7	2	80	0.0250000
NODE_16302_length_708_cov_12.228243	312	392	0	33	80	0.4125000
NODE_16302_length_708_cov_12.228243	312	392	1	2	80	0.0250000
NODE_16302_length_708_cov_12.228243	312	392	2	3	80	0.0375000
NODE_16302_length_708_cov_12.228243	312	392	4	40	80	0.5000000
NODE_16302_length_708_cov_12.228243	312	392	7	2	80	0.0250000
NODE_16302_length_708_cov_12.228243	365	445	0	76	80	0.9500000
NODE_16302_length_708_cov_12.228243	365	445	2	4	80	0.0500000
NODE_16303_length_708_cov_11.338259	255	335	0	80	80	1.0000000
NODE_16303_length_708_cov_11.338259	308	388	0	80	80	1.0000000
NODE_16305_length_708_cov_9.676519	219	299	0	80	80	1.0000000
NODE_16305_length_708_cov_9.676519	272	352	0	80	80	1.0000000
NODE_16306_length_708_cov_8.638752	324	399	0	75	75	1.0000000
NODE_16330_length_708_cov_2.699507	358	398	2	33	40	0.8250000
NODE_16330_length_708_cov_2.699507	358	398	4	7	40	0.1750000
NODE_16370_length_707_cov_30.067434	325	405	0	38	80	0.4750000
NODE_16370_length_707_cov_30.067434	325	405	2	42	80	0.5250000
NODE_16370_length_707_cov_30.067434	378	458	0	80	80	1.0000000
NODE_16371_length_707_cov_26.555921	241	321	0	80	80	1.0000000
NODE_16371_length_707_cov_26.555921	294	374	0	80	80	1.0000000
NODE_16372_length_707_cov_23.972039	322	402	0	37	80	0.4625000
NODE_16372_length_707_cov_23.972039	322	402	4	43	80	0.5375000
NODE_16372_length_707_cov_23.972039	375	455	0	80	80	1.0000000
NODE_16373_length_707_cov_20.348684	157	237	5	19	80	0.2375000
NODE_16373_length_707_cov_20.348684	157	237	6	61	80	0.7625000
NODE_16373_length_707_cov_20.348684	210	281	0	42	71	0.5915493
NODE_16373_length_707_cov_20.348684	210	281	5	21	71	0.2957746
NODE_16373_length_707_cov_20.348684	210	281	6	8	71	0.1126761
NODE_16374_length_707_cov_18.970395	253	333	0	6	80	0.0750000
NODE_16374_length_707_cov_18.970395	253	333	6	74	80	0.9250000
NODE_16374_length_707_cov_18.970395	306	386	6	80	80	1.0000000
NODE_16375_length_707_cov_14.324013	302	382	0	80	80	1.0000000
NODE_16375_length_707_cov_14.324013	355	435	0	80	80	1.0000000
NODE_16378_length_707_cov_5.062500	313	393	0	62	80	0.7750000
NODE_16378_length_707_cov_5.062500	313	393	2	18	80	0.2250000
NODE_16441_length_706_cov_34.116969	272	352	1	15	80	0.1875000
NODE_16441_length_706_cov_34.116969	272	352	2	12	80	0.1500000
NODE_16441_length_706_cov_34.116969	272	352	3	46	80	0.5750000
NODE_16441_length_706_cov_34.116969	272	352	5	7	80	0.0875000
NODE_16441_length_706_cov_34.116969	325	405	3	20	80	0.2500000
NODE_16441_length_706_cov_34.116969	325	405	4	15	80	0.1875000
NODE_16441_length_706_cov_34.116969	325	405	5	29	80	0.3625000
NODE_16441_length_706_cov_34.116969	325	405	6	16	80	0.2000000
NODE_16442_length_706_cov_27.220758	229	309	0	78	80	0.9750000
NODE_16442_length_706_cov_27.220758	229	309	2	2	80	0.0250000
NODE_16442_length_706_cov_27.220758	282	362	0	25	80	0.3125000
NODE_16442_length_706_cov_27.220758	282	362	2	55	80	0.6875000
NODE_16443_length_706_cov_20.380560	264	344	6	18	80	0.2250000
NODE_16443_length_706_cov_20.380560	264	344	8	62	80	0.7750000
NODE_16443_length_706_cov_20.380560	317	397	0	13	80	0.1625000
NODE_16443_length_706_cov_20.380560	317	397	6	58	80	0.7250000
NODE_16443_length_706_cov_20.380560	317	397	8	9	80	0.1125000
NODE_16444_length_706_cov_19.525535	289	369	0	80	80	1.0000000
NODE_16444_length_706_cov_19.525535	342	422	0	80	80	1.0000000
NODE_16454_length_706_cov_3.344316	465	545	0	80	80	1.0000000
NODE_16454_length_706_cov_3.344316	518	598	0	80	80	1.0000000
NODE_16494_length_705_cov_19.211221	118	198	0	29	80	0.3625000
NODE_16494_length_705_cov_19.211221	118	198	4	51	80	0.6375000
NODE_16494_length_705_cov_19.211221	171	250	0	9	79	0.1139240
NODE_16494_length_705_cov_19.211221	171	250	3	29	79	0.3670886
NODE_16494_length_705_cov_19.211221	171	250	4	41	79	0.5189874
NODE_16495_length_705_cov_16.338284	291	339	0	7	48	0.1458333
NODE_16495_length_705_cov_16.338284	291	339	2	41	48	0.8541667
NODE_16495_length_705_cov_16.338284	336	406	0	27	70	0.3857143
NODE_16495_length_705_cov_16.338284	336	406	2	43	70	0.6142857
NODE_16496_length_705_cov_14.354785	209	289	0	80	80	1.0000000
NODE_16496_length_705_cov_14.354785	262	342	0	80	80	1.0000000
NODE_16497_length_705_cov_12.231023	293	373	0	80	80	1.0000000
NODE_16497_length_705_cov_12.231023	346	426	0	80	80	1.0000000
NODE_16498_length_705_cov_11.836634	390	470	0	80	80	1.0000000
NODE_16498_length_705_cov_11.836634	443	523	0	80	80	1.0000000
NODE_16499_length_705_cov_10.049505	382	479	2	19	97	0.1958763
NODE_16499_length_705_cov_10.049505	382	479	4	78	97	0.8041237
NODE_16499_length_705_cov_10.049505	452	532	0	32	80	0.4000000
NODE_16499_length_705_cov_10.049505	452	532	2	12	80	0.1500000
NODE_16499_length_705_cov_10.049505	452	532	4	36	80	0.4500000
NODE_16507_length_705_cov_4.275578	358	438	0	80	80	1.0000000
NODE_16507_length_705_cov_4.275578	411	491	0	80	80	1.0000000
NODE_16509_length_705_cov_4.018152	306	364	2	24	58	0.4137931
NODE_16509_length_705_cov_4.018152	306	364	4	34	58	0.5862069
NODE_16509_length_705_cov_4.018152	337	410	4	60	73	0.8219178
NODE_16509_length_705_cov_4.018152	337	410	6	13	73	0.1780822
NODE_16511_length_705_cov_3.620462	253	315	4	16	62	0.2580645
NODE_16511_length_705_cov_3.620462	253	315	6	46	62	0.7419355
NODE_16511_length_705_cov_3.620462	308	368	0	27	60	0.4500000
NODE_16511_length_705_cov_3.620462	308	368	2	21	60	0.3500000
NODE_16511_length_705_cov_3.620462	308	368	4	12	60	0.2000000
NODE_16527_length_705_cov_1.607261	462	531	0	46	69	0.6666667
NODE_16527_length_705_cov_1.607261	462	531	2	23	69	0.3333333
NODE_16549_length_705_cov_0.529703	33	97	6	12	64	0.1875000
NODE_16549_length_705_cov_0.529703	33	97	8	52	64	0.8125000
NODE_16549_length_705_cov_0.529703	86	150	2	27	64	0.4218750
NODE_16549_length_705_cov_0.529703	86	150	6	28	64	0.4375000
NODE_16549_length_705_cov_0.529703	86	150	8	9	64	0.1406250
NODE_16550_length_704_cov_18.256198	295	375	0	80	80	1.0000000
NODE_16550_length_704_cov_18.256198	348	428	0	80	80	1.0000000
NODE_16552_length_704_cov_16.662810	264	344	0	39	80	0.4875000
NODE_16552_length_704_cov_16.662810	264	344	2	41	80	0.5125000
NODE_16552_length_704_cov_16.662810	317	397	0	14	80	0.1750000
NODE_16552_length_704_cov_16.662810	317	397	2	66	80	0.8250000
NODE_16553_length_704_cov_12.641322	294	374	1	3	80	0.0375000
NODE_16553_length_704_cov_12.641322	294	374	2	77	80	0.9625000
NODE_16553_length_704_cov_12.641322	347	427	0	42	80	0.5250000
NODE_16553_length_704_cov_12.641322	347	427	1	14	80	0.1750000
NODE_16553_length_704_cov_12.641322	347	427	2	24	80	0.3000000
NODE_16557_length_704_cov_5.603306	440	498	0	58	58	1.0000000
NODE_16564_length_704_cov_3.535537	303	383	0	80	80	1.0000000
NODE_16564_length_704_cov_3.535537	369	436	0	67	67	1.0000000
NODE_16578_length_704_cov_1.963636	345	425	4	9	80	0.1125000
NODE_16578_length_704_cov_1.963636	345	425	6	20	80	0.2500000
NODE_16578_length_704_cov_1.963636	345	425	8	51	80	0.6375000
NODE_16578_length_704_cov_1.963636	398	478	6	23	80	0.2875000
NODE_16578_length_704_cov_1.963636	398	478	8	57	80	0.7125000
NODE_16598_length_703_cov_44.102649	514	594	0	64	80	0.8000000
NODE_16598_length_703_cov_44.102649	514	594	2	16	80	0.2000000
NODE_16598_length_703_cov_44.102649	567	647	0	11	80	0.1375000
NODE_16598_length_703_cov_44.102649	567	647	2	69	80	0.8625000
NODE_16599_length_703_cov_33.067881	521	594	131	2	73	0.0273973
NODE_16599_length_703_cov_33.067881	521	594	137	1	73	0.0136986
NODE_16599_length_703_cov_33.067881	521	594	138	2	73	0.0273973
NODE_16599_length_703_cov_33.067881	521	594	139	3	73	0.0410959
NODE_16599_length_703_cov_33.067881	521	594	140	6	73	0.0821918
NODE_16599_length_703_cov_33.067881	521	594	141	8	73	0.1095890
NODE_16599_length_703_cov_33.067881	521	594	142	3	73	0.0410959
NODE_16599_length_703_cov_33.067881	521	594	143	4	73	0.0547945
NODE_16599_length_703_cov_33.067881	521	594	144	6	73	0.0821918
NODE_16599_length_703_cov_33.067881	521	594	145	4	73	0.0547945
NODE_16599_length_703_cov_33.067881	521	594	146	1	73	0.0136986
NODE_16599_length_703_cov_33.067881	521	594	147	6	73	0.0821918
NODE_16599_length_703_cov_33.067881	521	594	148	2	73	0.0273973
NODE_16599_length_703_cov_33.067881	521	594	149	2	73	0.0273973
NODE_16599_length_703_cov_33.067881	521	594	150	5	73	0.0684932
NODE_16599_length_703_cov_33.067881	521	594	151	4	73	0.0547945
NODE_16599_length_703_cov_33.067881	521	594	152	4	73	0.0547945
NODE_16599_length_703_cov_33.067881	521	594	153	7	73	0.0958904
NODE_16599_length_703_cov_33.067881	521	594	154	1	73	0.0136986
NODE_16599_length_703_cov_33.067881	521	594	155	1	73	0.0136986
NODE_16599_length_703_cov_33.067881	521	594	157	1	73	0.0136986
NODE_16599_length_703_cov_33.067881	561	602	144	4	41	0.0975610
NODE_16599_length_703_cov_33.067881	561	602	145	1	41	0.0243902
NODE_16599_length_703_cov_33.067881	561	602	146	2	41	0.0487805
NODE_16599_length_703_cov_33.067881	561	602	147	4	41	0.0975610
NODE_16599_length_703_cov_33.067881	561	602	148	1	41	0.0243902
NODE_16599_length_703_cov_33.067881	561	602	149	9	41	0.2195122
NODE_16599_length_703_cov_33.067881	561	602	150	5	41	0.1219512
NODE_16599_length_703_cov_33.067881	561	602	151	4	41	0.0975610
NODE_16599_length_703_cov_33.067881	561	602	152	4	41	0.0975610
NODE_16599_length_703_cov_33.067881	561	602	153	6	41	0.1463415
NODE_16599_length_703_cov_33.067881	561	602	154	1	41	0.0243902
NODE_16600_length_703_cov_30.266556	312	392	0	32	80	0.4000000
NODE_16600_length_703_cov_30.266556	312	392	2	48	80	0.6000000
NODE_16600_length_703_cov_30.266556	365	445	0	80	80	1.0000000
NODE_16601_length_703_cov_17.006623	449	529	0	1	80	0.0125000
NODE_16601_length_703_cov_17.006623	449	529	1	1	80	0.0125000
NODE_16601_length_703_cov_17.006623	449	529	2	78	80	0.9750000
NODE_16601_length_703_cov_17.006623	502	582	2	63	80	0.7875000
NODE_16601_length_703_cov_17.006623	502	582	4	17	80	0.2125000
NODE_16602_length_703_cov_14.801325	383	463	2	57	80	0.7125000
NODE_16602_length_703_cov_14.801325	383	463	4	23	80	0.2875000
NODE_16602_length_703_cov_14.801325	436	516	2	4	80	0.0500000
NODE_16602_length_703_cov_14.801325	436	516	4	74	80	0.9250000
NODE_16602_length_703_cov_14.801325	436	516	6	2	80	0.0250000
NODE_16603_length_703_cov_11.766556	308	388	0	72	80	0.9000000
NODE_16603_length_703_cov_11.766556	308	388	2	8	80	0.1000000
NODE_16603_length_703_cov_11.766556	361	441	0	19	80	0.2375000
NODE_16603_length_703_cov_11.766556	361	441	2	61	80	0.7625000
NODE_16604_length_703_cov_10.405629	213	293	6	2	80	0.0250000
NODE_16604_length_703_cov_10.405629	213	293	8	3	80	0.0375000
NODE_16604_length_703_cov_10.405629	213	293	12	24	80	0.3000000
NODE_16604_length_703_cov_10.405629	213	293	14	51	80	0.6375000
NODE_16604_length_703_cov_10.405629	266	301	4	5	35	0.1428571
NODE_16604_length_703_cov_10.405629	266	301	6	5	35	0.1428571
NODE_16604_length_703_cov_10.405629	266	301	8	3	35	0.0857143
NODE_16604_length_703_cov_10.405629	266	301	12	22	35	0.6285715
NODE_16605_length_703_cov_6.966887	381	440	0	59	59	1.0000000
NODE_16616_length_703_cov_3.491722	256	309	0	40	53	0.7547170
NODE_16616_length_703_cov_3.491722	256	309	2	13	53	0.2452830
NODE_16616_length_703_cov_3.491722	257	337	0	39	80	0.4875000
NODE_16616_length_703_cov_3.491722	257	337	2	28	80	0.3500000
NODE_16616_length_703_cov_3.491722	257	337	4	13	80	0.1625000
NODE_16616_length_703_cov_3.491722	305	362	2	19	57	0.3333333
NODE_16616_length_703_cov_3.491722	305	362	4	38	57	0.6666667
NODE_16624_length_703_cov_2.687086	216	296	0	80	80	1.0000000
NODE_16624_length_703_cov_2.687086	269	349	0	80	80	1.0000000
NODE_16663_length_702_cov_49.784411	221	299	0	72	78	0.9230769
NODE_16663_length_702_cov_49.784411	221	299	4	6	78	0.0769231
NODE_16663_length_702_cov_49.784411	277	352	0	16	75	0.2133333
NODE_16663_length_702_cov_49.784411	277	352	4	59	75	0.7866667
NODE_16664_length_702_cov_26.570481	201	281	0	52	80	0.6500000
NODE_16664_length_702_cov_26.570481	201	281	2	28	80	0.3500000
NODE_16664_length_702_cov_26.570481	254	334	0	80	80	1.0000000
NODE_16665_length_702_cov_23.971808	139	219	0	41	80	0.5125000
NODE_16665_length_702_cov_23.971808	139	219	2	39	80	0.4875000
NODE_16665_length_702_cov_23.971808	192	272	0	80	80	1.0000000
NODE_16665_length_702_cov_23.971808	268	348	0	80	80	1.0000000
NODE_16665_length_702_cov_23.971808	321	401	0	80	80	1.0000000
NODE_16666_length_702_cov_23.827529	448	528	0	14	80	0.1750000
NODE_16666_length_702_cov_23.827529	448	528	2	66	80	0.8250000
NODE_16666_length_702_cov_23.827529	501	581	0	10	80	0.1250000
NODE_16666_length_702_cov_23.827529	501	581	2	70	80	0.8750000
NODE_16667_length_702_cov_14.661692	424	504	0	80	80	1.0000000
NODE_16667_length_702_cov_14.661692	477	557	0	80	80	1.0000000
NODE_16668_length_702_cov_13.908789	259	304	4	21	45	0.4666667
NODE_16668_length_702_cov_13.908789	259	304	10	24	45	0.5333334
NODE_16668_length_702_cov_13.908789	277	357	4	3	80	0.0375000
NODE_16668_length_702_cov_13.908789	277	357	10	24	80	0.3000000
NODE_16668_length_702_cov_13.908789	277	357	14	1	80	0.0125000
NODE_16668_length_702_cov_13.908789	277	357	15	9	80	0.1125000
NODE_16668_length_702_cov_13.908789	277	357	16	43	80	0.5375000
NODE_16668_length_702_cov_13.908789	289	357	10	15	68	0.2205882
NODE_16668_length_702_cov_13.908789	289	357	14	1	68	0.0147059
NODE_16668_length_702_cov_13.908789	289	357	15	9	68	0.1323529
NODE_16668_length_702_cov_13.908789	289	357	16	43	68	0.6323529
NODE_16669_length_702_cov_8.502488	337	417	0	80	80	1.0000000
NODE_16669_length_702_cov_8.502488	390	470	0	80	80	1.0000000
NODE_16671_length_702_cov_6.470978	209	289	0	80	80	1.0000000
NODE_16671_length_702_cov_6.470978	262	342	0	80	80	1.0000000
NODE_16729_length_701_cov_38.715947	178	258	0	36	80	0.4500000
NODE_16729_length_701_cov_38.715947	178	258	2	44	80	0.5500000
NODE_16729_length_701_cov_38.715947	231	311	2	80	80	1.0000000
NODE_16729_length_701_cov_38.715947	307	387	0	75	80	0.9375000
NODE_16729_length_701_cov_38.715947	307	387	2	5	80	0.0625000
NODE_16729_length_701_cov_38.715947	360	440	0	80	80	1.0000000
NODE_16730_length_701_cov_28.059801	432	513	0	81	81	1.0000000
NODE_16730_length_701_cov_28.059801	486	566	0	80	80	1.0000000
NODE_16731_length_701_cov_18.387043	258	338	0	2	80	0.0250000
NODE_16731_length_701_cov_18.387043	258	338	6	78	80	0.9750000
NODE_16731_length_701_cov_18.387043	311	391	6	80	80	1.0000000
NODE_16732_length_701_cov_17.122924	295	367	6	23	72	0.3194444
NODE_16732_length_701_cov_17.122924	295	367	7	11	72	0.1527778
NODE_16732_length_701_cov_17.122924	295	367	9	7	72	0.0972222
NODE_16732_length_701_cov_17.122924	295	367	10	31	72	0.4305556
NODE_16733_length_701_cov_16.114618	242	322	0	16	80	0.2000000
NODE_16733_length_701_cov_16.114618	242	322	2	64	80	0.8000000
NODE_16733_length_701_cov_16.114618	295	375	0	32	80	0.4000000
NODE_16733_length_701_cov_16.114618	295	375	2	48	80	0.6000000
NODE_16734_length_701_cov_15.588040	399	479	2	80	80	1.0000000
NODE_16734_length_701_cov_15.588040	452	532	0	28	80	0.3500000
NODE_16734_length_701_cov_15.588040	452	532	2	52	80	0.6500000
NODE_16736_length_701_cov_11.420266	229	309	0	80	80	1.0000000
NODE_16736_length_701_cov_11.420266	282	362	0	80	80	1.0000000
NODE_16737_length_701_cov_10.411960	202	283	0	81	81	1.0000000
NODE_16737_length_701_cov_10.411960	256	336	0	80	80	1.0000000
NODE_16738_length_701_cov_9.107973	400	480	0	9	80	0.1125000
NODE_16738_length_701_cov_9.107973	400	480	2	71	80	0.8875000
NODE_16738_length_701_cov_9.107973	453	533	0	7	80	0.0875000
NODE_16738_length_701_cov_9.107973	453	533	2	73	80	0.9125000
NODE_16739_length_701_cov_8.877076	283	363	0	80	80	1.0000000
NODE_16739_length_701_cov_8.877076	336	416	0	80	80	1.0000000
NODE_16740_length_701_cov_8.543189	341	421	0	80	80	1.0000000
NODE_16740_length_701_cov_8.543189	394	474	0	80	80	1.0000000
NODE_16742_length_701_cov_6.317276	273	353	0	26	80	0.3250000
NODE_16742_length_701_cov_6.317276	273	353	2	54	80	0.6750000
NODE_16742_length_701_cov_6.317276	326	382	0	55	56	0.9821429
NODE_16742_length_701_cov_6.317276	326	382	2	1	56	0.0178571
NODE_16747_length_701_cov_5.081395	318	374	14	17	56	0.3035714
NODE_16747_length_701_cov_5.081395	318	374	22	12	56	0.2142857
NODE_16747_length_701_cov_5.081395	318	374	23	13	56	0.2321429
NODE_16747_length_701_cov_5.081395	318	374	24	14	56	0.2500000
NODE_16752_length_701_cov_3.320598	207	287	0	80	80	1.0000000
NODE_16752_length_701_cov_3.320598	260	340	0	80	80	1.0000000
NODE_16794_length_700_cov_22.241265	326	406	11	7	80	0.0875000
NODE_16794_length_700_cov_22.241265	326	406	13	1	80	0.0125000
NODE_16794_length_700_cov_22.241265	326	406	14	4	80	0.0500000
NODE_16794_length_700_cov_22.241265	326	406	15	2	80	0.0250000
NODE_16794_length_700_cov_22.241265	326	406	16	4	80	0.0500000
NODE_16794_length_700_cov_22.241265	326	406	17	3	80	0.0375000
NODE_16794_length_700_cov_22.241265	326	406	21	21	80	0.2625000
NODE_16794_length_700_cov_22.241265	326	406	25	6	80	0.0750000
NODE_16794_length_700_cov_22.241265	326	406	27	8	80	0.1000000
NODE_16794_length_700_cov_22.241265	326	406	29	14	80	0.1750000
NODE_16794_length_700_cov_22.241265	326	406	30	3	80	0.0375000
NODE_16794_length_700_cov_22.241265	326	406	32	6	80	0.0750000
NODE_16794_length_700_cov_22.241265	326	406	34	1	80	0.0125000
NODE_16796_length_700_cov_11.730449	294	374	0	80	80	1.0000000
NODE_16796_length_700_cov_11.730449	347	427	0	33	80	0.4125000
NODE_16796_length_700_cov_11.730449	347	427	4	47	80	0.5875000
NODE_16800_length_700_cov_7.291181	317	397	2	80	80	1.0000000
NODE_16800_length_700_cov_7.291181	370	450	2	80	80	1.0000000
NODE_16801_length_700_cov_6.557404	353	404	0	51	51	1.0000000
NODE_16802_length_700_cov_5.475874	301	381	0	15	80	0.1875000
NODE_16802_length_700_cov_5.475874	301	381	1	40	80	0.5000000
NODE_16802_length_700_cov_5.475874	301	381	2	25	80	0.3125000
NODE_16802_length_700_cov_5.475874	354	434	0	68	80	0.8500000
NODE_16802_length_700_cov_5.475874	354	434	1	12	80	0.1500000
NODE_16803_length_700_cov_3.960067	158	234	2	76	76	1.0000000
NODE_16803_length_700_cov_3.960067	209	291	0	40	82	0.4878049
NODE_16803_length_700_cov_3.960067	209	291	2	42	82	0.5121951
NODE_16822_length_700_cov_1.517471	324	404	0	80	80	1.0000000
NODE_16822_length_700_cov_1.517471	377	457	0	80	80	1.0000000
NODE_16844_length_699_cov_18.446667	185	265	0	57	80	0.7125000
NODE_16844_length_699_cov_18.446667	185	265	2	23	80	0.2875000
NODE_16844_length_699_cov_18.446667	238	318	0	4	80	0.0500000
NODE_16844_length_699_cov_18.446667	238	318	2	55	80	0.6875000
NODE_16844_length_699_cov_18.446667	238	318	4	21	80	0.2625000
NODE_16845_length_699_cov_18.383333	258	338	0	38	80	0.4750000
NODE_16845_length_699_cov_18.383333	258	338	4	42	80	0.5250000
NODE_16845_length_699_cov_18.383333	311	391	0	12	80	0.1500000
NODE_16845_length_699_cov_18.383333	311	391	4	68	80	0.8500000
NODE_16846_length_699_cov_18.103333	218	298	0	80	80	1.0000000
NODE_16846_length_699_cov_18.103333	271	351	0	63	80	0.7875000
NODE_16846_length_699_cov_18.103333	271	351	4	17	80	0.2125000
NODE_16847_length_699_cov_15.636667	279	359	0	80	80	1.0000000
NODE_16847_length_699_cov_15.636667	332	412	0	80	80	1.0000000
NODE_16848_length_699_cov_15.113333	313	393	4	80	80	1.0000000
NODE_16848_length_699_cov_15.113333	366	446	0	34	80	0.4250000
NODE_16848_length_699_cov_15.113333	366	446	4	46	80	0.5750000
NODE_16849_length_699_cov_10.070000	233	313	0	80	80	1.0000000
NODE_16849_length_699_cov_10.070000	286	366	0	80	80	1.0000000
NODE_16849_length_699_cov_10.070000	362	442	0	80	80	1.0000000
NODE_16849_length_699_cov_10.070000	415	495	0	80	80	1.0000000
NODE_16850_length_699_cov_8.083333	347	427	0	80	80	1.0000000
NODE_16850_length_699_cov_8.083333	400	480	0	80	80	1.0000000
NODE_16851_length_699_cov_7.758333	307	387	0	80	80	1.0000000
NODE_16851_length_699_cov_7.758333	360	440	0	80	80	1.0000000
NODE_16852_length_699_cov_7.713333	252	332	0	67	80	0.8375000
NODE_16852_length_699_cov_7.713333	252	332	2	13	80	0.1625000
NODE_16852_length_699_cov_7.713333	305	385	0	14	80	0.1750000
NODE_16852_length_699_cov_7.713333	305	385	2	66	80	0.8250000
NODE_16853_length_699_cov_7.186667	271	332	0	61	61	1.0000000
NODE_16853_length_699_cov_7.186667	348	428	0	80	80	1.0000000
NODE_16857_length_699_cov_5.815000	243	316	4	73	73	1.0000000
NODE_16857_length_699_cov_5.815000	293	374	0	1	81	0.0123457
NODE_16857_length_699_cov_5.815000	293	374	1	14	81	0.1728395
NODE_16857_length_699_cov_5.815000	293	374	2	21	81	0.2592593
NODE_16857_length_699_cov_5.815000	293	374	4	45	81	0.5555556
NODE_16858_length_699_cov_5.520000	302	382	0	48	80	0.6000000
NODE_16858_length_699_cov_5.520000	302	382	2	32	80	0.4000000
NODE_16858_length_699_cov_5.520000	355	435	0	25	80	0.3125000
NODE_16858_length_699_cov_5.520000	355	435	2	55	80	0.6875000
NODE_16860_length_699_cov_4.051667	289	369	0	80	80	1.0000000
NODE_16860_length_699_cov_4.051667	342	422	0	80	80	1.0000000
NODE_16868_length_699_cov_2.498333	204	284	0	80	80	1.0000000
NODE_16868_length_699_cov_2.498333	257	337	0	80	80	1.0000000
NODE_16908_length_698_cov_47.350584	321	401	0	80	80	1.0000000
NODE_16908_length_698_cov_47.350584	374	454	0	80	80	1.0000000
NODE_16909_length_698_cov_42.848080	255	335	0	80	80	1.0000000
NODE_16909_length_698_cov_42.848080	308	388	0	80	80	1.0000000
NODE_16910_length_698_cov_36.697830	366	446	0	80	80	1.0000000
NODE_16910_length_698_cov_36.697830	419	484	0	65	65	1.0000000
NODE_16911_length_698_cov_23.874791	222	302	0	80	80	1.0000000
NODE_16911_length_698_cov_23.874791	275	355	0	80	80	1.0000000
NODE_16912_length_698_cov_7.133556	360	440	0	80	80	1.0000000
NODE_16912_length_698_cov_7.133556	413	493	0	80	80	1.0000000
NODE_16913_length_698_cov_6.520868	267	347	0	80	80	1.0000000
NODE_16913_length_698_cov_6.520868	320	400	0	80	80	1.0000000
NODE_16917_length_698_cov_4.762938	329	359	2	30	30	1.0000000
NODE_16926_length_698_cov_2.577629	309	389	0	80	80	1.0000000
NODE_16926_length_698_cov_2.577629	362	442	0	80	80	1.0000000
NODE_16962_length_697_cov_16.013378	305	385	0	42	80	0.5250000
NODE_16962_length_697_cov_16.013378	305	385	4	38	80	0.4750000
NODE_16962_length_697_cov_16.013378	358	438	0	8	80	0.1000000
NODE_16962_length_697_cov_16.013378	358	438	3	15	80	0.1875000
NODE_16962_length_697_cov_16.013378	358	438	4	57	80	0.7125000
NODE_16963_length_697_cov_14.411371	440	520	6	1	80	0.0125000
NODE_16963_length_697_cov_14.411371	440	520	8	79	80	0.9875000
NODE_16963_length_697_cov_14.411371	493	573	0	24	80	0.3000000
NODE_16963_length_697_cov_14.411371	493	573	2	29	80	0.3625000
NODE_16963_length_697_cov_14.411371	493	573	8	27	80	0.3375000
NODE_16964_length_697_cov_14.282609	257	354	2	96	97	0.9896907
NODE_16964_length_697_cov_14.282609	257	354	4	1	97	0.0103093
NODE_16964_length_697_cov_14.282609	327	385	0	24	58	0.4137931
NODE_16964_length_697_cov_14.282609	327	385	2	34	58	0.5862069
NODE_16965_length_697_cov_9.969900	360	440	0	80	80	1.0000000
NODE_16965_length_697_cov_9.969900	413	493	0	80	80	1.0000000
NODE_16968_length_697_cov_6.117057	236	316	2	80	80	1.0000000
NODE_16968_length_697_cov_6.117057	289	369	0	41	80	0.5125000
NODE_16968_length_697_cov_6.117057	289	369	1	1	80	0.0125000
NODE_16968_length_697_cov_6.117057	289	369	2	38	80	0.4750000
NODE_17025_length_696_cov_28.360134	319	399	0	80	80	1.0000000
NODE_17025_length_696_cov_28.360134	372	452	0	80	80	1.0000000
NODE_17026_length_696_cov_18.708543	367	447	0	80	80	1.0000000
NODE_17026_length_696_cov_18.708543	420	500	0	80	80	1.0000000
NODE_17027_length_696_cov_18.170854	390	470	0	80	80	1.0000000
NODE_17027_length_696_cov_18.170854	443	523	0	80	80	1.0000000
NODE_17028_length_696_cov_13.738693	266	346	0	79	80	0.9875000
NODE_17028_length_696_cov_13.738693	266	346	2	1	80	0.0125000
NODE_17028_length_696_cov_13.738693	319	399	0	26	80	0.3250000
NODE_17028_length_696_cov_13.738693	319	399	2	54	80	0.6750000
NODE_17030_length_696_cov_10.693467	239	266	8	27	27	1.0000000
NODE_17031_length_696_cov_9.949749	248	328	0	80	80	1.0000000
NODE_17031_length_696_cov_9.949749	301	381	0	36	80	0.4500000
NODE_17031_length_696_cov_9.949749	301	381	1	22	80	0.2750000
NODE_17031_length_696_cov_9.949749	301	381	2	22	80	0.2750000
NODE_17032_length_696_cov_8.658291	247	327	0	80	80	1.0000000
NODE_17032_length_696_cov_8.658291	300	380	0	80	80	1.0000000
NODE_17032_length_696_cov_8.658291	376	456	0	80	80	1.0000000
NODE_17032_length_696_cov_8.658291	429	509	0	80	80	1.0000000
NODE_17068_length_696_cov_1.675042	498	543	2	1	45	0.0222222
NODE_17068_length_696_cov_1.675042	498	543	3	32	45	0.7111111
NODE_17068_length_696_cov_1.675042	498	543	4	12	45	0.2666667
NODE_17100_length_695_cov_24.112416	388	468	2	80	80	1.0000000
NODE_17100_length_695_cov_24.112416	441	521	0	14	80	0.1750000
NODE_17100_length_695_cov_24.112416	441	521	1	38	80	0.4750000
NODE_17100_length_695_cov_24.112416	441	521	2	28	80	0.3500000
NODE_17101_length_695_cov_12.152685	349	429	2	80	80	1.0000000
NODE_17101_length_695_cov_12.152685	402	482	0	41	80	0.5125000
NODE_17101_length_695_cov_12.152685	402	482	2	39	80	0.4875000
NODE_17103_length_695_cov_8.466443	345	425	0	80	80	1.0000000
NODE_17103_length_695_cov_8.466443	398	478	0	45	80	0.5625000
NODE_17103_length_695_cov_8.466443	398	478	2	35	80	0.4375000
NODE_17106_length_695_cov_5.661074	283	363	0	80	80	1.0000000
NODE_17106_length_695_cov_5.661074	346	416	0	70	70	1.0000000
NODE_17124_length_695_cov_2.050336	36	112	0	61	76	0.8026316
NODE_17124_length_695_cov_2.050336	36	112	2	15	76	0.1973684
NODE_17161_length_694_cov_46.675630	30	110	6	7	80	0.0875000
NODE_17161_length_694_cov_46.675630	30	110	10	73	80	0.9125000
NODE_17161_length_694_cov_46.675630	83	163	6	60	80	0.7500000
NODE_17161_length_694_cov_46.675630	83	163	10	20	80	0.2500000
NODE_17161_length_694_cov_46.675630	159	239	0	68	80	0.8500000
NODE_17161_length_694_cov_46.675630	159	239	6	12	80	0.1500000
NODE_17161_length_694_cov_46.675630	212	292	0	80	80	1.0000000
NODE_17162_length_694_cov_12.850420	326	406	0	80	80	1.0000000
NODE_17162_length_694_cov_12.850420	379	459	0	80	80	1.0000000
NODE_17163_length_694_cov_7.236975	318	396	0	78	78	1.0000000
NODE_17163_length_694_cov_7.236975	371	450	0	79	79	1.0000000
NODE_17166_length_694_cov_5.554622	404	484	0	11	80	0.1375000
NODE_17166_length_694_cov_5.554622	404	484	2	40	80	0.5000000
NODE_17166_length_694_cov_5.554622	404	484	5	8	80	0.1000000
NODE_17166_length_694_cov_5.554622	404	484	10	21	80	0.2625000
NODE_17166_length_694_cov_5.554622	457	537	2	80	80	1.0000000
NODE_17168_length_694_cov_5.373109	152	232	0	80	80	1.0000000
NODE_17168_length_694_cov_5.373109	205	285	0	80	80	1.0000000
NODE_17227_length_693_cov_26.616162	435	515	0	80	80	1.0000000
NODE_17227_length_693_cov_26.616162	488	568	0	80	80	1.0000000
NODE_17228_length_693_cov_23.552189	193	273	0	71	80	0.8875000
NODE_17228_length_693_cov_23.552189	193	273	2	9	80	0.1125000
NODE_17228_length_693_cov_23.552189	246	326	0	80	80	1.0000000
NODE_17229_length_693_cov_22.848485	231	311	0	80	80	1.0000000
NODE_17229_length_693_cov_22.848485	284	364	0	80	80	1.0000000
NODE_17230_length_693_cov_13.616162	219	299	0	80	80	1.0000000
NODE_17230_length_693_cov_13.616162	272	352	0	80	80	1.0000000
NODE_17231_length_693_cov_12.382155	305	385	0	16	80	0.2000000
NODE_17231_length_693_cov_12.382155	305	385	13	30	80	0.3750000
NODE_17231_length_693_cov_12.382155	305	385	14	34	80	0.4250000
NODE_17231_length_693_cov_12.382155	358	424	13	66	66	1.0000000
NODE_17232_length_693_cov_10.053872	279	359	0	80	80	1.0000000
NODE_17232_length_693_cov_10.053872	332	412	0	80	80	1.0000000
NODE_17233_length_693_cov_9.659933	247	327	0	80	80	1.0000000
NODE_17233_length_693_cov_9.659933	300	380	0	49	80	0.6125000
NODE_17233_length_693_cov_9.659933	300	380	2	18	80	0.2250000
NODE_17233_length_693_cov_9.659933	300	380	4	13	80	0.1625000
NODE_17235_length_693_cov_8.077441	343	423	0	80	80	1.0000000
NODE_17235_length_693_cov_8.077441	396	476	0	29	80	0.3625000
NODE_17235_length_693_cov_8.077441	396	476	5	34	80	0.4250000
NODE_17235_length_693_cov_8.077441	396	476	6	17	80	0.2125000
NODE_17243_length_693_cov_3.680135	250	321	0	71	71	1.0000000
NODE_17280_length_692_cov_33.416526	462	542	0	80	80	1.0000000
NODE_17280_length_692_cov_33.416526	515	595	0	80	80	1.0000000
NODE_17281_length_692_cov_17.559865	291	371	0	57	80	0.7125000
NODE_17281_length_692_cov_17.559865	291	371	2	23	80	0.2875000
NODE_17282_length_692_cov_15.070826	304	375	2	71	71	1.0000000
NODE_17283_length_692_cov_13.279933	308	388	0	80	80	1.0000000
NODE_17283_length_692_cov_13.279933	361	441	0	80	80	1.0000000
NODE_17285_length_692_cov_10.750422	317	397	0	80	80	1.0000000
NODE_17287_length_692_cov_7.497470	175	255	10	16	80	0.2000000
NODE_17287_length_692_cov_7.497470	175	255	12	22	80	0.2750000
NODE_17287_length_692_cov_7.497470	175	255	17	8	80	0.1000000
NODE_17287_length_692_cov_7.497470	175	255	18	34	80	0.4250000
NODE_17287_length_692_cov_7.497470	228	312	7	4	84	0.0476190
NODE_17287_length_692_cov_7.497470	228	312	16	17	84	0.2023810
NODE_17287_length_692_cov_7.497470	228	312	17	44	84	0.5238096
NODE_17287_length_692_cov_7.497470	228	312	18	19	84	0.2261905
NODE_17289_length_692_cov_7.370995	235	315	5	44	80	0.5500000
NODE_17289_length_692_cov_7.370995	235	315	9	1	80	0.0125000
NODE_17289_length_692_cov_7.370995	235	315	10	20	80	0.2500000
NODE_17289_length_692_cov_7.370995	235	315	12	15	80	0.1875000
NODE_17289_length_692_cov_7.370995	288	369	0	41	81	0.5061728
NODE_17289_length_692_cov_7.370995	288	369	5	40	81	0.4938272
NODE_17328_length_692_cov_1.514334	404	484	0	9	80	0.1125000
NODE_17328_length_692_cov_1.514334	404	484	4	24	80	0.3000000
NODE_17328_length_692_cov_1.514334	404	484	6	47	80	0.5875000
NODE_17350_length_691_cov_115.233108	276	356	18	18	80	0.2250000
NODE_17350_length_691_cov_115.233108	276	356	20	46	80	0.5750000
NODE_17350_length_691_cov_115.233108	276	356	22	16	80	0.2000000
NODE_17350_length_691_cov_115.233108	329	409	4	20	80	0.2500000
NODE_17350_length_691_cov_115.233108	329	409	14	14	80	0.1750000
NODE_17350_length_691_cov_115.233108	329	409	18	11	80	0.1375000
NODE_17350_length_691_cov_115.233108	329	409	22	35	80	0.4375000
NODE_17350_length_691_cov_115.233108	405	485	0	3	80	0.0375000
NODE_17350_length_691_cov_115.233108	405	485	4	12	80	0.1500000
NODE_17350_length_691_cov_115.233108	405	485	12	2	80	0.0250000
NODE_17350_length_691_cov_115.233108	405	485	16	8	80	0.1000000
NODE_17350_length_691_cov_115.233108	405	485	17	3	80	0.0375000
NODE_17350_length_691_cov_115.233108	405	485	19	1	80	0.0125000
NODE_17350_length_691_cov_115.233108	405	485	21	3	80	0.0375000
NODE_17350_length_691_cov_115.233108	405	485	23	3	80	0.0375000
NODE_17350_length_691_cov_115.233108	405	485	27	8	80	0.1000000
NODE_17350_length_691_cov_115.233108	405	485	34	3	80	0.0375000
NODE_17350_length_691_cov_115.233108	405	485	39	1	80	0.0125000
NODE_17350_length_691_cov_115.233108	405	485	40	4	80	0.0500000
NODE_17350_length_691_cov_115.233108	405	485	41	1	80	0.0125000
NODE_17350_length_691_cov_115.233108	405	485	45	1	80	0.0125000
NODE_17350_length_691_cov_115.233108	405	485	49	1	80	0.0125000
NODE_17350_length_691_cov_115.233108	405	485	51	1	80	0.0125000
NODE_17350_length_691_cov_115.233108	405	485	53	4	80	0.0500000
NODE_17350_length_691_cov_115.233108	405	485	55	4	80	0.0500000
NODE_17350_length_691_cov_115.233108	405	485	61	1	80	0.0125000
NODE_17350_length_691_cov_115.233108	405	485	63	2	80	0.0250000
NODE_17350_length_691_cov_115.233108	405	485	65	1	80	0.0125000
NODE_17350_length_691_cov_115.233108	405	485	69	1	80	0.0125000
NODE_17350_length_691_cov_115.233108	405	485	75	3	80	0.0375000
NODE_17350_length_691_cov_115.233108	405	485	77	2	80	0.0250000
NODE_17350_length_691_cov_115.233108	405	485	79	1	80	0.0125000
NODE_17350_length_691_cov_115.233108	405	485	81	1	80	0.0125000
NODE_17350_length_691_cov_115.233108	405	485	91	4	80	0.0500000
NODE_17350_length_691_cov_115.233108	405	485	95	1	80	0.0125000
NODE_17350_length_691_cov_115.233108	458	538	49	1	80	0.0125000
NODE_17350_length_691_cov_115.233108	458	538	51	1	80	0.0125000
NODE_17350_length_691_cov_115.233108	458	538	53	4	80	0.0500000
NODE_17350_length_691_cov_115.233108	458	538	55	4	80	0.0500000
NODE_17350_length_691_cov_115.233108	458	538	61	1	80	0.0125000
NODE_17350_length_691_cov_115.233108	458	538	63	2	80	0.0250000
NODE_17350_length_691_cov_115.233108	458	538	65	1	80	0.0125000
NODE_17350_length_691_cov_115.233108	458	538	69	1	80	0.0125000
NODE_17350_length_691_cov_115.233108	458	538	75	3	80	0.0375000
NODE_17350_length_691_cov_115.233108	458	538	77	2	80	0.0250000
NODE_17350_length_691_cov_115.233108	458	538	79	1	80	0.0125000
NODE_17350_length_691_cov_115.233108	458	538	81	1	80	0.0125000
NODE_17350_length_691_cov_115.233108	458	538	91	4	80	0.0500000
NODE_17350_length_691_cov_115.233108	458	538	95	7	80	0.0875000
NODE_17350_length_691_cov_115.233108	458	538	98	3	80	0.0375000
NODE_17350_length_691_cov_115.233108	458	538	99	8	80	0.1000000
NODE_17350_length_691_cov_115.233108	458	538	100	14	80	0.1750000
NODE_17350_length_691_cov_115.233108	458	538	101	2	80	0.0250000
NODE_17350_length_691_cov_115.233108	458	538	102	8	80	0.1000000
NODE_17350_length_691_cov_115.233108	458	538	107	1	80	0.0125000
NODE_17350_length_691_cov_115.233108	458	538	108	1	80	0.0125000
NODE_17350_length_691_cov_115.233108	458	538	109	10	80	0.1250000
NODE_17351_length_691_cov_26.076014	188	268	0	80	80	1.0000000
NODE_17351_length_691_cov_26.076014	241	321	0	80	80	1.0000000
NODE_17352_length_691_cov_21.991554	288	368	0	80	80	1.0000000
NODE_17352_length_691_cov_21.991554	341	419	0	78	78	1.0000000
NODE_17353_length_691_cov_14.908784	226	306	0	80	80	1.0000000
NODE_17353_length_691_cov_14.908784	279	359	0	80	80	1.0000000
NODE_17358_length_691_cov_5.670608	325	402	0	77	77	1.0000000
NODE_17358_length_691_cov_5.670608	375	455	0	80	80	1.0000000
NODE_17361_length_691_cov_4.866554	103	183	0	40	80	0.5000000
NODE_17361_length_691_cov_4.866554	103	183	1	36	80	0.4500000
NODE_17361_length_691_cov_4.866554	103	183	2	4	80	0.0500000
NODE_17361_length_691_cov_4.866554	156	236	1	23	80	0.2875000
NODE_17361_length_691_cov_4.866554	156	236	2	57	80	0.7125000
NODE_17367_length_691_cov_3.388514	304	384	0	80	80	1.0000000
NODE_17367_length_691_cov_3.388514	357	437	0	80	80	1.0000000
NODE_17415_length_690_cov_39.538071	563	612	0	49	49	1.0000000
NODE_17415_length_690_cov_39.538071	598	678	0	80	80	1.0000000
NODE_17415_length_690_cov_39.538071	651	690	0	39	39	1.0000000
NODE_17417_length_690_cov_30.336717	319	394	0	45	75	0.6000000
NODE_17417_length_690_cov_30.336717	319	394	2	28	75	0.3733333
NODE_17417_length_690_cov_30.336717	319	394	8	2	75	0.0266667
NODE_17417_length_690_cov_30.336717	372	453	2	20	81	0.2469136
NODE_17417_length_690_cov_30.336717	372	453	8	61	81	0.7530864
NODE_17417_length_690_cov_30.336717	449	529	0	19	80	0.2375000
NODE_17417_length_690_cov_30.336717	449	529	6	46	80	0.5750000
NODE_17417_length_690_cov_30.336717	449	529	8	15	80	0.1875000
NODE_17417_length_690_cov_30.336717	502	582	0	72	80	0.9000000
NODE_17417_length_690_cov_30.336717	502	582	6	8	80	0.1000000
NODE_17418_length_690_cov_26.888325	270	350	0	24	80	0.3000000
NODE_17418_length_690_cov_26.888325	270	350	2	56	80	0.7000000
NODE_17418_length_690_cov_26.888325	323	403	0	48	80	0.6000000
NODE_17418_length_690_cov_26.888325	323	403	2	32	80	0.4000000
NODE_17419_length_690_cov_23.360406	131	211	0	27	80	0.3375000
NODE_17419_length_690_cov_23.360406	131	211	5	12	80	0.1500000
NODE_17419_length_690_cov_23.360406	131	211	8	33	80	0.4125000
NODE_17419_length_690_cov_23.360406	131	211	12	8	80	0.1000000
NODE_17419_length_690_cov_23.360406	188	264	4	9	76	0.1184211
NODE_17419_length_690_cov_23.360406	188	264	8	15	76	0.1973684
NODE_17419_length_690_cov_23.360406	188	264	12	52	76	0.6842105
NODE_17420_length_690_cov_18.737733	316	396	0	80	80	1.0000000
NODE_17420_length_690_cov_18.737733	369	449	0	80	80	1.0000000
NODE_17421_length_690_cov_16.593909	364	444	0	80	80	1.0000000
NODE_17421_length_690_cov_16.593909	417	497	0	80	80	1.0000000
NODE_17422_length_690_cov_12.896785	320	400	2	80	80	1.0000000
NODE_17422_length_690_cov_12.896785	373	453	0	37	80	0.4625000
NODE_17422_length_690_cov_12.896785	373	453	2	43	80	0.5375000
NODE_17423_length_690_cov_10.818951	349	429	0	80	80	1.0000000
NODE_17424_length_690_cov_7.015228	273	353	0	33	80	0.4125000
NODE_17424_length_690_cov_7.015228	273	353	2	47	80	0.5875000
NODE_17424_length_690_cov_7.015228	326	406	0	10	80	0.1250000
NODE_17424_length_690_cov_7.015228	326	406	1	6	80	0.0750000
NODE_17424_length_690_cov_7.015228	326	406	2	64	80	0.8000000
NODE_17429_length_690_cov_4.793570	316	365	40	2	49	0.0408163
NODE_17429_length_690_cov_4.793570	316	365	42	3	49	0.0612245
NODE_17429_length_690_cov_4.793570	316	365	44	3	49	0.0612245
NODE_17429_length_690_cov_4.793570	316	365	46	2	49	0.0408163
NODE_17429_length_690_cov_4.793570	316	365	48	10	49	0.2040816
NODE_17429_length_690_cov_4.793570	316	365	50	8	49	0.1632653
NODE_17429_length_690_cov_4.793570	316	365	52	10	49	0.2040816
NODE_17429_length_690_cov_4.793570	316	365	54	3	49	0.0612245
NODE_17429_length_690_cov_4.793570	316	365	56	8	49	0.1632653
NODE_17430_length_690_cov_4.717428	316	396	0	80	80	1.0000000
NODE_17430_length_690_cov_4.717428	369	449	0	80	80	1.0000000
NODE_17484_length_689_cov_45.984746	244	322	0	78	78	1.0000000
NODE_17484_length_689_cov_45.984746	297	377	0	80	80	1.0000000
NODE_17485_length_689_cov_35.705085	436	516	0	80	80	1.0000000
NODE_17485_length_689_cov_35.705085	489	569	0	80	80	1.0000000
NODE_17486_length_689_cov_25.372881	211	291	0	80	80	1.0000000
NODE_17486_length_689_cov_25.372881	264	344	0	80	80	1.0000000
NODE_17487_length_689_cov_20.138983	319	399	0	80	80	1.0000000
NODE_17487_length_689_cov_20.138983	372	452	0	80	80	1.0000000
NODE_17488_length_689_cov_14.377966	351	431	0	47	80	0.5875000
NODE_17488_length_689_cov_14.377966	351	431	2	33	80	0.4125000
NODE_17488_length_689_cov_14.377966	404	484	2	80	80	1.0000000
NODE_17489_length_689_cov_9.477966	201	281	0	80	80	1.0000000
NODE_17489_length_689_cov_9.477966	254	334	0	80	80	1.0000000
NODE_17491_length_689_cov_7.367797	122	207	9	1	85	0.0117647
NODE_17491_length_689_cov_7.367797	122	207	11	7	85	0.0823529
NODE_17491_length_689_cov_7.367797	122	207	13	2	85	0.0235294
NODE_17491_length_689_cov_7.367797	122	207	14	1	85	0.0117647
NODE_17491_length_689_cov_7.367797	122	207	16	2	85	0.0235294
NODE_17491_length_689_cov_7.367797	122	207	18	11	85	0.1294118
NODE_17491_length_689_cov_7.367797	122	207	20	34	85	0.4000000
NODE_17491_length_689_cov_7.367797	122	207	22	6	85	0.0705882
NODE_17491_length_689_cov_7.367797	122	207	24	3	85	0.0352941
NODE_17491_length_689_cov_7.367797	122	207	26	18	85	0.2117647
NODE_17492_length_689_cov_6.649153	242	322	0	80	80	1.0000000
NODE_17492_length_689_cov_6.649153	295	375	0	80	80	1.0000000
NODE_17504_length_689_cov_2.788136	128	208	0	10	80	0.1250000
NODE_17504_length_689_cov_2.788136	128	208	4	70	80	0.8750000
NODE_17504_length_689_cov_2.788136	181	261	0	29	80	0.3625000
NODE_17504_length_689_cov_2.788136	181	261	4	51	80	0.6375000
NODE_17548_length_688_cov_52.256367	198	278	0	80	80	1.0000000
NODE_17548_length_688_cov_52.256367	251	331	0	29	80	0.3625000
NODE_17548_length_688_cov_52.256367	251	331	2	51	80	0.6375000
NODE_17549_length_688_cov_37.563667	373	453	1	28	80	0.3500000
NODE_17549_length_688_cov_37.563667	373	453	2	52	80	0.6500000
NODE_17549_length_688_cov_37.563667	426	506	2	80	80	1.0000000
NODE_17549_length_688_cov_37.563667	514	594	0	34	80	0.4250000
NODE_17549_length_688_cov_37.563667	514	594	1	46	80	0.5750000
NODE_17549_length_688_cov_37.563667	514	594	0	34	80	0.4250000
NODE_17549_length_688_cov_37.563667	514	594	1	46	80	0.5750000
NODE_17549_length_688_cov_37.563667	514	584	0	24	70	0.3428572
NODE_17549_length_688_cov_37.563667	514	584	1	46	70	0.6571429
NODE_17549_length_688_cov_37.563667	567	647	0	80	80	1.0000000
NODE_17549_length_688_cov_37.563667	567	646	0	79	79	1.0000000
NODE_17550_length_688_cov_33.898132	373	453	2	29	80	0.3625000
NODE_17550_length_688_cov_33.898132	373	453	4	10	80	0.1250000
NODE_17550_length_688_cov_33.898132	373	453	6	5	80	0.0625000
NODE_17550_length_688_cov_33.898132	373	453	8	36	80	0.4500000
NODE_17550_length_688_cov_33.898132	426	506	0	42	80	0.5250000
NODE_17550_length_688_cov_33.898132	426	506	2	38	80	0.4750000
NODE_17551_length_688_cov_26.769100	457	537	0	22	80	0.2750000
NODE_17551_length_688_cov_26.769100	457	537	2	58	80	0.7250000
NODE_17551_length_688_cov_26.769100	510	590	0	11	80	0.1375000
NODE_17551_length_688_cov_26.769100	510	590	2	69	80	0.8625000
NODE_17552_length_688_cov_22.517827	332	412	0	80	80	1.0000000
NODE_17552_length_688_cov_22.517827	385	465	0	80	80	1.0000000
NODE_17553_length_688_cov_16.796265	225	305	0	36	80	0.4500000
NODE_17553_length_688_cov_16.796265	225	305	2	44	80	0.5500000
NODE_17553_length_688_cov_16.796265	278	358	2	80	80	1.0000000
NODE_17555_length_688_cov_13.758913	378	458	2	80	80	1.0000000
NODE_17555_length_688_cov_13.758913	431	511	0	24	80	0.3000000
NODE_17555_length_688_cov_13.758913	431	511	2	56	80	0.7000000
NODE_17556_length_688_cov_12.511036	330	410	0	22	80	0.2750000
NODE_17556_length_688_cov_12.511036	330	410	2	58	80	0.7250000
NODE_17556_length_688_cov_12.511036	383	463	2	36	80	0.4500000
NODE_17556_length_688_cov_12.511036	383	463	4	36	80	0.4500000
NODE_17556_length_688_cov_12.511036	383	463	6	8	80	0.1000000
NODE_17561_length_688_cov_5.446520	366	414	0	19	48	0.3958333
NODE_17561_length_688_cov_5.446520	366	414	4	19	48	0.3958333
NODE_17561_length_688_cov_5.446520	366	414	6	10	48	0.2083333
NODE_17567_length_688_cov_3.692699	265	345	0	80	80	1.0000000
NODE_17567_length_688_cov_3.692699	322	380	0	58	58	1.0000000
NODE_17621_length_687_cov_50.214286	430	510	0	80	80	1.0000000
NODE_17621_length_687_cov_50.214286	483	563	0	80	80	1.0000000
NODE_17622_length_687_cov_32.564626	204	284	1	6	80	0.0750000
NODE_17622_length_687_cov_32.564626	204	284	2	74	80	0.9250000
NODE_17622_length_687_cov_32.564626	257	337	2	80	80	1.0000000
NODE_17623_length_687_cov_22.365646	231	311	0	54	80	0.6750000
NODE_17623_length_687_cov_22.365646	231	311	2	26	80	0.3250000
NODE_17623_length_687_cov_22.365646	284	364	0	1	80	0.0125000
NODE_17623_length_687_cov_22.365646	284	364	2	79	80	0.9875000
NODE_17626_length_687_cov_11.943878	233	313	0	80	80	1.0000000
NODE_17626_length_687_cov_11.943878	286	366	0	80	80	1.0000000
NODE_17627_length_687_cov_7.865646	311	391	0	35	80	0.4375000
NODE_17627_length_687_cov_7.865646	311	391	2	2	80	0.0250000
NODE_17627_length_687_cov_7.865646	311	391	4	43	80	0.5375000
NODE_17627_length_687_cov_7.865646	364	444	0	4	80	0.0500000
NODE_17627_length_687_cov_7.865646	364	444	3	1	80	0.0125000
NODE_17627_length_687_cov_7.865646	364	444	4	75	80	0.9375000
NODE_17628_length_687_cov_7.353741	286	366	0	80	80	1.0000000
NODE_17628_length_687_cov_7.353741	339	419	0	69	80	0.8625000
NODE_17628_length_687_cov_7.353741	339	419	2	11	80	0.1375000
NODE_17631_length_687_cov_5.903061	369	449	0	80	80	1.0000000
NODE_17631_length_687_cov_5.903061	422	502	0	80	80	1.0000000
NODE_17695_length_686_cov_34.642249	355	440	0	9	85	0.1058824
NODE_17695_length_686_cov_34.642249	355	440	2	76	85	0.8941177
NODE_17695_length_686_cov_34.642249	413	493	0	49	80	0.6125000
NODE_17695_length_686_cov_34.642249	413	493	1	9	80	0.1125000
NODE_17695_length_686_cov_34.642249	413	493	2	22	80	0.2750000
NODE_17697_length_686_cov_26.357751	413	493	0	80	80	1.0000000
NODE_17697_length_686_cov_26.357751	466	546	0	80	80	1.0000000
NODE_17698_length_686_cov_16.715503	400	480	0	80	80	1.0000000
NODE_17698_length_686_cov_16.715503	453	533	0	80	80	1.0000000
NODE_17757_length_685_cov_8.769625	178	258	0	11	80	0.1375000
NODE_17757_length_685_cov_8.769625	178	258	2	69	80	0.8625000
NODE_17757_length_685_cov_8.769625	222	250	0	3	28	0.1071429
NODE_17757_length_685_cov_8.769625	222	250	2	25	28	0.8928571
NODE_17757_length_685_cov_8.769625	231	311	0	64	80	0.8000000
NODE_17757_length_685_cov_8.769625	231	311	2	16	80	0.2000000
NODE_17764_length_685_cov_4.447099	249	329	0	33	80	0.4125000
NODE_17764_length_685_cov_4.447099	249	329	2	47	80	0.5875000
NODE_17764_length_685_cov_4.447099	302	382	0	55	80	0.6875000
NODE_17764_length_685_cov_4.447099	302	382	2	25	80	0.3125000
NODE_17768_length_685_cov_3.556314	338	418	0	80	80	1.0000000
NODE_17768_length_685_cov_3.556314	391	471	0	80	80	1.0000000
NODE_17821_length_684_cov_7.521368	189	269	2	34	80	0.4250000
NODE_17821_length_684_cov_7.521368	189	269	4	46	80	0.5750000
NODE_17821_length_684_cov_7.521368	242	322	0	20	80	0.2500000
NODE_17821_length_684_cov_7.521368	242	322	2	60	80	0.7500000
NODE_17832_length_684_cov_3.639316	306	386	0	80	80	1.0000000
NODE_17832_length_684_cov_3.639316	359	439	0	80	80	1.0000000
NODE_17866_length_683_cov_27.493151	346	426	0	80	80	1.0000000
NODE_17866_length_683_cov_27.493151	399	479	0	80	80	1.0000000
NODE_17867_length_683_cov_12.880137	242	321	0	11	79	0.1392405
NODE_17867_length_683_cov_12.880137	242	321	2	17	79	0.2151899
NODE_17867_length_683_cov_12.880137	242	321	6	22	79	0.2784810
NODE_17867_length_683_cov_12.880137	242	321	8	16	79	0.2025317
NODE_17867_length_683_cov_12.880137	242	321	10	4	79	0.0506329
NODE_17867_length_683_cov_12.880137	242	321	12	9	79	0.1139240
NODE_17868_length_683_cov_11.772260	218	274	0	56	56	1.0000000
NODE_17868_length_683_cov_11.772260	247	333	0	86	86	1.0000000
NODE_17869_length_683_cov_9.936644	435	515	0	80	80	1.0000000
NODE_17869_length_683_cov_9.936644	488	568	0	80	80	1.0000000
NODE_17871_length_683_cov_9.017123	296	364	0	68	68	1.0000000
NODE_17871_length_683_cov_9.017123	337	417	0	80	80	1.0000000
NODE_17873_length_683_cov_6.797945	359	415	0	56	56	1.0000000
NODE_17884_length_683_cov_3.176370	113	186	0	73	73	1.0000000
NODE_17947_length_682_cov_33.516295	423	503	0	80	80	1.0000000
NODE_17947_length_682_cov_33.516295	476	556	0	80	80	1.0000000
NODE_17948_length_682_cov_27.022298	479	559	0	64	80	0.8000000
NODE_17948_length_682_cov_27.022298	479	559	14	3	80	0.0375000
NODE_17948_length_682_cov_27.022298	479	559	16	1	80	0.0125000
NODE_17948_length_682_cov_27.022298	479	559	18	5	80	0.0625000
NODE_17948_length_682_cov_27.022298	479	559	20	7	80	0.0875000
NODE_17948_length_682_cov_27.022298	532	612	0	11	80	0.1375000
NODE_17948_length_682_cov_27.022298	532	612	14	3	80	0.0375000
NODE_17948_length_682_cov_27.022298	532	612	16	1	80	0.0125000
NODE_17948_length_682_cov_27.022298	532	612	18	5	80	0.0625000
NODE_17948_length_682_cov_27.022298	532	612	20	7	80	0.0875000
NODE_17948_length_682_cov_27.022298	532	612	24	53	80	0.6625000
NODE_17949_length_682_cov_19.612350	434	514	0	48	80	0.6000000
NODE_17949_length_682_cov_19.612350	434	514	2	32	80	0.4000000
NODE_17949_length_682_cov_19.612350	487	567	0	26	80	0.3250000
NODE_17949_length_682_cov_19.612350	487	567	2	54	80	0.6750000
NODE_17950_length_682_cov_16.620926	261	341	0	37	80	0.4625000
NODE_17950_length_682_cov_16.620926	261	341	2	43	80	0.5375000
NODE_17950_length_682_cov_16.620926	314	394	0	21	80	0.2625000
NODE_17950_length_682_cov_16.620926	314	394	2	59	80	0.7375000
NODE_17951_length_682_cov_13.735849	251	331	0	80	80	1.0000000
NODE_17951_length_682_cov_13.735849	304	384	0	80	80	1.0000000
NODE_17952_length_682_cov_12.835334	228	308	0	80	80	1.0000000
NODE_17952_length_682_cov_12.835334	281	361	0	80	80	1.0000000
NODE_17956_length_682_cov_7.504288	224	304	0	80	80	1.0000000
NODE_17956_length_682_cov_7.504288	277	357	0	80	80	1.0000000
NODE_17960_length_682_cov_5.102916	314	351	0	6	37	0.1621622
NODE_17960_length_682_cov_5.102916	314	351	2	31	37	0.8378378
NODE_17963_length_682_cov_4.579760	152	232	0	80	80	1.0000000
NODE_17963_length_682_cov_4.579760	205	285	0	80	80	1.0000000
NODE_17967_length_682_cov_4.006861	317	397	0	80	80	1.0000000
NODE_17967_length_682_cov_4.006861	370	450	0	80	80	1.0000000
NODE_17968_length_682_cov_3.859348	160	240	2	28	80	0.3500000
NODE_17968_length_682_cov_3.859348	160	240	4	52	80	0.6500000
NODE_17968_length_682_cov_3.859348	213	293	0	36	80	0.4500000
NODE_17968_length_682_cov_3.859348	213	293	1	4	80	0.0500000
NODE_17968_length_682_cov_3.859348	213	293	2	5	80	0.0625000
NODE_17968_length_682_cov_3.859348	213	293	4	35	80	0.4375000
NODE_18010_length_681_cov_51.810997	181	261	0	46	80	0.5750000
NODE_18010_length_681_cov_51.810997	181	261	7	1	80	0.0125000
NODE_18010_length_681_cov_51.810997	181	261	8	33	80	0.4125000
NODE_18010_length_681_cov_51.810997	234	316	0	7	82	0.0853659
NODE_18010_length_681_cov_51.810997	234	316	7	1	82	0.0121951
NODE_18010_length_681_cov_51.810997	234	316	8	74	82	0.9024390
NODE_18011_length_681_cov_32.128866	347	427	0	80	80	1.0000000
NODE_18011_length_681_cov_32.128866	400	475	0	66	75	0.8800000
NODE_18011_length_681_cov_32.128866	400	475	2	9	75	0.1200000
NODE_18012_length_681_cov_19.079038	282	362	0	80	80	1.0000000
NODE_18012_length_681_cov_19.079038	335	415	0	80	80	1.0000000
NODE_18013_length_681_cov_17.053265	294	374	0	80	80	1.0000000
NODE_18013_length_681_cov_17.053265	347	427	0	80	80	1.0000000
NODE_18014_length_681_cov_11.183849	306	386	0	80	80	1.0000000
NODE_18014_length_681_cov_11.183849	359	439	0	80	80	1.0000000
NODE_18015_length_681_cov_8.065292	236	316	1	11	80	0.1375000
NODE_18015_length_681_cov_8.065292	236	316	2	65	80	0.8125000
NODE_18015_length_681_cov_8.065292	236	316	3	4	80	0.0500000
NODE_18015_length_681_cov_8.065292	289	369	1	11	80	0.1375000
NODE_18015_length_681_cov_8.065292	289	369	2	14	80	0.1750000
NODE_18015_length_681_cov_8.065292	289	369	3	55	80	0.6875000
NODE_18017_length_681_cov_6.888316	344	424	3	2	80	0.0250000
NODE_18017_length_681_cov_6.888316	344	424	6	60	80	0.7500000
NODE_18017_length_681_cov_6.888316	344	424	8	18	80	0.2250000
NODE_18017_length_681_cov_6.888316	397	477	0	15	80	0.1875000
NODE_18017_length_681_cov_6.888316	397	477	3	40	80	0.5000000
NODE_18017_length_681_cov_6.888316	397	477	6	25	80	0.3125000
NODE_18080_length_680_cov_35.695353	348	428	0	80	80	1.0000000
NODE_18080_length_680_cov_35.695353	401	481	0	80	80	1.0000000
NODE_18081_length_680_cov_17.500861	296	376	0	80	80	1.0000000
NODE_18081_length_680_cov_17.500861	349	429	0	80	80	1.0000000
NODE_18082_length_680_cov_16.685026	260	340	0	80	80	1.0000000
NODE_18082_length_680_cov_16.685026	313	393	0	51	80	0.6375000
NODE_18082_length_680_cov_16.685026	313	393	2	29	80	0.3625000
NODE_18083_length_680_cov_15.345955	332	412	2	2	80	0.0250000
NODE_18083_length_680_cov_15.345955	332	412	4	46	80	0.5750000
NODE_18083_length_680_cov_15.345955	332	412	6	13	80	0.1625000
NODE_18083_length_680_cov_15.345955	332	412	8	19	80	0.2375000
NODE_18083_length_680_cov_15.345955	385	465	0	7	80	0.0875000
NODE_18083_length_680_cov_15.345955	385	465	4	51	80	0.6375000
NODE_18083_length_680_cov_15.345955	385	465	6	13	80	0.1625000
NODE_18083_length_680_cov_15.345955	385	465	8	9	80	0.1125000
NODE_18089_length_680_cov_3.858864	458	538	0	80	80	1.0000000
NODE_18107_length_680_cov_1.879518	236	256	0	20	20	1.0000000
NODE_18146_length_679_cov_52.046552	367	447	0	80	80	1.0000000
NODE_18146_length_679_cov_52.046552	420	500	0	80	80	1.0000000
NODE_18147_length_679_cov_40.353448	179	259	2	80	80	1.0000000
NODE_18147_length_679_cov_40.353448	232	312	0	46	80	0.5750000
NODE_18147_length_679_cov_40.353448	232	312	2	34	80	0.4250000
NODE_18148_length_679_cov_38.144828	364	428	4	4	64	0.0625000
NODE_18148_length_679_cov_38.144828	364	428	8	6	64	0.0937500
NODE_18148_length_679_cov_38.144828	364	428	10	54	64	0.8437500
NODE_18148_length_679_cov_38.144828	401	481	0	2	80	0.0250000
NODE_18148_length_679_cov_38.144828	401	481	4	55	80	0.6875000
NODE_18148_length_679_cov_38.144828	401	481	8	6	80	0.0750000
NODE_18148_length_679_cov_38.144828	401	481	10	17	80	0.2125000
NODE_18149_length_679_cov_17.134483	277	357	0	80	80	1.0000000
NODE_18149_length_679_cov_17.134483	330	410	0	80	80	1.0000000
NODE_18150_length_679_cov_15.046552	310	375	0	65	65	1.0000000
NODE_18151_length_679_cov_12.586207	247	327	0	80	80	1.0000000
NODE_18151_length_679_cov_12.586207	303	381	0	78	78	1.0000000
NODE_18152_length_679_cov_12.282759	337	417	0	80	80	1.0000000
NODE_18152_length_679_cov_12.282759	390	470	0	80	80	1.0000000
NODE_18153_length_679_cov_11.532759	205	285	0	80	80	1.0000000
NODE_18153_length_679_cov_11.532759	258	338	0	80	80	1.0000000
NODE_18155_length_679_cov_8.043103	269	341	0	72	72	1.0000000
NODE_18155_length_679_cov_8.043103	314	394	0	39	80	0.4875000
NODE_18155_length_679_cov_8.043103	314	394	2	41	80	0.5125000
NODE_18156_length_679_cov_7.267241	191	271	0	80	80	1.0000000
NODE_18156_length_679_cov_7.267241	244	324	0	80	80	1.0000000
NODE_18162_length_679_cov_5.391379	279	331	0	52	52	1.0000000
NODE_18164_length_679_cov_3.813793	10	69	1	1	59	0.0169492
NODE_18164_length_679_cov_3.813793	10	69	9	29	59	0.4915254
NODE_18164_length_679_cov_3.813793	10	69	10	2	59	0.0338983
NODE_18164_length_679_cov_3.813793	10	69	12	27	59	0.4576271
NODE_18164_length_679_cov_3.813793	48	122	10	1	74	0.0135135
NODE_18164_length_679_cov_3.813793	48	122	12	73	74	0.9864865
NODE_18217_length_678_cov_38.910190	252	332	0	80	80	1.0000000
NODE_18217_length_678_cov_38.910190	305	385	0	80	80	1.0000000
NODE_18217_length_678_cov_38.910190	381	461	0	80	80	1.0000000
NODE_18217_length_678_cov_38.910190	434	514	0	80	80	1.0000000
NODE_18218_length_678_cov_20.663212	243	323	0	6	80	0.0750000
NODE_18218_length_678_cov_20.663212	243	323	2	37	80	0.4625000
NODE_18218_length_678_cov_20.663212	243	323	4	37	80	0.4625000
NODE_18218_length_678_cov_20.663212	296	376	0	4	80	0.0500000
NODE_18218_length_678_cov_20.663212	296	376	2	19	80	0.2375000
NODE_18218_length_678_cov_20.663212	296	376	4	57	80	0.7125000
NODE_18219_length_678_cov_12.081174	243	323	0	80	80	1.0000000
NODE_18219_length_678_cov_12.081174	296	376	0	80	80	1.0000000
NODE_18224_length_678_cov_6.559585	195	264	0	69	69	1.0000000
NODE_18224_length_678_cov_6.559585	237	317	0	80	80	1.0000000
NODE_18228_length_678_cov_4.462867	133	213	0	80	80	1.0000000
NODE_18228_length_678_cov_4.462867	186	266	0	80	80	1.0000000
NODE_18239_length_678_cov_2.716753	351	431	0	80	80	1.0000000
NODE_18239_length_678_cov_2.716753	404	484	0	80	80	1.0000000
NODE_18289_length_677_cov_22.235294	274	354	0	80	80	1.0000000
NODE_18289_length_677_cov_22.235294	327	407	0	80	80	1.0000000
NODE_18290_length_677_cov_16.410035	124	206	0	82	82	1.0000000
NODE_18290_length_677_cov_16.410035	177	261	0	84	84	1.0000000
NODE_18291_length_677_cov_11.031142	393	473	0	80	80	1.0000000
NODE_18291_length_677_cov_11.031142	446	526	0	80	80	1.0000000
NODE_18292_length_677_cov_10.129758	258	338	0	19	80	0.2375000
NODE_18292_length_677_cov_10.129758	258	338	2	61	80	0.7625000
NODE_18292_length_677_cov_10.129758	311	391	0	54	80	0.6750000
NODE_18292_length_677_cov_10.129758	311	391	2	26	80	0.3250000
NODE_18295_length_677_cov_6.660900	217	297	35	5	80	0.0625000
NODE_18295_length_677_cov_6.660900	217	297	41	2	80	0.0250000
NODE_18295_length_677_cov_6.660900	217	297	45	4	80	0.0500000
NODE_18295_length_677_cov_6.660900	217	297	47	5	80	0.0625000
NODE_18295_length_677_cov_6.660900	217	297	49	4	80	0.0500000
NODE_18295_length_677_cov_6.660900	217	297	50	1	80	0.0125000
NODE_18295_length_677_cov_6.660900	217	297	52	30	80	0.3750000
NODE_18295_length_677_cov_6.660900	217	297	59	16	80	0.2000000
NODE_18295_length_677_cov_6.660900	217	297	60	9	80	0.1125000
NODE_18295_length_677_cov_6.660900	217	297	62	4	80	0.0500000
NODE_18297_length_677_cov_5.228374	366	446	0	80	80	1.0000000
NODE_18312_length_677_cov_2.306228	230	278	0	23	48	0.4791667
NODE_18312_length_677_cov_2.306228	230	278	2	25	48	0.5208333
NODE_18329_length_677_cov_1.709343	369	449	0	21	80	0.2625000
NODE_18329_length_677_cov_1.709343	369	449	4	10	80	0.1250000
NODE_18329_length_677_cov_1.709343	369	449	6	13	80	0.1625000
NODE_18329_length_677_cov_1.709343	369	449	10	36	80	0.4500000
NODE_18329_length_677_cov_1.709343	422	502	6	6	80	0.0750000
NODE_18329_length_677_cov_1.709343	422	502	10	74	80	0.9250000
NODE_18368_length_676_cov_66.473137	286	366	0	80	80	1.0000000
NODE_18368_length_676_cov_66.473137	339	419	0	44	80	0.5500000
NODE_18368_length_676_cov_66.473137	339	419	12	2	80	0.0250000
NODE_18368_length_676_cov_66.473137	339	419	15	1	80	0.0125000
NODE_18368_length_676_cov_66.473137	339	419	22	1	80	0.0125000
NODE_18368_length_676_cov_66.473137	339	419	26	1	80	0.0125000
NODE_18368_length_676_cov_66.473137	339	419	30	1	80	0.0125000
NODE_18368_length_676_cov_66.473137	339	419	33	1	80	0.0125000
NODE_18368_length_676_cov_66.473137	339	419	34	1	80	0.0125000
NODE_18368_length_676_cov_66.473137	339	419	35	2	80	0.0250000
NODE_18368_length_676_cov_66.473137	339	419	37	5	80	0.0625000
NODE_18368_length_676_cov_66.473137	339	419	41	12	80	0.1500000
NODE_18368_length_676_cov_66.473137	339	419	42	5	80	0.0625000
NODE_18368_length_676_cov_66.473137	339	419	43	4	80	0.0500000
NODE_18368_length_676_cov_66.473137	383	419	12	2	36	0.0555556
NODE_18368_length_676_cov_66.473137	383	419	15	1	36	0.0277778
NODE_18368_length_676_cov_66.473137	383	419	22	1	36	0.0277778
NODE_18368_length_676_cov_66.473137	383	419	26	1	36	0.0277778
NODE_18368_length_676_cov_66.473137	383	419	30	1	36	0.0277778
NODE_18368_length_676_cov_66.473137	383	419	33	1	36	0.0277778
NODE_18368_length_676_cov_66.473137	383	419	34	1	36	0.0277778
NODE_18368_length_676_cov_66.473137	383	419	35	2	36	0.0555556
NODE_18368_length_676_cov_66.473137	383	419	37	5	36	0.1388889
NODE_18368_length_676_cov_66.473137	383	419	41	12	36	0.3333333
NODE_18368_length_676_cov_66.473137	383	419	42	5	36	0.1388889
NODE_18368_length_676_cov_66.473137	383	419	43	4	36	0.1111111
NODE_18368_length_676_cov_66.473137	383	419	12	2	36	0.0555556
NODE_18368_length_676_cov_66.473137	383	419	15	1	36	0.0277778
NODE_18368_length_676_cov_66.473137	383	419	22	1	36	0.0277778
NODE_18368_length_676_cov_66.473137	383	419	26	1	36	0.0277778
NODE_18368_length_676_cov_66.473137	383	419	30	1	36	0.0277778
NODE_18368_length_676_cov_66.473137	383	419	33	1	36	0.0277778
NODE_18368_length_676_cov_66.473137	383	419	34	1	36	0.0277778
NODE_18368_length_676_cov_66.473137	383	419	35	2	36	0.0555556
NODE_18368_length_676_cov_66.473137	383	419	37	5	36	0.1388889
NODE_18368_length_676_cov_66.473137	383	419	41	12	36	0.3333333
NODE_18368_length_676_cov_66.473137	383	419	42	5	36	0.1388889
NODE_18368_length_676_cov_66.473137	383	419	43	4	36	0.1111111
NODE_18368_length_676_cov_66.473137	398	419	41	12	21	0.5714286
NODE_18368_length_676_cov_66.473137	398	419	42	5	21	0.2380952
NODE_18368_length_676_cov_66.473137	398	419	43	4	21	0.1904762
NODE_18369_length_676_cov_14.429809	259	330	4	6	71	0.0845070
NODE_18369_length_676_cov_14.429809	259	330	6	3	71	0.0422535
NODE_18369_length_676_cov_14.429809	259	330	9	10	71	0.1408451
NODE_18369_length_676_cov_14.429809	259	330	10	52	71	0.7323943
NODE_18370_length_676_cov_13.882149	292	372	0	20	80	0.2500000
NODE_18370_length_676_cov_13.882149	292	372	2	60	80	0.7500000
NODE_18370_length_676_cov_13.882149	345	425	0	11	80	0.1375000
NODE_18370_length_676_cov_13.882149	345	425	2	69	80	0.8625000
NODE_18374_length_676_cov_7.225303	363	443	0	80	80	1.0000000
NODE_18374_length_676_cov_7.225303	416	496	0	80	80	1.0000000
NODE_18375_length_676_cov_6.740035	373	433	2	60	60	1.0000000
NODE_18375_length_676_cov_6.740035	406	486	0	4	80	0.0500000
NODE_18375_length_676_cov_6.740035	406	486	2	76	80	0.9500000
NODE_18378_length_676_cov_4.658579	167	240	2	54	73	0.7397260
NODE_18378_length_676_cov_4.658579	167	240	4	19	73	0.2602740
NODE_18397_length_676_cov_2.292894	146	226	0	80	80	1.0000000
NODE_18401_length_676_cov_2.157712	175	226	0	51	51	1.0000000
NODE_18417_length_676_cov_1.547660	133	164	0	31	31	1.0000000
NODE_18447_length_675_cov_27.574653	190	270	0	80	80	1.0000000
NODE_18447_length_675_cov_27.574653	243	323	0	80	80	1.0000000
NODE_18448_length_675_cov_11.895833	336	416	0	80	80	1.0000000
NODE_18448_length_675_cov_11.895833	389	469	0	80	80	1.0000000
NODE_18449_length_675_cov_8.157986	414	494	0	80	80	1.0000000
NODE_18449_length_675_cov_8.157986	467	547	0	80	80	1.0000000
NODE_18450_length_675_cov_8.026042	320	400	0	80	80	1.0000000
NODE_18450_length_675_cov_8.026042	373	453	0	80	80	1.0000000
NODE_18451_length_675_cov_7.277778	317	397	0	80	80	1.0000000
NODE_18455_length_675_cov_5.666667	142	222	0	17	80	0.2125000
NODE_18455_length_675_cov_5.666667	142	222	2	43	80	0.5375000
NODE_18455_length_675_cov_5.666667	142	222	4	20	80	0.2500000
NODE_18455_length_675_cov_5.666667	195	275	2	32	80	0.4000000
NODE_18455_length_675_cov_5.666667	195	275	4	48	80	0.6000000
NODE_18464_length_675_cov_2.751736	67	122	2	2	55	0.0363636
NODE_18464_length_675_cov_2.751736	67	122	4	53	55	0.9636363
NODE_18467_length_675_cov_2.623264	251	289	0	3	38	0.0789474
NODE_18467_length_675_cov_2.623264	251	289	2	35	38	0.9210526
NODE_18467_length_675_cov_2.623264	279	343	0	28	64	0.4375000
NODE_18467_length_675_cov_2.623264	279	343	2	36	64	0.5625000
NODE_18467_length_675_cov_2.623264	432	494	0	62	62	1.0000000
NODE_18515_length_674_cov_38.401739	225	305	0	50	80	0.6250000
NODE_18515_length_674_cov_38.401739	225	305	2	30	80	0.3750000
NODE_18515_length_674_cov_38.401739	278	358	0	11	80	0.1375000
NODE_18515_length_674_cov_38.401739	278	358	2	69	80	0.8625000
NODE_18516_length_674_cov_30.215652	519	599	16	2	80	0.0250000
NODE_18516_length_674_cov_30.215652	519	599	18	3	80	0.0375000
NODE_18516_length_674_cov_30.215652	519	599	22	6	80	0.0750000
NODE_18516_length_674_cov_30.215652	519	599	28	6	80	0.0750000
NODE_18516_length_674_cov_30.215652	519	599	30	16	80	0.2000000
NODE_18516_length_674_cov_30.215652	519	599	32	47	80	0.5875000
NODE_18516_length_674_cov_30.215652	572	602	28	2	30	0.0666667
NODE_18516_length_674_cov_30.215652	572	602	32	28	30	0.9333333
NODE_18517_length_674_cov_19.636522	283	363	0	43	80	0.5375000
NODE_18517_length_674_cov_19.636522	283	363	2	17	80	0.2125000
NODE_18517_length_674_cov_19.636522	283	363	4	20	80	0.2500000
NODE_18517_length_674_cov_19.636522	336	416	2	9	80	0.1125000
NODE_18517_length_674_cov_19.636522	336	416	4	71	80	0.8875000
NODE_18518_length_674_cov_19.436522	81	161	0	80	80	1.0000000
NODE_18518_length_674_cov_19.436522	134	214	0	80	80	1.0000000
NODE_18519_length_674_cov_16.819130	185	265	0	80	80	1.0000000
NODE_18519_length_674_cov_16.819130	238	318	0	80	80	1.0000000
NODE_18520_length_674_cov_14.733913	169	249	0	34	80	0.4250000
NODE_18520_length_674_cov_14.733913	169	249	2	46	80	0.5750000
NODE_18520_length_674_cov_14.733913	222	302	2	80	80	1.0000000
NODE_18524_length_674_cov_7.086957	357	437	4	80	80	1.0000000
NODE_18524_length_674_cov_7.086957	410	490	0	1	80	0.0125000
NODE_18524_length_674_cov_7.086957	410	490	4	79	80	0.9875000
NODE_18528_length_674_cov_4.808696	262	342	0	80	80	1.0000000
NODE_18528_length_674_cov_4.808696	315	395	0	80	80	1.0000000
NODE_18592_length_673_cov_47.109756	405	485	0	3	80	0.0375000
NODE_18592_length_673_cov_47.109756	405	485	2	77	80	0.9625000
NODE_18592_length_673_cov_47.109756	458	538	0	56	80	0.7000000
NODE_18592_length_673_cov_47.109756	458	538	2	24	80	0.3000000
NODE_18593_length_673_cov_20.548780	214	294	14	4	80	0.0500000
NODE_18593_length_673_cov_20.548780	214	294	16	76	80	0.9500000
NODE_18593_length_673_cov_20.548780	267	347	7	6	80	0.0750000
NODE_18593_length_673_cov_20.548780	267	347	9	11	80	0.1375000
NODE_18593_length_673_cov_20.548780	267	347	16	63	80	0.7875000
NODE_18596_length_673_cov_8.306620	337	426	2	36	89	0.4044944
NODE_18596_length_673_cov_8.306620	337	426	4	33	89	0.3707865
NODE_18596_length_673_cov_8.306620	337	426	6	20	89	0.2247191
NODE_18607_length_673_cov_3.041812	196	276	0	8	80	0.1000000
NODE_18607_length_673_cov_3.041812	196	276	1	2	80	0.0250000
NODE_18607_length_673_cov_3.041812	196	276	2	70	80	0.8750000
NODE_18607_length_673_cov_3.041812	249	329	0	30	80	0.3750000
NODE_18607_length_673_cov_3.041812	249	329	2	50	80	0.6250000
NODE_18660_length_672_cov_15.380454	282	362	0	80	80	1.0000000
NODE_18660_length_672_cov_15.380454	335	415	0	80	80	1.0000000
NODE_18661_length_672_cov_9.902269	328	408	0	80	80	1.0000000
NODE_18661_length_672_cov_9.902269	381	461	0	80	80	1.0000000
NODE_18662_length_672_cov_9.462478	309	389	0	80	80	1.0000000
NODE_18662_length_672_cov_9.462478	362	442	0	80	80	1.0000000
NODE_18666_length_672_cov_6.516579	354	434	6	80	80	1.0000000
NODE_18666_length_672_cov_6.516579	407	487	0	2	80	0.0250000
NODE_18666_length_672_cov_6.516579	407	487	6	78	80	0.9750000
NODE_18668_length_672_cov_6.108202	135	215	0	80	80	1.0000000
NODE_18668_length_672_cov_6.108202	188	268	0	80	80	1.0000000
NODE_18670_length_672_cov_4.949389	115	152	0	7	37	0.1891892
NODE_18670_length_672_cov_4.949389	115	152	2	30	37	0.8108108
NODE_18670_length_672_cov_4.949389	125	205	0	60	80	0.7500000
NODE_18670_length_672_cov_4.949389	125	205	2	20	80	0.2500000
NODE_18670_length_672_cov_4.949389	278	326	0	48	48	1.0000000
NODE_18672_length_672_cov_4.753927	378	450	0	72	72	1.0000000
NODE_18704_length_672_cov_1.713787	340	401	2	39	61	0.6393443
NODE_18704_length_672_cov_1.713787	340	401	4	22	61	0.3606557
NODE_18742_length_671_cov_28.874126	306	387	0	33	81	0.4074074
NODE_18742_length_671_cov_28.874126	306	387	2	48	81	0.5925926
NODE_18742_length_671_cov_28.874126	360	440	0	34	80	0.4250000
NODE_18742_length_671_cov_28.874126	360	440	2	46	80	0.5750000
NODE_18744_length_671_cov_18.526224	294	333	0	39	39	1.0000000
NODE_18744_length_671_cov_18.526224	331	404	0	73	73	1.0000000
NODE_18744_length_671_cov_18.526224	331	351	0	20	20	1.0000000
NODE_18745_length_671_cov_16.094406	417	497	0	80	80	1.0000000
NODE_18745_length_671_cov_16.094406	470	550	0	80	80	1.0000000
NODE_18746_length_671_cov_11.756993	337	417	0	80	80	1.0000000
NODE_18746_length_671_cov_11.756993	390	470	0	80	80	1.0000000
NODE_18747_length_671_cov_9.237762	305	382	0	77	77	1.0000000
NODE_18748_length_671_cov_8.491259	298	379	0	81	81	1.0000000
NODE_18748_length_671_cov_8.491259	352	430	0	78	78	1.0000000
NODE_18749_length_671_cov_8.241259	97	128	0	11	31	0.3548387
NODE_18749_length_671_cov_8.241259	97	128	2	20	31	0.6451613
NODE_18752_length_671_cov_7.201049	368	448	0	30	80	0.3750000
NODE_18752_length_671_cov_7.201049	368	448	2	50	80	0.6250000
NODE_18752_length_671_cov_7.201049	421	501	0	40	80	0.5000000
NODE_18752_length_671_cov_7.201049	421	501	2	40	80	0.5000000
NODE_18753_length_671_cov_5.680070	370	450	3	8	80	0.1000000
NODE_18753_length_671_cov_5.680070	370	450	5	72	80	0.9000000
NODE_18753_length_671_cov_5.680070	423	503	3	61	80	0.7625000
NODE_18753_length_671_cov_5.680070	423	503	5	19	80	0.2375000
NODE_18754_length_671_cov_4.769231	362	414	0	52	52	1.0000000
NODE_18760_length_671_cov_3.804196	360	440	2	21	80	0.2625000
NODE_18760_length_671_cov_3.804196	360	440	4	59	80	0.7375000
NODE_18812_length_670_cov_21.017513	443	523	0	80	80	1.0000000
NODE_18812_length_670_cov_21.017513	496	576	0	80	80	1.0000000
NODE_18813_length_670_cov_20.346760	372	452	0	80	80	1.0000000
NODE_18813_length_670_cov_20.346760	425	505	0	80	80	1.0000000
NODE_18814_length_670_cov_15.728546	157	237	0	80	80	1.0000000
NODE_18814_length_670_cov_15.728546	210	290	0	80	80	1.0000000
NODE_18814_length_670_cov_15.728546	286	366	0	20	80	0.2500000
NODE_18814_length_670_cov_15.728546	286	366	4	60	80	0.7500000
NODE_18814_length_670_cov_15.728546	339	419	4	80	80	1.0000000
NODE_18818_length_670_cov_6.499124	390	470	4	80	80	1.0000000
NODE_18834_length_670_cov_3.099825	159	217	0	58	58	1.0000000
NODE_18838_length_670_cov_2.700525	252	332	0	62	80	0.7750000
NODE_18838_length_670_cov_2.700525	252	332	2	18	80	0.2250000
NODE_18838_length_670_cov_2.700525	305	385	0	9	80	0.1125000
NODE_18838_length_670_cov_2.700525	305	385	2	71	80	0.8875000
NODE_18883_length_669_cov_13.307018	432	512	2	16	80	0.2000000
NODE_18883_length_669_cov_13.307018	432	512	4	64	80	0.8000000
NODE_18883_length_669_cov_13.307018	485	565	0	28	80	0.3500000
NODE_18883_length_669_cov_13.307018	485	565	2	41	80	0.5125000
NODE_18883_length_669_cov_13.307018	485	565	4	11	80	0.1375000
NODE_18886_length_669_cov_6.921053	245	325	0	80	80	1.0000000
NODE_18886_length_669_cov_6.921053	298	370	0	72	72	1.0000000
NODE_18901_length_669_cov_3.633333	277	347	0	70	70	1.0000000
NODE_18909_length_669_cov_2.361404	434	490	0	56	56	1.0000000
NODE_18958_length_668_cov_23.131810	275	355	0	80	80	1.0000000
NODE_18958_length_668_cov_23.131810	328	408	0	80	80	1.0000000
NODE_18959_length_668_cov_14.978910	324	404	0	56	80	0.7000000
NODE_18959_length_668_cov_14.978910	324	404	2	24	80	0.3000000
NODE_18959_length_668_cov_14.978910	377	457	0	3	80	0.0375000
NODE_18959_length_668_cov_14.978910	377	457	2	77	80	0.9625000
NODE_18962_length_668_cov_11.184534	187	267	0	80	80	1.0000000
NODE_18962_length_668_cov_11.184534	240	320	0	80	80	1.0000000
NODE_18963_length_668_cov_10.548330	211	291	2	54	80	0.6750000
NODE_18963_length_668_cov_10.548330	211	291	4	20	80	0.2500000
NODE_18963_length_668_cov_10.548330	211	291	6	6	80	0.0750000
NODE_18963_length_668_cov_10.548330	264	344	2	1	80	0.0125000
NODE_18963_length_668_cov_10.548330	264	344	4	73	80	0.9125000
NODE_18963_length_668_cov_10.548330	264	344	6	6	80	0.0750000
NODE_18964_length_668_cov_10.370826	226	308	0	82	82	1.0000000
NODE_18964_length_668_cov_10.370826	279	361	0	82	82	1.0000000
NODE_18965_length_668_cov_10.223199	238	318	0	80	80	1.0000000
NODE_18965_length_668_cov_10.223199	291	371	0	80	80	1.0000000
NODE_18967_length_668_cov_9.340949	310	390	0	80	80	1.0000000
NODE_18967_length_668_cov_9.340949	363	443	0	80	80	1.0000000
NODE_18975_length_668_cov_4.077329	304	384	2	48	80	0.6000000
NODE_18975_length_668_cov_4.077329	304	384	4	27	80	0.3375000
NODE_18975_length_668_cov_4.077329	304	384	6	5	80	0.0625000
NODE_18975_length_668_cov_4.077329	338	367	2	29	29	1.0000000
NODE_18975_length_668_cov_4.077329	358	427	2	21	69	0.3043478
NODE_18975_length_668_cov_4.077329	358	427	4	6	69	0.0869565
NODE_18975_length_668_cov_4.077329	358	427	6	42	69	0.6086956
NODE_19032_length_667_cov_33.848592	168	248	0	64	80	0.8000000
NODE_19032_length_667_cov_33.848592	168	248	4	16	80	0.2000000
NODE_19032_length_667_cov_33.848592	221	301	0	11	80	0.1375000
NODE_19032_length_667_cov_33.848592	221	301	4	43	80	0.5375000
NODE_19032_length_667_cov_33.848592	221	301	6	26	80	0.3250000
NODE_19033_length_667_cov_21.218310	270	350	0	52	80	0.6500000
NODE_19033_length_667_cov_21.218310	270	350	2	28	80	0.3500000
NODE_19033_length_667_cov_21.218310	323	403	0	11	80	0.1375000
NODE_19033_length_667_cov_21.218310	323	403	2	69	80	0.8625000
NODE_19034_length_667_cov_19.204225	258	338	2	80	80	1.0000000
NODE_19034_length_667_cov_19.204225	311	391	0	41	80	0.5125000
NODE_19034_length_667_cov_19.204225	311	391	2	39	80	0.4875000
NODE_19036_length_667_cov_8.264085	299	379	0	4	80	0.0500000
NODE_19036_length_667_cov_8.264085	299	379	2	76	80	0.9500000
NODE_19036_length_667_cov_8.264085	352	432	0	39	80	0.4875000
NODE_19036_length_667_cov_8.264085	352	432	2	41	80	0.5125000
NODE_19037_length_667_cov_8.248239	76	156	0	80	80	1.0000000
NODE_19037_length_667_cov_8.248239	129	209	0	80	80	1.0000000
NODE_19038_length_667_cov_8.207746	257	323	0	46	66	0.6969697
NODE_19038_length_667_cov_8.207746	257	323	2	20	66	0.3030303
NODE_19038_length_667_cov_8.207746	296	376	0	19	80	0.2375000
NODE_19038_length_667_cov_8.207746	296	376	2	61	80	0.7625000
NODE_19039_length_667_cov_7.232394	357	437	0	80	80	1.0000000
NODE_19039_length_667_cov_7.232394	410	490	0	80	80	1.0000000
NODE_19042_length_667_cov_4.941901	199	279	0	80	80	1.0000000
NODE_19042_length_667_cov_4.941901	252	332	0	80	80	1.0000000
NODE_19053_length_667_cov_3.404930	501	536	0	4	35	0.1142857
NODE_19053_length_667_cov_3.404930	501	536	2	31	35	0.8857143
NODE_19053_length_667_cov_3.404930	503	533	0	1	30	0.0333333
NODE_19053_length_667_cov_3.404930	503	533	2	29	30	0.9666666
NODE_19100_length_666_cov_24.811287	179	254	10	59	75	0.7866667
NODE_19100_length_666_cov_24.811287	179	254	17	10	75	0.1333333
NODE_19100_length_666_cov_24.811287	179	254	18	1	75	0.0133333
NODE_19100_length_666_cov_24.811287	179	254	19	5	75	0.0666667
NODE_19100_length_666_cov_24.811287	182	254	10	56	72	0.7777778
NODE_19100_length_666_cov_24.811287	182	254	17	10	72	0.1388889
NODE_19100_length_666_cov_24.811287	182	254	18	1	72	0.0138889
NODE_19100_length_666_cov_24.811287	182	254	19	5	72	0.0694444
NODE_19100_length_666_cov_24.811287	227	307	9	18	80	0.2250000
NODE_19100_length_666_cov_24.811287	227	307	10	11	80	0.1375000
NODE_19100_length_666_cov_24.811287	227	307	11	12	80	0.1500000
NODE_19100_length_666_cov_24.811287	227	307	17	33	80	0.4125000
NODE_19100_length_666_cov_24.811287	227	307	18	1	80	0.0125000
NODE_19100_length_666_cov_24.811287	227	307	19	5	80	0.0625000
NODE_19100_length_666_cov_24.811287	227	307	9	18	80	0.2250000
NODE_19100_length_666_cov_24.811287	227	307	10	11	80	0.1375000
NODE_19100_length_666_cov_24.811287	227	307	11	12	80	0.1500000
NODE_19100_length_666_cov_24.811287	227	307	17	33	80	0.4125000
NODE_19100_length_666_cov_24.811287	227	307	18	1	80	0.0125000
NODE_19100_length_666_cov_24.811287	227	307	19	5	80	0.0625000
NODE_19100_length_666_cov_24.811287	303	383	9	22	80	0.2750000
NODE_19100_length_666_cov_24.811287	303	383	20	9	80	0.1125000
NODE_19100_length_666_cov_24.811287	303	383	21	3	80	0.0375000
NODE_19100_length_666_cov_24.811287	303	383	25	5	80	0.0625000
NODE_19100_length_666_cov_24.811287	303	383	31	2	80	0.0250000
NODE_19100_length_666_cov_24.811287	303	383	35	3	80	0.0375000
NODE_19100_length_666_cov_24.811287	303	383	37	7	80	0.0875000
NODE_19100_length_666_cov_24.811287	303	383	38	2	80	0.0250000
NODE_19100_length_666_cov_24.811287	303	383	40	27	80	0.3375000
NODE_19100_length_666_cov_24.811287	356	436	30	17	80	0.2125000
NODE_19100_length_666_cov_24.811287	356	436	32	31	80	0.3875000
NODE_19100_length_666_cov_24.811287	356	436	39	2	80	0.0250000
NODE_19100_length_666_cov_24.811287	356	436	40	30	80	0.3750000
NODE_19102_length_666_cov_20.114638	172	252	0	39	80	0.4875000
NODE_19102_length_666_cov_20.114638	172	252	2	41	80	0.5125000
NODE_19102_length_666_cov_20.114638	225	305	0	2	80	0.0250000
NODE_19102_length_666_cov_20.114638	225	305	2	78	80	0.9750000
NODE_19103_length_666_cov_16.813051	220	286	0	66	66	1.0000000
NODE_19103_length_666_cov_16.813051	259	344	0	85	85	1.0000000
NODE_19104_length_666_cov_15.384480	306	386	0	4	80	0.0500000
NODE_19104_length_666_cov_15.384480	306	386	2	76	80	0.9500000
NODE_19104_length_666_cov_15.384480	359	439	0	43	80	0.5375000
NODE_19104_length_666_cov_15.384480	359	439	2	37	80	0.4625000
NODE_19105_length_666_cov_14.195767	485	565	0	80	80	1.0000000
NODE_19105_length_666_cov_14.195767	538	618	0	80	80	1.0000000
NODE_19108_length_666_cov_7.770723	226	306	0	80	80	1.0000000
NODE_19108_length_666_cov_7.770723	279	359	0	80	80	1.0000000
NODE_19163_length_665_cov_28.786219	391	471	0	80	80	1.0000000
NODE_19163_length_665_cov_28.786219	444	524	0	80	80	1.0000000
NODE_19164_length_665_cov_21.740283	311	391	0	80	80	1.0000000
NODE_19164_length_665_cov_21.740283	364	444	0	80	80	1.0000000
NODE_19165_length_665_cov_15.904594	390	470	0	80	80	1.0000000
NODE_19165_length_665_cov_15.904594	443	523	0	80	80	1.0000000
NODE_19224_length_664_cov_27.208850	259	339	0	80	80	1.0000000
NODE_19224_length_664_cov_27.208850	345	404	0	3	59	0.0508475
NODE_19224_length_664_cov_27.208850	345	404	2	56	59	0.9491525
NODE_19225_length_664_cov_16.116814	241	321	0	80	80	1.0000000
NODE_19225_length_664_cov_16.116814	294	374	0	80	80	1.0000000
NODE_19227_length_664_cov_14.185841	332	412	6	9	80	0.1125000
NODE_19227_length_664_cov_14.185841	332	412	8	71	80	0.8875000
NODE_19227_length_664_cov_14.185841	385	465	0	19	80	0.2375000
NODE_19227_length_664_cov_14.185841	385	465	2	29	80	0.3625000
NODE_19227_length_664_cov_14.185841	385	465	8	32	80	0.4000000
NODE_19228_length_664_cov_12.256637	325	405	0	42	80	0.5250000
NODE_19228_length_664_cov_12.256637	325	405	2	38	80	0.4750000
NODE_19228_length_664_cov_12.256637	378	454	0	22	76	0.2894737
NODE_19228_length_664_cov_12.256637	378	454	2	54	76	0.7105263
NODE_19229_length_664_cov_8.378761	252	332	0	59	80	0.7375000
NODE_19229_length_664_cov_8.378761	252	332	2	21	80	0.2625000
NODE_19229_length_664_cov_8.378761	305	385	0	6	80	0.0750000
NODE_19229_length_664_cov_8.378761	305	385	2	74	80	0.9250000
NODE_19229_length_664_cov_8.378761	381	461	0	55	80	0.6875000
NODE_19229_length_664_cov_8.378761	381	461	2	25	80	0.3125000
NODE_19229_length_664_cov_8.378761	434	514	0	80	80	1.0000000
NODE_19254_length_664_cov_1.922124	393	434	0	41	41	1.0000000
NODE_19298_length_663_cov_26.601064	398	478	0	80	80	1.0000000
NODE_19298_length_663_cov_26.601064	451	531	0	70	80	0.8750000
NODE_19298_length_663_cov_26.601064	451	531	2	10	80	0.1250000
NODE_19299_length_663_cov_16.948582	368	448	0	80	80	1.0000000
NODE_19299_length_663_cov_16.948582	421	501	0	80	80	1.0000000
NODE_19300_length_663_cov_16.225177	118	198	0	27	80	0.3375000
NODE_19300_length_663_cov_16.225177	118	198	2	53	80	0.6625000
NODE_19300_length_663_cov_16.225177	171	251	0	80	80	1.0000000
NODE_19302_length_663_cov_13.748227	277	357	0	9	80	0.1125000
NODE_19302_length_663_cov_13.748227	277	357	4	71	80	0.8875000
NODE_19302_length_663_cov_13.748227	330	410	0	15	80	0.1875000
NODE_19302_length_663_cov_13.748227	330	410	4	65	80	0.8125000
NODE_19303_length_663_cov_10.377660	300	380	0	80	80	1.0000000
NODE_19304_length_663_cov_9.549645	199	279	0	80	80	1.0000000
NODE_19304_length_663_cov_9.549645	252	332	0	80	80	1.0000000
NODE_19305_length_663_cov_7.397163	151	231	0	48	80	0.6000000
NODE_19305_length_663_cov_7.397163	151	231	4	32	80	0.4000000
NODE_19305_length_663_cov_7.397163	204	284	4	80	80	1.0000000
NODE_19307_length_663_cov_5.081560	317	397	0	80	80	1.0000000
NODE_19368_length_662_cov_29.218472	233	313	0	26	80	0.3250000
NODE_19368_length_662_cov_29.218472	233	313	2	15	80	0.1875000
NODE_19368_length_662_cov_29.218472	233	313	12	2	80	0.0250000
NODE_19368_length_662_cov_29.218472	233	313	14	37	80	0.4625000
NODE_19368_length_662_cov_29.218472	286	366	9	1	80	0.0125000
NODE_19368_length_662_cov_29.218472	286	366	11	8	80	0.1000000
NODE_19368_length_662_cov_29.218472	286	366	12	34	80	0.4250000
NODE_19368_length_662_cov_29.218472	286	366	14	37	80	0.4625000
NODE_19369_length_662_cov_18.717584	193	273	0	80	80	1.0000000
NODE_19369_length_662_cov_18.717584	246	326	0	80	80	1.0000000
NODE_19370_length_662_cov_16.358792	258	338	2	5	80	0.0625000
NODE_19370_length_662_cov_16.358792	258	338	4	75	80	0.9375000
NODE_19370_length_662_cov_16.358792	311	391	0	42	80	0.5250000
NODE_19370_length_662_cov_16.358792	311	391	2	16	80	0.2000000
NODE_19370_length_662_cov_16.358792	311	391	4	22	80	0.2750000
NODE_19371_length_662_cov_12.845471	259	339	2	35	80	0.4375000
NODE_19371_length_662_cov_12.845471	259	339	4	45	80	0.5625000
NODE_19371_length_662_cov_12.845471	312	392	0	25	80	0.3125000
NODE_19371_length_662_cov_12.845471	312	392	2	55	80	0.6875000
NODE_19372_length_662_cov_12.476021	299	379	0	80	80	1.0000000
NODE_19372_length_662_cov_12.476021	352	432	0	80	80	1.0000000
NODE_19373_length_662_cov_10.252220	239	319	0	80	80	1.0000000
NODE_19373_length_662_cov_10.252220	292	372	0	80	80	1.0000000
NODE_19376_length_662_cov_6.335702	267	347	0	47	80	0.5875000
NODE_19376_length_662_cov_6.335702	267	347	2	6	80	0.0750000
NODE_19376_length_662_cov_6.335702	267	347	4	17	80	0.2125000
NODE_19376_length_662_cov_6.335702	267	347	6	10	80	0.1250000
NODE_19376_length_662_cov_6.335702	320	400	0	80	80	1.0000000
NODE_19378_length_662_cov_5.738899	295	331	0	36	36	1.0000000
NODE_19378_length_662_cov_5.738899	301	322	0	21	21	1.0000000
NODE_19402_length_662_cov_1.905861	150	230	0	80	80	1.0000000
NODE_19402_length_662_cov_1.905861	203	277	0	74	74	1.0000000
NODE_19441_length_661_cov_55.176157	236	316	2	21	80	0.2625000
NODE_19441_length_661_cov_55.176157	236	316	3	29	80	0.3625000
NODE_19441_length_661_cov_55.176157	236	316	4	11	80	0.1375000
NODE_19441_length_661_cov_55.176157	236	316	5	19	80	0.2375000
NODE_19441_length_661_cov_55.176157	289	369	0	35	80	0.4375000
NODE_19441_length_661_cov_55.176157	289	369	1	3	80	0.0375000
NODE_19441_length_661_cov_55.176157	289	369	2	36	80	0.4500000
NODE_19441_length_661_cov_55.176157	289	369	5	6	80	0.0750000
NODE_19442_length_661_cov_38.501779	231	311	4	80	80	1.0000000
NODE_19442_length_661_cov_38.501779	284	364	0	7	80	0.0875000
NODE_19442_length_661_cov_38.501779	284	364	2	24	80	0.3000000
NODE_19442_length_661_cov_38.501779	284	364	4	49	80	0.6125000
NODE_19442_length_661_cov_38.501779	360	440	0	80	80	1.0000000
NODE_19442_length_661_cov_38.501779	413	493	0	29	80	0.3625000
NODE_19442_length_661_cov_38.501779	413	493	2	31	80	0.3875000
NODE_19442_length_661_cov_38.501779	413	493	5	3	80	0.0375000
NODE_19442_length_661_cov_38.501779	413	493	7	15	80	0.1875000
NODE_19442_length_661_cov_38.501779	413	493	9	2	80	0.0250000
NODE_19443_length_661_cov_31.460854	128	208	0	80	80	1.0000000
NODE_19443_length_661_cov_31.460854	181	261	0	80	80	1.0000000
NODE_19444_length_661_cov_18.960854	216	296	0	20	80	0.2500000
NODE_19444_length_661_cov_18.960854	216	296	2	60	80	0.7500000
NODE_19444_length_661_cov_18.960854	269	349	0	73	80	0.9125000
NODE_19444_length_661_cov_18.960854	269	349	2	7	80	0.0875000
NODE_19445_length_661_cov_16.035587	201	281	2	80	80	1.0000000
NODE_19445_length_661_cov_16.035587	254	334	1	13	80	0.1625000
NODE_19445_length_661_cov_16.035587	254	334	2	67	80	0.8375000
NODE_19447_length_661_cov_13.005338	281	343	0	62	62	1.0000000
NODE_19447_length_661_cov_13.005338	353	433	0	80	80	1.0000000
NODE_19447_length_661_cov_13.005338	406	486	0	80	80	1.0000000
NODE_19452_length_661_cov_5.670819	374	454	0	80	80	1.0000000
NODE_19452_length_661_cov_5.670819	427	507	0	80	80	1.0000000
NODE_19457_length_661_cov_4.601423	319	395	2	10	76	0.1315790
NODE_19457_length_661_cov_4.601423	319	395	8	66	76	0.8684211
NODE_19459_length_661_cov_3.532028	282	362	0	41	80	0.5125000
NODE_19459_length_661_cov_3.532028	282	362	2	9	80	0.1125000
NODE_19459_length_661_cov_3.532028	282	362	4	30	80	0.3750000
NODE_19459_length_661_cov_3.532028	335	415	0	80	80	1.0000000
NODE_19515_length_660_cov_20.741533	343	423	2	80	80	1.0000000
NODE_19515_length_660_cov_20.741533	396	476	0	33	80	0.4125000
NODE_19515_length_660_cov_20.741533	396	476	2	47	80	0.5875000
NODE_19516_length_660_cov_15.089127	148	228	2	16	80	0.2000000
NODE_19516_length_660_cov_15.089127	148	228	8	34	80	0.4250000
NODE_19516_length_660_cov_15.089127	148	228	9	2	80	0.0250000
NODE_19516_length_660_cov_15.089127	148	228	10	28	80	0.3500000
NODE_19516_length_660_cov_15.089127	201	281	8	80	80	1.0000000
NODE_19518_length_660_cov_13.301248	276	356	0	80	80	1.0000000
NODE_19518_length_660_cov_13.301248	329	409	0	80	80	1.0000000
NODE_19519_length_660_cov_12.393939	234	314	0	27	80	0.3375000
NODE_19519_length_660_cov_12.393939	234	314	2	53	80	0.6625000
NODE_19519_length_660_cov_12.393939	287	367	0	13	80	0.1625000
NODE_19519_length_660_cov_12.393939	287	367	2	67	80	0.8375000
NODE_19521_length_660_cov_11.495544	399	479	0	8	80	0.1000000
NODE_19521_length_660_cov_11.495544	399	479	2	72	80	0.9000000
NODE_19521_length_660_cov_11.495544	452	532	0	61	80	0.7625000
NODE_19521_length_660_cov_11.495544	452	532	2	19	80	0.2375000
NODE_19522_length_660_cov_10.522282	177	257	0	80	80	1.0000000
NODE_19522_length_660_cov_10.522282	230	311	0	81	81	1.0000000
NODE_19524_length_660_cov_8.887701	254	325	2	37	71	0.5211267
NODE_19524_length_660_cov_8.887701	254	325	4	34	71	0.4788733
NODE_19527_length_660_cov_7.278075	225	305	0	80	80	1.0000000
NODE_19527_length_660_cov_7.278075	278	358	0	80	80	1.0000000
NODE_19529_length_660_cov_6.577540	350	430	0	37	80	0.4625000
NODE_19529_length_660_cov_6.577540	350	430	1	8	80	0.1000000
NODE_19529_length_660_cov_6.577540	350	430	2	34	80	0.4250000
NODE_19529_length_660_cov_6.577540	350	430	4	1	80	0.0125000
NODE_19529_length_660_cov_6.577540	403	483	0	26	80	0.3250000
NODE_19529_length_660_cov_6.577540	403	483	4	54	80	0.6750000
NODE_19549_length_660_cov_2.354724	421	470	2	5	49	0.1020408
NODE_19549_length_660_cov_2.354724	421	470	4	44	49	0.8979592
NODE_19594_length_659_cov_43.587500	2	82	0	80	80	1.0000000
NODE_19594_length_659_cov_43.587500	55	135	0	80	80	1.0000000
NODE_19594_length_659_cov_43.587500	131	211	0	80	80	1.0000000
NODE_19594_length_659_cov_43.587500	184	264	0	80	80	1.0000000
NODE_19595_length_659_cov_23.330357	236	316	0	80	80	1.0000000
NODE_19595_length_659_cov_23.330357	289	369	0	80	80	1.0000000
NODE_19596_length_659_cov_12.775000	255	335	0	15	80	0.1875000
NODE_19596_length_659_cov_12.775000	255	335	6	65	80	0.8125000
NODE_19596_length_659_cov_12.775000	308	388	2	8	80	0.1000000
NODE_19596_length_659_cov_12.775000	308	388	6	66	80	0.8250000
NODE_19596_length_659_cov_12.775000	308	388	8	6	80	0.0750000
NODE_19598_length_659_cov_9.683929	220	298	0	47	78	0.6025641
NODE_19598_length_659_cov_9.683929	220	298	4	13	78	0.1666667
NODE_19598_length_659_cov_9.683929	220	298	6	18	78	0.2307692
NODE_19598_length_659_cov_9.683929	271	351	0	80	80	1.0000000
NODE_19613_length_659_cov_3.658929	305	385	0	80	80	1.0000000
NODE_19613_length_659_cov_3.658929	358	438	0	80	80	1.0000000
NODE_19678_length_658_cov_38.479428	289	369	2	80	80	1.0000000
NODE_19678_length_658_cov_38.479428	342	422	2	80	80	1.0000000
NODE_19679_length_658_cov_35.409660	242	322	0	80	80	1.0000000
NODE_19679_length_658_cov_35.409660	295	375	0	80	80	1.0000000
NODE_19680_length_658_cov_20.322004	191	271	0	17	80	0.2125000
NODE_19680_length_658_cov_20.322004	191	271	2	63	80	0.7875000
NODE_19680_length_658_cov_20.322004	244	321	0	7	77	0.0909091
NODE_19680_length_658_cov_20.322004	244	321	2	70	77	0.9090909
NODE_19680_length_658_cov_20.322004	317	397	0	70	80	0.8750000
NODE_19680_length_658_cov_20.322004	317	397	2	10	80	0.1250000
NODE_19680_length_658_cov_20.322004	370	449	0	17	79	0.2151899
NODE_19680_length_658_cov_20.322004	370	449	2	62	79	0.7848101
NODE_19681_length_658_cov_11.352415	324	404	0	80	80	1.0000000
NODE_19681_length_658_cov_11.352415	377	457	0	80	80	1.0000000
NODE_19685_length_658_cov_8.241503	227	307	0	80	80	1.0000000
NODE_19685_length_658_cov_8.241503	280	360	0	80	80	1.0000000
NODE_19689_length_658_cov_5.477639	450	530	4	30	80	0.3750000
NODE_19689_length_658_cov_5.477639	450	530	6	50	80	0.6250000
NODE_19705_length_658_cov_2.277281	286	366	0	42	80	0.5250000
NODE_19705_length_658_cov_2.277281	286	366	2	38	80	0.4750000
NODE_19705_length_658_cov_2.277281	339	419	0	41	80	0.5125000
NODE_19705_length_658_cov_2.277281	339	419	4	3	80	0.0375000
NODE_19705_length_658_cov_2.277281	339	419	8	2	80	0.0250000
NODE_19705_length_658_cov_2.277281	339	419	11	1	80	0.0125000
NODE_19705_length_658_cov_2.277281	339	419	12	11	80	0.1375000
NODE_19705_length_658_cov_2.277281	339	419	13	14	80	0.1750000
NODE_19705_length_658_cov_2.277281	339	419	14	3	80	0.0375000
NODE_19705_length_658_cov_2.277281	339	419	16	2	80	0.0250000
NODE_19705_length_658_cov_2.277281	339	419	17	3	80	0.0375000
NODE_19750_length_657_cov_71.087814	306	372	0	56	66	0.8484849
NODE_19750_length_657_cov_71.087814	306	372	1	1	66	0.0151515
NODE_19750_length_657_cov_71.087814	306	372	7	1	66	0.0151515
NODE_19750_length_657_cov_71.087814	306	372	8	8	66	0.1212121
NODE_19750_length_657_cov_71.087814	382	462	8	13	80	0.1625000
NODE_19750_length_657_cov_71.087814	382	462	10	5	80	0.0625000
NODE_19750_length_657_cov_71.087814	382	462	12	1	80	0.0125000
NODE_19750_length_657_cov_71.087814	382	462	14	3	80	0.0375000
NODE_19750_length_657_cov_71.087814	382	462	17	3	80	0.0375000
NODE_19750_length_657_cov_71.087814	382	462	18	3	80	0.0375000
NODE_19750_length_657_cov_71.087814	382	462	19	17	80	0.2125000
NODE_19750_length_657_cov_71.087814	382	462	21	10	80	0.1250000
NODE_19750_length_657_cov_71.087814	382	462	23	20	80	0.2500000
NODE_19750_length_657_cov_71.087814	382	462	24	1	80	0.0125000
NODE_19750_length_657_cov_71.087814	382	462	25	1	80	0.0125000
NODE_19750_length_657_cov_71.087814	382	462	31	3	80	0.0375000
NODE_19750_length_657_cov_71.087814	382	462	8	13	80	0.1625000
NODE_19750_length_657_cov_71.087814	382	462	10	5	80	0.0625000
NODE_19750_length_657_cov_71.087814	382	462	12	1	80	0.0125000
NODE_19750_length_657_cov_71.087814	382	462	14	3	80	0.0375000
NODE_19750_length_657_cov_71.087814	382	462	17	3	80	0.0375000
NODE_19750_length_657_cov_71.087814	382	462	18	3	80	0.0375000
NODE_19750_length_657_cov_71.087814	382	462	19	17	80	0.2125000
NODE_19750_length_657_cov_71.087814	382	462	21	10	80	0.1250000
NODE_19750_length_657_cov_71.087814	382	462	23	20	80	0.2500000
NODE_19750_length_657_cov_71.087814	382	462	24	1	80	0.0125000
NODE_19750_length_657_cov_71.087814	382	462	25	1	80	0.0125000
NODE_19750_length_657_cov_71.087814	382	462	31	3	80	0.0375000
NODE_19750_length_657_cov_71.087814	435	515	16	20	80	0.2500000
NODE_19750_length_657_cov_71.087814	435	515	19	5	80	0.0625000
NODE_19750_length_657_cov_71.087814	435	515	20	2	80	0.0250000
NODE_19750_length_657_cov_71.087814	435	515	21	10	80	0.1250000
NODE_19750_length_657_cov_71.087814	435	515	22	11	80	0.1375000
NODE_19750_length_657_cov_71.087814	435	515	23	7	80	0.0875000
NODE_19750_length_657_cov_71.087814	435	515	24	7	80	0.0875000
NODE_19750_length_657_cov_71.087814	435	515	25	1	80	0.0125000
NODE_19750_length_657_cov_71.087814	435	515	26	4	80	0.0500000
NODE_19750_length_657_cov_71.087814	435	515	30	1	80	0.0125000
NODE_19750_length_657_cov_71.087814	435	515	31	12	80	0.1500000
NODE_19750_length_657_cov_71.087814	440	515	16	20	75	0.2666667
NODE_19750_length_657_cov_71.087814	440	515	19	5	75	0.0666667
NODE_19750_length_657_cov_71.087814	440	515	20	2	75	0.0266667
NODE_19750_length_657_cov_71.087814	440	515	21	10	75	0.1333333
NODE_19750_length_657_cov_71.087814	440	515	22	11	75	0.1466667
NODE_19750_length_657_cov_71.087814	440	515	23	2	75	0.0266667
NODE_19750_length_657_cov_71.087814	440	515	24	7	75	0.0933333
NODE_19750_length_657_cov_71.087814	440	515	25	1	75	0.0133333
NODE_19750_length_657_cov_71.087814	440	515	26	4	75	0.0533333
NODE_19750_length_657_cov_71.087814	440	515	30	1	75	0.0133333
NODE_19750_length_657_cov_71.087814	440	515	31	12	75	0.1600000
NODE_19751_length_657_cov_67.408602	98	178	0	4	80	0.0500000
NODE_19751_length_657_cov_67.408602	98	178	2	76	80	0.9500000
NODE_19751_length_657_cov_67.408602	151	231	0	53	80	0.6625000
NODE_19751_length_657_cov_67.408602	151	231	2	27	80	0.3375000
NODE_19752_length_657_cov_15.568100	265	345	0	80	80	1.0000000
NODE_19752_length_657_cov_15.568100	341	421	0	80	80	1.0000000
NODE_19759_length_657_cov_5.161290	185	256	0	67	71	0.9436620
NODE_19759_length_657_cov_5.161290	185	256	2	4	71	0.0563380
NODE_19759_length_657_cov_5.161290	229	309	0	23	80	0.2875000
NODE_19759_length_657_cov_5.161290	229	309	2	57	80	0.7125000
NODE_19824_length_656_cov_37.023339	470	550	0	80	80	1.0000000
NODE_19824_length_656_cov_37.023339	523	603	0	80	80	1.0000000
NODE_19825_length_656_cov_22.804309	173	253	0	80	80	1.0000000
NODE_19825_length_656_cov_22.804309	226	306	0	80	80	1.0000000
NODE_19826_length_656_cov_19.280072	345	425	0	80	80	1.0000000
NODE_19826_length_656_cov_19.280072	398	478	0	80	80	1.0000000
NODE_19827_length_656_cov_18.267504	272	352	2	80	80	1.0000000
NODE_19827_length_656_cov_18.267504	325	405	2	80	80	1.0000000
NODE_19828_length_656_cov_15.928187	223	303	0	39	80	0.4875000
NODE_19828_length_656_cov_15.928187	223	303	4	41	80	0.5125000
NODE_19829_length_656_cov_15.091562	297	377	4	36	80	0.4500000
NODE_19829_length_656_cov_15.091562	297	377	6	44	80	0.5500000
NODE_19829_length_656_cov_15.091562	350	430	2	37	80	0.4625000
NODE_19829_length_656_cov_15.091562	350	430	6	43	80	0.5375000
NODE_19830_length_656_cov_12.773788	269	349	0	80	80	1.0000000
NODE_19830_length_656_cov_12.773788	322	399	0	77	77	1.0000000
NODE_19831_length_656_cov_12.493716	212	292	0	80	80	1.0000000
NODE_19831_length_656_cov_12.493716	265	345	0	80	80	1.0000000
NODE_19832_length_656_cov_10.946140	197	277	0	80	80	1.0000000
NODE_19832_length_656_cov_10.946140	250	330	0	80	80	1.0000000
NODE_19833_length_656_cov_9.412926	295	375	0	80	80	1.0000000
NODE_19833_length_656_cov_9.412926	348	428	0	80	80	1.0000000
NODE_19904_length_655_cov_31.019784	212	292	0	80	80	1.0000000
NODE_19904_length_655_cov_31.019784	265	345	0	80	80	1.0000000
NODE_19907_length_655_cov_8.672662	216	296	0	80	80	1.0000000
NODE_19907_length_655_cov_8.672662	269	349	0	80	80	1.0000000
NODE_19908_length_655_cov_8.250000	204	234	0	30	30	1.0000000
NODE_19909_length_655_cov_7.910072	366	446	0	31	80	0.3875000
NODE_19909_length_655_cov_7.910072	366	446	2	49	80	0.6125000
NODE_19909_length_655_cov_7.910072	419	499	2	80	80	1.0000000
NODE_19916_length_655_cov_5.478417	178	255	0	77	77	1.0000000
NODE_19916_length_655_cov_5.478417	178	221	0	43	43	1.0000000
NODE_19919_length_655_cov_5.174460	347	428	0	23	81	0.2839506
NODE_19919_length_655_cov_5.174460	347	428	4	10	81	0.1234568
NODE_19919_length_655_cov_5.174460	347	428	6	48	81	0.5925926
NODE_19919_length_655_cov_5.174460	401	481	0	16	80	0.2000000
NODE_19919_length_655_cov_5.174460	401	481	2	23	80	0.2875000
NODE_19919_length_655_cov_5.174460	401	481	6	41	80	0.5125000
NODE_19979_length_654_cov_17.086486	323	403	0	80	80	1.0000000
NODE_19979_length_654_cov_17.086486	376	456	0	79	80	0.9875000
NODE_19979_length_654_cov_17.086486	376	456	2	1	80	0.0125000
NODE_19980_length_654_cov_16.194595	318	398	0	2	80	0.0250000
NODE_19980_length_654_cov_16.194595	318	398	2	78	80	0.9750000
NODE_19980_length_654_cov_16.194595	371	451	0	52	80	0.6500000
NODE_19980_length_654_cov_16.194595	371	451	2	28	80	0.3500000
NODE_19983_length_654_cov_5.556757	341	412	0	71	71	1.0000000
NODE_19990_length_654_cov_3.236036	105	181	0	11	76	0.1447368
NODE_19990_length_654_cov_3.236036	105	181	4	65	76	0.8552632
NODE_19990_length_654_cov_3.236036	158	236	0	33	78	0.4230769
NODE_19990_length_654_cov_3.236036	158	236	4	45	78	0.5769231
NODE_19998_length_654_cov_2.549550	279	366	0	87	87	1.0000000
NODE_20013_length_654_cov_1.790991	480	560	8	1	80	0.0125000
NODE_20013_length_654_cov_1.790991	480	560	10	1	80	0.0125000
NODE_20013_length_654_cov_1.790991	480	560	13	1	80	0.0125000
NODE_20013_length_654_cov_1.790991	480	560	14	36	80	0.4500000
NODE_20013_length_654_cov_1.790991	480	560	16	41	80	0.5125000
NODE_20044_length_653_cov_70.296029	277	357	0	31	80	0.3875000
NODE_20044_length_653_cov_70.296029	277	357	2	49	80	0.6125000
NODE_20044_length_653_cov_70.296029	330	410	2	76	80	0.9500000
NODE_20044_length_653_cov_70.296029	330	410	4	4	80	0.0500000
NODE_20045_length_653_cov_28.072202	302	382	0	30	80	0.3750000
NODE_20045_length_653_cov_28.072202	302	382	4	50	80	0.6250000
NODE_20045_length_653_cov_28.072202	355	435	0	80	80	1.0000000
NODE_20046_length_653_cov_18.382671	214	294	0	80	80	1.0000000
NODE_20046_length_653_cov_18.382671	267	347	0	80	80	1.0000000
NODE_20047_length_653_cov_8.821300	292	372	0	23	80	0.2875000
NODE_20047_length_653_cov_8.821300	292	372	2	57	80	0.7125000
NODE_20047_length_653_cov_8.821300	345	425	0	76	80	0.9500000
NODE_20047_length_653_cov_8.821300	345	425	2	4	80	0.0500000
NODE_20048_length_653_cov_8.660650	200	280	2	13	80	0.1625000
NODE_20048_length_653_cov_8.660650	200	280	6	67	80	0.8375000
NODE_20048_length_653_cov_8.660650	253	333	0	21	80	0.2625000
NODE_20048_length_653_cov_8.660650	253	333	4	14	80	0.1750000
NODE_20048_length_653_cov_8.660650	253	333	6	45	80	0.5625000
NODE_20052_length_653_cov_5.777978	308	383	3	2	75	0.0266667
NODE_20052_length_653_cov_5.777978	308	383	5	10	75	0.1333333
NODE_20052_length_653_cov_5.777978	308	383	7	15	75	0.2000000
NODE_20052_length_653_cov_5.777978	308	383	11	19	75	0.2533333
NODE_20052_length_653_cov_5.777978	308	383	13	3	75	0.0400000
NODE_20052_length_653_cov_5.777978	308	383	14	13	75	0.1733333
NODE_20052_length_653_cov_5.777978	308	383	15	13	75	0.1733333
NODE_20052_length_653_cov_5.777978	361	435	8	14	74	0.1891892
NODE_20052_length_653_cov_5.777978	361	435	10	12	74	0.1621622
NODE_20052_length_653_cov_5.777978	361	435	12	20	74	0.2702703
NODE_20052_length_653_cov_5.777978	361	435	14	19	74	0.2567568
NODE_20052_length_653_cov_5.777978	361	435	15	9	74	0.1216216
NODE_20054_length_653_cov_5.193141	304	356	0	52	52	1.0000000
NODE_20058_length_653_cov_4.823105	178	251	2	2	73	0.0273973
NODE_20058_length_653_cov_4.823105	178	251	4	1	73	0.0136986
NODE_20058_length_653_cov_4.823105	178	251	6	13	73	0.1780822
NODE_20058_length_653_cov_4.823105	178	251	8	29	73	0.3972603
NODE_20058_length_653_cov_4.823105	178	251	10	28	73	0.3835616
NODE_20058_length_653_cov_4.823105	178	256	2	2	78	0.0256410
NODE_20058_length_653_cov_4.823105	178	256	4	6	78	0.0769231
NODE_20058_length_653_cov_4.823105	178	256	6	13	78	0.1666667
NODE_20058_length_653_cov_4.823105	178	256	8	29	78	0.3717949
NODE_20058_length_653_cov_4.823105	178	256	10	28	78	0.3589744
NODE_20058_length_653_cov_4.823105	229	309	2	17	80	0.2125000
NODE_20058_length_653_cov_4.823105	229	309	4	42	80	0.5250000
NODE_20058_length_653_cov_4.823105	229	309	8	13	80	0.1625000
NODE_20058_length_653_cov_4.823105	229	309	10	8	80	0.1000000
NODE_20058_length_653_cov_4.823105	229	309	2	17	80	0.2125000
NODE_20058_length_653_cov_4.823105	229	309	4	42	80	0.5250000
NODE_20058_length_653_cov_4.823105	229	309	8	13	80	0.1625000
NODE_20058_length_653_cov_4.823105	229	309	10	8	80	0.1000000
NODE_20058_length_653_cov_4.823105	239	309	2	17	70	0.2428571
NODE_20058_length_653_cov_4.823105	239	309	4	42	70	0.6000000
NODE_20058_length_653_cov_4.823105	239	309	8	11	70	0.1571429
NODE_20127_length_652_cov_215.211573	185	248	4	42	63	0.6666667
NODE_20127_length_652_cov_215.211573	185	248	6	4	63	0.0634921
NODE_20127_length_652_cov_215.211573	185	248	8	17	63	0.2698413
NODE_20127_length_652_cov_215.211573	221	301	4	6	80	0.0750000
NODE_20127_length_652_cov_215.211573	221	301	6	4	80	0.0500000
NODE_20127_length_652_cov_215.211573	221	301	8	21	80	0.2625000
NODE_20127_length_652_cov_215.211573	221	301	10	8	80	0.1000000
NODE_20127_length_652_cov_215.211573	221	301	11	1	80	0.0125000
NODE_20127_length_652_cov_215.211573	221	301	12	16	80	0.2000000
NODE_20127_length_652_cov_215.211573	221	301	14	11	80	0.1375000
NODE_20127_length_652_cov_215.211573	221	301	16	4	80	0.0500000
NODE_20127_length_652_cov_215.211573	221	301	18	9	80	0.1125000
NODE_20128_length_652_cov_21.267631	299	379	0	52	80	0.6500000
NODE_20128_length_652_cov_21.267631	299	379	4	28	80	0.3500000
NODE_20128_length_652_cov_21.267631	352	432	3	38	80	0.4750000
NODE_20128_length_652_cov_21.267631	352	432	4	42	80	0.5250000
NODE_20138_length_652_cov_4.622061	266	315	6	49	49	1.0000000
NODE_20138_length_652_cov_4.622061	288	368	0	22	80	0.2750000
NODE_20138_length_652_cov_4.622061	288	368	6	58	80	0.7250000
NODE_20210_length_651_cov_49.981884	425	505	9	20	80	0.2500000
NODE_20210_length_651_cov_49.981884	425	505	10	4	80	0.0500000
NODE_20210_length_651_cov_49.981884	425	505	11	31	80	0.3875000
NODE_20210_length_651_cov_49.981884	425	505	13	9	80	0.1125000
NODE_20210_length_651_cov_49.981884	425	505	15	8	80	0.1000000
NODE_20210_length_651_cov_49.981884	425	505	16	5	80	0.0625000
NODE_20210_length_651_cov_49.981884	425	505	17	2	80	0.0250000
NODE_20210_length_651_cov_49.981884	425	505	19	1	80	0.0125000
NODE_20210_length_651_cov_49.981884	425	505	9	20	80	0.2500000
NODE_20210_length_651_cov_49.981884	425	505	10	4	80	0.0500000
NODE_20210_length_651_cov_49.981884	425	505	11	31	80	0.3875000
NODE_20210_length_651_cov_49.981884	425	505	13	9	80	0.1125000
NODE_20210_length_651_cov_49.981884	425	505	15	8	80	0.1000000
NODE_20210_length_651_cov_49.981884	425	505	16	5	80	0.0625000
NODE_20210_length_651_cov_49.981884	425	505	17	2	80	0.0250000
NODE_20210_length_651_cov_49.981884	425	505	19	1	80	0.0125000
NODE_20210_length_651_cov_49.981884	425	505	9	20	80	0.2500000
NODE_20210_length_651_cov_49.981884	425	505	10	4	80	0.0500000
NODE_20210_length_651_cov_49.981884	425	505	11	31	80	0.3875000
NODE_20210_length_651_cov_49.981884	425	505	13	9	80	0.1125000
NODE_20210_length_651_cov_49.981884	425	505	15	8	80	0.1000000
NODE_20210_length_651_cov_49.981884	425	505	16	5	80	0.0625000
NODE_20210_length_651_cov_49.981884	425	505	17	2	80	0.0250000
NODE_20210_length_651_cov_49.981884	425	505	19	1	80	0.0125000
NODE_20210_length_651_cov_49.981884	425	505	9	20	80	0.2500000
NODE_20210_length_651_cov_49.981884	425	505	10	4	80	0.0500000
NODE_20210_length_651_cov_49.981884	425	505	11	31	80	0.3875000
NODE_20210_length_651_cov_49.981884	425	505	13	9	80	0.1125000
NODE_20210_length_651_cov_49.981884	425	505	15	8	80	0.1000000
NODE_20210_length_651_cov_49.981884	425	505	16	5	80	0.0625000
NODE_20210_length_651_cov_49.981884	425	505	17	2	80	0.0250000
NODE_20210_length_651_cov_49.981884	425	505	19	1	80	0.0125000
NODE_20210_length_651_cov_49.981884	478	540	11	2	62	0.0322581
NODE_20210_length_651_cov_49.981884	478	540	13	9	62	0.1451613
NODE_20210_length_651_cov_49.981884	478	540	14	7	62	0.1129032
NODE_20210_length_651_cov_49.981884	478	540	15	8	62	0.1290323
NODE_20210_length_651_cov_49.981884	478	540	16	29	62	0.4677419
NODE_20210_length_651_cov_49.981884	478	540	17	2	62	0.0322581
NODE_20210_length_651_cov_49.981884	478	540	18	4	62	0.0645161
NODE_20210_length_651_cov_49.981884	478	540	19	1	62	0.0161290
NODE_20210_length_651_cov_49.981884	478	540	11	2	62	0.0322581
NODE_20210_length_651_cov_49.981884	478	540	13	9	62	0.1451613
NODE_20210_length_651_cov_49.981884	478	540	14	7	62	0.1129032
NODE_20210_length_651_cov_49.981884	478	540	15	8	62	0.1290323
NODE_20210_length_651_cov_49.981884	478	540	16	29	62	0.4677419
NODE_20210_length_651_cov_49.981884	478	540	17	2	62	0.0322581
NODE_20210_length_651_cov_49.981884	478	540	18	4	62	0.0645161
NODE_20210_length_651_cov_49.981884	478	540	19	1	62	0.0161290
NODE_20210_length_651_cov_49.981884	478	540	11	2	62	0.0322581
NODE_20210_length_651_cov_49.981884	478	540	13	9	62	0.1451613
NODE_20210_length_651_cov_49.981884	478	540	14	7	62	0.1129032
NODE_20210_length_651_cov_49.981884	478	540	15	8	62	0.1290323
NODE_20210_length_651_cov_49.981884	478	540	16	29	62	0.4677419
NODE_20210_length_651_cov_49.981884	478	540	17	2	62	0.0322581
NODE_20210_length_651_cov_49.981884	478	540	18	4	62	0.0645161
NODE_20210_length_651_cov_49.981884	478	540	19	1	62	0.0161290
NODE_20210_length_651_cov_49.981884	478	542	11	2	64	0.0312500
NODE_20210_length_651_cov_49.981884	478	542	13	9	64	0.1406250
NODE_20210_length_651_cov_49.981884	478	542	14	9	64	0.1406250
NODE_20210_length_651_cov_49.981884	478	542	15	8	64	0.1250000
NODE_20210_length_651_cov_49.981884	478	542	16	29	64	0.4531250
NODE_20210_length_651_cov_49.981884	478	542	17	2	64	0.0312500
NODE_20210_length_651_cov_49.981884	478	542	18	4	64	0.0625000
NODE_20210_length_651_cov_49.981884	478	542	19	1	64	0.0156250
NODE_20211_length_651_cov_36.121377	422	502	0	80	80	1.0000000
NODE_20211_length_651_cov_36.121377	475	555	0	80	80	1.0000000
NODE_20212_length_651_cov_20.045290	252	332	0	11	80	0.1375000
NODE_20212_length_651_cov_20.045290	252	332	2	69	80	0.8625000
NODE_20212_length_651_cov_20.045290	305	385	0	30	80	0.3750000
NODE_20212_length_651_cov_20.045290	305	385	2	50	80	0.6250000
NODE_20213_length_651_cov_12.704710	264	344	0	80	80	1.0000000
NODE_20213_length_651_cov_12.704710	317	397	0	38	80	0.4750000
NODE_20213_length_651_cov_12.704710	317	397	2	42	80	0.5250000
NODE_20214_length_651_cov_11.632246	205	285	0	80	80	1.0000000
NODE_20214_length_651_cov_11.632246	258	338	0	80	80	1.0000000
NODE_20215_length_651_cov_10.074275	369	449	0	45	80	0.5625000
NODE_20215_length_651_cov_10.074275	369	449	2	32	80	0.4000000
NODE_20215_length_651_cov_10.074275	369	449	6	3	80	0.0375000
NODE_20215_length_651_cov_10.074275	422	502	2	24	80	0.3000000
NODE_20215_length_651_cov_10.074275	422	502	6	56	80	0.7000000
NODE_20216_length_651_cov_9.699275	199	279	0	80	80	1.0000000
NODE_20216_length_651_cov_9.699275	252	332	0	80	80	1.0000000
NODE_20219_length_651_cov_8.309783	217	296	0	42	79	0.5316456
NODE_20219_length_651_cov_8.309783	217	296	2	37	79	0.4683544
NODE_20219_length_651_cov_8.309783	269	349	0	11	80	0.1375000
NODE_20219_length_651_cov_8.309783	269	349	2	69	80	0.8625000
NODE_20220_length_651_cov_5.621377	148	228	0	80	80	1.0000000
NODE_20220_length_651_cov_5.621377	201	281	0	80	80	1.0000000
NODE_20221_length_651_cov_5.610507	342	422	0	2	80	0.0250000
NODE_20221_length_651_cov_5.610507	342	422	2	78	80	0.9750000
NODE_20221_length_651_cov_5.610507	395	475	0	55	80	0.6875000
NODE_20221_length_651_cov_5.610507	395	475	2	25	80	0.3125000
NODE_20225_length_651_cov_4.246377	299	359	4	60	60	1.0000000
NODE_20238_length_651_cov_2.744565	340	421	0	81	81	1.0000000
NODE_20252_length_651_cov_2.016304	280	311	0	31	31	1.0000000
NODE_20292_length_650_cov_22.644283	233	313	0	75	80	0.9375000
NODE_20292_length_650_cov_22.644283	233	313	2	5	80	0.0625000
NODE_20292_length_650_cov_22.644283	286	366	0	80	80	1.0000000
NODE_20293_length_650_cov_22.156080	269	349	0	80	80	1.0000000
NODE_20293_length_650_cov_22.156080	322	402	0	80	80	1.0000000
NODE_20294_length_650_cov_20.012704	186	266	0	80	80	1.0000000
NODE_20294_length_650_cov_20.012704	239	319	0	80	80	1.0000000
NODE_20295_length_650_cov_17.626134	52	132	2	80	80	1.0000000
NODE_20295_length_650_cov_17.626134	105	185	0	46	80	0.5750000
NODE_20295_length_650_cov_17.626134	105	185	2	34	80	0.4250000
NODE_20297_length_650_cov_10.687840	289	369	0	80	80	1.0000000
NODE_20297_length_650_cov_10.687840	342	422	0	80	80	1.0000000
NODE_20301_length_650_cov_6.519056	312	365	3	36	53	0.6792453
NODE_20301_length_650_cov_6.519056	312	365	6	17	53	0.3207547
NODE_20301_length_650_cov_6.519056	338	417	3	10	79	0.1265823
NODE_20301_length_650_cov_6.519056	338	417	6	69	79	0.8734177
NODE_20302_length_650_cov_6.159710	243	323	0	80	80	1.0000000
NODE_20302_length_650_cov_6.159710	296	376	0	80	80	1.0000000
NODE_20318_length_650_cov_2.488203	213	266	0	53	53	1.0000000
NODE_20370_length_649_cov_20.780000	111	140	0	29	29	1.0000000
NODE_20370_length_649_cov_20.780000	111	191	0	80	80	1.0000000
NODE_20370_length_649_cov_20.780000	138	161	0	23	23	1.0000000
NODE_20370_length_649_cov_20.780000	138	214	0	76	76	1.0000000
NODE_20370_length_649_cov_20.780000	164	244	0	80	80	1.0000000
NODE_20371_length_649_cov_17.938182	162	242	0	80	80	1.0000000
NODE_20371_length_649_cov_17.938182	215	295	0	80	80	1.0000000
NODE_20372_length_649_cov_16.761818	395	475	2	15	80	0.1875000
NODE_20372_length_649_cov_16.761818	395	475	4	44	80	0.5500000
NODE_20372_length_649_cov_16.761818	395	475	6	21	80	0.2625000
NODE_20372_length_649_cov_16.761818	448	528	0	4	80	0.0500000
NODE_20372_length_649_cov_16.761818	448	528	2	64	80	0.8000000
NODE_20372_length_649_cov_16.761818	448	528	4	12	80	0.1500000
NODE_20373_length_649_cov_15.632727	226	306	0	80	80	1.0000000
NODE_20373_length_649_cov_15.632727	279	359	0	80	80	1.0000000
NODE_20374_length_649_cov_15.516364	329	409	0	80	80	1.0000000
NODE_20374_length_649_cov_15.516364	382	462	0	80	80	1.0000000
NODE_20375_length_649_cov_10.374545	453	533	0	32	80	0.4000000
NODE_20375_length_649_cov_10.374545	453	533	2	48	80	0.6000000
NODE_20375_length_649_cov_10.374545	506	586	0	14	80	0.1750000
NODE_20375_length_649_cov_10.374545	506	586	2	66	80	0.8250000
NODE_20382_length_649_cov_4.403636	213	293	0	80	80	1.0000000
NODE_20382_length_649_cov_4.403636	266	346	0	80	80	1.0000000
NODE_20454_length_648_cov_34.287796	343	423	0	80	80	1.0000000
NODE_20454_length_648_cov_34.287796	396	476	0	80	80	1.0000000
NODE_20454_length_648_cov_34.287796	472	552	0	80	80	1.0000000
NODE_20454_length_648_cov_34.287796	525	605	0	80	80	1.0000000
NODE_20455_length_648_cov_19.433515	259	339	0	80	80	1.0000000
NODE_20455_length_648_cov_19.433515	312	392	0	80	80	1.0000000
NODE_20457_length_648_cov_8.391621	206	286	0	52	80	0.6500000
NODE_20457_length_648_cov_8.391621	206	286	2	28	80	0.3500000
NODE_20457_length_648_cov_8.391621	259	339	2	80	80	1.0000000
NODE_20459_length_648_cov_6.573770	293	373	0	28	80	0.3500000
NODE_20459_length_648_cov_6.573770	293	373	2	52	80	0.6500000
NODE_20459_length_648_cov_6.573770	346	426	0	17	80	0.2125000
NODE_20459_length_648_cov_6.573770	346	426	2	63	80	0.7875000
NODE_20460_length_648_cov_6.431694	285	328	0	43	43	1.0000000
NODE_20463_length_648_cov_6.085610	257	337	0	80	80	1.0000000
NODE_20463_length_648_cov_6.085610	310	390	0	80	80	1.0000000
NODE_20483_length_648_cov_2.333333	19	86	0	67	67	1.0000000
NODE_20531_length_647_cov_18.489051	295	375	0	36	80	0.4500000
NODE_20531_length_647_cov_18.489051	295	375	2	44	80	0.5500000
NODE_20531_length_647_cov_18.489051	348	428	2	64	80	0.8000000
NODE_20531_length_647_cov_18.489051	348	428	4	16	80	0.2000000
NODE_20532_length_647_cov_14.677007	286	366	0	57	80	0.7125000
NODE_20532_length_647_cov_14.677007	286	366	2	23	80	0.2875000
NODE_20532_length_647_cov_14.677007	339	419	0	80	80	1.0000000
NODE_20533_length_647_cov_10.895985	231	311	0	67	80	0.8375000
NODE_20533_length_647_cov_10.895985	231	311	2	13	80	0.1625000
NODE_20533_length_647_cov_10.895985	284	364	0	14	80	0.1750000
NODE_20533_length_647_cov_10.895985	284	364	2	66	80	0.8250000
NODE_20534_length_647_cov_9.116788	372	452	0	80	80	1.0000000
NODE_20534_length_647_cov_9.116788	425	505	0	80	80	1.0000000
NODE_20536_length_647_cov_6.410584	150	221	4	71	71	1.0000000
NODE_20536_length_647_cov_6.410584	194	274	2	42	80	0.5250000
NODE_20536_length_647_cov_6.410584	194	274	4	33	80	0.4125000
NODE_20536_length_647_cov_6.410584	194	274	6	5	80	0.0625000
NODE_20539_length_647_cov_5.567518	239	319	0	7	80	0.0875000
NODE_20539_length_647_cov_5.567518	239	319	2	19	80	0.2375000
NODE_20539_length_647_cov_5.567518	239	319	4	54	80	0.6750000
NODE_20539_length_647_cov_5.567518	292	355	4	56	63	0.8888889
NODE_20539_length_647_cov_5.567518	292	355	5	2	63	0.0317460
NODE_20539_length_647_cov_5.567518	292	355	6	5	63	0.0793651
NODE_20539_length_647_cov_5.567518	348	416	3	3	68	0.0441176
NODE_20539_length_647_cov_5.567518	348	416	4	60	68	0.8823529
NODE_20539_length_647_cov_5.567518	348	416	5	5	68	0.0735294
NODE_20539_length_647_cov_5.567518	401	469	4	68	68	1.0000000
NODE_20544_length_647_cov_3.775547	356	399	4	25	43	0.5813953
NODE_20544_length_647_cov_3.775547	356	399	6	18	43	0.4186046
NODE_20550_length_647_cov_2.678832	239	319	0	80	80	1.0000000
NODE_20550_length_647_cov_2.678832	292	372	0	80	80	1.0000000
NODE_20561_length_647_cov_1.937956	254	304	0	24	50	0.4800000
NODE_20561_length_647_cov_1.937956	254	304	2	26	50	0.5200000
NODE_20607_length_646_cov_56.226691	267	347	0	80	80	1.0000000
NODE_20607_length_646_cov_56.226691	320	400	0	80	80	1.0000000
NODE_20608_length_646_cov_23.747715	76	153	0	77	77	1.0000000
NODE_20608_length_646_cov_23.747715	129	209	0	50	80	0.6250000
NODE_20608_length_646_cov_23.747715	129	209	2	30	80	0.3750000
NODE_20609_length_646_cov_22.740402	326	406	0	80	80	1.0000000
NODE_20609_length_646_cov_22.740402	379	459	0	80	80	1.0000000
NODE_20610_length_646_cov_15.160878	363	443	0	80	80	1.0000000
NODE_20610_length_646_cov_15.160878	416	496	0	80	80	1.0000000
NODE_20611_length_646_cov_9.429616	309	389	0	80	80	1.0000000
NODE_20611_length_646_cov_9.429616	362	442	0	80	80	1.0000000
NODE_20612_length_646_cov_9.246801	149	221	0	72	72	1.0000000
NODE_20613_length_646_cov_7.539305	227	307	0	2	80	0.0250000
NODE_20613_length_646_cov_7.539305	227	307	2	78	80	0.9750000
NODE_20613_length_646_cov_7.539305	280	360	0	49	80	0.6125000
NODE_20613_length_646_cov_7.539305	280	360	2	31	80	0.3875000
NODE_20614_length_646_cov_6.756856	236	316	0	80	80	1.0000000
NODE_20614_length_646_cov_6.756856	289	369	0	80	80	1.0000000
NODE_20615_length_646_cov_6.480804	373	437	0	35	64	0.5468750
NODE_20615_length_646_cov_6.480804	373	437	2	29	64	0.4531250
NODE_20615_length_646_cov_6.480804	410	490	2	80	80	1.0000000
NODE_20616_length_646_cov_6.396709	194	274	0	80	80	1.0000000
NODE_20616_length_646_cov_6.396709	254	327	0	73	73	1.0000000
NODE_20619_length_646_cov_4.652651	265	345	2	24	80	0.3000000
NODE_20619_length_646_cov_4.652651	265	345	4	56	80	0.7000000
NODE_20623_length_646_cov_4.122486	401	452	2	28	51	0.5490196
NODE_20623_length_646_cov_4.122486	401	452	3	15	51	0.2941177
NODE_20623_length_646_cov_4.122486	401	452	4	8	51	0.1568628
NODE_20688_length_645_cov_95.882784	179	259	0	61	80	0.7625000
NODE_20688_length_645_cov_95.882784	179	259	2	19	80	0.2375000
NODE_20688_length_645_cov_95.882784	232	312	0	8	80	0.1000000
NODE_20688_length_645_cov_95.882784	232	312	2	72	80	0.9000000
NODE_20689_length_645_cov_12.985348	343	423	0	80	80	1.0000000
NODE_20689_length_645_cov_12.985348	396	476	0	80	80	1.0000000
NODE_20691_length_645_cov_9.228938	254	334	0	15	80	0.1875000
NODE_20691_length_645_cov_9.228938	254	334	2	65	80	0.8125000
NODE_20691_length_645_cov_9.228938	307	387	0	68	80	0.8500000
NODE_20691_length_645_cov_9.228938	307	387	2	12	80	0.1500000
NODE_20692_length_645_cov_9.172161	293	373	0	80	80	1.0000000
NODE_20692_length_645_cov_9.172161	346	426	0	38	80	0.4750000
NODE_20692_length_645_cov_9.172161	346	426	4	42	80	0.5250000
NODE_20697_length_645_cov_5.609890	461	541	0	80	80	1.0000000
NODE_20697_length_645_cov_5.609890	514	594	0	80	80	1.0000000
NODE_20698_length_645_cov_4.743590	237	317	0	80	80	1.0000000
NODE_20698_length_645_cov_4.743590	290	370	0	80	80	1.0000000
NODE_20716_length_645_cov_2.177656	373	416	0	43	43	1.0000000
NODE_20762_length_644_cov_59.286239	323	401	195	1	78	0.0128205
NODE_20762_length_644_cov_59.286239	323	401	199	1	78	0.0128205
NODE_20762_length_644_cov_59.286239	323	401	207	1	78	0.0128205
NODE_20762_length_644_cov_59.286239	323	401	211	1	78	0.0128205
NODE_20762_length_644_cov_59.286239	323	401	212	1	78	0.0128205
NODE_20762_length_644_cov_59.286239	323	401	213	1	78	0.0128205
NODE_20762_length_644_cov_59.286239	323	401	214	1	78	0.0128205
NODE_20762_length_644_cov_59.286239	323	401	215	1	78	0.0128205
NODE_20762_length_644_cov_59.286239	323	401	219	1	78	0.0128205
NODE_20762_length_644_cov_59.286239	323	401	221	1	78	0.0128205
NODE_20762_length_644_cov_59.286239	323	401	228	1	78	0.0128205
NODE_20762_length_644_cov_59.286239	323	401	236	1	78	0.0128205
NODE_20762_length_644_cov_59.286239	323	401	237	1	78	0.0128205
NODE_20762_length_644_cov_59.286239	323	401	238	1	78	0.0128205
NODE_20762_length_644_cov_59.286239	323	401	244	1	78	0.0128205
NODE_20762_length_644_cov_59.286239	323	401	245	2	78	0.0256410
NODE_20762_length_644_cov_59.286239	323	401	253	1	78	0.0128205
NODE_20762_length_644_cov_59.286239	323	401	254	1	78	0.0128205
NODE_20762_length_644_cov_59.286239	323	401	256	1	78	0.0128205
NODE_20762_length_644_cov_59.286239	323	401	257	1	78	0.0128205
NODE_20762_length_644_cov_59.286239	323	401	259	1	78	0.0128205
NODE_20762_length_644_cov_59.286239	323	401	265	1	78	0.0128205
NODE_20762_length_644_cov_59.286239	323	401	268	1	78	0.0128205
NODE_20762_length_644_cov_59.286239	323	401	272	1	78	0.0128205
NODE_20762_length_644_cov_59.286239	323	401	284	1	78	0.0128205
NODE_20762_length_644_cov_59.286239	323	401	288	1	78	0.0128205
NODE_20762_length_644_cov_59.286239	323	401	294	1	78	0.0128205
NODE_20762_length_644_cov_59.286239	323	401	300	1	78	0.0128205
NODE_20762_length_644_cov_59.286239	323	401	307	1	78	0.0128205
NODE_20762_length_644_cov_59.286239	323	401	311	1	78	0.0128205
NODE_20762_length_644_cov_59.286239	323	401	313	1	78	0.0128205
NODE_20762_length_644_cov_59.286239	323	401	318	1	78	0.0128205
NODE_20762_length_644_cov_59.286239	323	401	321	1	78	0.0128205
NODE_20762_length_644_cov_59.286239	323	401	327	1	78	0.0128205
NODE_20762_length_644_cov_59.286239	323	401	329	2	78	0.0256410
NODE_20762_length_644_cov_59.286239	323	401	332	1	78	0.0128205
NODE_20762_length_644_cov_59.286239	323	401	335	1	78	0.0128205
NODE_20762_length_644_cov_59.286239	323	401	341	1	78	0.0128205
NODE_20762_length_644_cov_59.286239	323	401	343	1	78	0.0128205
NODE_20762_length_644_cov_59.286239	323	401	352	1	78	0.0128205
NODE_20762_length_644_cov_59.286239	323	401	356	1	78	0.0128205
NODE_20762_length_644_cov_59.286239	323	401	362	1	78	0.0128205
NODE_20762_length_644_cov_59.286239	323	401	366	1	78	0.0128205
NODE_20762_length_644_cov_59.286239	323	401	375	1	78	0.0128205
NODE_20762_length_644_cov_59.286239	323	401	379	1	78	0.0128205
NODE_20762_length_644_cov_59.286239	323	401	382	1	78	0.0128205
NODE_20762_length_644_cov_59.286239	323	401	393	2	78	0.0256410
NODE_20762_length_644_cov_59.286239	323	401	399	1	78	0.0128205
NODE_20762_length_644_cov_59.286239	323	401	401	1	78	0.0128205
NODE_20762_length_644_cov_59.286239	323	401	409	1	78	0.0128205
NODE_20762_length_644_cov_59.286239	323	401	419	1	78	0.0128205
NODE_20762_length_644_cov_59.286239	323	401	426	1	78	0.0128205
NODE_20762_length_644_cov_59.286239	323	401	431	1	78	0.0128205
NODE_20762_length_644_cov_59.286239	323	401	432	1	78	0.0128205
NODE_20762_length_644_cov_59.286239	323	401	435	2	78	0.0256410
NODE_20762_length_644_cov_59.286239	323	401	443	1	78	0.0128205
NODE_20762_length_644_cov_59.286239	323	401	444	1	78	0.0128205
NODE_20762_length_644_cov_59.286239	323	401	446	2	78	0.0256410
NODE_20762_length_644_cov_59.286239	323	401	447	1	78	0.0128205
NODE_20762_length_644_cov_59.286239	323	401	448	1	78	0.0128205
NODE_20762_length_644_cov_59.286239	323	401	449	1	78	0.0128205
NODE_20762_length_644_cov_59.286239	323	401	454	2	78	0.0256410
NODE_20762_length_644_cov_59.286239	323	401	456	1	78	0.0128205
NODE_20762_length_644_cov_59.286239	323	401	468	1	78	0.0128205
NODE_20762_length_644_cov_59.286239	323	401	469	2	78	0.0256410
NODE_20762_length_644_cov_59.286239	323	401	471	1	78	0.0128205
NODE_20762_length_644_cov_59.286239	323	401	472	1	78	0.0128205
NODE_20762_length_644_cov_59.286239	323	401	473	1	78	0.0128205
NODE_20762_length_644_cov_59.286239	323	401	474	1	78	0.0128205
NODE_20762_length_644_cov_59.286239	323	401	476	1	78	0.0128205
NODE_20762_length_644_cov_59.286239	323	401	477	1	78	0.0128205
NODE_20763_length_644_cov_27.577982	63	143	0	80	80	1.0000000
NODE_20763_length_644_cov_27.577982	116	196	0	80	80	1.0000000
NODE_20765_length_644_cov_10.073394	284	364	0	31	80	0.3875000
NODE_20765_length_644_cov_10.073394	284	364	2	10	80	0.1250000
NODE_20765_length_644_cov_10.073394	284	364	3	1	80	0.0125000
NODE_20765_length_644_cov_10.073394	284	364	4	38	80	0.4750000
NODE_20765_length_644_cov_10.073394	337	417	4	80	80	1.0000000
NODE_20845_length_643_cov_27.562500	201	281	0	80	80	1.0000000
NODE_20845_length_643_cov_27.562500	254	334	0	29	80	0.3625000
NODE_20845_length_643_cov_27.562500	254	334	2	51	80	0.6375000
NODE_20845_length_643_cov_27.562500	330	410	0	30	80	0.3750000
NODE_20845_length_643_cov_27.562500	330	410	2	50	80	0.6250000
NODE_20845_length_643_cov_27.562500	383	463	0	80	80	1.0000000
NODE_20846_length_643_cov_12.895221	203	283	0	23	80	0.2875000
NODE_20846_length_643_cov_12.895221	203	283	2	57	80	0.7125000
NODE_20846_length_643_cov_12.895221	256	336	2	80	80	1.0000000
NODE_20847_length_643_cov_10.501838	280	360	0	54	80	0.6750000
NODE_20847_length_643_cov_10.501838	280	360	4	26	80	0.3250000
NODE_20847_length_643_cov_10.501838	333	413	0	1	80	0.0125000
NODE_20847_length_643_cov_10.501838	333	413	4	79	80	0.9875000
NODE_20848_length_643_cov_9.136029	307	385	2	43	78	0.5512820
NODE_20848_length_643_cov_9.136029	307	385	3	1	78	0.0128205
NODE_20848_length_643_cov_9.136029	307	385	4	34	78	0.4358974
NODE_20848_length_643_cov_9.136029	358	438	0	12	80	0.1500000
NODE_20848_length_643_cov_9.136029	358	438	2	54	80	0.6750000
NODE_20848_length_643_cov_9.136029	358	438	3	1	80	0.0125000
NODE_20848_length_643_cov_9.136029	358	438	4	13	80	0.1625000
NODE_20849_length_643_cov_8.264706	202	282	0	80	80	1.0000000
NODE_20849_length_643_cov_8.264706	255	335	0	80	80	1.0000000
NODE_20851_length_643_cov_7.137868	173	253	0	80	80	1.0000000
NODE_20851_length_643_cov_7.137868	226	306	0	80	80	1.0000000
NODE_20855_length_643_cov_5.851103	255	335	4	2	80	0.0250000
NODE_20855_length_643_cov_5.851103	255	335	8	36	80	0.4500000
NODE_20855_length_643_cov_5.851103	255	335	10	14	80	0.1750000
NODE_20855_length_643_cov_5.851103	255	335	12	9	80	0.1125000
NODE_20855_length_643_cov_5.851103	255	335	14	19	80	0.2375000
NODE_20855_length_643_cov_5.851103	308	388	0	25	80	0.3125000
NODE_20855_length_643_cov_5.851103	308	388	2	23	80	0.2875000
NODE_20855_length_643_cov_5.851103	308	388	4	7	80	0.0875000
NODE_20855_length_643_cov_5.851103	308	388	8	25	80	0.3125000
NODE_20869_length_643_cov_3.121324	283	348	4	3	65	0.0461538
NODE_20869_length_643_cov_3.121324	283	348	6	46	65	0.7076923
NODE_20869_length_643_cov_3.121324	283	348	8	16	65	0.2461538
NODE_20872_length_643_cov_2.806985	387	451	0	64	64	1.0000000
NODE_20942_length_642_cov_36.309392	156	236	0	80	80	1.0000000
NODE_20942_length_642_cov_36.309392	209	289	0	80	80	1.0000000
NODE_20943_length_642_cov_27.046041	154	234	0	80	80	1.0000000
NODE_20943_length_642_cov_27.046041	207	287	0	80	80	1.0000000
NODE_20944_length_642_cov_26.290976	209	289	0	64	80	0.8000000
NODE_20944_length_642_cov_26.290976	209	289	2	16	80	0.2000000
NODE_20944_length_642_cov_26.290976	262	342	0	11	80	0.1375000
NODE_20944_length_642_cov_26.290976	262	342	2	69	80	0.8625000
NODE_20945_length_642_cov_11.651934	309	389	0	22	80	0.2750000
NODE_20945_length_642_cov_11.651934	309	389	2	34	80	0.4250000
NODE_20945_length_642_cov_11.651934	309	389	4	24	80	0.3000000
NODE_20945_length_642_cov_11.651934	362	442	0	75	80	0.9375000
NODE_20945_length_642_cov_11.651934	362	442	2	5	80	0.0625000
NODE_20947_length_642_cov_6.692449	453	533	0	80	80	1.0000000
NODE_20947_length_642_cov_6.692449	506	586	0	80	80	1.0000000
NODE_20951_length_642_cov_5.933702	260	340	0	21	80	0.2625000
NODE_20951_length_642_cov_5.933702	260	340	2	58	80	0.7250000
NODE_20951_length_642_cov_5.933702	260	340	6	1	80	0.0125000
NODE_20951_length_642_cov_5.933702	313	391	2	26	78	0.3333333
NODE_20951_length_642_cov_5.933702	313	391	4	39	78	0.5000000
NODE_20951_length_642_cov_5.933702	313	391	6	13	78	0.1666667
NODE_20967_length_642_cov_2.823204	115	158	10	5	43	0.1162791
NODE_20967_length_642_cov_2.823204	115	158	12	7	43	0.1627907
NODE_20967_length_642_cov_2.823204	115	158	14	4	43	0.0930233
NODE_20967_length_642_cov_2.823204	115	158	16	11	43	0.2558140
NODE_20967_length_642_cov_2.823204	115	158	18	2	43	0.0465116
NODE_20967_length_642_cov_2.823204	115	158	26	2	43	0.0465116
NODE_20967_length_642_cov_2.823204	115	158	28	12	43	0.2790698
NODE_20967_length_642_cov_2.823204	245	300	30	2	55	0.0363636
NODE_20967_length_642_cov_2.823204	245	300	32	1	55	0.0181818
NODE_20967_length_642_cov_2.823204	245	300	34	6	55	0.1090909
NODE_20967_length_642_cov_2.823204	245	300	38	3	55	0.0545455
NODE_20967_length_642_cov_2.823204	245	300	40	11	55	0.2000000
NODE_20967_length_642_cov_2.823204	245	300	42	1	55	0.0181818
NODE_20967_length_642_cov_2.823204	245	300	44	3	55	0.0545455
NODE_20967_length_642_cov_2.823204	245	300	45	4	55	0.0727273
NODE_20967_length_642_cov_2.823204	245	300	46	9	55	0.1636364
NODE_20967_length_642_cov_2.823204	245	300	47	2	55	0.0363636
NODE_20967_length_642_cov_2.823204	245	300	48	3	55	0.0545455
NODE_20967_length_642_cov_2.823204	245	300	49	6	55	0.1090909
NODE_20967_length_642_cov_2.823204	245	300	50	2	55	0.0363636
NODE_20967_length_642_cov_2.823204	245	300	51	1	55	0.0181818
NODE_20967_length_642_cov_2.823204	245	300	52	1	55	0.0181818
NODE_20967_length_642_cov_2.823204	329	410	33	23	81	0.2839506
NODE_20967_length_642_cov_2.823204	329	410	35	9	81	0.1111111
NODE_20967_length_642_cov_2.823204	329	410	39	3	81	0.0370370
NODE_20967_length_642_cov_2.823204	329	410	41	4	81	0.0493827
NODE_20967_length_642_cov_2.823204	329	410	45	22	81	0.2716049
NODE_20967_length_642_cov_2.823204	329	410	47	14	81	0.1728395
NODE_20967_length_642_cov_2.823204	329	410	49	6	81	0.0740741
NODE_20991_length_642_cov_1.357274	0	75	0	75	75	1.0000000
NODE_21018_length_641_cov_38.675277	284	345	14	7	61	0.1147541
NODE_21018_length_641_cov_38.675277	284	345	17	5	61	0.0819672
NODE_21018_length_641_cov_38.675277	284	345	19	1	61	0.0163934
NODE_21018_length_641_cov_38.675277	284	345	25	4	61	0.0655738
NODE_21018_length_641_cov_38.675277	284	345	31	7	61	0.1147541
NODE_21018_length_641_cov_38.675277	284	345	33	1	61	0.0163934
NODE_21018_length_641_cov_38.675277	284	345	35	1	61	0.0163934
NODE_21018_length_641_cov_38.675277	284	345	37	3	61	0.0491803
NODE_21018_length_641_cov_38.675277	284	345	39	2	61	0.0327869
NODE_21018_length_641_cov_38.675277	284	345	41	2	61	0.0327869
NODE_21018_length_641_cov_38.675277	284	345	42	5	61	0.0819672
NODE_21018_length_641_cov_38.675277	284	345	44	5	61	0.0819672
NODE_21018_length_641_cov_38.675277	284	345	46	1	61	0.0163934
NODE_21018_length_641_cov_38.675277	284	345	49	3	61	0.0491803
NODE_21018_length_641_cov_38.675277	284	345	51	2	61	0.0327869
NODE_21018_length_641_cov_38.675277	284	345	52	2	61	0.0327869
NODE_21018_length_641_cov_38.675277	284	345	53	7	61	0.1147541
NODE_21018_length_641_cov_38.675277	284	345	54	3	61	0.0491803
NODE_21018_length_641_cov_38.675277	318	369	42	4	51	0.0784314
NODE_21018_length_641_cov_38.675277	318	369	44	5	51	0.0980392
NODE_21018_length_641_cov_38.675277	318	369	46	1	51	0.0196078
NODE_21018_length_641_cov_38.675277	318	369	49	3	51	0.0588235
NODE_21018_length_641_cov_38.675277	318	369	51	2	51	0.0392157
NODE_21018_length_641_cov_38.675277	318	369	52	2	51	0.0392157
NODE_21018_length_641_cov_38.675277	318	369	53	31	51	0.6078432
NODE_21018_length_641_cov_38.675277	318	369	54	3	51	0.0588235
NODE_21019_length_641_cov_15.271218	260	340	0	41	80	0.5125000
NODE_21019_length_641_cov_15.271218	260	340	2	39	80	0.4875000
NODE_21019_length_641_cov_15.271218	313	393	0	47	80	0.5875000
NODE_21019_length_641_cov_15.271218	313	393	2	33	80	0.4125000
NODE_21021_length_641_cov_12.584871	363	443	0	80	80	1.0000000
NODE_21021_length_641_cov_12.584871	416	496	0	80	80	1.0000000
NODE_21022_length_641_cov_11.125461	38	118	0	80	80	1.0000000
NODE_21022_length_641_cov_11.125461	91	171	0	80	80	1.0000000
NODE_21025_length_641_cov_7.719557	84	138	4	54	54	1.0000000
NODE_21025_length_641_cov_7.719557	113	193	0	17	80	0.2125000
NODE_21025_length_641_cov_7.719557	113	193	2	14	80	0.1750000
NODE_21025_length_641_cov_7.719557	113	193	4	49	80	0.6125000
NODE_21026_length_641_cov_7.675277	232	312	0	80	80	1.0000000
NODE_21026_length_641_cov_7.675277	285	365	0	80	80	1.0000000
NODE_21027_length_641_cov_7.675277	255	335	1	5	80	0.0625000
NODE_21027_length_641_cov_7.675277	255	335	9	13	80	0.1625000
NODE_21027_length_641_cov_7.675277	255	335	13	6	80	0.0750000
NODE_21027_length_641_cov_7.675277	255	335	14	18	80	0.2250000
NODE_21027_length_641_cov_7.675277	255	335	15	38	80	0.4750000
NODE_21027_length_641_cov_7.675277	308	388	0	14	80	0.1750000
NODE_21027_length_641_cov_7.675277	308	388	4	2	80	0.0250000
NODE_21027_length_641_cov_7.675277	308	388	14	55	80	0.6875000
NODE_21027_length_641_cov_7.675277	308	388	15	9	80	0.1125000
NODE_21028_length_641_cov_7.627306	262	342	0	6	80	0.0750000
NODE_21028_length_641_cov_7.627306	262	342	2	74	80	0.9250000
NODE_21028_length_641_cov_7.627306	315	395	2	80	80	1.0000000
NODE_21029_length_641_cov_7.282288	247	300	0	53	53	1.0000000
NODE_21031_length_641_cov_5.029520	138	218	0	80	80	1.0000000
NODE_21031_length_641_cov_5.029520	191	271	0	75	80	0.9375000
NODE_21031_length_641_cov_5.029520	191	271	2	5	80	0.0625000
NODE_21034_length_641_cov_4.701107	238	282	0	12	44	0.2727273
NODE_21034_length_641_cov_4.701107	238	282	2	32	44	0.7272727
NODE_21109_length_640_cov_39.676525	524	597	102	3	73	0.0410959
NODE_21109_length_640_cov_39.676525	524	597	106	1	73	0.0136986
NODE_21109_length_640_cov_39.676525	524	597	110	1	73	0.0136986
NODE_21109_length_640_cov_39.676525	524	597	112	3	73	0.0410959
NODE_21109_length_640_cov_39.676525	524	597	115	1	73	0.0136986
NODE_21109_length_640_cov_39.676525	524	597	117	1	73	0.0136986
NODE_21109_length_640_cov_39.676525	524	597	119	1	73	0.0136986
NODE_21109_length_640_cov_39.676525	524	597	126	2	73	0.0273973
NODE_21109_length_640_cov_39.676525	524	597	127	7	73	0.0958904
NODE_21109_length_640_cov_39.676525	524	597	128	1	73	0.0136986
NODE_21109_length_640_cov_39.676525	524	597	134	1	73	0.0136986
NODE_21109_length_640_cov_39.676525	524	597	136	4	73	0.0547945
NODE_21109_length_640_cov_39.676525	524	597	138	1	73	0.0136986
NODE_21109_length_640_cov_39.676525	524	597	142	1	73	0.0136986
NODE_21109_length_640_cov_39.676525	524	597	144	2	73	0.0273973
NODE_21109_length_640_cov_39.676525	524	597	146	2	73	0.0273973
NODE_21109_length_640_cov_39.676525	524	597	152	4	73	0.0547945
NODE_21109_length_640_cov_39.676525	524	597	154	3	73	0.0410959
NODE_21109_length_640_cov_39.676525	524	597	164	4	73	0.0547945
NODE_21109_length_640_cov_39.676525	524	597	166	2	73	0.0273973
NODE_21109_length_640_cov_39.676525	524	597	168	1	73	0.0136986
NODE_21109_length_640_cov_39.676525	524	597	169	1	73	0.0136986
NODE_21109_length_640_cov_39.676525	524	597	171	1	73	0.0136986
NODE_21109_length_640_cov_39.676525	524	597	173	4	73	0.0547945
NODE_21109_length_640_cov_39.676525	524	597	175	1	73	0.0136986
NODE_21109_length_640_cov_39.676525	524	597	177	1	73	0.0136986
NODE_21109_length_640_cov_39.676525	524	597	178	1	73	0.0136986
NODE_21109_length_640_cov_39.676525	524	597	180	3	73	0.0410959
NODE_21109_length_640_cov_39.676525	524	597	182	1	73	0.0136986
NODE_21109_length_640_cov_39.676525	524	597	187	5	73	0.0684932
NODE_21109_length_640_cov_39.676525	524	597	189	2	73	0.0273973
NODE_21109_length_640_cov_39.676525	524	597	191	2	73	0.0273973
NODE_21109_length_640_cov_39.676525	524	597	193	5	73	0.0684932
NODE_21109_length_640_cov_39.676525	564	605	86	1	41	0.0243902
NODE_21109_length_640_cov_39.676525	564	605	95	2	41	0.0487805
NODE_21109_length_640_cov_39.676525	564	605	96	4	41	0.0975610
NODE_21109_length_640_cov_39.676525	564	605	98	1	41	0.0243902
NODE_21109_length_640_cov_39.676525	564	605	102	3	41	0.0731707
NODE_21109_length_640_cov_39.676525	564	605	106	1	41	0.0243902
NODE_21109_length_640_cov_39.676525	564	605	110	1	41	0.0243902
NODE_21109_length_640_cov_39.676525	564	605	112	3	41	0.0731707
NODE_21109_length_640_cov_39.676525	564	605	115	1	41	0.0243902
NODE_21109_length_640_cov_39.676525	564	605	117	1	41	0.0243902
NODE_21109_length_640_cov_39.676525	564	605	119	1	41	0.0243902
NODE_21109_length_640_cov_39.676525	564	605	126	2	41	0.0487805
NODE_21109_length_640_cov_39.676525	564	605	127	7	41	0.1707317
NODE_21109_length_640_cov_39.676525	564	605	128	1	41	0.0243902
NODE_21109_length_640_cov_39.676525	564	605	134	1	41	0.0243902
NODE_21109_length_640_cov_39.676525	564	605	136	4	41	0.0975610
NODE_21109_length_640_cov_39.676525	564	605	138	1	41	0.0243902
NODE_21109_length_640_cov_39.676525	564	605	142	1	41	0.0243902
NODE_21109_length_640_cov_39.676525	564	605	144	2	41	0.0487805
NODE_21109_length_640_cov_39.676525	564	605	146	2	41	0.0487805
NODE_21109_length_640_cov_39.676525	564	605	152	1	41	0.0243902
NODE_21110_length_640_cov_19.578558	273	353	0	8	80	0.1000000
NODE_21110_length_640_cov_19.578558	273	353	6	72	80	0.9000000
NODE_21110_length_640_cov_19.578558	326	406	0	61	80	0.7625000
NODE_21110_length_640_cov_19.578558	326	406	6	19	80	0.2375000
NODE_21111_length_640_cov_15.717190	178	258	0	10	80	0.1250000
NODE_21111_length_640_cov_15.717190	178	258	2	70	80	0.8750000
NODE_21111_length_640_cov_15.717190	231	311	0	63	80	0.7875000
NODE_21111_length_640_cov_15.717190	231	311	2	17	80	0.2125000
NODE_21112_length_640_cov_15.338262	319	399	0	80	80	1.0000000
NODE_21112_length_640_cov_15.338262	372	452	0	80	80	1.0000000
NODE_21113_length_640_cov_9.523105	20	43	0	23	23	1.0000000
NODE_21118_length_640_cov_5.123845	272	335	0	63	63	1.0000000
NODE_21121_length_640_cov_4.410351	254	334	0	80	80	1.0000000
NODE_21121_length_640_cov_4.410351	307	387	0	80	80	1.0000000
NODE_21129_length_640_cov_3.406654	244	324	4	52	80	0.6500000
NODE_21129_length_640_cov_3.406654	244	324	6	28	80	0.3500000
NODE_21140_length_640_cov_2.316081	21	57	0	36	36	1.0000000
NODE_21190_length_639_cov_58.092593	302	377	0	75	75	1.0000000
NODE_21190_length_639_cov_58.092593	350	430	0	80	80	1.0000000
NODE_21191_length_639_cov_32.951852	213	293	0	14	80	0.1750000
NODE_21191_length_639_cov_32.951852	213	293	2	32	80	0.4000000
NODE_21191_length_639_cov_32.951852	213	293	4	34	80	0.4250000
NODE_21191_length_639_cov_32.951852	266	346	2	80	80	1.0000000
NODE_21192_length_639_cov_24.564815	290	370	0	9	80	0.1125000
NODE_21192_length_639_cov_24.564815	290	370	2	71	80	0.8875000
NODE_21192_length_639_cov_24.564815	343	423	2	80	80	1.0000000
NODE_21193_length_639_cov_14.448148	288	368	0	80	80	1.0000000
NODE_21193_length_639_cov_14.448148	341	421	0	80	80	1.0000000
NODE_21195_length_639_cov_9.001852	265	345	0	80	80	1.0000000
NODE_21195_length_639_cov_9.001852	318	398	0	80	80	1.0000000
NODE_21197_length_639_cov_8.444444	161	241	0	80	80	1.0000000
NODE_21197_length_639_cov_8.444444	214	294	0	37	80	0.4625000
NODE_21197_length_639_cov_8.444444	214	294	2	43	80	0.5375000
NODE_21202_length_639_cov_6.283333	157	176	0	19	19	1.0000000
NODE_21207_length_639_cov_4.188889	258	335	0	77	77	1.0000000
NODE_21207_length_639_cov_4.188889	308	354	0	46	46	1.0000000
NODE_21213_length_639_cov_3.448148	126	206	0	14	80	0.1750000
NODE_21213_length_639_cov_3.448148	126	206	4	66	80	0.8250000
NODE_21213_length_639_cov_3.448148	179	259	0	30	80	0.3750000
NODE_21213_length_639_cov_3.448148	179	259	4	50	80	0.6250000
NODE_21223_length_639_cov_2.683333	256	288	0	32	32	1.0000000
NODE_21224_length_639_cov_2.555556	189	240	16	4	51	0.0784314
NODE_21224_length_639_cov_2.555556	189	240	24	9	51	0.1764706
NODE_21224_length_639_cov_2.555556	189	240	26	38	51	0.7450981
NODE_21225_length_639_cov_2.477778	562	635	2	73	73	1.0000000
NODE_21265_length_639_cov_1.179630	542	564	0	22	22	1.0000000
NODE_21269_length_639_cov_1.051852	404	455	0	51	51	1.0000000
NODE_21278_length_638_cov_13.018553	273	353	4	7	80	0.0875000
NODE_21278_length_638_cov_13.018553	273	353	6	73	80	0.9125000
NODE_21278_length_638_cov_13.018553	326	406	4	45	80	0.5625000
NODE_21278_length_638_cov_13.018553	326	406	6	35	80	0.4375000
NODE_21279_length_638_cov_12.656772	343	423	0	80	80	1.0000000
NODE_21279_length_638_cov_12.656772	396	476	0	80	80	1.0000000
NODE_21280_length_638_cov_11.877551	298	378	0	80	80	1.0000000
NODE_21280_length_638_cov_11.877551	351	431	0	80	80	1.0000000
NODE_21281_length_638_cov_8.779221	330	408	0	78	78	1.0000000
NODE_21281_length_638_cov_8.779221	383	461	0	41	78	0.5256410
NODE_21281_length_638_cov_8.779221	383	461	2	37	78	0.4743590
NODE_21284_length_638_cov_5.543599	315	395	0	18	80	0.2250000
NODE_21284_length_638_cov_5.543599	315	395	2	62	80	0.7750000
NODE_21290_length_638_cov_3.966605	307	387	2	80	80	1.0000000
NODE_21301_length_638_cov_2.786642	157	208	0	51	51	1.0000000
NODE_21301_length_638_cov_2.786642	181	261	0	80	80	1.0000000
NODE_21364_length_637_cov_67.157993	285	365	2	80	80	1.0000000
NODE_21364_length_637_cov_67.157993	338	418	0	47	80	0.5875000
NODE_21364_length_637_cov_67.157993	338	418	2	33	80	0.4125000
NODE_21364_length_637_cov_67.157993	414	494	0	80	80	1.0000000
NODE_21364_length_637_cov_67.157993	467	547	0	80	80	1.0000000
NODE_21365_length_637_cov_63.029740	195	275	0	75	80	0.9375000
NODE_21365_length_637_cov_63.029740	195	275	2	5	80	0.0625000
NODE_21365_length_637_cov_63.029740	248	328	0	22	80	0.2750000
NODE_21365_length_637_cov_63.029740	248	328	2	58	80	0.7250000
NODE_21366_length_637_cov_44.923792	53	133	4	80	80	1.0000000
NODE_21366_length_637_cov_44.923792	54	133	4	79	79	1.0000000
NODE_21366_length_637_cov_44.923792	106	186	0	20	80	0.2500000
NODE_21366_length_637_cov_44.923792	106	186	2	18	80	0.2250000
NODE_21366_length_637_cov_44.923792	106	186	4	42	80	0.5250000
NODE_21366_length_637_cov_44.923792	106	186	0	20	80	0.2500000
NODE_21366_length_637_cov_44.923792	106	186	2	18	80	0.2250000
NODE_21366_length_637_cov_44.923792	106	186	4	42	80	0.5250000
NODE_21366_length_637_cov_44.923792	182	262	0	80	80	1.0000000
NODE_21366_length_637_cov_44.923792	235	315	0	80	80	1.0000000
NODE_21367_length_637_cov_44.193309	193	273	2	80	80	1.0000000
NODE_21367_length_637_cov_44.193309	246	326	0	19	80	0.2375000
NODE_21367_length_637_cov_44.193309	246	326	2	61	80	0.7625000
NODE_21368_length_637_cov_37.855019	215	295	12	46	80	0.5750000
NODE_21368_length_637_cov_37.855019	215	295	15	1	80	0.0125000
NODE_21368_length_637_cov_37.855019	215	295	16	33	80	0.4125000
NODE_21368_length_637_cov_37.855019	268	347	4	8	79	0.1012658
NODE_21368_length_637_cov_37.855019	268	347	5	41	79	0.5189874
NODE_21368_length_637_cov_37.855019	268	347	16	30	79	0.3797468
NODE_21369_length_637_cov_33.957249	332	412	0	23	80	0.2875000
NODE_21369_length_637_cov_33.957249	332	412	2	57	80	0.7125000
NODE_21369_length_637_cov_33.957249	385	465	0	18	80	0.2250000
NODE_21369_length_637_cov_33.957249	385	465	2	62	80	0.7750000
NODE_21370_length_637_cov_23.682156	275	355	0	18	80	0.2250000
NODE_21370_length_637_cov_23.682156	275	355	4	62	80	0.7750000
NODE_21370_length_637_cov_23.682156	328	408	0	71	80	0.8875000
NODE_21370_length_637_cov_23.682156	328	408	4	9	80	0.1125000
NODE_21371_length_637_cov_19.676580	267	347	0	80	80	1.0000000
NODE_21371_length_637_cov_19.676580	320	400	0	80	80	1.0000000
NODE_21373_length_637_cov_9.182156	226	276	6	24	50	0.4800000
NODE_21373_length_637_cov_9.182156	226	276	8	26	50	0.5200000
NODE_21373_length_637_cov_9.182156	312	357	0	30	45	0.6666667
NODE_21373_length_637_cov_9.182156	312	357	4	15	45	0.3333333
NODE_21374_length_637_cov_9.078067	276	357	0	40	81	0.4938272
NODE_21374_length_637_cov_9.078067	276	357	2	1	81	0.0123457
NODE_21374_length_637_cov_9.078067	276	357	4	23	81	0.2839506
NODE_21374_length_637_cov_9.078067	276	357	6	17	81	0.2098765
NODE_21374_length_637_cov_9.078067	330	410	0	80	80	1.0000000
NODE_21375_length_637_cov_8.566914	235	315	0	15	80	0.1875000
NODE_21375_length_637_cov_8.566914	235	315	2	46	80	0.5750000
NODE_21375_length_637_cov_8.566914	235	315	5	19	80	0.2375000
NODE_21375_length_637_cov_8.566914	288	368	2	8	80	0.1000000
NODE_21375_length_637_cov_8.566914	288	368	4	4	80	0.0500000
NODE_21375_length_637_cov_8.566914	288	368	5	29	80	0.3625000
NODE_21375_length_637_cov_8.566914	288	368	6	39	80	0.4875000
NODE_21378_length_637_cov_6.652416	337	415	0	78	78	1.0000000
NODE_21378_length_637_cov_6.652416	390	472	0	82	82	1.0000000
NODE_21385_length_637_cov_4.522305	284	364	0	21	80	0.2625000
NODE_21385_length_637_cov_4.522305	284	364	2	1	80	0.0125000
NODE_21385_length_637_cov_4.522305	284	364	4	58	80	0.7250000
NODE_21385_length_637_cov_4.522305	337	417	0	6	80	0.0750000
NODE_21385_length_637_cov_4.522305	337	417	2	28	80	0.3500000
NODE_21385_length_637_cov_4.522305	337	417	4	46	80	0.5750000
NODE_21389_length_637_cov_4.131970	292	370	0	78	78	1.0000000
NODE_21389_length_637_cov_4.131970	343	423	0	80	80	1.0000000
NODE_21457_length_636_cov_19.938547	214	294	0	80	80	1.0000000
NODE_21457_length_636_cov_19.938547	267	347	0	80	80	1.0000000
NODE_21458_length_636_cov_12.283054	295	375	2	48	80	0.6000000
NODE_21458_length_636_cov_12.283054	295	375	4	18	80	0.2250000
NODE_21458_length_636_cov_12.283054	295	375	6	14	80	0.1750000
NODE_21458_length_636_cov_12.283054	348	428	4	71	80	0.8875000
NODE_21458_length_636_cov_12.283054	348	428	6	9	80	0.1125000
NODE_21460_length_636_cov_8.312849	346	413	0	32	67	0.4776119
NODE_21460_length_636_cov_8.312849	346	413	4	35	67	0.5223880
NODE_21460_length_636_cov_8.312849	399	479	0	15	80	0.1875000
NODE_21460_length_636_cov_8.312849	399	479	2	65	80	0.8125000
NODE_21467_length_636_cov_4.324022	185	251	6	56	66	0.8484849
NODE_21467_length_636_cov_4.324022	185	251	8	10	66	0.1515152
NODE_21467_length_636_cov_4.324022	224	266	6	25	42	0.5952381
NODE_21467_length_636_cov_4.324022	224	266	8	17	42	0.4047619
NODE_21467_length_636_cov_4.324022	224	264	6	23	40	0.5750000
NODE_21467_length_636_cov_4.324022	224	264	8	17	40	0.4250000
NODE_21539_length_635_cov_45.483209	195	239	179	2	44	0.0454545
NODE_21539_length_635_cov_45.483209	195	239	181	1	44	0.0227273
NODE_21539_length_635_cov_45.483209	195	239	183	2	44	0.0454545
NODE_21539_length_635_cov_45.483209	195	239	185	4	44	0.0909091
NODE_21539_length_635_cov_45.483209	195	239	186	1	44	0.0227273
NODE_21539_length_635_cov_45.483209	195	239	187	3	44	0.0681818
NODE_21539_length_635_cov_45.483209	195	239	188	2	44	0.0454545
NODE_21539_length_635_cov_45.483209	195	239	189	2	44	0.0454545
NODE_21539_length_635_cov_45.483209	195	239	190	5	44	0.1136364
NODE_21539_length_635_cov_45.483209	195	239	194	1	44	0.0227273
NODE_21539_length_635_cov_45.483209	195	239	196	1	44	0.0227273
NODE_21539_length_635_cov_45.483209	195	239	199	3	44	0.0681818
NODE_21539_length_635_cov_45.483209	195	239	200	3	44	0.0681818
NODE_21539_length_635_cov_45.483209	195	239	201	3	44	0.0681818
NODE_21539_length_635_cov_45.483209	195	239	202	1	44	0.0227273
NODE_21539_length_635_cov_45.483209	195	239	203	1	44	0.0227273
NODE_21539_length_635_cov_45.483209	195	239	205	5	44	0.1136364
NODE_21539_length_635_cov_45.483209	195	239	206	1	44	0.0227273
NODE_21539_length_635_cov_45.483209	195	239	207	3	44	0.0681818
NODE_21539_length_635_cov_45.483209	225	268	178	1	43	0.0232558
NODE_21539_length_635_cov_45.483209	225	268	180	1	43	0.0232558
NODE_21539_length_635_cov_45.483209	225	268	181	1	43	0.0232558
NODE_21539_length_635_cov_45.483209	225	268	190	3	43	0.0697674
NODE_21539_length_635_cov_45.483209	225	268	193	2	43	0.0465116
NODE_21539_length_635_cov_45.483209	225	268	194	1	43	0.0232558
NODE_21539_length_635_cov_45.483209	225	268	197	2	43	0.0465116
NODE_21539_length_635_cov_45.483209	225	268	198	1	43	0.0232558
NODE_21539_length_635_cov_45.483209	225	268	200	4	43	0.0930233
NODE_21539_length_635_cov_45.483209	225	268	201	7	43	0.1627907
NODE_21539_length_635_cov_45.483209	225	268	202	3	43	0.0697674
NODE_21539_length_635_cov_45.483209	225	268	203	4	43	0.0930233
NODE_21539_length_635_cov_45.483209	225	268	204	1	43	0.0232558
NODE_21539_length_635_cov_45.483209	225	268	205	6	43	0.1395349
NODE_21539_length_635_cov_45.483209	225	268	206	1	43	0.0232558
NODE_21539_length_635_cov_45.483209	225	268	207	5	43	0.1162791
NODE_21539_length_635_cov_45.483209	248	298	129	2	50	0.0400000
NODE_21539_length_635_cov_45.483209	248	298	131	3	50	0.0600000
NODE_21539_length_635_cov_45.483209	248	298	143	1	50	0.0200000
NODE_21539_length_635_cov_45.483209	248	298	144	1	50	0.0200000
NODE_21539_length_635_cov_45.483209	248	298	145	1	50	0.0200000
NODE_21539_length_635_cov_45.483209	248	298	154	3	50	0.0600000
NODE_21539_length_635_cov_45.483209	248	298	156	2	50	0.0400000
NODE_21539_length_635_cov_45.483209	248	298	158	1	50	0.0200000
NODE_21539_length_635_cov_45.483209	248	298	159	1	50	0.0200000
NODE_21539_length_635_cov_45.483209	248	298	162	1	50	0.0200000
NODE_21539_length_635_cov_45.483209	248	298	170	1	50	0.0200000
NODE_21539_length_635_cov_45.483209	248	298	171	1	50	0.0200000
NODE_21539_length_635_cov_45.483209	248	298	172	2	50	0.0400000
NODE_21539_length_635_cov_45.483209	248	298	174	1	50	0.0200000
NODE_21539_length_635_cov_45.483209	248	298	178	3	50	0.0600000
NODE_21539_length_635_cov_45.483209	248	298	180	1	50	0.0200000
NODE_21539_length_635_cov_45.483209	248	298	181	4	50	0.0800000
NODE_21539_length_635_cov_45.483209	248	298	183	2	50	0.0400000
NODE_21539_length_635_cov_45.483209	248	298	184	1	50	0.0200000
NODE_21539_length_635_cov_45.483209	248	298	189	1	50	0.0200000
NODE_21539_length_635_cov_45.483209	248	298	190	3	50	0.0600000
NODE_21539_length_635_cov_45.483209	248	298	193	2	50	0.0400000
NODE_21539_length_635_cov_45.483209	248	298	194	1	50	0.0200000
NODE_21539_length_635_cov_45.483209	248	298	197	2	50	0.0400000
NODE_21539_length_635_cov_45.483209	248	298	198	1	50	0.0200000
NODE_21539_length_635_cov_45.483209	248	298	200	1	50	0.0200000
NODE_21539_length_635_cov_45.483209	248	298	201	5	50	0.1000000
NODE_21539_length_635_cov_45.483209	248	298	203	2	50	0.0400000
NODE_21541_length_635_cov_23.895522	179	259	0	80	80	1.0000000
NODE_21541_length_635_cov_23.895522	232	312	0	80	80	1.0000000
NODE_21543_length_635_cov_14.772388	48	128	2	60	80	0.7500000
NODE_21543_length_635_cov_14.772388	48	128	4	20	80	0.2500000
NODE_21543_length_635_cov_14.772388	101	181	0	38	80	0.4750000
NODE_21543_length_635_cov_14.772388	101	181	2	42	80	0.5250000
NODE_21549_length_635_cov_6.180970	276	356	0	28	80	0.3500000
NODE_21549_length_635_cov_6.180970	276	356	4	52	80	0.6500000
NODE_21549_length_635_cov_6.180970	329	409	4	80	80	1.0000000
NODE_21554_length_635_cov_4.421642	442	522	0	80	80	1.0000000
NODE_21560_length_635_cov_2.985075	296	376	12	1	80	0.0125000
NODE_21560_length_635_cov_2.985075	296	376	15	1	80	0.0125000
NODE_21560_length_635_cov_2.985075	296	376	16	34	80	0.4250000
NODE_21560_length_635_cov_2.985075	296	376	18	24	80	0.3000000
NODE_21560_length_635_cov_2.985075	296	376	20	20	80	0.2500000
NODE_21625_length_634_cov_53.315888	349	429	0	21	80	0.2625000
NODE_21625_length_634_cov_53.315888	349	429	2	59	80	0.7375000
NODE_21625_length_634_cov_53.315888	402	482	0	20	80	0.2500000
NODE_21625_length_634_cov_53.315888	402	482	2	60	80	0.7500000
NODE_21626_length_634_cov_28.530841	156	236	0	62	80	0.7750000
NODE_21626_length_634_cov_28.530841	156	236	7	12	80	0.1500000
NODE_21626_length_634_cov_28.530841	156	236	9	6	80	0.0750000
NODE_21626_length_634_cov_28.530841	209	289	0	9	80	0.1125000
NODE_21626_length_634_cov_28.530841	209	289	7	12	80	0.1500000
NODE_21626_length_634_cov_28.530841	209	289	9	22	80	0.2750000
NODE_21626_length_634_cov_28.530841	209	289	10	37	80	0.4625000
NODE_21627_length_634_cov_19.117757	151	229	0	78	78	1.0000000
NODE_21627_length_634_cov_19.117757	204	268	0	62	64	0.9687500
NODE_21627_length_634_cov_19.117757	204	268	4	2	64	0.0312500
NODE_21628_length_634_cov_18.762617	84	164	0	80	80	1.0000000
NODE_21628_length_634_cov_18.762617	137	217	0	80	80	1.0000000
NODE_21629_length_634_cov_18.136449	162	242	3	80	80	1.0000000
NODE_21629_length_634_cov_18.136449	215	295	0	28	80	0.3500000
NODE_21629_length_634_cov_18.136449	215	295	3	52	80	0.6500000
NODE_21635_length_634_cov_9.988785	508	553	0	45	45	1.0000000
NODE_21636_length_634_cov_9.381308	267	353	0	86	86	1.0000000
NODE_21636_length_634_cov_9.381308	324	404	0	80	80	1.0000000
NODE_21651_length_634_cov_3.702804	460	532	0	72	72	1.0000000
NODE_21720_length_633_cov_30.076779	180	214	0	34	34	1.0000000
NODE_21720_length_633_cov_30.076779	187	267	0	80	80	1.0000000
NODE_21720_length_633_cov_30.076779	263	343	0	80	80	1.0000000
NODE_21720_length_633_cov_30.076779	316	396	0	80	80	1.0000000
NODE_21721_length_633_cov_17.595506	282	362	0	80	80	1.0000000
NODE_21721_length_633_cov_17.595506	335	415	0	80	80	1.0000000
NODE_21722_length_633_cov_17.327715	228	308	0	80	80	1.0000000
NODE_21722_length_633_cov_17.327715	281	361	0	80	80	1.0000000
NODE_21723_length_633_cov_9.689139	79	147	0	4	68	0.0588235
NODE_21723_length_633_cov_9.689139	79	147	4	5	68	0.0735294
NODE_21723_length_633_cov_9.689139	79	147	6	4	68	0.0588235
NODE_21723_length_633_cov_9.689139	79	147	8	3	68	0.0441176
NODE_21723_length_633_cov_9.689139	79	147	10	2	68	0.0294118
NODE_21723_length_633_cov_9.689139	79	147	12	46	68	0.6764706
NODE_21723_length_633_cov_9.689139	79	147	14	4	68	0.0588235
NODE_21729_length_633_cov_7.018727	309	389	0	33	80	0.4125000
NODE_21729_length_633_cov_7.018727	309	389	2	47	80	0.5875000
NODE_21729_length_633_cov_7.018727	362	442	0	19	80	0.2375000
NODE_21729_length_633_cov_7.018727	362	442	2	61	80	0.7625000
NODE_21755_length_633_cov_2.644195	166	240	0	13	74	0.1756757
NODE_21755_length_633_cov_2.644195	166	240	2	29	74	0.3918919
NODE_21755_length_633_cov_2.644195	166	240	8	32	74	0.4324324
NODE_21816_length_632_cov_25.425891	332	412	0	26	80	0.3250000
NODE_21816_length_632_cov_25.425891	332	412	2	54	80	0.6750000
NODE_21816_length_632_cov_25.425891	385	465	0	63	80	0.7875000
NODE_21816_length_632_cov_25.425891	385	465	2	17	80	0.2125000
NODE_21817_length_632_cov_21.613508	243	323	0	80	80	1.0000000
NODE_21817_length_632_cov_21.613508	296	376	0	80	80	1.0000000
NODE_21818_length_632_cov_16.465291	293	373	0	80	80	1.0000000
NODE_21818_length_632_cov_16.465291	346	426	0	74	80	0.9250000
NODE_21818_length_632_cov_16.465291	346	426	4	6	80	0.0750000
NODE_21819_length_632_cov_13.260788	232	312	0	4	80	0.0500000
NODE_21819_length_632_cov_13.260788	232	312	2	43	80	0.5375000
NODE_21819_length_632_cov_13.260788	232	312	4	33	80	0.4125000
NODE_21819_length_632_cov_13.260788	285	365	2	65	80	0.8125000
NODE_21819_length_632_cov_13.260788	285	365	4	15	80	0.1875000
NODE_21821_length_632_cov_9.106942	188	268	0	80	80	1.0000000
NODE_21821_length_632_cov_9.106942	241	321	0	80	80	1.0000000
NODE_21834_length_632_cov_4.135084	229	309	2	80	80	1.0000000
NODE_21834_length_632_cov_4.135084	282	359	0	50	77	0.6493506
NODE_21834_length_632_cov_4.135084	282	359	2	27	77	0.3506494
NODE_21841_length_632_cov_2.939962	216	274	6	27	58	0.4655173
NODE_21841_length_632_cov_2.939962	216	274	7	9	58	0.1551724
NODE_21841_length_632_cov_2.939962	216	274	8	22	58	0.3793103
NODE_21841_length_632_cov_2.939962	247	327	6	2	80	0.0250000
NODE_21841_length_632_cov_2.939962	247	327	7	5	80	0.0625000
NODE_21841_length_632_cov_2.939962	247	327	8	39	80	0.4875000
NODE_21841_length_632_cov_2.939962	247	327	10	27	80	0.3375000
NODE_21841_length_632_cov_2.939962	247	327	12	7	80	0.0875000
NODE_21848_length_632_cov_2.330206	57	76	0	19	19	1.0000000
NODE_21912_length_631_cov_31.469925	321	396	0	27	75	0.3600000
NODE_21912_length_631_cov_31.469925	321	396	2	48	75	0.6400000
NODE_21912_length_631_cov_31.469925	369	449	0	80	80	1.0000000
NODE_21913_length_631_cov_26.453008	383	463	0	80	80	1.0000000
NODE_21913_length_631_cov_26.453008	436	516	0	80	80	1.0000000
NODE_21917_length_631_cov_8.374060	318	398	0	80	80	1.0000000
NODE_21917_length_631_cov_8.374060	371	451	0	80	80	1.0000000
NODE_21924_length_631_cov_5.507519	335	386	0	41	51	0.8039216
NODE_21924_length_631_cov_5.507519	335	386	2	10	51	0.1960784
NODE_21927_length_631_cov_5.227444	443	523	4	80	80	1.0000000
NODE_21927_length_631_cov_5.227444	496	576	0	43	80	0.5375000
NODE_21927_length_631_cov_5.227444	496	576	2	1	80	0.0125000
NODE_21927_length_631_cov_5.227444	496	576	4	36	80	0.4500000
NODE_21942_length_631_cov_2.926692	307	354	0	47	47	1.0000000
NODE_21983_length_631_cov_1.383459	248	267	0	19	19	1.0000000
NODE_22011_length_630_cov_41.728814	6	86	0	80	80	1.0000000
NODE_22011_length_630_cov_41.728814	59	139	0	80	80	1.0000000
NODE_22012_length_630_cov_24.856874	421	501	0	80	80	1.0000000
NODE_22012_length_630_cov_24.856874	474	554	0	80	80	1.0000000
NODE_22013_length_630_cov_14.323917	196	276	6	36	80	0.4500000
NODE_22013_length_630_cov_14.323917	196	276	12	44	80	0.5500000
NODE_22013_length_630_cov_14.323917	249	329	9	4	80	0.0500000
NODE_22013_length_630_cov_14.323917	249	329	12	76	80	0.9500000
NODE_22014_length_630_cov_9.964218	284	364	0	80	80	1.0000000
NODE_22014_length_630_cov_9.964218	337	417	0	80	80	1.0000000
NODE_22086_length_629_cov_38.271698	288	368	0	73	80	0.9125000
NODE_22086_length_629_cov_38.271698	288	368	2	7	80	0.0875000
NODE_22086_length_629_cov_38.271698	341	421	0	80	80	1.0000000
NODE_22087_length_629_cov_27.556604	212	292	0	80	80	1.0000000
NODE_22087_length_629_cov_27.556604	265	345	0	80	80	1.0000000
NODE_22088_length_629_cov_24.150943	356	436	0	80	80	1.0000000
NODE_22088_length_629_cov_24.150943	409	489	0	80	80	1.0000000
NODE_22091_length_629_cov_13.641509	176	256	0	80	80	1.0000000
NODE_22091_length_629_cov_13.641509	229	309	0	44	80	0.5500000
NODE_22091_length_629_cov_13.641509	229	309	2	36	80	0.4500000
NODE_22101_length_629_cov_4.264151	362	442	4	1	80	0.0125000
NODE_22101_length_629_cov_4.264151	362	442	6	79	80	0.9875000
NODE_22188_length_628_cov_5.015123	210	274	4	64	64	1.0000000
NODE_22257_length_627_cov_24.500000	217	297	0	80	80	1.0000000
NODE_22257_length_627_cov_24.500000	270	350	0	80	80	1.0000000
NODE_22258_length_627_cov_20.395833	84	164	0	80	80	1.0000000
NODE_22258_length_627_cov_20.395833	137	217	0	80	80	1.0000000
NODE_22259_length_627_cov_19.676136	308	388	0	80	80	1.0000000
NODE_22259_length_627_cov_19.676136	361	441	0	31	80	0.3875000
NODE_22259_length_627_cov_19.676136	361	441	4	49	80	0.6125000
NODE_22260_length_627_cov_17.634470	264	296	0	32	32	1.0000000
NODE_22260_length_627_cov_17.634470	360	385	0	25	25	1.0000000
NODE_22260_length_627_cov_17.634470	365	385	0	20	20	1.0000000
NODE_22260_length_627_cov_17.634470	385	424	0	39	39	1.0000000
NODE_22267_length_627_cov_5.634470	298	346	2	48	48	1.0000000
NODE_22274_length_627_cov_4.517045	323	403	4	3	80	0.0375000
NODE_22274_length_627_cov_4.517045	323	403	6	20	80	0.2500000
NODE_22274_length_627_cov_4.517045	323	403	7	3	80	0.0375000
NODE_22274_length_627_cov_4.517045	323	403	8	25	80	0.3125000
NODE_22274_length_627_cov_4.517045	323	403	9	29	80	0.3625000
NODE_22274_length_627_cov_4.517045	376	456	0	18	80	0.2250000
NODE_22274_length_627_cov_4.517045	376	456	5	24	80	0.3000000
NODE_22274_length_627_cov_4.517045	376	456	6	31	80	0.3875000
NODE_22274_length_627_cov_4.517045	376	456	8	7	80	0.0875000
NODE_22357_length_626_cov_24.184061	140	220	0	80	80	1.0000000
NODE_22357_length_626_cov_24.184061	193	273	0	80	80	1.0000000
NODE_22358_length_626_cov_21.189753	342	419	1	10	77	0.1298701
NODE_22358_length_626_cov_21.189753	342	419	3	4	77	0.0519481
NODE_22358_length_626_cov_21.189753	342	419	5	1	77	0.0129870
NODE_22358_length_626_cov_21.189753	342	419	6	14	77	0.1818182
NODE_22358_length_626_cov_21.189753	342	419	7	1	77	0.0129870
NODE_22358_length_626_cov_21.189753	342	419	8	23	77	0.2987013
NODE_22358_length_626_cov_21.189753	342	419	9	24	77	0.3116883
NODE_22358_length_626_cov_21.189753	342	419	1	10	77	0.1298701
NODE_22358_length_626_cov_21.189753	342	419	3	4	77	0.0519481
NODE_22358_length_626_cov_21.189753	342	419	5	1	77	0.0129870
NODE_22358_length_626_cov_21.189753	342	419	6	14	77	0.1818182
NODE_22358_length_626_cov_21.189753	342	419	7	1	77	0.0129870
NODE_22358_length_626_cov_21.189753	342	419	8	23	77	0.2987013
NODE_22358_length_626_cov_21.189753	342	419	9	24	77	0.3116883
NODE_22358_length_626_cov_21.189753	392	453	0	1	61	0.0163934
NODE_22358_length_626_cov_21.189753	392	453	1	43	61	0.7049180
NODE_22358_length_626_cov_21.189753	392	453	3	4	61	0.0655738
NODE_22358_length_626_cov_21.189753	392	453	5	1	61	0.0163934
NODE_22358_length_626_cov_21.189753	392	453	6	12	61	0.1967213
NODE_22364_length_626_cov_7.100569	236	311	0	75	75	1.0000000
NODE_22364_length_626_cov_7.100569	284	364	0	80	80	1.0000000
NODE_22366_length_626_cov_6.296015	193	273	0	80	80	1.0000000
NODE_22366_length_626_cov_6.296015	246	326	0	80	80	1.0000000
NODE_22367_length_626_cov_6.163188	257	337	0	17	80	0.2125000
NODE_22367_length_626_cov_6.163188	257	337	4	63	80	0.7875000
NODE_22367_length_626_cov_6.163188	310	390	0	8	80	0.1000000
NODE_22367_length_626_cov_6.163188	310	390	4	72	80	0.9000000
NODE_22438_length_625_cov_33.100760	239	319	0	80	80	1.0000000
NODE_22438_length_625_cov_33.100760	292	372	0	80	80	1.0000000
NODE_22438_length_625_cov_33.100760	368	448	0	80	80	1.0000000
NODE_22438_length_625_cov_33.100760	421	501	0	80	80	1.0000000
NODE_22439_length_625_cov_21.062738	267	347	0	80	80	1.0000000
NODE_22439_length_625_cov_21.062738	320	400	0	80	80	1.0000000
NODE_22440_length_625_cov_14.237643	28	108	0	14	80	0.1750000
NODE_22440_length_625_cov_14.237643	28	108	2	66	80	0.8250000
NODE_22440_length_625_cov_14.237643	81	161	0	16	80	0.2000000
NODE_22440_length_625_cov_14.237643	81	161	2	64	80	0.8000000
NODE_22441_length_625_cov_14.207224	358	438	2	74	80	0.9250000
NODE_22441_length_625_cov_14.207224	358	438	4	6	80	0.0750000
NODE_22441_length_625_cov_14.207224	411	491	2	74	80	0.9250000
NODE_22441_length_625_cov_14.207224	411	491	4	6	80	0.0750000
NODE_22455_length_625_cov_4.157795	548	600	0	52	52	1.0000000
NODE_22466_length_625_cov_2.929658	118	198	0	62	80	0.7750000
NODE_22466_length_625_cov_2.929658	118	198	2	18	80	0.2250000
NODE_22466_length_625_cov_2.929658	171	251	0	9	80	0.1125000
NODE_22466_length_625_cov_2.929658	171	251	2	71	80	0.8875000
NODE_22491_length_625_cov_1.570342	471	502	0	31	31	1.0000000
NODE_22542_length_624_cov_9.598095	77	126	0	31	49	0.6326531
NODE_22542_length_624_cov_9.598095	77	126	2	18	49	0.3673469
NODE_22542_length_624_cov_9.598095	103	183	0	80	80	1.0000000
NODE_22544_length_624_cov_8.485714	271	351	0	6	80	0.0750000
NODE_22544_length_624_cov_8.485714	271	351	2	74	80	0.9250000
NODE_22544_length_624_cov_8.485714	324	404	0	59	80	0.7375000
NODE_22544_length_624_cov_8.485714	324	404	2	21	80	0.2625000
NODE_22546_length_624_cov_6.691429	386	466	0	72	80	0.9000000
NODE_22546_length_624_cov_6.691429	386	466	2	8	80	0.1000000
NODE_22546_length_624_cov_6.691429	439	519	0	80	80	1.0000000
NODE_22547_length_624_cov_5.592381	312	387	4	2	75	0.0266667
NODE_22547_length_624_cov_5.592381	312	387	10	1	75	0.0133333
NODE_22547_length_624_cov_5.592381	312	387	11	8	75	0.1066667
NODE_22547_length_624_cov_5.592381	312	387	13	1	75	0.0133333
NODE_22547_length_624_cov_5.592381	312	387	15	11	75	0.1466667
NODE_22547_length_624_cov_5.592381	312	387	22	17	75	0.2266667
NODE_22547_length_624_cov_5.592381	312	387	24	3	75	0.0400000
NODE_22547_length_624_cov_5.592381	312	387	26	32	75	0.4266667
NODE_22551_length_624_cov_4.638095	328	388	2	60	60	1.0000000
NODE_22642_length_623_cov_41.877863	419	499	2	17	80	0.2125000
NODE_22642_length_623_cov_41.877863	419	499	6	57	80	0.7125000
NODE_22642_length_623_cov_41.877863	419	499	8	6	80	0.0750000
NODE_22642_length_623_cov_41.877863	472	552	6	80	80	1.0000000
NODE_22643_length_623_cov_31.875954	148	228	0	6	80	0.0750000
NODE_22643_length_623_cov_31.875954	148	228	2	26	80	0.3250000
NODE_22643_length_623_cov_31.875954	148	228	4	5	80	0.0625000
NODE_22643_length_623_cov_31.875954	148	228	6	43	80	0.5375000
NODE_22643_length_623_cov_31.875954	201	281	0	23	80	0.2875000
NODE_22643_length_623_cov_31.875954	201	281	4	35	80	0.4375000
NODE_22643_length_623_cov_31.875954	201	281	6	22	80	0.2750000
NODE_22644_length_623_cov_31.192748	313	393	0	36	80	0.4500000
NODE_22644_length_623_cov_31.192748	313	393	2	44	80	0.5500000
NODE_22644_length_623_cov_31.192748	366	446	0	4	80	0.0500000
NODE_22644_length_623_cov_31.192748	366	446	2	76	80	0.9500000
NODE_22645_length_623_cov_20.187023	287	367	0	80	80	1.0000000
NODE_22645_length_623_cov_20.187023	340	420	0	80	80	1.0000000
NODE_22646_length_623_cov_12.045802	377	457	2	51	80	0.6375000
NODE_22646_length_623_cov_12.045802	377	457	4	29	80	0.3625000
NODE_22646_length_623_cov_12.045802	430	510	2	73	80	0.9125000
NODE_22646_length_623_cov_12.045802	430	510	4	7	80	0.0875000
NODE_22668_length_623_cov_2.891221	457	535	0	78	78	1.0000000
NODE_22725_length_622_cov_19.042065	368	448	0	80	80	1.0000000
NODE_22725_length_622_cov_19.042065	421	501	0	80	80	1.0000000
NODE_22726_length_622_cov_13.470363	109	189	0	80	80	1.0000000
NODE_22726_length_622_cov_13.470363	162	242	0	80	80	1.0000000
NODE_22752_length_622_cov_2.407266	94	170	2	34	76	0.4473684
NODE_22752_length_622_cov_2.407266	94	170	4	5	76	0.0657895
NODE_22752_length_622_cov_2.407266	94	170	6	37	76	0.4868421
NODE_22796_length_622_cov_1.353728	346	376	2	30	30	1.0000000
NODE_22819_length_621_cov_46.247126	0	52	0	52	52	1.0000000
NODE_22819_length_621_cov_46.247126	25	105	0	80	80	1.0000000
NODE_22819_length_621_cov_46.247126	101	181	0	80	80	1.0000000
NODE_22819_length_621_cov_46.247126	154	234	0	80	80	1.0000000
NODE_22820_length_621_cov_45.764368	344	424	0	62	80	0.7750000
NODE_22820_length_621_cov_45.764368	344	424	2	18	80	0.2250000
NODE_22820_length_621_cov_45.764368	397	477	0	9	80	0.1125000
NODE_22820_length_621_cov_45.764368	397	477	2	71	80	0.8875000
NODE_22821_length_621_cov_35.147510	393	473	0	65	80	0.8125000
NODE_22821_length_621_cov_35.147510	393	473	1	15	80	0.1875000
NODE_22821_length_621_cov_35.147510	446	526	0	80	80	1.0000000
NODE_22822_length_621_cov_13.842912	231	311	0	45	80	0.5625000
NODE_22822_length_621_cov_13.842912	231	311	4	2	80	0.0250000
NODE_22822_length_621_cov_13.842912	231	311	8	33	80	0.4125000
NODE_22822_length_621_cov_13.842912	284	364	8	80	80	1.0000000
NODE_22825_length_621_cov_6.279693	376	406	0	30	30	1.0000000
NODE_22845_length_621_cov_2.645594	367	426	0	59	59	1.0000000
NODE_22914_length_620_cov_23.913628	433	513	0	80	80	1.0000000
NODE_22914_length_620_cov_23.913628	486	566	0	80	80	1.0000000
NODE_22915_length_620_cov_9.222649	186	266	0	76	80	0.9500000
NODE_22915_length_620_cov_9.222649	186	266	2	4	80	0.0500000
NODE_22915_length_620_cov_9.222649	239	319	0	50	80	0.6250000
NODE_22915_length_620_cov_9.222649	239	319	2	30	80	0.3750000
NODE_22919_length_620_cov_7.804223	57	137	0	4	80	0.0500000
NODE_22919_length_620_cov_7.804223	57	137	2	4	80	0.0500000
NODE_22919_length_620_cov_7.804223	57	137	4	72	80	0.9000000
NODE_22919_length_620_cov_7.804223	110	190	4	80	80	1.0000000
NODE_22920_length_620_cov_6.909789	199	279	10	71	80	0.8875000
NODE_22920_length_620_cov_6.909789	199	279	11	3	80	0.0375000
NODE_22920_length_620_cov_6.909789	199	279	12	6	80	0.0750000
NODE_22920_length_620_cov_6.909789	252	332	0	14	80	0.1750000
NODE_22920_length_620_cov_6.909789	252	332	10	18	80	0.2250000
NODE_22920_length_620_cov_6.909789	252	332	11	3	80	0.0375000
NODE_22920_length_620_cov_6.909789	252	332	12	45	80	0.5625000
NODE_22930_length_620_cov_4.560461	309	347	24	38	38	1.0000000
NODE_22930_length_620_cov_4.560461	395	421	0	2	26	0.0769231
NODE_22930_length_620_cov_4.560461	395	421	2	18	26	0.6923077
NODE_22930_length_620_cov_4.560461	395	421	6	6	26	0.2307692
NODE_22930_length_620_cov_4.560461	395	451	0	2	56	0.0357143
NODE_22930_length_620_cov_4.560461	395	451	2	30	56	0.5357143
NODE_22930_length_620_cov_4.560461	395	451	4	18	56	0.3214286
NODE_22930_length_620_cov_4.560461	395	451	6	6	56	0.1071429
NODE_23031_length_619_cov_26.309615	118	198	0	11	80	0.1375000
NODE_23031_length_619_cov_26.309615	118	198	2	69	80	0.8625000
NODE_23031_length_619_cov_26.309615	171	251	0	64	80	0.8000000
NODE_23031_length_619_cov_26.309615	171	251	2	16	80	0.2000000
NODE_23033_length_619_cov_10.417308	427	487	6	28	60	0.4666667
NODE_23033_length_619_cov_10.417308	427	487	8	4	60	0.0666667
NODE_23033_length_619_cov_10.417308	427	487	10	22	60	0.3666667
NODE_23033_length_619_cov_10.417308	427	487	18	6	60	0.1000000
NODE_23034_length_619_cov_7.944231	213	293	0	80	80	1.0000000
NODE_23034_length_619_cov_7.944231	266	346	0	80	80	1.0000000
NODE_23135_length_618_cov_14.477842	223	299	0	76	76	1.0000000
NODE_23135_length_618_cov_14.477842	223	299	0	76	76	1.0000000
NODE_23135_length_618_cov_14.477842	276	337	0	61	61	1.0000000
NODE_23136_length_618_cov_13.840077	377	457	0	80	80	1.0000000
NODE_23136_length_618_cov_13.840077	430	510	0	80	80	1.0000000
NODE_23137_length_618_cov_12.048170	348	428	2	80	80	1.0000000
NODE_23137_length_618_cov_12.048170	401	481	0	49	80	0.6125000
NODE_23137_length_618_cov_12.048170	401	481	2	31	80	0.3875000
NODE_23138_length_618_cov_8.799615	353	433	0	46	80	0.5750000
NODE_23138_length_618_cov_8.799615	353	433	2	34	80	0.4250000
NODE_23138_length_618_cov_8.799615	406	486	0	12	80	0.1500000
NODE_23138_length_618_cov_8.799615	406	486	2	68	80	0.8500000
NODE_23147_length_618_cov_3.793834	412	478	0	66	66	1.0000000
NODE_23148_length_618_cov_3.761079	305	385	0	80	80	1.0000000
NODE_23252_length_617_cov_29.565637	378	458	2	33	80	0.4125000
NODE_23252_length_617_cov_29.565637	378	458	6	47	80	0.5875000
NODE_23252_length_617_cov_29.565637	431	511	0	10	80	0.1250000
NODE_23252_length_617_cov_29.565637	431	511	4	12	80	0.1500000
NODE_23252_length_617_cov_29.565637	431	511	6	58	80	0.7250000
NODE_23253_length_617_cov_16.781853	253	333	10	80	80	1.0000000
NODE_23253_length_617_cov_16.781853	306	386	9	39	80	0.4875000
NODE_23253_length_617_cov_16.781853	306	386	10	41	80	0.5125000
NODE_23254_length_617_cov_9.175676	373	453	0	34	80	0.4250000
NODE_23254_length_617_cov_9.175676	373	453	2	46	80	0.5750000
NODE_23254_length_617_cov_9.175676	426	506	0	80	80	1.0000000
NODE_23255_length_617_cov_8.774131	320	406	2	11	86	0.1279070
NODE_23255_length_617_cov_8.774131	320	406	4	13	86	0.1511628
NODE_23255_length_617_cov_8.774131	320	406	6	62	86	0.7209302
NODE_23255_length_617_cov_8.774131	379	458	4	27	79	0.3417721
NODE_23255_length_617_cov_8.774131	379	458	6	52	79	0.6582279
NODE_23257_length_617_cov_8.416988	359	439	0	80	80	1.0000000
NODE_23257_length_617_cov_8.416988	412	492	0	80	80	1.0000000
NODE_23259_length_617_cov_7.683398	197	275	0	42	78	0.5384616
NODE_23259_length_617_cov_7.683398	197	275	2	13	78	0.1666667
NODE_23259_length_617_cov_7.683398	197	275	6	23	78	0.2948718
NODE_23259_length_617_cov_7.683398	250	330	2	2	80	0.0250000
NODE_23259_length_617_cov_7.683398	250	330	4	19	80	0.2375000
NODE_23259_length_617_cov_7.683398	250	330	6	59	80	0.7375000
NODE_23263_length_617_cov_5.330116	288	360	0	16	72	0.2222222
NODE_23263_length_617_cov_5.330116	288	360	2	38	72	0.5277778
NODE_23263_length_617_cov_5.330116	288	360	4	11	72	0.1527778
NODE_23263_length_617_cov_5.330116	288	360	6	7	72	0.0972222
NODE_23263_length_617_cov_5.330116	333	413	2	80	80	1.0000000
NODE_23302_length_617_cov_1.967181	384	430	0	46	46	1.0000000
NODE_23311_length_617_cov_1.847490	273	344	0	71	71	1.0000000
NODE_23331_length_617_cov_1.322394	269	318	25	4	49	0.0816327
NODE_23331_length_617_cov_1.322394	269	318	26	1	49	0.0204082
NODE_23331_length_617_cov_1.322394	269	318	27	7	49	0.1428571
NODE_23331_length_617_cov_1.322394	269	318	28	9	49	0.1836735
NODE_23331_length_617_cov_1.322394	269	318	29	20	49	0.4081633
NODE_23331_length_617_cov_1.322394	269	318	33	8	49	0.1632653
NODE_23365_length_616_cov_15.914894	292	370	4	78	78	1.0000000
NODE_23365_length_616_cov_15.914894	343	423	0	11	80	0.1375000
NODE_23365_length_616_cov_15.914894	343	423	4	69	80	0.8625000
NODE_23366_length_616_cov_14.276596	191	271	0	80	80	1.0000000
NODE_23366_length_616_cov_14.276596	244	319	0	75	75	1.0000000
NODE_23366_length_616_cov_14.276596	368	448	2	80	80	1.0000000
NODE_23367_length_616_cov_12.119923	273	353	0	55	80	0.6875000
NODE_23367_length_616_cov_12.119923	273	353	4	25	80	0.3125000
NODE_23367_length_616_cov_12.119923	326	406	0	2	80	0.0250000
NODE_23367_length_616_cov_12.119923	326	406	4	78	80	0.9750000
NODE_23373_length_616_cov_6.379110	305	385	0	6	80	0.0750000
NODE_23373_length_616_cov_6.379110	305	385	2	74	80	0.9250000
NODE_23373_length_616_cov_6.379110	358	438	0	39	80	0.4875000
NODE_23373_length_616_cov_6.379110	358	438	2	41	80	0.5125000
NODE_23381_length_616_cov_4.441006	286	350	0	64	64	1.0000000
NODE_23381_length_616_cov_4.441006	286	306	0	20	20	1.0000000
NODE_23400_length_616_cov_2.541586	375	415	2	21	40	0.5250000
NODE_23400_length_616_cov_2.541586	375	415	4	19	40	0.4750000
NODE_23430_length_616_cov_1.491296	105	183	0	2	78	0.0256410
NODE_23430_length_616_cov_1.491296	105	183	1	1	78	0.0128205
NODE_23430_length_616_cov_1.491296	105	183	2	36	78	0.4615385
NODE_23430_length_616_cov_1.491296	105	183	4	37	78	0.4743590
NODE_23430_length_616_cov_1.491296	105	183	6	2	78	0.0256410
NODE_23474_length_615_cov_27.519380	302	382	9	2	80	0.0250000
NODE_23474_length_615_cov_27.519380	302	382	10	78	80	0.9750000
NODE_23474_length_615_cov_27.519380	355	435	10	80	80	1.0000000
NODE_23475_length_615_cov_17.792636	239	319	0	80	80	1.0000000
NODE_23475_length_615_cov_17.792636	292	372	0	80	80	1.0000000
NODE_23477_length_615_cov_11.835271	240	320	0	80	80	1.0000000
NODE_23477_length_615_cov_11.835271	293	373	0	80	80	1.0000000
NODE_23478_length_615_cov_8.591085	287	367	0	80	80	1.0000000
NODE_23478_length_615_cov_8.591085	340	420	0	80	80	1.0000000
NODE_23513_length_615_cov_2.461240	429	509	0	80	80	1.0000000
NODE_23513_length_615_cov_2.461240	482	562	0	80	80	1.0000000
NODE_23516_length_615_cov_2.379845	405	467	4	6	62	0.0967742
NODE_23516_length_615_cov_2.379845	405	467	7	1	62	0.0161290
NODE_23516_length_615_cov_2.379845	405	467	8	5	62	0.0806452
NODE_23516_length_615_cov_2.379845	405	467	10	50	62	0.8064516
NODE_23516_length_615_cov_2.379845	440	520	8	23	80	0.2875000
NODE_23516_length_615_cov_2.379845	440	520	10	57	80	0.7125000
NODE_23517_length_615_cov_2.294574	205	268	0	63	63	1.0000000
NODE_23554_length_615_cov_1.122093	255	335	0	41	80	0.5125000
NODE_23554_length_615_cov_1.122093	255	335	2	3	80	0.0375000
NODE_23554_length_615_cov_1.122093	255	335	4	36	80	0.4500000
NODE_23566_length_615_cov_0.887597	561	582	0	21	21	1.0000000
NODE_23575_length_614_cov_17.772816	257	337	0	31	80	0.3875000
NODE_23575_length_614_cov_17.772816	257	337	2	49	80	0.6125000
NODE_23575_length_614_cov_17.772816	310	390	2	64	80	0.8000000
NODE_23575_length_614_cov_17.772816	310	390	4	16	80	0.2000000
NODE_23576_length_614_cov_10.706796	425	505	0	80	80	1.0000000
NODE_23576_length_614_cov_10.706796	478	558	0	80	80	1.0000000
NODE_23578_length_614_cov_8.545631	193	273	0	52	80	0.6500000
NODE_23578_length_614_cov_8.545631	193	273	2	3	80	0.0375000
NODE_23578_length_614_cov_8.545631	193	273	4	2	80	0.0250000
NODE_23578_length_614_cov_8.545631	193	273	8	1	80	0.0125000
NODE_23578_length_614_cov_8.545631	193	273	12	1	80	0.0125000
NODE_23578_length_614_cov_8.545631	193	273	14	7	80	0.0875000
NODE_23578_length_614_cov_8.545631	193	273	16	2	80	0.0250000
NODE_23578_length_614_cov_8.545631	193	273	18	1	80	0.0125000
NODE_23578_length_614_cov_8.545631	193	273	20	11	80	0.1375000
NODE_23578_length_614_cov_8.545631	246	326	0	80	80	1.0000000
NODE_23604_length_614_cov_2.450485	315	393	0	78	78	1.0000000
NODE_23604_length_614_cov_2.450485	355	383	0	28	28	1.0000000
NODE_23604_length_614_cov_2.450485	368	448	0	80	80	1.0000000
NODE_23604_length_614_cov_2.450485	379	448	0	69	69	1.0000000
NODE_23662_length_613_cov_18.075875	211	291	0	12	80	0.1500000
NODE_23662_length_613_cov_18.075875	211	291	2	14	80	0.1750000
NODE_23662_length_613_cov_18.075875	211	291	4	54	80	0.6750000
NODE_23662_length_613_cov_18.075875	264	344	0	65	80	0.8125000
NODE_23662_length_613_cov_18.075875	264	344	2	14	80	0.1750000
NODE_23662_length_613_cov_18.075875	264	344	4	1	80	0.0125000
NODE_23663_length_613_cov_16.118677	283	363	0	80	80	1.0000000
NODE_23663_length_613_cov_16.118677	336	416	0	80	80	1.0000000
NODE_23665_length_613_cov_12.883268	155	235	0	80	80	1.0000000
NODE_23665_length_613_cov_12.883268	208	288	0	80	80	1.0000000
NODE_23674_length_613_cov_3.857977	167	247	0	80	80	1.0000000
NODE_23674_length_613_cov_3.857977	220	300	0	80	80	1.0000000
NODE_23771_length_612_cov_24.023392	173	253	0	80	80	1.0000000
NODE_23771_length_612_cov_24.023392	226	306	0	80	80	1.0000000
NODE_23772_length_612_cov_23.846004	141	221	0	80	80	1.0000000
NODE_23772_length_612_cov_23.846004	194	274	0	80	80	1.0000000
NODE_23773_length_612_cov_12.448343	244	324	0	17	80	0.2125000
NODE_23773_length_612_cov_12.448343	244	324	2	63	80	0.7875000
NODE_23773_length_612_cov_12.448343	297	377	0	43	80	0.5375000
NODE_23773_length_612_cov_12.448343	297	377	2	37	80	0.4625000
NODE_23774_length_612_cov_12.068226	267	347	0	72	80	0.9000000
NODE_23774_length_612_cov_12.068226	267	347	4	8	80	0.1000000
NODE_23774_length_612_cov_12.068226	320	400	0	19	80	0.2375000
NODE_23774_length_612_cov_12.068226	320	400	4	38	80	0.4750000
NODE_23774_length_612_cov_12.068226	320	400	6	23	80	0.2875000
NODE_23779_length_612_cov_6.393762	242	322	0	80	80	1.0000000
NODE_23779_length_612_cov_6.393762	295	375	0	80	80	1.0000000
NODE_23814_length_612_cov_1.904483	288	354	0	28	66	0.4242424
NODE_23814_length_612_cov_1.904483	288	354	2	6	66	0.0909091
NODE_23814_length_612_cov_1.904483	288	354	4	32	66	0.4848485
NODE_23869_length_611_cov_38.705078	132	212	0	26	80	0.3250000
NODE_23869_length_611_cov_38.705078	132	212	2	13	80	0.1625000
NODE_23869_length_611_cov_38.705078	132	212	4	41	80	0.5125000
NODE_23869_length_611_cov_38.705078	185	262	4	50	77	0.6493506
NODE_23869_length_611_cov_38.705078	185	262	6	1	77	0.0129870
NODE_23869_length_611_cov_38.705078	185	262	7	24	77	0.3116883
NODE_23869_length_611_cov_38.705078	185	262	9	2	77	0.0259740
NODE_23869_length_611_cov_38.705078	185	262	4	50	77	0.6493506
NODE_23869_length_611_cov_38.705078	185	262	6	1	77	0.0129870
NODE_23869_length_611_cov_38.705078	185	262	7	24	77	0.3116883
NODE_23869_length_611_cov_38.705078	185	262	9	2	77	0.0259740
NODE_23871_length_611_cov_12.669922	264	344	0	80	80	1.0000000
NODE_23871_length_611_cov_12.669922	317	397	0	46	80	0.5750000
NODE_23871_length_611_cov_12.669922	317	397	2	34	80	0.4250000
NODE_23880_length_611_cov_4.943359	27	107	6	80	80	1.0000000
NODE_23880_length_611_cov_4.943359	80	137	3	14	57	0.2456140
NODE_23880_length_611_cov_4.943359	80	137	4	1	57	0.0175439
NODE_23880_length_611_cov_4.943359	80	137	6	42	57	0.7368421
NODE_23880_length_611_cov_4.943359	143	209	0	66	66	1.0000000
NODE_23880_length_611_cov_4.943359	182	262	0	47	80	0.5875000
NODE_23880_length_611_cov_4.943359	182	262	2	33	80	0.4125000
NODE_23894_length_611_cov_3.294922	271	300	0	19	29	0.6551724
NODE_23894_length_611_cov_3.294922	271	300	2	10	29	0.3448276
NODE_23894_length_611_cov_3.294922	434	469	2	35	35	1.0000000
NODE_23897_length_611_cov_3.162109	313	342	2	19	29	0.6551724
NODE_23897_length_611_cov_3.162109	313	342	4	10	29	0.3448276
NODE_23973_length_610_cov_20.673190	87	167	0	27	80	0.3375000
NODE_23973_length_610_cov_20.673190	87	167	2	53	80	0.6625000
NODE_23973_length_610_cov_20.673190	140	220	0	27	80	0.3375000
NODE_23973_length_610_cov_20.673190	140	220	2	53	80	0.6625000
NODE_23974_length_610_cov_10.191781	250	330	0	80	80	1.0000000
NODE_23974_length_610_cov_10.191781	303	383	0	80	80	1.0000000
NODE_23980_length_610_cov_4.998043	129	181	8	8	52	0.1538462
NODE_23980_length_610_cov_4.998043	129	181	12	18	52	0.3461539
NODE_23980_length_610_cov_4.998043	129	181	16	26	52	0.5000000
NODE_23980_length_610_cov_4.998043	182	234	4	2	52	0.0384615
NODE_23980_length_610_cov_4.998043	182	234	8	22	52	0.4230769
NODE_23980_length_610_cov_4.998043	182	234	11	1	52	0.0192308
NODE_23980_length_610_cov_4.998043	182	234	12	7	52	0.1346154
NODE_23980_length_610_cov_4.998043	182	234	16	20	52	0.3846154
NODE_23989_length_610_cov_3.479452	215	267	0	52	52	1.0000000
NODE_24059_length_609_cov_21.117647	80	160	0	48	80	0.6000000
NODE_24059_length_609_cov_21.117647	80	160	4	32	80	0.4000000
NODE_24059_length_609_cov_21.117647	133	213	0	80	80	1.0000000
NODE_24060_length_609_cov_11.300000	218	298	0	16	80	0.2000000
NODE_24060_length_609_cov_11.300000	218	298	2	8	80	0.1000000
NODE_24060_length_609_cov_11.300000	218	298	6	23	80	0.2875000
NODE_24060_length_609_cov_11.300000	218	298	8	33	80	0.4125000
NODE_24060_length_609_cov_11.300000	271	351	0	15	80	0.1875000
NODE_24060_length_609_cov_11.300000	271	351	2	2	80	0.0250000
NODE_24060_length_609_cov_11.300000	271	351	4	11	80	0.1375000
NODE_24060_length_609_cov_11.300000	271	351	6	18	80	0.2250000
NODE_24060_length_609_cov_11.300000	271	351	8	34	80	0.4250000
NODE_24061_length_609_cov_10.778431	239	319	0	80	80	1.0000000
NODE_24061_length_609_cov_10.778431	292	372	0	80	80	1.0000000
NODE_24062_length_609_cov_10.298039	340	420	0	80	80	1.0000000
NODE_24062_length_609_cov_10.298039	393	473	0	80	80	1.0000000
NODE_24062_length_609_cov_10.298039	469	537	0	68	68	1.0000000
NODE_24063_length_609_cov_10.270588	217	297	0	72	80	0.9000000
NODE_24063_length_609_cov_10.270588	217	297	1	8	80	0.1000000
NODE_24063_length_609_cov_10.270588	270	353	0	83	83	1.0000000
NODE_24064_length_609_cov_8.345098	408	488	0	80	80	1.0000000
NODE_24064_length_609_cov_8.345098	461	515	0	54	54	1.0000000
NODE_24064_length_609_cov_8.345098	537	566	0	29	29	1.0000000
NODE_24066_length_609_cov_6.054902	219	299	0	80	80	1.0000000
NODE_24066_length_609_cov_6.054902	272	352	0	80	80	1.0000000
NODE_24067_length_609_cov_5.986275	219	299	0	80	80	1.0000000
NODE_24067_length_609_cov_5.986275	272	352	0	80	80	1.0000000
NODE_24160_length_608_cov_76.257367	300	380	0	80	80	1.0000000
NODE_24160_length_608_cov_76.257367	353	433	0	80	80	1.0000000
NODE_24161_length_608_cov_13.271120	252	332	0	29	80	0.3625000
NODE_24161_length_608_cov_13.271120	252	332	1	44	80	0.5500000
NODE_24161_length_608_cov_13.271120	252	332	2	7	80	0.0875000
NODE_24161_length_608_cov_13.271120	305	385	0	80	80	1.0000000
NODE_24162_length_608_cov_11.583497	63	139	0	76	76	1.0000000
NODE_24162_length_608_cov_11.583497	112	192	0	80	80	1.0000000
NODE_24164_length_608_cov_8.076621	53	133	113	2	80	0.0250000
NODE_24164_length_608_cov_8.076621	53	133	115	1	80	0.0125000
NODE_24164_length_608_cov_8.076621	53	133	117	1	80	0.0125000
NODE_24164_length_608_cov_8.076621	53	133	123	4	80	0.0500000
NODE_24164_length_608_cov_8.076621	53	133	125	2	80	0.0250000
NODE_24164_length_608_cov_8.076621	53	133	127	2	80	0.0250000
NODE_24164_length_608_cov_8.076621	53	133	136	1	80	0.0125000
NODE_24164_length_608_cov_8.076621	53	133	139	6	80	0.0750000
NODE_24164_length_608_cov_8.076621	53	133	141	1	80	0.0125000
NODE_24164_length_608_cov_8.076621	53	133	142	1	80	0.0125000
NODE_24164_length_608_cov_8.076621	53	133	143	3	80	0.0375000
NODE_24164_length_608_cov_8.076621	53	133	145	2	80	0.0250000
NODE_24164_length_608_cov_8.076621	53	133	146	1	80	0.0125000
NODE_24164_length_608_cov_8.076621	53	133	147	24	80	0.3000000
NODE_24164_length_608_cov_8.076621	53	133	149	5	80	0.0625000
NODE_24164_length_608_cov_8.076621	53	133	151	1	80	0.0125000
NODE_24164_length_608_cov_8.076621	53	133	153	6	80	0.0750000
NODE_24164_length_608_cov_8.076621	53	133	155	7	80	0.0875000
NODE_24164_length_608_cov_8.076621	53	133	159	10	80	0.1250000
NODE_24164_length_608_cov_8.076621	106	186	0	8	80	0.1000000
NODE_24164_length_608_cov_8.076621	106	186	2	12	80	0.1500000
NODE_24164_length_608_cov_8.076621	106	186	11	4	80	0.0500000
NODE_24164_length_608_cov_8.076621	106	186	15	1	80	0.0125000
NODE_24164_length_608_cov_8.076621	106	186	21	1	80	0.0125000
NODE_24164_length_608_cov_8.076621	106	186	35	1	80	0.0125000
NODE_24164_length_608_cov_8.076621	106	186	39	2	80	0.0250000
NODE_24164_length_608_cov_8.076621	106	186	43	3	80	0.0375000
NODE_24164_length_608_cov_8.076621	106	186	45	2	80	0.0250000
NODE_24164_length_608_cov_8.076621	106	186	49	1	80	0.0125000
NODE_24164_length_608_cov_8.076621	106	186	53	1	80	0.0125000
NODE_24164_length_608_cov_8.076621	106	186	55	1	80	0.0125000
NODE_24164_length_608_cov_8.076621	106	186	77	1	80	0.0125000
NODE_24164_length_608_cov_8.076621	106	186	85	1	80	0.0125000
NODE_24164_length_608_cov_8.076621	106	186	87	1	80	0.0125000
NODE_24164_length_608_cov_8.076621	106	186	89	1	80	0.0125000
NODE_24164_length_608_cov_8.076621	106	186	91	1	80	0.0125000
NODE_24164_length_608_cov_8.076621	106	186	93	1	80	0.0125000
NODE_24164_length_608_cov_8.076621	106	186	95	1	80	0.0125000
NODE_24164_length_608_cov_8.076621	106	186	97	1	80	0.0125000
NODE_24164_length_608_cov_8.076621	106	186	99	1	80	0.0125000
NODE_24164_length_608_cov_8.076621	106	186	103	1	80	0.0125000
NODE_24164_length_608_cov_8.076621	106	186	105	2	80	0.0250000
NODE_24164_length_608_cov_8.076621	106	186	111	4	80	0.0500000
NODE_24164_length_608_cov_8.076621	106	186	113	2	80	0.0250000
NODE_24164_length_608_cov_8.076621	106	186	115	1	80	0.0125000
NODE_24164_length_608_cov_8.076621	106	186	117	1	80	0.0125000
NODE_24164_length_608_cov_8.076621	106	186	123	4	80	0.0500000
NODE_24164_length_608_cov_8.076621	106	186	125	2	80	0.0250000
NODE_24164_length_608_cov_8.076621	106	186	127	2	80	0.0250000
NODE_24164_length_608_cov_8.076621	106	186	142	1	80	0.0125000
NODE_24164_length_608_cov_8.076621	106	186	145	1	80	0.0125000
NODE_24164_length_608_cov_8.076621	106	186	147	13	80	0.1625000
NODE_24165_length_608_cov_7.994106	279	326	0	47	47	1.0000000
NODE_24165_length_608_cov_7.994106	348	373	0	25	25	1.0000000
NODE_24166_length_608_cov_7.939096	247	277	0	30	30	1.0000000
NODE_24177_length_608_cov_3.829077	313	393	0	80	80	1.0000000
NODE_24177_length_608_cov_3.829077	366	446	0	80	80	1.0000000
NODE_24251_length_608_cov_1.064833	472	512	0	40	40	1.0000000
NODE_24281_length_607_cov_61.316929	347	427	4	10	80	0.1250000
NODE_24281_length_607_cov_61.316929	347	427	15	6	80	0.0750000
NODE_24281_length_607_cov_61.316929	347	427	25	15	80	0.1875000
NODE_24281_length_607_cov_61.316929	347	427	26	1	80	0.0125000
NODE_24281_length_607_cov_61.316929	347	427	27	32	80	0.4000000
NODE_24281_length_607_cov_61.316929	347	427	38	4	80	0.0500000
NODE_24281_length_607_cov_61.316929	347	427	40	12	80	0.1500000
NODE_24281_length_607_cov_61.316929	347	427	4	10	80	0.1250000
NODE_24281_length_607_cov_61.316929	347	427	15	6	80	0.0750000
NODE_24281_length_607_cov_61.316929	347	427	25	15	80	0.1875000
NODE_24281_length_607_cov_61.316929	347	427	26	1	80	0.0125000
NODE_24281_length_607_cov_61.316929	347	427	27	32	80	0.4000000
NODE_24281_length_607_cov_61.316929	347	427	38	4	80	0.0500000
NODE_24281_length_607_cov_61.316929	347	427	40	12	80	0.1500000
NODE_24281_length_607_cov_61.316929	347	427	4	10	80	0.1250000
NODE_24281_length_607_cov_61.316929	347	427	15	6	80	0.0750000
NODE_24281_length_607_cov_61.316929	347	427	25	15	80	0.1875000
NODE_24281_length_607_cov_61.316929	347	427	26	1	80	0.0125000
NODE_24281_length_607_cov_61.316929	347	427	27	32	80	0.4000000
NODE_24281_length_607_cov_61.316929	347	427	38	4	80	0.0500000
NODE_24281_length_607_cov_61.316929	347	427	40	12	80	0.1500000
NODE_24281_length_607_cov_61.316929	364	427	25	15	63	0.2380952
NODE_24281_length_607_cov_61.316929	364	427	27	32	63	0.5079365
NODE_24281_length_607_cov_61.316929	364	427	38	4	63	0.0634921
NODE_24281_length_607_cov_61.316929	364	427	40	12	63	0.1904762
NODE_24281_length_607_cov_61.316929	400	480	25	4	80	0.0500000
NODE_24281_length_607_cov_61.316929	400	480	27	7	80	0.0875000
NODE_24281_length_607_cov_61.316929	400	480	38	4	80	0.0500000
NODE_24281_length_607_cov_61.316929	400	480	40	16	80	0.2000000
NODE_24281_length_607_cov_61.316929	400	480	54	1	80	0.0125000
NODE_24281_length_607_cov_61.316929	400	480	56	6	80	0.0750000
NODE_24281_length_607_cov_61.316929	400	480	58	14	80	0.1750000
NODE_24281_length_607_cov_61.316929	400	480	66	24	80	0.3000000
NODE_24281_length_607_cov_61.316929	400	480	68	4	80	0.0500000
NODE_24281_length_607_cov_61.316929	400	480	25	4	80	0.0500000
NODE_24281_length_607_cov_61.316929	400	480	27	7	80	0.0875000
NODE_24281_length_607_cov_61.316929	400	480	38	4	80	0.0500000
NODE_24281_length_607_cov_61.316929	400	480	40	16	80	0.2000000
NODE_24281_length_607_cov_61.316929	400	480	54	1	80	0.0125000
NODE_24281_length_607_cov_61.316929	400	480	56	6	80	0.0750000
NODE_24281_length_607_cov_61.316929	400	480	58	14	80	0.1750000
NODE_24281_length_607_cov_61.316929	400	480	66	24	80	0.3000000
NODE_24281_length_607_cov_61.316929	400	480	68	4	80	0.0500000
NODE_24281_length_607_cov_61.316929	400	480	25	4	80	0.0500000
NODE_24281_length_607_cov_61.316929	400	480	27	7	80	0.0875000
NODE_24281_length_607_cov_61.316929	400	480	38	4	80	0.0500000
NODE_24281_length_607_cov_61.316929	400	480	40	16	80	0.2000000
NODE_24281_length_607_cov_61.316929	400	480	54	1	80	0.0125000
NODE_24281_length_607_cov_61.316929	400	480	56	6	80	0.0750000
NODE_24281_length_607_cov_61.316929	400	480	58	14	80	0.1750000
NODE_24281_length_607_cov_61.316929	400	480	66	24	80	0.3000000
NODE_24281_length_607_cov_61.316929	400	480	68	4	80	0.0500000
NODE_24281_length_607_cov_61.316929	400	480	25	4	80	0.0500000
NODE_24281_length_607_cov_61.316929	400	480	27	7	80	0.0875000
NODE_24281_length_607_cov_61.316929	400	480	38	4	80	0.0500000
NODE_24281_length_607_cov_61.316929	400	480	40	16	80	0.2000000
NODE_24281_length_607_cov_61.316929	400	480	54	1	80	0.0125000
NODE_24281_length_607_cov_61.316929	400	480	56	6	80	0.0750000
NODE_24281_length_607_cov_61.316929	400	480	58	14	80	0.1750000
NODE_24281_length_607_cov_61.316929	400	480	66	24	80	0.3000000
NODE_24281_length_607_cov_61.316929	400	480	68	4	80	0.0500000
NODE_24281_length_607_cov_61.316929	476	556	54	7	80	0.0875000
NODE_24281_length_607_cov_61.316929	476	556	66	5	80	0.0625000
NODE_24281_length_607_cov_61.316929	476	556	69	15	80	0.1875000
NODE_24281_length_607_cov_61.316929	476	556	71	34	80	0.4250000
NODE_24281_length_607_cov_61.316929	476	556	72	2	80	0.0250000
NODE_24281_length_607_cov_61.316929	476	556	74	3	80	0.0375000
NODE_24281_length_607_cov_61.316929	476	556	78	1	80	0.0125000
NODE_24281_length_607_cov_61.316929	476	556	82	13	80	0.1625000
NODE_24281_length_607_cov_61.316929	476	556	54	7	80	0.0875000
NODE_24281_length_607_cov_61.316929	476	556	66	5	80	0.0625000
NODE_24281_length_607_cov_61.316929	476	556	69	15	80	0.1875000
NODE_24281_length_607_cov_61.316929	476	556	71	34	80	0.4250000
NODE_24281_length_607_cov_61.316929	476	556	72	2	80	0.0250000
NODE_24281_length_607_cov_61.316929	476	556	74	3	80	0.0375000
NODE_24281_length_607_cov_61.316929	476	556	78	1	80	0.0125000
NODE_24281_length_607_cov_61.316929	476	556	82	13	80	0.1625000
NODE_24281_length_607_cov_61.316929	476	556	54	7	80	0.0875000
NODE_24281_length_607_cov_61.316929	476	556	66	5	80	0.0625000
NODE_24281_length_607_cov_61.316929	476	556	69	15	80	0.1875000
NODE_24281_length_607_cov_61.316929	476	556	71	34	80	0.4250000
NODE_24281_length_607_cov_61.316929	476	556	72	2	80	0.0250000
NODE_24281_length_607_cov_61.316929	476	556	74	3	80	0.0375000
NODE_24281_length_607_cov_61.316929	476	556	78	1	80	0.0125000
NODE_24281_length_607_cov_61.316929	476	556	82	13	80	0.1625000
NODE_24281_length_607_cov_61.316929	529	595	16	7	66	0.1060606
NODE_24281_length_607_cov_61.316929	529	595	18	5	66	0.0757576
NODE_24281_length_607_cov_61.316929	529	595	22	1	66	0.0151515
NODE_24281_length_607_cov_61.316929	529	595	31	1	66	0.0151515
NODE_24281_length_607_cov_61.316929	529	595	34	9	66	0.1363636
NODE_24281_length_607_cov_61.316929	529	595	36	7	66	0.1060606
NODE_24281_length_607_cov_61.316929	529	595	38	3	66	0.0454545
NODE_24281_length_607_cov_61.316929	529	595	42	1	66	0.0151515
NODE_24281_length_607_cov_61.316929	529	595	53	4	66	0.0606061
NODE_24281_length_607_cov_61.316929	529	595	69	16	66	0.2424242
NODE_24281_length_607_cov_61.316929	529	595	71	12	66	0.1818182
NODE_24281_length_607_cov_61.316929	529	607	12	1	78	0.0128205
NODE_24281_length_607_cov_61.316929	529	607	16	18	78	0.2307692
NODE_24281_length_607_cov_61.316929	529	607	18	5	78	0.0641026
NODE_24281_length_607_cov_61.316929	529	607	22	1	78	0.0128205
NODE_24281_length_607_cov_61.316929	529	607	31	1	78	0.0128205
NODE_24281_length_607_cov_61.316929	529	607	34	9	78	0.1153846
NODE_24281_length_607_cov_61.316929	529	607	36	7	78	0.0897436
NODE_24281_length_607_cov_61.316929	529	607	38	3	78	0.0384615
NODE_24281_length_607_cov_61.316929	529	607	42	1	78	0.0128205
NODE_24281_length_607_cov_61.316929	529	607	53	4	78	0.0512821
NODE_24281_length_607_cov_61.316929	529	607	69	16	78	0.2051282
NODE_24281_length_607_cov_61.316929	529	607	71	12	78	0.1538462
NODE_24281_length_607_cov_61.316929	529	600	16	12	71	0.1690141
NODE_24281_length_607_cov_61.316929	529	600	18	5	71	0.0704225
NODE_24281_length_607_cov_61.316929	529	600	22	1	71	0.0140845
NODE_24281_length_607_cov_61.316929	529	600	31	1	71	0.0140845
NODE_24281_length_607_cov_61.316929	529	600	34	9	71	0.1267606
NODE_24281_length_607_cov_61.316929	529	600	36	7	71	0.0985916
NODE_24281_length_607_cov_61.316929	529	600	38	3	71	0.0422535
NODE_24281_length_607_cov_61.316929	529	600	42	1	71	0.0140845
NODE_24281_length_607_cov_61.316929	529	600	53	4	71	0.0563380
NODE_24281_length_607_cov_61.316929	529	600	69	16	71	0.2253521
NODE_24281_length_607_cov_61.316929	529	600	71	12	71	0.1690141
NODE_24281_length_607_cov_61.316929	534	607	12	1	73	0.0136986
NODE_24281_length_607_cov_61.316929	534	607	16	18	73	0.2465753
NODE_24281_length_607_cov_61.316929	534	607	18	5	73	0.0684932
NODE_24281_length_607_cov_61.316929	534	607	22	1	73	0.0136986
NODE_24281_length_607_cov_61.316929	534	607	31	1	73	0.0136986
NODE_24281_length_607_cov_61.316929	534	607	34	9	73	0.1232877
NODE_24281_length_607_cov_61.316929	534	607	36	7	73	0.0958904
NODE_24281_length_607_cov_61.316929	534	607	38	3	73	0.0410959
NODE_24281_length_607_cov_61.316929	534	607	42	1	73	0.0136986
NODE_24281_length_607_cov_61.316929	534	607	53	4	73	0.0547945
NODE_24281_length_607_cov_61.316929	534	607	69	16	73	0.2191781
NODE_24281_length_607_cov_61.316929	534	607	71	7	73	0.0958904
NODE_24282_length_607_cov_16.852362	383	463	0	80	80	1.0000000
NODE_24282_length_607_cov_16.852362	436	516	0	80	80	1.0000000
NODE_24283_length_607_cov_12.889764	67	147	0	80	80	1.0000000
NODE_24283_length_607_cov_12.889764	120	200	0	80	80	1.0000000
NODE_24284_length_607_cov_11.023622	122	202	4	56	80	0.7000000
NODE_24284_length_607_cov_11.023622	122	202	8	4	80	0.0500000
NODE_24284_length_607_cov_11.023622	122	202	10	20	80	0.2500000
NODE_24284_length_607_cov_11.023622	175	255	2	2	80	0.0250000
NODE_24284_length_607_cov_11.023622	175	255	4	3	80	0.0375000
NODE_24284_length_607_cov_11.023622	175	255	6	23	80	0.2875000
NODE_24284_length_607_cov_11.023622	175	255	8	4	80	0.0500000
NODE_24284_length_607_cov_11.023622	175	255	10	48	80	0.6000000
NODE_24285_length_607_cov_10.690945	199	279	0	80	80	1.0000000
NODE_24285_length_607_cov_10.690945	252	332	0	80	80	1.0000000
NODE_24290_length_607_cov_5.818898	301	386	0	85	85	1.0000000
NODE_24291_length_607_cov_5.771654	278	358	0	66	80	0.8250000
NODE_24291_length_607_cov_5.771654	278	358	2	14	80	0.1750000
NODE_24291_length_607_cov_5.771654	331	411	0	80	80	1.0000000
NODE_24295_length_607_cov_4.816929	282	362	0	80	80	1.0000000
NODE_24295_length_607_cov_4.816929	335	415	0	80	80	1.0000000
NODE_24300_length_607_cov_4.015748	295	354	0	33	59	0.5593221
NODE_24300_length_607_cov_4.015748	295	354	2	26	59	0.4406780
NODE_24310_length_607_cov_3.088583	107	158	0	51	51	1.0000000
NODE_24331_length_607_cov_1.791339	204	247	6	1	43	0.0232558
NODE_24331_length_607_cov_1.791339	204	247	10	42	43	0.9767442
NODE_24400_length_606_cov_42.264300	182	262	0	80	80	1.0000000
NODE_24400_length_606_cov_42.264300	235	315	0	80	80	1.0000000
NODE_24402_length_606_cov_26.341223	371	451	3	11	80	0.1375000
NODE_24402_length_606_cov_26.341223	371	451	13	2	80	0.0250000
NODE_24402_length_606_cov_26.341223	371	451	14	67	80	0.8375000
NODE_24402_length_606_cov_26.341223	424	504	0	11	80	0.1375000
NODE_24402_length_606_cov_26.341223	424	504	2	13	80	0.1625000
NODE_24402_length_606_cov_26.341223	424	504	3	40	80	0.5000000
NODE_24402_length_606_cov_26.341223	424	504	13	2	80	0.0250000
NODE_24402_length_606_cov_26.341223	424	504	14	14	80	0.1750000
NODE_24403_length_606_cov_14.895464	308	388	0	80	80	1.0000000
NODE_24403_length_606_cov_14.895464	361	441	0	80	80	1.0000000
NODE_24406_length_606_cov_7.934911	412	492	0	80	80	1.0000000
NODE_24406_length_606_cov_7.934911	465	545	0	80	80	1.0000000
NODE_24407_length_606_cov_7.481262	250	330	0	80	80	1.0000000
NODE_24407_length_606_cov_7.481262	303	383	0	55	80	0.6875000
NODE_24407_length_606_cov_7.481262	303	383	2	9	80	0.1125000
NODE_24407_length_606_cov_7.481262	303	383	8	16	80	0.2000000
NODE_24409_length_606_cov_6.842209	139	219	0	64	80	0.8000000
NODE_24409_length_606_cov_6.842209	139	219	4	16	80	0.2000000
NODE_24409_length_606_cov_6.842209	192	272	0	80	80	1.0000000
NODE_24428_length_606_cov_3.384615	156	206	0	50	50	1.0000000
NODE_24433_length_606_cov_2.670611	113	193	3	39	80	0.4875000
NODE_24433_length_606_cov_2.670611	113	193	4	31	80	0.3875000
NODE_24433_length_606_cov_2.670611	113	193	8	10	80	0.1250000
NODE_24525_length_605_cov_63.343874	7	83	0	8	76	0.1052632
NODE_24525_length_605_cov_63.343874	7	83	2	68	76	0.8947368
NODE_24525_length_605_cov_63.343874	12	83	0	3	71	0.0422535
NODE_24525_length_605_cov_63.343874	12	83	2	68	71	0.9577465
NODE_24525_length_605_cov_63.343874	17	83	2	66	66	1.0000000
NODE_24525_length_605_cov_63.343874	56	136	0	12	80	0.1500000
NODE_24525_length_605_cov_63.343874	56	136	2	68	80	0.8500000
NODE_24525_length_605_cov_63.343874	56	136	0	12	80	0.1500000
NODE_24525_length_605_cov_63.343874	56	136	2	68	80	0.8500000
NODE_24525_length_605_cov_63.343874	56	136	0	12	80	0.1500000
NODE_24525_length_605_cov_63.343874	56	136	2	68	80	0.8500000
NODE_24525_length_605_cov_63.343874	132	212	0	7	80	0.0875000
NODE_24525_length_605_cov_63.343874	132	212	4	11	80	0.1375000
NODE_24525_length_605_cov_63.343874	132	212	6	62	80	0.7750000
NODE_24525_length_605_cov_63.343874	132	212	0	7	80	0.0875000
NODE_24525_length_605_cov_63.343874	132	212	4	11	80	0.1375000
NODE_24525_length_605_cov_63.343874	132	212	6	62	80	0.7750000
NODE_24525_length_605_cov_63.343874	132	210	0	7	78	0.0897436
NODE_24525_length_605_cov_63.343874	132	210	4	11	78	0.1410256
NODE_24525_length_605_cov_63.343874	132	210	6	60	78	0.7692308
NODE_24525_length_605_cov_63.343874	132	212	0	7	80	0.0875000
NODE_24525_length_605_cov_63.343874	132	212	4	11	80	0.1375000
NODE_24525_length_605_cov_63.343874	132	212	6	62	80	0.7750000
NODE_24525_length_605_cov_63.343874	132	212	0	7	80	0.0875000
NODE_24525_length_605_cov_63.343874	132	212	4	11	80	0.1375000
NODE_24525_length_605_cov_63.343874	132	212	6	62	80	0.7750000
NODE_24525_length_605_cov_63.343874	185	265	2	37	80	0.4625000
NODE_24525_length_605_cov_63.343874	185	265	4	1	80	0.0125000
NODE_24525_length_605_cov_63.343874	185	265	6	42	80	0.5250000
NODE_24526_length_605_cov_48.191700	298	374	0	11	76	0.1447368
NODE_24526_length_605_cov_48.191700	298	374	6	65	76	0.8552632
NODE_24526_length_605_cov_48.191700	347	427	0	11	80	0.1375000
NODE_24526_length_605_cov_48.191700	347	427	6	69	80	0.8625000
NODE_24528_length_605_cov_33.328063	57	137	198	1	80	0.0125000
NODE_24528_length_605_cov_33.328063	57	137	202	1	80	0.0125000
NODE_24528_length_605_cov_33.328063	57	137	211	1	80	0.0125000
NODE_24528_length_605_cov_33.328063	57	137	213	1	80	0.0125000
NODE_24528_length_605_cov_33.328063	57	137	219	1	80	0.0125000
NODE_24528_length_605_cov_33.328063	57	137	225	1	80	0.0125000
NODE_24528_length_605_cov_33.328063	57	137	227	1	80	0.0125000
NODE_24528_length_605_cov_33.328063	57	137	230	1	80	0.0125000
NODE_24528_length_605_cov_33.328063	57	137	231	1	80	0.0125000
NODE_24528_length_605_cov_33.328063	57	137	236	6	80	0.0750000
NODE_24528_length_605_cov_33.328063	57	137	245	1	80	0.0125000
NODE_24528_length_605_cov_33.328063	57	137	247	1	80	0.0125000
NODE_24528_length_605_cov_33.328063	57	137	260	1	80	0.0125000
NODE_24528_length_605_cov_33.328063	57	137	264	1	80	0.0125000
NODE_24528_length_605_cov_33.328063	57	137	269	1	80	0.0125000
NODE_24528_length_605_cov_33.328063	57	137	273	2	80	0.0250000
NODE_24528_length_605_cov_33.328063	57	137	280	1	80	0.0125000
NODE_24528_length_605_cov_33.328063	57	137	282	2	80	0.0250000
NODE_24528_length_605_cov_33.328063	57	137	283	1	80	0.0125000
NODE_24528_length_605_cov_33.328063	57	137	287	1	80	0.0125000
NODE_24528_length_605_cov_33.328063	57	137	293	1	80	0.0125000
NODE_24528_length_605_cov_33.328063	57	137	294	1	80	0.0125000
NODE_24528_length_605_cov_33.328063	57	137	302	1	80	0.0125000
NODE_24528_length_605_cov_33.328063	57	137	309	1	80	0.0125000
NODE_24528_length_605_cov_33.328063	57	137	311	1	80	0.0125000
NODE_24528_length_605_cov_33.328063	57	137	318	1	80	0.0125000
NODE_24528_length_605_cov_33.328063	57	137	321	1	80	0.0125000
NODE_24528_length_605_cov_33.328063	57	137	322	1	80	0.0125000
NODE_24528_length_605_cov_33.328063	57	137	326	1	80	0.0125000
NODE_24528_length_605_cov_33.328063	57	137	333	1	80	0.0125000
NODE_24528_length_605_cov_33.328063	57	137	334	1	80	0.0125000
NODE_24528_length_605_cov_33.328063	57	137	340	1	80	0.0125000
NODE_24528_length_605_cov_33.328063	57	137	347	2	80	0.0250000
NODE_24528_length_605_cov_33.328063	57	137	348	3	80	0.0375000
NODE_24528_length_605_cov_33.328063	57	137	349	1	80	0.0125000
NODE_24528_length_605_cov_33.328063	57	137	350	1	80	0.0125000
NODE_24528_length_605_cov_33.328063	57	137	353	3	80	0.0375000
NODE_24528_length_605_cov_33.328063	57	137	355	1	80	0.0125000
NODE_24528_length_605_cov_33.328063	57	137	356	1	80	0.0125000
NODE_24528_length_605_cov_33.328063	57	137	362	1	80	0.0125000
NODE_24528_length_605_cov_33.328063	57	137	368	1	80	0.0125000
NODE_24528_length_605_cov_33.328063	57	137	370	1	80	0.0125000
NODE_24528_length_605_cov_33.328063	57	137	381	1	80	0.0125000
NODE_24528_length_605_cov_33.328063	57	137	383	1	80	0.0125000
NODE_24528_length_605_cov_33.328063	57	137	391	1	80	0.0125000
NODE_24528_length_605_cov_33.328063	57	137	392	2	80	0.0250000
NODE_24528_length_605_cov_33.328063	57	137	393	1	80	0.0125000
NODE_24528_length_605_cov_33.328063	57	137	394	2	80	0.0250000
NODE_24528_length_605_cov_33.328063	57	137	401	1	80	0.0125000
NODE_24528_length_605_cov_33.328063	57	137	402	1	80	0.0125000
NODE_24528_length_605_cov_33.328063	57	137	403	1	80	0.0125000
NODE_24528_length_605_cov_33.328063	57	137	406	1	80	0.0125000
NODE_24528_length_605_cov_33.328063	57	137	408	3	80	0.0375000
NODE_24528_length_605_cov_33.328063	57	137	410	4	80	0.0500000
NODE_24528_length_605_cov_33.328063	57	137	411	1	80	0.0125000
NODE_24528_length_605_cov_33.328063	57	137	414	2	80	0.0250000
NODE_24528_length_605_cov_33.328063	57	137	415	1	80	0.0125000
NODE_24528_length_605_cov_33.328063	57	137	417	1	80	0.0125000
NODE_24528_length_605_cov_33.328063	57	137	422	1	80	0.0125000
NODE_24528_length_605_cov_33.328063	57	137	429	1	80	0.0125000
NODE_24528_length_605_cov_33.328063	140	175	504	1	35	0.0285714
NODE_24528_length_605_cov_33.328063	140	175	507	1	35	0.0285714
NODE_24528_length_605_cov_33.328063	140	175	509	1	35	0.0285714
NODE_24528_length_605_cov_33.328063	140	175	510	2	35	0.0571429
NODE_24528_length_605_cov_33.328063	140	175	515	2	35	0.0571429
NODE_24528_length_605_cov_33.328063	140	175	520	1	35	0.0285714
NODE_24528_length_605_cov_33.328063	140	175	524	1	35	0.0285714
NODE_24528_length_605_cov_33.328063	140	175	530	1	35	0.0285714
NODE_24528_length_605_cov_33.328063	140	175	533	1	35	0.0285714
NODE_24528_length_605_cov_33.328063	140	175	535	2	35	0.0571429
NODE_24528_length_605_cov_33.328063	140	175	539	1	35	0.0285714
NODE_24528_length_605_cov_33.328063	140	175	547	1	35	0.0285714
NODE_24528_length_605_cov_33.328063	140	175	560	1	35	0.0285714
NODE_24528_length_605_cov_33.328063	140	175	566	1	35	0.0285714
NODE_24528_length_605_cov_33.328063	140	175	569	1	35	0.0285714
NODE_24528_length_605_cov_33.328063	140	175	574	1	35	0.0285714
NODE_24528_length_605_cov_33.328063	140	175	582	1	35	0.0285714
NODE_24528_length_605_cov_33.328063	140	175	583	1	35	0.0285714
NODE_24528_length_605_cov_33.328063	140	175	585	1	35	0.0285714
NODE_24528_length_605_cov_33.328063	140	175	586	1	35	0.0285714
NODE_24528_length_605_cov_33.328063	140	175	588	1	35	0.0285714
NODE_24528_length_605_cov_33.328063	140	175	596	1	35	0.0285714
NODE_24528_length_605_cov_33.328063	140	175	600	1	35	0.0285714
NODE_24528_length_605_cov_33.328063	140	175	614	1	35	0.0285714
NODE_24528_length_605_cov_33.328063	140	175	625	1	35	0.0285714
NODE_24528_length_605_cov_33.328063	140	175	628	1	35	0.0285714
NODE_24528_length_605_cov_33.328063	140	175	631	1	35	0.0285714
NODE_24528_length_605_cov_33.328063	140	175	633	1	35	0.0285714
NODE_24528_length_605_cov_33.328063	140	175	635	1	35	0.0285714
NODE_24528_length_605_cov_33.328063	140	175	638	1	35	0.0285714
NODE_24528_length_605_cov_33.328063	140	175	639	2	35	0.0571429
NODE_24529_length_605_cov_26.717391	353	433	0	80	80	1.0000000
NODE_24529_length_605_cov_26.717391	406	486	0	80	80	1.0000000
NODE_24530_length_605_cov_17.677866	215	295	0	80	80	1.0000000
NODE_24530_length_605_cov_17.677866	268	348	0	80	80	1.0000000
NODE_24531_length_605_cov_15.225296	144	224	0	18	80	0.2250000
NODE_24531_length_605_cov_15.225296	144	224	8	2	80	0.0250000
NODE_24531_length_605_cov_15.225296	144	224	10	19	80	0.2375000
NODE_24531_length_605_cov_15.225296	144	224	12	41	80	0.5125000
NODE_24531_length_605_cov_15.225296	197	277	2	2	80	0.0250000
NODE_24531_length_605_cov_15.225296	197	277	9	6	80	0.0750000
NODE_24531_length_605_cov_15.225296	197	277	11	3	80	0.0375000
NODE_24531_length_605_cov_15.225296	197	277	12	69	80	0.8625000
NODE_24532_length_605_cov_14.990119	136	216	18	9	80	0.1125000
NODE_24532_length_605_cov_14.990119	136	216	19	20	80	0.2500000
NODE_24532_length_605_cov_14.990119	136	216	20	2	80	0.0250000
NODE_24532_length_605_cov_14.990119	136	216	21	2	80	0.0250000
NODE_24532_length_605_cov_14.990119	136	216	22	29	80	0.3625000
NODE_24532_length_605_cov_14.990119	136	216	28	18	80	0.2250000
NODE_24532_length_605_cov_14.990119	189	269	0	25	80	0.3125000
NODE_24532_length_605_cov_14.990119	189	269	22	21	80	0.2625000
NODE_24532_length_605_cov_14.990119	189	269	25	5	80	0.0625000
NODE_24532_length_605_cov_14.990119	189	269	28	29	80	0.3625000
NODE_24533_length_605_cov_10.835968	103	183	0	49	80	0.6125000
NODE_24533_length_605_cov_10.835968	103	183	2	31	80	0.3875000
NODE_24533_length_605_cov_10.835968	156	236	2	80	80	1.0000000
NODE_24534_length_605_cov_9.169960	306	377	0	22	71	0.3098592
NODE_24534_length_605_cov_9.169960	306	377	2	49	71	0.6901408
NODE_24534_length_605_cov_9.169960	359	432	0	9	73	0.1232877
NODE_24534_length_605_cov_9.169960	359	432	2	64	73	0.8767123
NODE_24546_length_605_cov_4.308300	159	239	0	61	80	0.7625000
NODE_24546_length_605_cov_4.308300	159	239	2	19	80	0.2375000
NODE_24546_length_605_cov_4.308300	271	338	14	7	67	0.1044776
NODE_24546_length_605_cov_4.308300	271	338	16	6	67	0.0895522
NODE_24546_length_605_cov_4.308300	271	338	18	7	67	0.1044776
NODE_24546_length_605_cov_4.308300	271	338	20	47	67	0.7014925
NODE_24546_length_605_cov_4.308300	275	350	14	3	75	0.0400000
NODE_24546_length_605_cov_4.308300	275	350	16	6	75	0.0800000
NODE_24546_length_605_cov_4.308300	275	350	18	9	75	0.1200000
NODE_24546_length_605_cov_4.308300	275	350	20	57	75	0.7600000
NODE_24546_length_605_cov_4.308300	315	372	2	2	57	0.0350877
NODE_24546_length_605_cov_4.308300	315	372	4	1	57	0.0175439
NODE_24546_length_605_cov_4.308300	315	372	8	5	57	0.0877193
NODE_24546_length_605_cov_4.308300	315	372	10	2	57	0.0350877
NODE_24546_length_605_cov_4.308300	315	372	16	6	57	0.1052632
NODE_24546_length_605_cov_4.308300	315	372	18	8	57	0.1403509
NODE_24546_length_605_cov_4.308300	315	372	20	33	57	0.5789474
NODE_24546_length_605_cov_4.308300	328	373	2	3	45	0.0666667
NODE_24546_length_605_cov_4.308300	328	373	4	1	45	0.0222222
NODE_24546_length_605_cov_4.308300	328	373	8	5	45	0.1111111
NODE_24546_length_605_cov_4.308300	328	373	10	2	45	0.0444444
NODE_24546_length_605_cov_4.308300	328	373	16	6	45	0.1333333
NODE_24546_length_605_cov_4.308300	328	373	18	8	45	0.1777778
NODE_24546_length_605_cov_4.308300	328	373	20	20	45	0.4444444
NODE_24558_length_605_cov_3.120553	216	287	0	71	71	1.0000000
NODE_24561_length_605_cov_2.909091	408	487	26	2	79	0.0253165
NODE_24561_length_605_cov_2.909091	408	487	28	1	79	0.0126582
NODE_24561_length_605_cov_2.909091	408	487	30	2	79	0.0253165
NODE_24561_length_605_cov_2.909091	408	487	32	13	79	0.1645570
NODE_24561_length_605_cov_2.909091	408	487	36	15	79	0.1898734
NODE_24561_length_605_cov_2.909091	408	487	38	30	79	0.3797468
NODE_24561_length_605_cov_2.909091	408	487	40	16	79	0.2025317
NODE_24577_length_605_cov_1.897233	230	273	2	5	43	0.1162791
NODE_24577_length_605_cov_1.897233	230	273	6	5	43	0.1162791
NODE_24577_length_605_cov_1.897233	230	273	7	1	43	0.0232558
NODE_24577_length_605_cov_1.897233	230	273	8	32	43	0.7441860
NODE_24603_length_605_cov_1.339921	168	210	2	4	42	0.0952381
NODE_24603_length_605_cov_1.339921	168	210	4	38	42	0.9047619
NODE_24636_length_604_cov_30.411881	93	173	0	80	80	1.0000000
NODE_24636_length_604_cov_30.411881	146	226	0	80	80	1.0000000
NODE_24637_length_604_cov_20.099010	414	494	0	80	80	1.0000000
NODE_24637_length_604_cov_20.099010	467	547	0	80	80	1.0000000
NODE_24639_length_604_cov_10.291089	184	264	0	35	80	0.4375000
NODE_24639_length_604_cov_10.291089	184	264	2	12	80	0.1500000
NODE_24639_length_604_cov_10.291089	184	264	3	6	80	0.0750000
NODE_24639_length_604_cov_10.291089	184	264	4	27	80	0.3375000
NODE_24639_length_604_cov_10.291089	237	317	0	80	80	1.0000000
NODE_24646_length_604_cov_6.033663	265	345	0	29	80	0.3625000
NODE_24646_length_604_cov_6.033663	265	345	2	13	80	0.1625000
NODE_24646_length_604_cov_6.033663	265	345	4	12	80	0.1500000
NODE_24646_length_604_cov_6.033663	265	345	10	19	80	0.2375000
NODE_24646_length_604_cov_6.033663	265	345	11	7	80	0.0875000
NODE_24646_length_604_cov_6.033663	318	397	4	1	79	0.0126582
NODE_24646_length_604_cov_6.033663	318	397	10	19	79	0.2405063
NODE_24646_length_604_cov_6.033663	318	397	11	7	79	0.0886076
NODE_24646_length_604_cov_6.033663	318	397	12	2	79	0.0253165
NODE_24646_length_604_cov_6.033663	318	397	14	1	79	0.0126582
NODE_24646_length_604_cov_6.033663	318	397	16	12	79	0.1518987
NODE_24646_length_604_cov_6.033663	318	397	22	1	79	0.0126582
NODE_24646_length_604_cov_6.033663	318	397	24	8	79	0.1012658
NODE_24646_length_604_cov_6.033663	318	397	25	9	79	0.1139240
NODE_24646_length_604_cov_6.033663	318	397	26	8	79	0.1012658
NODE_24646_length_604_cov_6.033663	318	397	30	11	79	0.1392405
NODE_24654_length_604_cov_4.316832	40	106	0	66	66	1.0000000
NODE_24654_length_604_cov_4.316832	377	435	0	58	58	1.0000000
NODE_24692_length_604_cov_1.805941	299	380	0	27	81	0.3333333
NODE_24692_length_604_cov_1.805941	299	380	2	54	81	0.6666667
NODE_24692_length_604_cov_1.805941	353	433	0	31	80	0.3875000
NODE_24692_length_604_cov_1.805941	353	433	2	49	80	0.6125000
NODE_24732_length_603_cov_18.761905	108	188	0	80	80	1.0000000
NODE_24732_length_603_cov_18.761905	161	241	0	80	80	1.0000000
NODE_24734_length_603_cov_8.996032	163	243	0	80	80	1.0000000
NODE_24734_length_603_cov_8.996032	216	296	0	80	80	1.0000000
NODE_24735_length_603_cov_8.970238	413	493	0	18	80	0.2250000
NODE_24735_length_603_cov_8.970238	413	493	2	1	80	0.0125000
NODE_24735_length_603_cov_8.970238	413	493	4	61	80	0.7625000
NODE_24736_length_603_cov_7.212302	324	404	0	80	80	1.0000000
NODE_24736_length_603_cov_7.212302	377	457	0	80	80	1.0000000
NODE_24739_length_603_cov_5.831349	351	385	0	34	34	1.0000000
NODE_24744_length_603_cov_4.744048	103	183	0	80	80	1.0000000
NODE_24744_length_603_cov_4.744048	156	236	0	80	80	1.0000000
NODE_24748_length_603_cov_4.115079	219	259	0	40	40	1.0000000
NODE_24755_length_603_cov_3.269841	186	223	0	37	37	1.0000000
NODE_24755_length_603_cov_3.269841	196	276	0	80	80	1.0000000
NODE_24755_length_603_cov_3.269841	367	441	0	74	74	1.0000000
NODE_24843_length_602_cov_33.208748	106	186	0	80	80	1.0000000
NODE_24843_length_602_cov_33.208748	159	239	0	80	80	1.0000000
NODE_24844_length_602_cov_28.922465	319	399	0	9	80	0.1125000
NODE_24844_length_602_cov_28.922465	319	399	4	71	80	0.8875000
NODE_24844_length_602_cov_28.922465	372	452	0	17	80	0.2125000
NODE_24844_length_602_cov_28.922465	372	452	3	1	80	0.0125000
NODE_24844_length_602_cov_28.922465	372	452	4	62	80	0.7750000
NODE_24846_length_602_cov_10.930417	248	328	6	80	80	1.0000000
NODE_24846_length_602_cov_10.930417	301	381	0	18	80	0.2250000
NODE_24846_length_602_cov_10.930417	301	381	2	1	80	0.0125000
NODE_24846_length_602_cov_10.930417	301	381	4	8	80	0.1000000
NODE_24846_length_602_cov_10.930417	301	381	6	53	80	0.6625000
NODE_24847_length_602_cov_10.447316	148	207	17	21	59	0.3559322
NODE_24847_length_602_cov_10.447316	148	207	19	16	59	0.2711864
NODE_24847_length_602_cov_10.447316	148	207	21	3	59	0.0508475
NODE_24847_length_602_cov_10.447316	148	207	22	1	59	0.0169492
NODE_24847_length_602_cov_10.447316	148	207	25	2	59	0.0338983
NODE_24847_length_602_cov_10.447316	148	207	26	6	59	0.1016949
NODE_24847_length_602_cov_10.447316	148	207	28	10	59	0.1694915
NODE_24847_length_602_cov_10.447316	181	207	17	12	26	0.4615385
NODE_24847_length_602_cov_10.447316	181	207	19	14	26	0.5384616
NODE_24847_length_602_cov_10.447316	259	291	17	2	32	0.0625000
NODE_24847_length_602_cov_10.447316	259	291	18	6	32	0.1875000
NODE_24847_length_602_cov_10.447316	259	291	19	4	32	0.1250000
NODE_24847_length_602_cov_10.447316	259	291	20	6	32	0.1875000
NODE_24847_length_602_cov_10.447316	259	291	21	14	32	0.4375000
NODE_24851_length_602_cov_7.787276	544	565	0	21	21	1.0000000
NODE_24875_length_602_cov_3.332008	157	239	0	11	82	0.1341463
NODE_24875_length_602_cov_3.332008	157	239	2	8	82	0.0975610
NODE_24875_length_602_cov_3.332008	157	239	4	48	82	0.5853658
NODE_24875_length_602_cov_3.332008	157	239	6	15	82	0.1829268
NODE_24957_length_601_cov_14.952191	183	263	0	80	80	1.0000000
NODE_24957_length_601_cov_14.952191	236	316	0	80	80	1.0000000
NODE_24958_length_601_cov_14.747012	324	404	0	80	80	1.0000000
NODE_24958_length_601_cov_14.747012	377	457	0	80	80	1.0000000
NODE_24959_length_601_cov_11.561753	226	306	4	33	80	0.4125000
NODE_24959_length_601_cov_11.561753	226	306	5	46	80	0.5750000
NODE_24959_length_601_cov_11.561753	226	306	7	1	80	0.0125000
NODE_24959_length_601_cov_11.561753	279	359	0	34	80	0.4250000
NODE_24959_length_601_cov_11.561753	279	359	4	46	80	0.5750000
NODE_24960_length_601_cov_10.826693	320	388	0	68	68	1.0000000
NODE_24961_length_601_cov_10.392430	243	323	6	80	80	1.0000000
NODE_24961_length_601_cov_10.392430	296	375	0	15	79	0.1898734
NODE_24961_length_601_cov_10.392430	296	375	5	2	79	0.0253165
NODE_24961_length_601_cov_10.392430	296	375	6	62	79	0.7848101
NODE_24965_length_601_cov_7.037849	236	316	0	80	80	1.0000000
NODE_24965_length_601_cov_7.037849	289	369	0	80	80	1.0000000
NODE_24969_length_601_cov_5.798805	290	361	0	71	71	1.0000000
NODE_24970_length_601_cov_5.657371	228	308	14	80	80	1.0000000
NODE_24973_length_601_cov_5.039841	395	462	0	8	67	0.1194030
NODE_24973_length_601_cov_5.039841	395	462	2	59	67	0.8805970
NODE_24975_length_601_cov_4.735060	184	247	4	63	63	1.0000000
NODE_24995_length_601_cov_2.599602	371	430	0	59	59	1.0000000
NODE_24995_length_601_cov_2.599602	441	494	0	53	53	1.0000000
NODE_25090_length_600_cov_6.341317	125	147	0	22	22	1.0000000
NODE_25103_length_600_cov_3.754491	142	222	6	36	80	0.4500000
NODE_25103_length_600_cov_3.754491	142	222	8	44	80	0.5500000
NODE_25126_length_600_cov_2.081836	282	328	0	37	46	0.8043478
NODE_25126_length_600_cov_2.081836	282	328	2	9	46	0.1956522
NODE_25141_length_600_cov_1.728543	381	423	0	42	42	1.0000000
NODE_25190_length_599_cov_36.488000	25	105	26	5	80	0.0625000
NODE_25190_length_599_cov_36.488000	25	105	28	75	80	0.9375000
NODE_25191_length_599_cov_27.870000	255	335	0	80	80	1.0000000
NODE_25191_length_599_cov_27.870000	308	388	0	80	80	1.0000000
NODE_25192_length_599_cov_22.640000	229	309	2	22	80	0.2750000
NODE_25192_length_599_cov_22.640000	229	309	4	27	80	0.3375000
NODE_25192_length_599_cov_22.640000	229	309	5	31	80	0.3875000
NODE_25192_length_599_cov_22.640000	229	309	2	22	80	0.2750000
NODE_25192_length_599_cov_22.640000	229	309	4	27	80	0.3375000
NODE_25192_length_599_cov_22.640000	229	309	5	31	80	0.3875000
NODE_25192_length_599_cov_22.640000	229	309	2	22	80	0.2750000
NODE_25192_length_599_cov_22.640000	229	309	4	27	80	0.3375000
NODE_25192_length_599_cov_22.640000	229	309	5	31	80	0.3875000
NODE_25192_length_599_cov_22.640000	229	309	2	22	80	0.2750000
NODE_25192_length_599_cov_22.640000	229	309	4	27	80	0.3375000
NODE_25192_length_599_cov_22.640000	229	309	5	31	80	0.3875000
NODE_25192_length_599_cov_22.640000	229	309	2	22	80	0.2750000
NODE_25192_length_599_cov_22.640000	229	309	4	27	80	0.3375000
NODE_25192_length_599_cov_22.640000	229	309	5	31	80	0.3875000
NODE_25192_length_599_cov_22.640000	282	362	1	26	80	0.3250000
NODE_25192_length_599_cov_22.640000	282	362	3	13	80	0.1625000
NODE_25192_length_599_cov_22.640000	282	362	4	35	80	0.4375000
NODE_25192_length_599_cov_22.640000	282	362	5	6	80	0.0750000
NODE_25192_length_599_cov_22.640000	282	362	1	26	80	0.3250000
NODE_25192_length_599_cov_22.640000	282	362	3	13	80	0.1625000
NODE_25192_length_599_cov_22.640000	282	362	4	35	80	0.4375000
NODE_25192_length_599_cov_22.640000	282	362	5	6	80	0.0750000
NODE_25192_length_599_cov_22.640000	282	353	1	17	71	0.2394366
NODE_25192_length_599_cov_22.640000	282	353	3	13	71	0.1830986
NODE_25192_length_599_cov_22.640000	282	353	4	35	71	0.4929577
NODE_25192_length_599_cov_22.640000	282	353	5	6	71	0.0845070
NODE_25192_length_599_cov_22.640000	285	355	1	19	70	0.2714286
NODE_25192_length_599_cov_22.640000	285	355	3	13	70	0.1857143
NODE_25192_length_599_cov_22.640000	285	355	4	35	70	0.5000000
NODE_25192_length_599_cov_22.640000	285	355	5	3	70	0.0428571
NODE_25192_length_599_cov_22.640000	287	362	1	26	75	0.3466667
NODE_25192_length_599_cov_22.640000	287	362	3	13	75	0.1733333
NODE_25192_length_599_cov_22.640000	287	362	4	35	75	0.4666667
NODE_25192_length_599_cov_22.640000	287	362	5	1	75	0.0133333
NODE_25193_length_599_cov_14.618000	279	359	2	80	80	1.0000000
NODE_25193_length_599_cov_14.618000	332	412	0	25	80	0.3125000
NODE_25193_length_599_cov_14.618000	332	412	2	55	80	0.6875000
NODE_25195_length_599_cov_10.308000	245	325	0	80	80	1.0000000
NODE_25195_length_599_cov_10.308000	298	378	0	80	80	1.0000000
NODE_25196_length_599_cov_9.224000	160	240	0	31	80	0.3875000
NODE_25196_length_599_cov_9.224000	160	240	2	49	80	0.6125000
NODE_25196_length_599_cov_9.224000	213	297	0	42	84	0.5000000
NODE_25196_length_599_cov_9.224000	213	297	2	42	84	0.5000000
NODE_25201_length_599_cov_5.536000	58	112	0	44	54	0.8148148
NODE_25201_length_599_cov_5.536000	58	112	2	10	54	0.1851852
NODE_25208_length_599_cov_3.810000	271	334	0	23	63	0.3650794
NODE_25208_length_599_cov_3.810000	271	334	1	18	63	0.2857143
NODE_25208_length_599_cov_3.810000	271	334	2	22	63	0.3492064
NODE_25208_length_599_cov_3.810000	324	390	2	66	66	1.0000000
NODE_25211_length_599_cov_3.598000	238	318	0	5	80	0.0625000
NODE_25211_length_599_cov_3.598000	238	318	2	75	80	0.9375000
NODE_25211_length_599_cov_3.598000	291	371	0	58	80	0.7250000
NODE_25211_length_599_cov_3.598000	291	371	2	22	80	0.2750000
NODE_25308_length_598_cov_54.450902	264	344	0	51	80	0.6375000
NODE_25308_length_598_cov_54.450902	264	344	28	1	80	0.0125000
NODE_25308_length_598_cov_54.450902	264	344	29	28	80	0.3500000
NODE_25308_length_598_cov_54.450902	317	397	1	3	80	0.0375000
NODE_25308_length_598_cov_54.450902	317	397	21	4	80	0.0500000
NODE_25308_length_598_cov_54.450902	317	397	25	2	80	0.0250000
NODE_25308_length_598_cov_54.450902	317	397	28	2	80	0.0250000
NODE_25308_length_598_cov_54.450902	317	397	29	59	80	0.7375000
NODE_25308_length_598_cov_54.450902	317	397	30	10	80	0.1250000
NODE_25309_length_598_cov_8.326653	204	284	0	80	80	1.0000000
NODE_25309_length_598_cov_8.326653	257	337	0	80	80	1.0000000
NODE_25316_length_598_cov_5.623246	169	240	2	71	71	1.0000000
NODE_25320_length_598_cov_4.929860	73	153	0	73	80	0.9125000
NODE_25320_length_598_cov_4.929860	73	153	2	7	80	0.0875000
NODE_25320_length_598_cov_4.929860	126	206	0	20	80	0.2500000
NODE_25320_length_598_cov_4.929860	126	206	2	60	80	0.7500000
NODE_25421_length_597_cov_15.142570	197	277	0	62	80	0.7750000
NODE_25421_length_597_cov_15.142570	197	277	2	18	80	0.2250000
NODE_25421_length_597_cov_15.142570	250	330	0	9	80	0.1125000
NODE_25421_length_597_cov_15.142570	250	330	2	71	80	0.8875000
NODE_25422_length_597_cov_12.387550	118	198	2	80	80	1.0000000
NODE_25422_length_597_cov_12.387550	171	251	0	46	80	0.5750000
NODE_25422_length_597_cov_12.387550	171	251	2	34	80	0.4250000
NODE_25423_length_597_cov_7.016064	213	293	2	80	80	1.0000000
NODE_25423_length_597_cov_7.016064	266	346	0	53	80	0.6625000
NODE_25423_length_597_cov_7.016064	266	346	2	27	80	0.3375000
NODE_25426_length_597_cov_6.212851	374	449	0	13	75	0.1733333
NODE_25426_length_597_cov_6.212851	374	449	2	28	75	0.3733333
NODE_25426_length_597_cov_6.212851	374	449	3	34	75	0.4533333
NODE_25434_length_597_cov_4.273092	368	448	0	80	80	1.0000000
NODE_25434_length_597_cov_4.273092	421	507	0	86	86	1.0000000
NODE_25464_length_597_cov_2.162651	92	172	0	12	80	0.1500000
NODE_25464_length_597_cov_2.162651	92	172	2	68	80	0.8500000
NODE_25464_length_597_cov_2.162651	145	225	0	12	80	0.1500000
NODE_25464_length_597_cov_2.162651	145	225	2	68	80	0.8500000
NODE_25467_length_597_cov_2.096386	440	509	0	69	69	1.0000000
NODE_25469_length_597_cov_1.977912	392	472	2	6	80	0.0750000
NODE_25469_length_597_cov_1.977912	392	472	4	1	80	0.0125000
NODE_25469_length_597_cov_1.977912	392	472	6	16	80	0.2000000
NODE_25469_length_597_cov_1.977912	392	472	8	57	80	0.7125000
NODE_25469_length_597_cov_1.977912	437	494	0	8	57	0.1403509
NODE_25469_length_597_cov_1.977912	437	494	4	1	57	0.0175439
NODE_25469_length_597_cov_1.977912	437	494	6	29	57	0.5087720
NODE_25469_length_597_cov_1.977912	437	494	8	19	57	0.3333333
NODE_25469_length_597_cov_1.977912	445	525	0	39	80	0.4875000
NODE_25469_length_597_cov_1.977912	445	525	4	1	80	0.0125000
NODE_25469_length_597_cov_1.977912	445	525	6	29	80	0.3625000
NODE_25469_length_597_cov_1.977912	445	525	8	11	80	0.1375000
NODE_25552_length_596_cov_32.293763	221	301	0	33	80	0.4125000
NODE_25552_length_596_cov_32.293763	221	301	4	47	80	0.5875000
NODE_25552_length_596_cov_32.293763	274	354	0	32	80	0.4000000
NODE_25552_length_596_cov_32.293763	274	354	4	48	80	0.6000000
NODE_25552_length_596_cov_32.293763	351	406	0	55	55	1.0000000
NODE_25552_length_596_cov_32.293763	381	459	0	78	78	1.0000000
NODE_25553_length_596_cov_26.891348	199	279	0	80	80	1.0000000
NODE_25553_length_596_cov_26.891348	252	332	0	80	80	1.0000000
NODE_25554_length_596_cov_17.082495	179	259	0	52	80	0.6500000
NODE_25554_length_596_cov_17.082495	179	259	4	1	80	0.0125000
NODE_25554_length_596_cov_17.082495	179	259	5	27	80	0.3375000
NODE_25554_length_596_cov_17.082495	232	312	5	37	80	0.4625000
NODE_25554_length_596_cov_17.082495	232	312	9	28	80	0.3500000
NODE_25554_length_596_cov_17.082495	232	312	10	15	80	0.1875000
NODE_25555_length_596_cov_10.372233	354	434	0	35	80	0.4375000
NODE_25555_length_596_cov_10.372233	354	434	2	45	80	0.5625000
NODE_25555_length_596_cov_10.372233	407	487	0	2	80	0.0250000
NODE_25555_length_596_cov_10.372233	407	487	2	78	80	0.9750000
NODE_25557_length_596_cov_6.955734	142	222	0	80	80	1.0000000
NODE_25558_length_596_cov_6.225352	242	322	0	12	80	0.1500000
NODE_25558_length_596_cov_6.225352	242	322	2	68	80	0.8500000
NODE_25558_length_596_cov_6.225352	308	375	0	16	67	0.2388060
NODE_25558_length_596_cov_6.225352	308	375	2	51	67	0.7611941
NODE_25567_length_596_cov_4.197183	369	444	0	17	75	0.2266667
NODE_25567_length_596_cov_4.197183	369	444	2	6	75	0.0800000
NODE_25567_length_596_cov_4.197183	369	444	3	1	75	0.0133333
NODE_25567_length_596_cov_4.197183	369	444	4	3	75	0.0400000
NODE_25567_length_596_cov_4.197183	369	444	5	6	75	0.0800000
NODE_25567_length_596_cov_4.197183	369	444	6	42	75	0.5600000
NODE_25593_length_596_cov_2.066398	534	583	0	49	49	1.0000000
NODE_25666_length_595_cov_52.532258	248	328	0	80	80	1.0000000
NODE_25666_length_595_cov_52.532258	301	381	0	27	80	0.3375000
NODE_25666_length_595_cov_52.532258	301	381	2	53	80	0.6625000
NODE_25667_length_595_cov_38.584677	122	202	0	2	80	0.0250000
NODE_25667_length_595_cov_38.584677	122	202	2	4	80	0.0500000
NODE_25667_length_595_cov_38.584677	122	202	4	74	80	0.9250000
NODE_25667_length_595_cov_38.584677	175	255	0	2	80	0.0250000
NODE_25667_length_595_cov_38.584677	175	255	2	57	80	0.7125000
NODE_25667_length_595_cov_38.584677	175	255	4	21	80	0.2625000
NODE_25669_length_595_cov_10.576613	323	403	0	80	80	1.0000000
NODE_25669_length_595_cov_10.576613	376	456	0	80	80	1.0000000
NODE_25672_length_595_cov_7.917339	342	415	2	33	73	0.4520548
NODE_25672_length_595_cov_7.917339	342	415	4	40	73	0.5479452
NODE_25672_length_595_cov_7.917339	388	438	2	25	50	0.5000000
NODE_25672_length_595_cov_7.917339	388	438	4	25	50	0.5000000
NODE_25702_length_595_cov_2.792339	178	258	0	80	80	1.0000000
NODE_25702_length_595_cov_2.792339	231	311	0	80	80	1.0000000
NODE_25807_length_594_cov_34.157576	283	363	0	42	80	0.5250000
NODE_25807_length_594_cov_34.157576	283	363	2	38	80	0.4750000
NODE_25807_length_594_cov_34.157576	336	416	0	80	80	1.0000000
NODE_25811_length_594_cov_8.933333	258	338	0	80	80	1.0000000
NODE_25811_length_594_cov_8.933333	311	389	0	78	78	1.0000000
NODE_25815_length_594_cov_5.759596	82	118	0	32	36	0.8888889
NODE_25815_length_594_cov_5.759596	82	118	2	4	36	0.1111111
NODE_25815_length_594_cov_5.759596	114	194	2	53	80	0.6625000
NODE_25815_length_594_cov_5.759596	114	194	4	27	80	0.3375000
NODE_25815_length_594_cov_5.759596	167	242	2	30	75	0.4000000
NODE_25815_length_594_cov_5.759596	167	242	4	45	75	0.6000000
NODE_25825_length_594_cov_3.913131	275	355	1	7	80	0.0875000
NODE_25825_length_594_cov_3.913131	275	355	2	4	80	0.0500000
NODE_25825_length_594_cov_3.913131	275	355	4	38	80	0.4750000
NODE_25825_length_594_cov_3.913131	275	355	6	31	80	0.3875000
NODE_25844_length_594_cov_2.470707	209	247	2	38	38	1.0000000
NODE_25919_length_594_cov_0.698990	33	73	0	40	40	1.0000000
NODE_25928_length_593_cov_124.985830	247	285	48	1	38	0.0263158
NODE_25928_length_593_cov_124.985830	247	285	49	4	38	0.1052632
NODE_25928_length_593_cov_124.985830	247	285	54	3	38	0.0789474
NODE_25928_length_593_cov_124.985830	247	285	57	1	38	0.0263158
NODE_25928_length_593_cov_124.985830	247	285	58	1	38	0.0263158
NODE_25928_length_593_cov_124.985830	247	285	68	2	38	0.0526316
NODE_25928_length_593_cov_124.985830	247	285	70	2	38	0.0526316
NODE_25928_length_593_cov_124.985830	247	285	73	2	38	0.0526316
NODE_25928_length_593_cov_124.985830	247	285	74	1	38	0.0263158
NODE_25928_length_593_cov_124.985830	247	285	75	1	38	0.0263158
NODE_25928_length_593_cov_124.985830	247	285	79	5	38	0.1315790
NODE_25928_length_593_cov_124.985830	247	285	81	1	38	0.0263158
NODE_25928_length_593_cov_124.985830	247	285	86	1	38	0.0263158
NODE_25928_length_593_cov_124.985830	247	285	90	1	38	0.0263158
NODE_25928_length_593_cov_124.985830	247	285	93	1	38	0.0263158
NODE_25928_length_593_cov_124.985830	247	285	95	2	38	0.0526316
NODE_25928_length_593_cov_124.985830	247	285	96	1	38	0.0263158
NODE_25928_length_593_cov_124.985830	247	285	101	5	38	0.1315790
NODE_25928_length_593_cov_124.985830	247	285	102	1	38	0.0263158
NODE_25928_length_593_cov_124.985830	247	285	107	1	38	0.0263158
NODE_25928_length_593_cov_124.985830	247	285	108	1	38	0.0263158
NODE_25929_length_593_cov_36.161943	150	230	0	80	80	1.0000000
NODE_25929_length_593_cov_36.161943	203	283	0	80	80	1.0000000
NODE_25930_length_593_cov_14.979757	219	299	0	80	80	1.0000000
NODE_25930_length_593_cov_14.979757	272	352	0	80	80	1.0000000
NODE_25931_length_593_cov_11.018219	324	404	0	80	80	1.0000000
NODE_25931_length_593_cov_11.018219	377	457	0	80	80	1.0000000
NODE_25946_length_593_cov_3.232794	210	273	4	63	63	1.0000000
NODE_25946_length_593_cov_3.232794	263	326	2	6	63	0.0952381
NODE_25946_length_593_cov_3.232794	263	326	3	5	63	0.0793651
NODE_25946_length_593_cov_3.232794	263	326	4	51	63	0.8095238
NODE_25946_length_593_cov_3.232794	263	326	5	1	63	0.0158730
NODE_25996_length_593_cov_1.261134	227	249	0	22	22	1.0000000
NODE_26033_length_592_cov_18.908722	163	243	0	80	80	1.0000000
NODE_26033_length_592_cov_18.908722	230	296	0	66	66	1.0000000
NODE_26034_length_592_cov_7.531440	232	312	4	61	80	0.7625000
NODE_26034_length_592_cov_7.531440	232	312	6	19	80	0.2375000
NODE_26034_length_592_cov_7.531440	285	361	0	5	76	0.0657895
NODE_26034_length_592_cov_7.531440	285	361	2	11	76	0.1447368
NODE_26034_length_592_cov_7.531440	285	361	4	50	76	0.6578947
NODE_26034_length_592_cov_7.531440	285	361	6	10	76	0.1315790
NODE_26035_length_592_cov_7.000000	77	157	0	5	80	0.0625000
NODE_26035_length_592_cov_7.000000	77	157	1	48	80	0.6000000
NODE_26035_length_592_cov_7.000000	77	157	4	17	80	0.2125000
NODE_26035_length_592_cov_7.000000	77	157	6	10	80	0.1250000
NODE_26035_length_592_cov_7.000000	130	210	4	19	80	0.2375000
NODE_26035_length_592_cov_7.000000	130	210	6	38	80	0.4750000
NODE_26035_length_592_cov_7.000000	130	210	7	23	80	0.2875000
NODE_26040_length_592_cov_5.036511	270	349	7	24	79	0.3037975
NODE_26040_length_592_cov_5.036511	270	349	8	55	79	0.6962025
NODE_26041_length_592_cov_5.024341	205	285	0	80	80	1.0000000
NODE_26041_length_592_cov_5.024341	258	309	0	51	51	1.0000000
NODE_26062_length_592_cov_2.866126	61	127	0	66	66	1.0000000
NODE_26069_length_592_cov_2.361055	476	526	2	15	50	0.3000000
NODE_26069_length_592_cov_2.361055	476	526	4	7	50	0.1400000
NODE_26069_length_592_cov_2.361055	476	526	5	17	50	0.3400000
NODE_26069_length_592_cov_2.361055	476	526	7	11	50	0.2200000
NODE_26142_length_591_cov_11.286585	245	325	0	80	80	1.0000000
NODE_26142_length_591_cov_11.286585	298	378	0	80	80	1.0000000
NODE_26143_length_591_cov_9.432927	241	321	0	80	80	1.0000000
NODE_26143_length_591_cov_9.432927	294	374	0	80	80	1.0000000
NODE_26184_length_591_cov_2.365854	396	476	0	80	80	1.0000000
NODE_26184_length_591_cov_2.365854	449	529	0	80	80	1.0000000
NODE_26272_length_590_cov_29.661914	26	106	4	80	80	1.0000000
NODE_26272_length_590_cov_29.661914	79	159	0	53	80	0.6625000
NODE_26272_length_590_cov_29.661914	79	159	4	27	80	0.3375000
NODE_26272_length_590_cov_29.661914	155	235	0	80	80	1.0000000
NODE_26272_length_590_cov_29.661914	208	288	0	80	80	1.0000000
NODE_26273_length_590_cov_21.360489	178	258	0	80	80	1.0000000
NODE_26273_length_590_cov_21.360489	231	311	0	80	80	1.0000000
NODE_26274_length_590_cov_18.395112	161	241	0	80	80	1.0000000
NODE_26274_length_590_cov_18.395112	214	294	0	80	80	1.0000000
NODE_26275_length_590_cov_17.376782	238	318	0	41	80	0.5125000
NODE_26275_length_590_cov_17.376782	238	318	1	3	80	0.0375000
NODE_26275_length_590_cov_17.376782	238	318	2	36	80	0.4500000
NODE_26275_length_590_cov_17.376782	291	371	0	80	80	1.0000000
NODE_26279_length_590_cov_6.205703	262	333	0	71	71	1.0000000
NODE_26283_length_590_cov_5.319756	224	304	0	80	80	1.0000000
NODE_26283_length_590_cov_5.319756	277	357	0	80	80	1.0000000
NODE_26366_length_590_cov_0.971487	0	32	0	32	32	1.0000000
NODE_26390_length_589_cov_15.810204	384	464	0	80	80	1.0000000
NODE_26390_length_589_cov_15.810204	437	517	0	80	80	1.0000000
NODE_26391_length_589_cov_13.855102	320	400	0	68	80	0.8500000
NODE_26391_length_589_cov_13.855102	320	400	2	12	80	0.1500000
NODE_26391_length_589_cov_13.855102	373	453	0	15	80	0.1875000
NODE_26391_length_589_cov_13.855102	373	453	2	65	80	0.8125000
NODE_26395_length_589_cov_6.297959	186	266	0	30	80	0.3750000
NODE_26395_length_589_cov_6.297959	186	266	2	50	80	0.6250000
NODE_26395_length_589_cov_6.297959	239	319	2	80	80	1.0000000
NODE_26430_length_589_cov_2.320408	431	511	2	19	80	0.2375000
NODE_26430_length_589_cov_2.320408	431	511	4	26	80	0.3250000
NODE_26430_length_589_cov_2.320408	431	511	8	35	80	0.4375000
NODE_26515_length_588_cov_49.936605	264	341	0	77	77	1.0000000
NODE_26515_length_588_cov_49.936605	314	394	0	80	80	1.0000000
NODE_26516_length_588_cov_33.691207	273	353	11	41	80	0.5125000
NODE_26516_length_588_cov_33.691207	273	353	12	15	80	0.1875000
NODE_26516_length_588_cov_33.691207	273	353	14	24	80	0.3000000
NODE_26516_length_588_cov_33.691207	326	406	0	22	80	0.2750000
NODE_26516_length_588_cov_33.691207	326	406	2	7	80	0.0875000
NODE_26516_length_588_cov_33.691207	326	406	12	27	80	0.3375000
NODE_26516_length_588_cov_33.691207	326	406	14	24	80	0.3000000
NODE_26517_length_588_cov_16.564417	245	325	4	80	80	1.0000000
NODE_26517_length_588_cov_16.564417	298	378	0	32	80	0.4000000
NODE_26517_length_588_cov_16.564417	298	378	4	48	80	0.6000000
NODE_26518_length_588_cov_14.595092	266	346	0	80	80	1.0000000
NODE_26518_length_588_cov_14.595092	319	399	0	80	80	1.0000000
NODE_26522_length_588_cov_7.439673	155	235	0	80	80	1.0000000
NODE_26522_length_588_cov_7.439673	208	288	0	80	80	1.0000000
NODE_26523_length_588_cov_7.094070	191	263	2	72	72	1.0000000
NODE_26523_length_588_cov_7.094070	244	310	0	44	66	0.6666667
NODE_26523_length_588_cov_7.094070	244	310	2	22	66	0.3333333
NODE_26523_length_588_cov_7.094070	439	519	0	80	80	1.0000000
NODE_26523_length_588_cov_7.094070	492	572	0	80	80	1.0000000
NODE_26534_length_588_cov_4.167689	65	122	0	57	57	1.0000000
NODE_26634_length_587_cov_39.782787	123	203	0	69	80	0.8625000
NODE_26634_length_587_cov_39.782787	123	203	2	11	80	0.1375000
NODE_26634_length_587_cov_39.782787	176	256	0	16	80	0.2000000
NODE_26634_length_587_cov_39.782787	176	256	2	64	80	0.8000000
NODE_26634_length_587_cov_39.782787	252	332	0	62	80	0.7750000
NODE_26634_length_587_cov_39.782787	252	332	2	18	80	0.2250000
NODE_26634_length_587_cov_39.782787	305	385	0	80	80	1.0000000
NODE_26635_length_587_cov_31.807377	141	221	0	80	80	1.0000000
NODE_26635_length_587_cov_31.807377	194	274	0	80	80	1.0000000
NODE_26636_length_587_cov_12.629098	219	299	4	17	80	0.2125000
NODE_26636_length_587_cov_12.629098	219	299	6	1	80	0.0125000
NODE_26636_length_587_cov_12.629098	219	299	8	4	80	0.0500000
NODE_26636_length_587_cov_12.629098	219	299	10	1	80	0.0125000
NODE_26636_length_587_cov_12.629098	219	299	12	2	80	0.0250000
NODE_26636_length_587_cov_12.629098	219	299	15	16	80	0.2000000
NODE_26636_length_587_cov_12.629098	219	299	16	2	80	0.0250000
NODE_26636_length_587_cov_12.629098	219	299	17	3	80	0.0375000
NODE_26636_length_587_cov_12.629098	219	299	21	10	80	0.1250000
NODE_26636_length_587_cov_12.629098	219	299	22	4	80	0.0500000
NODE_26636_length_587_cov_12.629098	219	299	23	12	80	0.1500000
NODE_26636_length_587_cov_12.629098	219	299	24	7	80	0.0875000
NODE_26636_length_587_cov_12.629098	219	299	25	1	80	0.0125000
NODE_26636_length_587_cov_12.629098	272	352	2	18	80	0.2250000
NODE_26636_length_587_cov_12.629098	272	352	4	52	80	0.6500000
NODE_26636_length_587_cov_12.629098	272	352	6	1	80	0.0125000
NODE_26636_length_587_cov_12.629098	272	352	8	4	80	0.0500000
NODE_26636_length_587_cov_12.629098	272	352	10	1	80	0.0125000
NODE_26636_length_587_cov_12.629098	272	352	12	2	80	0.0250000
NODE_26636_length_587_cov_12.629098	272	352	16	2	80	0.0250000
NODE_26639_length_587_cov_9.067623	203	283	0	80	80	1.0000000
NODE_26639_length_587_cov_9.067623	256	336	0	80	80	1.0000000
NODE_26640_length_587_cov_8.411885	253	311	0	58	58	1.0000000
NODE_26656_length_587_cov_3.231557	201	256	30	17	55	0.3090909
NODE_26656_length_587_cov_3.231557	201	256	32	10	55	0.1818182
NODE_26656_length_587_cov_3.231557	201	256	34	17	55	0.3090909
NODE_26656_length_587_cov_3.231557	201	256	36	4	55	0.0727273
NODE_26656_length_587_cov_3.231557	201	256	40	7	55	0.1272727
NODE_26665_length_587_cov_2.850410	255	288	6	15	33	0.4545455
NODE_26665_length_587_cov_2.850410	255	288	8	18	33	0.5454546
NODE_26749_length_586_cov_37.843943	268	348	0	80	80	1.0000000
NODE_26749_length_586_cov_37.843943	321	401	0	80	80	1.0000000
NODE_26749_length_586_cov_37.843943	397	477	0	80	80	1.0000000
NODE_26749_length_586_cov_37.843943	450	531	0	81	81	1.0000000
NODE_26750_length_586_cov_12.831622	186	266	0	80	80	1.0000000
NODE_26750_length_586_cov_12.831622	239	319	0	80	80	1.0000000
NODE_26752_length_586_cov_11.264887	108	188	0	46	80	0.5750000
NODE_26752_length_586_cov_11.264887	108	188	2	34	80	0.4250000
NODE_26752_length_586_cov_11.264887	161	241	2	80	80	1.0000000
NODE_26754_length_586_cov_9.624230	299	360	0	10	61	0.1639344
NODE_26754_length_586_cov_9.624230	299	360	2	7	61	0.1147541
NODE_26754_length_586_cov_9.624230	299	360	4	44	61	0.7213115
NODE_26754_length_586_cov_9.624230	299	360	0	10	61	0.1639344
NODE_26754_length_586_cov_9.624230	299	360	2	7	61	0.1147541
NODE_26754_length_586_cov_9.624230	299	360	4	44	61	0.7213115
NODE_26754_length_586_cov_9.624230	299	360	0	10	61	0.1639344
NODE_26754_length_586_cov_9.624230	299	360	2	7	61	0.1147541
NODE_26754_length_586_cov_9.624230	299	360	4	44	61	0.7213115
NODE_26754_length_586_cov_9.624230	301	360	0	10	59	0.1694915
NODE_26754_length_586_cov_9.624230	301	360	2	7	59	0.1186441
NODE_26754_length_586_cov_9.624230	301	360	4	42	59	0.7118644
NODE_26756_length_586_cov_8.591376	273	353	0	80	80	1.0000000
NODE_26756_length_586_cov_8.591376	326	406	0	80	80	1.0000000
NODE_26758_length_586_cov_6.135524	334	375	0	41	41	1.0000000
NODE_26758_length_586_cov_6.135524	334	375	0	41	41	1.0000000
NODE_26760_length_586_cov_5.634497	150	230	0	80	80	1.0000000
NODE_26760_length_586_cov_5.634497	203	283	0	80	80	1.0000000
NODE_26765_length_586_cov_4.626283	296	362	0	66	66	1.0000000
NODE_26765_length_586_cov_4.626283	453	533	2	4	80	0.0500000
NODE_26765_length_586_cov_4.626283	453	533	4	39	80	0.4875000
NODE_26765_length_586_cov_4.626283	453	533	8	37	80	0.4625000
NODE_26885_length_585_cov_112.094650	456	536	121	3	80	0.0375000
NODE_26885_length_585_cov_112.094650	456	536	122	1	80	0.0125000
NODE_26885_length_585_cov_112.094650	456	536	123	2	80	0.0250000
NODE_26885_length_585_cov_112.094650	456	536	128	1	80	0.0125000
NODE_26885_length_585_cov_112.094650	456	536	129	3	80	0.0375000
NODE_26885_length_585_cov_112.094650	456	536	133	4	80	0.0500000
NODE_26885_length_585_cov_112.094650	456	536	140	1	80	0.0125000
NODE_26885_length_585_cov_112.094650	456	536	141	2	80	0.0250000
NODE_26885_length_585_cov_112.094650	456	536	142	1	80	0.0125000
NODE_26885_length_585_cov_112.094650	456	536	143	1	80	0.0125000
NODE_26885_length_585_cov_112.094650	456	536	146	3	80	0.0375000
NODE_26885_length_585_cov_112.094650	456	536	150	3	80	0.0375000
NODE_26885_length_585_cov_112.094650	456	536	151	1	80	0.0125000
NODE_26885_length_585_cov_112.094650	456	536	152	1	80	0.0125000
NODE_26885_length_585_cov_112.094650	456	536	153	2	80	0.0250000
NODE_26885_length_585_cov_112.094650	456	536	154	4	80	0.0500000
NODE_26885_length_585_cov_112.094650	456	536	155	1	80	0.0125000
NODE_26885_length_585_cov_112.094650	456	536	157	1	80	0.0125000
NODE_26885_length_585_cov_112.094650	456	536	158	3	80	0.0375000
NODE_26885_length_585_cov_112.094650	456	536	159	3	80	0.0375000
NODE_26885_length_585_cov_112.094650	456	536	160	1	80	0.0125000
NODE_26885_length_585_cov_112.094650	456	536	161	3	80	0.0375000
NODE_26885_length_585_cov_112.094650	456	536	162	1	80	0.0125000
NODE_26885_length_585_cov_112.094650	456	536	165	6	80	0.0750000
NODE_26885_length_585_cov_112.094650	456	536	167	3	80	0.0375000
NODE_26885_length_585_cov_112.094650	456	536	168	3	80	0.0375000
NODE_26885_length_585_cov_112.094650	456	536	169	8	80	0.1000000
NODE_26885_length_585_cov_112.094650	456	536	171	6	80	0.0750000
NODE_26885_length_585_cov_112.094650	456	536	172	5	80	0.0625000
NODE_26885_length_585_cov_112.094650	456	536	173	3	80	0.0375000
NODE_26885_length_585_cov_112.094650	509	585	10	4	76	0.0526316
NODE_26885_length_585_cov_112.094650	509	585	11	1	76	0.0131579
NODE_26885_length_585_cov_112.094650	509	585	13	4	76	0.0526316
NODE_26885_length_585_cov_112.094650	509	585	19	2	76	0.0263158
NODE_26885_length_585_cov_112.094650	509	585	27	4	76	0.0526316
NODE_26885_length_585_cov_112.094650	509	585	29	1	76	0.0131579
NODE_26885_length_585_cov_112.094650	509	585	33	2	76	0.0263158
NODE_26885_length_585_cov_112.094650	509	585	35	2	76	0.0263158
NODE_26885_length_585_cov_112.094650	509	585	47	2	76	0.0263158
NODE_26885_length_585_cov_112.094650	509	585	53	2	76	0.0263158
NODE_26885_length_585_cov_112.094650	509	585	55	4	76	0.0526316
NODE_26885_length_585_cov_112.094650	509	585	57	1	76	0.0131579
NODE_26885_length_585_cov_112.094650	509	585	59	6	76	0.0789474
NODE_26885_length_585_cov_112.094650	509	585	67	1	76	0.0131579
NODE_26885_length_585_cov_112.094650	509	585	81	3	76	0.0394737
NODE_26885_length_585_cov_112.094650	509	585	85	1	76	0.0131579
NODE_26885_length_585_cov_112.094650	509	585	95	2	76	0.0263158
NODE_26885_length_585_cov_112.094650	509	585	112	1	76	0.0131579
NODE_26885_length_585_cov_112.094650	509	585	113	2	76	0.0263158
NODE_26885_length_585_cov_112.094650	509	585	115	3	76	0.0394737
NODE_26885_length_585_cov_112.094650	509	585	116	1	76	0.0131579
NODE_26885_length_585_cov_112.094650	509	585	121	3	76	0.0394737
NODE_26885_length_585_cov_112.094650	509	585	122	1	76	0.0131579
NODE_26885_length_585_cov_112.094650	509	585	123	2	76	0.0263158
NODE_26885_length_585_cov_112.094650	509	585	128	1	76	0.0131579
NODE_26885_length_585_cov_112.094650	509	585	129	1	76	0.0131579
NODE_26885_length_585_cov_112.094650	509	585	133	1	76	0.0131579
NODE_26885_length_585_cov_112.094650	509	585	140	1	76	0.0131579
NODE_26885_length_585_cov_112.094650	509	585	146	1	76	0.0131579
NODE_26885_length_585_cov_112.094650	509	585	151	1	76	0.0131579
NODE_26885_length_585_cov_112.094650	509	585	153	2	76	0.0263158
NODE_26885_length_585_cov_112.094650	509	585	155	1	76	0.0131579
NODE_26885_length_585_cov_112.094650	509	585	157	1	76	0.0131579
NODE_26885_length_585_cov_112.094650	509	585	158	1	76	0.0131579
NODE_26885_length_585_cov_112.094650	509	585	159	3	76	0.0394737
NODE_26885_length_585_cov_112.094650	509	585	160	1	76	0.0131579
NODE_26885_length_585_cov_112.094650	509	585	161	1	76	0.0131579
NODE_26885_length_585_cov_112.094650	509	585	162	1	76	0.0131579
NODE_26885_length_585_cov_112.094650	509	585	167	1	76	0.0131579
NODE_26885_length_585_cov_112.094650	509	585	169	3	76	0.0394737
NODE_26886_length_585_cov_23.872428	168	248	0	80	80	1.0000000
NODE_26886_length_585_cov_23.872428	222	301	0	79	79	1.0000000
NODE_26887_length_585_cov_18.981481	360	440	0	80	80	1.0000000
NODE_26887_length_585_cov_18.981481	413	493	0	80	80	1.0000000
NODE_26888_length_585_cov_13.967078	323	387	0	64	64	1.0000000
NODE_26889_length_585_cov_10.555556	229	309	0	29	80	0.3625000
NODE_26889_length_585_cov_10.555556	229	309	2	51	80	0.6375000
NODE_26889_length_585_cov_10.555556	282	362	2	80	80	1.0000000
NODE_26891_length_585_cov_9.216049	233	313	0	80	80	1.0000000
NODE_26891_length_585_cov_9.216049	286	366	0	80	80	1.0000000
NODE_26894_length_585_cov_8.090535	292	372	0	76	80	0.9500000
NODE_26894_length_585_cov_8.090535	292	372	2	4	80	0.0500000
NODE_26894_length_585_cov_8.090535	345	425	0	80	80	1.0000000
NODE_26895_length_585_cov_8.018519	339	381	0	42	42	1.0000000
NODE_26895_length_585_cov_8.018519	354	419	0	65	65	1.0000000
NODE_26900_length_585_cov_4.954733	147	227	0	32	80	0.4000000
NODE_26900_length_585_cov_4.954733	147	227	1	1	80	0.0125000
NODE_26900_length_585_cov_4.954733	147	227	2	16	80	0.2000000
NODE_26900_length_585_cov_4.954733	147	227	7	31	80	0.3875000
NODE_26912_length_585_cov_3.751029	288	368	8	16	80	0.2000000
NODE_26912_length_585_cov_3.751029	288	368	10	17	80	0.2125000
NODE_26912_length_585_cov_3.751029	288	368	12	5	80	0.0625000
NODE_26912_length_585_cov_3.751029	288	368	14	21	80	0.2625000
NODE_26912_length_585_cov_3.751029	288	368	16	15	80	0.1875000
NODE_26912_length_585_cov_3.751029	288	368	18	6	80	0.0750000
NODE_26912_length_585_cov_3.751029	341	421	6	28	80	0.3500000
NODE_26912_length_585_cov_3.751029	341	421	7	9	80	0.1125000
NODE_26912_length_585_cov_3.751029	341	421	8	3	80	0.0375000
NODE_26912_length_585_cov_3.751029	341	421	10	21	80	0.2625000
NODE_26912_length_585_cov_3.751029	341	421	14	19	80	0.2375000
NODE_27019_length_584_cov_21.657732	57	137	0	80	80	1.0000000
NODE_27019_length_584_cov_21.657732	110	190	0	80	80	1.0000000
NODE_27020_length_584_cov_11.915464	280	360	0	4	80	0.0500000
NODE_27020_length_584_cov_11.915464	280	360	4	76	80	0.9500000
NODE_27020_length_584_cov_11.915464	333	413	0	30	80	0.3750000
NODE_27020_length_584_cov_11.915464	333	413	4	50	80	0.6250000
NODE_27021_length_584_cov_11.197938	217	297	2	46	80	0.5750000
NODE_27021_length_584_cov_11.197938	217	297	4	34	80	0.4250000
NODE_27021_length_584_cov_11.197938	270	350	2	25	80	0.3125000
NODE_27021_length_584_cov_11.197938	270	350	4	55	80	0.6875000
NODE_27022_length_584_cov_9.824742	375	441	5	3	66	0.0454545
NODE_27022_length_584_cov_9.824742	375	441	9	2	66	0.0303030
NODE_27022_length_584_cov_9.824742	375	441	15	4	66	0.0606061
NODE_27022_length_584_cov_9.824742	375	441	16	52	66	0.7878788
NODE_27022_length_584_cov_9.824742	375	441	17	5	66	0.0757576
NODE_27022_length_584_cov_9.824742	375	441	5	3	66	0.0454545
NODE_27022_length_584_cov_9.824742	375	441	9	2	66	0.0303030
NODE_27022_length_584_cov_9.824742	375	441	15	4	66	0.0606061
NODE_27022_length_584_cov_9.824742	375	441	16	52	66	0.7878788
NODE_27022_length_584_cov_9.824742	375	441	17	5	66	0.0757576
NODE_27023_length_584_cov_9.160825	369	449	0	80	80	1.0000000
NODE_27023_length_584_cov_9.160825	422	502	0	80	80	1.0000000
NODE_27023_length_584_cov_9.160825	422	502	0	80	80	1.0000000
NODE_27026_length_584_cov_7.736082	51	131	0	10	80	0.1250000
NODE_27026_length_584_cov_7.736082	51	131	2	70	80	0.8750000
NODE_27026_length_584_cov_7.736082	104	184	0	49	80	0.6125000
NODE_27026_length_584_cov_7.736082	104	184	2	31	80	0.3875000
NODE_27031_length_584_cov_7.113402	213	293	2	80	80	1.0000000
NODE_27031_length_584_cov_7.113402	266	346	0	43	80	0.5375000
NODE_27031_length_584_cov_7.113402	266	346	2	37	80	0.4625000
NODE_27035_length_584_cov_5.843299	281	341	0	13	60	0.2166667
NODE_27035_length_584_cov_5.843299	281	341	2	47	60	0.7833334
NODE_27039_length_584_cov_5.032990	240	320	0	80	80	1.0000000
NODE_27039_length_584_cov_5.032990	293	373	0	80	80	1.0000000
NODE_27061_length_584_cov_2.707216	186	257	0	1	71	0.0140845
NODE_27061_length_584_cov_2.707216	186	257	3	16	71	0.2253521
NODE_27061_length_584_cov_2.707216	186	257	6	54	71	0.7605634
NODE_27147_length_583_cov_7.973140	232	312	0	80	80	1.0000000
NODE_27147_length_583_cov_7.973140	285	365	0	52	80	0.6500000
NODE_27147_length_583_cov_7.973140	285	365	2	8	80	0.1000000
NODE_27147_length_583_cov_7.973140	285	365	4	20	80	0.2500000
NODE_27148_length_583_cov_6.731405	328	408	0	80	80	1.0000000
NODE_27148_length_583_cov_6.731405	381	461	0	80	80	1.0000000
NODE_27149_length_583_cov_6.363636	161	231	0	70	70	1.0000000
NODE_27152_length_583_cov_5.766529	132	186	0	50	54	0.9259259
NODE_27152_length_583_cov_5.766529	132	186	2	4	54	0.0740741
NODE_27263_length_583_cov_0.762397	9	50	0	41	41	1.0000000
NODE_27278_length_582_cov_74.269151	295	375	0	80	80	1.0000000
NODE_27278_length_582_cov_74.269151	348	428	0	80	80	1.0000000
NODE_27279_length_582_cov_53.093168	11	91	0	80	80	1.0000000
NODE_27279_length_582_cov_53.093168	64	144	0	80	80	1.0000000
NODE_27279_length_582_cov_53.093168	140	220	0	80	80	1.0000000
NODE_27279_length_582_cov_53.093168	193	273	0	80	80	1.0000000
NODE_27280_length_582_cov_47.393375	345	425	0	26	80	0.3250000
NODE_27280_length_582_cov_47.393375	345	425	2	31	80	0.3875000
NODE_27280_length_582_cov_47.393375	345	425	4	23	80	0.2875000
NODE_27280_length_582_cov_47.393375	398	478	2	31	80	0.3875000
NODE_27280_length_582_cov_47.393375	398	478	4	49	80	0.6125000
NODE_27281_length_582_cov_16.358178	297	377	0	80	80	1.0000000
NODE_27281_length_582_cov_16.358178	350	431	0	81	81	1.0000000
NODE_27282_length_582_cov_14.107660	128	208	0	8	80	0.1000000
NODE_27282_length_582_cov_14.107660	128	208	2	50	80	0.6250000
NODE_27282_length_582_cov_14.107660	128	208	4	22	80	0.2750000
NODE_27282_length_582_cov_14.107660	181	261	0	61	80	0.7625000
NODE_27282_length_582_cov_14.107660	181	261	2	19	80	0.2375000
NODE_27283_length_582_cov_7.923395	208	287	0	79	79	1.0000000
NODE_27283_length_582_cov_7.923395	262	340	0	78	78	1.0000000
NODE_27284_length_582_cov_7.722567	216	296	2	80	80	1.0000000
NODE_27284_length_582_cov_7.722567	269	349	0	37	80	0.4625000
NODE_27284_length_582_cov_7.722567	269	349	2	43	80	0.5375000
NODE_27289_length_582_cov_4.956522	294	325	2	31	31	1.0000000
NODE_27295_length_582_cov_4.308489	151	192	2	30	41	0.7317073
NODE_27295_length_582_cov_4.308489	151	192	6	11	41	0.2682927
NODE_27297_length_582_cov_3.838509	223	299	6	22	76	0.2894737
NODE_27297_length_582_cov_3.838509	223	299	8	42	76	0.5526316
NODE_27297_length_582_cov_3.838509	223	299	10	4	76	0.0526316
NODE_27297_length_582_cov_3.838509	223	299	11	4	76	0.0526316
NODE_27297_length_582_cov_3.838509	223	299	12	4	76	0.0526316
NODE_27297_length_582_cov_3.838509	272	354	4	18	82	0.2195122
NODE_27297_length_582_cov_3.838509	272	354	8	42	82	0.5121951
NODE_27297_length_582_cov_3.838509	272	354	10	10	82	0.1219512
NODE_27297_length_582_cov_3.838509	272	354	11	4	82	0.0487805
NODE_27297_length_582_cov_3.838509	272	354	12	8	82	0.0975610
NODE_27350_length_582_cov_1.650104	375	450	0	14	75	0.1866667
NODE_27350_length_582_cov_1.650104	375	450	2	61	75	0.8133333
NODE_27405_length_581_cov_16.890041	244	316	0	72	72	1.0000000
NODE_27413_length_581_cov_6.340249	262	342	0	63	80	0.7875000
NODE_27413_length_581_cov_6.340249	262	342	4	17	80	0.2125000
NODE_27413_length_581_cov_6.340249	315	395	0	80	80	1.0000000
NODE_27416_length_581_cov_5.827801	122	192	7	17	70	0.2428571
NODE_27416_length_581_cov_5.827801	122	192	9	5	70	0.0714286
NODE_27416_length_581_cov_5.827801	122	192	11	8	70	0.1142857
NODE_27416_length_581_cov_5.827801	122	192	13	28	70	0.4000000
NODE_27416_length_581_cov_5.827801	122	192	14	1	70	0.0142857
NODE_27416_length_581_cov_5.827801	122	192	15	11	70	0.1571429
NODE_27420_length_581_cov_5.072614	392	466	0	74	74	1.0000000
NODE_27420_length_581_cov_5.072614	424	444	0	20	20	1.0000000
NODE_27464_length_581_cov_1.881743	474	538	4	64	64	1.0000000
NODE_27541_length_580_cov_39.353430	358	438	0	55	80	0.6875000
NODE_27541_length_580_cov_39.353430	358	438	2	25	80	0.3125000
NODE_27541_length_580_cov_39.353430	411	491	0	2	80	0.0250000
NODE_27541_length_580_cov_39.353430	411	491	2	44	80	0.5500000
NODE_27541_length_580_cov_39.353430	411	491	6	12	80	0.1500000
NODE_27541_length_580_cov_39.353430	411	491	18	4	80	0.0500000
NODE_27541_length_580_cov_39.353430	411	491	21	18	80	0.2250000
NODE_27541_length_580_cov_39.353430	487	567	16	4	80	0.0500000
NODE_27541_length_580_cov_39.353430	487	567	20	30	80	0.3750000
NODE_27541_length_580_cov_39.353430	487	567	21	26	80	0.3250000
NODE_27541_length_580_cov_39.353430	487	567	22	20	80	0.2500000
NODE_27541_length_580_cov_39.353430	487	567	16	4	80	0.0500000
NODE_27541_length_580_cov_39.353430	487	567	20	30	80	0.3750000
NODE_27541_length_580_cov_39.353430	487	567	21	26	80	0.3250000
NODE_27541_length_580_cov_39.353430	487	567	22	20	80	0.2500000
NODE_27541_length_580_cov_39.353430	487	567	16	4	80	0.0500000
NODE_27541_length_580_cov_39.353430	487	567	20	30	80	0.3750000
NODE_27541_length_580_cov_39.353430	487	567	21	26	80	0.3250000
NODE_27541_length_580_cov_39.353430	487	567	22	20	80	0.2500000
NODE_27541_length_580_cov_39.353430	487	567	16	4	80	0.0500000
NODE_27541_length_580_cov_39.353430	487	567	20	30	80	0.3750000
NODE_27541_length_580_cov_39.353430	487	567	21	26	80	0.3250000
NODE_27541_length_580_cov_39.353430	487	567	22	20	80	0.2500000
NODE_27541_length_580_cov_39.353430	487	567	16	4	80	0.0500000
NODE_27541_length_580_cov_39.353430	487	567	20	30	80	0.3750000
NODE_27541_length_580_cov_39.353430	487	567	21	26	80	0.3250000
NODE_27541_length_580_cov_39.353430	487	567	22	20	80	0.2500000
NODE_27541_length_580_cov_39.353430	487	567	16	4	80	0.0500000
NODE_27541_length_580_cov_39.353430	487	567	20	30	80	0.3750000
NODE_27541_length_580_cov_39.353430	487	567	21	26	80	0.3250000
NODE_27541_length_580_cov_39.353430	487	567	22	20	80	0.2500000
NODE_27544_length_580_cov_8.925156	198	238	0	40	40	1.0000000
NODE_27544_length_580_cov_8.925156	258	338	0	80	80	1.0000000
NODE_27545_length_580_cov_8.634096	197	277	0	80	80	1.0000000
NODE_27545_length_580_cov_8.634096	250	330	0	80	80	1.0000000
NODE_27551_length_580_cov_6.291060	356	398	0	42	42	1.0000000
NODE_27554_length_580_cov_5.494802	110	190	0	80	80	1.0000000
NODE_27554_length_580_cov_5.494802	163	243	0	80	80	1.0000000
NODE_27559_length_580_cov_4.563410	231	292	8	51	61	0.8360656
NODE_27559_length_580_cov_4.563410	231	292	9	1	61	0.0163934
NODE_27559_length_580_cov_4.563410	231	292	10	9	61	0.1475410
NODE_27559_length_580_cov_4.563410	322	357	2	23	35	0.6571429
NODE_27559_length_580_cov_4.563410	322	357	6	9	35	0.2571429
NODE_27559_length_580_cov_4.563410	322	357	10	3	35	0.0857143
NODE_27590_length_580_cov_2.264033	215	277	0	62	62	1.0000000
NODE_27597_length_580_cov_2.116424	265	345	0	80	80	1.0000000
NODE_27659_length_579_cov_24.231250	159	239	0	80	80	1.0000000
NODE_27659_length_579_cov_24.231250	212	287	0	33	75	0.4400000
NODE_27659_length_579_cov_24.231250	212	287	2	42	75	0.5600000
NODE_27660_length_579_cov_12.602083	246	326	0	80	80	1.0000000
NODE_27660_length_579_cov_12.602083	299	377	0	78	78	1.0000000
NODE_27663_length_579_cov_9.195833	254	334	4	4	80	0.0500000
NODE_27663_length_579_cov_9.195833	254	334	6	5	80	0.0625000
NODE_27663_length_579_cov_9.195833	254	334	8	45	80	0.5625000
NODE_27663_length_579_cov_9.195833	254	334	10	26	80	0.3250000
NODE_27663_length_579_cov_9.195833	307	387	2	16	80	0.2000000
NODE_27663_length_579_cov_9.195833	307	387	6	6	80	0.0750000
NODE_27663_length_579_cov_9.195833	307	387	8	58	80	0.7250000
NODE_27663_length_579_cov_9.195833	383	463	0	72	80	0.9000000
NODE_27663_length_579_cov_9.195833	383	463	2	8	80	0.1000000
NODE_27664_length_579_cov_6.600000	169	249	0	80	80	1.0000000
NODE_27664_length_579_cov_6.600000	222	302	0	80	80	1.0000000
NODE_27667_length_579_cov_5.956250	225	295	2	16	70	0.2285714
NODE_27667_length_579_cov_5.956250	225	295	4	45	70	0.6428571
NODE_27667_length_579_cov_5.956250	225	295	6	9	70	0.1285714
NODE_27667_length_579_cov_5.956250	279	316	2	37	37	1.0000000
NODE_27674_length_579_cov_4.850000	105	185	0	49	80	0.6125000
NODE_27674_length_579_cov_4.850000	105	185	2	31	80	0.3875000
NODE_27674_length_579_cov_4.850000	158	238	0	6	80	0.0750000
NODE_27674_length_579_cov_4.850000	158	238	2	74	80	0.9250000
NODE_27688_length_579_cov_3.291667	290	343	0	53	53	1.0000000
NODE_27695_length_579_cov_2.420833	251	331	0	66	80	0.8250000
NODE_27695_length_579_cov_2.420833	251	331	2	14	80	0.1750000
NODE_27695_length_579_cov_2.420833	304	384	0	13	80	0.1625000
NODE_27695_length_579_cov_2.420833	304	384	2	67	80	0.8375000
NODE_27724_length_579_cov_1.435417	463	497	2	34	34	1.0000000
NODE_27781_length_578_cov_70.192067	100	180	0	80	80	1.0000000
NODE_27781_length_578_cov_70.192067	153	233	0	64	80	0.8000000
NODE_27781_length_578_cov_70.192067	153	233	2	16	80	0.2000000
NODE_27782_length_578_cov_51.676409	129	209	0	12	80	0.1500000
NODE_27782_length_578_cov_51.676409	129	209	2	68	80	0.8500000
NODE_27782_length_578_cov_51.676409	182	262	0	65	80	0.8125000
NODE_27782_length_578_cov_51.676409	182	262	2	15	80	0.1875000
NODE_27783_length_578_cov_32.152401	310	390	0	80	80	1.0000000
NODE_27783_length_578_cov_32.152401	363	443	0	34	80	0.4250000
NODE_27783_length_578_cov_32.152401	363	443	2	46	80	0.5750000
NODE_27784_length_578_cov_30.484342	215	295	0	2	80	0.0250000
NODE_27784_length_578_cov_30.484342	215	295	2	8	80	0.1000000
NODE_27784_length_578_cov_30.484342	215	295	4	70	80	0.8750000
NODE_27784_length_578_cov_30.484342	268	348	0	55	80	0.6875000
NODE_27784_length_578_cov_30.484342	268	348	2	8	80	0.1000000
NODE_27784_length_578_cov_30.484342	268	348	4	17	80	0.2125000
NODE_27785_length_578_cov_15.983299	213	265	3	12	52	0.2307692
NODE_27785_length_578_cov_15.983299	213	265	6	8	52	0.1538462
NODE_27785_length_578_cov_15.983299	213	265	7	1	52	0.0192308
NODE_27785_length_578_cov_15.983299	213	265	8	31	52	0.5961539
NODE_27786_length_578_cov_14.968685	147	227	2	80	80	1.0000000
NODE_27786_length_578_cov_14.968685	200	280	0	1	80	0.0125000
NODE_27786_length_578_cov_14.968685	200	280	1	1	80	0.0125000
NODE_27786_length_578_cov_14.968685	200	280	2	78	80	0.9750000
NODE_27787_length_578_cov_9.567850	273	328	0	55	55	1.0000000
NODE_27792_length_578_cov_6.670146	273	353	0	2	80	0.0250000
NODE_27792_length_578_cov_6.670146	273	353	1	27	80	0.3375000
NODE_27792_length_578_cov_6.670146	273	353	2	51	80	0.6375000
NODE_27792_length_578_cov_6.670146	326	406	2	80	80	1.0000000
NODE_27793_length_578_cov_6.465553	320	400	0	80	80	1.0000000
NODE_27793_length_578_cov_6.465553	373	453	0	80	80	1.0000000
NODE_27863_length_578_cov_1.480167	185	265	0	43	80	0.5375000
NODE_27863_length_578_cov_1.480167	185	265	2	37	80	0.4625000
NODE_27863_length_578_cov_1.480167	238	318	0	4	80	0.0500000
NODE_27863_length_578_cov_1.480167	238	318	2	76	80	0.9500000
NODE_27935_length_577_cov_11.638075	312	392	0	80	80	1.0000000
NODE_27942_length_577_cov_4.912134	218	249	8	31	31	1.0000000
NODE_27942_length_577_cov_4.912134	301	330	0	29	29	1.0000000
NODE_27961_length_577_cov_2.970711	78	126	20	4	48	0.0833333
NODE_27961_length_577_cov_2.970711	78	126	22	44	48	0.9166667
NODE_27968_length_577_cov_2.631799	169	253	8	4	84	0.0476190
NODE_27968_length_577_cov_2.631799	169	253	9	5	84	0.0595238
NODE_27968_length_577_cov_2.631799	169	253	10	2	84	0.0238095
NODE_27968_length_577_cov_2.631799	169	253	12	9	84	0.1071429
NODE_27968_length_577_cov_2.631799	169	253	13	16	84	0.1904762
NODE_27968_length_577_cov_2.631799	169	253	14	14	84	0.1666667
NODE_27968_length_577_cov_2.631799	169	253	15	8	84	0.0952381
NODE_27968_length_577_cov_2.631799	169	253	16	26	84	0.3095238
NODE_27968_length_577_cov_2.631799	226	269	14	13	43	0.3023256
NODE_27968_length_577_cov_2.631799	226	269	16	30	43	0.6976744
NODE_28003_length_577_cov_1.468619	71	146	0	68	75	0.9066667
NODE_28003_length_577_cov_1.468619	71	146	8	7	75	0.0933333
NODE_28003_length_577_cov_1.468619	119	199	0	20	80	0.2500000
NODE_28003_length_577_cov_1.468619	119	199	8	60	80	0.7500000
NODE_28058_length_576_cov_10.903564	194	274	0	80	80	1.0000000
NODE_28059_length_576_cov_9.039832	271	351	0	80	80	1.0000000
NODE_28059_length_576_cov_9.039832	324	404	0	80	80	1.0000000
NODE_28060_length_576_cov_8.490566	338	418	2	80	80	1.0000000
NODE_28060_length_576_cov_8.490566	391	471	0	13	80	0.1625000
NODE_28060_length_576_cov_8.490566	391	471	2	67	80	0.8375000
NODE_28061_length_576_cov_7.002096	157	237	0	80	80	1.0000000
NODE_28061_length_576_cov_7.002096	210	290	0	72	80	0.9000000
NODE_28061_length_576_cov_7.002096	210	290	2	8	80	0.1000000
NODE_28076_length_576_cov_3.322851	118	183	14	5	65	0.0769231
NODE_28076_length_576_cov_3.322851	118	183	18	1	65	0.0153846
NODE_28076_length_576_cov_3.322851	118	183	19	1	65	0.0153846
NODE_28076_length_576_cov_3.322851	118	183	20	14	65	0.2153846
NODE_28076_length_576_cov_3.322851	118	183	22	6	65	0.0923077
NODE_28076_length_576_cov_3.322851	118	183	24	1	65	0.0153846
NODE_28076_length_576_cov_3.322851	118	183	26	37	65	0.5692308
NODE_28102_length_576_cov_1.964361	148	228	0	80	80	1.0000000
NODE_28102_length_576_cov_1.964361	201	281	0	80	80	1.0000000
NODE_28104_length_576_cov_1.951782	159	239	4	74	80	0.9250000
NODE_28104_length_576_cov_1.951782	159	239	6	6	80	0.0750000
NODE_28104_length_576_cov_1.951782	212	292	0	36	80	0.4500000
NODE_28104_length_576_cov_1.951782	212	292	4	44	80	0.5500000
NODE_28116_length_576_cov_1.584906	381	455	0	74	74	1.0000000
NODE_28179_length_575_cov_15.319328	319	399	0	31	80	0.3875000
NODE_28179_length_575_cov_15.319328	319	399	2	49	80	0.6125000
NODE_28179_length_575_cov_15.319328	372	452	0	31	80	0.3875000
NODE_28179_length_575_cov_15.319328	372	452	2	49	80	0.6125000
NODE_28181_length_575_cov_8.254202	286	366	0	46	80	0.5750000
NODE_28181_length_575_cov_8.254202	286	366	2	7	80	0.0875000
NODE_28181_length_575_cov_8.254202	286	366	5	27	80	0.3375000
NODE_28181_length_575_cov_8.254202	339	419	5	43	80	0.5375000
NODE_28181_length_575_cov_8.254202	339	419	6	37	80	0.4625000
NODE_28182_length_575_cov_7.558824	300	380	0	80	80	1.0000000
NODE_28313_length_574_cov_6.282105	185	265	2	67	80	0.8375000
NODE_28313_length_574_cov_6.282105	185	265	4	13	80	0.1625000
NODE_28313_length_574_cov_6.282105	238	318	2	60	80	0.7500000
NODE_28313_length_574_cov_6.282105	238	318	4	20	80	0.2500000
NODE_28330_length_574_cov_2.993684	215	234	0	19	19	1.0000000
NODE_28438_length_573_cov_53.668776	393	473	2	17	80	0.2125000
NODE_28438_length_573_cov_53.668776	393	473	9	19	80	0.2375000
NODE_28438_length_573_cov_53.668776	393	473	10	41	80	0.5125000
NODE_28438_length_573_cov_53.668776	393	473	11	3	80	0.0375000
NODE_28438_length_573_cov_53.668776	446	526	0	16	80	0.2000000
NODE_28438_length_573_cov_53.668776	446	526	1	9	80	0.1125000
NODE_28438_length_573_cov_53.668776	446	526	2	4	80	0.0500000
NODE_28438_length_573_cov_53.668776	446	526	8	1	80	0.0125000
NODE_28438_length_573_cov_53.668776	446	526	9	42	80	0.5250000
NODE_28438_length_573_cov_53.668776	446	526	10	5	80	0.0625000
NODE_28438_length_573_cov_53.668776	446	526	11	3	80	0.0375000
NODE_28439_length_573_cov_30.658228	451	531	2	36	80	0.4500000
NODE_28439_length_573_cov_30.658228	451	531	4	1	80	0.0125000
NODE_28439_length_573_cov_30.658228	451	531	8	43	80	0.5375000
NODE_28440_length_573_cov_30.116034	435	515	113	3	80	0.0375000
NODE_28440_length_573_cov_30.116034	435	515	118	1	80	0.0125000
NODE_28440_length_573_cov_30.116034	435	515	122	2	80	0.0250000
NODE_28440_length_573_cov_30.116034	435	515	128	3	80	0.0375000
NODE_28440_length_573_cov_30.116034	435	515	129	1	80	0.0125000
NODE_28440_length_573_cov_30.116034	435	515	134	2	80	0.0250000
NODE_28440_length_573_cov_30.116034	435	515	135	1	80	0.0125000
NODE_28440_length_573_cov_30.116034	435	515	140	4	80	0.0500000
NODE_28440_length_573_cov_30.116034	435	515	142	2	80	0.0250000
NODE_28440_length_573_cov_30.116034	435	515	143	1	80	0.0125000
NODE_28440_length_573_cov_30.116034	435	515	144	1	80	0.0125000
NODE_28440_length_573_cov_30.116034	435	515	146	3	80	0.0375000
NODE_28440_length_573_cov_30.116034	435	515	151	1	80	0.0125000
NODE_28440_length_573_cov_30.116034	435	515	152	4	80	0.0500000
NODE_28440_length_573_cov_30.116034	435	515	154	2	80	0.0250000
NODE_28440_length_573_cov_30.116034	435	515	156	1	80	0.0125000
NODE_28440_length_573_cov_30.116034	435	515	157	2	80	0.0250000
NODE_28440_length_573_cov_30.116034	435	515	158	2	80	0.0250000
NODE_28440_length_573_cov_30.116034	435	515	159	1	80	0.0125000
NODE_28440_length_573_cov_30.116034	435	515	161	2	80	0.0250000
NODE_28440_length_573_cov_30.116034	435	515	162	2	80	0.0250000
NODE_28440_length_573_cov_30.116034	435	515	163	1	80	0.0125000
NODE_28440_length_573_cov_30.116034	435	515	164	1	80	0.0125000
NODE_28440_length_573_cov_30.116034	435	515	166	4	80	0.0500000
NODE_28440_length_573_cov_30.116034	435	515	168	8	80	0.1000000
NODE_28440_length_573_cov_30.116034	435	515	170	4	80	0.0500000
NODE_28440_length_573_cov_30.116034	435	515	171	1	80	0.0125000
NODE_28440_length_573_cov_30.116034	435	515	172	2	80	0.0250000
NODE_28440_length_573_cov_30.116034	435	515	173	1	80	0.0125000
NODE_28440_length_573_cov_30.116034	435	515	174	7	80	0.0875000
NODE_28440_length_573_cov_30.116034	435	515	175	3	80	0.0375000
NODE_28440_length_573_cov_30.116034	435	515	176	2	80	0.0250000
NODE_28440_length_573_cov_30.116034	435	515	177	3	80	0.0375000
NODE_28440_length_573_cov_30.116034	435	515	179	1	80	0.0125000
NODE_28440_length_573_cov_30.116034	435	515	185	1	80	0.0125000
NODE_28440_length_573_cov_30.116034	488	568	27	2	80	0.0250000
NODE_28440_length_573_cov_30.116034	488	568	31	1	80	0.0125000
NODE_28440_length_573_cov_30.116034	488	568	32	2	80	0.0250000
NODE_28440_length_573_cov_30.116034	488	568	34	1	80	0.0125000
NODE_28440_length_573_cov_30.116034	488	568	36	1	80	0.0125000
NODE_28440_length_573_cov_30.116034	488	568	41	1	80	0.0125000
NODE_28440_length_573_cov_30.116034	488	568	48	2	80	0.0250000
NODE_28440_length_573_cov_30.116034	488	568	52	2	80	0.0250000
NODE_28440_length_573_cov_30.116034	488	568	57	1	80	0.0125000
NODE_28440_length_573_cov_30.116034	488	568	63	1	80	0.0125000
NODE_28440_length_573_cov_30.116034	488	568	65	2	80	0.0250000
NODE_28440_length_573_cov_30.116034	488	568	69	1	80	0.0125000
NODE_28440_length_573_cov_30.116034	488	568	71	2	80	0.0250000
NODE_28440_length_573_cov_30.116034	488	568	75	4	80	0.0500000
NODE_28440_length_573_cov_30.116034	488	568	77	1	80	0.0125000
NODE_28440_length_573_cov_30.116034	488	568	78	1	80	0.0125000
NODE_28440_length_573_cov_30.116034	488	568	79	1	80	0.0125000
NODE_28440_length_573_cov_30.116034	488	568	82	6	80	0.0750000
NODE_28440_length_573_cov_30.116034	488	568	84	3	80	0.0375000
NODE_28440_length_573_cov_30.116034	488	568	86	1	80	0.0125000
NODE_28440_length_573_cov_30.116034	488	568	93	2	80	0.0250000
NODE_28440_length_573_cov_30.116034	488	568	99	1	80	0.0125000
NODE_28440_length_573_cov_30.116034	488	568	101	8	80	0.1000000
NODE_28440_length_573_cov_30.116034	488	568	104	1	80	0.0125000
NODE_28440_length_573_cov_30.116034	488	568	106	1	80	0.0125000
NODE_28440_length_573_cov_30.116034	488	568	109	1	80	0.0125000
NODE_28440_length_573_cov_30.116034	488	568	111	2	80	0.0250000
NODE_28440_length_573_cov_30.116034	488	568	113	4	80	0.0500000
NODE_28440_length_573_cov_30.116034	488	568	118	1	80	0.0125000
NODE_28440_length_573_cov_30.116034	488	568	122	2	80	0.0250000
NODE_28440_length_573_cov_30.116034	488	568	128	3	80	0.0375000
NODE_28440_length_573_cov_30.116034	488	568	129	1	80	0.0125000
NODE_28440_length_573_cov_30.116034	488	568	134	2	80	0.0250000
NODE_28440_length_573_cov_30.116034	488	568	135	1	80	0.0125000
NODE_28440_length_573_cov_30.116034	488	568	140	4	80	0.0500000
NODE_28440_length_573_cov_30.116034	488	568	142	2	80	0.0250000
NODE_28440_length_573_cov_30.116034	488	568	143	1	80	0.0125000
NODE_28440_length_573_cov_30.116034	488	568	144	1	80	0.0125000
NODE_28440_length_573_cov_30.116034	488	568	146	3	80	0.0375000
NODE_28440_length_573_cov_30.116034	488	568	151	1	80	0.0125000
NODE_28440_length_573_cov_30.116034	488	568	152	2	80	0.0250000
NODE_28441_length_573_cov_24.234177	210	290	0	80	80	1.0000000
NODE_28441_length_573_cov_24.234177	263	343	0	80	80	1.0000000
NODE_28442_length_573_cov_13.464135	278	358	0	80	80	1.0000000
NODE_28442_length_573_cov_13.464135	331	411	0	80	80	1.0000000
NODE_28443_length_573_cov_8.761603	124	204	4	6	80	0.0750000
NODE_28443_length_573_cov_8.761603	124	204	6	52	80	0.6500000
NODE_28443_length_573_cov_8.761603	124	204	10	22	80	0.2750000
NODE_28443_length_573_cov_8.761603	177	257	4	59	80	0.7375000
NODE_28443_length_573_cov_8.761603	177	257	10	21	80	0.2625000
NODE_28456_length_573_cov_3.364979	365	398	30	2	33	0.0606061
NODE_28456_length_573_cov_3.364979	365	398	34	4	33	0.1212121
NODE_28456_length_573_cov_3.364979	365	398	36	5	33	0.1515152
NODE_28456_length_573_cov_3.364979	365	398	37	15	33	0.4545455
NODE_28456_length_573_cov_3.364979	365	398	38	3	33	0.0909091
NODE_28456_length_573_cov_3.364979	365	398	39	4	33	0.1212121
NODE_28565_length_572_cov_17.530655	312	392	0	80	80	1.0000000
NODE_28565_length_572_cov_17.530655	365	445	0	80	80	1.0000000
NODE_28567_length_572_cov_8.059197	250	321	0	1	71	0.0140845
NODE_28567_length_572_cov_8.059197	250	321	2	70	71	0.9859155
NODE_28568_length_572_cov_7.873150	134	214	0	80	80	1.0000000
NODE_28568_length_572_cov_7.873150	187	267	0	80	80	1.0000000
NODE_28570_length_572_cov_6.706131	365	445	6	26	80	0.3250000
NODE_28570_length_572_cov_6.706131	365	445	7	16	80	0.2000000
NODE_28570_length_572_cov_6.706131	365	445	8	38	80	0.4750000
NODE_28570_length_572_cov_6.706131	418	498	0	4	80	0.0500000
NODE_28570_length_572_cov_6.706131	418	498	5	2	80	0.0250000
NODE_28570_length_572_cov_6.706131	418	498	6	73	80	0.9125000
NODE_28570_length_572_cov_6.706131	418	498	7	1	80	0.0125000
NODE_28573_length_572_cov_5.625793	137	217	0	80	80	1.0000000
NODE_28573_length_572_cov_5.625793	190	270	0	80	80	1.0000000
NODE_28574_length_572_cov_5.617336	331	401	0	14	70	0.2000000
NODE_28574_length_572_cov_5.617336	331	401	4	9	70	0.1285714
NODE_28574_length_572_cov_5.617336	331	401	6	6	70	0.0857143
NODE_28574_length_572_cov_5.617336	331	401	8	3	70	0.0428571
NODE_28574_length_572_cov_5.617336	331	401	12	38	70	0.5428572
NODE_28578_length_572_cov_4.596195	212	288	0	76	76	1.0000000
NODE_28578_length_572_cov_4.596195	261	341	0	80	80	1.0000000
NODE_28585_length_572_cov_3.843552	210	290	2	17	80	0.2125000
NODE_28585_length_572_cov_3.843552	210	290	4	63	80	0.7875000
NODE_28585_length_572_cov_3.843552	263	343	0	8	80	0.1000000
NODE_28585_length_572_cov_3.843552	263	343	1	35	80	0.4375000
NODE_28585_length_572_cov_3.843552	263	343	2	27	80	0.3375000
NODE_28585_length_572_cov_3.843552	263	343	4	10	80	0.1250000
NODE_28621_length_572_cov_2.319239	357	431	8	17	74	0.2297297
NODE_28621_length_572_cov_2.319239	357	431	10	2	74	0.0270270
NODE_28621_length_572_cov_2.319239	357	431	11	4	74	0.0540541
NODE_28621_length_572_cov_2.319239	357	431	15	7	74	0.0945946
NODE_28621_length_572_cov_2.319239	357	431	17	22	74	0.2972973
NODE_28621_length_572_cov_2.319239	357	431	19	4	74	0.0540541
NODE_28621_length_572_cov_2.319239	357	431	21	18	74	0.2432432
NODE_28621_length_572_cov_2.319239	410	478	8	1	68	0.0147059
NODE_28621_length_572_cov_2.319239	410	478	12	4	68	0.0588235
NODE_28621_length_572_cov_2.319239	410	478	13	11	68	0.1617647
NODE_28621_length_572_cov_2.319239	410	478	14	6	68	0.0882353
NODE_28621_length_572_cov_2.319239	410	478	15	29	68	0.4264706
NODE_28621_length_572_cov_2.319239	410	478	17	8	68	0.1176471
NODE_28621_length_572_cov_2.319239	410	478	21	9	68	0.1323529
NODE_28625_length_572_cov_2.107822	184	254	0	70	70	1.0000000
NODE_28625_length_572_cov_2.107822	415	493	5	15	78	0.1923077
NODE_28625_length_572_cov_2.107822	415	493	7	33	78	0.4230769
NODE_28625_length_572_cov_2.107822	415	493	9	30	78	0.3846154
NODE_28631_length_572_cov_1.947146	327	363	0	2	36	0.0555556
NODE_28631_length_572_cov_1.947146	327	363	2	34	36	0.9444444
NODE_28631_length_572_cov_1.947146	328	354	2	26	26	1.0000000
NODE_28700_length_571_cov_14.262712	237	317	0	80	80	1.0000000
NODE_28700_length_571_cov_14.262712	290	370	0	80	80	1.0000000
NODE_28717_length_571_cov_4.033898	154	234	0	80	80	1.0000000
NODE_28717_length_571_cov_4.033898	207	273	0	66	66	1.0000000
NODE_28809_length_570_cov_28.269639	487	559	31	1	72	0.0138889
NODE_28809_length_570_cov_28.269639	487	559	33	11	72	0.1527778
NODE_28809_length_570_cov_28.269639	487	559	41	2	72	0.0277778
NODE_28809_length_570_cov_28.269639	487	559	43	4	72	0.0555556
NODE_28809_length_570_cov_28.269639	487	559	45	6	72	0.0833333
NODE_28809_length_570_cov_28.269639	487	559	46	2	72	0.0277778
NODE_28809_length_570_cov_28.269639	487	559	48	3	72	0.0416667
NODE_28809_length_570_cov_28.269639	487	559	49	5	72	0.0694444
NODE_28809_length_570_cov_28.269639	487	559	50	12	72	0.1666667
NODE_28809_length_570_cov_28.269639	487	559	51	20	72	0.2777778
NODE_28809_length_570_cov_28.269639	487	559	53	6	72	0.0833333
NODE_28812_length_570_cov_10.161359	167	247	0	80	80	1.0000000
NODE_28812_length_570_cov_10.161359	220	256	0	36	36	1.0000000
NODE_28819_length_570_cov_5.010616	179	216	0	37	37	1.0000000
NODE_28819_length_570_cov_5.010616	189	269	0	80	80	1.0000000
NODE_28828_length_570_cov_3.898089	236	316	0	80	80	1.0000000
NODE_28828_length_570_cov_3.898089	289	369	0	80	80	1.0000000
NODE_28840_length_570_cov_2.938429	202	280	8	16	78	0.2051282
NODE_28840_length_570_cov_2.938429	202	280	10	8	78	0.1025641
NODE_28840_length_570_cov_2.938429	202	280	12	12	78	0.1538462
NODE_28840_length_570_cov_2.938429	202	280	14	3	78	0.0384615
NODE_28840_length_570_cov_2.938429	202	280	16	39	78	0.5000000
NODE_28840_length_570_cov_2.938429	262	333	2	7	71	0.0985916
NODE_28840_length_570_cov_2.938429	262	333	4	41	71	0.5774648
NODE_28840_length_570_cov_2.938429	262	333	8	21	71	0.2957746
NODE_28840_length_570_cov_2.938429	262	333	10	2	71	0.0281690
NODE_28842_length_570_cov_2.891720	204	260	2	13	56	0.2321429
NODE_28842_length_570_cov_2.891720	204	260	4	43	56	0.7678571
NODE_28950_length_569_cov_20.559574	275	355	0	29	80	0.3625000
NODE_28950_length_569_cov_20.559574	275	355	2	51	80	0.6375000
NODE_28950_length_569_cov_20.559574	328	408	0	80	80	1.0000000
NODE_28951_length_569_cov_15.282979	272	352	0	80	80	1.0000000
NODE_28951_length_569_cov_15.282979	325	405	0	80	80	1.0000000
NODE_28952_length_569_cov_11.023404	280	360	0	61	80	0.7625000
NODE_28952_length_569_cov_11.023404	280	360	2	19	80	0.2375000
NODE_28952_length_569_cov_11.023404	333	413	0	8	80	0.1000000
NODE_28952_length_569_cov_11.023404	333	413	2	72	80	0.9000000
NODE_28953_length_569_cov_9.310638	231	277	2	12	46	0.2608696
NODE_28953_length_569_cov_9.310638	231	277	4	23	46	0.5000000
NODE_28953_length_569_cov_9.310638	231	277	6	7	46	0.1521739
NODE_28953_length_569_cov_9.310638	231	277	8	4	46	0.0869565
NODE_28956_length_569_cov_6.989362	258	338	4	2	80	0.0250000
NODE_28956_length_569_cov_6.989362	258	338	6	4	80	0.0500000
NODE_28956_length_569_cov_6.989362	258	338	8	74	80	0.9250000
NODE_28956_length_569_cov_6.989362	294	329	4	2	35	0.0571429
NODE_28956_length_569_cov_6.989362	294	329	8	33	35	0.9428571
NODE_28956_length_569_cov_6.989362	296	338	4	2	42	0.0476190
NODE_28956_length_569_cov_6.989362	296	338	8	40	42	0.9523810
NODE_28957_length_569_cov_6.978723	264	344	0	80	80	1.0000000
NODE_28957_length_569_cov_6.978723	317	397	0	80	80	1.0000000
NODE_28960_length_569_cov_6.434043	228	308	0	80	80	1.0000000
NODE_28973_length_569_cov_3.353191	340	419	0	79	79	1.0000000
NODE_28981_length_569_cov_3.027660	277	348	0	71	71	1.0000000
NODE_29072_length_568_cov_59.729211	124	204	38	59	80	0.7375000
NODE_29072_length_568_cov_59.729211	124	204	39	20	80	0.2500000
NODE_29072_length_568_cov_59.729211	124	204	40	1	80	0.0125000
NODE_29072_length_568_cov_59.729211	177	257	0	36	80	0.4500000
NODE_29072_length_568_cov_59.729211	177	257	11	1	80	0.0125000
NODE_29072_length_568_cov_59.729211	177	257	12	1	80	0.0125000
NODE_29072_length_568_cov_59.729211	177	257	25	2	80	0.0250000
NODE_29072_length_568_cov_59.729211	177	257	26	7	80	0.0875000
NODE_29072_length_568_cov_59.729211	177	257	38	33	80	0.4125000
NODE_29075_length_568_cov_7.763326	215	294	0	79	79	1.0000000
NODE_29075_length_568_cov_7.763326	267	347	0	80	80	1.0000000
NODE_29078_length_568_cov_6.257996	397	471	0	32	74	0.4324324
NODE_29078_length_568_cov_6.257996	397	471	2	42	74	0.5675676
NODE_29091_length_568_cov_3.748401	170	236	0	66	66	1.0000000
NODE_29091_length_568_cov_3.748401	262	311	0	49	49	1.0000000
NODE_29133_length_568_cov_1.769723	192	233	2	41	41	1.0000000
NODE_29160_length_568_cov_1.358209	355	432	2	2	77	0.0259740
NODE_29160_length_568_cov_1.358209	355	432	4	3	77	0.0389610
NODE_29160_length_568_cov_1.358209	355	432	6	54	77	0.7012987
NODE_29160_length_568_cov_1.358209	355	432	8	18	77	0.2337662
NODE_29182_length_568_cov_1.038380	195	275	0	80	80	1.0000000
NODE_29216_length_567_cov_21.155983	347	427	0	80	80	1.0000000
NODE_29216_length_567_cov_21.155983	400	480	0	80	80	1.0000000
NODE_29217_length_567_cov_18.292735	367	447	0	65	80	0.8125000
NODE_29217_length_567_cov_18.292735	367	447	4	15	80	0.1875000
NODE_29217_length_567_cov_18.292735	420	500	0	12	80	0.1500000
NODE_29217_length_567_cov_18.292735	420	500	4	68	80	0.8500000
NODE_29218_length_567_cov_17.579060	259	339	0	80	80	1.0000000
NODE_29218_length_567_cov_17.579060	312	392	0	80	80	1.0000000
NODE_29220_length_567_cov_15.457265	276	356	0	3	80	0.0375000
NODE_29220_length_567_cov_15.457265	276	356	2	9	80	0.1125000
NODE_29220_length_567_cov_15.457265	276	356	8	68	80	0.8500000
NODE_29220_length_567_cov_15.457265	329	409	8	80	80	1.0000000
NODE_29221_length_567_cov_14.393162	270	350	0	80	80	1.0000000
NODE_29221_length_567_cov_14.393162	323	403	0	80	80	1.0000000
NODE_29225_length_567_cov_6.611111	356	436	0	80	80	1.0000000
NODE_29225_length_567_cov_6.611111	409	489	0	80	80	1.0000000
NODE_29245_length_567_cov_2.884615	204	284	0	80	80	1.0000000
NODE_29245_length_567_cov_2.884615	204	254	0	50	50	1.0000000
NODE_29245_length_567_cov_2.884615	266	297	0	31	31	1.0000000
NODE_29363_length_566_cov_47.747323	157	237	0	37	80	0.4625000
NODE_29363_length_566_cov_47.747323	157	237	18	43	80	0.5375000
NODE_29363_length_566_cov_47.747323	210	290	18	80	80	1.0000000
NODE_29364_length_566_cov_44.824411	14	94	24	5	80	0.0625000
NODE_29364_length_566_cov_44.824411	14	94	28	4	80	0.0500000
NODE_29364_length_566_cov_44.824411	14	94	30	3	80	0.0375000
NODE_29364_length_566_cov_44.824411	14	94	32	1	80	0.0125000
NODE_29364_length_566_cov_44.824411	14	94	34	3	80	0.0375000
NODE_29364_length_566_cov_44.824411	14	94	41	1	80	0.0125000
NODE_29364_length_566_cov_44.824411	14	94	42	1	80	0.0125000
NODE_29364_length_566_cov_44.824411	14	94	48	9	80	0.1125000
NODE_29364_length_566_cov_44.824411	14	94	52	5	80	0.0625000
NODE_29364_length_566_cov_44.824411	14	94	54	4	80	0.0500000
NODE_29364_length_566_cov_44.824411	14	94	58	44	80	0.5500000
NODE_29364_length_566_cov_44.824411	15	94	24	4	79	0.0506329
NODE_29364_length_566_cov_44.824411	15	94	28	4	79	0.0506329
NODE_29364_length_566_cov_44.824411	15	94	30	3	79	0.0379747
NODE_29364_length_566_cov_44.824411	15	94	32	1	79	0.0126582
NODE_29364_length_566_cov_44.824411	15	94	34	3	79	0.0379747
NODE_29364_length_566_cov_44.824411	15	94	41	1	79	0.0126582
NODE_29364_length_566_cov_44.824411	15	94	42	1	79	0.0126582
NODE_29364_length_566_cov_44.824411	15	94	48	9	79	0.1139240
NODE_29364_length_566_cov_44.824411	15	94	52	5	79	0.0632911
NODE_29364_length_566_cov_44.824411	15	94	54	4	79	0.0506329
NODE_29364_length_566_cov_44.824411	15	94	58	44	79	0.5569620
NODE_29364_length_566_cov_44.824411	67	147	20	7	80	0.0875000
NODE_29364_length_566_cov_44.824411	67	147	28	2	80	0.0250000
NODE_29364_length_566_cov_44.824411	67	147	32	4	80	0.0500000
NODE_29364_length_566_cov_44.824411	67	147	38	4	80	0.0500000
NODE_29364_length_566_cov_44.824411	67	147	42	1	80	0.0125000
NODE_29364_length_566_cov_44.824411	67	147	46	4	80	0.0500000
NODE_29364_length_566_cov_44.824411	67	147	48	2	80	0.0250000
NODE_29364_length_566_cov_44.824411	67	147	54	2	80	0.0250000
NODE_29364_length_566_cov_44.824411	67	147	56	12	80	0.1500000
NODE_29364_length_566_cov_44.824411	67	147	58	42	80	0.5250000
NODE_29364_length_566_cov_44.824411	67	147	20	7	80	0.0875000
NODE_29364_length_566_cov_44.824411	67	147	28	2	80	0.0250000
NODE_29364_length_566_cov_44.824411	67	147	32	4	80	0.0500000
NODE_29364_length_566_cov_44.824411	67	147	38	4	80	0.0500000
NODE_29364_length_566_cov_44.824411	67	147	42	1	80	0.0125000
NODE_29364_length_566_cov_44.824411	67	147	46	4	80	0.0500000
NODE_29364_length_566_cov_44.824411	67	147	48	2	80	0.0250000
NODE_29364_length_566_cov_44.824411	67	147	54	2	80	0.0250000
NODE_29364_length_566_cov_44.824411	67	147	56	12	80	0.1500000
NODE_29364_length_566_cov_44.824411	67	147	58	42	80	0.5250000
NODE_29364_length_566_cov_44.824411	77	147	20	7	70	0.1000000
NODE_29364_length_566_cov_44.824411	77	147	28	2	70	0.0285714
NODE_29364_length_566_cov_44.824411	77	147	32	4	70	0.0571429
NODE_29364_length_566_cov_44.824411	77	147	38	4	70	0.0571429
NODE_29364_length_566_cov_44.824411	77	147	42	1	70	0.0142857
NODE_29364_length_566_cov_44.824411	77	147	46	4	70	0.0571429
NODE_29364_length_566_cov_44.824411	77	147	48	2	70	0.0285714
NODE_29364_length_566_cov_44.824411	77	147	54	2	70	0.0285714
NODE_29364_length_566_cov_44.824411	77	147	56	12	70	0.1714286
NODE_29364_length_566_cov_44.824411	77	147	58	32	70	0.4571429
NODE_29364_length_566_cov_44.824411	143	223	6	34	80	0.4250000
NODE_29364_length_566_cov_44.824411	143	223	8	13	80	0.1625000
NODE_29364_length_566_cov_44.824411	143	223	10	19	80	0.2375000
NODE_29364_length_566_cov_44.824411	143	223	18	5	80	0.0625000
NODE_29364_length_566_cov_44.824411	143	223	20	6	80	0.0750000
NODE_29364_length_566_cov_44.824411	143	223	24	3	80	0.0375000
NODE_29364_length_566_cov_44.824411	196	276	0	3	80	0.0375000
NODE_29364_length_566_cov_44.824411	196	276	5	27	80	0.3375000
NODE_29364_length_566_cov_44.824411	196	276	6	50	80	0.6250000
NODE_29367_length_566_cov_18.494647	344	424	0	80	80	1.0000000
NODE_29367_length_566_cov_18.494647	397	477	0	80	80	1.0000000
NODE_29368_length_566_cov_17.537473	324	404	0	19	80	0.2375000
NODE_29368_length_566_cov_17.537473	324	404	2	61	80	0.7625000
NODE_29368_length_566_cov_17.537473	377	457	0	72	80	0.9000000
NODE_29368_length_566_cov_17.537473	377	457	2	8	80	0.1000000
NODE_29369_length_566_cov_13.019272	157	237	0	80	80	1.0000000
NODE_29369_length_566_cov_13.019272	210	290	0	80	80	1.0000000
NODE_29371_length_566_cov_9.513919	191	279	0	88	88	1.0000000
NODE_29371_length_566_cov_9.513919	252	332	0	80	80	1.0000000
NODE_29397_length_566_cov_3.239829	292	334	0	42	42	1.0000000
NODE_29397_length_566_cov_3.239829	351	375	0	24	24	1.0000000
NODE_29437_length_566_cov_1.698073	432	481	0	49	49	1.0000000
NODE_29472_length_566_cov_0.957173	378	405	0	4	27	0.1481481
NODE_29472_length_566_cov_0.957173	378	405	4	23	27	0.8518519
NODE_29503_length_565_cov_10.508584	202	280	0	2	78	0.0256410
NODE_29503_length_565_cov_10.508584	202	280	2	76	78	0.9743590
NODE_29503_length_565_cov_10.508584	253	334	0	23	81	0.2839506
NODE_29503_length_565_cov_10.508584	253	334	2	58	81	0.7160494
NODE_29509_length_565_cov_7.560086	170	246	14	4	76	0.0526316
NODE_29509_length_565_cov_7.560086	170	246	15	1	76	0.0131579
NODE_29509_length_565_cov_7.560086	170	246	16	2	76	0.0263158
NODE_29509_length_565_cov_7.560086	170	246	18	12	76	0.1578947
NODE_29509_length_565_cov_7.560086	170	246	20	23	76	0.3026316
NODE_29509_length_565_cov_7.560086	170	246	22	32	76	0.4210526
NODE_29509_length_565_cov_7.560086	170	246	24	2	76	0.0263158
NODE_29520_length_565_cov_4.045064	231	311	0	80	80	1.0000000
NODE_29520_length_565_cov_4.045064	284	364	0	80	80	1.0000000
NODE_29528_length_565_cov_3.399142	161	241	0	80	80	1.0000000
NODE_29528_length_565_cov_3.399142	214	294	0	80	80	1.0000000
NODE_29542_length_565_cov_2.542918	302	382	0	80	80	1.0000000
NODE_29542_length_565_cov_2.542918	355	435	0	80	80	1.0000000
NODE_29650_length_564_cov_46.901075	129	209	0	80	80	1.0000000
NODE_29650_length_564_cov_46.901075	182	262	0	80	80	1.0000000
NODE_29651_length_564_cov_13.520430	300	380	2	17	80	0.2125000
NODE_29651_length_564_cov_13.520430	300	380	4	63	80	0.7875000
NODE_29651_length_564_cov_13.520430	353	433	0	6	80	0.0750000
NODE_29651_length_564_cov_13.520430	353	433	2	56	80	0.7000000
NODE_29651_length_564_cov_13.520430	353	433	4	18	80	0.2250000
NODE_29653_length_564_cov_7.965591	291	332	0	41	41	1.0000000
NODE_29796_length_563_cov_24.487069	97	177	0	80	80	1.0000000
NODE_29796_length_563_cov_24.487069	150	230	0	80	80	1.0000000
NODE_29800_length_563_cov_6.758621	301	367	4	11	66	0.1666667
NODE_29800_length_563_cov_6.758621	301	367	6	3	66	0.0454545
NODE_29800_length_563_cov_6.758621	301	367	10	14	66	0.2121212
NODE_29800_length_563_cov_6.758621	301	367	12	4	66	0.0606061
NODE_29800_length_563_cov_6.758621	301	367	16	8	66	0.1212121
NODE_29800_length_563_cov_6.758621	301	367	18	6	66	0.0909091
NODE_29800_length_563_cov_6.758621	301	367	20	7	66	0.1060606
NODE_29800_length_563_cov_6.758621	301	367	22	6	66	0.0909091
NODE_29800_length_563_cov_6.758621	301	367	24	7	66	0.1060606
NODE_29800_length_563_cov_6.758621	378	422	2	28	44	0.6363636
NODE_29800_length_563_cov_6.758621	378	422	4	16	44	0.3636364
NODE_29802_length_563_cov_5.762931	48	135	0	87	87	1.0000000
NODE_29802_length_563_cov_5.762931	108	188	0	80	80	1.0000000
NODE_29808_length_563_cov_4.176724	197	277	2	59	80	0.7375000
NODE_29808_length_563_cov_4.176724	197	277	4	21	80	0.2625000
NODE_29808_length_563_cov_4.176724	250	330	2	46	80	0.5750000
NODE_29808_length_563_cov_4.176724	250	330	4	34	80	0.4250000
NODE_29809_length_563_cov_4.155172	273	315	2	8	42	0.1904762
NODE_29809_length_563_cov_4.155172	273	315	4	1	42	0.0238095
NODE_29809_length_563_cov_4.155172	273	315	6	23	42	0.5476190
NODE_29809_length_563_cov_4.155172	273	315	8	4	42	0.0952381
NODE_29809_length_563_cov_4.155172	273	315	10	6	42	0.1428571
NODE_29809_length_563_cov_4.155172	288	358	6	17	70	0.2428571
NODE_29809_length_563_cov_4.155172	288	358	8	4	70	0.0571429
NODE_29809_length_563_cov_4.155172	288	358	10	49	70	0.7000000
NODE_29925_length_562_cov_31.194384	47	127	0	64	80	0.8000000
NODE_29925_length_562_cov_31.194384	47	127	2	16	80	0.2000000
NODE_29925_length_562_cov_31.194384	100	180	0	11	80	0.1375000
NODE_29925_length_562_cov_31.194384	100	180	2	69	80	0.8625000
NODE_29926_length_562_cov_29.857451	33	113	3	7	80	0.0875000
NODE_29926_length_562_cov_29.857451	33	113	4	73	80	0.9125000
NODE_29926_length_562_cov_29.857451	86	166	0	51	80	0.6375000
NODE_29926_length_562_cov_29.857451	86	166	3	9	80	0.1125000
NODE_29926_length_562_cov_29.857451	86	166	4	20	80	0.2500000
NODE_29927_length_562_cov_23.194384	245	325	1	4	80	0.0500000
NODE_29927_length_562_cov_23.194384	245	325	2	76	80	0.9500000
NODE_29927_length_562_cov_23.194384	298	378	1	3	80	0.0375000
NODE_29927_length_562_cov_23.194384	298	378	2	77	80	0.9625000
NODE_29930_length_562_cov_10.304536	271	321	0	16	50	0.3200000
NODE_29930_length_562_cov_10.304536	271	321	2	5	50	0.1000000
NODE_29930_length_562_cov_10.304536	271	321	3	24	50	0.4800000
NODE_29930_length_562_cov_10.304536	271	321	4	3	50	0.0600000
NODE_29930_length_562_cov_10.304536	271	321	6	2	50	0.0400000
NODE_29931_length_562_cov_9.131749	265	346	0	27	81	0.3333333
NODE_29931_length_562_cov_9.131749	265	346	1	28	81	0.3456790
NODE_29931_length_562_cov_9.131749	265	346	2	26	81	0.3209876
NODE_29931_length_562_cov_9.131749	319	399	1	1	80	0.0125000
NODE_29931_length_562_cov_9.131749	319	399	2	39	80	0.4875000
NODE_29931_length_562_cov_9.131749	319	399	4	40	80	0.5000000
NODE_29960_length_562_cov_2.961123	350	398	0	48	48	1.0000000
NODE_30083_length_561_cov_18.049784	54	134	26	80	80	1.0000000
NODE_30083_length_561_cov_18.049784	107	187	0	41	80	0.5125000
NODE_30083_length_561_cov_18.049784	107	187	26	39	80	0.4875000
NODE_30087_length_561_cov_5.348485	208	274	0	49	66	0.7424242
NODE_30087_length_561_cov_5.348485	208	274	1	17	66	0.2575758
NODE_30105_length_561_cov_2.787879	216	285	2	9	69	0.1304348
NODE_30105_length_561_cov_2.787879	216	285	4	52	69	0.7536232
NODE_30105_length_561_cov_2.787879	216	285	5	3	69	0.0434783
NODE_30105_length_561_cov_2.787879	216	285	6	5	69	0.0724638
NODE_30120_length_561_cov_2.233766	339	419	0	80	80	1.0000000
NODE_30120_length_561_cov_2.233766	391	445	0	54	54	1.0000000
NODE_30120_length_561_cov_2.233766	392	438	0	46	46	1.0000000
NODE_30133_length_561_cov_1.803030	258	334	0	76	76	1.0000000
NODE_30224_length_560_cov_41.433839	67	147	0	10	80	0.1250000
NODE_30224_length_560_cov_41.433839	67	147	5	21	80	0.2625000
NODE_30224_length_560_cov_41.433839	67	147	6	49	80	0.6125000
NODE_30224_length_560_cov_41.433839	120	200	0	63	80	0.7875000
NODE_30224_length_560_cov_41.433839	120	200	6	17	80	0.2125000
NODE_30225_length_560_cov_35.993492	366	446	6	80	80	1.0000000
NODE_30225_length_560_cov_35.993492	419	499	0	23	80	0.2875000
NODE_30225_length_560_cov_35.993492	419	499	6	57	80	0.7125000
NODE_30226_length_560_cov_20.433839	342	422	0	80	80	1.0000000
NODE_30226_length_560_cov_20.433839	395	475	0	80	80	1.0000000
NODE_30227_length_560_cov_13.850325	274	327	0	53	53	1.0000000
NODE_30228_length_560_cov_12.075922	233	314	14	6	81	0.0740741
NODE_30228_length_560_cov_12.075922	233	314	16	1	81	0.0123457
NODE_30228_length_560_cov_12.075922	233	314	17	1	81	0.0123457
NODE_30228_length_560_cov_12.075922	233	314	19	11	81	0.1358025
NODE_30228_length_560_cov_12.075922	233	314	21	9	81	0.1111111
NODE_30228_length_560_cov_12.075922	233	314	26	6	81	0.0740741
NODE_30228_length_560_cov_12.075922	233	314	27	9	81	0.1111111
NODE_30228_length_560_cov_12.075922	233	314	28	5	81	0.0617284
NODE_30228_length_560_cov_12.075922	233	314	29	10	81	0.1234568
NODE_30228_length_560_cov_12.075922	233	314	31	3	81	0.0370370
NODE_30228_length_560_cov_12.075922	233	314	35	20	81	0.2469136
NODE_30229_length_560_cov_8.594360	263	343	0	80	80	1.0000000
NODE_30229_length_560_cov_8.594360	316	396	0	80	80	1.0000000
NODE_30237_length_560_cov_5.227766	264	328	30	2	64	0.0312500
NODE_30237_length_560_cov_5.227766	264	328	32	9	64	0.1406250
NODE_30237_length_560_cov_5.227766	264	328	34	5	64	0.0781250
NODE_30237_length_560_cov_5.227766	264	328	36	20	64	0.3125000
NODE_30237_length_560_cov_5.227766	264	328	38	28	64	0.4375000
NODE_30238_length_560_cov_5.056399	299	379	0	80	80	1.0000000
NODE_30238_length_560_cov_5.056399	352	432	0	80	80	1.0000000
NODE_30244_length_560_cov_4.518438	156	236	0	80	80	1.0000000
NODE_30281_length_560_cov_2.154013	204	275	2	71	71	1.0000000
NODE_30281_length_560_cov_2.154013	255	335	0	55	80	0.6875000
NODE_30281_length_560_cov_2.154013	255	335	1	5	80	0.0625000
NODE_30281_length_560_cov_2.154013	255	335	2	20	80	0.2500000
NODE_30288_length_560_cov_2.017354	52	114	0	62	62	1.0000000
NODE_30363_length_559_cov_37.526087	289	370	0	81	81	1.0000000
NODE_30363_length_559_cov_37.526087	343	423	0	80	80	1.0000000
NODE_30363_length_559_cov_37.526087	419	500	0	81	81	1.0000000
NODE_30363_length_559_cov_37.526087	473	553	0	80	80	1.0000000
NODE_30365_length_559_cov_19.126087	388	468	0	3	80	0.0375000
NODE_30365_length_559_cov_19.126087	388	468	2	77	80	0.9625000
NODE_30365_length_559_cov_19.126087	441	521	0	53	80	0.6625000
NODE_30365_length_559_cov_19.126087	441	521	2	27	80	0.3375000
NODE_30366_length_559_cov_12.489130	262	341	2	79	79	1.0000000
NODE_30366_length_559_cov_12.489130	316	394	0	27	78	0.3461539
NODE_30366_length_559_cov_12.489130	316	394	2	51	78	0.6538461
NODE_30370_length_559_cov_6.530435	283	363	0	80	80	1.0000000
NODE_30377_length_559_cov_4.930435	112	192	0	80	80	1.0000000
NODE_30377_length_559_cov_4.930435	165	244	0	79	79	1.0000000
NODE_30419_length_559_cov_1.776087	395	433	96	2	38	0.0526316
NODE_30419_length_559_cov_1.776087	395	433	98	3	38	0.0789474
NODE_30419_length_559_cov_1.776087	395	433	100	2	38	0.0526316
NODE_30419_length_559_cov_1.776087	395	433	102	4	38	0.1052632
NODE_30419_length_559_cov_1.776087	395	433	103	3	38	0.0789474
NODE_30419_length_559_cov_1.776087	395	433	105	8	38	0.2105263
NODE_30419_length_559_cov_1.776087	395	433	106	2	38	0.0526316
NODE_30419_length_559_cov_1.776087	395	433	107	14	38	0.3684210
NODE_30480_length_558_cov_13.102397	297	364	0	43	67	0.6417910
NODE_30480_length_558_cov_13.102397	297	364	2	24	67	0.3582090
NODE_30482_length_558_cov_9.309368	369	449	0	73	80	0.9125000
NODE_30482_length_558_cov_9.309368	369	449	2	7	80	0.0875000
NODE_30482_length_558_cov_9.309368	422	502	0	20	80	0.2500000
NODE_30482_length_558_cov_9.309368	422	502	2	60	80	0.7500000
NODE_30489_length_558_cov_5.921569	304	361	0	57	57	1.0000000
NODE_30493_length_558_cov_4.801743	197	266	0	69	69	1.0000000
NODE_30493_length_558_cov_4.801743	197	277	0	80	80	1.0000000
NODE_30493_length_558_cov_4.801743	250	330	0	40	80	0.5000000
NODE_30493_length_558_cov_4.801743	250	330	2	40	80	0.5000000
NODE_30493_length_558_cov_4.801743	250	330	0	40	80	0.5000000
NODE_30493_length_558_cov_4.801743	250	330	2	40	80	0.5000000
NODE_30495_length_558_cov_4.570806	188	244	4	3	56	0.0535714
NODE_30495_length_558_cov_4.570806	188	244	6	18	56	0.3214286
NODE_30495_length_558_cov_4.570806	188	244	8	23	56	0.4107143
NODE_30495_length_558_cov_4.570806	188	244	10	12	56	0.2142857
NODE_30536_length_558_cov_2.259259	236	294	0	20	58	0.3448276
NODE_30536_length_558_cov_2.259259	236	294	2	38	58	0.6551724
NODE_30536_length_558_cov_2.259259	267	347	2	80	80	1.0000000
NODE_30568_length_558_cov_1.544662	403	483	0	80	80	1.0000000
NODE_30568_length_558_cov_1.544662	456	536	0	80	80	1.0000000
NODE_30623_length_557_cov_9.141921	255	335	0	80	80	1.0000000
NODE_30623_length_557_cov_9.141921	308	388	0	80	80	1.0000000
NODE_30626_length_557_cov_7.316594	210	290	0	42	80	0.5250000
NODE_30626_length_557_cov_7.316594	210	290	2	12	80	0.1500000
NODE_30626_length_557_cov_7.316594	210	290	4	1	80	0.0125000
NODE_30626_length_557_cov_7.316594	210	290	5	2	80	0.0250000
NODE_30626_length_557_cov_7.316594	210	290	7	7	80	0.0875000
NODE_30626_length_557_cov_7.316594	210	290	8	16	80	0.2000000
NODE_30626_length_557_cov_7.316594	263	341	0	78	78	1.0000000
NODE_30636_length_557_cov_4.259825	185	267	0	82	82	1.0000000
NODE_30646_length_557_cov_3.794760	131	188	0	57	57	1.0000000
NODE_30646_length_557_cov_3.794760	139	219	0	80	80	1.0000000
NODE_30650_length_557_cov_3.517467	246	325	0	79	79	1.0000000
NODE_30650_length_557_cov_3.517467	298	378	0	80	80	1.0000000
NODE_30652_length_557_cov_3.390830	366	395	34	8	29	0.2758621
NODE_30652_length_557_cov_3.390830	366	395	36	2	29	0.0689655
NODE_30652_length_557_cov_3.390830	366	395	39	1	29	0.0344828
NODE_30652_length_557_cov_3.390830	366	395	40	3	29	0.1034483
NODE_30652_length_557_cov_3.390830	366	395	42	8	29	0.2758621
NODE_30652_length_557_cov_3.390830	366	395	44	7	29	0.2413793
NODE_30792_length_556_cov_37.258206	122	202	0	19	80	0.2375000
NODE_30792_length_556_cov_37.258206	122	202	4	61	80	0.7625000
NODE_30792_length_556_cov_37.258206	175	255	0	72	80	0.9000000
NODE_30792_length_556_cov_37.258206	175	255	4	8	80	0.1000000
NODE_30793_length_556_cov_15.266958	360	440	2	23	80	0.2875000
NODE_30793_length_556_cov_15.266958	360	440	4	57	80	0.7125000
NODE_30793_length_556_cov_15.266958	413	493	0	40	80	0.5000000
NODE_30793_length_556_cov_15.266958	413	493	2	2	80	0.0250000
NODE_30793_length_556_cov_15.266958	413	493	4	38	80	0.4750000
NODE_30794_length_556_cov_12.781182	341	421	2	80	80	1.0000000
NODE_30794_length_556_cov_12.781182	394	474	0	33	80	0.4125000
NODE_30794_length_556_cov_12.781182	394	474	2	47	80	0.5875000
NODE_30795_length_556_cov_11.131291	304	384	0	80	80	1.0000000
NODE_30795_length_556_cov_11.131291	357	437	0	80	80	1.0000000
NODE_30797_length_556_cov_7.168490	163	243	0	80	80	1.0000000
NODE_30797_length_556_cov_7.168490	216	296	0	80	80	1.0000000
NODE_30798_length_556_cov_7.089716	325	379	4	12	54	0.2222222
NODE_30798_length_556_cov_7.089716	325	379	6	2	54	0.0370370
NODE_30798_length_556_cov_7.089716	325	379	8	8	54	0.1481481
NODE_30798_length_556_cov_7.089716	325	379	10	32	54	0.5925926
NODE_30801_length_556_cov_6.505470	232	312	0	15	80	0.1875000
NODE_30801_length_556_cov_6.505470	232	312	2	28	80	0.3500000
NODE_30801_length_556_cov_6.505470	232	312	3	2	80	0.0250000
NODE_30801_length_556_cov_6.505470	232	312	4	35	80	0.4375000
NODE_30801_length_556_cov_6.505470	285	365	2	36	80	0.4500000
NODE_30801_length_556_cov_6.505470	285	365	4	44	80	0.5500000
NODE_30802_length_556_cov_6.496718	140	179	2	39	39	1.0000000
NODE_30802_length_556_cov_6.496718	226	255	0	29	29	1.0000000
NODE_30809_length_556_cov_4.457330	197	277	14	2	80	0.0250000
NODE_30809_length_556_cov_4.457330	197	277	15	10	80	0.1250000
NODE_30809_length_556_cov_4.457330	197	277	16	12	80	0.1500000
NODE_30809_length_556_cov_4.457330	197	277	18	1	80	0.0125000
NODE_30809_length_556_cov_4.457330	197	277	19	26	80	0.3250000
NODE_30809_length_556_cov_4.457330	197	277	20	1	80	0.0125000
NODE_30809_length_556_cov_4.457330	197	277	25	6	80	0.0750000
NODE_30809_length_556_cov_4.457330	197	277	28	1	80	0.0125000
NODE_30809_length_556_cov_4.457330	197	277	29	2	80	0.0250000
NODE_30809_length_556_cov_4.457330	197	277	30	2	80	0.0250000
NODE_30809_length_556_cov_4.457330	197	277	32	17	80	0.2125000
NODE_30818_length_556_cov_3.761488	234	307	0	20	73	0.2739726
NODE_30818_length_556_cov_3.761488	234	307	2	53	73	0.7260274
NODE_30930_length_555_cov_20.949561	322	402	0	80	80	1.0000000
NODE_30930_length_555_cov_20.949561	375	455	0	80	80	1.0000000
NODE_30931_length_555_cov_16.822368	268	348	0	29	80	0.3625000
NODE_30931_length_555_cov_16.822368	268	348	2	51	80	0.6375000
NODE_30931_length_555_cov_16.822368	321	401	0	36	80	0.4500000
NODE_30931_length_555_cov_16.822368	321	401	2	44	80	0.5500000
NODE_30933_length_555_cov_9.912281	313	393	0	80	80	1.0000000
NODE_30935_length_555_cov_8.057018	277	357	2	80	80	1.0000000
NODE_30935_length_555_cov_8.057018	330	410	0	32	80	0.4000000
NODE_30935_length_555_cov_8.057018	330	410	2	48	80	0.6000000
NODE_30938_length_555_cov_6.778509	62	92	0	30	30	1.0000000
NODE_30986_length_555_cov_2.177632	208	288	0	54	80	0.6750000
NODE_30986_length_555_cov_2.177632	208	288	2	26	80	0.3250000
NODE_30986_length_555_cov_2.177632	261	329	0	1	68	0.0147059
NODE_30986_length_555_cov_2.177632	261	329	2	67	68	0.9852941
NODE_31092_length_554_cov_11.942857	118	198	0	80	80	1.0000000
NODE_31092_length_554_cov_11.942857	171	251	0	80	80	1.0000000
NODE_31096_length_554_cov_8.426374	242	322	0	80	80	1.0000000
NODE_31096_length_554_cov_8.426374	295	375	0	80	80	1.0000000
NODE_31101_length_554_cov_6.116484	264	344	0	80	80	1.0000000
NODE_31101_length_554_cov_6.116484	317	393	0	76	76	1.0000000
NODE_31115_length_554_cov_3.586813	207	286	2	40	79	0.5063291
NODE_31115_length_554_cov_3.586813	207	286	4	39	79	0.4936709
NODE_31240_length_553_cov_42.017621	197	277	2	2	80	0.0250000
NODE_31240_length_553_cov_42.017621	197	277	4	17	80	0.2125000
NODE_31240_length_553_cov_42.017621	197	277	6	61	80	0.7625000
NODE_31240_length_553_cov_42.017621	250	330	0	8	80	0.1000000
NODE_31240_length_553_cov_42.017621	250	330	4	62	80	0.7750000
NODE_31240_length_553_cov_42.017621	250	330	6	10	80	0.1250000
NODE_31241_length_553_cov_28.944934	333	413	0	80	80	1.0000000
NODE_31241_length_553_cov_28.944934	386	466	0	80	80	1.0000000
NODE_31242_length_553_cov_12.176211	242	322	0	18	80	0.2250000
NODE_31242_length_553_cov_12.176211	242	322	6	10	80	0.1250000
NODE_31242_length_553_cov_12.176211	242	322	10	11	80	0.1375000
NODE_31242_length_553_cov_12.176211	242	322	12	41	80	0.5125000
NODE_31242_length_553_cov_12.176211	295	375	6	30	80	0.3750000
NODE_31242_length_553_cov_12.176211	295	375	12	50	80	0.6250000
NODE_31244_length_553_cov_9.876652	232	312	0	80	80	1.0000000
NODE_31244_length_553_cov_9.876652	285	365	0	80	80	1.0000000
NODE_31246_length_553_cov_9.306167	207	287	0	80	80	1.0000000
NODE_31246_length_553_cov_9.306167	207	287	0	80	80	1.0000000
NODE_31246_length_553_cov_9.306167	260	340	0	80	80	1.0000000
NODE_31259_length_553_cov_3.729075	36	93	33	1	57	0.0175439
NODE_31259_length_553_cov_3.729075	36	93	35	10	57	0.1754386
NODE_31259_length_553_cov_3.729075	36	93	36	11	57	0.1929825
NODE_31259_length_553_cov_3.729075	36	93	38	1	57	0.0175439
NODE_31259_length_553_cov_3.729075	36	93	48	1	57	0.0175439
NODE_31259_length_553_cov_3.729075	36	93	52	33	57	0.5789474
NODE_31259_length_553_cov_3.729075	89	146	24	1	57	0.0175439
NODE_31259_length_553_cov_3.729075	89	146	26	7	57	0.1228070
NODE_31259_length_553_cov_3.729075	89	146	28	1	57	0.0175439
NODE_31259_length_553_cov_3.729075	89	146	32	5	57	0.0877193
NODE_31259_length_553_cov_3.729075	89	146	41	2	57	0.0350877
NODE_31259_length_553_cov_3.729075	89	146	42	4	57	0.0701754
NODE_31259_length_553_cov_3.729075	89	146	48	5	57	0.0877193
NODE_31259_length_553_cov_3.729075	89	146	50	10	57	0.1754386
NODE_31259_length_553_cov_3.729075	89	146	52	22	57	0.3859649
NODE_31266_length_553_cov_3.310573	226	293	0	67	67	1.0000000
NODE_31279_length_553_cov_2.678414	102	180	0	78	78	1.0000000
NODE_31279_length_553_cov_2.678414	248	275	0	13	27	0.4814815
NODE_31279_length_553_cov_2.678414	248	275	4	14	27	0.5185185
NODE_31295_length_553_cov_1.958150	416	462	14	2	46	0.0434783
NODE_31295_length_553_cov_1.958150	416	462	16	6	46	0.1304348
NODE_31295_length_553_cov_1.958150	416	462	18	2	46	0.0434783
NODE_31295_length_553_cov_1.958150	416	462	20	2	46	0.0434783
NODE_31295_length_553_cov_1.958150	416	462	22	10	46	0.2173913
NODE_31295_length_553_cov_1.958150	416	462	24	2	46	0.0434783
NODE_31295_length_553_cov_1.958150	416	462	25	1	46	0.0217391
NODE_31295_length_553_cov_1.958150	416	462	26	9	46	0.1956522
NODE_31295_length_553_cov_1.958150	416	462	28	12	46	0.2608696
NODE_31295_length_553_cov_1.958150	469	515	20	9	46	0.1956522
NODE_31295_length_553_cov_1.958150	469	515	22	3	46	0.0652174
NODE_31295_length_553_cov_1.958150	469	515	24	9	46	0.1956522
NODE_31295_length_553_cov_1.958150	469	515	26	6	46	0.1304348
NODE_31295_length_553_cov_1.958150	469	515	28	19	46	0.4130435
NODE_31377_length_552_cov_92.070640	298	378	5	1	80	0.0125000
NODE_31377_length_552_cov_92.070640	298	378	7	1	80	0.0125000
NODE_31377_length_552_cov_92.070640	298	378	8	1	80	0.0125000
NODE_31377_length_552_cov_92.070640	298	378	20	1	80	0.0125000
NODE_31377_length_552_cov_92.070640	298	378	21	3	80	0.0375000
NODE_31377_length_552_cov_92.070640	298	378	23	20	80	0.2500000
NODE_31377_length_552_cov_92.070640	298	378	31	5	80	0.0625000
NODE_31377_length_552_cov_92.070640	298	378	33	34	80	0.4250000
NODE_31377_length_552_cov_92.070640	298	378	43	1	80	0.0125000
NODE_31377_length_552_cov_92.070640	298	378	45	7	80	0.0875000
NODE_31377_length_552_cov_92.070640	298	378	49	6	80	0.0750000
NODE_31377_length_552_cov_92.070640	298	378	5	1	80	0.0125000
NODE_31377_length_552_cov_92.070640	298	378	7	1	80	0.0125000
NODE_31377_length_552_cov_92.070640	298	378	8	1	80	0.0125000
NODE_31377_length_552_cov_92.070640	298	378	20	1	80	0.0125000
NODE_31377_length_552_cov_92.070640	298	378	21	3	80	0.0375000
NODE_31377_length_552_cov_92.070640	298	378	23	20	80	0.2500000
NODE_31377_length_552_cov_92.070640	298	378	31	5	80	0.0625000
NODE_31377_length_552_cov_92.070640	298	378	33	34	80	0.4250000
NODE_31377_length_552_cov_92.070640	298	378	43	1	80	0.0125000
NODE_31377_length_552_cov_92.070640	298	378	45	7	80	0.0875000
NODE_31377_length_552_cov_92.070640	298	378	49	6	80	0.0750000
NODE_31377_length_552_cov_92.070640	374	454	14	3	80	0.0375000
NODE_31377_length_552_cov_92.070640	374	454	19	2	80	0.0250000
NODE_31377_length_552_cov_92.070640	374	454	20	1	80	0.0125000
NODE_31377_length_552_cov_92.070640	374	454	22	4	80	0.0500000
NODE_31377_length_552_cov_92.070640	374	454	30	1	80	0.0125000
NODE_31377_length_552_cov_92.070640	374	454	33	1	80	0.0125000
NODE_31377_length_552_cov_92.070640	374	454	34	2	80	0.0250000
NODE_31377_length_552_cov_92.070640	374	454	44	5	80	0.0625000
NODE_31377_length_552_cov_92.070640	374	454	46	12	80	0.1500000
NODE_31377_length_552_cov_92.070640	374	454	48	6	80	0.0750000
NODE_31377_length_552_cov_92.070640	374	454	49	16	80	0.2000000
NODE_31377_length_552_cov_92.070640	374	454	50	9	80	0.1125000
NODE_31377_length_552_cov_92.070640	374	454	54	12	80	0.1500000
NODE_31377_length_552_cov_92.070640	374	454	56	6	80	0.0750000
NODE_31377_length_552_cov_92.070640	374	454	14	3	80	0.0375000
NODE_31377_length_552_cov_92.070640	374	454	19	2	80	0.0250000
NODE_31377_length_552_cov_92.070640	374	454	20	1	80	0.0125000
NODE_31377_length_552_cov_92.070640	374	454	22	4	80	0.0500000
NODE_31377_length_552_cov_92.070640	374	454	30	1	80	0.0125000
NODE_31377_length_552_cov_92.070640	374	454	33	1	80	0.0125000
NODE_31377_length_552_cov_92.070640	374	454	34	2	80	0.0250000
NODE_31377_length_552_cov_92.070640	374	454	44	5	80	0.0625000
NODE_31377_length_552_cov_92.070640	374	454	46	12	80	0.1500000
NODE_31377_length_552_cov_92.070640	374	454	48	6	80	0.0750000
NODE_31377_length_552_cov_92.070640	374	454	49	16	80	0.2000000
NODE_31377_length_552_cov_92.070640	374	454	50	9	80	0.1125000
NODE_31377_length_552_cov_92.070640	374	454	54	12	80	0.1500000
NODE_31377_length_552_cov_92.070640	374	454	56	6	80	0.0750000
NODE_31377_length_552_cov_92.070640	374	454	14	3	80	0.0375000
NODE_31377_length_552_cov_92.070640	374	454	19	2	80	0.0250000
NODE_31377_length_552_cov_92.070640	374	454	20	1	80	0.0125000
NODE_31377_length_552_cov_92.070640	374	454	22	4	80	0.0500000
NODE_31377_length_552_cov_92.070640	374	454	30	1	80	0.0125000
NODE_31377_length_552_cov_92.070640	374	454	33	1	80	0.0125000
NODE_31377_length_552_cov_92.070640	374	454	34	2	80	0.0250000
NODE_31377_length_552_cov_92.070640	374	454	44	5	80	0.0625000
NODE_31377_length_552_cov_92.070640	374	454	46	12	80	0.1500000
NODE_31377_length_552_cov_92.070640	374	454	48	6	80	0.0750000
NODE_31377_length_552_cov_92.070640	374	454	49	16	80	0.2000000
NODE_31377_length_552_cov_92.070640	374	454	50	9	80	0.1125000
NODE_31377_length_552_cov_92.070640	374	454	54	12	80	0.1500000
NODE_31377_length_552_cov_92.070640	374	454	56	6	80	0.0750000
NODE_31377_length_552_cov_92.070640	374	454	14	3	80	0.0375000
NODE_31377_length_552_cov_92.070640	374	454	19	2	80	0.0250000
NODE_31377_length_552_cov_92.070640	374	454	20	1	80	0.0125000
NODE_31377_length_552_cov_92.070640	374	454	22	4	80	0.0500000
NODE_31377_length_552_cov_92.070640	374	454	30	1	80	0.0125000
NODE_31377_length_552_cov_92.070640	374	454	33	1	80	0.0125000
NODE_31377_length_552_cov_92.070640	374	454	34	2	80	0.0250000
NODE_31377_length_552_cov_92.070640	374	454	44	5	80	0.0625000
NODE_31377_length_552_cov_92.070640	374	454	46	12	80	0.1500000
NODE_31377_length_552_cov_92.070640	374	454	48	6	80	0.0750000
NODE_31377_length_552_cov_92.070640	374	454	49	16	80	0.2000000
NODE_31377_length_552_cov_92.070640	374	454	50	9	80	0.1125000
NODE_31377_length_552_cov_92.070640	374	454	54	12	80	0.1500000
NODE_31377_length_552_cov_92.070640	374	454	56	6	80	0.0750000
NODE_31377_length_552_cov_92.070640	374	450	19	1	76	0.0131579
NODE_31377_length_552_cov_92.070640	374	450	20	1	76	0.0131579
NODE_31377_length_552_cov_92.070640	374	450	22	4	76	0.0526316
NODE_31377_length_552_cov_92.070640	374	450	30	1	76	0.0131579
NODE_31377_length_552_cov_92.070640	374	450	33	1	76	0.0131579
NODE_31377_length_552_cov_92.070640	374	450	34	2	76	0.0263158
NODE_31377_length_552_cov_92.070640	374	450	44	5	76	0.0657895
NODE_31377_length_552_cov_92.070640	374	450	46	12	76	0.1578947
NODE_31377_length_552_cov_92.070640	374	450	48	6	76	0.0789474
NODE_31377_length_552_cov_92.070640	374	450	49	16	76	0.2105263
NODE_31377_length_552_cov_92.070640	374	450	50	9	76	0.1184211
NODE_31377_length_552_cov_92.070640	374	450	54	12	76	0.1578947
NODE_31377_length_552_cov_92.070640	374	450	56	6	76	0.0789474
NODE_31377_length_552_cov_92.070640	427	507	10	7	80	0.0875000
NODE_31377_length_552_cov_92.070640	427	507	11	38	80	0.4750000
NODE_31377_length_552_cov_92.070640	427	507	14	11	80	0.1375000
NODE_31377_length_552_cov_92.070640	427	507	19	2	80	0.0250000
NODE_31377_length_552_cov_92.070640	427	507	20	1	80	0.0125000
NODE_31377_length_552_cov_92.070640	427	507	22	4	80	0.0500000
NODE_31377_length_552_cov_92.070640	427	507	30	1	80	0.0125000
NODE_31377_length_552_cov_92.070640	427	507	33	1	80	0.0125000
NODE_31377_length_552_cov_92.070640	427	507	34	2	80	0.0250000
NODE_31377_length_552_cov_92.070640	427	507	44	5	80	0.0625000
NODE_31377_length_552_cov_92.070640	427	507	46	8	80	0.1000000
NODE_31377_length_552_cov_92.070640	427	507	10	7	80	0.0875000
NODE_31377_length_552_cov_92.070640	427	507	11	38	80	0.4750000
NODE_31377_length_552_cov_92.070640	427	507	14	11	80	0.1375000
NODE_31377_length_552_cov_92.070640	427	507	19	2	80	0.0250000
NODE_31377_length_552_cov_92.070640	427	507	20	1	80	0.0125000
NODE_31377_length_552_cov_92.070640	427	507	22	4	80	0.0500000
NODE_31377_length_552_cov_92.070640	427	507	30	1	80	0.0125000
NODE_31377_length_552_cov_92.070640	427	507	33	1	80	0.0125000
NODE_31377_length_552_cov_92.070640	427	507	34	2	80	0.0250000
NODE_31377_length_552_cov_92.070640	427	507	44	5	80	0.0625000
NODE_31377_length_552_cov_92.070640	427	507	46	8	80	0.1000000
NODE_31377_length_552_cov_92.070640	427	498	10	7	71	0.0985916
NODE_31377_length_552_cov_92.070640	427	498	11	29	71	0.4084507
NODE_31377_length_552_cov_92.070640	427	498	14	11	71	0.1549296
NODE_31377_length_552_cov_92.070640	427	498	19	2	71	0.0281690
NODE_31377_length_552_cov_92.070640	427	498	20	1	71	0.0140845
NODE_31377_length_552_cov_92.070640	427	498	22	4	71	0.0563380
NODE_31377_length_552_cov_92.070640	427	498	30	1	71	0.0140845
NODE_31377_length_552_cov_92.070640	427	498	33	1	71	0.0140845
NODE_31377_length_552_cov_92.070640	427	498	34	2	71	0.0281690
NODE_31377_length_552_cov_92.070640	427	498	44	5	71	0.0704225
NODE_31377_length_552_cov_92.070640	427	498	46	8	71	0.1126761
NODE_31377_length_552_cov_92.070640	430	500	10	7	70	0.1000000
NODE_31377_length_552_cov_92.070640	430	500	11	31	70	0.4428571
NODE_31377_length_552_cov_92.070640	430	500	14	11	70	0.1571429
NODE_31377_length_552_cov_92.070640	430	500	19	2	70	0.0285714
NODE_31377_length_552_cov_92.070640	430	500	20	1	70	0.0142857
NODE_31377_length_552_cov_92.070640	430	500	22	4	70	0.0571429
NODE_31377_length_552_cov_92.070640	430	500	30	1	70	0.0142857
NODE_31377_length_552_cov_92.070640	430	500	33	1	70	0.0142857
NODE_31377_length_552_cov_92.070640	430	500	34	2	70	0.0285714
NODE_31377_length_552_cov_92.070640	430	500	44	5	70	0.0714286
NODE_31377_length_552_cov_92.070640	430	500	46	5	70	0.0714286
NODE_31377_length_552_cov_92.070640	432	507	10	7	75	0.0933333
NODE_31377_length_552_cov_92.070640	432	507	11	38	75	0.5066667
NODE_31377_length_552_cov_92.070640	432	507	14	11	75	0.1466667
NODE_31377_length_552_cov_92.070640	432	507	19	2	75	0.0266667
NODE_31377_length_552_cov_92.070640	432	507	20	1	75	0.0133333
NODE_31377_length_552_cov_92.070640	432	507	22	4	75	0.0533333
NODE_31377_length_552_cov_92.070640	432	507	30	1	75	0.0133333
NODE_31377_length_552_cov_92.070640	432	507	33	1	75	0.0133333
NODE_31377_length_552_cov_92.070640	432	507	34	2	75	0.0266667
NODE_31377_length_552_cov_92.070640	432	507	44	5	75	0.0666667
NODE_31377_length_552_cov_92.070640	432	507	46	3	75	0.0400000
NODE_31378_length_552_cov_20.432671	151	231	0	80	80	1.0000000
NODE_31378_length_552_cov_20.432671	204	284	0	80	80	1.0000000
NODE_31379_length_552_cov_18.075055	257	333	0	76	76	1.0000000
NODE_31380_length_552_cov_13.331126	214	294	0	32	80	0.4000000
NODE_31380_length_552_cov_13.331126	214	294	2	48	80	0.6000000
NODE_31380_length_552_cov_13.331126	267	347	2	80	80	1.0000000
NODE_31381_length_552_cov_12.774834	360	440	0	80	80	1.0000000
NODE_31381_length_552_cov_12.774834	413	493	0	59	80	0.7375000
NODE_31381_length_552_cov_12.774834	413	493	2	21	80	0.2625000
NODE_31384_length_552_cov_8.883002	310	390	0	80	80	1.0000000
NODE_31384_length_552_cov_8.883002	363	443	0	80	80	1.0000000
NODE_31385_length_552_cov_6.916115	206	281	0	41	75	0.5466667
NODE_31385_length_552_cov_6.916115	206	281	2	23	75	0.3066667
NODE_31385_length_552_cov_6.916115	206	281	4	11	75	0.1466667
NODE_31538_length_551_cov_34.070796	324	406	0	82	82	1.0000000
NODE_31538_length_551_cov_34.070796	379	444	0	65	65	1.0000000
NODE_31541_length_551_cov_10.252212	164	244	0	51	80	0.6375000
NODE_31541_length_551_cov_10.252212	164	244	2	29	80	0.3625000
NODE_31541_length_551_cov_10.252212	217	297	2	80	80	1.0000000
NODE_31543_length_551_cov_8.075221	363	406	0	43	43	1.0000000
NODE_31547_length_551_cov_5.668142	213	293	2	7	80	0.0875000
NODE_31547_length_551_cov_5.668142	213	293	4	5	80	0.0625000
NODE_31547_length_551_cov_5.668142	213	293	6	29	80	0.3625000
NODE_31547_length_551_cov_5.668142	213	293	8	39	80	0.4875000
NODE_31547_length_551_cov_5.668142	266	346	0	8	80	0.1000000
NODE_31547_length_551_cov_5.668142	266	346	2	14	80	0.1750000
NODE_31547_length_551_cov_5.668142	266	346	5	1	80	0.0125000
NODE_31547_length_551_cov_5.668142	266	346	6	57	80	0.7125000
NODE_31552_length_551_cov_4.212389	171	242	2	10	71	0.1408451
NODE_31552_length_551_cov_4.212389	171	242	6	15	71	0.2112676
NODE_31552_length_551_cov_4.212389	171	242	8	1	71	0.0140845
NODE_31552_length_551_cov_4.212389	171	242	10	19	71	0.2676056
NODE_31552_length_551_cov_4.212389	171	242	12	26	71	0.3661972
NODE_31552_length_551_cov_4.212389	215	263	2	31	48	0.6458333
NODE_31552_length_551_cov_4.212389	215	263	6	15	48	0.3125000
NODE_31552_length_551_cov_4.212389	215	263	8	1	48	0.0208333
NODE_31552_length_551_cov_4.212389	215	263	12	1	48	0.0208333
NODE_31563_length_551_cov_3.307522	227	307	0	80	80	1.0000000
NODE_31563_length_551_cov_3.307522	280	360	0	80	80	1.0000000
NODE_31693_length_550_cov_17.308204	101	181	4	7	80	0.0875000
NODE_31693_length_550_cov_17.308204	101	181	14	73	80	0.9125000
NODE_31693_length_550_cov_17.308204	154	234	10	16	80	0.2000000
NODE_31693_length_550_cov_17.308204	154	234	14	64	80	0.8000000
NODE_31700_length_550_cov_5.580931	286	329	0	43	43	1.0000000
NODE_31701_length_550_cov_5.490022	458	500	0	1	42	0.0238095
NODE_31701_length_550_cov_5.490022	458	500	4	41	42	0.9761904
NODE_31701_length_550_cov_5.490022	459	523	4	64	64	1.0000000
NODE_31703_length_550_cov_5.243902	194	274	0	80	80	1.0000000
NODE_31703_length_550_cov_5.243902	247	327	0	80	80	1.0000000
NODE_31706_length_550_cov_4.815965	184	264	0	80	80	1.0000000
NODE_31726_length_550_cov_3.252772	308	388	6	7	80	0.0875000
NODE_31726_length_550_cov_3.252772	308	388	12	4	80	0.0500000
NODE_31726_length_550_cov_3.252772	308	388	14	13	80	0.1625000
NODE_31726_length_550_cov_3.252772	308	388	16	5	80	0.0625000
NODE_31726_length_550_cov_3.252772	308	388	18	12	80	0.1500000
NODE_31726_length_550_cov_3.252772	308	388	20	39	80	0.4875000
NODE_31756_length_550_cov_1.864745	189	259	0	70	70	1.0000000
NODE_31756_length_550_cov_1.864745	189	258	0	69	69	1.0000000
NODE_31847_length_549_cov_31.826667	216	292	10	7	76	0.0921053
NODE_31847_length_549_cov_31.826667	216	292	12	3	76	0.0394737
NODE_31847_length_549_cov_31.826667	216	292	16	13	76	0.1710526
NODE_31847_length_549_cov_31.826667	216	292	18	46	76	0.6052632
NODE_31847_length_549_cov_31.826667	216	292	20	7	76	0.0921053
NODE_31847_length_549_cov_31.826667	267	331	10	1	64	0.0156250
NODE_31847_length_549_cov_31.826667	267	331	12	4	64	0.0625000
NODE_31847_length_549_cov_31.826667	267	331	13	1	64	0.0156250
NODE_31847_length_549_cov_31.826667	267	331	14	3	64	0.0468750
NODE_31847_length_549_cov_31.826667	267	331	16	1	64	0.0156250
NODE_31847_length_549_cov_31.826667	267	331	18	46	64	0.7187500
NODE_31847_length_549_cov_31.826667	267	331	19	1	64	0.0156250
NODE_31847_length_549_cov_31.826667	267	331	20	7	64	0.1093750
NODE_31848_length_549_cov_14.124444	174	263	0	89	89	1.0000000
NODE_31848_length_549_cov_14.124444	242	315	0	73	73	1.0000000
NODE_31857_length_549_cov_5.375556	181	257	170	2	76	0.0263158
NODE_31857_length_549_cov_5.375556	181	257	177	1	76	0.0131579
NODE_31857_length_549_cov_5.375556	181	257	178	1	76	0.0131579
NODE_31857_length_549_cov_5.375556	181	257	180	2	76	0.0263158
NODE_31857_length_549_cov_5.375556	181	257	182	2	76	0.0263158
NODE_31857_length_549_cov_5.375556	181	257	184	2	76	0.0263158
NODE_31857_length_549_cov_5.375556	181	257	187	1	76	0.0131579
NODE_31857_length_549_cov_5.375556	181	257	190	1	76	0.0131579
NODE_31857_length_549_cov_5.375556	181	257	191	1	76	0.0131579
NODE_31857_length_549_cov_5.375556	181	257	193	1	76	0.0131579
NODE_31857_length_549_cov_5.375556	181	257	196	1	76	0.0131579
NODE_31857_length_549_cov_5.375556	181	257	198	1	76	0.0131579
NODE_31857_length_549_cov_5.375556	181	257	201	1	76	0.0131579
NODE_31857_length_549_cov_5.375556	181	257	203	1	76	0.0131579
NODE_31857_length_549_cov_5.375556	181	257	204	1	76	0.0131579
NODE_31857_length_549_cov_5.375556	181	257	211	1	76	0.0131579
NODE_31857_length_549_cov_5.375556	181	257	212	1	76	0.0131579
NODE_31857_length_549_cov_5.375556	181	257	213	4	76	0.0526316
NODE_31857_length_549_cov_5.375556	181	257	215	3	76	0.0394737
NODE_31857_length_549_cov_5.375556	181	257	216	1	76	0.0131579
NODE_31857_length_549_cov_5.375556	181	257	219	2	76	0.0263158
NODE_31857_length_549_cov_5.375556	181	257	222	2	76	0.0263158
NODE_31857_length_549_cov_5.375556	181	257	224	1	76	0.0131579
NODE_31857_length_549_cov_5.375556	181	257	230	1	76	0.0131579
NODE_31857_length_549_cov_5.375556	181	257	239	1	76	0.0131579
NODE_31857_length_549_cov_5.375556	181	257	241	1	76	0.0131579
NODE_31857_length_549_cov_5.375556	181	257	248	1	76	0.0131579
NODE_31857_length_549_cov_5.375556	181	257	249	2	76	0.0263158
NODE_31857_length_549_cov_5.375556	181	257	250	1	76	0.0131579
NODE_31857_length_549_cov_5.375556	181	257	251	1	76	0.0131579
NODE_31857_length_549_cov_5.375556	181	257	252	1	76	0.0131579
NODE_31857_length_549_cov_5.375556	181	257	254	2	76	0.0263158
NODE_31857_length_549_cov_5.375556	181	257	255	2	76	0.0263158
NODE_31857_length_549_cov_5.375556	181	257	257	1	76	0.0131579
NODE_31857_length_549_cov_5.375556	181	257	258	1	76	0.0131579
NODE_31857_length_549_cov_5.375556	181	257	259	2	76	0.0263158
NODE_31857_length_549_cov_5.375556	181	257	260	1	76	0.0131579
NODE_31857_length_549_cov_5.375556	181	257	263	3	76	0.0394737
NODE_31857_length_549_cov_5.375556	181	257	264	1	76	0.0131579
NODE_31857_length_549_cov_5.375556	181	257	265	2	76	0.0263158
NODE_31857_length_549_cov_5.375556	181	257	266	1	76	0.0131579
NODE_31857_length_549_cov_5.375556	181	257	267	3	76	0.0394737
NODE_31857_length_549_cov_5.375556	181	257	268	1	76	0.0131579
NODE_31857_length_549_cov_5.375556	181	257	269	5	76	0.0657895
NODE_31857_length_549_cov_5.375556	181	257	270	2	76	0.0263158
NODE_31857_length_549_cov_5.375556	181	257	271	3	76	0.0394737
NODE_31857_length_549_cov_5.375556	181	257	272	2	76	0.0263158
NODE_31857_length_549_cov_5.375556	181	257	273	1	76	0.0131579
NODE_31859_length_549_cov_4.933333	260	340	2	5	80	0.0625000
NODE_31859_length_549_cov_4.933333	260	340	6	23	80	0.2875000
NODE_31859_length_549_cov_4.933333	260	340	8	52	80	0.6500000
NODE_31864_length_549_cov_4.537778	345	430	0	85	85	1.0000000
NODE_31864_length_549_cov_4.537778	403	483	0	80	80	1.0000000
NODE_31865_length_549_cov_4.124444	406	486	4	25	80	0.3125000
NODE_31865_length_549_cov_4.124444	406	486	6	15	80	0.1875000
NODE_31865_length_549_cov_4.124444	406	486	8	8	80	0.1000000
NODE_31865_length_549_cov_4.124444	406	486	10	32	80	0.4000000
NODE_31866_length_549_cov_3.931111	182	219	0	37	37	1.0000000
NODE_31868_length_549_cov_3.893333	287	367	0	80	80	1.0000000
NODE_31868_length_549_cov_3.893333	340	420	0	80	80	1.0000000
NODE_31887_length_549_cov_2.673333	282	343	2	27	61	0.4426230
NODE_31887_length_549_cov_2.673333	282	343	8	21	61	0.3442623
NODE_31887_length_549_cov_2.673333	282	343	10	13	61	0.2131148
NODE_31890_length_549_cov_2.622222	144	220	0	1	76	0.0131579
NODE_31890_length_549_cov_2.622222	144	220	2	75	76	0.9868421
NODE_32013_length_548_cov_13.962138	285	371	4	68	86	0.7906977
NODE_32013_length_548_cov_13.962138	285	371	6	18	86	0.2093023
NODE_32013_length_548_cov_13.962138	344	424	0	7	80	0.0875000
NODE_32013_length_548_cov_13.962138	344	424	2	7	80	0.0875000
NODE_32013_length_548_cov_13.962138	344	424	4	9	80	0.1125000
NODE_32013_length_548_cov_13.962138	344	424	5	1	80	0.0125000
NODE_32013_length_548_cov_13.962138	344	424	6	56	80	0.7000000
NODE_32022_length_548_cov_4.683742	261	336	2	29	75	0.3866667
NODE_32022_length_548_cov_4.683742	261	336	3	46	75	0.6133333
NODE_32023_length_548_cov_4.670379	140	182	0	22	42	0.5238096
NODE_32023_length_548_cov_4.670379	140	182	2	20	42	0.4761905
NODE_32023_length_548_cov_4.670379	282	311	0	29	29	1.0000000
NODE_32023_length_548_cov_4.670379	410	455	7	24	45	0.5333334
NODE_32023_length_548_cov_4.670379	410	455	9	21	45	0.4666667
NODE_32029_length_548_cov_3.630290	111	177	0	26	66	0.3939394
NODE_32029_length_548_cov_3.630290	111	177	1	6	66	0.0909091
NODE_32029_length_548_cov_3.630290	111	177	5	13	66	0.1969697
NODE_32029_length_548_cov_3.630290	111	177	6	11	66	0.1666667
NODE_32029_length_548_cov_3.630290	111	177	10	10	66	0.1515152
NODE_32039_length_548_cov_3.080178	142	191	0	49	49	1.0000000
NODE_32180_length_547_cov_23.982143	243	323	14	3	80	0.0375000
NODE_32180_length_547_cov_23.982143	243	323	16	16	80	0.2000000
NODE_32180_length_547_cov_23.982143	243	323	18	5	80	0.0625000
NODE_32180_length_547_cov_23.982143	243	323	21	43	80	0.5375000
NODE_32180_length_547_cov_23.982143	243	323	23	13	80	0.1625000
NODE_32180_length_547_cov_23.982143	243	323	14	3	80	0.0375000
NODE_32180_length_547_cov_23.982143	243	323	16	16	80	0.2000000
NODE_32180_length_547_cov_23.982143	243	323	18	5	80	0.0625000
NODE_32180_length_547_cov_23.982143	243	323	21	43	80	0.5375000
NODE_32180_length_547_cov_23.982143	243	323	23	13	80	0.1625000
NODE_32180_length_547_cov_23.982143	252	323	16	10	71	0.1408451
NODE_32180_length_547_cov_23.982143	252	323	18	5	71	0.0704225
NODE_32180_length_547_cov_23.982143	252	323	21	43	71	0.6056338
NODE_32180_length_547_cov_23.982143	252	323	23	13	71	0.1830986
NODE_32181_length_547_cov_23.555804	42	122	0	80	80	1.0000000
NODE_32181_length_547_cov_23.555804	95	175	0	80	80	1.0000000
NODE_32183_length_547_cov_12.819196	190	270	0	6	80	0.0750000
NODE_32183_length_547_cov_12.819196	190	270	2	16	80	0.2000000
NODE_32183_length_547_cov_12.819196	190	270	6	11	80	0.1375000
NODE_32183_length_547_cov_12.819196	190	270	7	16	80	0.2000000
NODE_32183_length_547_cov_12.819196	190	270	8	31	80	0.3875000
NODE_32195_length_547_cov_5.207589	290	370	0	27	80	0.3375000
NODE_32195_length_547_cov_5.207589	290	370	2	32	80	0.4000000
NODE_32195_length_547_cov_5.207589	290	370	4	13	80	0.1625000
NODE_32195_length_547_cov_5.207589	290	370	8	8	80	0.1000000
NODE_32195_length_547_cov_5.207589	343	423	2	6	80	0.0750000
NODE_32195_length_547_cov_5.207589	343	423	4	13	80	0.1625000
NODE_32195_length_547_cov_5.207589	343	423	8	15	80	0.1875000
NODE_32195_length_547_cov_5.207589	343	423	10	18	80	0.2250000
NODE_32195_length_547_cov_5.207589	343	423	14	7	80	0.0875000
NODE_32195_length_547_cov_5.207589	343	423	16	21	80	0.2625000
NODE_32197_length_547_cov_4.975446	411	488	0	46	77	0.5974026
NODE_32197_length_547_cov_4.975446	411	488	2	31	77	0.4025974
NODE_32197_length_547_cov_4.975446	461	542	2	81	81	1.0000000
NODE_32199_length_547_cov_4.683036	451	492	2	41	41	1.0000000
NODE_32204_length_547_cov_4.138393	97	175	2	49	78	0.6282051
NODE_32204_length_547_cov_4.138393	97	175	4	29	78	0.3717949
NODE_32204_length_547_cov_4.138393	151	228	2	17	77	0.2207792
NODE_32204_length_547_cov_4.138393	151	228	4	38	77	0.4935065
NODE_32204_length_547_cov_4.138393	151	228	6	22	77	0.2857143
NODE_32206_length_547_cov_4.026786	136	216	0	80	80	1.0000000
NODE_32206_length_547_cov_4.026786	189	269	0	80	80	1.0000000
NODE_32215_length_547_cov_3.468750	219	299	0	80	80	1.0000000
NODE_32222_length_547_cov_2.901786	304	384	0	80	80	1.0000000
NODE_32347_length_546_cov_17.733781	159	239	0	80	80	1.0000000
NODE_32347_length_546_cov_17.733781	212	293	0	81	81	1.0000000
NODE_32348_length_546_cov_16.275168	272	352	0	80	80	1.0000000
NODE_32348_length_546_cov_16.275168	325	405	0	80	80	1.0000000
NODE_32349_length_546_cov_8.201342	179	259	3	11	80	0.1375000
NODE_32349_length_546_cov_8.201342	179	259	9	2	80	0.0250000
NODE_32349_length_546_cov_8.201342	179	259	10	6	80	0.0750000
NODE_32349_length_546_cov_8.201342	179	259	12	2	80	0.0250000
NODE_32349_length_546_cov_8.201342	179	259	14	59	80	0.7375000
NODE_32351_length_546_cov_7.454139	241	321	0	80	80	1.0000000
NODE_32351_length_546_cov_7.454139	294	374	0	80	80	1.0000000
NODE_32380_length_546_cov_3.192394	171	251	0	80	80	1.0000000
NODE_32510_length_545_cov_31.524664	38	118	0	48	80	0.6000000
NODE_32510_length_545_cov_31.524664	38	118	4	1	80	0.0125000
NODE_32510_length_545_cov_31.524664	38	118	8	9	80	0.1125000
NODE_32510_length_545_cov_31.524664	38	118	12	6	80	0.0750000
NODE_32510_length_545_cov_31.524664	38	118	18	16	80	0.2000000
NODE_32510_length_545_cov_31.524664	91	171	8	5	80	0.0625000
NODE_32510_length_545_cov_31.524664	91	171	12	6	80	0.0750000
NODE_32510_length_545_cov_31.524664	91	171	18	69	80	0.8625000
NODE_32517_length_545_cov_5.524664	268	348	1	80	80	1.0000000
NODE_32525_length_545_cov_3.885650	137	217	2	39	80	0.4875000
NODE_32525_length_545_cov_3.885650	137	217	3	1	80	0.0125000
NODE_32525_length_545_cov_3.885650	137	217	4	1	80	0.0125000
NODE_32525_length_545_cov_3.885650	137	217	6	5	80	0.0625000
NODE_32525_length_545_cov_3.885650	137	217	8	33	80	0.4125000
NODE_32525_length_545_cov_3.885650	137	217	16	1	80	0.0125000
NODE_32571_length_545_cov_2.013453	246	318	0	72	72	1.0000000
NODE_32599_length_545_cov_1.450673	130	179	0	34	49	0.6938776
NODE_32599_length_545_cov_1.450673	130	179	1	2	49	0.0408163
NODE_32599_length_545_cov_1.450673	130	179	2	13	49	0.2653061
NODE_32616_length_545_cov_1.179372	431	469	0	38	38	1.0000000
NODE_32673_length_544_cov_37.705618	258	338	0	80	80	1.0000000
NODE_32673_length_544_cov_37.705618	311	391	0	80	80	1.0000000
NODE_32674_length_544_cov_33.847191	189	269	3	8	80	0.1000000
NODE_32674_length_544_cov_33.847191	189	269	6	3	80	0.0375000
NODE_32674_length_544_cov_33.847191	189	269	7	69	80	0.8625000
NODE_32674_length_544_cov_33.847191	242	327	0	43	85	0.5058824
NODE_32674_length_544_cov_33.847191	242	327	1	13	85	0.1529412
NODE_32674_length_544_cov_33.847191	242	327	2	1	85	0.0117647
NODE_32674_length_544_cov_33.847191	242	327	3	9	85	0.1058824
NODE_32674_length_544_cov_33.847191	242	327	6	3	85	0.0352941
NODE_32674_length_544_cov_33.847191	242	327	7	16	85	0.1882353
NODE_32675_length_544_cov_19.467416	251	331	0	80	80	1.0000000
NODE_32675_length_544_cov_19.467416	304	384	0	80	80	1.0000000
NODE_32676_length_544_cov_16.775281	163	243	0	6	80	0.0750000
NODE_32676_length_544_cov_16.775281	163	243	2	74	80	0.9250000
NODE_32676_length_544_cov_16.775281	216	296	0	40	80	0.5000000
NODE_32676_length_544_cov_16.775281	216	296	2	40	80	0.5000000
NODE_32677_length_544_cov_8.943820	81	161	0	80	80	1.0000000
NODE_32677_length_544_cov_8.943820	134	214	0	80	80	1.0000000
NODE_32678_length_544_cov_8.537079	283	363	0	80	80	1.0000000
NODE_32678_length_544_cov_8.537079	336	416	0	80	80	1.0000000
NODE_32680_length_544_cov_8.440449	209	289	6	80	80	1.0000000
NODE_32680_length_544_cov_8.440449	262	342	0	2	80	0.0250000
NODE_32680_length_544_cov_8.440449	262	342	6	78	80	0.9750000
NODE_32681_length_544_cov_7.604494	332	412	0	41	80	0.5125000
NODE_32681_length_544_cov_7.604494	332	412	2	39	80	0.4875000
NODE_32681_length_544_cov_7.604494	385	465	0	80	80	1.0000000
NODE_32684_length_544_cov_6.000000	461	513	2	17	52	0.3269231
NODE_32684_length_544_cov_6.000000	461	513	4	7	52	0.1346154
NODE_32684_length_544_cov_6.000000	461	513	8	1	52	0.0192308
NODE_32684_length_544_cov_6.000000	461	513	10	2	52	0.0384615
NODE_32684_length_544_cov_6.000000	461	513	12	3	52	0.0576923
NODE_32684_length_544_cov_6.000000	461	513	16	19	52	0.3653846
NODE_32684_length_544_cov_6.000000	461	513	19	2	52	0.0384615
NODE_32684_length_544_cov_6.000000	461	513	21	1	52	0.0192308
NODE_32830_length_543_cov_38.790541	116	196	0	80	80	1.0000000
NODE_32830_length_543_cov_38.790541	169	249	0	80	80	1.0000000
NODE_32831_length_543_cov_31.713964	193	273	0	80	80	1.0000000
NODE_32831_length_543_cov_31.713964	246	326	0	80	80	1.0000000
NODE_32832_length_543_cov_13.689189	118	198	0	80	80	1.0000000
NODE_32832_length_543_cov_13.689189	171	251	0	80	80	1.0000000
NODE_32833_length_543_cov_10.601351	271	351	0	5	80	0.0625000
NODE_32833_length_543_cov_10.601351	271	351	2	75	80	0.9375000
NODE_32833_length_543_cov_10.601351	324	404	0	58	80	0.7250000
NODE_32833_length_543_cov_10.601351	324	404	2	22	80	0.2750000
NODE_32833_length_543_cov_10.601351	400	480	0	80	80	1.0000000
NODE_32833_length_543_cov_10.601351	453	533	0	80	80	1.0000000
NODE_32834_length_543_cov_9.202703	291	341	15	4	50	0.0800000
NODE_32834_length_543_cov_9.202703	291	341	19	14	50	0.2800000
NODE_32834_length_543_cov_9.202703	291	341	20	25	50	0.5000000
NODE_32834_length_543_cov_9.202703	291	341	21	7	50	0.1400000
NODE_32834_length_543_cov_9.202703	347	384	14	4	37	0.1081081
NODE_32834_length_543_cov_9.202703	347	384	15	16	37	0.4324324
NODE_32834_length_543_cov_9.202703	347	384	16	7	37	0.1891892
NODE_32834_length_543_cov_9.202703	347	384	20	10	37	0.2702703
NODE_32835_length_543_cov_7.722973	300	378	0	41	78	0.5256410
NODE_32835_length_543_cov_7.722973	300	378	2	37	78	0.4743590
NODE_32835_length_543_cov_7.722973	351	431	2	80	80	1.0000000
NODE_32836_length_543_cov_6.815315	181	260	0	79	79	1.0000000
NODE_32845_length_543_cov_4.704955	145	225	0	80	80	1.0000000
NODE_32845_length_543_cov_4.704955	198	275	0	77	77	1.0000000
NODE_32864_length_543_cov_3.301802	247	312	0	65	65	1.0000000
NODE_32875_length_543_cov_2.635135	253	316	6	2	63	0.0317460
NODE_32875_length_543_cov_2.635135	253	316	8	55	63	0.8730159
NODE_32875_length_543_cov_2.635135	253	316	10	6	63	0.0952381
NODE_32875_length_543_cov_2.635135	293	373	4	9	80	0.1125000
NODE_32875_length_543_cov_2.635135	293	373	6	2	80	0.0250000
NODE_32875_length_543_cov_2.635135	293	373	8	55	80	0.6875000
NODE_32875_length_543_cov_2.635135	293	373	9	1	80	0.0125000
NODE_32875_length_543_cov_2.635135	293	373	10	13	80	0.1625000
NODE_33002_length_543_cov_0.682432	98	178	0	20	80	0.2500000
NODE_33002_length_543_cov_0.682432	98	178	2	3	80	0.0375000
NODE_33002_length_543_cov_0.682432	98	178	4	34	80	0.4250000
NODE_33002_length_543_cov_0.682432	98	178	6	23	80	0.2875000
NODE_33012_length_542_cov_57.370203	287	367	0	80	80	1.0000000
NODE_33012_length_542_cov_57.370203	340	378	0	38	38	1.0000000
NODE_33014_length_542_cov_11.616253	277	357	0	80	80	1.0000000
NODE_33014_length_542_cov_11.616253	330	410	0	80	80	1.0000000
NODE_33015_length_542_cov_9.988713	253	333	0	37	80	0.4625000
NODE_33015_length_542_cov_9.988713	253	333	2	43	80	0.5375000
NODE_33015_length_542_cov_9.988713	306	386	0	80	80	1.0000000
NODE_33018_length_542_cov_7.934537	215	295	6	25	80	0.3125000
NODE_33018_length_542_cov_7.934537	215	295	8	7	80	0.0875000
NODE_33018_length_542_cov_7.934537	215	295	12	48	80	0.6000000
NODE_33018_length_542_cov_7.934537	268	348	4	16	80	0.2000000
NODE_33018_length_542_cov_7.934537	268	348	9	7	80	0.0875000
NODE_33018_length_542_cov_7.934537	268	348	12	57	80	0.7125000
NODE_33020_length_542_cov_7.266366	159	239	0	80	80	1.0000000
NODE_33021_length_542_cov_7.069977	230	304	0	74	74	1.0000000
NODE_33021_length_542_cov_7.069977	284	362	0	78	78	1.0000000
NODE_33025_length_542_cov_4.783296	237	267	0	30	30	1.0000000
NODE_33035_length_542_cov_3.882619	275	303	0	28	28	1.0000000
NODE_33040_length_542_cov_3.600451	82	131	0	42	49	0.8571429
NODE_33040_length_542_cov_3.600451	82	131	2	7	49	0.1428571
NODE_33188_length_541_cov_22.463801	247	327	0	80	80	1.0000000
NODE_33188_length_541_cov_22.463801	300	380	0	80	80	1.0000000
NODE_33190_length_541_cov_11.070136	60	140	0	80	80	1.0000000
NODE_33190_length_541_cov_11.070136	113	193	0	80	80	1.0000000
NODE_33204_length_541_cov_3.690045	179	250	0	71	71	1.0000000
NODE_33300_length_541_cov_1.187783	352	400	0	48	48	1.0000000
NODE_33359_length_540_cov_78.353741	219	299	2	80	80	1.0000000
NODE_33359_length_540_cov_78.353741	272	352	0	40	80	0.5000000
NODE_33359_length_540_cov_78.353741	272	352	2	40	80	0.5000000
NODE_33360_length_540_cov_33.473923	59	139	0	31	80	0.3875000
NODE_33360_length_540_cov_33.473923	59	139	2	49	80	0.6125000
NODE_33360_length_540_cov_33.473923	112	192	0	37	80	0.4625000
NODE_33360_length_540_cov_33.473923	112	192	2	43	80	0.5375000
NODE_33361_length_540_cov_20.380952	97	177	0	32	80	0.4000000
NODE_33361_length_540_cov_20.380952	97	177	2	48	80	0.6000000
NODE_33361_length_540_cov_20.380952	150	230	0	14	80	0.1750000
NODE_33361_length_540_cov_20.380952	150	230	2	66	80	0.8250000
NODE_33362_length_540_cov_12.657596	248	328	0	80	80	1.0000000
NODE_33362_length_540_cov_12.657596	301	381	0	80	80	1.0000000
NODE_33363_length_540_cov_11.111111	180	260	0	80	80	1.0000000
NODE_33363_length_540_cov_11.111111	233	313	0	80	80	1.0000000
NODE_33365_length_540_cov_6.328798	260	340	0	34	80	0.4250000
NODE_33365_length_540_cov_6.328798	260	340	2	46	80	0.5750000
NODE_33365_length_540_cov_6.328798	313	393	2	80	80	1.0000000
NODE_33382_length_540_cov_3.587302	351	411	2	60	60	1.0000000
NODE_33503_length_539_cov_1023.604545	264	344	804	1	80	0.0125000
NODE_33503_length_539_cov_1023.604545	264	344	816	1	80	0.0125000
NODE_33503_length_539_cov_1023.604545	264	344	848	1	80	0.0125000
NODE_33503_length_539_cov_1023.604545	264	344	852	1	80	0.0125000
NODE_33503_length_539_cov_1023.604545	264	344	885	1	80	0.0125000
NODE_33503_length_539_cov_1023.604545	264	344	905	1	80	0.0125000
NODE_33503_length_539_cov_1023.604545	264	344	927	1	80	0.0125000
NODE_33503_length_539_cov_1023.604545	264	344	956	1	80	0.0125000
NODE_33503_length_539_cov_1023.604545	264	344	959	1	80	0.0125000
NODE_33503_length_539_cov_1023.604545	264	344	960	1	80	0.0125000
NODE_33503_length_539_cov_1023.604545	264	344	970	1	80	0.0125000
NODE_33503_length_539_cov_1023.604545	264	344	1020	1	80	0.0125000
NODE_33503_length_539_cov_1023.604545	264	344	1033	1	80	0.0125000
NODE_33503_length_539_cov_1023.604545	264	344	1044	1	80	0.0125000
NODE_33503_length_539_cov_1023.604545	264	344	1045	1	80	0.0125000
NODE_33503_length_539_cov_1023.604545	264	344	1064	1	80	0.0125000
NODE_33503_length_539_cov_1023.604545	264	344	1097	1	80	0.0125000
NODE_33503_length_539_cov_1023.604545	264	344	1119	1	80	0.0125000
NODE_33503_length_539_cov_1023.604545	264	344	1148	1	80	0.0125000
NODE_33503_length_539_cov_1023.604545	264	344	1169	1	80	0.0125000
NODE_33503_length_539_cov_1023.604545	264	344	1195	1	80	0.0125000
NODE_33503_length_539_cov_1023.604545	264	344	1241	1	80	0.0125000
NODE_33503_length_539_cov_1023.604545	264	344	1269	1	80	0.0125000
NODE_33503_length_539_cov_1023.604545	264	344	1332	1	80	0.0125000
NODE_33503_length_539_cov_1023.604545	264	344	1375	1	80	0.0125000
NODE_33503_length_539_cov_1023.604545	264	344	1415	1	80	0.0125000
NODE_33503_length_539_cov_1023.604545	264	344	1434	1	80	0.0125000
NODE_33503_length_539_cov_1023.604545	264	344	1458	1	80	0.0125000
NODE_33503_length_539_cov_1023.604545	264	344	1481	1	80	0.0125000
NODE_33503_length_539_cov_1023.604545	264	344	1518	1	80	0.0125000
NODE_33503_length_539_cov_1023.604545	264	344	1532	1	80	0.0125000
NODE_33503_length_539_cov_1023.604545	264	344	1547	1	80	0.0125000
NODE_33503_length_539_cov_1023.604545	264	344	1582	1	80	0.0125000
NODE_33503_length_539_cov_1023.604545	264	344	1597	1	80	0.0125000
NODE_33503_length_539_cov_1023.604545	264	344	1603	1	80	0.0125000
NODE_33503_length_539_cov_1023.604545	264	344	1619	1	80	0.0125000
NODE_33503_length_539_cov_1023.604545	264	344	1653	1	80	0.0125000
NODE_33503_length_539_cov_1023.604545	264	344	1674	1	80	0.0125000
NODE_33503_length_539_cov_1023.604545	264	344	1702	1	80	0.0125000
NODE_33503_length_539_cov_1023.604545	264	344	1719	1	80	0.0125000
NODE_33503_length_539_cov_1023.604545	264	344	1754	1	80	0.0125000
NODE_33503_length_539_cov_1023.604545	264	344	1771	1	80	0.0125000
NODE_33503_length_539_cov_1023.604545	264	344	1788	1	80	0.0125000
NODE_33503_length_539_cov_1023.604545	264	344	1803	1	80	0.0125000
NODE_33503_length_539_cov_1023.604545	264	344	1807	1	80	0.0125000
NODE_33503_length_539_cov_1023.604545	264	344	1808	1	80	0.0125000
NODE_33503_length_539_cov_1023.604545	264	344	1810	1	80	0.0125000
NODE_33503_length_539_cov_1023.604545	264	344	1816	1	80	0.0125000
NODE_33503_length_539_cov_1023.604545	264	344	1837	1	80	0.0125000
NODE_33503_length_539_cov_1023.604545	264	344	1839	1	80	0.0125000
NODE_33503_length_539_cov_1023.604545	264	344	1847	1	80	0.0125000
NODE_33503_length_539_cov_1023.604545	264	344	1861	1	80	0.0125000
NODE_33503_length_539_cov_1023.604545	264	344	1876	1	80	0.0125000
NODE_33503_length_539_cov_1023.604545	264	344	1884	1	80	0.0125000
NODE_33503_length_539_cov_1023.604545	264	344	1886	1	80	0.0125000
NODE_33503_length_539_cov_1023.604545	264	344	1903	1	80	0.0125000
NODE_33503_length_539_cov_1023.604545	264	344	1904	1	80	0.0125000
NODE_33503_length_539_cov_1023.604545	264	344	1914	1	80	0.0125000
NODE_33503_length_539_cov_1023.604545	264	344	1935	1	80	0.0125000
NODE_33503_length_539_cov_1023.604545	264	344	1938	1	80	0.0125000
NODE_33503_length_539_cov_1023.604545	264	344	1946	1	80	0.0125000
NODE_33503_length_539_cov_1023.604545	264	344	1950	1	80	0.0125000
NODE_33503_length_539_cov_1023.604545	264	344	1958	1	80	0.0125000
NODE_33503_length_539_cov_1023.604545	264	344	1961	1	80	0.0125000
NODE_33503_length_539_cov_1023.604545	264	344	1967	1	80	0.0125000
NODE_33503_length_539_cov_1023.604545	264	344	1973	1	80	0.0125000
NODE_33503_length_539_cov_1023.604545	264	344	1991	1	80	0.0125000
NODE_33503_length_539_cov_1023.604545	264	344	1997	1	80	0.0125000
NODE_33503_length_539_cov_1023.604545	264	344	2009	1	80	0.0125000
NODE_33503_length_539_cov_1023.604545	264	344	2017	1	80	0.0125000
NODE_33503_length_539_cov_1023.604545	264	344	2030	1	80	0.0125000
NODE_33503_length_539_cov_1023.604545	264	344	2036	1	80	0.0125000
NODE_33503_length_539_cov_1023.604545	264	344	2047	1	80	0.0125000
NODE_33503_length_539_cov_1023.604545	264	344	2059	1	80	0.0125000
NODE_33503_length_539_cov_1023.604545	264	344	2063	1	80	0.0125000
NODE_33503_length_539_cov_1023.604545	264	344	2064	1	80	0.0125000
NODE_33503_length_539_cov_1023.604545	264	344	2066	1	80	0.0125000
NODE_33503_length_539_cov_1023.604545	264	344	2070	1	80	0.0125000
NODE_33503_length_539_cov_1023.604545	264	344	2073	1	80	0.0125000
NODE_33503_length_539_cov_1023.604545	264	344	2075	1	80	0.0125000
NODE_33503_length_539_cov_1023.604545	317	397	1747	1	80	0.0125000
NODE_33503_length_539_cov_1023.604545	317	397	1750	1	80	0.0125000
NODE_33503_length_539_cov_1023.604545	317	397	1758	1	80	0.0125000
NODE_33503_length_539_cov_1023.604545	317	397	1763	1	80	0.0125000
NODE_33503_length_539_cov_1023.604545	317	397	1764	1	80	0.0125000
NODE_33503_length_539_cov_1023.604545	317	397	1794	1	80	0.0125000
NODE_33503_length_539_cov_1023.604545	317	397	1814	1	80	0.0125000
NODE_33503_length_539_cov_1023.604545	317	397	1828	1	80	0.0125000
NODE_33503_length_539_cov_1023.604545	317	397	1830	1	80	0.0125000
NODE_33503_length_539_cov_1023.604545	317	397	1836	1	80	0.0125000
NODE_33503_length_539_cov_1023.604545	317	397	1846	1	80	0.0125000
NODE_33503_length_539_cov_1023.604545	317	397	1859	1	80	0.0125000
NODE_33503_length_539_cov_1023.604545	317	397	1860	1	80	0.0125000
NODE_33503_length_539_cov_1023.604545	317	397	1861	1	80	0.0125000
NODE_33503_length_539_cov_1023.604545	317	397	1868	1	80	0.0125000
NODE_33503_length_539_cov_1023.604545	317	397	1869	1	80	0.0125000
NODE_33503_length_539_cov_1023.604545	317	397	1874	1	80	0.0125000
NODE_33503_length_539_cov_1023.604545	317	397	1876	1	80	0.0125000
NODE_33503_length_539_cov_1023.604545	317	397	1883	1	80	0.0125000
NODE_33503_length_539_cov_1023.604545	317	397	1884	1	80	0.0125000
NODE_33503_length_539_cov_1023.604545	317	397	1886	1	80	0.0125000
NODE_33503_length_539_cov_1023.604545	317	397	1897	1	80	0.0125000
NODE_33503_length_539_cov_1023.604545	317	397	1901	1	80	0.0125000
NODE_33503_length_539_cov_1023.604545	317	397	1903	2	80	0.0250000
NODE_33503_length_539_cov_1023.604545	317	397	1904	1	80	0.0125000
NODE_33503_length_539_cov_1023.604545	317	397	1909	1	80	0.0125000
NODE_33503_length_539_cov_1023.604545	317	397	1914	1	80	0.0125000
NODE_33503_length_539_cov_1023.604545	317	397	1917	1	80	0.0125000
NODE_33503_length_539_cov_1023.604545	317	397	1918	1	80	0.0125000
NODE_33503_length_539_cov_1023.604545	317	397	1921	1	80	0.0125000
NODE_33503_length_539_cov_1023.604545	317	397	1935	1	80	0.0125000
NODE_33503_length_539_cov_1023.604545	317	397	1938	1	80	0.0125000
NODE_33503_length_539_cov_1023.604545	317	397	1946	1	80	0.0125000
NODE_33503_length_539_cov_1023.604545	317	397	1950	1	80	0.0125000
NODE_33503_length_539_cov_1023.604545	317	397	1957	1	80	0.0125000
NODE_33503_length_539_cov_1023.604545	317	397	1958	1	80	0.0125000
NODE_33503_length_539_cov_1023.604545	317	397	1961	1	80	0.0125000
NODE_33503_length_539_cov_1023.604545	317	397	1967	2	80	0.0250000
NODE_33503_length_539_cov_1023.604545	317	397	1973	1	80	0.0125000
NODE_33503_length_539_cov_1023.604545	317	397	1983	1	80	0.0125000
NODE_33503_length_539_cov_1023.604545	317	397	1991	1	80	0.0125000
NODE_33503_length_539_cov_1023.604545	317	397	1997	1	80	0.0125000
NODE_33503_length_539_cov_1023.604545	317	397	2003	1	80	0.0125000
NODE_33503_length_539_cov_1023.604545	317	397	2007	1	80	0.0125000
NODE_33503_length_539_cov_1023.604545	317	397	2009	1	80	0.0125000
NODE_33503_length_539_cov_1023.604545	317	397	2017	1	80	0.0125000
NODE_33503_length_539_cov_1023.604545	317	397	2020	2	80	0.0250000
NODE_33503_length_539_cov_1023.604545	317	397	2028	1	80	0.0125000
NODE_33503_length_539_cov_1023.604545	317	397	2029	1	80	0.0125000
NODE_33503_length_539_cov_1023.604545	317	397	2030	1	80	0.0125000
NODE_33503_length_539_cov_1023.604545	317	397	2036	1	80	0.0125000
NODE_33503_length_539_cov_1023.604545	317	397	2046	1	80	0.0125000
NODE_33503_length_539_cov_1023.604545	317	397	2047	1	80	0.0125000
NODE_33503_length_539_cov_1023.604545	317	397	2052	1	80	0.0125000
NODE_33503_length_539_cov_1023.604545	317	397	2059	1	80	0.0125000
NODE_33503_length_539_cov_1023.604545	317	397	2060	1	80	0.0125000
NODE_33503_length_539_cov_1023.604545	317	397	2062	1	80	0.0125000
NODE_33503_length_539_cov_1023.604545	317	397	2063	1	80	0.0125000
NODE_33503_length_539_cov_1023.604545	317	397	2064	2	80	0.0250000
NODE_33503_length_539_cov_1023.604545	317	397	2066	1	80	0.0125000
NODE_33503_length_539_cov_1023.604545	317	397	2067	2	80	0.0250000
NODE_33503_length_539_cov_1023.604545	317	397	2070	1	80	0.0125000
NODE_33503_length_539_cov_1023.604545	317	397	2073	2	80	0.0250000
NODE_33503_length_539_cov_1023.604545	317	397	2075	1	80	0.0125000
NODE_33503_length_539_cov_1023.604545	317	397	2076	2	80	0.0250000
NODE_33503_length_539_cov_1023.604545	317	397	2081	1	80	0.0125000
NODE_33503_length_539_cov_1023.604545	317	397	2082	1	80	0.0125000
NODE_33503_length_539_cov_1023.604545	317	397	2090	1	80	0.0125000
NODE_33503_length_539_cov_1023.604545	317	397	2091	1	80	0.0125000
NODE_33503_length_539_cov_1023.604545	317	397	2092	1	80	0.0125000
NODE_33503_length_539_cov_1023.604545	317	397	2093	1	80	0.0125000
NODE_33503_length_539_cov_1023.604545	317	397	2095	1	80	0.0125000
NODE_33503_length_539_cov_1023.604545	317	397	2100	1	80	0.0125000
NODE_33504_length_539_cov_99.579545	478	539	0	35	61	0.5737705
NODE_33504_length_539_cov_99.579545	478	539	2	26	61	0.4262295
NODE_33505_length_539_cov_15.247727	217	297	0	80	80	1.0000000
NODE_33505_length_539_cov_15.247727	270	350	0	80	80	1.0000000
NODE_33506_length_539_cov_14.172727	278	350	2	4	72	0.0555556
NODE_33506_length_539_cov_14.172727	278	350	6	68	72	0.9444444
NODE_33507_length_539_cov_13.154545	118	198	0	31	80	0.3875000
NODE_33507_length_539_cov_13.154545	118	198	2	14	80	0.1750000
NODE_33507_length_539_cov_13.154545	118	198	6	35	80	0.4375000
NODE_33507_length_539_cov_13.154545	171	251	4	48	80	0.6000000
NODE_33507_length_539_cov_13.154545	171	251	6	32	80	0.4000000
NODE_33508_length_539_cov_10.811364	48	128	0	80	80	1.0000000
NODE_33508_length_539_cov_10.811364	101	181	0	80	80	1.0000000
NODE_33509_length_539_cov_9.563636	201	277	0	76	76	1.0000000
NODE_33510_length_539_cov_7.934091	311	369	2	58	58	1.0000000
NODE_33510_length_539_cov_7.934091	342	422	0	5	80	0.0625000
NODE_33510_length_539_cov_7.934091	342	422	2	75	80	0.9375000
NODE_33517_length_539_cov_5.740909	251	319	0	68	68	1.0000000
NODE_33517_length_539_cov_5.740909	301	372	0	71	71	1.0000000
NODE_33533_length_539_cov_3.627273	80	157	0	77	77	1.0000000
NODE_33533_length_539_cov_3.627273	130	175	0	45	45	1.0000000
NODE_33569_length_539_cov_2.143182	325	371	0	7	46	0.1521739
NODE_33569_length_539_cov_2.143182	325	371	2	39	46	0.8478261
NODE_33595_length_539_cov_1.618182	408	456	0	7	48	0.1458333
NODE_33595_length_539_cov_1.618182	408	456	2	41	48	0.8541667
NODE_33623_length_539_cov_1.129545	97	134	0	37	37	1.0000000
NODE_33669_length_538_cov_23.193622	171	256	0	85	85	1.0000000
NODE_33669_length_538_cov_23.193622	225	305	0	80	80	1.0000000
NODE_33672_length_538_cov_7.378132	145	225	6	4	80	0.0500000
NODE_33672_length_538_cov_7.378132	145	225	8	18	80	0.2250000
NODE_33672_length_538_cov_7.378132	145	225	9	1	80	0.0125000
NODE_33672_length_538_cov_7.378132	145	225	10	57	80	0.7125000
NODE_33672_length_538_cov_7.378132	198	278	4	44	80	0.5500000
NODE_33672_length_538_cov_7.378132	198	278	8	13	80	0.1625000
NODE_33672_length_538_cov_7.378132	198	278	10	23	80	0.2875000
NODE_33683_length_538_cov_4.496583	277	357	0	80	80	1.0000000
NODE_33683_length_538_cov_4.496583	330	410	0	80	80	1.0000000
NODE_33687_length_538_cov_3.753986	251	309	0	58	58	1.0000000
NODE_33713_length_538_cov_2.239180	256	338	2	43	82	0.5243902
NODE_33713_length_538_cov_2.239180	256	338	4	14	82	0.1707317
NODE_33713_length_538_cov_2.239180	256	338	6	4	82	0.0487805
NODE_33713_length_538_cov_2.239180	256	338	10	3	82	0.0365854
NODE_33713_length_538_cov_2.239180	256	338	14	18	82	0.2195122
NODE_33814_length_538_cov_0.822323	397	477	0	1	80	0.0125000
NODE_33814_length_538_cov_0.822323	397	477	2	14	80	0.1750000
NODE_33814_length_538_cov_0.822323	397	477	4	14	80	0.1750000
NODE_33814_length_538_cov_0.822323	397	477	6	51	80	0.6375000
NODE_33852_length_537_cov_13.031963	258	309	0	51	51	1.0000000
NODE_33854_length_537_cov_9.552511	198	278	0	80	80	1.0000000
NODE_33854_length_537_cov_9.552511	251	332	0	81	81	1.0000000
NODE_33960_length_537_cov_1.244292	107	187	17	4	80	0.0500000
NODE_33960_length_537_cov_1.244292	107	187	22	15	80	0.1875000
NODE_33960_length_537_cov_1.244292	107	187	24	1	80	0.0125000
NODE_33960_length_537_cov_1.244292	107	187	26	1	80	0.0125000
NODE_33960_length_537_cov_1.244292	107	187	28	2	80	0.0250000
NODE_33960_length_537_cov_1.244292	107	187	30	1	80	0.0125000
NODE_33960_length_537_cov_1.244292	107	187	34	5	80	0.0625000
NODE_33960_length_537_cov_1.244292	107	187	36	3	80	0.0375000
NODE_33960_length_537_cov_1.244292	107	187	38	1	80	0.0125000
NODE_33960_length_537_cov_1.244292	107	187	47	1	80	0.0125000
NODE_33960_length_537_cov_1.244292	107	187	52	1	80	0.0125000
NODE_33960_length_537_cov_1.244292	107	187	54	2	80	0.0250000
NODE_33960_length_537_cov_1.244292	107	187	60	2	80	0.0250000
NODE_33960_length_537_cov_1.244292	107	187	62	2	80	0.0250000
NODE_33960_length_537_cov_1.244292	107	187	66	1	80	0.0125000
NODE_33960_length_537_cov_1.244292	107	187	68	1	80	0.0125000
NODE_33960_length_537_cov_1.244292	107	187	74	1	80	0.0125000
NODE_33960_length_537_cov_1.244292	107	187	78	1	80	0.0125000
NODE_33960_length_537_cov_1.244292	107	187	80	6	80	0.0750000
NODE_33960_length_537_cov_1.244292	107	187	82	1	80	0.0125000
NODE_33960_length_537_cov_1.244292	107	187	84	5	80	0.0625000
NODE_33960_length_537_cov_1.244292	107	187	94	5	80	0.0625000
NODE_33960_length_537_cov_1.244292	107	187	96	2	80	0.0250000
NODE_33960_length_537_cov_1.244292	107	187	98	4	80	0.0500000
NODE_33960_length_537_cov_1.244292	107	187	100	1	80	0.0125000
NODE_33960_length_537_cov_1.244292	107	187	102	1	80	0.0125000
NODE_33960_length_537_cov_1.244292	107	187	106	9	80	0.1125000
NODE_33960_length_537_cov_1.244292	107	187	108	1	80	0.0125000
NODE_34029_length_536_cov_87.622426	430	462	180	1	32	0.0312500
NODE_34029_length_536_cov_87.622426	430	462	182	1	32	0.0312500
NODE_34029_length_536_cov_87.622426	430	462	188	1	32	0.0312500
NODE_34029_length_536_cov_87.622426	430	462	194	1	32	0.0312500
NODE_34029_length_536_cov_87.622426	430	462	196	1	32	0.0312500
NODE_34029_length_536_cov_87.622426	430	462	197	2	32	0.0625000
NODE_34029_length_536_cov_87.622426	430	462	199	1	32	0.0312500
NODE_34029_length_536_cov_87.622426	430	462	201	1	32	0.0312500
NODE_34029_length_536_cov_87.622426	430	462	207	1	32	0.0312500
NODE_34029_length_536_cov_87.622426	430	462	208	4	32	0.1250000
NODE_34029_length_536_cov_87.622426	430	462	215	1	32	0.0312500
NODE_34029_length_536_cov_87.622426	430	462	216	1	32	0.0312500
NODE_34029_length_536_cov_87.622426	430	462	227	1	32	0.0312500
NODE_34029_length_536_cov_87.622426	430	462	228	1	32	0.0312500
NODE_34029_length_536_cov_87.622426	430	462	230	2	32	0.0625000
NODE_34029_length_536_cov_87.622426	430	462	232	1	32	0.0312500
NODE_34029_length_536_cov_87.622426	430	462	237	1	32	0.0312500
NODE_34029_length_536_cov_87.622426	430	462	239	1	32	0.0312500
NODE_34029_length_536_cov_87.622426	430	462	242	1	32	0.0312500
NODE_34029_length_536_cov_87.622426	430	462	248	1	32	0.0312500
NODE_34029_length_536_cov_87.622426	430	462	250	5	32	0.1562500
NODE_34029_length_536_cov_87.622426	430	462	254	1	32	0.0312500
NODE_34029_length_536_cov_87.622426	430	462	256	1	32	0.0312500
NODE_34030_length_536_cov_11.629291	119	199	0	80	80	1.0000000
NODE_34030_length_536_cov_11.629291	172	252	0	80	80	1.0000000
NODE_34032_length_536_cov_6.613272	286	372	0	86	86	1.0000000
NODE_34035_length_536_cov_5.810069	191	271	0	80	80	1.0000000
NODE_34035_length_536_cov_5.810069	244	324	0	80	80	1.0000000
NODE_34035_length_536_cov_5.810069	374	404	0	21	30	0.7000000
NODE_34035_length_536_cov_5.810069	374	404	2	9	30	0.3000000
NODE_34039_length_536_cov_4.729977	202	245	0	43	43	1.0000000
NODE_34057_length_536_cov_3.297483	86	126	2	40	40	1.0000000
NODE_34068_length_536_cov_2.796339	223	280	0	57	57	1.0000000
NODE_34094_length_536_cov_1.956522	181	230	18	7	49	0.1428571
NODE_34094_length_536_cov_1.956522	181	230	19	4	49	0.0816327
NODE_34094_length_536_cov_1.956522	181	230	20	4	49	0.0816327
NODE_34094_length_536_cov_1.956522	181	230	22	3	49	0.0612245
NODE_34094_length_536_cov_1.956522	181	230	24	1	49	0.0204082
NODE_34094_length_536_cov_1.956522	181	230	26	3	49	0.0612245
NODE_34094_length_536_cov_1.956522	181	230	30	2	49	0.0408163
NODE_34094_length_536_cov_1.956522	181	230	32	23	49	0.4693878
NODE_34094_length_536_cov_1.956522	181	230	34	2	49	0.0408163
NODE_34095_length_536_cov_1.951945	203	284	6	4	81	0.0493827
NODE_34095_length_536_cov_1.951945	203	284	11	3	81	0.0370370
NODE_34095_length_536_cov_1.951945	203	284	12	7	81	0.0864198
NODE_34095_length_536_cov_1.951945	203	284	13	1	81	0.0123457
NODE_34095_length_536_cov_1.951945	203	284	14	1	81	0.0123457
NODE_34095_length_536_cov_1.951945	203	284	15	6	81	0.0740741
NODE_34095_length_536_cov_1.951945	203	284	16	3	81	0.0370370
NODE_34095_length_536_cov_1.951945	203	284	18	26	81	0.3209876
NODE_34095_length_536_cov_1.951945	203	284	22	30	81	0.3703704
NODE_34095_length_536_cov_1.951945	306	368	4	42	62	0.6774194
NODE_34095_length_536_cov_1.951945	306	368	5	17	62	0.2741936
NODE_34095_length_536_cov_1.951945	306	368	6	3	62	0.0483871
NODE_34209_length_535_cov_32.277523	158	238	0	80	80	1.0000000
NODE_34209_length_535_cov_32.277523	211	291	0	38	80	0.4750000
NODE_34209_length_535_cov_32.277523	211	291	2	42	80	0.5250000
NODE_34215_length_535_cov_5.910550	110	162	4	23	52	0.4423077
NODE_34215_length_535_cov_5.910550	110	162	6	29	52	0.5576923
NODE_34229_length_535_cov_3.795872	217	297	2	7	80	0.0875000
NODE_34229_length_535_cov_3.795872	217	297	4	1	80	0.0125000
NODE_34229_length_535_cov_3.795872	217	297	10	5	80	0.0625000
NODE_34229_length_535_cov_3.795872	217	297	12	18	80	0.2250000
NODE_34229_length_535_cov_3.795872	217	297	16	49	80	0.6125000
NODE_34375_length_534_cov_54.331034	435	498	0	56	63	0.8888889
NODE_34375_length_534_cov_54.331034	435	498	4	1	63	0.0158730
NODE_34375_length_534_cov_54.331034	435	498	10	1	63	0.0158730
NODE_34375_length_534_cov_54.331034	435	498	23	1	63	0.0158730
NODE_34375_length_534_cov_54.331034	435	498	100	1	63	0.0158730
NODE_34375_length_534_cov_54.331034	435	498	104	1	63	0.0158730
NODE_34375_length_534_cov_54.331034	435	498	106	2	63	0.0317460
NODE_34375_length_534_cov_54.331034	471	534	0	63	63	1.0000000
NODE_34377_length_534_cov_15.462069	460	534	0	1	74	0.0135135
NODE_34377_length_534_cov_15.462069	460	534	2	73	74	0.9864865
NODE_34377_length_534_cov_15.462069	512	534	2	22	22	1.0000000
NODE_34378_length_534_cov_10.308046	268	348	0	80	80	1.0000000
NODE_34378_length_534_cov_10.308046	321	401	0	80	80	1.0000000
NODE_34380_length_534_cov_9.041379	204	284	0	80	80	1.0000000
NODE_34380_length_534_cov_9.041379	257	332	0	75	75	1.0000000
NODE_34383_length_534_cov_6.958621	273	303	0	30	30	1.0000000
NODE_34392_length_534_cov_5.022989	291	371	40	2	80	0.0250000
NODE_34392_length_534_cov_5.022989	291	371	42	2	80	0.0250000
NODE_34392_length_534_cov_5.022989	291	371	43	1	80	0.0125000
NODE_34392_length_534_cov_5.022989	291	371	44	5	80	0.0625000
NODE_34392_length_534_cov_5.022989	291	371	45	3	80	0.0375000
NODE_34392_length_534_cov_5.022989	291	371	46	3	80	0.0375000
NODE_34392_length_534_cov_5.022989	291	371	50	1	80	0.0125000
NODE_34392_length_534_cov_5.022989	291	371	51	1	80	0.0125000
NODE_34392_length_534_cov_5.022989	291	371	52	1	80	0.0125000
NODE_34392_length_534_cov_5.022989	291	371	55	1	80	0.0125000
NODE_34392_length_534_cov_5.022989	291	371	57	11	80	0.1375000
NODE_34392_length_534_cov_5.022989	291	371	58	1	80	0.0125000
NODE_34392_length_534_cov_5.022989	291	371	59	6	80	0.0750000
NODE_34392_length_534_cov_5.022989	291	371	60	12	80	0.1500000
NODE_34392_length_534_cov_5.022989	291	371	61	6	80	0.0750000
NODE_34392_length_534_cov_5.022989	291	371	62	9	80	0.1125000
NODE_34392_length_534_cov_5.022989	291	371	69	15	80	0.1875000
NODE_34402_length_534_cov_3.873563	110	190	2	19	80	0.2375000
NODE_34402_length_534_cov_3.873563	110	190	3	11	80	0.1375000
NODE_34402_length_534_cov_3.873563	110	190	4	50	80	0.6250000
NODE_34409_length_534_cov_3.202299	221	301	2	12	80	0.1500000
NODE_34409_length_534_cov_3.202299	221	301	6	25	80	0.3125000
NODE_34409_length_534_cov_3.202299	221	301	8	43	80	0.5375000
NODE_34411_length_534_cov_3.158621	171	200	12	11	29	0.3793103
NODE_34411_length_534_cov_3.158621	171	200	14	18	29	0.6206896
NODE_34418_length_534_cov_3.002299	175	219	0	44	44	1.0000000
NODE_34489_length_534_cov_1.344828	475	518	0	43	43	1.0000000
NODE_34494_length_534_cov_1.291954	273	336	2	8	63	0.1269841
NODE_34494_length_534_cov_1.291954	273	336	4	16	63	0.2539683
NODE_34494_length_534_cov_1.291954	273	336	6	39	63	0.6190476
NODE_34511_length_534_cov_1.160920	227	264	2	6	37	0.1621622
NODE_34511_length_534_cov_1.160920	227	264	4	4	37	0.1081081
NODE_34511_length_534_cov_1.160920	227	264	6	16	37	0.4324324
NODE_34511_length_534_cov_1.160920	227	264	10	11	37	0.2972973
NODE_34570_length_533_cov_13.956221	216	296	2	80	80	1.0000000
NODE_34570_length_533_cov_13.956221	269	349	0	43	80	0.5375000
NODE_34570_length_533_cov_13.956221	269	349	2	37	80	0.4625000
NODE_34575_length_533_cov_8.207373	244	322	0	72	78	0.9230769
NODE_34575_length_533_cov_8.207373	244	322	2	6	78	0.0769231
NODE_34576_length_533_cov_8.023041	230	310	0	33	80	0.4125000
NODE_34576_length_533_cov_8.023041	230	310	2	47	80	0.5875000
NODE_34576_length_533_cov_8.023041	283	364	0	26	81	0.3209876
NODE_34576_length_533_cov_8.023041	283	364	2	55	81	0.6790124
NODE_34585_length_533_cov_5.170507	308	369	0	61	61	1.0000000
NODE_34588_length_533_cov_4.988479	229	309	0	47	80	0.5875000
NODE_34588_length_533_cov_4.988479	229	309	2	6	80	0.0750000
NODE_34588_length_533_cov_4.988479	229	309	4	27	80	0.3375000
NODE_34588_length_533_cov_4.988479	282	362	0	80	80	1.0000000
NODE_34600_length_533_cov_3.638249	201	265	16	15	64	0.2343750
NODE_34600_length_533_cov_3.638249	201	265	18	3	64	0.0468750
NODE_34600_length_533_cov_3.638249	201	265	19	3	64	0.0468750
NODE_34600_length_533_cov_3.638249	201	265	20	43	64	0.6718750
NODE_34603_length_533_cov_3.511521	138	218	0	80	80	1.0000000
NODE_34615_length_533_cov_3.073733	294	340	0	46	46	1.0000000
NODE_34617_length_533_cov_3.052995	256	304	8	48	48	1.0000000
NODE_34631_length_533_cov_2.366359	229	311	2	19	82	0.2317073
NODE_34631_length_533_cov_2.366359	229	311	4	32	82	0.3902439
NODE_34631_length_533_cov_2.366359	229	311	6	9	82	0.1097561
NODE_34631_length_533_cov_2.366359	229	311	8	22	82	0.2682927
NODE_34635_length_533_cov_2.288018	468	490	0	22	22	1.0000000
NODE_34767_length_532_cov_73.279446	0	64	0	3	64	0.0468750
NODE_34767_length_532_cov_73.279446	0	64	2	6	64	0.0937500
NODE_34767_length_532_cov_73.279446	0	64	4	55	64	0.8593750
NODE_34768_length_532_cov_23.055427	168	248	0	54	80	0.6750000
NODE_34768_length_532_cov_23.055427	168	248	2	14	80	0.1750000
NODE_34768_length_532_cov_23.055427	168	248	4	12	80	0.1500000
NODE_34768_length_532_cov_23.055427	221	301	0	80	80	1.0000000
NODE_34769_length_532_cov_22.778291	256	336	0	12	80	0.1500000
NODE_34769_length_532_cov_22.778291	256	336	2	13	80	0.1625000
NODE_34769_length_532_cov_22.778291	256	336	4	55	80	0.6875000
NODE_34769_length_532_cov_22.778291	309	389	0	21	80	0.2625000
NODE_34769_length_532_cov_22.778291	309	389	2	1	80	0.0125000
NODE_34769_length_532_cov_22.778291	309	389	4	58	80	0.7250000
NODE_34770_length_532_cov_13.279446	85	165	0	35	80	0.4375000
NODE_34770_length_532_cov_13.279446	85	165	2	45	80	0.5625000
NODE_34770_length_532_cov_13.279446	138	218	0	80	80	1.0000000
NODE_34774_length_532_cov_7.591224	171	235	0	14	64	0.2187500
NODE_34774_length_532_cov_7.591224	171	235	5	1	64	0.0156250
NODE_34774_length_532_cov_7.591224	171	235	6	7	64	0.1093750
NODE_34774_length_532_cov_7.591224	171	235	10	23	64	0.3593750
NODE_34774_length_532_cov_7.591224	171	235	13	1	64	0.0156250
NODE_34774_length_532_cov_7.591224	171	235	14	18	64	0.2812500
NODE_34774_length_532_cov_7.591224	172	235	0	13	63	0.2063492
NODE_34774_length_532_cov_7.591224	172	235	5	1	63	0.0158730
NODE_34774_length_532_cov_7.591224	172	235	6	7	63	0.1111111
NODE_34774_length_532_cov_7.591224	172	235	10	23	63	0.3650794
NODE_34774_length_532_cov_7.591224	172	235	13	1	63	0.0158730
NODE_34774_length_532_cov_7.591224	172	235	14	18	63	0.2857143
NODE_34774_length_532_cov_7.591224	173	226	0	12	53	0.2264151
NODE_34774_length_532_cov_7.591224	173	226	5	1	53	0.0188679
NODE_34774_length_532_cov_7.591224	173	226	6	7	53	0.1320755
NODE_34774_length_532_cov_7.591224	173	226	10	23	53	0.4339623
NODE_34774_length_532_cov_7.591224	173	226	13	1	53	0.0188679
NODE_34774_length_532_cov_7.591224	173	226	14	9	53	0.1698113
NODE_34774_length_532_cov_7.591224	173	228	0	12	55	0.2181818
NODE_34774_length_532_cov_7.591224	173	228	5	1	55	0.0181818
NODE_34774_length_532_cov_7.591224	173	228	6	7	55	0.1272727
NODE_34774_length_532_cov_7.591224	173	228	10	23	55	0.4181818
NODE_34774_length_532_cov_7.591224	173	228	13	1	55	0.0181818
NODE_34774_length_532_cov_7.591224	173	228	14	11	55	0.2000000
NODE_34774_length_532_cov_7.591224	208	282	10	16	74	0.2162162
NODE_34774_length_532_cov_7.591224	208	282	13	1	74	0.0135135
NODE_34774_length_532_cov_7.591224	208	282	14	35	74	0.4729730
NODE_34774_length_532_cov_7.591224	208	282	16	22	74	0.2972973
NODE_34774_length_532_cov_7.591224	208	282	10	16	74	0.2162162
NODE_34774_length_532_cov_7.591224	208	282	13	1	74	0.0135135
NODE_34774_length_532_cov_7.591224	208	282	14	35	74	0.4729730
NODE_34774_length_532_cov_7.591224	208	282	16	22	74	0.2972973
NODE_34774_length_532_cov_7.591224	208	282	10	16	74	0.2162162
NODE_34774_length_532_cov_7.591224	208	282	13	1	74	0.0135135
NODE_34774_length_532_cov_7.591224	208	282	14	35	74	0.4729730
NODE_34774_length_532_cov_7.591224	208	282	16	22	74	0.2972973
NODE_34774_length_532_cov_7.591224	208	282	10	16	74	0.2162162
NODE_34774_length_532_cov_7.591224	208	282	13	1	74	0.0135135
NODE_34774_length_532_cov_7.591224	208	282	14	35	74	0.4729730
NODE_34774_length_532_cov_7.591224	208	282	16	22	74	0.2972973
NODE_34788_length_532_cov_4.524249	84	151	0	67	67	1.0000000
NODE_34788_length_532_cov_4.524249	137	218	0	81	81	1.0000000
NODE_34838_length_532_cov_1.866051	263	309	0	46	46	1.0000000
NODE_34845_length_532_cov_1.757506	126	146	0	20	20	1.0000000
NODE_34948_length_531_cov_35.539352	7	45	0	38	38	1.0000000
NODE_34948_length_531_cov_35.539352	18	98	0	80	80	1.0000000
NODE_34949_length_531_cov_13.162037	129	209	0	80	80	1.0000000
NODE_34949_length_531_cov_13.162037	182	251	0	69	69	1.0000000
NODE_34953_length_531_cov_6.821759	242	322	0	80	80	1.0000000
NODE_34953_length_531_cov_6.821759	295	375	0	80	80	1.0000000
NODE_34958_length_531_cov_5.261574	261	336	13	9	75	0.1200000
NODE_34958_length_531_cov_5.261574	261	336	16	1	75	0.0133333
NODE_34958_length_531_cov_5.261574	261	336	18	4	75	0.0533333
NODE_34958_length_531_cov_5.261574	261	336	19	7	75	0.0933333
NODE_34958_length_531_cov_5.261574	261	336	21	2	75	0.0266667
NODE_34958_length_531_cov_5.261574	261	336	25	2	75	0.0266667
NODE_34958_length_531_cov_5.261574	261	336	26	1	75	0.0133333
NODE_34958_length_531_cov_5.261574	261	336	27	16	75	0.2133333
NODE_34958_length_531_cov_5.261574	261	336	28	33	75	0.4400000
NODE_34958_length_531_cov_5.261574	309	362	10	2	53	0.0377358
NODE_34958_length_531_cov_5.261574	309	362	14	5	53	0.0943396
NODE_34958_length_531_cov_5.261574	309	362	16	6	53	0.1132075
NODE_34958_length_531_cov_5.261574	309	362	18	17	53	0.3207547
NODE_34958_length_531_cov_5.261574	309	362	25	2	53	0.0377358
NODE_34958_length_531_cov_5.261574	309	362	28	21	53	0.3962264
NODE_34963_length_531_cov_4.527778	177	255	0	67	78	0.8589743
NODE_34963_length_531_cov_4.527778	177	255	2	11	78	0.1410256
NODE_34965_length_531_cov_4.319444	283	363	0	80	80	1.0000000
NODE_34965_length_531_cov_4.319444	336	416	0	61	80	0.7625000
NODE_34965_length_531_cov_4.319444	336	416	2	19	80	0.2375000
NODE_34979_length_531_cov_3.488426	238	318	0	55	80	0.6875000
NODE_34979_length_531_cov_3.488426	238	318	2	25	80	0.3125000
NODE_34979_length_531_cov_3.488426	291	371	0	80	80	1.0000000
NODE_34980_length_531_cov_3.375000	153	207	0	23	54	0.4259259
NODE_34980_length_531_cov_3.375000	153	207	2	29	54	0.5370370
NODE_34980_length_531_cov_3.375000	153	207	4	2	54	0.0370370
NODE_34980_length_531_cov_3.375000	180	260	0	2	80	0.0250000
NODE_34980_length_531_cov_3.375000	180	260	2	40	80	0.5000000
NODE_34980_length_531_cov_3.375000	180	260	4	28	80	0.3500000
NODE_34980_length_531_cov_3.375000	180	260	8	10	80	0.1250000
NODE_34986_length_531_cov_3.111111	243	323	0	3	80	0.0375000
NODE_34986_length_531_cov_3.111111	243	323	2	77	80	0.9625000
NODE_34986_length_531_cov_3.111111	296	376	0	56	80	0.7000000
NODE_34986_length_531_cov_3.111111	296	376	2	24	80	0.3000000
NODE_35008_length_531_cov_2.201389	302	373	0	22	71	0.3098592
NODE_35008_length_531_cov_2.201389	302	373	2	49	71	0.6901408
NODE_35008_length_531_cov_2.201389	350	426	0	1	76	0.0131579
NODE_35008_length_531_cov_2.201389	350	426	2	75	76	0.9868421
NODE_35141_length_530_cov_30.605568	250	330	0	80	80	1.0000000
NODE_35141_length_530_cov_30.605568	303	383	0	80	80	1.0000000
NODE_35142_length_530_cov_16.937355	404	484	3	2	80	0.0250000
NODE_35142_length_530_cov_16.937355	404	484	5	3	80	0.0375000
NODE_35142_length_530_cov_16.937355	404	484	7	1	80	0.0125000
NODE_35142_length_530_cov_16.937355	404	484	15	1	80	0.0125000
NODE_35142_length_530_cov_16.937355	404	484	27	2	80	0.0250000
NODE_35142_length_530_cov_16.937355	404	484	30	1	80	0.0125000
NODE_35142_length_530_cov_16.937355	404	484	32	1	80	0.0125000
NODE_35142_length_530_cov_16.937355	404	484	34	1	80	0.0125000
NODE_35142_length_530_cov_16.937355	404	484	38	2	80	0.0250000
NODE_35142_length_530_cov_16.937355	404	484	40	66	80	0.8250000
NODE_35142_length_530_cov_16.937355	457	530	4	9	73	0.1232877
NODE_35142_length_530_cov_16.937355	457	530	6	1	73	0.0136986
NODE_35142_length_530_cov_16.937355	457	530	8	2	73	0.0273973
NODE_35142_length_530_cov_16.937355	457	530	16	4	73	0.0547945
NODE_35142_length_530_cov_16.937355	457	530	20	1	73	0.0136986
NODE_35142_length_530_cov_16.937355	457	530	25	1	73	0.0136986
NODE_35142_length_530_cov_16.937355	457	530	30	2	73	0.0273973
NODE_35142_length_530_cov_16.937355	457	530	34	2	73	0.0273973
NODE_35142_length_530_cov_16.937355	457	530	36	1	73	0.0136986
NODE_35142_length_530_cov_16.937355	457	530	40	50	73	0.6849315
NODE_35143_length_530_cov_9.902552	273	353	0	80	80	1.0000000
NODE_35143_length_530_cov_9.902552	326	406	0	80	80	1.0000000
NODE_35144_length_530_cov_7.928074	46	126	0	80	80	1.0000000
NODE_35144_length_530_cov_7.928074	99	179	0	80	80	1.0000000
NODE_35150_length_530_cov_4.647332	188	268	2	80	80	1.0000000
NODE_35150_length_530_cov_4.647332	241	321	0	29	80	0.3625000
NODE_35150_length_530_cov_4.647332	241	321	2	51	80	0.6375000
NODE_35154_length_530_cov_4.389791	162	242	21	3	80	0.0375000
NODE_35154_length_530_cov_4.389791	162	242	24	1	80	0.0125000
NODE_35154_length_530_cov_4.389791	162	242	25	1	80	0.0125000
NODE_35154_length_530_cov_4.389791	162	242	26	10	80	0.1250000
NODE_35154_length_530_cov_4.389791	162	242	28	6	80	0.0750000
NODE_35154_length_530_cov_4.389791	162	242	29	15	80	0.1875000
NODE_35154_length_530_cov_4.389791	162	242	31	1	80	0.0125000
NODE_35154_length_530_cov_4.389791	162	242	35	3	80	0.0375000
NODE_35154_length_530_cov_4.389791	162	242	37	7	80	0.0875000
NODE_35154_length_530_cov_4.389791	162	242	38	7	80	0.0875000
NODE_35154_length_530_cov_4.389791	162	242	39	1	80	0.0125000
NODE_35154_length_530_cov_4.389791	162	242	40	2	80	0.0250000
NODE_35154_length_530_cov_4.389791	162	242	46	4	80	0.0500000
NODE_35154_length_530_cov_4.389791	162	242	47	4	80	0.0500000
NODE_35154_length_530_cov_4.389791	162	242	49	2	80	0.0250000
NODE_35154_length_530_cov_4.389791	162	242	50	13	80	0.1625000
NODE_35159_length_530_cov_4.046404	76	111	2	35	35	1.0000000
NODE_35319_length_529_cov_38.983721	140	220	2	11	80	0.1375000
NODE_35319_length_529_cov_38.983721	140	220	4	2	80	0.0250000
NODE_35319_length_529_cov_38.983721	140	220	5	1	80	0.0125000
NODE_35319_length_529_cov_38.983721	140	220	6	64	80	0.8000000
NODE_35319_length_529_cov_38.983721	140	220	8	2	80	0.0250000
NODE_35320_length_529_cov_18.223256	189	269	0	80	80	1.0000000
NODE_35320_length_529_cov_18.223256	242	322	0	80	80	1.0000000
NODE_35321_length_529_cov_17.009302	358	438	0	80	80	1.0000000
NODE_35321_length_529_cov_17.009302	411	491	0	80	80	1.0000000
NODE_35331_length_529_cov_6.195349	211	291	0	80	80	1.0000000
NODE_35331_length_529_cov_6.195349	264	322	0	58	58	1.0000000
NODE_35336_length_529_cov_5.176744	139	207	0	68	68	1.0000000
NODE_35336_length_529_cov_5.176744	185	260	0	75	75	1.0000000
NODE_35364_length_529_cov_2.883721	223	281	4	11	58	0.1896552
NODE_35364_length_529_cov_2.883721	223	281	6	3	58	0.0517241
NODE_35364_length_529_cov_2.883721	223	281	8	19	58	0.3275862
NODE_35364_length_529_cov_2.883721	223	281	10	3	58	0.0517241
NODE_35364_length_529_cov_2.883721	223	281	12	22	58	0.3793103
NODE_35374_length_529_cov_2.660465	89	168	0	79	79	1.0000000
NODE_35375_length_529_cov_2.595349	278	321	0	43	43	1.0000000
NODE_35384_length_529_cov_2.272093	247	313	2	66	66	1.0000000
NODE_35427_length_529_cov_1.597674	289	332	0	43	43	1.0000000
NODE_35521_length_528_cov_25.808858	233	313	0	80	80	1.0000000
NODE_35521_length_528_cov_25.808858	286	366	0	80	80	1.0000000
NODE_35522_length_528_cov_17.331002	219	299	0	80	80	1.0000000
NODE_35522_length_528_cov_17.331002	272	352	0	80	80	1.0000000
NODE_35523_length_528_cov_16.165501	262	342	0	80	80	1.0000000
NODE_35523_length_528_cov_16.165501	315	395	0	80	80	1.0000000
NODE_35529_length_528_cov_5.776224	204	284	2	47	80	0.5875000
NODE_35529_length_528_cov_5.776224	204	284	4	33	80	0.4125000
NODE_35529_length_528_cov_5.776224	257	337	0	32	80	0.4000000
NODE_35529_length_528_cov_5.776224	257	337	2	43	80	0.5375000
NODE_35529_length_528_cov_5.776224	257	337	4	5	80	0.0625000
NODE_35542_length_528_cov_4.016317	235	315	2	74	80	0.9250000
NODE_35542_length_528_cov_4.016317	235	315	3	6	80	0.0750000
NODE_35542_length_528_cov_4.016317	288	368	1	13	80	0.1625000
NODE_35542_length_528_cov_4.016317	288	368	2	22	80	0.2750000
NODE_35542_length_528_cov_4.016317	288	368	3	45	80	0.5625000
NODE_35545_length_528_cov_3.799534	144	192	2	48	48	1.0000000
NODE_35561_length_528_cov_2.902098	252	305	0	49	53	0.9245283
NODE_35561_length_528_cov_2.902098	252	305	2	4	53	0.0754717
NODE_35575_length_528_cov_2.324009	137	188	20	4	51	0.0784314
NODE_35575_length_528_cov_2.324009	137	188	22	1	51	0.0196078
NODE_35575_length_528_cov_2.324009	137	188	23	42	51	0.8235294
NODE_35575_length_528_cov_2.324009	137	188	24	4	51	0.0784314
NODE_35575_length_528_cov_2.324009	161	241	8	3	80	0.0375000
NODE_35575_length_528_cov_2.324009	161	241	20	9	80	0.1125000
NODE_35575_length_528_cov_2.324009	161	241	23	23	80	0.2875000
NODE_35575_length_528_cov_2.324009	161	241	24	45	80	0.5625000
NODE_35597_length_528_cov_1.755245	268	348	4	4	80	0.0500000
NODE_35597_length_528_cov_1.755245	268	348	6	1	80	0.0125000
NODE_35597_length_528_cov_1.755245	268	348	8	17	80	0.2125000
NODE_35597_length_528_cov_1.755245	268	348	10	58	80	0.7250000
NODE_35597_length_528_cov_1.755245	321	401	4	13	80	0.1625000
NODE_35597_length_528_cov_1.755245	321	401	6	31	80	0.3875000
NODE_35597_length_528_cov_1.755245	321	401	8	30	80	0.3750000
NODE_35597_length_528_cov_1.755245	321	401	10	6	80	0.0750000
NODE_35687_length_527_cov_19.247664	306	386	4	80	80	1.0000000
NODE_35687_length_527_cov_19.247664	359	439	2	37	80	0.4625000
NODE_35687_length_527_cov_19.247664	359	439	4	43	80	0.5375000
NODE_35688_length_527_cov_15.974299	250	349	0	48	99	0.4848485
NODE_35688_length_527_cov_15.974299	250	349	2	51	99	0.5151515
NODE_35688_length_527_cov_15.974299	322	402	0	9	80	0.1125000
NODE_35688_length_527_cov_15.974299	322	402	2	71	80	0.8875000
NODE_35691_length_527_cov_8.221963	235	315	0	69	80	0.8625000
NODE_35691_length_527_cov_8.221963	235	315	2	1	80	0.0125000
NODE_35691_length_527_cov_8.221963	235	315	6	1	80	0.0125000
NODE_35691_length_527_cov_8.221963	235	315	8	1	80	0.0125000
NODE_35691_length_527_cov_8.221963	235	315	10	7	80	0.0875000
NODE_35691_length_527_cov_8.221963	235	315	12	1	80	0.0125000
NODE_35691_length_527_cov_8.221963	288	368	0	16	80	0.2000000
NODE_35691_length_527_cov_8.221963	288	368	2	1	80	0.0125000
NODE_35691_length_527_cov_8.221963	288	368	6	1	80	0.0125000
NODE_35691_length_527_cov_8.221963	288	368	8	1	80	0.0125000
NODE_35691_length_527_cov_8.221963	288	368	10	7	80	0.0875000
NODE_35691_length_527_cov_8.221963	288	368	12	54	80	0.6750000
NODE_35693_length_527_cov_7.200935	190	270	0	9	80	0.1125000
NODE_35693_length_527_cov_7.200935	190	270	2	19	80	0.2375000
NODE_35693_length_527_cov_7.200935	190	270	4	52	80	0.6500000
NODE_35693_length_527_cov_7.200935	243	346	0	50	103	0.4854369
NODE_35693_length_527_cov_7.200935	243	346	2	36	103	0.3495146
NODE_35693_length_527_cov_7.200935	243	346	4	17	103	0.1650485
NODE_35693_length_527_cov_7.200935	342	422	0	80	80	1.0000000
NODE_35693_length_527_cov_7.200935	395	475	0	40	80	0.5000000
NODE_35693_length_527_cov_7.200935	395	475	4	40	80	0.5000000
NODE_35696_length_527_cov_6.862150	279	359	0	80	80	1.0000000
NODE_35697_length_527_cov_6.046729	155	235	0	10	80	0.1250000
NODE_35697_length_527_cov_6.046729	155	235	2	70	80	0.8750000
NODE_35697_length_527_cov_6.046729	208	288	0	45	80	0.5625000
NODE_35697_length_527_cov_6.046729	208	288	2	35	80	0.4375000
NODE_35736_length_527_cov_2.238318	226	306	0	13	80	0.1625000
NODE_35736_length_527_cov_2.238318	226	306	4	67	80	0.8375000
NODE_35858_length_526_cov_50.866511	169	242	0	73	73	1.0000000
NODE_35858_length_526_cov_50.866511	215	295	0	80	80	1.0000000
NODE_35858_length_526_cov_50.866511	291	371	0	8	80	0.1000000
NODE_35858_length_526_cov_50.866511	291	371	4	72	80	0.9000000
NODE_35858_length_526_cov_50.866511	344	424	4	80	80	1.0000000
NODE_35860_length_526_cov_26.395785	315	395	0	80	80	1.0000000
NODE_35860_length_526_cov_26.395785	368	448	0	80	80	1.0000000
NODE_35861_length_526_cov_16.611241	305	385	6	39	80	0.4875000
NODE_35861_length_526_cov_16.611241	305	385	8	41	80	0.5125000
NODE_35861_length_526_cov_16.611241	358	438	2	40	80	0.5000000
NODE_35861_length_526_cov_16.611241	358	438	8	40	80	0.5000000
NODE_35866_length_526_cov_6.215457	303	351	0	48	48	1.0000000
NODE_35877_length_526_cov_3.936768	118	142	0	24	24	1.0000000
NODE_35877_length_526_cov_3.936768	118	163	0	45	45	1.0000000
NODE_35901_length_526_cov_2.466042	138	184	0	46	46	1.0000000
NODE_36055_length_525_cov_33.910798	98	178	0	8	80	0.1000000
NODE_36055_length_525_cov_33.910798	98	178	2	5	80	0.0625000
NODE_36055_length_525_cov_33.910798	98	178	4	4	80	0.0500000
NODE_36055_length_525_cov_33.910798	98	178	6	20	80	0.2500000
NODE_36055_length_525_cov_33.910798	98	178	8	43	80	0.5375000
NODE_36055_length_525_cov_33.910798	151	231	0	7	80	0.0875000
NODE_36055_length_525_cov_33.910798	151	231	2	19	80	0.2375000
NODE_36055_length_525_cov_33.910798	151	231	4	2	80	0.0250000
NODE_36055_length_525_cov_33.910798	151	231	6	52	80	0.6500000
NODE_36055_length_525_cov_33.910798	159	231	2	18	72	0.2500000
NODE_36055_length_525_cov_33.910798	159	231	4	2	72	0.0277778
NODE_36055_length_525_cov_33.910798	159	231	6	52	72	0.7222222
NODE_36058_length_525_cov_8.788732	175	255	0	38	80	0.4750000
NODE_36058_length_525_cov_8.788732	175	255	2	6	80	0.0750000
NODE_36058_length_525_cov_8.788732	175	255	4	36	80	0.4500000
NODE_36058_length_525_cov_8.788732	228	308	2	8	80	0.1000000
NODE_36058_length_525_cov_8.788732	228	308	4	72	80	0.9000000
NODE_36059_length_525_cov_7.880282	242	285	0	43	43	1.0000000
NODE_36098_length_525_cov_2.417840	229	306	1	77	77	1.0000000
NODE_36230_length_524_cov_21.649412	262	342	0	80	80	1.0000000
NODE_36230_length_524_cov_21.649412	315	395	0	80	80	1.0000000
NODE_36231_length_524_cov_14.131765	136	201	24	12	65	0.1846154
NODE_36231_length_524_cov_14.131765	136	201	30	1	65	0.0153846
NODE_36231_length_524_cov_14.131765	136	201	36	3	65	0.0461538
NODE_36231_length_524_cov_14.131765	136	201	38	49	65	0.7538462
NODE_36232_length_524_cov_10.392941	237	317	0	80	80	1.0000000
NODE_36232_length_524_cov_10.392941	290	370	0	80	80	1.0000000
NODE_36262_length_524_cov_3.221176	195	272	0	77	77	1.0000000
NODE_36262_length_524_cov_3.221176	253	324	0	71	71	1.0000000
NODE_36264_length_524_cov_3.148235	317	397	0	80	80	1.0000000
NODE_36410_length_523_cov_113.438679	0	48	0	10	48	0.2083333
NODE_36410_length_523_cov_113.438679	0	48	4	10	48	0.2083333
NODE_36410_length_523_cov_113.438679	0	48	6	2	48	0.0416667
NODE_36410_length_523_cov_113.438679	0	48	8	26	48	0.5416667
NODE_36410_length_523_cov_113.438679	14	69	4	6	55	0.1090909
NODE_36410_length_523_cov_113.438679	14	69	6	2	55	0.0363636
NODE_36410_length_523_cov_113.438679	14	69	8	29	55	0.5272727
NODE_36410_length_523_cov_113.438679	14	69	10	2	55	0.0363636
NODE_36410_length_523_cov_113.438679	14	69	12	16	55	0.2909091
NODE_36410_length_523_cov_113.438679	25	101	8	26	76	0.3421053
NODE_36410_length_523_cov_113.438679	25	101	10	2	76	0.0263158
NODE_36410_length_523_cov_113.438679	25	101	12	32	76	0.4210526
NODE_36410_length_523_cov_113.438679	25	101	14	16	76	0.2105263
NODE_36410_length_523_cov_113.438679	105	181	16	3	76	0.0394737
NODE_36410_length_523_cov_113.438679	105	181	18	3	76	0.0394737
NODE_36410_length_523_cov_113.438679	105	181	19	1	76	0.0131579
NODE_36410_length_523_cov_113.438679	105	181	20	11	76	0.1447368
NODE_36410_length_523_cov_113.438679	105	181	21	2	76	0.0263158
NODE_36410_length_523_cov_113.438679	105	181	22	6	76	0.0789474
NODE_36410_length_523_cov_113.438679	105	181	24	1	76	0.0131579
NODE_36410_length_523_cov_113.438679	105	181	26	1	76	0.0131579
NODE_36410_length_523_cov_113.438679	105	181	28	1	76	0.0131579
NODE_36410_length_523_cov_113.438679	105	181	29	1	76	0.0131579
NODE_36410_length_523_cov_113.438679	105	181	34	1	76	0.0131579
NODE_36410_length_523_cov_113.438679	105	181	36	1	76	0.0131579
NODE_36410_length_523_cov_113.438679	105	181	37	1	76	0.0131579
NODE_36410_length_523_cov_113.438679	105	181	39	1	76	0.0131579
NODE_36410_length_523_cov_113.438679	105	181	41	6	76	0.0789474
NODE_36410_length_523_cov_113.438679	105	181	43	5	76	0.0657895
NODE_36410_length_523_cov_113.438679	105	181	45	3	76	0.0394737
NODE_36410_length_523_cov_113.438679	105	181	46	4	76	0.0526316
NODE_36410_length_523_cov_113.438679	105	181	48	1	76	0.0131579
NODE_36410_length_523_cov_113.438679	105	181	49	2	76	0.0263158
NODE_36410_length_523_cov_113.438679	105	181	50	2	76	0.0263158
NODE_36410_length_523_cov_113.438679	105	181	52	2	76	0.0263158
NODE_36410_length_523_cov_113.438679	105	181	56	3	76	0.0394737
NODE_36410_length_523_cov_113.438679	105	181	60	2	76	0.0263158
NODE_36410_length_523_cov_113.438679	105	181	64	1	76	0.0131579
NODE_36410_length_523_cov_113.438679	105	181	65	2	76	0.0263158
NODE_36410_length_523_cov_113.438679	105	181	67	4	76	0.0526316
NODE_36410_length_523_cov_113.438679	105	181	69	3	76	0.0394737
NODE_36410_length_523_cov_113.438679	105	181	77	1	76	0.0131579
NODE_36410_length_523_cov_113.438679	105	181	79	1	76	0.0131579
NODE_36410_length_523_cov_113.438679	154	234	46	3	80	0.0375000
NODE_36410_length_523_cov_113.438679	154	234	48	1	80	0.0125000
NODE_36410_length_523_cov_113.438679	154	234	49	2	80	0.0250000
NODE_36410_length_523_cov_113.438679	154	234	50	2	80	0.0250000
NODE_36410_length_523_cov_113.438679	154	234	52	2	80	0.0250000
NODE_36410_length_523_cov_113.438679	154	234	56	3	80	0.0375000
NODE_36410_length_523_cov_113.438679	154	234	60	2	80	0.0250000
NODE_36410_length_523_cov_113.438679	154	234	64	1	80	0.0125000
NODE_36410_length_523_cov_113.438679	154	234	65	2	80	0.0250000
NODE_36410_length_523_cov_113.438679	154	234	67	4	80	0.0500000
NODE_36410_length_523_cov_113.438679	154	234	69	3	80	0.0375000
NODE_36410_length_523_cov_113.438679	154	234	77	1	80	0.0125000
NODE_36410_length_523_cov_113.438679	154	234	79	1	80	0.0125000
NODE_36410_length_523_cov_113.438679	154	234	82	1	80	0.0125000
NODE_36410_length_523_cov_113.438679	154	234	84	2	80	0.0250000
NODE_36410_length_523_cov_113.438679	154	234	86	2	80	0.0250000
NODE_36410_length_523_cov_113.438679	154	234	87	5	80	0.0625000
NODE_36410_length_523_cov_113.438679	154	234	90	3	80	0.0375000
NODE_36410_length_523_cov_113.438679	154	234	91	3	80	0.0375000
NODE_36410_length_523_cov_113.438679	154	234	92	8	80	0.1000000
NODE_36410_length_523_cov_113.438679	154	234	94	1	80	0.0125000
NODE_36410_length_523_cov_113.438679	154	234	95	11	80	0.1375000
NODE_36410_length_523_cov_113.438679	154	234	96	8	80	0.1000000
NODE_36410_length_523_cov_113.438679	154	234	97	6	80	0.0750000
NODE_36410_length_523_cov_113.438679	154	234	98	3	80	0.0375000
NODE_36410_length_523_cov_113.438679	312	355	24	5	43	0.1162791
NODE_36410_length_523_cov_113.438679	312	355	26	1	43	0.0232558
NODE_36410_length_523_cov_113.438679	312	355	28	5	43	0.1162791
NODE_36410_length_523_cov_113.438679	312	355	30	9	43	0.2093023
NODE_36410_length_523_cov_113.438679	312	355	31	1	43	0.0232558
NODE_36410_length_523_cov_113.438679	312	355	32	9	43	0.2093023
NODE_36410_length_523_cov_113.438679	312	355	33	8	43	0.1860465
NODE_36410_length_523_cov_113.438679	312	355	34	5	43	0.1162791
NODE_36412_length_523_cov_64.695755	35	115	0	80	80	1.0000000
NODE_36412_length_523_cov_64.695755	88	168	0	80	80	1.0000000
NODE_36414_length_523_cov_20.724057	235	315	4	9	80	0.1125000
NODE_36414_length_523_cov_20.724057	235	315	6	71	80	0.8875000
NODE_36414_length_523_cov_20.724057	288	368	0	22	80	0.2750000
NODE_36414_length_523_cov_20.724057	288	368	4	29	80	0.3625000
NODE_36414_length_523_cov_20.724057	288	368	6	29	80	0.3625000
NODE_36415_length_523_cov_18.500000	164	244	2	13	80	0.1625000
NODE_36415_length_523_cov_18.500000	164	244	4	54	80	0.6750000
NODE_36415_length_523_cov_18.500000	164	244	6	13	80	0.1625000
NODE_36415_length_523_cov_18.500000	217	297	4	80	80	1.0000000
NODE_36416_length_523_cov_15.216981	62	142	0	80	80	1.0000000
NODE_36416_length_523_cov_15.216981	115	195	0	80	80	1.0000000
NODE_36417_length_523_cov_10.575472	157	183	2	26	26	1.0000000
NODE_36418_length_523_cov_9.962264	212	292	0	18	80	0.2250000
NODE_36418_length_523_cov_9.962264	212	292	2	62	80	0.7750000
NODE_36418_length_523_cov_9.962264	265	345	2	80	80	1.0000000
NODE_36427_length_523_cov_4.943396	108	188	14	4	80	0.0500000
NODE_36427_length_523_cov_4.943396	108	188	16	13	80	0.1625000
NODE_36427_length_523_cov_4.943396	108	188	18	9	80	0.1125000
NODE_36427_length_523_cov_4.943396	108	188	20	6	80	0.0750000
NODE_36427_length_523_cov_4.943396	108	188	22	18	80	0.2250000
NODE_36427_length_523_cov_4.943396	108	188	24	7	80	0.0875000
NODE_36427_length_523_cov_4.943396	108	188	25	9	80	0.1125000
NODE_36427_length_523_cov_4.943396	108	188	26	5	80	0.0625000
NODE_36427_length_523_cov_4.943396	108	188	27	1	80	0.0125000
NODE_36427_length_523_cov_4.943396	108	188	28	8	80	0.1000000
NODE_36427_length_523_cov_4.943396	161	241	18	1	80	0.0125000
NODE_36427_length_523_cov_4.943396	161	241	21	6	80	0.0750000
NODE_36427_length_523_cov_4.943396	161	241	22	3	80	0.0375000
NODE_36427_length_523_cov_4.943396	161	241	23	2	80	0.0250000
NODE_36427_length_523_cov_4.943396	161	241	24	8	80	0.1000000
NODE_36427_length_523_cov_4.943396	161	241	25	22	80	0.2750000
NODE_36427_length_523_cov_4.943396	161	241	26	19	80	0.2375000
NODE_36427_length_523_cov_4.943396	161	241	27	11	80	0.1375000
NODE_36427_length_523_cov_4.943396	161	241	28	8	80	0.1000000
NODE_36429_length_523_cov_4.787736	110	141	12	4	31	0.1290323
NODE_36429_length_523_cov_4.787736	110	141	14	3	31	0.0967742
NODE_36429_length_523_cov_4.787736	110	141	16	15	31	0.4838710
NODE_36429_length_523_cov_4.787736	110	141	18	9	31	0.2903226
NODE_36429_length_523_cov_4.787736	131	194	14	1	63	0.0158730
NODE_36429_length_523_cov_4.787736	131	194	16	8	63	0.1269841
NODE_36429_length_523_cov_4.787736	131	194	18	12	63	0.1904762
NODE_36429_length_523_cov_4.787736	131	194	20	13	63	0.2063492
NODE_36429_length_523_cov_4.787736	131	194	22	14	63	0.2222222
NODE_36429_length_523_cov_4.787736	131	194	24	15	63	0.2380952
NODE_36439_length_523_cov_3.792453	139	219	0	80	80	1.0000000
NODE_36439_length_523_cov_3.792453	192	272	0	80	80	1.0000000
NODE_36481_length_523_cov_2.259434	337	372	0	4	35	0.1142857
NODE_36481_length_523_cov_2.259434	337	372	1	22	35	0.6285715
NODE_36481_length_523_cov_2.259434	337	372	2	9	35	0.2571429
NODE_36490_length_523_cov_2.096698	307	351	6	12	44	0.2727273
NODE_36490_length_523_cov_2.096698	307	351	8	14	44	0.3181818
NODE_36490_length_523_cov_2.096698	307	351	10	6	44	0.1363636
NODE_36490_length_523_cov_2.096698	307	351	12	3	44	0.0681818
NODE_36490_length_523_cov_2.096698	307	351	14	4	44	0.0909091
NODE_36490_length_523_cov_2.096698	307	351	16	5	44	0.1136364
NODE_36518_length_523_cov_1.700472	176	195	0	19	19	1.0000000
NODE_36632_length_522_cov_33.579196	55	135	0	32	80	0.4000000
NODE_36632_length_522_cov_33.579196	55	135	2	48	80	0.6000000
NODE_36632_length_522_cov_33.579196	108	188	0	31	80	0.3875000
NODE_36632_length_522_cov_33.579196	108	188	2	49	80	0.6125000
NODE_36634_length_522_cov_12.851064	266	342	0	76	76	1.0000000
NODE_36634_length_522_cov_12.851064	319	395	0	76	76	1.0000000
NODE_36637_length_522_cov_7.349882	212	283	0	71	71	1.0000000
NODE_36637_length_522_cov_7.349882	400	469	0	69	69	1.0000000
NODE_36670_length_522_cov_2.933806	178	258	0	80	80	1.0000000
NODE_36670_length_522_cov_2.933806	231	311	0	80	80	1.0000000
NODE_36676_length_522_cov_2.661939	187	241	0	10	54	0.1851852
NODE_36676_length_522_cov_2.661939	187	241	2	44	54	0.8148148
NODE_36820_length_521_cov_9.303318	106	186	1	14	80	0.1750000
NODE_36820_length_521_cov_9.303318	106	186	2	56	80	0.7000000
NODE_36820_length_521_cov_9.303318	106	186	3	10	80	0.1250000
NODE_36820_length_521_cov_9.303318	159	239	1	14	80	0.1750000
NODE_36820_length_521_cov_9.303318	159	239	2	55	80	0.6875000
NODE_36820_length_521_cov_9.303318	159	239	3	11	80	0.1375000
NODE_36832_length_521_cov_4.971564	218	298	0	80	80	1.0000000
NODE_36832_length_521_cov_4.971564	271	351	0	80	80	1.0000000
NODE_36845_length_521_cov_3.504739	113	191	0	78	78	1.0000000
NODE_36845_length_521_cov_3.504739	164	205	0	41	41	1.0000000
NODE_36848_length_521_cov_3.324645	158	244	0	31	86	0.3604651
NODE_36848_length_521_cov_3.324645	158	244	2	6	86	0.0697674
NODE_36848_length_521_cov_3.324645	158	244	6	1	86	0.0116279
NODE_36848_length_521_cov_3.324645	158	244	14	1	86	0.0116279
NODE_36848_length_521_cov_3.324645	158	244	16	5	86	0.0581395
NODE_36848_length_521_cov_3.324645	158	244	18	2	86	0.0232558
NODE_36848_length_521_cov_3.324645	158	244	20	40	86	0.4651163
NODE_36848_length_521_cov_3.324645	217	280	16	1	63	0.0158730
NODE_36848_length_521_cov_3.324645	217	280	18	1	63	0.0158730
NODE_36848_length_521_cov_3.324645	217	280	20	61	63	0.9682540
NODE_36916_length_521_cov_1.613744	165	227	4	36	62	0.5806451
NODE_36916_length_521_cov_1.613744	165	227	6	26	62	0.4193548
NODE_37036_length_520_cov_50.676960	0	75	0	75	75	1.0000000
NODE_37036_length_520_cov_50.676960	48	128	0	80	80	1.0000000
NODE_37036_length_520_cov_50.676960	124	204	0	80	80	1.0000000
NODE_37036_length_520_cov_50.676960	177	257	0	80	80	1.0000000
NODE_37037_length_520_cov_43.294537	10	90	0	11	80	0.1375000
NODE_37037_length_520_cov_43.294537	10	90	1	69	80	0.8625000
NODE_37037_length_520_cov_43.294537	10	90	0	11	80	0.1375000
NODE_37037_length_520_cov_43.294537	10	90	1	69	80	0.8625000
NODE_37037_length_520_cov_43.294537	10	90	0	11	80	0.1375000
NODE_37037_length_520_cov_43.294537	10	90	1	69	80	0.8625000
NODE_37037_length_520_cov_43.294537	10	90	0	11	80	0.1375000
NODE_37037_length_520_cov_43.294537	10	90	1	69	80	0.8625000
NODE_37037_length_520_cov_43.294537	10	90	0	11	80	0.1375000
NODE_37037_length_520_cov_43.294537	10	90	1	69	80	0.8625000
NODE_37037_length_520_cov_43.294537	10	90	0	11	80	0.1375000
NODE_37037_length_520_cov_43.294537	10	90	1	69	80	0.8625000
NODE_37037_length_520_cov_43.294537	63	129	1	41	66	0.6212121
NODE_37037_length_520_cov_43.294537	63	129	3	18	66	0.2727273
NODE_37037_length_520_cov_43.294537	63	129	4	7	66	0.1060606
NODE_37037_length_520_cov_43.294537	63	142	1	41	79	0.5189874
NODE_37037_length_520_cov_43.294537	63	142	3	31	79	0.3924051
NODE_37037_length_520_cov_43.294537	63	142	4	7	79	0.0886076
NODE_37037_length_520_cov_43.294537	63	143	1	41	80	0.5125000
NODE_37037_length_520_cov_43.294537	63	143	3	32	80	0.4000000
NODE_37037_length_520_cov_43.294537	63	143	4	7	80	0.0875000
NODE_37037_length_520_cov_43.294537	63	133	1	41	70	0.5857143
NODE_37037_length_520_cov_43.294537	63	133	3	22	70	0.3142857
NODE_37037_length_520_cov_43.294537	63	133	4	7	70	0.1000000
NODE_37037_length_520_cov_43.294537	66	133	1	38	67	0.5671642
NODE_37037_length_520_cov_43.294537	66	133	3	22	67	0.3283582
NODE_37037_length_520_cov_43.294537	66	133	4	7	67	0.1044776
NODE_37037_length_520_cov_43.294537	68	143	1	36	75	0.4800000
NODE_37037_length_520_cov_43.294537	68	143	3	32	75	0.4266667
NODE_37037_length_520_cov_43.294537	68	143	4	7	75	0.0933333
NODE_37038_length_520_cov_29.427553	224	304	0	80	80	1.0000000
NODE_37038_length_520_cov_29.427553	277	357	0	80	80	1.0000000
NODE_37038_length_520_cov_29.427553	353	433	0	42	80	0.5250000
NODE_37038_length_520_cov_29.427553	353	433	2	38	80	0.4750000
NODE_37038_length_520_cov_29.427553	406	486	2	80	80	1.0000000
NODE_37039_length_520_cov_14.365796	103	183	0	40	80	0.5000000
NODE_37039_length_520_cov_14.365796	103	183	2	40	80	0.5000000
NODE_37039_length_520_cov_14.365796	156	237	0	45	81	0.5555556
NODE_37039_length_520_cov_14.365796	156	237	2	36	81	0.4444444
NODE_37059_length_520_cov_4.121140	79	159	0	80	80	1.0000000
NODE_37059_length_520_cov_4.121140	132	212	0	80	80	1.0000000
NODE_37063_length_520_cov_3.900238	203	233	0	30	30	1.0000000
NODE_37235_length_519_cov_42.842857	8	88	4	5	80	0.0625000
NODE_37235_length_519_cov_42.842857	8	88	12	7	80	0.0875000
NODE_37235_length_519_cov_42.842857	8	88	16	22	80	0.2750000
NODE_37235_length_519_cov_42.842857	8	88	24	12	80	0.1500000
NODE_37235_length_519_cov_42.842857	8	88	26	12	80	0.1500000
NODE_37235_length_519_cov_42.842857	8	88	27	9	80	0.1125000
NODE_37235_length_519_cov_42.842857	8	88	28	13	80	0.1625000
NODE_37235_length_519_cov_42.842857	61	139	17	8	78	0.1025641
NODE_37235_length_519_cov_42.842857	61	139	21	8	78	0.1025641
NODE_37235_length_519_cov_42.842857	61	139	23	13	78	0.1666667
NODE_37235_length_519_cov_42.842857	61	139	25	1	78	0.0128205
NODE_37235_length_519_cov_42.842857	61	139	26	5	78	0.0641026
NODE_37235_length_519_cov_42.842857	61	139	27	30	78	0.3846154
NODE_37235_length_519_cov_42.842857	61	139	28	13	78	0.1666667
NODE_37236_length_519_cov_19.269048	284	363	0	79	79	1.0000000
NODE_37236_length_519_cov_19.269048	336	416	0	80	80	1.0000000
NODE_37237_length_519_cov_8.500000	195	267	6	1	72	0.0138889
NODE_37237_length_519_cov_8.500000	195	267	7	1	72	0.0138889
NODE_37237_length_519_cov_8.500000	195	267	8	52	72	0.7222222
NODE_37237_length_519_cov_8.500000	195	267	10	18	72	0.2500000
NODE_37245_length_519_cov_5.169048	282	346	0	64	64	1.0000000
NODE_37290_length_519_cov_2.783333	174	235	0	61	61	1.0000000
NODE_37349_length_519_cov_1.538095	147	213	0	66	66	1.0000000
NODE_37447_length_518_cov_40.026253	385	465	7	10	80	0.1250000
NODE_37447_length_518_cov_40.026253	385	465	12	1	80	0.0125000
NODE_37447_length_518_cov_40.026253	385	465	14	69	80	0.8625000
NODE_37447_length_518_cov_40.026253	438	518	0	38	80	0.4750000
NODE_37447_length_518_cov_40.026253	438	518	7	25	80	0.3125000
NODE_37447_length_518_cov_40.026253	438	518	12	1	80	0.0125000
NODE_37447_length_518_cov_40.026253	438	518	14	16	80	0.2000000
NODE_37449_length_518_cov_12.083532	144	224	0	80	80	1.0000000
NODE_37449_length_518_cov_12.083532	197	277	0	80	80	1.0000000
NODE_37449_length_518_cov_12.083532	407	481	0	14	74	0.1891892
NODE_37449_length_518_cov_12.083532	407	481	2	60	74	0.8108108
NODE_37449_length_518_cov_12.083532	454	518	0	16	64	0.2500000
NODE_37449_length_518_cov_12.083532	454	518	2	48	64	0.7500000
NODE_37450_length_518_cov_11.467780	171	200	0	29	29	1.0000000
NODE_37450_length_518_cov_11.467780	253	320	0	67	67	1.0000000
NODE_37450_length_518_cov_11.467780	253	282	0	29	29	1.0000000
NODE_37454_length_518_cov_7.441527	188	273	2	82	85	0.9647059
NODE_37454_length_518_cov_7.441527	188	273	4	3	85	0.0352941
NODE_37461_length_518_cov_5.563246	315	366	2	51	51	1.0000000
NODE_37461_length_518_cov_5.563246	339	383	0	8	44	0.1818182
NODE_37461_length_518_cov_5.563246	339	383	2	36	44	0.8181818
NODE_37465_length_518_cov_4.732697	214	276	0	62	62	1.0000000
NODE_37465_length_518_cov_4.732697	350	430	2	80	80	1.0000000
NODE_37479_length_518_cov_3.503580	291	333	6	42	42	1.0000000
NODE_37479_length_518_cov_3.503580	306	363	3	19	57	0.3333333
NODE_37479_length_518_cov_3.503580	306	363	5	1	57	0.0175439
NODE_37479_length_518_cov_3.503580	306	363	6	37	57	0.6491228
NODE_37483_length_518_cov_3.136038	269	338	2	5	69	0.0724638
NODE_37483_length_518_cov_3.136038	269	338	4	13	69	0.1884058
NODE_37483_length_518_cov_3.136038	269	338	6	51	69	0.7391304
NODE_37483_length_518_cov_3.136038	269	348	2	5	79	0.0632911
NODE_37483_length_518_cov_3.136038	269	348	4	15	79	0.1898734
NODE_37483_length_518_cov_3.136038	269	348	6	59	79	0.7468355
NODE_37483_length_518_cov_3.136038	269	349	2	5	80	0.0625000
NODE_37483_length_518_cov_3.136038	269	349	4	16	80	0.2000000
NODE_37483_length_518_cov_3.136038	269	349	6	59	80	0.7375000
NODE_37483_length_518_cov_3.136038	322	402	0	14	80	0.1750000
NODE_37483_length_518_cov_3.136038	322	402	2	15	80	0.1875000
NODE_37483_length_518_cov_3.136038	322	402	4	27	80	0.3375000
NODE_37483_length_518_cov_3.136038	322	402	6	24	80	0.3000000
NODE_37483_length_518_cov_3.136038	322	364	4	18	42	0.4285714
NODE_37483_length_518_cov_3.136038	322	364	6	24	42	0.5714286
NODE_37483_length_518_cov_3.136038	322	368	4	22	46	0.4782609
NODE_37483_length_518_cov_3.136038	322	368	6	24	46	0.5217391
NODE_37483_length_518_cov_3.136038	331	366	4	20	35	0.5714286
NODE_37483_length_518_cov_3.136038	331	366	6	15	35	0.4285714
NODE_37637_length_517_cov_55.267943	177	257	0	80	80	1.0000000
NODE_37637_length_517_cov_55.267943	230	310	0	80	80	1.0000000
NODE_37639_length_517_cov_30.863636	0	72	0	52	72	0.7222222
NODE_37639_length_517_cov_30.863636	0	72	2	20	72	0.2777778
NODE_37639_length_517_cov_30.863636	0	72	0	52	72	0.7222222
NODE_37639_length_517_cov_30.863636	0	72	2	20	72	0.2777778
NODE_37639_length_517_cov_30.863636	45	125	0	19	80	0.2375000
NODE_37639_length_517_cov_30.863636	45	125	2	61	80	0.7625000
NODE_37639_length_517_cov_30.863636	45	99	0	7	54	0.1296296
NODE_37639_length_517_cov_30.863636	45	99	2	47	54	0.8703704
NODE_37641_length_517_cov_12.258373	305	385	0	34	80	0.4250000
NODE_37641_length_517_cov_12.258373	305	385	2	46	80	0.5750000
NODE_37641_length_517_cov_12.258373	358	438	0	80	80	1.0000000
NODE_37643_length_517_cov_7.131579	100	152	0	52	52	1.0000000
NODE_37662_length_517_cov_4.492823	140	220	0	80	80	1.0000000
NODE_37662_length_517_cov_4.492823	193	273	0	80	80	1.0000000
NODE_37697_length_517_cov_2.437799	331	388	0	29	57	0.5087720
NODE_37697_length_517_cov_2.437799	331	388	4	28	57	0.4912281
NODE_37850_length_516_cov_17.570743	147	227	0	80	80	1.0000000
NODE_37850_length_516_cov_17.570743	200	280	0	60	80	0.7500000
NODE_37850_length_516_cov_17.570743	200	280	2	20	80	0.2500000
NODE_37861_length_516_cov_5.268585	402	448	2	46	46	1.0000000
NODE_37862_length_516_cov_5.067146	114	194	2	6	80	0.0750000
NODE_37862_length_516_cov_5.067146	114	194	4	74	80	0.9250000
NODE_37862_length_516_cov_5.067146	167	247	0	42	80	0.5250000
NODE_37862_length_516_cov_5.067146	167	247	3	1	80	0.0125000
NODE_37862_length_516_cov_5.067146	167	247	4	37	80	0.4625000
NODE_37864_length_516_cov_4.788969	156	236	0	80	80	1.0000000
NODE_37864_length_516_cov_4.788969	209	277	0	68	68	1.0000000
NODE_37881_length_516_cov_3.167866	48	93	0	1	45	0.0222222
NODE_37881_length_516_cov_3.167866	48	93	3	22	45	0.4888889
NODE_37881_length_516_cov_3.167866	48	93	5	12	45	0.2666667
NODE_37881_length_516_cov_3.167866	48	93	6	10	45	0.2222222
NODE_37881_length_516_cov_3.167866	103	177	2	26	74	0.3513514
NODE_37881_length_516_cov_3.167866	103	177	3	8	74	0.1081081
NODE_37881_length_516_cov_3.167866	103	177	5	2	74	0.0270270
NODE_37881_length_516_cov_3.167866	103	177	6	8	74	0.1081081
NODE_37881_length_516_cov_3.167866	103	177	7	14	74	0.1891892
NODE_37881_length_516_cov_3.167866	103	177	8	16	74	0.2162162
NODE_38044_length_515_cov_69.442308	177	257	27	11	80	0.1375000
NODE_38044_length_515_cov_69.442308	177	257	29	4	80	0.0500000
NODE_38044_length_515_cov_69.442308	177	257	30	1	80	0.0125000
NODE_38044_length_515_cov_69.442308	177	257	34	6	80	0.0750000
NODE_38044_length_515_cov_69.442308	177	257	40	26	80	0.3250000
NODE_38044_length_515_cov_69.442308	177	257	41	9	80	0.1125000
NODE_38044_length_515_cov_69.442308	177	257	42	4	80	0.0500000
NODE_38044_length_515_cov_69.442308	177	257	43	2	80	0.0250000
NODE_38044_length_515_cov_69.442308	177	257	46	4	80	0.0500000
NODE_38044_length_515_cov_69.442308	177	257	47	13	80	0.1625000
NODE_38044_length_515_cov_69.442308	177	257	27	11	80	0.1375000
NODE_38044_length_515_cov_69.442308	177	257	29	4	80	0.0500000
NODE_38044_length_515_cov_69.442308	177	257	30	1	80	0.0125000
NODE_38044_length_515_cov_69.442308	177	257	34	6	80	0.0750000
NODE_38044_length_515_cov_69.442308	177	257	40	26	80	0.3250000
NODE_38044_length_515_cov_69.442308	177	257	41	9	80	0.1125000
NODE_38044_length_515_cov_69.442308	177	257	42	4	80	0.0500000
NODE_38044_length_515_cov_69.442308	177	257	43	2	80	0.0250000
NODE_38044_length_515_cov_69.442308	177	257	46	4	80	0.0500000
NODE_38044_length_515_cov_69.442308	177	257	47	13	80	0.1625000
NODE_38044_length_515_cov_69.442308	177	257	27	11	80	0.1375000
NODE_38044_length_515_cov_69.442308	177	257	29	4	80	0.0500000
NODE_38044_length_515_cov_69.442308	177	257	30	1	80	0.0125000
NODE_38044_length_515_cov_69.442308	177	257	34	6	80	0.0750000
NODE_38044_length_515_cov_69.442308	177	257	40	26	80	0.3250000
NODE_38044_length_515_cov_69.442308	177	257	41	9	80	0.1125000
NODE_38044_length_515_cov_69.442308	177	257	42	4	80	0.0500000
NODE_38044_length_515_cov_69.442308	177	257	43	2	80	0.0250000
NODE_38044_length_515_cov_69.442308	177	257	46	4	80	0.0500000
NODE_38044_length_515_cov_69.442308	177	257	47	13	80	0.1625000
NODE_38044_length_515_cov_69.442308	230	291	24	5	61	0.0819672
NODE_38044_length_515_cov_69.442308	230	291	25	8	61	0.1311475
NODE_38044_length_515_cov_69.442308	230	291	30	1	61	0.0163934
NODE_38044_length_515_cov_69.442308	230	291	31	12	61	0.1967213
NODE_38044_length_515_cov_69.442308	230	291	41	9	61	0.1475410
NODE_38044_length_515_cov_69.442308	230	291	42	10	61	0.1639344
NODE_38044_length_515_cov_69.442308	230	291	43	3	61	0.0491803
NODE_38044_length_515_cov_69.442308	230	291	47	13	61	0.2131148
NODE_38044_length_515_cov_69.442308	230	308	23	17	78	0.2179487
NODE_38044_length_515_cov_69.442308	230	308	24	5	78	0.0641026
NODE_38044_length_515_cov_69.442308	230	308	25	8	78	0.1025641
NODE_38044_length_515_cov_69.442308	230	308	30	1	78	0.0128205
NODE_38044_length_515_cov_69.442308	230	308	31	12	78	0.1538462
NODE_38044_length_515_cov_69.442308	230	308	41	9	78	0.1153846
NODE_38044_length_515_cov_69.442308	230	308	42	10	78	0.1282051
NODE_38044_length_515_cov_69.442308	230	308	43	3	78	0.0384615
NODE_38044_length_515_cov_69.442308	230	308	47	13	78	0.1666667
NODE_38044_length_515_cov_69.442308	235	308	23	17	73	0.2328767
NODE_38044_length_515_cov_69.442308	235	308	24	5	73	0.0684932
NODE_38044_length_515_cov_69.442308	235	308	25	8	73	0.1095890
NODE_38044_length_515_cov_69.442308	235	308	30	1	73	0.0136986
NODE_38044_length_515_cov_69.442308	235	308	31	12	73	0.1643836
NODE_38044_length_515_cov_69.442308	235	308	41	9	73	0.1232877
NODE_38044_length_515_cov_69.442308	235	308	42	10	73	0.1369863
NODE_38044_length_515_cov_69.442308	235	308	43	3	73	0.0410959
NODE_38044_length_515_cov_69.442308	235	308	47	8	73	0.1095890
NODE_38045_length_515_cov_13.271635	168	248	0	80	80	1.0000000
NODE_38045_length_515_cov_13.271635	221	301	0	80	80	1.0000000
NODE_38048_length_515_cov_8.314904	213	290	0	77	77	1.0000000
NODE_38054_length_515_cov_5.487981	317	402	0	33	85	0.3882353
NODE_38054_length_515_cov_5.487981	317	402	2	12	85	0.1411765
NODE_38054_length_515_cov_5.487981	317	402	6	4	85	0.0470588
NODE_38054_length_515_cov_5.487981	317	402	8	36	85	0.4235294
NODE_38242_length_514_cov_26.910843	170	250	0	80	80	1.0000000
NODE_38242_length_514_cov_26.910843	223	303	0	80	80	1.0000000
NODE_38243_length_514_cov_12.775904	85	149	8	64	64	1.0000000
NODE_38243_length_514_cov_12.775904	123	202	0	6	79	0.0759494
NODE_38243_length_514_cov_12.775904	123	202	2	22	79	0.2784810
NODE_38243_length_514_cov_12.775904	123	202	5	1	79	0.0126582
NODE_38243_length_514_cov_12.775904	123	202	8	50	79	0.6329114
NODE_38244_length_514_cov_11.156627	124	204	0	80	80	1.0000000
NODE_38244_length_514_cov_11.156627	177	257	0	80	80	1.0000000
NODE_38253_length_514_cov_5.802410	165	217	0	17	52	0.3269231
NODE_38253_length_514_cov_5.802410	165	217	2	35	52	0.6730769
NODE_38253_length_514_cov_5.802410	190	270	2	80	80	1.0000000
NODE_38254_length_514_cov_5.554217	192	272	0	80	80	1.0000000
NODE_38254_length_514_cov_5.554217	294	340	0	10	46	0.2173913
NODE_38254_length_514_cov_5.554217	294	340	2	36	46	0.7826087
NODE_38257_length_514_cov_5.322892	230	260	0	30	30	1.0000000
NODE_38262_length_514_cov_4.337349	220	300	0	80	80	1.0000000
NODE_38286_length_514_cov_3.012048	264	328	0	64	64	1.0000000
NODE_38432_length_513_cov_14.613527	118	198	0	49	80	0.6125000
NODE_38432_length_513_cov_14.613527	118	198	4	31	80	0.3875000
NODE_38432_length_513_cov_14.613527	171	251	4	80	80	1.0000000
NODE_38433_length_513_cov_9.898551	253	333	0	80	80	1.0000000
NODE_38433_length_513_cov_9.898551	306	386	0	80	80	1.0000000
NODE_38434_length_513_cov_9.164251	185	265	0	80	80	1.0000000
NODE_38434_length_513_cov_9.164251	238	318	0	80	80	1.0000000
NODE_38441_length_513_cov_6.123188	284	364	0	80	80	1.0000000
NODE_38441_length_513_cov_6.123188	337	417	0	80	80	1.0000000
NODE_38460_length_513_cov_3.456522	283	350	6	2	67	0.0298507
NODE_38460_length_513_cov_3.456522	283	350	8	6	67	0.0895522
NODE_38460_length_513_cov_3.456522	283	350	10	44	67	0.6567164
NODE_38460_length_513_cov_3.456522	283	350	12	15	67	0.2238806
NODE_38460_length_513_cov_3.456522	336	398	6	3	62	0.0483871
NODE_38460_length_513_cov_3.456522	336	398	8	2	62	0.0322581
NODE_38460_length_513_cov_3.456522	336	398	10	9	62	0.1451613
NODE_38460_length_513_cov_3.456522	336	398	12	38	62	0.6129032
NODE_38460_length_513_cov_3.456522	336	398	13	6	62	0.0967742
NODE_38460_length_513_cov_3.456522	336	398	14	4	62	0.0645161
NODE_38482_length_513_cov_2.309179	134	174	0	31	40	0.7750000
NODE_38482_length_513_cov_2.309179	134	174	4	9	40	0.2250000
NODE_38482_length_513_cov_2.309179	170	223	0	53	53	1.0000000
NODE_38482_length_513_cov_2.309179	238	285	0	47	47	1.0000000
NODE_38515_length_513_cov_1.671498	427	476	5	1	49	0.0204082
NODE_38515_length_513_cov_1.671498	427	476	11	6	49	0.1224490
NODE_38515_length_513_cov_1.671498	427	476	13	5	49	0.1020408
NODE_38515_length_513_cov_1.671498	427	476	15	37	49	0.7551020
NODE_38646_length_512_cov_45.070218	34	114	0	80	80	1.0000000
NODE_38646_length_512_cov_45.070218	87	167	0	80	80	1.0000000
NODE_38647_length_512_cov_39.639225	323	404	0	81	81	1.0000000
NODE_38647_length_512_cov_39.639225	377	457	0	80	80	1.0000000
NODE_38648_length_512_cov_8.581114	192	256	8	4	64	0.0625000
NODE_38648_length_512_cov_8.581114	192	256	10	9	64	0.1406250
NODE_38648_length_512_cov_8.581114	192	256	14	5	64	0.0781250
NODE_38648_length_512_cov_8.581114	192	256	16	13	64	0.2031250
NODE_38648_length_512_cov_8.581114	192	256	17	4	64	0.0625000
NODE_38648_length_512_cov_8.581114	192	256	18	8	64	0.1250000
NODE_38648_length_512_cov_8.581114	192	256	19	7	64	0.1093750
NODE_38648_length_512_cov_8.581114	192	256	20	14	64	0.2187500
NODE_38661_length_512_cov_4.869249	327	407	2	80	80	1.0000000
NODE_38661_length_512_cov_4.869249	380	460	0	25	80	0.3125000
NODE_38661_length_512_cov_4.869249	380	460	2	55	80	0.6875000
NODE_38668_length_512_cov_4.157385	161	204	0	38	43	0.8837209
NODE_38668_length_512_cov_4.157385	161	204	2	5	43	0.1162791
NODE_38668_length_512_cov_4.157385	178	257	0	79	79	1.0000000
NODE_38677_length_512_cov_3.435835	138	218	0	16	80	0.2000000
NODE_38677_length_512_cov_3.435835	138	218	3	1	80	0.0125000
NODE_38677_length_512_cov_3.435835	138	218	4	63	80	0.7875000
NODE_38677_length_512_cov_3.435835	191	271	4	45	80	0.5625000
NODE_38677_length_512_cov_3.435835	191	271	6	35	80	0.4375000
NODE_38693_length_512_cov_2.888620	320	400	0	75	80	0.9375000
NODE_38693_length_512_cov_2.888620	320	400	2	5	80	0.0625000
NODE_38768_length_512_cov_1.341404	198	269	2	1	71	0.0140845
NODE_38768_length_512_cov_1.341404	198	269	6	1	71	0.0140845
NODE_38768_length_512_cov_1.341404	198	269	13	3	71	0.0422535
NODE_38768_length_512_cov_1.341404	198	269	15	4	71	0.0563380
NODE_38768_length_512_cov_1.341404	198	269	17	2	71	0.0281690
NODE_38768_length_512_cov_1.341404	198	269	19	4	71	0.0563380
NODE_38768_length_512_cov_1.341404	198	269	20	4	71	0.0563380
NODE_38768_length_512_cov_1.341404	198	269	22	1	71	0.0140845
NODE_38768_length_512_cov_1.341404	198	269	23	6	71	0.0845070
NODE_38768_length_512_cov_1.341404	198	269	25	4	71	0.0563380
NODE_38768_length_512_cov_1.341404	198	269	27	1	71	0.0140845
NODE_38768_length_512_cov_1.341404	198	269	29	5	71	0.0704225
NODE_38768_length_512_cov_1.341404	198	269	30	2	71	0.0281690
NODE_38768_length_512_cov_1.341404	198	269	33	6	71	0.0845070
NODE_38768_length_512_cov_1.341404	198	269	39	3	71	0.0422535
NODE_38768_length_512_cov_1.341404	198	269	41	5	71	0.0704225
NODE_38768_length_512_cov_1.341404	198	269	42	11	71	0.1549296
NODE_38768_length_512_cov_1.341404	198	269	43	7	71	0.0985916
NODE_38768_length_512_cov_1.341404	198	269	44	1	71	0.0140845
NODE_38866_length_511_cov_9.796117	251	331	0	3	80	0.0375000
NODE_38866_length_511_cov_9.796117	251	331	2	77	80	0.9625000
NODE_38866_length_511_cov_9.796117	304	370	0	40	66	0.6060606
NODE_38866_length_511_cov_9.796117	304	370	2	26	66	0.3939394
NODE_38869_length_511_cov_8.873786	239	319	2	7	80	0.0875000
NODE_38869_length_511_cov_8.873786	239	319	3	73	80	0.9125000
NODE_38869_length_511_cov_8.873786	292	356	0	10	64	0.1562500
NODE_38869_length_511_cov_8.873786	292	356	2	34	64	0.5312500
NODE_38869_length_511_cov_8.873786	292	356	3	20	64	0.3125000
NODE_38870_length_511_cov_8.434466	232	312	0	80	80	1.0000000
NODE_38870_length_511_cov_8.434466	285	366	0	81	81	1.0000000
NODE_38872_length_511_cov_7.519417	157	237	0	15	80	0.1875000
NODE_38872_length_511_cov_7.519417	157	237	2	61	80	0.7625000
NODE_38872_length_511_cov_7.519417	157	237	4	4	80	0.0500000
NODE_38872_length_511_cov_7.519417	210	290	2	74	80	0.9250000
NODE_38872_length_511_cov_7.519417	210	290	4	6	80	0.0750000
NODE_38877_length_511_cov_5.762136	102	179	4	1	77	0.0129870
NODE_38877_length_511_cov_5.762136	102	179	16	58	77	0.7532467
NODE_38877_length_511_cov_5.762136	102	179	18	9	77	0.1168831
NODE_38877_length_511_cov_5.762136	102	179	20	9	77	0.1168831
NODE_38877_length_511_cov_5.762136	155	230	16	6	75	0.0800000
NODE_38877_length_511_cov_5.762136	155	230	18	9	75	0.1200000
NODE_38877_length_511_cov_5.762136	155	230	20	24	75	0.3200000
NODE_38877_length_511_cov_5.762136	155	230	22	7	75	0.0933333
NODE_38877_length_511_cov_5.762136	155	230	23	1	75	0.0133333
NODE_38877_length_511_cov_5.762136	155	230	24	28	75	0.3733333
NODE_38878_length_511_cov_5.655340	133	213	0	80	80	1.0000000
NODE_38878_length_511_cov_5.655340	186	266	0	80	80	1.0000000
NODE_38911_length_511_cov_2.978155	219	255	0	36	36	1.0000000
NODE_39013_length_511_cov_1.225728	99	127	6	28	28	1.0000000
NODE_39092_length_511_cov_0.708738	98	146	0	48	48	1.0000000
NODE_39105_length_510_cov_18.206813	334	414	0	41	80	0.5125000
NODE_39105_length_510_cov_18.206813	334	414	2	39	80	0.4875000
NODE_39105_length_510_cov_18.206813	387	467	0	80	80	1.0000000
NODE_39110_length_510_cov_8.017032	211	291	0	53	80	0.6625000
NODE_39110_length_510_cov_8.017032	211	291	1	5	80	0.0625000
NODE_39110_length_510_cov_8.017032	211	291	2	22	80	0.2750000
NODE_39110_length_510_cov_8.017032	264	344	0	7	80	0.0875000
NODE_39110_length_510_cov_8.017032	264	344	2	73	80	0.9125000
NODE_39110_length_510_cov_8.017032	391	413	0	22	22	1.0000000
NODE_39112_length_510_cov_6.476886	208	251	4	43	43	1.0000000
NODE_39115_length_510_cov_6.133820	149	200	0	51	51	1.0000000
NODE_39122_length_510_cov_4.313869	32	106	0	39	74	0.5270270
NODE_39122_length_510_cov_4.313869	32	106	2	5	74	0.0675676
NODE_39122_length_510_cov_4.313869	32	106	4	30	74	0.4054054
NODE_39131_length_510_cov_3.435523	149	213	0	64	64	1.0000000
NODE_39131_length_510_cov_3.435523	191	249	0	58	58	1.0000000
NODE_39293_length_509_cov_13.378049	160	240	0	17	80	0.2125000
NODE_39293_length_509_cov_13.378049	160	240	1	14	80	0.1750000
NODE_39293_length_509_cov_13.378049	160	240	2	49	80	0.6125000
NODE_39293_length_509_cov_13.378049	213	294	0	66	81	0.8148148
NODE_39293_length_509_cov_13.378049	213	294	2	15	81	0.1851852
NODE_39302_length_509_cov_5.190244	203	283	4	1	80	0.0125000
NODE_39302_length_509_cov_5.190244	203	283	6	52	80	0.6500000
NODE_39302_length_509_cov_5.190244	203	283	8	27	80	0.3375000
NODE_39302_length_509_cov_5.190244	256	336	0	42	80	0.5250000
NODE_39302_length_509_cov_5.190244	256	336	2	4	80	0.0500000
NODE_39302_length_509_cov_5.190244	256	336	4	1	80	0.0125000
NODE_39302_length_509_cov_5.190244	256	336	6	33	80	0.4125000
NODE_39309_length_509_cov_4.478049	221	301	0	80	80	1.0000000
NODE_39309_length_509_cov_4.478049	274	354	0	80	80	1.0000000
NODE_39311_length_509_cov_4.451220	203	283	2	5	80	0.0625000
NODE_39311_length_509_cov_4.451220	203	283	4	8	80	0.1000000
NODE_39311_length_509_cov_4.451220	203	283	8	67	80	0.8375000
NODE_39322_length_509_cov_3.443902	133	185	0	52	52	1.0000000
NODE_39326_length_509_cov_3.207317	367	445	2	11	78	0.1410256
NODE_39326_length_509_cov_3.207317	367	445	4	67	78	0.8589743
NODE_39337_length_509_cov_2.853659	194	274	0	53	80	0.6625000
NODE_39337_length_509_cov_2.853659	194	274	1	2	80	0.0250000
NODE_39337_length_509_cov_2.853659	194	274	3	22	80	0.2750000
NODE_39337_length_509_cov_2.853659	194	274	4	3	80	0.0375000
NODE_39480_length_509_cov_0.809756	229	272	0	30	43	0.6976744
NODE_39480_length_509_cov_0.809756	229	272	2	13	43	0.3023256
NODE_39506_length_508_cov_22.009780	440	508	0	68	68	1.0000000
NODE_39512_length_508_cov_5.158924	248	284	0	36	36	1.0000000
NODE_39539_length_508_cov_2.662592	165	244	8	8	79	0.1012658
NODE_39539_length_508_cov_2.662592	165	244	10	33	79	0.4177215
NODE_39539_length_508_cov_2.662592	165	244	14	35	79	0.4430380
NODE_39539_length_508_cov_2.662592	165	244	16	3	79	0.0379747
NODE_39698_length_507_cov_32.286765	0	61	5	1	61	0.0163934
NODE_39698_length_507_cov_32.286765	0	61	7	1	61	0.0163934
NODE_39698_length_507_cov_32.286765	0	61	13	1	61	0.0163934
NODE_39698_length_507_cov_32.286765	0	61	17	1	61	0.0163934
NODE_39698_length_507_cov_32.286765	0	61	21	1	61	0.0163934
NODE_39698_length_507_cov_32.286765	0	61	28	1	61	0.0163934
NODE_39698_length_507_cov_32.286765	0	61	30	1	61	0.0163934
NODE_39698_length_507_cov_32.286765	0	61	34	1	61	0.0163934
NODE_39698_length_507_cov_32.286765	0	61	35	1	61	0.0163934
NODE_39698_length_507_cov_32.286765	0	61	36	2	61	0.0327869
NODE_39698_length_507_cov_32.286765	0	61	40	1	61	0.0163934
NODE_39698_length_507_cov_32.286765	0	61	41	3	61	0.0491803
NODE_39698_length_507_cov_32.286765	0	61	44	1	61	0.0163934
NODE_39698_length_507_cov_32.286765	0	61	49	2	61	0.0327869
NODE_39698_length_507_cov_32.286765	0	61	53	1	61	0.0163934
NODE_39698_length_507_cov_32.286765	0	61	55	2	61	0.0327869
NODE_39698_length_507_cov_32.286765	0	61	57	2	61	0.0327869
NODE_39698_length_507_cov_32.286765	0	61	59	2	61	0.0327869
NODE_39698_length_507_cov_32.286765	0	61	66	2	61	0.0327869
NODE_39698_length_507_cov_32.286765	0	61	67	1	61	0.0163934
NODE_39698_length_507_cov_32.286765	0	61	69	1	61	0.0163934
NODE_39698_length_507_cov_32.286765	0	61	73	3	61	0.0491803
NODE_39698_length_507_cov_32.286765	0	61	80	1	61	0.0163934
NODE_39698_length_507_cov_32.286765	0	61	84	1	61	0.0163934
NODE_39698_length_507_cov_32.286765	0	61	86	1	61	0.0163934
NODE_39698_length_507_cov_32.286765	0	61	88	1	61	0.0163934
NODE_39698_length_507_cov_32.286765	0	61	95	7	61	0.1147541
NODE_39698_length_507_cov_32.286765	0	61	97	2	61	0.0327869
NODE_39698_length_507_cov_32.286765	0	61	99	1	61	0.0163934
NODE_39698_length_507_cov_32.286765	0	61	100	3	61	0.0491803
NODE_39698_length_507_cov_32.286765	0	61	105	1	61	0.0163934
NODE_39698_length_507_cov_32.286765	0	61	106	1	61	0.0163934
NODE_39698_length_507_cov_32.286765	0	61	119	1	61	0.0163934
NODE_39698_length_507_cov_32.286765	0	61	120	1	61	0.0163934
NODE_39698_length_507_cov_32.286765	0	61	122	1	61	0.0163934
NODE_39698_length_507_cov_32.286765	0	61	124	1	61	0.0163934
NODE_39698_length_507_cov_32.286765	0	61	126	2	61	0.0327869
NODE_39698_length_507_cov_32.286765	0	61	128	4	61	0.0655738
NODE_39698_length_507_cov_32.286765	53	97	122	1	44	0.0227273
NODE_39698_length_507_cov_32.286765	53	97	124	1	44	0.0227273
NODE_39698_length_507_cov_32.286765	53	97	126	2	44	0.0454545
NODE_39698_length_507_cov_32.286765	53	97	128	4	44	0.0909091
NODE_39698_length_507_cov_32.286765	53	97	132	1	44	0.0227273
NODE_39698_length_507_cov_32.286765	53	97	136	1	44	0.0227273
NODE_39698_length_507_cov_32.286765	53	97	144	1	44	0.0227273
NODE_39698_length_507_cov_32.286765	53	97	146	1	44	0.0227273
NODE_39698_length_507_cov_32.286765	53	97	147	3	44	0.0681818
NODE_39698_length_507_cov_32.286765	53	97	149	1	44	0.0227273
NODE_39698_length_507_cov_32.286765	53	97	159	4	44	0.0909091
NODE_39698_length_507_cov_32.286765	53	97	170	1	44	0.0227273
NODE_39698_length_507_cov_32.286765	53	97	176	2	44	0.0454545
NODE_39698_length_507_cov_32.286765	53	97	178	1	44	0.0227273
NODE_39698_length_507_cov_32.286765	53	97	182	1	44	0.0227273
NODE_39698_length_507_cov_32.286765	53	97	186	2	44	0.0454545
NODE_39698_length_507_cov_32.286765	53	97	188	2	44	0.0454545
NODE_39698_length_507_cov_32.286765	53	97	190	1	44	0.0227273
NODE_39698_length_507_cov_32.286765	53	97	194	1	44	0.0227273
NODE_39698_length_507_cov_32.286765	53	97	203	1	44	0.0227273
NODE_39698_length_507_cov_32.286765	53	97	206	1	44	0.0227273
NODE_39698_length_507_cov_32.286765	53	97	210	1	44	0.0227273
NODE_39698_length_507_cov_32.286765	53	97	216	1	44	0.0227273
NODE_39698_length_507_cov_32.286765	53	97	218	1	44	0.0227273
NODE_39698_length_507_cov_32.286765	53	97	222	1	44	0.0227273
NODE_39698_length_507_cov_32.286765	53	97	225	1	44	0.0227273
NODE_39698_length_507_cov_32.286765	53	97	227	4	44	0.0909091
NODE_39698_length_507_cov_32.286765	53	97	233	2	44	0.0454545
NODE_39701_length_507_cov_7.553922	203	283	8	11	80	0.1375000
NODE_39701_length_507_cov_7.553922	203	283	12	23	80	0.2875000
NODE_39701_length_507_cov_7.553922	203	283	16	6	80	0.0750000
NODE_39701_length_507_cov_7.553922	203	283	18	6	80	0.0750000
NODE_39701_length_507_cov_7.553922	203	283	20	26	80	0.3250000
NODE_39701_length_507_cov_7.553922	203	283	24	8	80	0.1000000
NODE_39709_length_507_cov_5.154412	296	362	0	56	66	0.8484849
NODE_39709_length_507_cov_5.154412	296	362	2	10	66	0.1515152
NODE_39714_length_507_cov_4.710784	248	328	0	2	80	0.0250000
NODE_39714_length_507_cov_4.710784	248	328	2	1	80	0.0125000
NODE_39714_length_507_cov_4.710784	248	328	4	11	80	0.1375000
NODE_39714_length_507_cov_4.710784	248	328	6	66	80	0.8250000
NODE_39714_length_507_cov_4.710784	308	379	2	12	71	0.1690141
NODE_39714_length_507_cov_4.710784	308	379	4	38	71	0.5352113
NODE_39714_length_507_cov_4.710784	308	379	6	21	71	0.2957746
NODE_39728_length_507_cov_3.649510	80	109	8	2	29	0.0689655
NODE_39728_length_507_cov_3.649510	80	109	9	3	29	0.1034483
NODE_39728_length_507_cov_3.649510	80	109	11	5	29	0.1724138
NODE_39728_length_507_cov_3.649510	80	109	12	5	29	0.1724138
NODE_39728_length_507_cov_3.649510	80	109	13	1	29	0.0344828
NODE_39728_length_507_cov_3.649510	80	109	15	9	29	0.3103448
NODE_39728_length_507_cov_3.649510	80	109	16	2	29	0.0689655
NODE_39728_length_507_cov_3.649510	80	109	18	2	29	0.0689655
NODE_39728_length_507_cov_3.649510	184	266	32	12	82	0.1463415
NODE_39728_length_507_cov_3.649510	184	266	33	9	82	0.1097561
NODE_39728_length_507_cov_3.649510	184	266	34	11	82	0.1341463
NODE_39728_length_507_cov_3.649510	184	266	35	28	82	0.3414634
NODE_39728_length_507_cov_3.649510	184	266	36	5	82	0.0609756
NODE_39728_length_507_cov_3.649510	184	266	37	7	82	0.0853659
NODE_39728_length_507_cov_3.649510	184	266	38	9	82	0.1097561
NODE_39728_length_507_cov_3.649510	184	266	40	1	82	0.0121951
NODE_39728_length_507_cov_3.649510	189	273	32	19	84	0.2261905
NODE_39728_length_507_cov_3.649510	189	273	33	9	84	0.1071429
NODE_39728_length_507_cov_3.649510	189	273	34	11	84	0.1309524
NODE_39728_length_507_cov_3.649510	189	273	35	28	84	0.3333333
NODE_39728_length_507_cov_3.649510	189	273	36	5	84	0.0595238
NODE_39728_length_507_cov_3.649510	189	273	37	2	84	0.0238095
NODE_39728_length_507_cov_3.649510	189	273	38	9	84	0.1071429
NODE_39728_length_507_cov_3.649510	189	273	40	1	84	0.0119048
NODE_39728_length_507_cov_3.649510	207	266	32	12	59	0.2033898
NODE_39728_length_507_cov_3.649510	207	266	33	9	59	0.1525424
NODE_39728_length_507_cov_3.649510	207	266	34	11	59	0.1864407
NODE_39728_length_507_cov_3.649510	207	266	35	12	59	0.2033898
NODE_39728_length_507_cov_3.649510	207	266	36	5	59	0.0847458
NODE_39728_length_507_cov_3.649510	207	266	38	9	59	0.1525424
NODE_39728_length_507_cov_3.649510	207	266	40	1	59	0.0169492
NODE_39747_length_507_cov_2.754902	345	425	0	80	80	1.0000000
NODE_39747_length_507_cov_2.754902	428	463	0	35	35	1.0000000
NODE_39918_length_506_cov_31.987715	71	156	14	4	85	0.0470588
NODE_39918_length_506_cov_31.987715	71	156	18	5	85	0.0588235
NODE_39918_length_506_cov_31.987715	71	156	20	4	85	0.0470588
NODE_39918_length_506_cov_31.987715	71	156	24	4	85	0.0470588
NODE_39918_length_506_cov_31.987715	71	156	26	6	85	0.0705882
NODE_39918_length_506_cov_31.987715	71	156	28	45	85	0.5294118
NODE_39918_length_506_cov_31.987715	71	156	30	17	85	0.2000000
NODE_39918_length_506_cov_31.987715	71	156	14	4	85	0.0470588
NODE_39918_length_506_cov_31.987715	71	156	18	5	85	0.0588235
NODE_39918_length_506_cov_31.987715	71	156	20	4	85	0.0470588
NODE_39918_length_506_cov_31.987715	71	156	24	4	85	0.0470588
NODE_39918_length_506_cov_31.987715	71	156	26	6	85	0.0705882
NODE_39918_length_506_cov_31.987715	71	156	28	45	85	0.5294118
NODE_39918_length_506_cov_31.987715	71	156	30	17	85	0.2000000
NODE_39918_length_506_cov_31.987715	71	156	14	4	85	0.0470588
NODE_39918_length_506_cov_31.987715	71	156	18	5	85	0.0588235
NODE_39918_length_506_cov_31.987715	71	156	20	4	85	0.0470588
NODE_39918_length_506_cov_31.987715	71	156	24	4	85	0.0470588
NODE_39918_length_506_cov_31.987715	71	156	26	6	85	0.0705882
NODE_39918_length_506_cov_31.987715	71	156	28	45	85	0.5294118
NODE_39918_length_506_cov_31.987715	71	156	30	17	85	0.2000000
NODE_39918_length_506_cov_31.987715	129	209	11	3	80	0.0375000
NODE_39918_length_506_cov_31.987715	129	209	13	3	80	0.0375000
NODE_39918_length_506_cov_31.987715	129	209	14	2	80	0.0250000
NODE_39918_length_506_cov_31.987715	129	209	16	11	80	0.1375000
NODE_39918_length_506_cov_31.987715	129	209	20	11	80	0.1375000
NODE_39918_length_506_cov_31.987715	129	209	21	2	80	0.0250000
NODE_39918_length_506_cov_31.987715	129	209	22	11	80	0.1375000
NODE_39918_length_506_cov_31.987715	129	209	23	1	80	0.0125000
NODE_39918_length_506_cov_31.987715	129	209	24	1	80	0.0125000
NODE_39918_length_506_cov_31.987715	129	209	25	3	80	0.0375000
NODE_39918_length_506_cov_31.987715	129	209	28	23	80	0.2875000
NODE_39918_length_506_cov_31.987715	129	209	30	9	80	0.1125000
NODE_39919_length_506_cov_15.877150	210	279	0	60	69	0.8695652
NODE_39919_length_506_cov_15.877150	210	279	2	9	69	0.1304348
NODE_39920_length_506_cov_15.461916	334	414	0	22	80	0.2750000
NODE_39920_length_506_cov_15.461916	334	414	2	12	80	0.1500000
NODE_39920_length_506_cov_15.461916	334	414	4	43	80	0.5375000
NODE_39920_length_506_cov_15.461916	334	414	8	3	80	0.0375000
NODE_39920_length_506_cov_15.461916	387	467	4	37	80	0.4625000
NODE_39920_length_506_cov_15.461916	387	467	6	20	80	0.2500000
NODE_39920_length_506_cov_15.461916	387	467	8	23	80	0.2875000
NODE_39921_length_506_cov_9.749386	197	276	0	12	79	0.1518987
NODE_39921_length_506_cov_9.749386	197	276	2	67	79	0.8481013
NODE_39921_length_506_cov_9.749386	249	329	2	80	80	1.0000000
NODE_39947_length_506_cov_3.122850	218	298	0	80	80	1.0000000
NODE_39947_length_506_cov_3.122850	271	351	0	80	80	1.0000000
NODE_39951_length_506_cov_2.894349	190	270	0	80	80	1.0000000
NODE_40133_length_505_cov_35.541872	373	453	0	19	80	0.2375000
NODE_40133_length_505_cov_35.541872	373	453	2	61	80	0.7625000
NODE_40135_length_505_cov_10.339901	30	110	0	23	80	0.2875000
NODE_40135_length_505_cov_10.339901	30	110	4	57	80	0.7125000
NODE_40135_length_505_cov_10.339901	83	163	0	43	80	0.5375000
NODE_40135_length_505_cov_10.339901	83	163	4	37	80	0.4625000
NODE_40158_length_505_cov_3.554187	225	305	0	80	80	1.0000000
NODE_40158_length_505_cov_3.554187	278	358	0	80	80	1.0000000
NODE_40160_length_505_cov_3.403941	207	287	0	80	80	1.0000000
NODE_40175_length_505_cov_2.975369	162	227	6	65	65	1.0000000
NODE_40222_length_505_cov_1.864532	55	126	0	65	71	0.9154930
NODE_40222_length_505_cov_1.864532	55	126	1	6	71	0.0845070
NODE_40368_length_504_cov_115.891358	122	202	384	1	80	0.0125000
NODE_40368_length_504_cov_115.891358	122	202	395	1	80	0.0125000
NODE_40368_length_504_cov_115.891358	122	202	417	1	80	0.0125000
NODE_40368_length_504_cov_115.891358	122	202	433	1	80	0.0125000
NODE_40368_length_504_cov_115.891358	122	202	435	1	80	0.0125000
NODE_40368_length_504_cov_115.891358	122	202	478	1	80	0.0125000
NODE_40368_length_504_cov_115.891358	122	202	490	1	80	0.0125000
NODE_40368_length_504_cov_115.891358	122	202	496	1	80	0.0125000
NODE_40368_length_504_cov_115.891358	122	202	500	1	80	0.0125000
NODE_40368_length_504_cov_115.891358	122	202	503	1	80	0.0125000
NODE_40368_length_504_cov_115.891358	122	202	527	1	80	0.0125000
NODE_40368_length_504_cov_115.891358	122	202	543	1	80	0.0125000
NODE_40368_length_504_cov_115.891358	122	202	544	2	80	0.0250000
NODE_40368_length_504_cov_115.891358	122	202	545	1	80	0.0125000
NODE_40368_length_504_cov_115.891358	122	202	552	1	80	0.0125000
NODE_40368_length_504_cov_115.891358	122	202	568	1	80	0.0125000
NODE_40368_length_504_cov_115.891358	122	202	573	1	80	0.0125000
NODE_40368_length_504_cov_115.891358	122	202	575	2	80	0.0250000
NODE_40368_length_504_cov_115.891358	122	202	582	1	80	0.0125000
NODE_40368_length_504_cov_115.891358	122	202	587	1	80	0.0125000
NODE_40368_length_504_cov_115.891358	122	202	594	1	80	0.0125000
NODE_40368_length_504_cov_115.891358	122	202	613	1	80	0.0125000
NODE_40368_length_504_cov_115.891358	122	202	614	1	80	0.0125000
NODE_40368_length_504_cov_115.891358	122	202	618	1	80	0.0125000
NODE_40368_length_504_cov_115.891358	122	202	620	1	80	0.0125000
NODE_40368_length_504_cov_115.891358	122	202	634	2	80	0.0250000
NODE_40368_length_504_cov_115.891358	122	202	662	1	80	0.0125000
NODE_40368_length_504_cov_115.891358	122	202	668	1	80	0.0125000
NODE_40368_length_504_cov_115.891358	122	202	678	1	80	0.0125000
NODE_40368_length_504_cov_115.891358	122	202	691	1	80	0.0125000
NODE_40368_length_504_cov_115.891358	122	202	692	2	80	0.0250000
NODE_40368_length_504_cov_115.891358	122	202	693	1	80	0.0125000
NODE_40368_length_504_cov_115.891358	122	202	697	1	80	0.0125000
NODE_40368_length_504_cov_115.891358	122	202	709	1	80	0.0125000
NODE_40368_length_504_cov_115.891358	122	202	715	3	80	0.0375000
NODE_40368_length_504_cov_115.891358	122	202	719	1	80	0.0125000
NODE_40368_length_504_cov_115.891358	122	202	723	1	80	0.0125000
NODE_40368_length_504_cov_115.891358	122	202	725	1	80	0.0125000
NODE_40368_length_504_cov_115.891358	122	202	740	1	80	0.0125000
NODE_40368_length_504_cov_115.891358	122	202	753	1	80	0.0125000
NODE_40368_length_504_cov_115.891358	122	202	763	1	80	0.0125000
NODE_40368_length_504_cov_115.891358	122	202	778	1	80	0.0125000
NODE_40368_length_504_cov_115.891358	122	202	782	1	80	0.0125000
NODE_40368_length_504_cov_115.891358	122	202	798	1	80	0.0125000
NODE_40368_length_504_cov_115.891358	122	202	800	2	80	0.0250000
NODE_40368_length_504_cov_115.891358	122	202	817	1	80	0.0125000
NODE_40368_length_504_cov_115.891358	122	202	820	1	80	0.0125000
NODE_40368_length_504_cov_115.891358	122	202	828	2	80	0.0250000
NODE_40368_length_504_cov_115.891358	122	202	829	1	80	0.0125000
NODE_40368_length_504_cov_115.891358	122	202	846	1	80	0.0125000
NODE_40368_length_504_cov_115.891358	122	202	853	1	80	0.0125000
NODE_40368_length_504_cov_115.891358	122	202	857	1	80	0.0125000
NODE_40368_length_504_cov_115.891358	122	202	864	1	80	0.0125000
NODE_40368_length_504_cov_115.891358	122	202	865	1	80	0.0125000
NODE_40368_length_504_cov_115.891358	122	202	882	1	80	0.0125000
NODE_40368_length_504_cov_115.891358	122	202	889	1	80	0.0125000
NODE_40368_length_504_cov_115.891358	122	202	901	1	80	0.0125000
NODE_40368_length_504_cov_115.891358	122	202	916	1	80	0.0125000
NODE_40368_length_504_cov_115.891358	122	202	924	1	80	0.0125000
NODE_40368_length_504_cov_115.891358	122	202	947	1	80	0.0125000
NODE_40368_length_504_cov_115.891358	122	202	954	1	80	0.0125000
NODE_40368_length_504_cov_115.891358	122	202	955	1	80	0.0125000
NODE_40368_length_504_cov_115.891358	122	202	956	2	80	0.0250000
NODE_40368_length_504_cov_115.891358	122	202	958	2	80	0.0250000
NODE_40368_length_504_cov_115.891358	122	202	965	1	80	0.0125000
NODE_40368_length_504_cov_115.891358	122	202	978	2	80	0.0250000
NODE_40368_length_504_cov_115.891358	122	202	979	1	80	0.0125000
NODE_40368_length_504_cov_115.891358	122	202	980	1	80	0.0125000
NODE_40368_length_504_cov_115.891358	122	202	984	1	80	0.0125000
NODE_40368_length_504_cov_115.891358	175	255	677	1	80	0.0125000
NODE_40368_length_504_cov_115.891358	175	255	685	1	80	0.0125000
NODE_40368_length_504_cov_115.891358	175	255	690	1	80	0.0125000
NODE_40368_length_504_cov_115.891358	175	255	692	1	80	0.0125000
NODE_40368_length_504_cov_115.891358	175	255	704	1	80	0.0125000
NODE_40368_length_504_cov_115.891358	175	255	714	1	80	0.0125000
NODE_40368_length_504_cov_115.891358	175	255	741	1	80	0.0125000
NODE_40368_length_504_cov_115.891358	175	255	758	1	80	0.0125000
NODE_40368_length_504_cov_115.891358	175	255	767	1	80	0.0125000
NODE_40368_length_504_cov_115.891358	175	255	778	1	80	0.0125000
NODE_40368_length_504_cov_115.891358	175	255	788	1	80	0.0125000
NODE_40368_length_504_cov_115.891358	175	255	790	1	80	0.0125000
NODE_40368_length_504_cov_115.891358	175	255	797	1	80	0.0125000
NODE_40368_length_504_cov_115.891358	175	255	798	1	80	0.0125000
NODE_40368_length_504_cov_115.891358	175	255	820	1	80	0.0125000
NODE_40368_length_504_cov_115.891358	175	255	823	1	80	0.0125000
NODE_40368_length_504_cov_115.891358	175	255	828	2	80	0.0250000
NODE_40368_length_504_cov_115.891358	175	255	829	1	80	0.0125000
NODE_40368_length_504_cov_115.891358	175	255	837	1	80	0.0125000
NODE_40368_length_504_cov_115.891358	175	255	846	1	80	0.0125000
NODE_40368_length_504_cov_115.891358	175	255	853	1	80	0.0125000
NODE_40368_length_504_cov_115.891358	175	255	857	1	80	0.0125000
NODE_40368_length_504_cov_115.891358	175	255	861	1	80	0.0125000
NODE_40368_length_504_cov_115.891358	175	255	863	1	80	0.0125000
NODE_40368_length_504_cov_115.891358	175	255	864	1	80	0.0125000
NODE_40368_length_504_cov_115.891358	175	255	865	1	80	0.0125000
NODE_40368_length_504_cov_115.891358	175	255	875	1	80	0.0125000
NODE_40368_length_504_cov_115.891358	175	255	880	1	80	0.0125000
NODE_40368_length_504_cov_115.891358	175	255	882	1	80	0.0125000
NODE_40368_length_504_cov_115.891358	175	255	889	1	80	0.0125000
NODE_40368_length_504_cov_115.891358	175	255	890	1	80	0.0125000
NODE_40368_length_504_cov_115.891358	175	255	897	1	80	0.0125000
NODE_40368_length_504_cov_115.891358	175	255	900	1	80	0.0125000
NODE_40368_length_504_cov_115.891358	175	255	901	1	80	0.0125000
NODE_40368_length_504_cov_115.891358	175	255	909	2	80	0.0250000
NODE_40368_length_504_cov_115.891358	175	255	916	1	80	0.0125000
NODE_40368_length_504_cov_115.891358	175	255	923	1	80	0.0125000
NODE_40368_length_504_cov_115.891358	175	255	924	1	80	0.0125000
NODE_40368_length_504_cov_115.891358	175	255	926	2	80	0.0250000
NODE_40368_length_504_cov_115.891358	175	255	928	1	80	0.0125000
NODE_40368_length_504_cov_115.891358	175	255	940	1	80	0.0125000
NODE_40368_length_504_cov_115.891358	175	255	941	1	80	0.0125000
NODE_40368_length_504_cov_115.891358	175	255	944	1	80	0.0125000
NODE_40368_length_504_cov_115.891358	175	255	947	1	80	0.0125000
NODE_40368_length_504_cov_115.891358	175	255	949	2	80	0.0250000
NODE_40368_length_504_cov_115.891358	175	255	954	1	80	0.0125000
NODE_40368_length_504_cov_115.891358	175	255	955	1	80	0.0125000
NODE_40368_length_504_cov_115.891358	175	255	956	2	80	0.0250000
NODE_40368_length_504_cov_115.891358	175	255	957	2	80	0.0250000
NODE_40368_length_504_cov_115.891358	175	255	958	2	80	0.0250000
NODE_40368_length_504_cov_115.891358	175	255	961	1	80	0.0125000
NODE_40368_length_504_cov_115.891358	175	255	962	1	80	0.0125000
NODE_40368_length_504_cov_115.891358	175	255	965	1	80	0.0125000
NODE_40368_length_504_cov_115.891358	175	255	968	1	80	0.0125000
NODE_40368_length_504_cov_115.891358	175	255	971	1	80	0.0125000
NODE_40368_length_504_cov_115.891358	175	255	972	1	80	0.0125000
NODE_40368_length_504_cov_115.891358	175	255	975	2	80	0.0250000
NODE_40368_length_504_cov_115.891358	175	255	976	1	80	0.0125000
NODE_40368_length_504_cov_115.891358	175	255	977	1	80	0.0125000
NODE_40368_length_504_cov_115.891358	175	255	978	3	80	0.0375000
NODE_40368_length_504_cov_115.891358	175	255	979	1	80	0.0125000
NODE_40368_length_504_cov_115.891358	175	255	980	2	80	0.0250000
NODE_40368_length_504_cov_115.891358	175	255	981	1	80	0.0125000
NODE_40368_length_504_cov_115.891358	175	255	982	2	80	0.0250000
NODE_40368_length_504_cov_115.891358	175	255	984	1	80	0.0125000
NODE_40368_length_504_cov_115.891358	175	255	986	1	80	0.0125000
NODE_40368_length_504_cov_115.891358	175	255	987	1	80	0.0125000
NODE_40368_length_504_cov_115.891358	175	255	988	1	80	0.0125000
NODE_40369_length_504_cov_33.360494	28	108	0	80	80	1.0000000
NODE_40369_length_504_cov_33.360494	81	161	0	80	80	1.0000000
NODE_40370_length_504_cov_15.669136	176	256	0	80	80	1.0000000
NODE_40370_length_504_cov_15.669136	229	309	0	80	80	1.0000000
NODE_40371_length_504_cov_13.202469	134	215	0	74	81	0.9135802
NODE_40371_length_504_cov_13.202469	134	215	3	7	81	0.0864198
NODE_40371_length_504_cov_13.202469	188	268	0	80	80	1.0000000
NODE_40377_length_504_cov_6.770370	55	135	0	80	80	1.0000000
NODE_40377_length_504_cov_6.770370	108	188	0	80	80	1.0000000
NODE_40427_length_504_cov_2.234568	359	407	7	48	48	1.0000000
NODE_40428_length_504_cov_2.227160	307	370	0	63	63	1.0000000
NODE_40434_length_504_cov_2.116049	245	325	0	61	80	0.7625000
NODE_40434_length_504_cov_2.116049	245	325	1	19	80	0.2375000
NODE_40434_length_504_cov_2.116049	298	378	0	8	80	0.1000000
NODE_40434_length_504_cov_2.116049	298	378	1	38	80	0.4750000
NODE_40434_length_504_cov_2.116049	298	378	2	34	80	0.4250000
NODE_40446_length_504_cov_1.925926	196	262	2	3	66	0.0454545
NODE_40446_length_504_cov_1.925926	196	262	4	63	66	0.9545454
NODE_40601_length_503_cov_11.356436	268	348	0	80	80	1.0000000
NODE_40601_length_503_cov_11.356436	321	401	0	80	80	1.0000000
NODE_40615_length_503_cov_5.537129	314	381	0	67	67	1.0000000
NODE_40645_length_503_cov_3.012376	264	285	0	21	21	1.0000000
NODE_40652_length_503_cov_2.757426	266	334	2	5	68	0.0735294
NODE_40652_length_503_cov_2.757426	266	334	4	63	68	0.9264706
NODE_40652_length_503_cov_2.757426	307	387	0	4	80	0.0500000
NODE_40652_length_503_cov_2.757426	307	387	2	29	80	0.3625000
NODE_40652_length_503_cov_2.757426	307	387	4	47	80	0.5875000
NODE_40655_length_503_cov_2.705446	158	237	0	79	79	1.0000000
NODE_40655_length_503_cov_2.705446	211	291	0	80	80	1.0000000
NODE_40656_length_503_cov_2.705446	251	331	5	1	80	0.0125000
NODE_40656_length_503_cov_2.705446	251	331	9	8	80	0.1000000
NODE_40656_length_503_cov_2.705446	251	331	10	47	80	0.5875000
NODE_40656_length_503_cov_2.705446	251	331	11	17	80	0.2125000
NODE_40656_length_503_cov_2.705446	251	331	12	7	80	0.0875000
NODE_40656_length_503_cov_2.705446	251	321	9	5	70	0.0714286
NODE_40656_length_503_cov_2.705446	251	321	10	41	70	0.5857143
NODE_40656_length_503_cov_2.705446	251	321	11	17	70	0.2428571
NODE_40656_length_503_cov_2.705446	251	321	12	7	70	0.1000000
NODE_40656_length_503_cov_2.705446	330	384	4	30	54	0.5555556
NODE_40656_length_503_cov_2.705446	330	384	5	16	54	0.2962963
NODE_40656_length_503_cov_2.705446	330	384	7	8	54	0.1481481
NODE_40656_length_503_cov_2.705446	338	384	4	30	46	0.6521739
NODE_40656_length_503_cov_2.705446	338	384	5	13	46	0.2826087
NODE_40656_length_503_cov_2.705446	338	384	7	3	46	0.0652174
NODE_40664_length_503_cov_2.584158	95	163	0	68	68	1.0000000
NODE_40857_length_502_cov_45.292804	353	433	12	2	80	0.0250000
NODE_40857_length_502_cov_45.292804	353	433	15	6	80	0.0750000
NODE_40857_length_502_cov_45.292804	353	433	18	52	80	0.6500000
NODE_40857_length_502_cov_45.292804	353	433	19	1	80	0.0125000
NODE_40857_length_502_cov_45.292804	353	433	20	16	80	0.2000000
NODE_40857_length_502_cov_45.292804	353	433	21	3	80	0.0375000
NODE_40864_length_502_cov_5.980149	305	381	5	3	76	0.0394737
NODE_40864_length_502_cov_5.980149	305	381	8	1	76	0.0131579
NODE_40864_length_502_cov_5.980149	305	381	9	1	76	0.0131579
NODE_40864_length_502_cov_5.980149	305	381	10	19	76	0.2500000
NODE_40864_length_502_cov_5.980149	305	381	13	1	76	0.0131579
NODE_40864_length_502_cov_5.980149	305	381	14	4	76	0.0526316
NODE_40864_length_502_cov_5.980149	305	381	15	13	76	0.1710526
NODE_40864_length_502_cov_5.980149	305	381	17	28	76	0.3684210
NODE_40864_length_502_cov_5.980149	305	381	19	6	76	0.0789474
NODE_41070_length_501_cov_208.708955	288	350	95	3	62	0.0483871
NODE_41070_length_501_cov_208.708955	288	350	110	1	62	0.0161290
NODE_41070_length_501_cov_208.708955	288	350	129	1	62	0.0161290
NODE_41070_length_501_cov_208.708955	288	350	140	1	62	0.0161290
NODE_41070_length_501_cov_208.708955	288	350	152	1	62	0.0161290
NODE_41070_length_501_cov_208.708955	288	350	170	3	62	0.0483871
NODE_41070_length_501_cov_208.708955	288	350	183	1	62	0.0161290
NODE_41070_length_501_cov_208.708955	288	350	190	1	62	0.0161290
NODE_41070_length_501_cov_208.708955	288	350	198	1	62	0.0161290
NODE_41070_length_501_cov_208.708955	288	350	204	1	62	0.0161290
NODE_41070_length_501_cov_208.708955	288	350	216	1	62	0.0161290
NODE_41070_length_501_cov_208.708955	288	350	220	1	62	0.0161290
NODE_41070_length_501_cov_208.708955	288	350	229	1	62	0.0161290
NODE_41070_length_501_cov_208.708955	288	350	231	2	62	0.0322581
NODE_41070_length_501_cov_208.708955	288	350	236	1	62	0.0161290
NODE_41070_length_501_cov_208.708955	288	350	237	1	62	0.0161290
NODE_41070_length_501_cov_208.708955	288	350	245	1	62	0.0161290
NODE_41070_length_501_cov_208.708955	288	350	251	1	62	0.0161290
NODE_41070_length_501_cov_208.708955	288	350	256	2	62	0.0322581
NODE_41070_length_501_cov_208.708955	288	350	257	3	62	0.0483871
NODE_41070_length_501_cov_208.708955	288	350	261	1	62	0.0161290
NODE_41070_length_501_cov_208.708955	288	350	273	1	62	0.0161290
NODE_41070_length_501_cov_208.708955	288	350	277	1	62	0.0161290
NODE_41070_length_501_cov_208.708955	288	350	284	1	62	0.0161290
NODE_41070_length_501_cov_208.708955	288	350	285	1	62	0.0161290
NODE_41070_length_501_cov_208.708955	288	350	286	2	62	0.0322581
NODE_41070_length_501_cov_208.708955	288	350	291	3	62	0.0483871
NODE_41070_length_501_cov_208.708955	288	350	292	2	62	0.0322581
NODE_41070_length_501_cov_208.708955	288	350	293	1	62	0.0161290
NODE_41070_length_501_cov_208.708955	288	350	295	1	62	0.0161290
NODE_41070_length_501_cov_208.708955	288	350	296	1	62	0.0161290
NODE_41070_length_501_cov_208.708955	288	350	297	5	62	0.0806452
NODE_41070_length_501_cov_208.708955	288	350	298	3	62	0.0483871
NODE_41070_length_501_cov_208.708955	288	350	299	6	62	0.0967742
NODE_41070_length_501_cov_208.708955	288	350	300	4	62	0.0645161
NODE_41070_length_501_cov_208.708955	288	350	301	1	62	0.0161290
NODE_41070_length_501_cov_208.708955	327	413	155	3	86	0.0348837
NODE_41070_length_501_cov_208.708955	327	413	160	1	86	0.0116279
NODE_41070_length_501_cov_208.708955	327	413	161	1	86	0.0116279
NODE_41070_length_501_cov_208.708955	327	413	163	1	86	0.0116279
NODE_41070_length_501_cov_208.708955	327	413	167	1	86	0.0116279
NODE_41070_length_501_cov_208.708955	327	413	177	1	86	0.0116279
NODE_41070_length_501_cov_208.708955	327	413	199	3	86	0.0348837
NODE_41070_length_501_cov_208.708955	327	413	207	1	86	0.0116279
NODE_41070_length_501_cov_208.708955	327	413	209	1	86	0.0116279
NODE_41070_length_501_cov_208.708955	327	413	219	1	86	0.0116279
NODE_41070_length_501_cov_208.708955	327	413	221	1	86	0.0116279
NODE_41070_length_501_cov_208.708955	327	413	257	1	86	0.0116279
NODE_41070_length_501_cov_208.708955	327	413	259	8	86	0.0930233
NODE_41070_length_501_cov_208.708955	327	413	260	2	86	0.0232558
NODE_41070_length_501_cov_208.708955	327	413	264	1	86	0.0116279
NODE_41070_length_501_cov_208.708955	327	413	271	1	86	0.0116279
NODE_41070_length_501_cov_208.708955	327	413	272	1	86	0.0116279
NODE_41070_length_501_cov_208.708955	327	413	276	5	86	0.0581395
NODE_41070_length_501_cov_208.708955	327	413	278	3	86	0.0348837
NODE_41070_length_501_cov_208.708955	327	413	279	3	86	0.0348837
NODE_41070_length_501_cov_208.708955	327	413	282	1	86	0.0116279
NODE_41070_length_501_cov_208.708955	327	413	283	3	86	0.0348837
NODE_41070_length_501_cov_208.708955	327	413	284	1	86	0.0116279
NODE_41070_length_501_cov_208.708955	327	413	285	4	86	0.0465116
NODE_41070_length_501_cov_208.708955	327	413	291	1	86	0.0116279
NODE_41070_length_501_cov_208.708955	327	413	292	3	86	0.0348837
NODE_41070_length_501_cov_208.708955	327	413	293	1	86	0.0116279
NODE_41070_length_501_cov_208.708955	327	413	294	6	86	0.0697674
NODE_41070_length_501_cov_208.708955	327	413	295	1	86	0.0116279
NODE_41070_length_501_cov_208.708955	327	413	296	2	86	0.0232558
NODE_41070_length_501_cov_208.708955	327	413	297	4	86	0.0465116
NODE_41070_length_501_cov_208.708955	327	413	298	4	86	0.0465116
NODE_41070_length_501_cov_208.708955	327	413	299	8	86	0.0930233
NODE_41070_length_501_cov_208.708955	327	413	300	4	86	0.0465116
NODE_41070_length_501_cov_208.708955	327	413	301	1	86	0.0116279
NODE_41070_length_501_cov_208.708955	327	413	303	1	86	0.0116279
NODE_41070_length_501_cov_208.708955	327	413	304	1	86	0.0116279
NODE_41071_length_501_cov_29.126866	23	103	0	80	80	1.0000000
NODE_41071_length_501_cov_29.126866	76	156	0	80	80	1.0000000
NODE_41072_length_501_cov_23.736318	85	165	0	22	80	0.2750000
NODE_41072_length_501_cov_23.736318	85	165	2	4	80	0.0500000
NODE_41072_length_501_cov_23.736318	85	165	6	54	80	0.6750000
NODE_41072_length_501_cov_23.736318	138	218	4	3	80	0.0375000
NODE_41072_length_501_cov_23.736318	138	218	6	77	80	0.9625000
NODE_41075_length_501_cov_7.820896	270	350	0	80	80	1.0000000
NODE_41075_length_501_cov_7.820896	323	403	0	29	80	0.3625000
NODE_41075_length_501_cov_7.820896	323	403	2	51	80	0.6375000
NODE_41080_length_501_cov_6.437811	309	389	4	80	80	1.0000000
NODE_41097_length_501_cov_3.656716	289	312	0	23	23	1.0000000
NODE_41097_length_501_cov_3.656716	355	420	0	65	65	1.0000000
NODE_41103_length_501_cov_3.477612	329	409	2	9	80	0.1125000
NODE_41103_length_501_cov_3.477612	329	409	4	71	80	0.8875000
NODE_41109_length_501_cov_3.134328	266	345	0	79	79	1.0000000
NODE_41308_length_500_cov_77.895262	456	500	0	44	44	1.0000000
NODE_41309_length_500_cov_35.805486	326	406	0	80	80	1.0000000
NODE_41309_length_500_cov_35.805486	379	459	0	80	80	1.0000000
NODE_41310_length_500_cov_13.084788	160	221	0	24	61	0.3934426
NODE_41310_length_500_cov_13.084788	160	221	2	3	61	0.0491803
NODE_41310_length_500_cov_13.084788	160	221	6	34	61	0.5573770
NODE_41311_length_500_cov_12.650873	215	295	0	80	80	1.0000000
NODE_41311_length_500_cov_12.650873	268	348	0	80	80	1.0000000
NODE_41312_length_500_cov_12.009975	203	268	0	13	65	0.2000000
NODE_41312_length_500_cov_12.009975	203	268	2	4	65	0.0615385
NODE_41312_length_500_cov_12.009975	203	268	4	3	65	0.0461538
NODE_41312_length_500_cov_12.009975	203	268	6	34	65	0.5230770
NODE_41312_length_500_cov_12.009975	203	268	12	11	65	0.1692308
NODE_41312_length_500_cov_12.009975	241	321	6	16	80	0.2000000
NODE_41312_length_500_cov_12.009975	241	321	10	40	80	0.5000000
NODE_41312_length_500_cov_12.009975	241	321	12	24	80	0.3000000
NODE_41325_length_500_cov_4.653367	224	295	0	71	71	1.0000000
NODE_41415_length_500_cov_1.650873	355	435	0	80	80	1.0000000
NODE_41415_length_500_cov_1.650873	408	488	0	80	80	1.0000000
NODE_41462_length_500_cov_1.231920	169	212	0	43	43	1.0000000
NODE_41542_length_499_cov_358.730000	425	492	46	1	67	0.0149254
NODE_41542_length_499_cov_358.730000	425	492	50	1	67	0.0149254
NODE_41542_length_499_cov_358.730000	425	492	52	1	67	0.0149254
NODE_41542_length_499_cov_358.730000	425	492	57	1	67	0.0149254
NODE_41542_length_499_cov_358.730000	425	492	66	1	67	0.0149254
NODE_41542_length_499_cov_358.730000	425	492	68	1	67	0.0149254
NODE_41542_length_499_cov_358.730000	425	492	78	1	67	0.0149254
NODE_41542_length_499_cov_358.730000	425	492	82	1	67	0.0149254
NODE_41542_length_499_cov_358.730000	425	492	85	1	67	0.0149254
NODE_41542_length_499_cov_358.730000	425	492	91	1	67	0.0149254
NODE_41542_length_499_cov_358.730000	425	492	95	2	67	0.0298507
NODE_41542_length_499_cov_358.730000	425	492	99	3	67	0.0447761
NODE_41542_length_499_cov_358.730000	425	492	101	1	67	0.0149254
NODE_41542_length_499_cov_358.730000	425	492	103	1	67	0.0149254
NODE_41542_length_499_cov_358.730000	425	492	106	1	67	0.0149254
NODE_41542_length_499_cov_358.730000	425	492	112	1	67	0.0149254
NODE_41542_length_499_cov_358.730000	425	492	114	1	67	0.0149254
NODE_41542_length_499_cov_358.730000	425	492	118	1	67	0.0149254
NODE_41542_length_499_cov_358.730000	425	492	121	1	67	0.0149254
NODE_41542_length_499_cov_358.730000	425	492	124	1	67	0.0149254
NODE_41542_length_499_cov_358.730000	425	492	125	2	67	0.0298507
NODE_41542_length_499_cov_358.730000	425	492	133	2	67	0.0298507
NODE_41542_length_499_cov_358.730000	425	492	135	1	67	0.0149254
NODE_41542_length_499_cov_358.730000	425	492	137	1	67	0.0149254
NODE_41542_length_499_cov_358.730000	425	492	138	3	67	0.0447761
NODE_41542_length_499_cov_358.730000	425	492	140	3	67	0.0447761
NODE_41542_length_499_cov_358.730000	425	492	142	3	67	0.0447761
NODE_41542_length_499_cov_358.730000	425	492	144	1	67	0.0149254
NODE_41542_length_499_cov_358.730000	425	492	150	1	67	0.0149254
NODE_41542_length_499_cov_358.730000	425	492	152	1	67	0.0149254
NODE_41542_length_499_cov_358.730000	425	492	154	1	67	0.0149254
NODE_41542_length_499_cov_358.730000	425	492	157	1	67	0.0149254
NODE_41542_length_499_cov_358.730000	425	492	160	1	67	0.0149254
NODE_41542_length_499_cov_358.730000	425	492	165	1	67	0.0149254
NODE_41542_length_499_cov_358.730000	425	492	171	1	67	0.0149254
NODE_41542_length_499_cov_358.730000	425	492	173	2	67	0.0298507
NODE_41542_length_499_cov_358.730000	425	492	177	1	67	0.0149254
NODE_41542_length_499_cov_358.730000	425	492	179	3	67	0.0447761
NODE_41542_length_499_cov_358.730000	425	492	181	2	67	0.0298507
NODE_41542_length_499_cov_358.730000	425	492	182	2	67	0.0298507
NODE_41542_length_499_cov_358.730000	425	492	184	3	67	0.0447761
NODE_41542_length_499_cov_358.730000	425	492	186	1	67	0.0149254
NODE_41542_length_499_cov_358.730000	425	492	192	2	67	0.0298507
NODE_41542_length_499_cov_358.730000	425	492	194	1	67	0.0149254
NODE_41542_length_499_cov_358.730000	425	492	196	1	67	0.0149254
NODE_41542_length_499_cov_358.730000	425	492	198	1	67	0.0149254
NODE_41542_length_499_cov_358.730000	425	492	199	1	67	0.0149254
NODE_41542_length_499_cov_358.730000	425	492	200	1	67	0.0149254
NODE_41543_length_499_cov_21.135000	52	132	0	80	80	1.0000000
NODE_41543_length_499_cov_21.135000	105	185	0	80	80	1.0000000
NODE_41544_length_499_cov_11.917500	50	130	0	35	80	0.4375000
NODE_41544_length_499_cov_11.917500	50	130	2	45	80	0.5625000
NODE_41544_length_499_cov_11.917500	103	183	0	20	80	0.2500000
NODE_41544_length_499_cov_11.917500	103	183	2	60	80	0.7500000
NODE_41549_length_499_cov_5.007500	0	54	0	54	54	1.0000000
NODE_41563_length_499_cov_3.482500	307	336	14	27	29	0.9310345
NODE_41563_length_499_cov_3.482500	307	336	16	2	29	0.0689655
NODE_41594_length_499_cov_2.420000	198	247	0	49	49	1.0000000
NODE_41662_length_499_cov_1.445000	311	372	0	61	61	1.0000000
NODE_41770_length_498_cov_31.704261	12	92	0	80	80	1.0000000
NODE_41770_length_498_cov_31.704261	65	145	0	80	80	1.0000000
NODE_41775_length_498_cov_7.002506	256	336	2	29	80	0.3625000
NODE_41775_length_498_cov_7.002506	256	336	4	51	80	0.6375000
NODE_41780_length_498_cov_5.759398	217	247	0	30	30	1.0000000
NODE_41814_length_498_cov_3.075188	225	262	2	12	37	0.3243243
NODE_41814_length_498_cov_3.075188	225	262	4	6	37	0.1621622
NODE_41814_length_498_cov_3.075188	225	262	6	2	37	0.0540541
NODE_41814_length_498_cov_3.075188	225	262	8	4	37	0.1081081
NODE_41814_length_498_cov_3.075188	225	262	10	8	37	0.2162162
NODE_41814_length_498_cov_3.075188	225	262	12	5	37	0.1351351
NODE_41814_length_498_cov_3.075188	246	324	8	3	78	0.0384615
NODE_41814_length_498_cov_3.075188	246	324	10	8	78	0.1025641
NODE_41814_length_498_cov_3.075188	246	324	12	8	78	0.1025641
NODE_41814_length_498_cov_3.075188	246	324	16	58	78	0.7435898
NODE_41814_length_498_cov_3.075188	246	324	18	1	78	0.0128205
NODE_42016_length_497_cov_44.105528	169	249	0	80	80	1.0000000
NODE_42016_length_497_cov_44.105528	222	302	0	80	80	1.0000000
NODE_42017_length_497_cov_10.145729	85	165	0	25	80	0.3125000
NODE_42017_length_497_cov_10.145729	85	165	2	11	80	0.1375000
NODE_42017_length_497_cov_10.145729	85	165	4	44	80	0.5500000
NODE_42017_length_497_cov_10.145729	138	226	2	3	88	0.0340909
NODE_42017_length_497_cov_10.145729	138	226	4	85	88	0.9659091
NODE_42024_length_497_cov_6.618090	231	304	0	73	73	1.0000000
NODE_42024_length_497_cov_6.618090	284	364	0	80	80	1.0000000
NODE_42065_length_497_cov_2.889447	109	189	0	33	80	0.4125000
NODE_42065_length_497_cov_2.889447	109	189	4	47	80	0.5875000
NODE_42065_length_497_cov_2.889447	162	242	4	80	80	1.0000000
NODE_42071_length_497_cov_2.623116	302	368	4	11	66	0.1666667
NODE_42071_length_497_cov_2.623116	302	368	6	2	66	0.0303030
NODE_42071_length_497_cov_2.623116	302	368	8	3	66	0.0454545
NODE_42071_length_497_cov_2.623116	302	368	10	29	66	0.4393939
NODE_42071_length_497_cov_2.623116	302	368	12	21	66	0.3181818
NODE_42071_length_497_cov_2.623116	355	406	10	7	51	0.1372549
NODE_42071_length_497_cov_2.623116	355	406	12	44	51	0.8627451
NODE_42100_length_497_cov_1.909548	106	186	20	1	80	0.0125000
NODE_42100_length_497_cov_1.909548	106	186	22	6	80	0.0750000
NODE_42100_length_497_cov_1.909548	106	186	24	1	80	0.0125000
NODE_42100_length_497_cov_1.909548	106	186	28	2	80	0.0250000
NODE_42100_length_497_cov_1.909548	106	186	32	2	80	0.0250000
NODE_42100_length_497_cov_1.909548	106	186	40	18	80	0.2250000
NODE_42100_length_497_cov_1.909548	106	186	44	12	80	0.1500000
NODE_42100_length_497_cov_1.909548	106	186	46	9	80	0.1125000
NODE_42100_length_497_cov_1.909548	106	186	47	1	80	0.0125000
NODE_42100_length_497_cov_1.909548	106	186	48	1	80	0.0125000
NODE_42100_length_497_cov_1.909548	106	186	49	1	80	0.0125000
NODE_42100_length_497_cov_1.909548	106	186	51	8	80	0.1000000
NODE_42100_length_497_cov_1.909548	106	186	53	18	80	0.2250000
NODE_42100_length_497_cov_1.909548	159	240	37	7	81	0.0864198
NODE_42100_length_497_cov_1.909548	159	240	39	2	81	0.0246914
NODE_42100_length_497_cov_1.909548	159	240	41	2	81	0.0246914
NODE_42100_length_497_cov_1.909548	159	240	45	2	81	0.0246914
NODE_42100_length_497_cov_1.909548	159	240	49	1	81	0.0123457
NODE_42100_length_497_cov_1.909548	159	240	51	18	81	0.2222222
NODE_42100_length_497_cov_1.909548	159	240	53	23	81	0.2839506
NODE_42100_length_497_cov_1.909548	159	240	55	6	81	0.0740741
NODE_42100_length_497_cov_1.909548	159	240	57	3	81	0.0370370
NODE_42100_length_497_cov_1.909548	159	240	59	2	81	0.0246914
NODE_42100_length_497_cov_1.909548	159	240	61	7	81	0.0864198
NODE_42100_length_497_cov_1.909548	159	240	63	4	81	0.0493827
NODE_42100_length_497_cov_1.909548	159	240	67	4	81	0.0493827
NODE_42100_length_497_cov_1.909548	262	324	10	1	62	0.0161290
NODE_42100_length_497_cov_1.909548	262	324	12	5	62	0.0806452
NODE_42100_length_497_cov_1.909548	262	324	16	2	62	0.0322581
NODE_42100_length_497_cov_1.909548	262	324	18	2	62	0.0322581
NODE_42100_length_497_cov_1.909548	262	324	20	3	62	0.0483871
NODE_42100_length_497_cov_1.909548	262	324	24	1	62	0.0161290
NODE_42100_length_497_cov_1.909548	262	324	33	1	62	0.0161290
NODE_42100_length_497_cov_1.909548	262	324	37	6	62	0.0967742
NODE_42100_length_497_cov_1.909548	262	324	42	3	62	0.0483871
NODE_42100_length_497_cov_1.909548	262	324	46	2	62	0.0322581
NODE_42100_length_497_cov_1.909548	262	324	48	6	62	0.0967742
NODE_42100_length_497_cov_1.909548	262	324	50	7	62	0.1129032
NODE_42100_length_497_cov_1.909548	262	324	51	1	62	0.0161290
NODE_42100_length_497_cov_1.909548	262	324	52	1	62	0.0161290
NODE_42100_length_497_cov_1.909548	262	324	53	2	62	0.0322581
NODE_42100_length_497_cov_1.909548	262	324	55	2	62	0.0322581
NODE_42100_length_497_cov_1.909548	262	324	57	17	62	0.2741936
NODE_42131_length_497_cov_1.500000	259	339	0	80	80	1.0000000
NODE_42136_length_497_cov_1.404523	211	263	0	52	52	1.0000000
NODE_42279_length_496_cov_5.619647	239	269	0	30	30	1.0000000
NODE_42281_length_496_cov_5.392947	103	168	0	65	65	1.0000000
NODE_42281_length_496_cov_5.392947	141	221	0	65	80	0.8125000
NODE_42281_length_496_cov_5.392947	141	221	2	15	80	0.1875000
NODE_42281_length_496_cov_5.392947	217	295	2	78	78	1.0000000
NODE_42281_length_496_cov_5.392947	270	295	2	25	25	1.0000000
NODE_42287_length_496_cov_4.397985	388	467	2	22	79	0.2784810
NODE_42287_length_496_cov_4.397985	388	467	3	19	79	0.2405063
NODE_42287_length_496_cov_4.397985	388	467	4	38	79	0.4810127
NODE_42288_length_496_cov_4.193955	235	315	3	5	80	0.0625000
NODE_42288_length_496_cov_4.193955	235	315	4	14	80	0.1750000
NODE_42288_length_496_cov_4.193955	235	315	6	51	80	0.6375000
NODE_42288_length_496_cov_4.193955	235	315	7	10	80	0.1250000
NODE_42297_length_496_cov_3.531486	192	273	2	14	81	0.1728395
NODE_42297_length_496_cov_3.531486	192	273	3	7	81	0.0864198
NODE_42297_length_496_cov_3.531486	192	273	4	5	81	0.0617284
NODE_42297_length_496_cov_3.531486	192	273	6	4	81	0.0493827
NODE_42297_length_496_cov_3.531486	192	273	7	1	81	0.0123457
NODE_42297_length_496_cov_3.531486	192	273	12	25	81	0.3086420
NODE_42297_length_496_cov_3.531486	192	273	14	25	81	0.3086420
NODE_42297_length_496_cov_3.531486	245	325	12	67	80	0.8375000
NODE_42297_length_496_cov_3.531486	245	325	14	13	80	0.1625000
NODE_42298_length_496_cov_3.377834	252	332	0	80	80	1.0000000
NODE_42298_length_496_cov_3.377834	305	383	0	78	78	1.0000000
NODE_42316_length_496_cov_2.659950	203	251	0	3	48	0.0625000
NODE_42316_length_496_cov_2.659950	203	251	2	45	48	0.9375000
NODE_42328_length_496_cov_2.445844	95	165	2	34	70	0.4857143
NODE_42328_length_496_cov_2.445844	95	165	4	36	70	0.5142857
NODE_42328_length_496_cov_2.445844	148	228	1	20	80	0.2500000
NODE_42328_length_496_cov_2.445844	148	228	2	60	80	0.7500000
NODE_42333_length_496_cov_2.214106	299	359	14	60	60	1.0000000
NODE_42415_length_496_cov_1.395466	273	317	9	2	44	0.0454545
NODE_42415_length_496_cov_1.395466	273	317	10	42	44	0.9545454
NODE_42461_length_496_cov_0.979849	214	294	0	80	80	1.0000000
NODE_42525_length_495_cov_34.888889	209	264	0	55	55	1.0000000
NODE_42526_length_495_cov_12.800505	268	348	0	80	80	1.0000000
NODE_42526_length_495_cov_12.800505	321	401	0	80	80	1.0000000
NODE_42529_length_495_cov_7.080808	386	416	0	30	30	1.0000000
NODE_42548_length_495_cov_3.868687	218	298	0	30	80	0.3750000
NODE_42548_length_495_cov_3.868687	218	298	2	50	80	0.6250000
NODE_42736_length_495_cov_0.792929	274	309	5	35	35	1.0000000
NODE_42773_length_494_cov_20.096203	182	262	0	11	80	0.1375000
NODE_42773_length_494_cov_20.096203	182	262	2	4	80	0.0500000
NODE_42773_length_494_cov_20.096203	182	262	4	46	80	0.5750000
NODE_42773_length_494_cov_20.096203	182	262	6	19	80	0.2375000
NODE_42773_length_494_cov_20.096203	235	315	2	57	80	0.7125000
NODE_42773_length_494_cov_20.096203	235	315	4	4	80	0.0500000
NODE_42773_length_494_cov_20.096203	235	315	6	19	80	0.2375000
NODE_42778_length_494_cov_7.498734	187	240	0	53	53	1.0000000
NODE_42788_length_494_cov_4.283544	255	332	0	77	77	1.0000000
NODE_42804_length_494_cov_3.496203	209	276	0	67	67	1.0000000
NODE_42812_length_494_cov_3.032911	385	432	6	33	47	0.7021276
NODE_42812_length_494_cov_3.032911	385	432	8	14	47	0.2978723
NODE_42816_length_494_cov_2.908861	189	269	4	7	80	0.0875000
NODE_42816_length_494_cov_2.908861	189	269	6	56	80	0.7000000
NODE_42816_length_494_cov_2.908861	189	269	8	17	80	0.2125000
NODE_42822_length_494_cov_2.777215	145	188	0	43	43	1.0000000
NODE_42834_length_494_cov_2.531646	371	430	2	5	59	0.0847458
NODE_42834_length_494_cov_2.531646	371	430	4	54	59	0.9152542
NODE_42834_length_494_cov_2.531646	428	494	0	19	66	0.2878788
NODE_42834_length_494_cov_2.531646	428	494	1	1	66	0.0151515
NODE_42834_length_494_cov_2.531646	428	494	2	24	66	0.3636364
NODE_42834_length_494_cov_2.531646	428	494	4	22	66	0.3333333
NODE_43021_length_493_cov_34.946701	140	220	7	2	80	0.0250000
NODE_43021_length_493_cov_34.946701	140	220	11	1	80	0.0125000
NODE_43021_length_493_cov_34.946701	140	220	13	13	80	0.1625000
NODE_43021_length_493_cov_34.946701	140	220	14	64	80	0.8000000
NODE_43021_length_493_cov_34.946701	193	265	13	54	72	0.7500000
NODE_43021_length_493_cov_34.946701	193	265	14	18	72	0.2500000
NODE_43022_length_493_cov_12.451777	173	253	0	80	80	1.0000000
NODE_43022_length_493_cov_12.451777	226	306	0	80	80	1.0000000
NODE_43025_length_493_cov_8.540609	116	146	8	3	30	0.1000000
NODE_43025_length_493_cov_8.540609	116	146	9	15	30	0.5000000
NODE_43025_length_493_cov_8.540609	116	146	10	12	30	0.4000000
NODE_43025_length_493_cov_8.540609	119	199	9	15	80	0.1875000
NODE_43025_length_493_cov_8.540609	119	199	10	13	80	0.1625000
NODE_43025_length_493_cov_8.540609	119	199	12	18	80	0.2250000
NODE_43025_length_493_cov_8.540609	119	199	14	29	80	0.3625000
NODE_43025_length_493_cov_8.540609	119	199	18	5	80	0.0625000
NODE_43031_length_493_cov_6.144670	300	380	0	80	80	1.0000000
NODE_43031_length_493_cov_6.144670	353	433	0	80	80	1.0000000
NODE_43046_length_493_cov_3.840102	178	258	0	80	80	1.0000000
NODE_43046_length_493_cov_3.840102	231	311	0	41	80	0.5125000
NODE_43046_length_493_cov_3.840102	231	311	1	4	80	0.0500000
NODE_43046_length_493_cov_3.840102	231	311	2	35	80	0.4375000
NODE_43125_length_493_cov_1.588832	126	206	0	80	80	1.0000000
NODE_43125_length_493_cov_1.588832	179	259	0	80	80	1.0000000
NODE_43261_length_492_cov_5.488550	117	197	0	80	80	1.0000000
NODE_43261_length_492_cov_5.488550	170	250	0	80	80	1.0000000
NODE_43270_length_492_cov_4.445293	158	234	2	38	76	0.5000000
NODE_43270_length_492_cov_4.445293	158	234	4	38	76	0.5000000
NODE_43270_length_492_cov_4.445293	207	285	0	26	78	0.3333333
NODE_43270_length_492_cov_4.445293	207	285	2	52	78	0.6666667
NODE_43273_length_492_cov_4.244275	272	315	0	8	43	0.1860465
NODE_43273_length_492_cov_4.244275	272	315	2	35	43	0.8139535
NODE_43293_length_492_cov_3.297710	113	193	0	80	80	1.0000000
NODE_43528_length_491_cov_17.196429	138	218	0	80	80	1.0000000
NODE_43528_length_491_cov_17.196429	191	271	0	80	80	1.0000000
NODE_43529_length_491_cov_17.193878	77	157	0	80	80	1.0000000
NODE_43529_length_491_cov_17.193878	130	210	0	80	80	1.0000000
NODE_43535_length_491_cov_5.505102	215	284	0	13	69	0.1884058
NODE_43535_length_491_cov_5.505102	215	284	2	1	69	0.0144928
NODE_43535_length_491_cov_5.505102	215	284	4	55	69	0.7971014
NODE_43535_length_491_cov_5.505102	215	295	0	13	80	0.1625000
NODE_43535_length_491_cov_5.505102	215	295	2	1	80	0.0125000
NODE_43535_length_491_cov_5.505102	215	295	4	66	80	0.8250000
NODE_43535_length_491_cov_5.505102	268	348	0	16	80	0.2000000
NODE_43535_length_491_cov_5.505102	268	348	2	20	80	0.2500000
NODE_43535_length_491_cov_5.505102	268	348	4	44	80	0.5500000
NODE_43536_length_491_cov_5.477041	169	222	0	53	53	1.0000000
NODE_43546_length_491_cov_4.176020	383	449	6	1	66	0.0151515
NODE_43546_length_491_cov_4.176020	383	449	14	65	66	0.9848485
NODE_43546_length_491_cov_4.176020	422	476	0	1	54	0.0185185
NODE_43546_length_491_cov_4.176020	422	476	4	4	54	0.0740741
NODE_43546_length_491_cov_4.176020	422	476	8	3	54	0.0555556
NODE_43546_length_491_cov_4.176020	422	476	10	11	54	0.2037037
NODE_43546_length_491_cov_4.176020	422	476	12	3	54	0.0555556
NODE_43546_length_491_cov_4.176020	422	476	14	32	54	0.5925926
NODE_43570_length_491_cov_2.887755	348	428	0	23	80	0.2875000
NODE_43570_length_491_cov_2.887755	348	428	2	57	80	0.7125000
NODE_43570_length_491_cov_2.887755	401	472	0	1	71	0.0140845
NODE_43570_length_491_cov_2.887755	401	472	2	70	71	0.9859155
NODE_43575_length_491_cov_2.693878	239	316	2	43	77	0.5584416
NODE_43575_length_491_cov_2.693878	239	316	3	2	77	0.0259740
NODE_43575_length_491_cov_2.693878	239	316	4	32	77	0.4155844
NODE_43744_length_490_cov_10.058824	192	272	0	72	80	0.9000000
NODE_43744_length_490_cov_10.058824	192	272	2	8	80	0.1000000
NODE_43744_length_490_cov_10.058824	245	325	0	80	80	1.0000000
NODE_43748_length_490_cov_6.652174	304	363	0	59	59	1.0000000
NODE_43816_length_490_cov_2.212276	241	300	0	59	59	1.0000000
NODE_43816_length_490_cov_2.212276	280	358	0	78	78	1.0000000
NODE_43886_length_490_cov_1.360614	97	159	11	17	62	0.2741936
NODE_43886_length_490_cov_1.360614	97	159	13	45	62	0.7258065
NODE_43886_length_490_cov_1.360614	132	212	4	14	80	0.1750000
NODE_43886_length_490_cov_1.360614	132	212	6	18	80	0.2250000
NODE_43886_length_490_cov_1.360614	132	212	8	8	80	0.1000000
NODE_43886_length_490_cov_1.360614	132	212	9	5	80	0.0625000
NODE_43886_length_490_cov_1.360614	132	212	11	25	80	0.3125000
NODE_43886_length_490_cov_1.360614	132	212	13	10	80	0.1250000
NODE_43993_length_489_cov_55.992308	50	130	0	49	80	0.6125000
NODE_43993_length_489_cov_55.992308	50	130	2	31	80	0.3875000
NODE_43993_length_489_cov_55.992308	103	183	2	80	80	1.0000000
NODE_43993_length_489_cov_55.992308	179	259	0	31	80	0.3875000
NODE_43993_length_489_cov_55.992308	179	259	2	49	80	0.6125000
NODE_43993_length_489_cov_55.992308	232	312	0	80	80	1.0000000
NODE_43994_length_489_cov_31.707692	299	384	0	24	85	0.2823530
NODE_43994_length_489_cov_31.707692	299	384	2	18	85	0.2117647
NODE_43994_length_489_cov_31.707692	299	384	4	22	85	0.2588235
NODE_43994_length_489_cov_31.707692	299	384	8	21	85	0.2470588
NODE_43994_length_489_cov_31.707692	299	384	0	24	85	0.2823530
NODE_43994_length_489_cov_31.707692	299	384	2	18	85	0.2117647
NODE_43994_length_489_cov_31.707692	299	384	4	22	85	0.2588235
NODE_43994_length_489_cov_31.707692	299	384	8	21	85	0.2470588
NODE_43996_length_489_cov_13.661538	227	307	0	80	80	1.0000000
NODE_43996_length_489_cov_13.661538	280	358	0	78	78	1.0000000
NODE_43997_length_489_cov_12.017949	214	294	0	69	80	0.8625000
NODE_43997_length_489_cov_12.017949	214	294	2	11	80	0.1375000
NODE_43997_length_489_cov_12.017949	267	347	0	16	80	0.2000000
NODE_43997_length_489_cov_12.017949	267	347	2	64	80	0.8000000
NODE_43998_length_489_cov_10.774359	262	304	0	42	42	1.0000000
NODE_44001_length_489_cov_8.094872	141	221	4	15	80	0.1875000
NODE_44001_length_489_cov_8.094872	141	221	6	45	80	0.5625000
NODE_44001_length_489_cov_8.094872	141	221	8	20	80	0.2500000
NODE_44001_length_489_cov_8.094872	194	247	2	5	53	0.0943396
NODE_44001_length_489_cov_8.094872	194	247	4	25	53	0.4716981
NODE_44001_length_489_cov_8.094872	194	247	6	23	53	0.4339623
NODE_44007_length_489_cov_5.284615	176	256	0	80	80	1.0000000
NODE_44007_length_489_cov_5.284615	229	309	0	39	80	0.4875000
NODE_44007_length_489_cov_5.284615	229	309	2	41	80	0.5125000
NODE_44096_length_489_cov_1.646154	234	278	2	37	44	0.8409091
NODE_44096_length_489_cov_1.646154	234	278	4	7	44	0.1590909
NODE_44105_length_489_cov_1.574359	351	391	2	10	40	0.2500000
NODE_44105_length_489_cov_1.574359	351	391	4	23	40	0.5750000
NODE_44105_length_489_cov_1.574359	351	391	6	7	40	0.1750000
NODE_44105_length_489_cov_1.574359	351	383	2	10	32	0.3125000
NODE_44105_length_489_cov_1.574359	351	383	4	18	32	0.5625000
NODE_44105_length_489_cov_1.574359	351	383	6	4	32	0.1250000
NODE_44105_length_489_cov_1.574359	365	445	2	10	80	0.1250000
NODE_44105_length_489_cov_1.574359	365	445	4	63	80	0.7875000
NODE_44105_length_489_cov_1.574359	365	445	6	7	80	0.0875000
NODE_44105_length_489_cov_1.574359	365	445	2	10	80	0.1250000
NODE_44105_length_489_cov_1.574359	365	445	4	63	80	0.7875000
NODE_44105_length_489_cov_1.574359	365	445	6	7	80	0.0875000
NODE_44105_length_489_cov_1.574359	366	445	2	10	79	0.1265823
NODE_44105_length_489_cov_1.574359	366	445	4	62	79	0.7848101
NODE_44105_length_489_cov_1.574359	366	445	6	7	79	0.0886076
NODE_44231_length_488_cov_15.406170	235	313	4	56	78	0.7179487
NODE_44231_length_488_cov_15.406170	235	313	6	22	78	0.2820513
NODE_44231_length_488_cov_15.406170	286	367	0	4	81	0.0493827
NODE_44231_length_488_cov_15.406170	286	367	2	31	81	0.3827161
NODE_44231_length_488_cov_15.406170	286	367	4	5	81	0.0617284
NODE_44231_length_488_cov_15.406170	286	367	6	41	81	0.5061728
NODE_44234_length_488_cov_8.416452	210	290	0	80	80	1.0000000
NODE_44234_length_488_cov_8.416452	263	343	0	80	80	1.0000000
NODE_44240_length_488_cov_6.084833	254	302	4	47	48	0.9791667
NODE_44240_length_488_cov_6.084833	254	302	6	1	48	0.0208333
NODE_44243_length_488_cov_5.434447	210	279	0	69	69	1.0000000
NODE_44243_length_488_cov_5.434447	265	300	0	35	35	1.0000000
NODE_44263_length_488_cov_3.431877	212	248	2	1	36	0.0277778
NODE_44263_length_488_cov_3.431877	212	248	4	35	36	0.9722222
NODE_44264_length_488_cov_3.424165	320	367	6	21	47	0.4468085
NODE_44264_length_488_cov_3.424165	320	367	8	26	47	0.5531915
NODE_44264_length_488_cov_3.424165	320	378	6	21	58	0.3620690
NODE_44264_length_488_cov_3.424165	320	378	8	37	58	0.6379310
NODE_44264_length_488_cov_3.424165	351	393	6	12	42	0.2857143
NODE_44264_length_488_cov_3.424165	351	393	8	30	42	0.7142857
NODE_44264_length_488_cov_3.424165	360	395	6	14	35	0.4000000
NODE_44264_length_488_cov_3.424165	360	395	8	21	35	0.6000000
NODE_44274_length_488_cov_2.850900	276	356	0	80	80	1.0000000
NODE_44376_length_488_cov_1.562982	31	67	0	36	36	1.0000000
NODE_44496_length_487_cov_7.028351	278	358	3	4	80	0.0500000
NODE_44496_length_487_cov_7.028351	278	358	9	4	80	0.0500000
NODE_44496_length_487_cov_7.028351	278	358	10	22	80	0.2750000
NODE_44496_length_487_cov_7.028351	278	358	11	2	80	0.0250000
NODE_44496_length_487_cov_7.028351	278	358	12	48	80	0.6000000
NODE_44498_length_487_cov_6.804124	242	313	0	71	71	1.0000000
NODE_44498_length_487_cov_6.804124	286	366	0	80	80	1.0000000
NODE_44500_length_487_cov_5.917526	140	220	0	80	80	1.0000000
NODE_44500_length_487_cov_5.917526	193	273	0	80	80	1.0000000
NODE_44520_length_487_cov_3.296392	235	315	3	17	80	0.2125000
NODE_44520_length_487_cov_3.296392	235	315	4	10	80	0.1250000
NODE_44520_length_487_cov_3.296392	235	315	5	9	80	0.1125000
NODE_44520_length_487_cov_3.296392	235	315	9	3	80	0.0375000
NODE_44520_length_487_cov_3.296392	235	315	12	1	80	0.0125000
NODE_44520_length_487_cov_3.296392	235	315	13	4	80	0.0500000
NODE_44520_length_487_cov_3.296392	235	315	15	3	80	0.0375000
NODE_44520_length_487_cov_3.296392	235	315	17	5	80	0.0625000
NODE_44520_length_487_cov_3.296392	235	315	19	4	80	0.0500000
NODE_44520_length_487_cov_3.296392	235	315	20	3	80	0.0375000
NODE_44520_length_487_cov_3.296392	235	315	24	3	80	0.0375000
NODE_44520_length_487_cov_3.296392	235	315	25	2	80	0.0250000
NODE_44520_length_487_cov_3.296392	235	315	27	7	80	0.0875000
NODE_44520_length_487_cov_3.296392	235	315	29	9	80	0.1125000
NODE_44521_length_487_cov_3.237113	301	363	0	62	62	1.0000000
NODE_44525_length_487_cov_3.074742	214	294	6	36	80	0.4500000
NODE_44525_length_487_cov_3.074742	214	294	8	19	80	0.2375000
NODE_44525_length_487_cov_3.074742	214	294	10	4	80	0.0500000
NODE_44525_length_487_cov_3.074742	214	294	12	21	80	0.2625000
NODE_44723_length_486_cov_6.609819	206	286	0	80	80	1.0000000
NODE_44728_length_486_cov_5.428941	147	227	0	56	80	0.7000000
NODE_44728_length_486_cov_5.428941	147	227	2	24	80	0.3000000
NODE_44754_length_486_cov_3.072351	131	211	0	25	80	0.3125000
NODE_44754_length_486_cov_3.072351	131	211	4	55	80	0.6875000
NODE_44754_length_486_cov_3.072351	190	235	0	45	45	1.0000000
NODE_44769_length_486_cov_2.581395	156	236	0	80	80	1.0000000
NODE_44769_length_486_cov_2.581395	209	289	0	80	80	1.0000000
NODE_44781_length_486_cov_2.343669	189	230	0	41	41	1.0000000
NODE_44781_length_486_cov_2.343669	242	306	0	64	64	1.0000000
NODE_44959_length_485_cov_29.505181	270	350	0	80	80	1.0000000
NODE_44959_length_485_cov_29.505181	323	403	0	80	80	1.0000000
NODE_44959_length_485_cov_29.505181	399	479	0	80	80	1.0000000
NODE_44960_length_485_cov_10.450777	67	153	0	86	86	1.0000000
NODE_44960_length_485_cov_10.450777	133	206	0	73	73	1.0000000
NODE_44965_length_485_cov_5.922280	196	273	2	1	77	0.0129870
NODE_44965_length_485_cov_5.922280	196	273	3	4	77	0.0519481
NODE_44965_length_485_cov_5.922280	196	273	4	72	77	0.9350649
NODE_44965_length_485_cov_5.922280	246	326	0	22	80	0.2750000
NODE_44965_length_485_cov_5.922280	246	326	2	29	80	0.3625000
NODE_44965_length_485_cov_5.922280	246	326	4	29	80	0.3625000
NODE_44966_length_485_cov_5.818653	279	359	0	58	80	0.7250000
NODE_44966_length_485_cov_5.818653	279	359	1	22	80	0.2750000
NODE_44966_length_485_cov_5.818653	332	412	0	80	80	1.0000000
NODE_44968_length_485_cov_5.670984	321	396	2	33	75	0.4400000
NODE_44968_length_485_cov_5.670984	321	396	12	14	75	0.1866667
NODE_44968_length_485_cov_5.670984	321	396	14	28	75	0.3733333
NODE_44992_length_485_cov_3.518135	162	210	0	48	48	1.0000000
NODE_45005_length_485_cov_2.790155	193	253	0	60	60	1.0000000
NODE_45021_length_485_cov_2.427461	170	249	0	79	79	1.0000000
NODE_45100_length_485_cov_1.264249	232	251	0	19	19	1.0000000
NODE_45193_length_484_cov_33.384416	92	172	0	80	80	1.0000000
NODE_45193_length_484_cov_33.384416	145	225	0	80	80	1.0000000
NODE_45195_length_484_cov_9.111688	136	216	0	80	80	1.0000000
NODE_45195_length_484_cov_9.111688	189	270	0	81	81	1.0000000
NODE_45196_length_484_cov_8.353247	165	244	0	79	79	1.0000000
NODE_45196_length_484_cov_8.353247	217	297	0	80	80	1.0000000
NODE_45197_length_484_cov_8.119481	108	188	8	80	80	1.0000000
NODE_45197_length_484_cov_8.119481	161	241	0	5	80	0.0625000
NODE_45197_length_484_cov_8.119481	161	241	6	19	80	0.2375000
NODE_45197_length_484_cov_8.119481	161	241	8	56	80	0.7000000
NODE_45200_length_484_cov_7.703896	208	288	0	80	80	1.0000000
NODE_45200_length_484_cov_7.703896	261	341	0	80	80	1.0000000
NODE_45202_length_484_cov_7.153247	230	292	0	62	62	1.0000000
NODE_45204_length_484_cov_6.594805	221	301	0	80	80	1.0000000
NODE_45204_length_484_cov_6.594805	274	354	0	80	80	1.0000000
NODE_45218_length_484_cov_4.044156	267	347	6	7	80	0.0875000
NODE_45218_length_484_cov_4.044156	267	347	8	16	80	0.2000000
NODE_45218_length_484_cov_4.044156	267	347	10	7	80	0.0875000
NODE_45218_length_484_cov_4.044156	267	347	11	8	80	0.1000000
NODE_45218_length_484_cov_4.044156	267	347	12	13	80	0.1625000
NODE_45218_length_484_cov_4.044156	267	347	14	22	80	0.2750000
NODE_45218_length_484_cov_4.044156	267	347	16	5	80	0.0625000
NODE_45218_length_484_cov_4.044156	267	347	17	1	80	0.0125000
NODE_45218_length_484_cov_4.044156	267	347	18	1	80	0.0125000
NODE_45218_length_484_cov_4.044156	342	396	2	2	54	0.0370370
NODE_45218_length_484_cov_4.044156	342	396	4	27	54	0.5000000
NODE_45218_length_484_cov_4.044156	342	396	6	25	54	0.4629630
NODE_45225_length_484_cov_3.787013	287	331	0	44	44	1.0000000
NODE_45225_length_484_cov_3.787013	307	386	0	79	79	1.0000000
NODE_45225_length_484_cov_3.787013	317	386	0	69	69	1.0000000
NODE_45276_length_484_cov_2.254545	79	132	10	14	53	0.2641509
NODE_45276_length_484_cov_2.254545	79	132	12	18	53	0.3396226
NODE_45276_length_484_cov_2.254545	79	132	15	13	53	0.2452830
NODE_45276_length_484_cov_2.254545	79	132	17	8	53	0.1509434
NODE_45352_length_484_cov_1.322078	429	477	0	48	48	1.0000000
NODE_45353_length_484_cov_1.314286	431	472	0	41	41	1.0000000
NODE_45459_length_483_cov_40.815104	396	473	0	77	77	1.0000000
NODE_45459_length_483_cov_40.815104	396	473	0	77	77	1.0000000
NODE_45473_length_483_cov_5.289062	124	185	0	61	61	1.0000000
NODE_45494_length_483_cov_4.114583	226	306	0	38	80	0.4750000
NODE_45494_length_483_cov_4.114583	226	306	2	42	80	0.5250000
NODE_45494_length_483_cov_4.114583	226	305	0	37	79	0.4683544
NODE_45494_length_483_cov_4.114583	226	305	2	42	79	0.5316456
NODE_45494_length_483_cov_4.114583	226	306	0	38	80	0.4750000
NODE_45494_length_483_cov_4.114583	226	306	2	42	80	0.5250000
NODE_45494_length_483_cov_4.114583	226	306	0	38	80	0.4750000
NODE_45494_length_483_cov_4.114583	226	306	2	42	80	0.5250000
NODE_45494_length_483_cov_4.114583	279	359	0	80	80	1.0000000
NODE_45494_length_483_cov_4.114583	279	325	0	46	46	1.0000000
NODE_45494_length_483_cov_4.114583	297	323	0	26	26	1.0000000
NODE_45495_length_483_cov_4.046875	68	117	0	49	49	1.0000000
NODE_45495_length_483_cov_4.046875	184	250	0	13	66	0.1969697
NODE_45495_length_483_cov_4.046875	184	250	2	53	66	0.8030303
NODE_45635_length_483_cov_1.205729	249	291	0	42	42	1.0000000
NODE_45725_length_482_cov_37.900783	72	152	0	80	80	1.0000000
NODE_45725_length_482_cov_37.900783	125	205	0	80	80	1.0000000
NODE_45728_length_482_cov_10.545692	233	297	0	64	64	1.0000000
NODE_45729_length_482_cov_9.342037	281	333	0	52	52	1.0000000
NODE_45730_length_482_cov_8.190601	247	311	8	12	64	0.1875000
NODE_45730_length_482_cov_8.190601	247	311	10	2	64	0.0312500
NODE_45730_length_482_cov_8.190601	247	311	11	2	64	0.0312500
NODE_45730_length_482_cov_8.190601	247	311	13	1	64	0.0156250
NODE_45730_length_482_cov_8.190601	247	311	14	1	64	0.0156250
NODE_45730_length_482_cov_8.190601	247	311	15	40	64	0.6250000
NODE_45730_length_482_cov_8.190601	247	311	16	6	64	0.0937500
NODE_45730_length_482_cov_8.190601	284	355	6	42	71	0.5915493
NODE_45730_length_482_cov_8.190601	284	355	8	14	71	0.1971831
NODE_45730_length_482_cov_8.190601	284	355	10	2	71	0.0281690
NODE_45730_length_482_cov_8.190601	284	355	11	2	71	0.0281690
NODE_45730_length_482_cov_8.190601	284	355	13	1	71	0.0140845
NODE_45730_length_482_cov_8.190601	284	355	15	10	71	0.1408451
NODE_45734_length_482_cov_6.002611	112	192	0	80	80	1.0000000
NODE_45734_length_482_cov_6.002611	165	245	0	80	80	1.0000000
NODE_45735_length_482_cov_5.953003	315	395	0	80	80	1.0000000
NODE_45735_length_482_cov_5.953003	368	441	0	73	73	1.0000000
NODE_45748_length_482_cov_4.530026	20	85	0	65	65	1.0000000
NODE_45759_length_482_cov_3.791123	278	358	0	80	80	1.0000000
NODE_45759_length_482_cov_3.791123	331	411	0	80	80	1.0000000
NODE_45842_length_482_cov_1.647520	382	446	0	64	64	1.0000000
NODE_45842_length_482_cov_1.647520	435	482	0	47	47	1.0000000
NODE_45994_length_481_cov_50.623037	154	234	0	80	80	1.0000000
NODE_45994_length_481_cov_50.623037	207	287	0	80	80	1.0000000
NODE_45995_length_481_cov_30.939791	149	198	4	11	49	0.2244898
NODE_45995_length_481_cov_30.939791	149	198	16	3	49	0.0612245
NODE_45995_length_481_cov_30.939791	149	198	18	35	49	0.7142857
NODE_45995_length_481_cov_30.939791	171	235	14	2	64	0.0312500
NODE_45995_length_481_cov_30.939791	171	235	18	62	64	0.9687500
NODE_45995_length_481_cov_30.939791	171	235	14	2	64	0.0312500
NODE_45995_length_481_cov_30.939791	171	235	18	62	64	0.9687500
NODE_45996_length_481_cov_30.183246	0	41	0	41	41	1.0000000
NODE_45996_length_481_cov_30.183246	0	39	0	39	39	1.0000000
NODE_45996_length_481_cov_30.183246	0	44	0	44	44	1.0000000
NODE_45996_length_481_cov_30.183246	0	44	0	44	44	1.0000000
NODE_45996_length_481_cov_30.183246	0	44	0	44	44	1.0000000
NODE_45996_length_481_cov_30.183246	0	44	0	44	44	1.0000000
NODE_45996_length_481_cov_30.183246	17	97	0	80	80	1.0000000
NODE_45996_length_481_cov_30.183246	17	97	0	80	80	1.0000000
NODE_45996_length_481_cov_30.183246	17	97	0	80	80	1.0000000
NODE_45996_length_481_cov_30.183246	17	97	0	80	80	1.0000000
NODE_45996_length_481_cov_30.183246	17	97	0	80	80	1.0000000
NODE_45996_length_481_cov_30.183246	17	97	0	80	80	1.0000000
NODE_45997_length_481_cov_12.709424	250	330	2	6	80	0.0750000
NODE_45997_length_481_cov_12.709424	250	330	10	69	80	0.8625000
NODE_45997_length_481_cov_12.709424	250	330	14	5	80	0.0625000
NODE_45997_length_481_cov_12.709424	303	383	6	14	80	0.1750000
NODE_45997_length_481_cov_12.709424	303	383	8	13	80	0.1625000
NODE_45997_length_481_cov_12.709424	303	383	10	22	80	0.2750000
NODE_45997_length_481_cov_12.709424	303	383	14	31	80	0.3875000
NODE_46037_length_481_cov_3.002618	197	277	0	80	80	1.0000000
NODE_46064_length_481_cov_2.261780	271	351	0	49	80	0.6125000
NODE_46064_length_481_cov_2.261780	271	351	2	18	80	0.2250000
NODE_46064_length_481_cov_2.261780	271	351	4	13	80	0.1625000
NODE_46256_length_480_cov_22.346457	318	398	0	80	80	1.0000000
NODE_46256_length_480_cov_22.346457	371	451	0	80	80	1.0000000
NODE_46257_length_480_cov_16.488189	252	332	0	3	80	0.0375000
NODE_46257_length_480_cov_16.488189	252	332	5	1	80	0.0125000
NODE_46257_length_480_cov_16.488189	252	332	6	76	80	0.9500000
NODE_46257_length_480_cov_16.488189	305	385	0	22	80	0.2750000
NODE_46257_length_480_cov_16.488189	305	385	6	58	80	0.7250000
NODE_46258_length_480_cov_12.874016	164	234	2	42	70	0.6000000
NODE_46258_length_480_cov_12.874016	164	234	4	28	70	0.4000000
NODE_46258_length_480_cov_12.874016	207	273	2	64	66	0.9696970
NODE_46258_length_480_cov_12.874016	207	273	4	2	66	0.0303030
NODE_46260_length_480_cov_11.879265	170	250	0	80	80	1.0000000
NODE_46260_length_480_cov_11.879265	223	303	0	80	80	1.0000000
NODE_46261_length_480_cov_8.774278	114	143	2	13	29	0.4482759
NODE_46261_length_480_cov_8.774278	114	143	4	16	29	0.5517241
NODE_46261_length_480_cov_8.774278	165	245	4	4	80	0.0500000
NODE_46261_length_480_cov_8.774278	165	245	6	2	80	0.0250000
NODE_46261_length_480_cov_8.774278	165	245	8	14	80	0.1750000
NODE_46261_length_480_cov_8.774278	165	245	10	33	80	0.4125000
NODE_46261_length_480_cov_8.774278	165	245	12	27	80	0.3375000
NODE_46261_length_480_cov_8.774278	218	298	2	37	80	0.4625000
NODE_46261_length_480_cov_8.774278	218	298	4	1	80	0.0125000
NODE_46261_length_480_cov_8.774278	218	298	8	13	80	0.1625000
NODE_46261_length_480_cov_8.774278	218	298	10	11	80	0.1375000
NODE_46261_length_480_cov_8.774278	218	298	12	18	80	0.2250000
NODE_46261_length_480_cov_8.774278	385	428	0	43	43	1.0000000
NODE_46271_length_480_cov_5.671916	231	302	0	4	71	0.0563380
NODE_46271_length_480_cov_5.671916	231	302	4	67	71	0.9436620
NODE_46283_length_480_cov_4.354331	126	187	0	44	61	0.7213115
NODE_46283_length_480_cov_4.354331	126	187	2	17	61	0.2786885
NODE_46283_length_480_cov_4.354331	218	298	1	30	80	0.3750000
NODE_46283_length_480_cov_4.354331	218	298	2	48	80	0.6000000
NODE_46283_length_480_cov_4.354331	218	298	3	2	80	0.0250000
NODE_46445_length_480_cov_1.152231	142	216	0	59	74	0.7972973
NODE_46445_length_480_cov_1.152231	142	216	7	5	74	0.0675676
NODE_46445_length_480_cov_1.152231	142	216	18	10	74	0.1351351
NODE_46470_length_480_cov_0.973753	31	71	0	40	40	1.0000000
NODE_46533_length_479_cov_28.205263	308	388	0	24	80	0.3000000
NODE_46533_length_479_cov_28.205263	308	388	2	9	80	0.1125000
NODE_46533_length_479_cov_28.205263	308	388	6	1	80	0.0125000
NODE_46533_length_479_cov_28.205263	308	388	8	46	80	0.5750000
NODE_46533_length_479_cov_28.205263	361	441	4	10	80	0.1250000
NODE_46533_length_479_cov_28.205263	361	441	8	70	80	0.8750000
NODE_46534_length_479_cov_23.944737	189	269	6	2	80	0.0250000
NODE_46534_length_479_cov_23.944737	189	269	8	10	80	0.1250000
NODE_46534_length_479_cov_23.944737	189	269	10	23	80	0.2875000
NODE_46534_length_479_cov_23.944737	189	269	12	45	80	0.5625000
NODE_46534_length_479_cov_23.944737	242	322	10	76	80	0.9500000
NODE_46534_length_479_cov_23.944737	242	322	12	4	80	0.0500000
NODE_46554_length_479_cov_4.942105	283	363	0	52	80	0.6500000
NODE_46554_length_479_cov_4.942105	283	363	2	28	80	0.3500000
NODE_46554_length_479_cov_4.942105	336	416	0	19	80	0.2375000
NODE_46554_length_479_cov_4.942105	336	416	2	61	80	0.7625000
NODE_46574_length_479_cov_3.494737	217	279	0	39	62	0.6290323
NODE_46574_length_479_cov_3.494737	217	279	4	2	62	0.0322581
NODE_46574_length_479_cov_3.494737	217	279	6	4	62	0.0645161
NODE_46574_length_479_cov_3.494737	217	279	8	1	62	0.0161290
NODE_46574_length_479_cov_3.494737	217	279	10	16	62	0.2580645
NODE_46574_length_479_cov_3.494737	272	332	0	60	60	1.0000000
NODE_46611_length_479_cov_2.281579	219	265	4	5	46	0.1086956
NODE_46611_length_479_cov_2.281579	219	265	10	22	46	0.4782609
NODE_46611_length_479_cov_2.281579	219	265	11	3	46	0.0652174
NODE_46611_length_479_cov_2.281579	219	265	13	1	46	0.0217391
NODE_46611_length_479_cov_2.281579	219	265	14	1	46	0.0217391
NODE_46611_length_479_cov_2.281579	219	265	15	10	46	0.2173913
NODE_46611_length_479_cov_2.281579	219	265	17	3	46	0.0652174
NODE_46611_length_479_cov_2.281579	219	265	19	1	46	0.0217391
NODE_46638_length_479_cov_1.839474	376	431	0	55	55	1.0000000
NODE_46654_length_479_cov_1.710526	203	265	1	9	62	0.1451613
NODE_46654_length_479_cov_1.710526	203	265	2	53	62	0.8548387
NODE_46654_length_479_cov_1.710526	248	318	0	49	70	0.7000000
NODE_46654_length_479_cov_1.710526	248	318	1	13	70	0.1857143
NODE_46654_length_479_cov_1.710526	248	318	2	8	70	0.1142857
NODE_46828_length_478_cov_336.139842	153	233	287	2	80	0.0250000
NODE_46828_length_478_cov_336.139842	153	233	288	1	80	0.0125000
NODE_46828_length_478_cov_336.139842	153	233	295	1	80	0.0125000
NODE_46828_length_478_cov_336.139842	153	233	306	1	80	0.0125000
NODE_46828_length_478_cov_336.139842	153	233	308	1	80	0.0125000
NODE_46828_length_478_cov_336.139842	153	233	310	1	80	0.0125000
NODE_46828_length_478_cov_336.139842	153	233	319	2	80	0.0250000
NODE_46828_length_478_cov_336.139842	153	233	322	1	80	0.0125000
NODE_46828_length_478_cov_336.139842	153	233	325	1	80	0.0125000
NODE_46828_length_478_cov_336.139842	153	233	326	1	80	0.0125000
NODE_46828_length_478_cov_336.139842	153	233	332	1	80	0.0125000
NODE_46828_length_478_cov_336.139842	153	233	335	1	80	0.0125000
NODE_46828_length_478_cov_336.139842	153	233	338	1	80	0.0125000
NODE_46828_length_478_cov_336.139842	153	233	339	1	80	0.0125000
NODE_46828_length_478_cov_336.139842	153	233	340	3	80	0.0375000
NODE_46828_length_478_cov_336.139842	153	233	342	1	80	0.0125000
NODE_46828_length_478_cov_336.139842	153	233	345	3	80	0.0375000
NODE_46828_length_478_cov_336.139842	153	233	357	1	80	0.0125000
NODE_46828_length_478_cov_336.139842	153	233	358	1	80	0.0125000
NODE_46828_length_478_cov_336.139842	153	233	360	2	80	0.0250000
NODE_46828_length_478_cov_336.139842	153	233	361	2	80	0.0250000
NODE_46828_length_478_cov_336.139842	153	233	363	2	80	0.0250000
NODE_46828_length_478_cov_336.139842	153	233	365	1	80	0.0125000
NODE_46828_length_478_cov_336.139842	153	233	366	1	80	0.0125000
NODE_46828_length_478_cov_336.139842	153	233	372	1	80	0.0125000
NODE_46828_length_478_cov_336.139842	153	233	373	3	80	0.0375000
NODE_46828_length_478_cov_336.139842	153	233	374	1	80	0.0125000
NODE_46828_length_478_cov_336.139842	153	233	375	2	80	0.0250000
NODE_46828_length_478_cov_336.139842	153	233	390	1	80	0.0125000
NODE_46828_length_478_cov_336.139842	153	233	391	2	80	0.0250000
NODE_46828_length_478_cov_336.139842	153	233	393	2	80	0.0250000
NODE_46828_length_478_cov_336.139842	153	233	394	1	80	0.0125000
NODE_46828_length_478_cov_336.139842	153	233	395	1	80	0.0125000
NODE_46828_length_478_cov_336.139842	153	233	396	1	80	0.0125000
NODE_46828_length_478_cov_336.139842	153	233	397	4	80	0.0500000
NODE_46828_length_478_cov_336.139842	153	233	403	1	80	0.0125000
NODE_46828_length_478_cov_336.139842	153	233	411	1	80	0.0125000
NODE_46828_length_478_cov_336.139842	153	233	419	2	80	0.0250000
NODE_46828_length_478_cov_336.139842	153	233	421	1	80	0.0125000
NODE_46828_length_478_cov_336.139842	153	233	426	1	80	0.0125000
NODE_46828_length_478_cov_336.139842	153	233	428	2	80	0.0250000
NODE_46828_length_478_cov_336.139842	153	233	429	2	80	0.0250000
NODE_46828_length_478_cov_336.139842	153	233	430	1	80	0.0125000
NODE_46828_length_478_cov_336.139842	153	233	431	1	80	0.0125000
NODE_46828_length_478_cov_336.139842	153	233	435	4	80	0.0500000
NODE_46828_length_478_cov_336.139842	153	233	436	1	80	0.0125000
NODE_46828_length_478_cov_336.139842	153	233	437	1	80	0.0125000
NODE_46828_length_478_cov_336.139842	153	233	439	2	80	0.0250000
NODE_46828_length_478_cov_336.139842	153	233	440	1	80	0.0125000
NODE_46828_length_478_cov_336.139842	153	233	441	4	80	0.0500000
NODE_46828_length_478_cov_336.139842	153	233	442	3	80	0.0375000
NODE_46828_length_478_cov_336.139842	206	286	300	1	80	0.0125000
NODE_46828_length_478_cov_336.139842	206	286	302	1	80	0.0125000
NODE_46828_length_478_cov_336.139842	206	286	312	1	80	0.0125000
NODE_46828_length_478_cov_336.139842	206	286	320	1	80	0.0125000
NODE_46828_length_478_cov_336.139842	206	286	324	1	80	0.0125000
NODE_46828_length_478_cov_336.139842	206	286	326	1	80	0.0125000
NODE_46828_length_478_cov_336.139842	206	286	342	1	80	0.0125000
NODE_46828_length_478_cov_336.139842	206	286	344	1	80	0.0125000
NODE_46828_length_478_cov_336.139842	206	286	349	1	80	0.0125000
NODE_46828_length_478_cov_336.139842	206	286	357	1	80	0.0125000
NODE_46828_length_478_cov_336.139842	206	286	360	1	80	0.0125000
NODE_46828_length_478_cov_336.139842	206	286	363	1	80	0.0125000
NODE_46828_length_478_cov_336.139842	206	286	365	1	80	0.0125000
NODE_46828_length_478_cov_336.139842	206	286	368	1	80	0.0125000
NODE_46828_length_478_cov_336.139842	206	286	370	2	80	0.0250000
NODE_46828_length_478_cov_336.139842	206	286	373	2	80	0.0250000
NODE_46828_length_478_cov_336.139842	206	286	375	2	80	0.0250000
NODE_46828_length_478_cov_336.139842	206	286	385	1	80	0.0125000
NODE_46828_length_478_cov_336.139842	206	286	387	2	80	0.0250000
NODE_46828_length_478_cov_336.139842	206	286	397	1	80	0.0125000
NODE_46828_length_478_cov_336.139842	206	286	411	1	80	0.0125000
NODE_46828_length_478_cov_336.139842	206	286	417	1	80	0.0125000
NODE_46828_length_478_cov_336.139842	206	286	419	2	80	0.0250000
NODE_46828_length_478_cov_336.139842	206	286	421	2	80	0.0250000
NODE_46828_length_478_cov_336.139842	206	286	424	1	80	0.0125000
NODE_46828_length_478_cov_336.139842	206	286	426	2	80	0.0250000
NODE_46828_length_478_cov_336.139842	206	286	428	2	80	0.0250000
NODE_46828_length_478_cov_336.139842	206	286	429	2	80	0.0250000
NODE_46828_length_478_cov_336.139842	206	286	430	2	80	0.0250000
NODE_46828_length_478_cov_336.139842	206	286	431	1	80	0.0125000
NODE_46828_length_478_cov_336.139842	206	286	432	1	80	0.0125000
NODE_46828_length_478_cov_336.139842	206	286	434	1	80	0.0125000
NODE_46828_length_478_cov_336.139842	206	286	435	5	80	0.0625000
NODE_46828_length_478_cov_336.139842	206	286	436	5	80	0.0625000
NODE_46828_length_478_cov_336.139842	206	286	437	1	80	0.0125000
NODE_46828_length_478_cov_336.139842	206	286	438	2	80	0.0250000
NODE_46828_length_478_cov_336.139842	206	286	439	7	80	0.0875000
NODE_46828_length_478_cov_336.139842	206	286	440	2	80	0.0250000
NODE_46828_length_478_cov_336.139842	206	286	441	5	80	0.0625000
NODE_46828_length_478_cov_336.139842	206	286	442	4	80	0.0500000
NODE_46828_length_478_cov_336.139842	206	286	445	2	80	0.0250000
NODE_46828_length_478_cov_336.139842	206	286	446	1	80	0.0125000
NODE_46828_length_478_cov_336.139842	206	286	447	2	80	0.0250000
NODE_46828_length_478_cov_336.139842	206	286	449	1	80	0.0125000
NODE_46828_length_478_cov_336.139842	206	286	451	1	80	0.0125000
NODE_46846_length_478_cov_4.448549	150	230	0	80	80	1.0000000
NODE_46846_length_478_cov_4.448549	203	284	0	81	81	1.0000000
NODE_46874_length_478_cov_2.627968	228	278	0	44	50	0.8800000
NODE_46874_length_478_cov_2.627968	228	278	2	1	50	0.0200000
NODE_46874_length_478_cov_2.627968	228	278	3	3	50	0.0600000
NODE_46874_length_478_cov_2.627968	228	278	4	2	50	0.0400000
NODE_47128_length_477_cov_36.230159	225	305	2	1	80	0.0125000
NODE_47128_length_477_cov_36.230159	225	305	4	79	80	0.9875000
NODE_47128_length_477_cov_36.230159	278	358	0	40	80	0.5000000
NODE_47128_length_477_cov_36.230159	278	358	2	14	80	0.1750000
NODE_47128_length_477_cov_36.230159	278	358	4	26	80	0.3250000
NODE_47129_length_477_cov_33.111111	307	387	0	39	80	0.4875000
NODE_47129_length_477_cov_33.111111	307	387	2	41	80	0.5125000
NODE_47129_length_477_cov_33.111111	360	440	0	24	80	0.3000000
NODE_47129_length_477_cov_33.111111	360	440	2	56	80	0.7000000
NODE_47133_length_477_cov_11.235450	119	199	0	69	80	0.8625000
NODE_47133_length_477_cov_11.235450	119	199	2	11	80	0.1375000
NODE_47133_length_477_cov_11.235450	172	247	0	16	75	0.2133333
NODE_47133_length_477_cov_11.235450	172	247	2	59	75	0.7866667
NODE_47135_length_477_cov_9.359788	221	301	0	40	80	0.5000000
NODE_47135_length_477_cov_9.359788	221	301	2	40	80	0.5000000
NODE_47135_length_477_cov_9.359788	274	354	0	27	80	0.3375000
NODE_47135_length_477_cov_9.359788	274	354	2	53	80	0.6625000
NODE_47139_length_477_cov_7.436508	230	304	0	8	74	0.1081081
NODE_47139_length_477_cov_7.436508	230	304	2	9	74	0.1216216
NODE_47139_length_477_cov_7.436508	230	304	6	1	74	0.0135135
NODE_47139_length_477_cov_7.436508	230	304	8	5	74	0.0675676
NODE_47139_length_477_cov_7.436508	230	304	10	7	74	0.0945946
NODE_47139_length_477_cov_7.436508	230	304	12	10	74	0.1351351
NODE_47139_length_477_cov_7.436508	230	304	14	8	74	0.1081081
NODE_47139_length_477_cov_7.436508	230	304	16	26	74	0.3513514
NODE_47140_length_477_cov_7.433862	43	123	0	61	80	0.7625000
NODE_47140_length_477_cov_7.433862	43	123	4	19	80	0.2375000
NODE_47140_length_477_cov_7.433862	96	176	0	8	80	0.1000000
NODE_47140_length_477_cov_7.433862	96	176	4	72	80	0.9000000
NODE_47143_length_477_cov_6.846561	163	243	0	80	80	1.0000000
NODE_47143_length_477_cov_6.846561	216	296	0	80	80	1.0000000
NODE_47147_length_477_cov_5.677249	150	228	0	78	78	1.0000000
NODE_47148_length_477_cov_5.084656	227	288	0	58	61	0.9508197
NODE_47148_length_477_cov_5.084656	227	288	2	3	61	0.0491803
NODE_47253_length_477_cov_1.629630	115	171	2	3	56	0.0535714
NODE_47253_length_477_cov_1.629630	115	171	4	6	56	0.1071429
NODE_47253_length_477_cov_1.629630	115	171	6	14	56	0.2500000
NODE_47253_length_477_cov_1.629630	115	171	8	31	56	0.5535714
NODE_47253_length_477_cov_1.629630	115	171	10	2	56	0.0357143
NODE_47253_length_477_cov_1.629630	167	224	4	14	57	0.2456140
NODE_47253_length_477_cov_1.629630	167	224	6	4	57	0.0701754
NODE_47253_length_477_cov_1.629630	167	224	8	13	57	0.2280702
NODE_47253_length_477_cov_1.629630	167	224	10	26	57	0.4561403
NODE_47375_length_477_cov_0.859788	445	477	0	17	32	0.5312500
NODE_47375_length_477_cov_0.859788	445	477	2	15	32	0.4687500
NODE_47427_length_476_cov_7.533156	221	301	0	80	80	1.0000000
NODE_47427_length_476_cov_7.533156	274	354	0	80	80	1.0000000
NODE_47529_length_476_cov_1.618037	385	444	2	12	59	0.2033898
NODE_47529_length_476_cov_1.618037	385	444	4	9	59	0.1525424
NODE_47529_length_476_cov_1.618037	385	444	6	26	59	0.4406780
NODE_47529_length_476_cov_1.618037	385	444	8	12	59	0.2033898
NODE_47601_length_476_cov_1.129973	15	34	0	19	19	1.0000000
NODE_47620_length_476_cov_1.037135	180	243	2	63	63	1.0000000
NODE_47620_length_476_cov_1.037135	237	296	2	35	59	0.5932204
NODE_47620_length_476_cov_1.037135	237	296	4	24	59	0.4067796
NODE_47693_length_475_cov_34.460106	270	350	0	80	80	1.0000000
NODE_47693_length_475_cov_34.460106	323	403	0	80	80	1.0000000
NODE_47694_length_475_cov_30.087766	273	353	2	26	80	0.3250000
NODE_47694_length_475_cov_30.087766	273	353	4	54	80	0.6750000
NODE_47694_length_475_cov_30.087766	326	406	0	8	80	0.1000000
NODE_47694_length_475_cov_30.087766	326	406	2	12	80	0.1500000
NODE_47694_length_475_cov_30.087766	326	406	4	60	80	0.7500000
NODE_47695_length_475_cov_10.247340	42	122	0	80	80	1.0000000
NODE_47701_length_475_cov_8.393617	9	89	0	80	80	1.0000000
NODE_47701_length_475_cov_8.393617	62	142	0	55	80	0.6875000
NODE_47701_length_475_cov_8.393617	62	142	2	25	80	0.3125000
NODE_47828_length_475_cov_1.531915	272	352	0	19	80	0.2375000
NODE_47828_length_475_cov_1.531915	272	352	2	21	80	0.2625000
NODE_47828_length_475_cov_1.531915	272	352	4	40	80	0.5000000
NODE_47839_length_475_cov_1.457447	50	93	0	43	43	1.0000000
NODE_47979_length_474_cov_49.453333	392	472	74	1	80	0.0125000
NODE_47979_length_474_cov_49.453333	392	472	75	1	80	0.0125000
NODE_47979_length_474_cov_49.453333	392	472	77	1	80	0.0125000
NODE_47979_length_474_cov_49.453333	392	472	79	1	80	0.0125000
NODE_47979_length_474_cov_49.453333	392	472	85	1	80	0.0125000
NODE_47979_length_474_cov_49.453333	392	472	87	1	80	0.0125000
NODE_47979_length_474_cov_49.453333	392	472	95	1	80	0.0125000
NODE_47979_length_474_cov_49.453333	392	472	108	1	80	0.0125000
NODE_47979_length_474_cov_49.453333	392	472	110	1	80	0.0125000
NODE_47979_length_474_cov_49.453333	392	472	129	1	80	0.0125000
NODE_47979_length_474_cov_49.453333	392	472	131	1	80	0.0125000
NODE_47979_length_474_cov_49.453333	392	472	135	1	80	0.0125000
NODE_47979_length_474_cov_49.453333	392	472	139	1	80	0.0125000
NODE_47979_length_474_cov_49.453333	392	472	141	1	80	0.0125000
NODE_47979_length_474_cov_49.453333	392	472	143	1	80	0.0125000
NODE_47979_length_474_cov_49.453333	392	472	149	1	80	0.0125000
NODE_47979_length_474_cov_49.453333	392	472	150	1	80	0.0125000
NODE_47979_length_474_cov_49.453333	392	472	157	1	80	0.0125000
NODE_47979_length_474_cov_49.453333	392	472	160	1	80	0.0125000
NODE_47979_length_474_cov_49.453333	392	472	162	1	80	0.0125000
NODE_47979_length_474_cov_49.453333	392	472	165	2	80	0.0250000
NODE_47979_length_474_cov_49.453333	392	472	168	1	80	0.0125000
NODE_47979_length_474_cov_49.453333	392	472	175	1	80	0.0125000
NODE_47979_length_474_cov_49.453333	392	472	177	1	80	0.0125000
NODE_47979_length_474_cov_49.453333	392	472	189	1	80	0.0125000
NODE_47979_length_474_cov_49.453333	392	472	193	1	80	0.0125000
NODE_47979_length_474_cov_49.453333	392	472	196	1	80	0.0125000
NODE_47979_length_474_cov_49.453333	392	472	199	1	80	0.0125000
NODE_47979_length_474_cov_49.453333	392	472	203	1	80	0.0125000
NODE_47979_length_474_cov_49.453333	392	472	206	1	80	0.0125000
NODE_47979_length_474_cov_49.453333	392	472	213	1	80	0.0125000
NODE_47979_length_474_cov_49.453333	392	472	215	2	80	0.0250000
NODE_47979_length_474_cov_49.453333	392	472	220	1	80	0.0125000
NODE_47979_length_474_cov_49.453333	392	472	221	1	80	0.0125000
NODE_47979_length_474_cov_49.453333	392	472	224	1	80	0.0125000
NODE_47979_length_474_cov_49.453333	392	472	225	2	80	0.0250000
NODE_47979_length_474_cov_49.453333	392	472	231	1	80	0.0125000
NODE_47979_length_474_cov_49.453333	392	472	235	1	80	0.0125000
NODE_47979_length_474_cov_49.453333	392	472	243	1	80	0.0125000
NODE_47979_length_474_cov_49.453333	392	472	244	1	80	0.0125000
NODE_47979_length_474_cov_49.453333	392	472	253	1	80	0.0125000
NODE_47979_length_474_cov_49.453333	392	472	256	1	80	0.0125000
NODE_47979_length_474_cov_49.453333	392	472	261	1	80	0.0125000
NODE_47979_length_474_cov_49.453333	392	472	262	2	80	0.0250000
NODE_47979_length_474_cov_49.453333	392	472	269	1	80	0.0125000
NODE_47979_length_474_cov_49.453333	392	472	270	1	80	0.0125000
NODE_47979_length_474_cov_49.453333	392	472	274	1	80	0.0125000
NODE_47979_length_474_cov_49.453333	392	472	279	1	80	0.0125000
NODE_47979_length_474_cov_49.453333	392	472	283	1	80	0.0125000
NODE_47979_length_474_cov_49.453333	392	472	291	1	80	0.0125000
NODE_47979_length_474_cov_49.453333	392	472	293	1	80	0.0125000
NODE_47979_length_474_cov_49.453333	392	472	295	1	80	0.0125000
NODE_47979_length_474_cov_49.453333	392	472	299	1	80	0.0125000
NODE_47979_length_474_cov_49.453333	392	472	302	1	80	0.0125000
NODE_47979_length_474_cov_49.453333	392	472	308	2	80	0.0250000
NODE_47979_length_474_cov_49.453333	392	472	310	1	80	0.0125000
NODE_47979_length_474_cov_49.453333	392	472	317	2	80	0.0250000
NODE_47979_length_474_cov_49.453333	392	472	319	1	80	0.0125000
NODE_47979_length_474_cov_49.453333	392	472	324	1	80	0.0125000
NODE_47979_length_474_cov_49.453333	392	472	325	1	80	0.0125000
NODE_47979_length_474_cov_49.453333	392	472	327	1	80	0.0125000
NODE_47979_length_474_cov_49.453333	392	472	332	1	80	0.0125000
NODE_47979_length_474_cov_49.453333	392	472	338	1	80	0.0125000
NODE_47979_length_474_cov_49.453333	392	472	346	1	80	0.0125000
NODE_47979_length_474_cov_49.453333	392	472	353	1	80	0.0125000
NODE_47979_length_474_cov_49.453333	392	472	358	1	80	0.0125000
NODE_47979_length_474_cov_49.453333	392	472	359	1	80	0.0125000
NODE_47979_length_474_cov_49.453333	392	472	363	1	80	0.0125000
NODE_47979_length_474_cov_49.453333	392	472	372	1	80	0.0125000
NODE_47979_length_474_cov_49.453333	392	472	374	1	80	0.0125000
NODE_47979_length_474_cov_49.453333	392	472	377	1	80	0.0125000
NODE_47979_length_474_cov_49.453333	392	472	380	1	80	0.0125000
NODE_47979_length_474_cov_49.453333	392	472	389	2	80	0.0250000
NODE_47979_length_474_cov_49.453333	445	474	51	1	29	0.0344828
NODE_47979_length_474_cov_49.453333	445	474	60	1	29	0.0344828
NODE_47979_length_474_cov_49.453333	445	474	74	1	29	0.0344828
NODE_47979_length_474_cov_49.453333	445	474	75	1	29	0.0344828
NODE_47979_length_474_cov_49.453333	445	474	77	1	29	0.0344828
NODE_47979_length_474_cov_49.453333	445	474	79	1	29	0.0344828
NODE_47979_length_474_cov_49.453333	445	474	85	1	29	0.0344828
NODE_47979_length_474_cov_49.453333	445	474	87	1	29	0.0344828
NODE_47979_length_474_cov_49.453333	445	474	95	1	29	0.0344828
NODE_47979_length_474_cov_49.453333	445	474	108	1	29	0.0344828
NODE_47979_length_474_cov_49.453333	445	474	110	1	29	0.0344828
NODE_47979_length_474_cov_49.453333	445	474	129	1	29	0.0344828
NODE_47979_length_474_cov_49.453333	445	474	131	1	29	0.0344828
NODE_47979_length_474_cov_49.453333	445	474	135	1	29	0.0344828
NODE_47979_length_474_cov_49.453333	445	474	139	1	29	0.0344828
NODE_47979_length_474_cov_49.453333	445	474	141	1	29	0.0344828
NODE_47979_length_474_cov_49.453333	445	474	143	1	29	0.0344828
NODE_47979_length_474_cov_49.453333	445	474	149	1	29	0.0344828
NODE_47979_length_474_cov_49.453333	445	474	150	1	29	0.0344828
NODE_47979_length_474_cov_49.453333	445	474	157	1	29	0.0344828
NODE_47979_length_474_cov_49.453333	445	474	160	1	29	0.0344828
NODE_47979_length_474_cov_49.453333	445	474	162	1	29	0.0344828
NODE_47979_length_474_cov_49.453333	445	474	165	2	29	0.0689655
NODE_47979_length_474_cov_49.453333	445	474	168	1	29	0.0344828
NODE_47979_length_474_cov_49.453333	445	474	175	1	29	0.0344828
NODE_47979_length_474_cov_49.453333	445	474	177	1	29	0.0344828
NODE_47979_length_474_cov_49.453333	445	474	189	1	29	0.0344828
NODE_47979_length_474_cov_49.453333	445	474	193	1	29	0.0344828
NODE_47981_length_474_cov_24.930667	287	367	0	8	80	0.1000000
NODE_47981_length_474_cov_24.930667	287	367	2	72	80	0.9000000
NODE_47981_length_474_cov_24.930667	340	420	0	3	80	0.0375000
NODE_47981_length_474_cov_24.930667	340	420	2	31	80	0.3875000
NODE_47981_length_474_cov_24.930667	340	420	4	46	80	0.5750000
NODE_47982_length_474_cov_15.952000	258	338	0	29	80	0.3625000
NODE_47982_length_474_cov_15.952000	258	338	4	51	80	0.6375000
NODE_47982_length_474_cov_15.952000	311	391	0	80	80	1.0000000
NODE_48003_length_474_cov_3.986667	172	252	11	3	80	0.0375000
NODE_48003_length_474_cov_3.986667	172	252	12	3	80	0.0375000
NODE_48003_length_474_cov_3.986667	172	252	16	5	80	0.0625000
NODE_48003_length_474_cov_3.986667	172	252	18	2	80	0.0250000
NODE_48003_length_474_cov_3.986667	172	252	20	10	80	0.1250000
NODE_48003_length_474_cov_3.986667	172	252	22	7	80	0.0875000
NODE_48003_length_474_cov_3.986667	172	252	24	20	80	0.2500000
NODE_48003_length_474_cov_3.986667	172	252	26	30	80	0.3750000
NODE_48015_length_474_cov_3.496000	163	243	4	2	80	0.0250000
NODE_48015_length_474_cov_3.496000	163	243	6	3	80	0.0375000
NODE_48015_length_474_cov_3.496000	163	243	8	9	80	0.1125000
NODE_48015_length_474_cov_3.496000	163	243	10	16	80	0.2000000
NODE_48015_length_474_cov_3.496000	163	243	12	50	80	0.6250000
NODE_48038_length_474_cov_2.784000	259	300	2	41	41	1.0000000
NODE_48116_length_474_cov_1.538667	41	62	0	21	21	1.0000000
NODE_48181_length_474_cov_1.085333	0	50	0	50	50	1.0000000
NODE_48184_length_474_cov_1.056000	95	133	0	38	38	1.0000000
NODE_48266_length_473_cov_82.374332	123	203	0	80	80	1.0000000
NODE_48266_length_473_cov_82.374332	176	256	0	80	80	1.0000000
NODE_48267_length_473_cov_54.882353	199	279	0	80	80	1.0000000
NODE_48267_length_473_cov_54.882353	252	332	0	80	80	1.0000000
NODE_48268_length_473_cov_48.997326	119	194	31	2	75	0.0266667
NODE_48268_length_473_cov_48.997326	119	194	33	11	75	0.1466667
NODE_48268_length_473_cov_48.997326	119	194	35	2	75	0.0266667
NODE_48268_length_473_cov_48.997326	119	194	37	2	75	0.0266667
NODE_48268_length_473_cov_48.997326	119	194	44	1	75	0.0133333
NODE_48268_length_473_cov_48.997326	119	194	45	2	75	0.0266667
NODE_48268_length_473_cov_48.997326	119	194	47	13	75	0.1733333
NODE_48268_length_473_cov_48.997326	119	194	50	30	75	0.4000000
NODE_48268_length_473_cov_48.997326	119	194	51	1	75	0.0133333
NODE_48268_length_473_cov_48.997326	119	194	52	5	75	0.0666667
NODE_48268_length_473_cov_48.997326	119	194	54	2	75	0.0266667
NODE_48268_length_473_cov_48.997326	119	194	56	4	75	0.0533333
NODE_48268_length_473_cov_48.997326	119	194	31	2	75	0.0266667
NODE_48268_length_473_cov_48.997326	119	194	33	11	75	0.1466667
NODE_48268_length_473_cov_48.997326	119	194	35	2	75	0.0266667
NODE_48268_length_473_cov_48.997326	119	194	37	2	75	0.0266667
NODE_48268_length_473_cov_48.997326	119	194	44	1	75	0.0133333
NODE_48268_length_473_cov_48.997326	119	194	45	2	75	0.0266667
NODE_48268_length_473_cov_48.997326	119	194	47	13	75	0.1733333
NODE_48268_length_473_cov_48.997326	119	194	50	30	75	0.4000000
NODE_48268_length_473_cov_48.997326	119	194	51	1	75	0.0133333
NODE_48268_length_473_cov_48.997326	119	194	52	5	75	0.0666667
NODE_48268_length_473_cov_48.997326	119	194	54	2	75	0.0266667
NODE_48268_length_473_cov_48.997326	119	194	56	4	75	0.0533333
NODE_48268_length_473_cov_48.997326	167	247	34	11	80	0.1375000
NODE_48268_length_473_cov_48.997326	167	247	35	12	80	0.1500000
NODE_48268_length_473_cov_48.997326	167	247	37	2	80	0.0250000
NODE_48268_length_473_cov_48.997326	167	247	39	32	80	0.4000000
NODE_48268_length_473_cov_48.997326	167	247	47	13	80	0.1625000
NODE_48268_length_473_cov_48.997326	167	247	52	4	80	0.0500000
NODE_48268_length_473_cov_48.997326	167	247	54	2	80	0.0250000
NODE_48268_length_473_cov_48.997326	167	247	56	4	80	0.0500000
NODE_48269_length_473_cov_30.679144	174	254	2	22	80	0.2750000
NODE_48269_length_473_cov_30.679144	174	254	4	12	80	0.1500000
NODE_48269_length_473_cov_30.679144	174	254	10	12	80	0.1500000
NODE_48269_length_473_cov_30.679144	174	254	13	3	80	0.0375000
NODE_48269_length_473_cov_30.679144	174	254	15	4	80	0.0500000
NODE_48269_length_473_cov_30.679144	174	254	17	9	80	0.1125000
NODE_48269_length_473_cov_30.679144	174	254	19	4	80	0.0500000
NODE_48269_length_473_cov_30.679144	174	254	20	5	80	0.0625000
NODE_48269_length_473_cov_30.679144	174	254	24	1	80	0.0125000
NODE_48269_length_473_cov_30.679144	174	254	25	3	80	0.0375000
NODE_48269_length_473_cov_30.679144	174	254	28	5	80	0.0625000
NODE_48269_length_473_cov_30.679144	226	307	0	34	81	0.4197531
NODE_48269_length_473_cov_30.679144	226	307	2	41	81	0.5061728
NODE_48269_length_473_cov_30.679144	226	307	4	6	81	0.0740741
NODE_48269_length_473_cov_30.679144	227	307	0	34	80	0.4250000
NODE_48269_length_473_cov_30.679144	227	307	2	41	80	0.5125000
NODE_48269_length_473_cov_30.679144	227	307	4	5	80	0.0625000
NODE_48270_length_473_cov_24.967914	295	370	4	75	75	1.0000000
NODE_48270_length_473_cov_24.967914	343	423	2	20	80	0.2500000
NODE_48270_length_473_cov_24.967914	343	423	4	60	80	0.7500000
NODE_48271_length_473_cov_18.540107	168	248	0	80	80	1.0000000
NODE_48271_length_473_cov_18.540107	221	301	0	80	80	1.0000000
NODE_48272_length_473_cov_15.871658	143	223	0	80	80	1.0000000
NODE_48272_length_473_cov_15.871658	196	276	0	80	80	1.0000000
NODE_48291_length_473_cov_4.363636	160	240	2	24	80	0.3000000
NODE_48291_length_473_cov_4.363636	160	240	4	56	80	0.7000000
NODE_48291_length_473_cov_4.363636	213	293	2	77	80	0.9625000
NODE_48291_length_473_cov_4.363636	213	293	4	3	80	0.0375000
NODE_48320_length_473_cov_2.959893	199	267	2	68	68	1.0000000
NODE_48325_length_473_cov_2.804813	207	269	0	36	62	0.5806451
NODE_48325_length_473_cov_2.804813	207	269	2	14	62	0.2258064
NODE_48325_length_473_cov_2.804813	207	269	6	12	62	0.1935484
NODE_48350_length_473_cov_2.251337	48	128	2	3	80	0.0375000
NODE_48350_length_473_cov_2.251337	48	128	4	77	80	0.9625000
NODE_48350_length_473_cov_2.251337	101	181	0	5	80	0.0625000
NODE_48350_length_473_cov_2.251337	101	181	2	51	80	0.6375000
NODE_48350_length_473_cov_2.251337	101	181	4	24	80	0.3000000
NODE_48568_length_472_cov_50.077748	1	81	4	4	80	0.0500000
NODE_48568_length_472_cov_50.077748	1	81	6	3	80	0.0375000
NODE_48568_length_472_cov_50.077748	1	81	8	31	80	0.3875000
NODE_48568_length_472_cov_50.077748	1	81	10	39	80	0.4875000
NODE_48568_length_472_cov_50.077748	1	81	12	3	80	0.0375000
NODE_48568_length_472_cov_50.077748	1	81	4	4	80	0.0500000
NODE_48568_length_472_cov_50.077748	1	81	6	3	80	0.0375000
NODE_48568_length_472_cov_50.077748	1	81	8	31	80	0.3875000
NODE_48568_length_472_cov_50.077748	1	81	10	39	80	0.4875000
NODE_48568_length_472_cov_50.077748	1	81	12	3	80	0.0375000
NODE_48568_length_472_cov_50.077748	1	81	4	4	80	0.0500000
NODE_48568_length_472_cov_50.077748	1	81	6	3	80	0.0375000
NODE_48568_length_472_cov_50.077748	1	81	8	31	80	0.3875000
NODE_48568_length_472_cov_50.077748	1	81	10	39	80	0.4875000
NODE_48568_length_472_cov_50.077748	1	81	12	3	80	0.0375000
NODE_48568_length_472_cov_50.077748	1	81	4	4	80	0.0500000
NODE_48568_length_472_cov_50.077748	1	81	6	3	80	0.0375000
NODE_48568_length_472_cov_50.077748	1	81	8	31	80	0.3875000
NODE_48568_length_472_cov_50.077748	1	81	10	39	80	0.4875000
NODE_48568_length_472_cov_50.077748	1	81	12	3	80	0.0375000
NODE_48568_length_472_cov_50.077748	1	81	4	4	80	0.0500000
NODE_48568_length_472_cov_50.077748	1	81	6	3	80	0.0375000
NODE_48568_length_472_cov_50.077748	1	81	8	31	80	0.3875000
NODE_48568_length_472_cov_50.077748	1	81	10	39	80	0.4875000
NODE_48568_length_472_cov_50.077748	1	81	12	3	80	0.0375000
NODE_48568_length_472_cov_50.077748	10	81	8	29	71	0.4084507
NODE_48568_length_472_cov_50.077748	10	81	10	39	71	0.5492958
NODE_48568_length_472_cov_50.077748	10	81	12	3	71	0.0422535
NODE_48568_length_472_cov_50.077748	54	131	8	6	77	0.0779221
NODE_48568_length_472_cov_50.077748	54	131	9	1	77	0.0129870
NODE_48568_length_472_cov_50.077748	54	131	10	27	77	0.3506494
NODE_48568_length_472_cov_50.077748	54	131	11	4	77	0.0519481
NODE_48568_length_472_cov_50.077748	54	131	12	39	77	0.5064935
NODE_48568_length_472_cov_50.077748	54	131	8	6	77	0.0779221
NODE_48568_length_472_cov_50.077748	54	131	9	1	77	0.0129870
NODE_48568_length_472_cov_50.077748	54	131	10	27	77	0.3506494
NODE_48568_length_472_cov_50.077748	54	131	11	4	77	0.0519481
NODE_48568_length_472_cov_50.077748	54	131	12	39	77	0.5064935
NODE_48568_length_472_cov_50.077748	54	131	8	6	77	0.0779221
NODE_48568_length_472_cov_50.077748	54	131	9	1	77	0.0129870
NODE_48568_length_472_cov_50.077748	54	131	10	27	77	0.3506494
NODE_48568_length_472_cov_50.077748	54	131	11	4	77	0.0519481
NODE_48568_length_472_cov_50.077748	54	131	12	39	77	0.5064935
NODE_48568_length_472_cov_50.077748	130	204	6	56	74	0.7567568
NODE_48568_length_472_cov_50.077748	130	204	10	1	74	0.0135135
NODE_48568_length_472_cov_50.077748	130	204	12	17	74	0.2297297
NODE_48569_length_472_cov_10.469169	294	374	0	27	80	0.3375000
NODE_48569_length_472_cov_10.469169	294	374	4	53	80	0.6625000
NODE_48569_length_472_cov_10.469169	347	427	0	31	80	0.3875000
NODE_48569_length_472_cov_10.469169	347	427	3	1	80	0.0125000
NODE_48569_length_472_cov_10.469169	347	427	4	48	80	0.6000000
NODE_48570_length_472_cov_10.195710	143	223	0	17	80	0.2125000
NODE_48570_length_472_cov_10.195710	143	223	2	63	80	0.7875000
NODE_48570_length_472_cov_10.195710	196	276	0	70	80	0.8750000
NODE_48570_length_472_cov_10.195710	196	276	2	10	80	0.1250000
NODE_48593_length_472_cov_4.375335	165	245	0	80	80	1.0000000
NODE_48593_length_472_cov_4.375335	218	251	0	33	33	1.0000000
NODE_48614_length_472_cov_3.495979	305	349	0	44	44	1.0000000
NODE_48620_length_472_cov_3.093834	220	295	2	8	75	0.1066667
NODE_48620_length_472_cov_3.093834	220	295	6	67	75	0.8933333
NODE_48638_length_472_cov_2.592493	431	471	0	40	40	1.0000000
NODE_48745_length_472_cov_1.294906	43	98	6	7	55	0.1272727
NODE_48745_length_472_cov_1.294906	43	98	8	28	55	0.5090909
NODE_48745_length_472_cov_1.294906	43	98	10	20	55	0.3636364
NODE_48745_length_472_cov_1.294906	71	151	2	3	80	0.0375000
NODE_48745_length_472_cov_1.294906	71	151	8	15	80	0.1875000
NODE_48745_length_472_cov_1.294906	71	151	10	62	80	0.7750000
NODE_48768_length_472_cov_1.211796	106	126	0	20	20	1.0000000
NODE_48873_length_471_cov_39.319892	119	193	2	37	74	0.5000000
NODE_48873_length_471_cov_39.319892	119	193	3	1	74	0.0135135
NODE_48873_length_471_cov_39.319892	119	193	4	33	74	0.4459459
NODE_48873_length_471_cov_39.319892	119	193	9	1	74	0.0135135
NODE_48873_length_471_cov_39.319892	119	193	14	1	74	0.0135135
NODE_48873_length_471_cov_39.319892	119	193	30	1	74	0.0135135
NODE_48874_length_471_cov_24.279570	185	265	6	8	80	0.1000000
NODE_48874_length_471_cov_24.279570	185	265	8	72	80	0.9000000
NODE_48874_length_471_cov_24.279570	238	318	0	27	80	0.3375000
NODE_48874_length_471_cov_24.279570	238	318	2	11	80	0.1375000
NODE_48874_length_471_cov_24.279570	238	318	6	23	80	0.2875000
NODE_48874_length_471_cov_24.279570	238	318	8	19	80	0.2375000
NODE_48875_length_471_cov_19.669355	83	163	2	14	80	0.1750000
NODE_48875_length_471_cov_19.669355	83	163	4	66	80	0.8250000
NODE_48875_length_471_cov_19.669355	136	216	4	80	80	1.0000000
NODE_48876_length_471_cov_14.387097	198	278	0	80	80	1.0000000
NODE_48876_length_471_cov_14.387097	251	331	0	80	80	1.0000000
NODE_48881_length_471_cov_6.948925	186	213	4	27	27	1.0000000
NODE_48881_length_471_cov_6.948925	204	284	2	1	80	0.0125000
NODE_48881_length_471_cov_6.948925	204	284	4	69	80	0.8625000
NODE_48881_length_471_cov_6.948925	204	284	6	10	80	0.1250000
NODE_48881_length_471_cov_6.948925	244	275	4	21	31	0.6774194
NODE_48881_length_471_cov_6.948925	244	275	6	10	31	0.3225806
NODE_48881_length_471_cov_6.948925	257	337	0	15	80	0.1875000
NODE_48881_length_471_cov_6.948925	257	337	2	39	80	0.4875000
NODE_48881_length_471_cov_6.948925	257	337	4	23	80	0.2875000
NODE_48881_length_471_cov_6.948925	257	337	6	3	80	0.0375000
NODE_48881_length_471_cov_6.948925	268	337	0	15	69	0.2173913
NODE_48881_length_471_cov_6.948925	268	337	2	39	69	0.5652174
NODE_48881_length_471_cov_6.948925	268	337	4	15	69	0.2173913
NODE_48902_length_471_cov_3.803763	83	162	0	79	79	1.0000000
NODE_48902_length_471_cov_3.803763	135	215	0	80	80	1.0000000
NODE_48924_length_471_cov_2.954301	284	315	22	7	31	0.2258064
NODE_48924_length_471_cov_2.954301	284	315	26	22	31	0.7096774
NODE_48924_length_471_cov_2.954301	284	315	30	2	31	0.0645161
NODE_48957_length_471_cov_2.287634	133	200	0	2	67	0.0298507
NODE_48957_length_471_cov_2.287634	133	200	2	1	67	0.0149254
NODE_48957_length_471_cov_2.287634	133	200	3	1	67	0.0149254
NODE_48957_length_471_cov_2.287634	133	200	5	10	67	0.1492537
NODE_48957_length_471_cov_2.287634	133	200	7	4	67	0.0597015
NODE_48957_length_471_cov_2.287634	133	200	11	2	67	0.0298507
NODE_48957_length_471_cov_2.287634	133	200	13	25	67	0.3731343
NODE_48957_length_471_cov_2.287634	133	200	15	22	67	0.3283582
NODE_49186_length_470_cov_57.078167	184	264	0	56	80	0.7000000
NODE_49186_length_470_cov_57.078167	184	264	4	10	80	0.1250000
NODE_49186_length_470_cov_57.078167	184	264	6	14	80	0.1750000
NODE_49186_length_470_cov_57.078167	237	317	0	3	80	0.0375000
NODE_49186_length_470_cov_57.078167	237	317	4	10	80	0.1250000
NODE_49186_length_470_cov_57.078167	237	317	6	36	80	0.4500000
NODE_49186_length_470_cov_57.078167	237	317	8	13	80	0.1625000
NODE_49186_length_470_cov_57.078167	237	317	10	18	80	0.2250000
NODE_49186_length_470_cov_57.078167	313	393	6	42	80	0.5250000
NODE_49186_length_470_cov_57.078167	313	393	10	26	80	0.3250000
NODE_49186_length_470_cov_57.078167	313	393	12	12	80	0.1500000
NODE_49186_length_470_cov_57.078167	366	446	2	10	80	0.1250000
NODE_49186_length_470_cov_57.078167	366	446	4	31	80	0.3875000
NODE_49186_length_470_cov_57.078167	366	446	6	39	80	0.4875000
NODE_49187_length_470_cov_34.035040	228	308	0	80	80	1.0000000
NODE_49187_length_470_cov_34.035040	281	361	0	80	80	1.0000000
NODE_49187_length_470_cov_34.035040	357	437	0	80	80	1.0000000
NODE_49187_length_470_cov_34.035040	410	470	0	60	60	1.0000000
NODE_49188_length_470_cov_15.539084	142	222	0	80	80	1.0000000
NODE_49188_length_470_cov_15.539084	195	275	0	80	80	1.0000000
NODE_49193_length_470_cov_6.070081	272	330	184	1	58	0.0172414
NODE_49193_length_470_cov_6.070081	272	330	190	1	58	0.0172414
NODE_49193_length_470_cov_6.070081	272	330	192	2	58	0.0344828
NODE_49193_length_470_cov_6.070081	272	330	193	2	58	0.0344828
NODE_49193_length_470_cov_6.070081	272	330	197	1	58	0.0172414
NODE_49193_length_470_cov_6.070081	272	330	200	6	58	0.1034483
NODE_49193_length_470_cov_6.070081	272	330	202	1	58	0.0172414
NODE_49193_length_470_cov_6.070081	272	330	204	3	58	0.0517241
NODE_49193_length_470_cov_6.070081	272	330	206	2	58	0.0344828
NODE_49193_length_470_cov_6.070081	272	330	207	2	58	0.0344828
NODE_49193_length_470_cov_6.070081	272	330	208	2	58	0.0344828
NODE_49193_length_470_cov_6.070081	272	330	210	1	58	0.0172414
NODE_49193_length_470_cov_6.070081	272	330	216	2	58	0.0344828
NODE_49193_length_470_cov_6.070081	272	330	218	9	58	0.1551724
NODE_49193_length_470_cov_6.070081	272	330	227	1	58	0.0172414
NODE_49193_length_470_cov_6.070081	272	330	228	2	58	0.0344828
NODE_49193_length_470_cov_6.070081	272	330	230	1	58	0.0172414
NODE_49193_length_470_cov_6.070081	272	330	231	4	58	0.0689655
NODE_49193_length_470_cov_6.070081	272	330	232	10	58	0.1724138
NODE_49193_length_470_cov_6.070081	272	330	233	5	58	0.0862069
NODE_49193_length_470_cov_6.070081	325	383	23	1	58	0.0172414
NODE_49193_length_470_cov_6.070081	325	383	32	1	58	0.0172414
NODE_49193_length_470_cov_6.070081	325	383	35	1	58	0.0172414
NODE_49193_length_470_cov_6.070081	325	383	39	1	58	0.0172414
NODE_49193_length_470_cov_6.070081	325	383	43	1	58	0.0172414
NODE_49193_length_470_cov_6.070081	325	383	45	1	58	0.0172414
NODE_49193_length_470_cov_6.070081	325	383	48	1	58	0.0172414
NODE_49193_length_470_cov_6.070081	325	383	50	1	58	0.0172414
NODE_49193_length_470_cov_6.070081	325	383	52	1	58	0.0172414
NODE_49193_length_470_cov_6.070081	325	383	58	2	58	0.0344828
NODE_49193_length_470_cov_6.070081	325	383	60	2	58	0.0344828
NODE_49193_length_470_cov_6.070081	325	383	64	1	58	0.0172414
NODE_49193_length_470_cov_6.070081	325	383	66	1	58	0.0172414
NODE_49193_length_470_cov_6.070081	325	383	68	2	58	0.0344828
NODE_49193_length_470_cov_6.070081	325	383	71	4	58	0.0689655
NODE_49193_length_470_cov_6.070081	325	383	80	2	58	0.0344828
NODE_49193_length_470_cov_6.070081	325	383	82	2	58	0.0344828
NODE_49193_length_470_cov_6.070081	325	383	83	1	58	0.0172414
NODE_49193_length_470_cov_6.070081	325	383	85	1	58	0.0172414
NODE_49193_length_470_cov_6.070081	325	383	86	1	58	0.0172414
NODE_49193_length_470_cov_6.070081	325	383	88	1	58	0.0172414
NODE_49193_length_470_cov_6.070081	325	383	90	1	58	0.0172414
NODE_49193_length_470_cov_6.070081	325	383	106	1	58	0.0172414
NODE_49193_length_470_cov_6.070081	325	383	108	1	58	0.0172414
NODE_49193_length_470_cov_6.070081	325	383	117	1	58	0.0172414
NODE_49193_length_470_cov_6.070081	325	383	124	1	58	0.0172414
NODE_49193_length_470_cov_6.070081	325	383	125	2	58	0.0344828
NODE_49193_length_470_cov_6.070081	325	383	128	1	58	0.0172414
NODE_49193_length_470_cov_6.070081	325	383	130	2	58	0.0344828
NODE_49193_length_470_cov_6.070081	325	383	132	1	58	0.0172414
NODE_49193_length_470_cov_6.070081	325	383	135	1	58	0.0172414
NODE_49193_length_470_cov_6.070081	325	383	142	1	58	0.0172414
NODE_49193_length_470_cov_6.070081	325	383	152	1	58	0.0172414
NODE_49193_length_470_cov_6.070081	325	383	154	2	58	0.0344828
NODE_49193_length_470_cov_6.070081	325	383	160	2	58	0.0344828
NODE_49193_length_470_cov_6.070081	325	383	162	1	58	0.0172414
NODE_49193_length_470_cov_6.070081	325	383	164	1	58	0.0172414
NODE_49193_length_470_cov_6.070081	325	383	168	1	58	0.0172414
NODE_49193_length_470_cov_6.070081	325	383	182	1	58	0.0172414
NODE_49193_length_470_cov_6.070081	325	383	184	3	58	0.0517241
NODE_49193_length_470_cov_6.070081	325	383	190	1	58	0.0172414
NODE_49193_length_470_cov_6.070081	325	383	192	2	58	0.0344828
NODE_49193_length_470_cov_6.070081	325	383	193	1	58	0.0172414
NODE_49215_length_470_cov_3.735849	194	251	0	57	57	1.0000000
NODE_49260_length_470_cov_2.363881	403	422	0	19	19	1.0000000
NODE_49260_length_470_cov_2.363881	403	422	0	19	19	1.0000000
NODE_49389_length_470_cov_1.142857	414	470	0	13	56	0.2321429
NODE_49389_length_470_cov_1.142857	414	470	2	22	56	0.3928571
NODE_49389_length_470_cov_1.142857	414	470	4	21	56	0.3750000
NODE_49502_length_469_cov_221.024324	150	228	583	1	78	0.0128205
NODE_49502_length_469_cov_221.024324	150	228	589	1	78	0.0128205
NODE_49502_length_469_cov_221.024324	150	228	590	2	78	0.0256410
NODE_49502_length_469_cov_221.024324	150	228	593	1	78	0.0128205
NODE_49502_length_469_cov_221.024324	150	228	600	2	78	0.0256410
NODE_49502_length_469_cov_221.024324	150	228	613	1	78	0.0128205
NODE_49502_length_469_cov_221.024324	150	228	622	1	78	0.0128205
NODE_49502_length_469_cov_221.024324	150	228	627	4	78	0.0512821
NODE_49502_length_469_cov_221.024324	150	228	629	1	78	0.0128205
NODE_49502_length_469_cov_221.024324	150	228	650	1	78	0.0128205
NODE_49502_length_469_cov_221.024324	150	228	659	2	78	0.0256410
NODE_49502_length_469_cov_221.024324	150	228	666	1	78	0.0128205
NODE_49502_length_469_cov_221.024324	150	228	668	1	78	0.0128205
NODE_49502_length_469_cov_221.024324	150	228	673	1	78	0.0128205
NODE_49502_length_469_cov_221.024324	150	228	681	1	78	0.0128205
NODE_49502_length_469_cov_221.024324	150	228	697	1	78	0.0128205
NODE_49502_length_469_cov_221.024324	150	228	702	1	78	0.0128205
NODE_49502_length_469_cov_221.024324	150	228	707	1	78	0.0128205
NODE_49502_length_469_cov_221.024324	150	228	708	1	78	0.0128205
NODE_49502_length_469_cov_221.024324	150	228	709	2	78	0.0256410
NODE_49502_length_469_cov_221.024324	150	228	710	3	78	0.0384615
NODE_49502_length_469_cov_221.024324	150	228	712	1	78	0.0128205
NODE_49502_length_469_cov_221.024324	150	228	713	1	78	0.0128205
NODE_49502_length_469_cov_221.024324	150	228	714	1	78	0.0128205
NODE_49502_length_469_cov_221.024324	150	228	715	4	78	0.0512821
NODE_49502_length_469_cov_221.024324	150	228	717	3	78	0.0384615
NODE_49502_length_469_cov_221.024324	150	228	718	3	78	0.0384615
NODE_49502_length_469_cov_221.024324	150	228	728	1	78	0.0128205
NODE_49502_length_469_cov_221.024324	150	228	730	1	78	0.0128205
NODE_49502_length_469_cov_221.024324	150	228	734	3	78	0.0384615
NODE_49502_length_469_cov_221.024324	150	228	738	1	78	0.0128205
NODE_49502_length_469_cov_221.024324	150	228	739	4	78	0.0512821
NODE_49502_length_469_cov_221.024324	150	228	741	1	78	0.0128205
NODE_49502_length_469_cov_221.024324	150	228	745	2	78	0.0256410
NODE_49502_length_469_cov_221.024324	150	228	747	7	78	0.0897436
NODE_49502_length_469_cov_221.024324	150	228	751	2	78	0.0256410
NODE_49502_length_469_cov_221.024324	150	228	752	1	78	0.0128205
NODE_49502_length_469_cov_221.024324	150	228	753	1	78	0.0128205
NODE_49502_length_469_cov_221.024324	150	228	755	1	78	0.0128205
NODE_49502_length_469_cov_221.024324	150	228	761	1	78	0.0128205
NODE_49502_length_469_cov_221.024324	150	228	766	1	78	0.0128205
NODE_49502_length_469_cov_221.024324	150	228	768	1	78	0.0128205
NODE_49502_length_469_cov_221.024324	150	228	770	1	78	0.0128205
NODE_49502_length_469_cov_221.024324	150	228	772	1	78	0.0128205
NODE_49502_length_469_cov_221.024324	150	228	774	1	78	0.0128205
NODE_49502_length_469_cov_221.024324	150	228	779	1	78	0.0128205
NODE_49502_length_469_cov_221.024324	150	228	780	1	78	0.0128205
NODE_49502_length_469_cov_221.024324	150	228	786	1	78	0.0128205
NODE_49502_length_469_cov_221.024324	150	228	787	1	78	0.0128205
NODE_49502_length_469_cov_221.024324	150	228	583	1	78	0.0128205
NODE_49502_length_469_cov_221.024324	150	228	589	1	78	0.0128205
NODE_49502_length_469_cov_221.024324	150	228	590	2	78	0.0256410
NODE_49502_length_469_cov_221.024324	150	228	593	1	78	0.0128205
NODE_49502_length_469_cov_221.024324	150	228	600	2	78	0.0256410
NODE_49502_length_469_cov_221.024324	150	228	613	1	78	0.0128205
NODE_49502_length_469_cov_221.024324	150	228	622	1	78	0.0128205
NODE_49502_length_469_cov_221.024324	150	228	627	4	78	0.0512821
NODE_49502_length_469_cov_221.024324	150	228	629	1	78	0.0128205
NODE_49502_length_469_cov_221.024324	150	228	650	1	78	0.0128205
NODE_49502_length_469_cov_221.024324	150	228	659	2	78	0.0256410
NODE_49502_length_469_cov_221.024324	150	228	666	1	78	0.0128205
NODE_49502_length_469_cov_221.024324	150	228	668	1	78	0.0128205
NODE_49502_length_469_cov_221.024324	150	228	673	1	78	0.0128205
NODE_49502_length_469_cov_221.024324	150	228	681	1	78	0.0128205
NODE_49502_length_469_cov_221.024324	150	228	697	1	78	0.0128205
NODE_49502_length_469_cov_221.024324	150	228	702	1	78	0.0128205
NODE_49502_length_469_cov_221.024324	150	228	707	1	78	0.0128205
NODE_49502_length_469_cov_221.024324	150	228	708	1	78	0.0128205
NODE_49502_length_469_cov_221.024324	150	228	709	2	78	0.0256410
NODE_49502_length_469_cov_221.024324	150	228	710	3	78	0.0384615
NODE_49502_length_469_cov_221.024324	150	228	712	1	78	0.0128205
NODE_49502_length_469_cov_221.024324	150	228	713	1	78	0.0128205
NODE_49502_length_469_cov_221.024324	150	228	714	1	78	0.0128205
NODE_49502_length_469_cov_221.024324	150	228	715	4	78	0.0512821
NODE_49502_length_469_cov_221.024324	150	228	717	3	78	0.0384615
NODE_49502_length_469_cov_221.024324	150	228	718	3	78	0.0384615
NODE_49502_length_469_cov_221.024324	150	228	728	1	78	0.0128205
NODE_49502_length_469_cov_221.024324	150	228	730	1	78	0.0128205
NODE_49502_length_469_cov_221.024324	150	228	734	3	78	0.0384615
NODE_49502_length_469_cov_221.024324	150	228	738	1	78	0.0128205
NODE_49502_length_469_cov_221.024324	150	228	739	4	78	0.0512821
NODE_49502_length_469_cov_221.024324	150	228	741	1	78	0.0128205
NODE_49502_length_469_cov_221.024324	150	228	745	2	78	0.0256410
NODE_49502_length_469_cov_221.024324	150	228	747	7	78	0.0897436
NODE_49502_length_469_cov_221.024324	150	228	751	2	78	0.0256410
NODE_49502_length_469_cov_221.024324	150	228	752	1	78	0.0128205
NODE_49502_length_469_cov_221.024324	150	228	753	1	78	0.0128205
NODE_49502_length_469_cov_221.024324	150	228	755	1	78	0.0128205
NODE_49502_length_469_cov_221.024324	150	228	761	1	78	0.0128205
NODE_49502_length_469_cov_221.024324	150	228	766	1	78	0.0128205
NODE_49502_length_469_cov_221.024324	150	228	768	1	78	0.0128205
NODE_49502_length_469_cov_221.024324	150	228	770	1	78	0.0128205
NODE_49502_length_469_cov_221.024324	150	228	772	1	78	0.0128205
NODE_49502_length_469_cov_221.024324	150	228	774	1	78	0.0128205
NODE_49502_length_469_cov_221.024324	150	228	779	1	78	0.0128205
NODE_49502_length_469_cov_221.024324	150	228	780	1	78	0.0128205
NODE_49502_length_469_cov_221.024324	150	228	786	1	78	0.0128205
NODE_49502_length_469_cov_221.024324	150	228	787	1	78	0.0128205
NODE_49502_length_469_cov_221.024324	150	219	627	4	69	0.0579710
NODE_49502_length_469_cov_221.024324	150	219	629	1	69	0.0144928
NODE_49502_length_469_cov_221.024324	150	219	650	1	69	0.0144928
NODE_49502_length_469_cov_221.024324	150	219	659	2	69	0.0289855
NODE_49502_length_469_cov_221.024324	150	219	666	1	69	0.0144928
NODE_49502_length_469_cov_221.024324	150	219	668	1	69	0.0144928
NODE_49502_length_469_cov_221.024324	150	219	673	1	69	0.0144928
NODE_49502_length_469_cov_221.024324	150	219	681	1	69	0.0144928
NODE_49502_length_469_cov_221.024324	150	219	697	1	69	0.0144928
NODE_49502_length_469_cov_221.024324	150	219	702	1	69	0.0144928
NODE_49502_length_469_cov_221.024324	150	219	707	1	69	0.0144928
NODE_49502_length_469_cov_221.024324	150	219	708	1	69	0.0144928
NODE_49502_length_469_cov_221.024324	150	219	709	2	69	0.0289855
NODE_49502_length_469_cov_221.024324	150	219	710	3	69	0.0434783
NODE_49502_length_469_cov_221.024324	150	219	712	1	69	0.0144928
NODE_49502_length_469_cov_221.024324	150	219	713	1	69	0.0144928
NODE_49502_length_469_cov_221.024324	150	219	714	1	69	0.0144928
NODE_49502_length_469_cov_221.024324	150	219	715	4	69	0.0579710
NODE_49502_length_469_cov_221.024324	150	219	717	3	69	0.0434783
NODE_49502_length_469_cov_221.024324	150	219	718	3	69	0.0434783
NODE_49502_length_469_cov_221.024324	150	219	728	1	69	0.0144928
NODE_49502_length_469_cov_221.024324	150	219	730	1	69	0.0144928
NODE_49502_length_469_cov_221.024324	150	219	734	3	69	0.0434783
NODE_49502_length_469_cov_221.024324	150	219	738	1	69	0.0144928
NODE_49502_length_469_cov_221.024324	150	219	739	4	69	0.0579710
NODE_49502_length_469_cov_221.024324	150	219	741	1	69	0.0144928
NODE_49502_length_469_cov_221.024324	150	219	745	2	69	0.0289855
NODE_49502_length_469_cov_221.024324	150	219	747	7	69	0.1014493
NODE_49502_length_469_cov_221.024324	150	219	751	2	69	0.0289855
NODE_49502_length_469_cov_221.024324	150	219	752	1	69	0.0144928
NODE_49502_length_469_cov_221.024324	150	219	753	1	69	0.0144928
NODE_49502_length_469_cov_221.024324	150	219	755	1	69	0.0144928
NODE_49502_length_469_cov_221.024324	150	219	761	1	69	0.0144928
NODE_49502_length_469_cov_221.024324	150	219	766	1	69	0.0144928
NODE_49502_length_469_cov_221.024324	150	219	768	1	69	0.0144928
NODE_49502_length_469_cov_221.024324	150	219	770	1	69	0.0144928
NODE_49502_length_469_cov_221.024324	150	219	772	1	69	0.0144928
NODE_49502_length_469_cov_221.024324	150	219	774	1	69	0.0144928
NODE_49502_length_469_cov_221.024324	150	219	779	1	69	0.0144928
NODE_49502_length_469_cov_221.024324	150	219	780	1	69	0.0144928
NODE_49502_length_469_cov_221.024324	150	219	786	1	69	0.0144928
NODE_49502_length_469_cov_221.024324	150	219	787	1	69	0.0144928
NODE_49557_length_469_cov_2.686486	263	343	0	80	80	1.0000000
NODE_49561_length_469_cov_2.521622	237	289	0	52	52	1.0000000
NODE_49579_length_469_cov_2.224324	279	331	0	52	52	1.0000000
NODE_49796_length_468_cov_8.043360	190	250	0	14	60	0.2333333
NODE_49796_length_468_cov_8.043360	190	250	2	46	60	0.7666667
NODE_49796_length_468_cov_8.043360	223	303	0	67	80	0.8375000
NODE_49796_length_468_cov_8.043360	223	303	2	13	80	0.1625000
NODE_49800_length_468_cov_6.046070	152	232	0	80	80	1.0000000
NODE_49800_length_468_cov_6.046070	205	285	0	80	80	1.0000000
NODE_49801_length_468_cov_5.997290	81	161	0	45	80	0.5625000
NODE_49801_length_468_cov_5.997290	81	161	1	27	80	0.3375000
NODE_49801_length_468_cov_5.997290	81	161	2	8	80	0.1000000
NODE_49801_length_468_cov_5.997290	134	214	1	36	80	0.4500000
NODE_49801_length_468_cov_5.997290	134	214	2	6	80	0.0750000
NODE_49801_length_468_cov_5.997290	134	214	3	17	80	0.2125000
NODE_49801_length_468_cov_5.997290	134	214	5	9	80	0.1125000
NODE_49801_length_468_cov_5.997290	134	214	7	7	80	0.0875000
NODE_49801_length_468_cov_5.997290	134	214	8	5	80	0.0625000
NODE_49801_length_468_cov_5.997290	210	270	6	28	60	0.4666667
NODE_49801_length_468_cov_5.997290	210	270	8	32	60	0.5333334
NODE_49803_length_468_cov_5.872629	133	201	10	9	68	0.1323529
NODE_49803_length_468_cov_5.872629	133	201	12	5	68	0.0735294
NODE_49803_length_468_cov_5.872629	133	201	14	9	68	0.1323529
NODE_49803_length_468_cov_5.872629	133	201	16	9	68	0.1323529
NODE_49803_length_468_cov_5.872629	133	201	18	34	68	0.5000000
NODE_49803_length_468_cov_5.872629	133	201	20	2	68	0.0294118
NODE_49807_length_468_cov_5.384824	305	356	2	16	51	0.3137255
NODE_49807_length_468_cov_5.384824	305	356	4	35	51	0.6862745
NODE_49894_length_468_cov_2.067751	45	96	14	6	51	0.1176471
NODE_49894_length_468_cov_2.067751	45	96	16	7	51	0.1372549
NODE_49894_length_468_cov_2.067751	45	96	18	38	51	0.7450981
NODE_49913_length_468_cov_1.891599	4	63	0	59	59	1.0000000
NODE_49928_length_468_cov_1.758808	140	218	0	78	78	1.0000000
NODE_49928_length_468_cov_1.758808	191	257	0	66	66	1.0000000
NODE_49974_length_468_cov_1.390244	291	310	4	19	19	1.0000000
NODE_49974_length_468_cov_1.390244	369	405	0	36	36	1.0000000
NODE_50133_length_467_cov_14.100543	176	256	4	2	80	0.0250000
NODE_50133_length_467_cov_14.100543	176	256	6	34	80	0.4250000
NODE_50133_length_467_cov_14.100543	176	256	7	14	80	0.1750000
NODE_50133_length_467_cov_14.100543	176	256	8	30	80	0.3750000
NODE_50134_length_467_cov_11.902174	193	236	0	43	43	1.0000000
NODE_50135_length_467_cov_10.875000	226	306	0	27	80	0.3375000
NODE_50135_length_467_cov_10.875000	226	306	2	53	80	0.6625000
NODE_50135_length_467_cov_10.875000	279	359	0	66	80	0.8250000
NODE_50135_length_467_cov_10.875000	279	359	2	14	80	0.1750000
NODE_50144_length_467_cov_6.625000	206	275	0	6	69	0.0869565
NODE_50144_length_467_cov_6.625000	206	275	4	23	69	0.3333333
NODE_50144_length_467_cov_6.625000	206	275	8	2	69	0.0289855
NODE_50144_length_467_cov_6.625000	206	275	10	1	69	0.0144928
NODE_50144_length_467_cov_6.625000	206	275	11	2	69	0.0289855
NODE_50144_length_467_cov_6.625000	206	275	17	35	69	0.5072464
NODE_50144_length_467_cov_6.625000	257	328	7	9	71	0.1267606
NODE_50144_length_467_cov_6.625000	257	328	13	38	71	0.5352113
NODE_50144_length_467_cov_6.625000	257	328	16	1	71	0.0140845
NODE_50144_length_467_cov_6.625000	257	328	17	23	71	0.3239437
NODE_50197_length_467_cov_2.709239	247	327	0	29	80	0.3625000
NODE_50197_length_467_cov_2.709239	247	327	2	24	80	0.3000000
NODE_50197_length_467_cov_2.709239	247	327	4	2	80	0.0250000
NODE_50197_length_467_cov_2.709239	247	327	6	25	80	0.3125000
NODE_50215_length_467_cov_2.296196	284	329	0	45	45	1.0000000
NODE_50238_length_467_cov_2.027174	218	269	0	51	51	1.0000000
NODE_50252_length_467_cov_1.836957	55	118	0	63	63	1.0000000
NODE_50267_length_467_cov_1.603261	92	141	0	7	49	0.1428571
NODE_50267_length_467_cov_1.603261	92	141	2	31	49	0.6326531
NODE_50267_length_467_cov_1.603261	92	141	8	1	49	0.0204082
NODE_50267_length_467_cov_1.603261	92	141	9	10	49	0.2040816
NODE_50283_length_467_cov_1.426630	135	183	0	48	48	1.0000000
NODE_50447_length_466_cov_42.839237	0	47	0	47	47	1.0000000
NODE_50447_length_466_cov_42.839237	20	100	0	80	80	1.0000000
NODE_50447_length_466_cov_42.839237	96	176	0	80	80	1.0000000
NODE_50447_length_466_cov_42.839237	149	229	0	80	80	1.0000000
NODE_50448_length_466_cov_36.901907	85	165	0	80	80	1.0000000
NODE_50448_length_466_cov_36.901907	138	218	0	80	80	1.0000000
NODE_50448_length_466_cov_36.901907	214	294	0	80	80	1.0000000
NODE_50448_length_466_cov_36.901907	267	347	0	80	80	1.0000000
NODE_50457_length_466_cov_5.122616	275	316	0	41	41	1.0000000
NODE_50457_length_466_cov_5.122616	276	316	0	40	40	1.0000000
NODE_50457_length_466_cov_5.122616	289	338	0	49	49	1.0000000
NODE_50515_length_466_cov_2.602180	9	90	2	81	81	1.0000000
NODE_50515_length_466_cov_2.602180	312	341	4	14	29	0.4827586
NODE_50515_length_466_cov_2.602180	312	341	6	15	29	0.5172414
NODE_50549_length_466_cov_2.108992	130	182	4	52	52	1.0000000
NODE_50562_length_466_cov_1.980926	183	265	0	29	82	0.3536585
NODE_50562_length_466_cov_1.980926	183	265	2	7	82	0.0853659
NODE_50562_length_466_cov_1.980926	183	265	3	7	82	0.0853659
NODE_50562_length_466_cov_1.980926	183	265	4	39	82	0.4756097
NODE_50787_length_465_cov_13.019126	170	250	2	80	80	1.0000000
NODE_50787_length_465_cov_13.019126	223	301	0	2	78	0.0256410
NODE_50787_length_465_cov_13.019126	223	301	2	76	78	0.9743590
NODE_50799_length_465_cov_5.363388	316	393	0	77	77	1.0000000
NODE_50800_length_465_cov_4.898907	376	406	0	30	30	1.0000000
NODE_50869_length_465_cov_2.366120	147	227	0	80	80	1.0000000
NODE_50869_length_465_cov_2.366120	200	271	0	71	71	1.0000000
NODE_50911_length_465_cov_1.737705	338	383	6	35	45	0.7777778
NODE_50911_length_465_cov_1.737705	338	383	8	6	45	0.1333333
NODE_50911_length_465_cov_1.737705	338	383	10	4	45	0.0888889
NODE_51100_length_464_cov_8.473973	209	289	0	80	80	1.0000000
NODE_51100_length_464_cov_8.473973	262	342	0	80	80	1.0000000
NODE_51148_length_464_cov_2.528767	136	199	0	63	63	1.0000000
NODE_51167_length_464_cov_2.134247	130	203	1	18	73	0.2465753
NODE_51167_length_464_cov_2.134247	130	203	2	6	73	0.0821918
NODE_51167_length_464_cov_2.134247	130	203	4	49	73	0.6712329
NODE_51186_length_464_cov_1.901370	58	138	2	68	80	0.8500000
NODE_51186_length_464_cov_1.901370	58	138	4	12	80	0.1500000
NODE_51203_length_464_cov_1.706849	186	265	0	6	79	0.0759494
NODE_51203_length_464_cov_1.706849	186	265	2	12	79	0.1518987
NODE_51203_length_464_cov_1.706849	186	265	4	61	79	0.7721519
NODE_51377_length_463_cov_64.420330	375	455	0	1	80	0.0125000
NODE_51377_length_463_cov_64.420330	375	455	2	32	80	0.4000000
NODE_51377_length_463_cov_64.420330	375	455	10	27	80	0.3375000
NODE_51377_length_463_cov_64.420330	375	455	15	5	80	0.0625000
NODE_51377_length_463_cov_64.420330	375	455	24	11	80	0.1375000
NODE_51377_length_463_cov_64.420330	375	455	31	1	80	0.0125000
NODE_51377_length_463_cov_64.420330	375	455	32	3	80	0.0375000
NODE_51377_length_463_cov_64.420330	375	455	0	1	80	0.0125000
NODE_51377_length_463_cov_64.420330	375	455	2	32	80	0.4000000
NODE_51377_length_463_cov_64.420330	375	455	10	27	80	0.3375000
NODE_51377_length_463_cov_64.420330	375	455	15	5	80	0.0625000
NODE_51377_length_463_cov_64.420330	375	455	24	11	80	0.1375000
NODE_51377_length_463_cov_64.420330	375	455	31	1	80	0.0125000
NODE_51377_length_463_cov_64.420330	375	455	32	3	80	0.0375000
NODE_51377_length_463_cov_64.420330	375	455	0	1	80	0.0125000
NODE_51377_length_463_cov_64.420330	375	455	2	32	80	0.4000000
NODE_51377_length_463_cov_64.420330	375	455	10	27	80	0.3375000
NODE_51377_length_463_cov_64.420330	375	455	15	5	80	0.0625000
NODE_51377_length_463_cov_64.420330	375	455	24	11	80	0.1375000
NODE_51377_length_463_cov_64.420330	375	455	31	1	80	0.0125000
NODE_51377_length_463_cov_64.420330	375	455	32	3	80	0.0375000
NODE_51377_length_463_cov_64.420330	375	455	0	1	80	0.0125000
NODE_51377_length_463_cov_64.420330	375	455	2	32	80	0.4000000
NODE_51377_length_463_cov_64.420330	375	455	10	27	80	0.3375000
NODE_51377_length_463_cov_64.420330	375	455	15	5	80	0.0625000
NODE_51377_length_463_cov_64.420330	375	455	24	11	80	0.1375000
NODE_51377_length_463_cov_64.420330	375	455	31	1	80	0.0125000
NODE_51377_length_463_cov_64.420330	375	455	32	3	80	0.0375000
NODE_51377_length_463_cov_64.420330	375	455	0	1	80	0.0125000
NODE_51377_length_463_cov_64.420330	375	455	2	32	80	0.4000000
NODE_51377_length_463_cov_64.420330	375	455	10	27	80	0.3375000
NODE_51377_length_463_cov_64.420330	375	455	15	5	80	0.0625000
NODE_51377_length_463_cov_64.420330	375	455	24	11	80	0.1375000
NODE_51377_length_463_cov_64.420330	375	455	31	1	80	0.0125000
NODE_51377_length_463_cov_64.420330	375	455	32	3	80	0.0375000
NODE_51378_length_463_cov_49.673077	0	71	0	1	71	0.0140845
NODE_51378_length_463_cov_49.673077	0	71	8	12	71	0.1690141
NODE_51378_length_463_cov_49.673077	0	71	12	58	71	0.8169014
NODE_51378_length_463_cov_49.673077	44	121	12	77	77	1.0000000
NODE_51379_length_463_cov_41.005495	8	88	2	80	80	1.0000000
NODE_51379_length_463_cov_41.005495	61	141	0	24	80	0.3000000
NODE_51379_length_463_cov_41.005495	61	141	2	56	80	0.7000000
NODE_51380_length_463_cov_30.626374	318	398	0	28	80	0.3500000
NODE_51380_length_463_cov_30.626374	318	398	2	52	80	0.6500000
NODE_51380_length_463_cov_30.626374	371	451	0	59	80	0.7375000
NODE_51380_length_463_cov_30.626374	371	451	2	21	80	0.2625000
NODE_51381_length_463_cov_27.475275	211	291	0	16	80	0.2000000
NODE_51381_length_463_cov_27.475275	211	291	2	64	80	0.8000000
NODE_51381_length_463_cov_27.475275	264	344	0	25	80	0.3125000
NODE_51381_length_463_cov_27.475275	264	344	2	55	80	0.6875000
NODE_51383_length_463_cov_11.211538	304	377	20	63	73	0.8630137
NODE_51383_length_463_cov_11.211538	304	377	22	10	73	0.1369863
NODE_51383_length_463_cov_11.211538	350	430	6	5	80	0.0625000
NODE_51383_length_463_cov_11.211538	350	430	15	1	80	0.0125000
NODE_51383_length_463_cov_11.211538	350	430	16	8	80	0.1000000
NODE_51383_length_463_cov_11.211538	350	430	20	38	80	0.4750000
NODE_51383_length_463_cov_11.211538	350	430	22	28	80	0.3500000
NODE_51391_length_463_cov_5.711538	181	261	0	80	80	1.0000000
NODE_51391_length_463_cov_5.711538	234	314	0	80	80	1.0000000
NODE_51399_length_463_cov_4.398352	119	169	0	50	50	1.0000000
NODE_51402_length_463_cov_4.186813	175	233	16	1	58	0.0172414
NODE_51402_length_463_cov_4.186813	175	233	18	37	58	0.6379310
NODE_51402_length_463_cov_4.186813	175	233	20	20	58	0.3448276
NODE_51402_length_463_cov_4.186813	206	251	18	41	45	0.9111111
NODE_51402_length_463_cov_4.186813	206	251	20	4	45	0.0888889
NODE_51408_length_463_cov_3.846154	235	268	2	6	33	0.1818182
NODE_51408_length_463_cov_3.846154	235	268	8	8	33	0.2424242
NODE_51408_length_463_cov_3.846154	235	268	10	19	33	0.5757576
NODE_51421_length_463_cov_3.063187	193	248	0	55	55	1.0000000
NODE_51421_length_463_cov_3.063187	222	301	0	79	79	1.0000000
NODE_51680_length_462_cov_21.876033	93	173	0	80	80	1.0000000
NODE_51680_length_462_cov_21.876033	146	226	0	80	80	1.0000000
NODE_51687_length_462_cov_5.033058	93	154	0	6	61	0.0983607
NODE_51687_length_462_cov_5.033058	93	154	4	55	61	0.9016393
NODE_51687_length_462_cov_5.033058	159	209	4	50	50	1.0000000
NODE_51699_length_462_cov_4.101928	168	246	0	74	78	0.9487180
NODE_51699_length_462_cov_4.101928	168	246	2	4	78	0.0512821
NODE_51699_length_462_cov_4.101928	184	208	0	24	24	1.0000000
NODE_51699_length_462_cov_4.101928	219	299	0	80	80	1.0000000
NODE_51708_length_462_cov_3.630854	149	194	2	45	45	1.0000000
NODE_51720_length_462_cov_3.079890	103	147	0	34	44	0.7727273
NODE_51720_length_462_cov_3.079890	103	147	4	3	44	0.0681818
NODE_51720_length_462_cov_3.079890	103	147	6	7	44	0.1590909
NODE_51735_length_462_cov_2.677686	78	118	0	40	40	1.0000000
NODE_51763_length_462_cov_2.209366	18	58	0	40	40	1.0000000
NODE_51817_length_462_cov_1.570248	68	113	0	45	45	1.0000000
NODE_51995_length_461_cov_35.116022	0	79	0	79	79	1.0000000
NODE_51995_length_461_cov_35.116022	52	132	0	80	80	1.0000000
NODE_51996_length_461_cov_11.124309	77	157	0	80	80	1.0000000
NODE_51996_length_461_cov_11.124309	130	210	0	80	80	1.0000000
NODE_52010_length_461_cov_5.361878	246	322	4	62	76	0.8157895
NODE_52010_length_461_cov_5.361878	246	322	6	14	76	0.1842105
NODE_52018_length_461_cov_4.472376	268	333	6	65	65	1.0000000
NODE_52021_length_461_cov_4.168508	159	234	0	75	75	1.0000000
NODE_52047_length_461_cov_2.892265	233	312	0	79	79	1.0000000
NODE_52073_length_461_cov_2.392265	186	223	0	37	37	1.0000000
NODE_52154_length_461_cov_1.389503	283	349	4	66	66	1.0000000
NODE_52292_length_460_cov_172.986150	0	68	34	1	68	0.0147059
NODE_52292_length_460_cov_172.986150	0	68	41	1	68	0.0147059
NODE_52292_length_460_cov_172.986150	0	68	43	1	68	0.0147059
NODE_52292_length_460_cov_172.986150	0	68	55	1	68	0.0147059
NODE_52292_length_460_cov_172.986150	0	68	63	1	68	0.0147059
NODE_52292_length_460_cov_172.986150	0	68	67	1	68	0.0147059
NODE_52292_length_460_cov_172.986150	0	68	69	1	68	0.0147059
NODE_52292_length_460_cov_172.986150	0	68	83	1	68	0.0147059
NODE_52292_length_460_cov_172.986150	0	68	96	1	68	0.0147059
NODE_52292_length_460_cov_172.986150	0	68	113	1	68	0.0147059
NODE_52292_length_460_cov_172.986150	0	68	124	1	68	0.0147059
NODE_52292_length_460_cov_172.986150	0	68	131	1	68	0.0147059
NODE_52292_length_460_cov_172.986150	0	68	153	1	68	0.0147059
NODE_52292_length_460_cov_172.986150	0	68	168	1	68	0.0147059
NODE_52292_length_460_cov_172.986150	0	68	174	1	68	0.0147059
NODE_52292_length_460_cov_172.986150	0	68	179	1	68	0.0147059
NODE_52292_length_460_cov_172.986150	0	68	201	1	68	0.0147059
NODE_52292_length_460_cov_172.986150	0	68	217	1	68	0.0147059
NODE_52292_length_460_cov_172.986150	0	68	233	1	68	0.0147059
NODE_52292_length_460_cov_172.986150	0	68	241	1	68	0.0147059
NODE_52292_length_460_cov_172.986150	0	68	268	1	68	0.0147059
NODE_52292_length_460_cov_172.986150	0	68	272	1	68	0.0147059
NODE_52292_length_460_cov_172.986150	0	68	274	1	68	0.0147059
NODE_52292_length_460_cov_172.986150	0	68	285	1	68	0.0147059
NODE_52292_length_460_cov_172.986150	0	68	304	1	68	0.0147059
NODE_52292_length_460_cov_172.986150	0	68	313	1	68	0.0147059
NODE_52292_length_460_cov_172.986150	0	68	317	1	68	0.0147059
NODE_52292_length_460_cov_172.986150	0	68	325	1	68	0.0147059
NODE_52292_length_460_cov_172.986150	0	68	331	1	68	0.0147059
NODE_52292_length_460_cov_172.986150	0	68	345	1	68	0.0147059
NODE_52292_length_460_cov_172.986150	0	68	351	1	68	0.0147059
NODE_52292_length_460_cov_172.986150	0	68	353	1	68	0.0147059
NODE_52292_length_460_cov_172.986150	0	68	359	2	68	0.0294118
NODE_52292_length_460_cov_172.986150	0	68	365	1	68	0.0147059
NODE_52292_length_460_cov_172.986150	0	68	366	1	68	0.0147059
NODE_52292_length_460_cov_172.986150	0	68	367	1	68	0.0147059
NODE_52292_length_460_cov_172.986150	0	68	381	1	68	0.0147059
NODE_52292_length_460_cov_172.986150	0	68	385	1	68	0.0147059
NODE_52292_length_460_cov_172.986150	0	68	390	1	68	0.0147059
NODE_52292_length_460_cov_172.986150	0	68	398	1	68	0.0147059
NODE_52292_length_460_cov_172.986150	0	68	402	1	68	0.0147059
NODE_52292_length_460_cov_172.986150	0	68	417	1	68	0.0147059
NODE_52292_length_460_cov_172.986150	0	68	420	1	68	0.0147059
NODE_52292_length_460_cov_172.986150	0	68	424	1	68	0.0147059
NODE_52292_length_460_cov_172.986150	0	68	436	1	68	0.0147059
NODE_52292_length_460_cov_172.986150	0	68	440	1	68	0.0147059
NODE_52292_length_460_cov_172.986150	0	68	449	1	68	0.0147059
NODE_52292_length_460_cov_172.986150	0	68	459	1	68	0.0147059
NODE_52292_length_460_cov_172.986150	0	68	461	1	68	0.0147059
NODE_52292_length_460_cov_172.986150	0	68	479	1	68	0.0147059
NODE_52292_length_460_cov_172.986150	0	68	485	1	68	0.0147059
NODE_52292_length_460_cov_172.986150	0	68	495	2	68	0.0294118
NODE_52292_length_460_cov_172.986150	0	68	531	1	68	0.0147059
NODE_52292_length_460_cov_172.986150	0	68	540	1	68	0.0147059
NODE_52292_length_460_cov_172.986150	0	68	541	1	68	0.0147059
NODE_52292_length_460_cov_172.986150	0	68	543	1	68	0.0147059
NODE_52292_length_460_cov_172.986150	0	68	551	1	68	0.0147059
NODE_52292_length_460_cov_172.986150	0	68	560	1	68	0.0147059
NODE_52292_length_460_cov_172.986150	0	68	562	1	68	0.0147059
NODE_52292_length_460_cov_172.986150	0	68	567	3	68	0.0441176
NODE_52292_length_460_cov_172.986150	0	68	568	1	68	0.0147059
NODE_52292_length_460_cov_172.986150	0	68	577	1	68	0.0147059
NODE_52292_length_460_cov_172.986150	0	68	583	2	68	0.0294118
NODE_52292_length_460_cov_172.986150	41	121	402	1	80	0.0125000
NODE_52292_length_460_cov_172.986150	41	121	417	1	80	0.0125000
NODE_52292_length_460_cov_172.986150	41	121	420	1	80	0.0125000
NODE_52292_length_460_cov_172.986150	41	121	424	1	80	0.0125000
NODE_52292_length_460_cov_172.986150	41	121	436	1	80	0.0125000
NODE_52292_length_460_cov_172.986150	41	121	440	1	80	0.0125000
NODE_52292_length_460_cov_172.986150	41	121	449	1	80	0.0125000
NODE_52292_length_460_cov_172.986150	41	121	459	1	80	0.0125000
NODE_52292_length_460_cov_172.986150	41	121	461	1	80	0.0125000
NODE_52292_length_460_cov_172.986150	41	121	479	1	80	0.0125000
NODE_52292_length_460_cov_172.986150	41	121	485	1	80	0.0125000
NODE_52292_length_460_cov_172.986150	41	121	495	2	80	0.0250000
NODE_52292_length_460_cov_172.986150	41	121	531	1	80	0.0125000
NODE_52292_length_460_cov_172.986150	41	121	540	1	80	0.0125000
NODE_52292_length_460_cov_172.986150	41	121	541	1	80	0.0125000
NODE_52292_length_460_cov_172.986150	41	121	543	1	80	0.0125000
NODE_52292_length_460_cov_172.986150	41	121	551	1	80	0.0125000
NODE_52292_length_460_cov_172.986150	41	121	560	1	80	0.0125000
NODE_52292_length_460_cov_172.986150	41	121	562	1	80	0.0125000
NODE_52292_length_460_cov_172.986150	41	121	567	3	80	0.0375000
NODE_52292_length_460_cov_172.986150	41	121	568	1	80	0.0125000
NODE_52292_length_460_cov_172.986150	41	121	577	1	80	0.0125000
NODE_52292_length_460_cov_172.986150	41	121	583	2	80	0.0250000
NODE_52292_length_460_cov_172.986150	41	121	585	2	80	0.0250000
NODE_52292_length_460_cov_172.986150	41	121	592	1	80	0.0125000
NODE_52292_length_460_cov_172.986150	41	121	595	1	80	0.0125000
NODE_52292_length_460_cov_172.986150	41	121	600	2	80	0.0250000
NODE_52292_length_460_cov_172.986150	41	121	602	1	80	0.0125000
NODE_52292_length_460_cov_172.986150	41	121	604	1	80	0.0125000
NODE_52292_length_460_cov_172.986150	41	121	612	2	80	0.0250000
NODE_52292_length_460_cov_172.986150	41	121	614	1	80	0.0125000
NODE_52292_length_460_cov_172.986150	41	121	622	1	80	0.0125000
NODE_52292_length_460_cov_172.986150	41	121	624	1	80	0.0125000
NODE_52292_length_460_cov_172.986150	41	121	630	1	80	0.0125000
NODE_52292_length_460_cov_172.986150	41	121	637	1	80	0.0125000
NODE_52292_length_460_cov_172.986150	41	121	642	1	80	0.0125000
NODE_52292_length_460_cov_172.986150	41	121	647	1	80	0.0125000
NODE_52292_length_460_cov_172.986150	41	121	651	1	80	0.0125000
NODE_52292_length_460_cov_172.986150	41	121	653	2	80	0.0250000
NODE_52292_length_460_cov_172.986150	41	121	664	1	80	0.0125000
NODE_52292_length_460_cov_172.986150	41	121	668	1	80	0.0125000
NODE_52292_length_460_cov_172.986150	41	121	673	1	80	0.0125000
NODE_52292_length_460_cov_172.986150	41	121	680	1	80	0.0125000
NODE_52292_length_460_cov_172.986150	41	121	683	1	80	0.0125000
NODE_52292_length_460_cov_172.986150	41	121	698	1	80	0.0125000
NODE_52292_length_460_cov_172.986150	41	121	702	1	80	0.0125000
NODE_52292_length_460_cov_172.986150	41	121	708	1	80	0.0125000
NODE_52292_length_460_cov_172.986150	41	121	716	1	80	0.0125000
NODE_52292_length_460_cov_172.986150	41	121	720	1	80	0.0125000
NODE_52292_length_460_cov_172.986150	41	121	726	1	80	0.0125000
NODE_52292_length_460_cov_172.986150	41	121	738	1	80	0.0125000
NODE_52292_length_460_cov_172.986150	41	121	746	2	80	0.0250000
NODE_52292_length_460_cov_172.986150	41	121	748	1	80	0.0125000
NODE_52292_length_460_cov_172.986150	41	121	756	2	80	0.0250000
NODE_52292_length_460_cov_172.986150	41	121	758	1	80	0.0125000
NODE_52292_length_460_cov_172.986150	41	121	762	1	80	0.0125000
NODE_52292_length_460_cov_172.986150	41	121	764	2	80	0.0250000
NODE_52292_length_460_cov_172.986150	41	121	770	1	80	0.0125000
NODE_52292_length_460_cov_172.986150	41	121	778	1	80	0.0125000
NODE_52292_length_460_cov_172.986150	41	121	779	1	80	0.0125000
NODE_52292_length_460_cov_172.986150	41	121	783	1	80	0.0125000
NODE_52292_length_460_cov_172.986150	41	121	787	2	80	0.0250000
NODE_52292_length_460_cov_172.986150	41	121	828	1	80	0.0125000
NODE_52292_length_460_cov_172.986150	41	121	830	1	80	0.0125000
NODE_52292_length_460_cov_172.986150	41	121	834	1	80	0.0125000
NODE_52292_length_460_cov_172.986150	41	121	841	2	80	0.0250000
NODE_52292_length_460_cov_172.986150	41	121	851	1	80	0.0125000
NODE_52293_length_460_cov_62.512465	9	48	1	1	39	0.0256410
NODE_52293_length_460_cov_62.512465	9	48	3	3	39	0.0769231
NODE_52293_length_460_cov_62.512465	9	48	5	6	39	0.1538462
NODE_52293_length_460_cov_62.512465	9	48	6	10	39	0.2564103
NODE_52293_length_460_cov_62.512465	9	48	7	2	39	0.0512821
NODE_52293_length_460_cov_62.512465	9	48	8	17	39	0.4358974
NODE_52294_length_460_cov_33.146814	0	47	0	47	47	1.0000000
NODE_52294_length_460_cov_33.146814	43	115	0	72	72	1.0000000
NODE_52294_length_460_cov_33.146814	96	165	0	69	69	1.0000000
NODE_52295_length_460_cov_26.049861	0	63	1	2	63	0.0317460
NODE_52295_length_460_cov_26.049861	0	63	2	8	63	0.1269841
NODE_52295_length_460_cov_26.049861	0	63	4	3	63	0.0476190
NODE_52295_length_460_cov_26.049861	0	63	12	2	63	0.0317460
NODE_52295_length_460_cov_26.049861	0	63	14	7	63	0.1111111
NODE_52295_length_460_cov_26.049861	0	63	16	13	63	0.2063492
NODE_52295_length_460_cov_26.049861	0	63	18	5	63	0.0793651
NODE_52295_length_460_cov_26.049861	0	63	20	7	63	0.1111111
NODE_52295_length_460_cov_26.049861	0	63	28	1	63	0.0158730
NODE_52295_length_460_cov_26.049861	0	63	32	1	63	0.0158730
NODE_52295_length_460_cov_26.049861	0	63	38	3	63	0.0476190
NODE_52295_length_460_cov_26.049861	0	63	40	3	63	0.0476190
NODE_52295_length_460_cov_26.049861	0	63	41	8	63	0.1269841
NODE_52296_length_460_cov_25.709141	246	326	0	80	80	1.0000000
NODE_52296_length_460_cov_25.709141	299	379	0	80	80	1.0000000
NODE_52297_length_460_cov_11.063712	273	353	0	80	80	1.0000000
NODE_52297_length_460_cov_11.063712	326	406	0	80	80	1.0000000
NODE_52303_length_460_cov_7.285319	172	250	0	78	78	1.0000000
NODE_52312_length_460_cov_5.163435	120	200	0	41	80	0.5125000
NODE_52312_length_460_cov_5.163435	120	200	2	39	80	0.4875000
NODE_52312_length_460_cov_5.163435	173	253	0	18	80	0.2250000
NODE_52312_length_460_cov_5.163435	173	253	2	62	80	0.7750000
NODE_52333_length_460_cov_3.457064	150	230	0	38	80	0.4750000
NODE_52333_length_460_cov_3.457064	150	230	2	42	80	0.5250000
NODE_52333_length_460_cov_3.457064	203	246	2	43	43	1.0000000
NODE_52339_length_460_cov_3.027701	167	230	0	18	63	0.2857143
NODE_52339_length_460_cov_3.027701	167	230	2	45	63	0.7142857
NODE_52347_length_460_cov_2.819945	195	266	0	71	71	1.0000000
NODE_52358_length_460_cov_2.626039	223	277	0	54	54	1.0000000
NODE_52612_length_459_cov_34.927778	165	239	0	73	74	0.9864865
NODE_52612_length_459_cov_34.927778	165	239	2	1	74	0.0135135
NODE_52612_length_459_cov_34.927778	212	292	0	66	80	0.8250000
NODE_52612_length_459_cov_34.927778	212	292	5	14	80	0.1750000
NODE_52617_length_459_cov_7.261111	143	189	0	46	46	1.0000000
NODE_52617_length_459_cov_7.261111	162	242	0	80	80	1.0000000
NODE_52635_length_459_cov_4.127778	153	233	0	6	80	0.0750000
NODE_52635_length_459_cov_4.127778	153	233	2	7	80	0.0875000
NODE_52635_length_459_cov_4.127778	153	233	6	67	80	0.8375000
NODE_52685_length_459_cov_2.158333	219	285	0	66	66	1.0000000
NODE_52685_length_459_cov_2.158333	283	342	0	59	59	1.0000000
NODE_52704_length_459_cov_1.722222	280	353	0	45	73	0.6164383
NODE_52704_length_459_cov_1.722222	280	353	2	28	73	0.3835616
NODE_52920_length_458_cov_71.047354	0	51	0	51	51	1.0000000
NODE_52920_length_458_cov_71.047354	24	104	0	80	80	1.0000000
NODE_52920_length_458_cov_71.047354	100	180	0	33	80	0.4125000
NODE_52920_length_458_cov_71.047354	100	180	2	24	80	0.3000000
NODE_52920_length_458_cov_71.047354	100	180	4	23	80	0.2875000
NODE_52920_length_458_cov_71.047354	153	233	0	2	80	0.0250000
NODE_52920_length_458_cov_71.047354	153	233	2	19	80	0.2375000
NODE_52920_length_458_cov_71.047354	153	233	4	59	80	0.7375000
NODE_52921_length_458_cov_47.966574	151	231	0	80	80	1.0000000
NODE_52921_length_458_cov_47.966574	204	284	0	80	80	1.0000000
NODE_52921_length_458_cov_47.966574	280	360	0	80	80	1.0000000
NODE_52921_length_458_cov_47.966574	333	413	0	80	80	1.0000000
NODE_52924_length_458_cov_9.935933	267	347	0	8	80	0.1000000
NODE_52924_length_458_cov_9.935933	267	347	2	72	80	0.9000000
NODE_52924_length_458_cov_9.935933	320	400	0	61	80	0.7625000
NODE_52924_length_458_cov_9.935933	320	400	2	19	80	0.2375000
NODE_52929_length_458_cov_7.598886	87	167	2	4	80	0.0500000
NODE_52929_length_458_cov_7.598886	87	167	3	6	80	0.0750000
NODE_52929_length_458_cov_7.598886	87	167	4	35	80	0.4375000
NODE_52929_length_458_cov_7.598886	87	167	6	35	80	0.4375000
NODE_52967_length_458_cov_3.061281	62	91	4	19	29	0.6551724
NODE_52967_length_458_cov_3.061281	62	91	6	10	29	0.3448276
NODE_52967_length_458_cov_3.061281	185	224	0	33	39	0.8461539
NODE_52967_length_458_cov_3.061281	185	224	2	6	39	0.1538462
NODE_52992_length_458_cov_2.454039	210	251	0	41	41	1.0000000
NODE_53107_length_458_cov_1.139276	242	289	0	47	47	1.0000000
NODE_53107_length_458_cov_1.139276	262	328	0	66	66	1.0000000
NODE_53205_length_457_cov_20.754190	123	203	0	80	80	1.0000000
NODE_53205_length_457_cov_20.754190	176	256	0	80	80	1.0000000
NODE_53207_length_457_cov_13.918994	218	298	0	80	80	1.0000000
NODE_53207_length_457_cov_13.918994	218	298	0	80	80	1.0000000
NODE_53207_length_457_cov_13.918994	218	298	0	80	80	1.0000000
NODE_53207_length_457_cov_13.918994	218	298	0	80	80	1.0000000
NODE_53207_length_457_cov_13.918994	271	320	0	49	49	1.0000000
NODE_53207_length_457_cov_13.918994	271	320	0	49	49	1.0000000
NODE_53207_length_457_cov_13.918994	271	320	0	49	49	1.0000000
NODE_53216_length_457_cov_6.050279	264	326	2	62	62	1.0000000
NODE_53220_length_457_cov_5.078212	71	149	0	78	78	1.0000000
NODE_53220_length_457_cov_5.078212	122	202	0	80	80	1.0000000
NODE_53225_length_457_cov_4.530726	193	273	2	30	80	0.3750000
NODE_53225_length_457_cov_4.530726	193	273	4	50	80	0.6250000
NODE_53225_length_457_cov_4.530726	246	315	0	23	69	0.3333333
NODE_53225_length_457_cov_4.530726	246	315	2	15	69	0.2173913
NODE_53225_length_457_cov_4.530726	246	315	4	31	69	0.4492754
NODE_53230_length_457_cov_3.986034	192	272	0	80	80	1.0000000
NODE_53267_length_457_cov_2.636872	117	197	0	80	80	1.0000000
NODE_53462_length_457_cov_0.916201	108	188	0	80	80	1.0000000
NODE_53462_length_457_cov_0.916201	108	188	0	80	80	1.0000000
NODE_53462_length_457_cov_0.916201	161	241	0	80	80	1.0000000
NODE_53462_length_457_cov_0.916201	161	241	0	80	80	1.0000000
NODE_53512_length_456_cov_34.731092	0	63	0	63	63	1.0000000
NODE_53512_length_456_cov_34.731092	36	116	0	80	80	1.0000000
NODE_53512_length_456_cov_34.731092	112	194	0	82	82	1.0000000
NODE_53532_length_456_cov_4.582633	269	349	0	80	80	1.0000000
NODE_53533_length_456_cov_4.554622	124	206	0	82	82	1.0000000
NODE_53533_length_456_cov_4.554622	179	263	0	84	84	1.0000000
NODE_53546_length_456_cov_3.669468	123	186	6	8	63	0.1269841
NODE_53546_length_456_cov_3.669468	123	186	8	39	63	0.6190476
NODE_53546_length_456_cov_3.669468	123	186	10	16	63	0.2539683
NODE_53566_length_456_cov_2.921569	302	362	2	60	60	1.0000000
NODE_53859_length_455_cov_113.589888	137	220	4	32	83	0.3855422
NODE_53859_length_455_cov_113.589888	137	220	6	51	83	0.6144578
NODE_53859_length_455_cov_113.589888	198	268	0	35	70	0.5000000
NODE_53859_length_455_cov_113.589888	198	268	4	35	70	0.5000000
NODE_53859_length_455_cov_113.589888	269	348	0	56	79	0.7088608
NODE_53859_length_455_cov_113.589888	269	348	2	23	79	0.2911392
NODE_53859_length_455_cov_113.589888	321	401	0	23	80	0.2875000
NODE_53859_length_455_cov_113.589888	321	401	2	57	80	0.7125000
NODE_53860_length_455_cov_52.941011	260	340	0	80	80	1.0000000
NODE_53860_length_455_cov_52.941011	313	393	0	80	80	1.0000000
NODE_53863_length_455_cov_8.584270	250	302	0	52	52	1.0000000
NODE_53863_length_455_cov_8.584270	275	355	0	80	80	1.0000000
NODE_53864_length_455_cov_8.084270	146	226	0	8	80	0.1000000
NODE_53864_length_455_cov_8.084270	146	226	7	1	80	0.0125000
NODE_53864_length_455_cov_8.084270	146	226	8	7	80	0.0875000
NODE_53864_length_455_cov_8.084270	146	226	10	8	80	0.1000000
NODE_53864_length_455_cov_8.084270	146	226	12	18	80	0.2250000
NODE_53864_length_455_cov_8.084270	146	226	14	38	80	0.4750000
NODE_53864_length_455_cov_8.084270	199	279	0	61	80	0.7625000
NODE_53864_length_455_cov_8.084270	199	279	7	1	80	0.0125000
NODE_53864_length_455_cov_8.084270	199	279	8	7	80	0.0875000
NODE_53864_length_455_cov_8.084270	199	279	10	8	80	0.1000000
NODE_53864_length_455_cov_8.084270	199	279	12	3	80	0.0375000
NODE_53870_length_455_cov_6.022472	122	203	4	8	81	0.0987654
NODE_53870_length_455_cov_6.022472	122	203	10	73	81	0.9012346
NODE_53872_length_455_cov_5.140449	181	232	0	51	51	1.0000000
NODE_54512_length_453_cov_29.528249	44	124	0	80	80	1.0000000
NODE_54512_length_453_cov_29.528249	97	177	0	80	80	1.0000000
NODE_54512_length_453_cov_29.528249	173	253	0	19	80	0.2375000
NODE_54512_length_453_cov_29.528249	173	253	8	2	80	0.0250000
NODE_54512_length_453_cov_29.528249	173	253	10	59	80	0.7375000
NODE_54512_length_453_cov_29.528249	226	301	4	4	75	0.0533333
NODE_54512_length_453_cov_29.528249	226	301	10	32	75	0.4266667
NODE_54512_length_453_cov_29.528249	226	301	11	22	75	0.2933333
NODE_54512_length_453_cov_29.528249	226	301	12	17	75	0.2266667
NODE_54513_length_453_cov_11.146893	95	140	0	45	45	1.0000000
NODE_54513_length_453_cov_11.146893	146	220	0	74	74	1.0000000
NODE_54517_length_453_cov_7.709040	194	252	2	35	58	0.6034483
NODE_54517_length_453_cov_7.709040	194	252	4	5	58	0.0862069
NODE_54517_length_453_cov_7.709040	194	252	6	8	58	0.1379310
NODE_54517_length_453_cov_7.709040	194	252	7	1	58	0.0172414
NODE_54517_length_453_cov_7.709040	194	252	8	9	58	0.1551724
NODE_54518_length_453_cov_7.440678	250	319	2	54	69	0.7826087
NODE_54518_length_453_cov_7.440678	250	319	4	15	69	0.2173913
NODE_54533_length_453_cov_4.282486	190	270	0	9	80	0.1125000
NODE_54533_length_453_cov_4.282486	190	270	4	71	80	0.8875000
NODE_54533_length_453_cov_4.282486	243	283	4	40	40	1.0000000
NODE_54566_length_453_cov_2.836158	186	266	0	9	80	0.1125000
NODE_54566_length_453_cov_2.836158	186	266	2	71	80	0.8875000
NODE_54566_length_453_cov_2.836158	239	319	0	37	80	0.4625000
NODE_54566_length_453_cov_2.836158	239	319	2	43	80	0.5375000
NODE_54592_length_453_cov_2.048023	139	174	5	13	35	0.3714286
NODE_54592_length_453_cov_2.048023	139	174	6	22	35	0.6285715
NODE_54600_length_453_cov_2.002825	78	98	0	20	20	1.0000000
NODE_54767_length_453_cov_0.774011	174	195	0	21	21	1.0000000
NODE_54822_length_452_cov_36.028329	0	72	0	19	72	0.2638889
NODE_54822_length_452_cov_36.028329	0	72	4	53	72	0.7361111
NODE_54822_length_452_cov_36.028329	0	72	0	19	72	0.2638889
NODE_54822_length_452_cov_36.028329	0	72	4	53	72	0.7361111
NODE_54822_length_452_cov_36.028329	45	99	4	54	54	1.0000000
NODE_54822_length_452_cov_36.028329	45	125	0	15	80	0.1875000
NODE_54822_length_452_cov_36.028329	45	125	2	5	80	0.0625000
NODE_54822_length_452_cov_36.028329	45	125	4	60	80	0.7500000
NODE_54823_length_452_cov_17.424929	29	109	0	16	80	0.2000000
NODE_54823_length_452_cov_17.424929	29	109	5	1	80	0.0125000
NODE_54823_length_452_cov_17.424929	29	109	6	62	80	0.7750000
NODE_54823_length_452_cov_17.424929	29	109	8	1	80	0.0125000
NODE_54823_length_452_cov_17.424929	82	162	0	6	80	0.0750000
NODE_54823_length_452_cov_17.424929	82	162	2	31	80	0.3875000
NODE_54823_length_452_cov_17.424929	82	162	6	26	80	0.3250000
NODE_54823_length_452_cov_17.424929	82	162	7	1	80	0.0125000
NODE_54823_length_452_cov_17.424929	82	162	8	16	80	0.2000000
NODE_54844_length_452_cov_4.317280	141	200	0	59	59	1.0000000
NODE_54886_length_452_cov_2.634561	262	338	0	38	76	0.5000000
NODE_54886_length_452_cov_2.634561	262	338	6	15	76	0.1973684
NODE_54886_length_452_cov_2.634561	262	338	8	23	76	0.3026316
NODE_55146_length_451_cov_37.090909	230	310	0	80	80	1.0000000
NODE_55146_length_451_cov_37.090909	283	363	0	80	80	1.0000000
NODE_55147_length_451_cov_16.517045	205	286	0	81	81	1.0000000
NODE_55147_length_451_cov_16.517045	259	339	0	80	80	1.0000000
NODE_55148_length_451_cov_13.153409	182	262	0	80	80	1.0000000
NODE_55148_length_451_cov_13.153409	235	315	0	80	80	1.0000000
NODE_55149_length_451_cov_11.926136	141	221	1	6	80	0.0750000
NODE_55149_length_451_cov_11.926136	141	221	3	3	80	0.0375000
NODE_55149_length_451_cov_11.926136	141	221	4	13	80	0.1625000
NODE_55149_length_451_cov_11.926136	141	221	6	11	80	0.1375000
NODE_55149_length_451_cov_11.926136	141	221	8	25	80	0.3125000
NODE_55149_length_451_cov_11.926136	141	221	10	4	80	0.0500000
NODE_55149_length_451_cov_11.926136	141	221	16	1	80	0.0125000
NODE_55149_length_451_cov_11.926136	141	221	17	17	80	0.2125000
NODE_55149_length_451_cov_11.926136	331	411	0	80	80	1.0000000
NODE_55154_length_451_cov_7.102273	81	143	0	62	62	1.0000000
NODE_55161_length_451_cov_5.610795	1	31	0	30	30	1.0000000
NODE_55161_length_451_cov_5.610795	60	90	0	30	30	1.0000000
NODE_55166_length_451_cov_5.065341	219	285	4	49	66	0.7424242
NODE_55166_length_451_cov_5.065341	219	285	6	17	66	0.2575758
NODE_55166_length_451_cov_5.065341	272	322	4	13	50	0.2600000
NODE_55166_length_451_cov_5.065341	272	322	6	37	50	0.7400000
NODE_55184_length_451_cov_3.696023	253	332	6	11	79	0.1392405
NODE_55184_length_451_cov_3.696023	253	332	12	3	79	0.0379747
NODE_55184_length_451_cov_3.696023	253	332	14	3	79	0.0379747
NODE_55184_length_451_cov_3.696023	253	332	16	4	79	0.0506329
NODE_55184_length_451_cov_3.696023	253	332	18	6	79	0.0759494
NODE_55184_length_451_cov_3.696023	253	332	20	10	79	0.1265823
NODE_55184_length_451_cov_3.696023	253	332	21	1	79	0.0126582
NODE_55184_length_451_cov_3.696023	253	332	22	3	79	0.0379747
NODE_55184_length_451_cov_3.696023	253	332	24	4	79	0.0506329
NODE_55184_length_451_cov_3.696023	253	332	28	7	79	0.0886076
NODE_55184_length_451_cov_3.696023	253	332	34	1	79	0.0126582
NODE_55184_length_451_cov_3.696023	253	332	36	1	79	0.0126582
NODE_55184_length_451_cov_3.696023	253	332	38	1	79	0.0126582
NODE_55184_length_451_cov_3.696023	253	332	42	8	79	0.1012658
NODE_55184_length_451_cov_3.696023	253	332	44	2	79	0.0253165
NODE_55184_length_451_cov_3.696023	253	332	46	2	79	0.0253165
NODE_55184_length_451_cov_3.696023	253	332	48	12	79	0.1518987
NODE_55188_length_451_cov_3.406250	176	247	5	12	71	0.1690141
NODE_55188_length_451_cov_3.406250	176	247	7	2	71	0.0281690
NODE_55188_length_451_cov_3.406250	176	247	10	1	71	0.0140845
NODE_55188_length_451_cov_3.406250	176	247	12	2	71	0.0281690
NODE_55188_length_451_cov_3.406250	176	247	14	2	71	0.0281690
NODE_55188_length_451_cov_3.406250	176	247	16	7	71	0.0985916
NODE_55188_length_451_cov_3.406250	176	247	18	13	71	0.1830986
NODE_55188_length_451_cov_3.406250	176	247	19	2	71	0.0281690
NODE_55188_length_451_cov_3.406250	176	247	20	30	71	0.4225352
NODE_55188_length_451_cov_3.406250	220	300	12	5	80	0.0625000
NODE_55188_length_451_cov_3.406250	220	300	14	1	80	0.0125000
NODE_55188_length_451_cov_3.406250	220	300	16	2	80	0.0250000
NODE_55188_length_451_cov_3.406250	220	300	18	49	80	0.6125000
NODE_55188_length_451_cov_3.406250	220	300	20	23	80	0.2875000
NODE_55198_length_451_cov_3.025568	72	148	0	76	76	1.0000000
NODE_55213_length_451_cov_2.607955	84	143	2	59	59	1.0000000
NODE_55213_length_451_cov_2.607955	257	326	0	69	69	1.0000000
NODE_55234_length_451_cov_2.125000	156	224	0	68	68	1.0000000
NODE_55436_length_450_cov_105.723647	317	386	0	68	69	0.9855072
NODE_55436_length_450_cov_105.723647	317	386	2	1	69	0.0144928
NODE_55438_length_450_cov_27.982906	98	120	0	22	22	1.0000000
NODE_55438_length_450_cov_27.982906	225	305	0	80	80	1.0000000
NODE_55438_length_450_cov_27.982906	278	358	0	80	80	1.0000000
NODE_55459_length_450_cov_3.991453	220	290	0	70	70	1.0000000
NODE_55459_length_450_cov_3.991453	223	290	0	67	67	1.0000000
NODE_55459_length_450_cov_3.991453	268	348	0	80	80	1.0000000
NODE_55459_length_450_cov_3.991453	268	348	0	80	80	1.0000000
NODE_55459_length_450_cov_3.991453	278	348	0	70	70	1.0000000
NODE_55459_length_450_cov_3.991453	344	363	0	19	19	1.0000000
NODE_55466_length_450_cov_3.717949	107	177	0	70	70	1.0000000
NODE_55483_length_450_cov_3.162393	99	157	0	58	58	1.0000000
NODE_55550_length_450_cov_1.857550	114	172	2	1	58	0.0172414
NODE_55550_length_450_cov_1.857550	114	172	6	2	58	0.0344828
NODE_55550_length_450_cov_1.857550	114	172	8	12	58	0.2068966
NODE_55550_length_450_cov_1.857550	114	172	10	2	58	0.0344828
NODE_55550_length_450_cov_1.857550	114	172	12	4	58	0.0689655
NODE_55550_length_450_cov_1.857550	114	172	13	3	58	0.0517241
NODE_55550_length_450_cov_1.857550	114	172	14	8	58	0.1379310
NODE_55550_length_450_cov_1.857550	114	172	15	13	58	0.2241379
NODE_55550_length_450_cov_1.857550	114	172	18	13	58	0.2241379
NODE_55560_length_450_cov_1.749288	321	376	0	55	55	1.0000000
NODE_55565_length_450_cov_1.723647	101	161	11	8	60	0.1333333
NODE_55565_length_450_cov_1.723647	101	161	13	2	60	0.0333333
NODE_55565_length_450_cov_1.723647	101	161	15	1	60	0.0166667
NODE_55565_length_450_cov_1.723647	101	161	17	9	60	0.1500000
NODE_55565_length_450_cov_1.723647	101	161	21	14	60	0.2333333
NODE_55565_length_450_cov_1.723647	101	161	23	26	60	0.4333333
NODE_55685_length_450_cov_1.017094	116	196	0	80	80	1.0000000
NODE_55761_length_449_cov_46.882857	237	317	0	80	80	1.0000000
NODE_55761_length_449_cov_46.882857	290	370	0	80	80	1.0000000
NODE_55762_length_449_cov_36.031429	238	318	0	18	80	0.2250000
NODE_55762_length_449_cov_36.031429	238	318	2	24	80	0.3000000
NODE_55762_length_449_cov_36.031429	238	318	17	2	80	0.0250000
NODE_55762_length_449_cov_36.031429	238	318	18	36	80	0.4500000
NODE_55762_length_449_cov_36.031429	291	371	18	80	80	1.0000000
NODE_55783_length_449_cov_4.594286	137	184	4	8	47	0.1702128
NODE_55783_length_449_cov_4.594286	137	184	6	35	47	0.7446808
NODE_55783_length_449_cov_4.594286	137	184	8	4	47	0.0851064
NODE_55794_length_449_cov_3.797143	204	284	0	1	80	0.0125000
NODE_55794_length_449_cov_3.797143	204	284	2	79	80	0.9875000
NODE_55844_length_449_cov_2.445714	346	376	0	30	30	1.0000000
NODE_56144_length_448_cov_44.664756	126	206	0	80	80	1.0000000
NODE_56144_length_448_cov_44.664756	179	259	0	80	80	1.0000000
NODE_56145_length_448_cov_36.148997	195	275	0	27	80	0.3375000
NODE_56145_length_448_cov_36.148997	195	275	2	19	80	0.2375000
NODE_56145_length_448_cov_36.148997	195	275	8	31	80	0.3875000
NODE_56145_length_448_cov_36.148997	195	275	10	3	80	0.0375000
NODE_56145_length_448_cov_36.148997	248	328	6	7	80	0.0875000
NODE_56145_length_448_cov_36.148997	248	328	8	38	80	0.4750000
NODE_56145_length_448_cov_36.148997	248	328	10	35	80	0.4375000
NODE_56145_length_448_cov_36.148997	324	404	2	63	80	0.7875000
NODE_56145_length_448_cov_36.148997	324	404	8	17	80	0.2125000
NODE_56145_length_448_cov_36.148997	377	448	0	27	71	0.3802817
NODE_56145_length_448_cov_36.148997	377	448	2	44	71	0.6197183
NODE_56146_length_448_cov_31.816619	43	123	0	80	80	1.0000000
NODE_56151_length_448_cov_6.779370	197	277	0	59	80	0.7375000
NODE_56151_length_448_cov_6.779370	197	277	2	21	80	0.2625000
NODE_56151_length_448_cov_6.779370	250	313	0	6	63	0.0952381
NODE_56151_length_448_cov_6.779370	250	313	2	57	63	0.9047619
NODE_56180_length_448_cov_3.664756	148	189	2	41	41	1.0000000
NODE_56189_length_448_cov_3.108883	242	324	6	1	82	0.0121951
NODE_56189_length_448_cov_3.108883	242	324	10	12	82	0.1463415
NODE_56189_length_448_cov_3.108883	242	324	14	5	82	0.0609756
NODE_56189_length_448_cov_3.108883	242	324	15	2	82	0.0243902
NODE_56189_length_448_cov_3.108883	242	324	19	6	82	0.0731707
NODE_56189_length_448_cov_3.108883	242	324	20	3	82	0.0365854
NODE_56189_length_448_cov_3.108883	242	324	22	33	82	0.4024390
NODE_56189_length_448_cov_3.108883	242	324	24	8	82	0.0975610
NODE_56189_length_448_cov_3.108883	242	324	26	12	82	0.1463415
NODE_56233_length_448_cov_2.263610	292	360	6	50	68	0.7352941
NODE_56233_length_448_cov_2.263610	292	360	8	18	68	0.2647059
NODE_56518_length_447_cov_10.505747	205	234	0	29	29	1.0000000
NODE_56518_length_447_cov_10.505747	267	326	0	59	59	1.0000000
NODE_56518_length_447_cov_10.505747	299	379	0	80	80	1.0000000
NODE_56527_length_447_cov_5.767241	176	256	0	17	80	0.2125000
NODE_56527_length_447_cov_5.767241	176	256	2	32	80	0.4000000
NODE_56527_length_447_cov_5.767241	176	256	4	31	80	0.3875000
NODE_56527_length_447_cov_5.767241	229	309	0	70	80	0.8750000
NODE_56527_length_447_cov_5.767241	229	309	2	10	80	0.1250000
NODE_56539_length_447_cov_4.583333	265	289	0	5	24	0.2083333
NODE_56539_length_447_cov_4.583333	265	289	1	1	24	0.0416667
NODE_56539_length_447_cov_4.583333	265	289	2	18	24	0.7500000
NODE_56545_length_447_cov_4.037356	58	138	0	53	80	0.6625000
NODE_56545_length_447_cov_4.037356	58	138	5	27	80	0.3375000
NODE_56545_length_447_cov_4.037356	111	191	5	80	80	1.0000000
NODE_56890_length_446_cov_42.527378	239	310	21	5	71	0.0704225
NODE_56890_length_446_cov_42.527378	239	310	24	5	71	0.0704225
NODE_56890_length_446_cov_42.527378	239	310	27	1	71	0.0140845
NODE_56890_length_446_cov_42.527378	239	310	33	1	71	0.0140845
NODE_56890_length_446_cov_42.527378	239	310	41	8	71	0.1126761
NODE_56890_length_446_cov_42.527378	239	310	44	1	71	0.0140845
NODE_56890_length_446_cov_42.527378	239	310	45	14	71	0.1971831
NODE_56890_length_446_cov_42.527378	239	310	46	18	71	0.2535211
NODE_56890_length_446_cov_42.527378	239	310	47	5	71	0.0704225
NODE_56890_length_446_cov_42.527378	239	310	48	2	71	0.0281690
NODE_56890_length_446_cov_42.527378	239	310	49	5	71	0.0704225
NODE_56890_length_446_cov_42.527378	239	310	50	4	71	0.0563380
NODE_56890_length_446_cov_42.527378	239	310	52	2	71	0.0281690
NODE_56890_length_446_cov_42.527378	359	433	14	4	74	0.0540541
NODE_56890_length_446_cov_42.527378	359	433	18	5	74	0.0675676
NODE_56890_length_446_cov_42.527378	359	433	20	3	74	0.0405405
NODE_56890_length_446_cov_42.527378	359	433	23	1	74	0.0135135
NODE_56890_length_446_cov_42.527378	359	433	24	5	74	0.0675676
NODE_56890_length_446_cov_42.527378	359	433	26	15	74	0.2027027
NODE_56890_length_446_cov_42.527378	359	433	32	6	74	0.0810811
NODE_56890_length_446_cov_42.527378	359	433	38	1	74	0.0135135
NODE_56890_length_446_cov_42.527378	359	433	39	4	74	0.0540541
NODE_56890_length_446_cov_42.527378	359	433	40	11	74	0.1486486
NODE_56890_length_446_cov_42.527378	359	433	42	5	74	0.0675676
NODE_56890_length_446_cov_42.527378	359	433	48	6	74	0.0810811
NODE_56890_length_446_cov_42.527378	359	433	50	4	74	0.0540541
NODE_56890_length_446_cov_42.527378	359	433	54	4	74	0.0540541
NODE_56891_length_446_cov_12.749280	92	172	0	54	80	0.6750000
NODE_56891_length_446_cov_12.749280	92	172	2	26	80	0.3250000
NODE_56891_length_446_cov_12.749280	145	225	0	1	80	0.0125000
NODE_56891_length_446_cov_12.749280	145	225	2	79	80	0.9875000
NODE_56896_length_446_cov_6.902017	175	217	0	42	42	1.0000000
NODE_56902_length_446_cov_5.930836	165	245	0	80	80	1.0000000
NODE_56902_length_446_cov_5.930836	165	245	0	80	80	1.0000000
NODE_56902_length_446_cov_5.930836	165	235	0	70	70	1.0000000
NODE_56902_length_446_cov_5.930836	218	298	0	80	80	1.0000000
NODE_56902_length_446_cov_5.930836	218	297	0	79	79	1.0000000
NODE_56919_length_446_cov_3.896254	215	274	6	4	59	0.0677966
NODE_56919_length_446_cov_3.896254	215	274	8	17	59	0.2881356
NODE_56919_length_446_cov_3.896254	215	274	10	38	59	0.6440678
NODE_56934_length_446_cov_3.282421	130	168	0	38	38	1.0000000
NODE_56952_length_446_cov_2.775216	337	417	2	80	80	1.0000000
NODE_56995_length_446_cov_2.161383	17	97	0	80	80	1.0000000
NODE_57022_length_446_cov_1.907781	196	225	8	13	29	0.4482759
NODE_57022_length_446_cov_1.907781	196	225	10	11	29	0.3793103
NODE_57022_length_446_cov_1.907781	196	225	14	3	29	0.1034483
NODE_57022_length_446_cov_1.907781	196	225	17	2	29	0.0689655
NODE_57277_length_445_cov_75.572254	108	188	0	80	80	1.0000000
NODE_57277_length_445_cov_75.572254	161	241	0	80	80	1.0000000
NODE_57277_length_445_cov_75.572254	237	317	0	80	80	1.0000000
NODE_57277_length_445_cov_75.572254	290	370	0	80	80	1.0000000
NODE_57278_length_445_cov_33.973988	83	163	0	80	80	1.0000000
NODE_57278_length_445_cov_33.973988	136	216	0	80	80	1.0000000
NODE_57280_length_445_cov_9.323699	78	148	0	70	70	1.0000000
NODE_57280_length_445_cov_9.323699	121	201	0	31	80	0.3875000
NODE_57280_length_445_cov_9.323699	121	201	2	49	80	0.6125000
NODE_57284_length_445_cov_6.439306	210	282	6	30	72	0.4166667
NODE_57284_length_445_cov_6.439306	210	282	8	42	72	0.5833333
NODE_57286_length_445_cov_5.479769	115	184	4	10	69	0.1449275
NODE_57286_length_445_cov_5.479769	115	184	6	59	69	0.8550724
NODE_57286_length_445_cov_5.479769	157	237	0	10	80	0.1250000
NODE_57286_length_445_cov_5.479769	157	237	2	18	80	0.2250000
NODE_57286_length_445_cov_5.479769	157	237	4	12	80	0.1500000
NODE_57286_length_445_cov_5.479769	157	237	6	40	80	0.5000000
NODE_57286_length_445_cov_5.479769	233	309	0	76	76	1.0000000
NODE_57286_length_445_cov_5.479769	286	309	0	23	23	1.0000000
NODE_57345_length_445_cov_2.843931	124	199	0	40	75	0.5333334
NODE_57345_length_445_cov_2.843931	124	199	2	35	75	0.4666667
NODE_57352_length_445_cov_2.682081	202	248	2	2	46	0.0434783
NODE_57352_length_445_cov_2.682081	202	248	4	44	46	0.9565217
NODE_57400_length_445_cov_1.884393	252	332	0	80	80	1.0000000
NODE_57409_length_445_cov_1.783237	132	203	0	3	71	0.0422535
NODE_57409_length_445_cov_1.783237	132	203	2	68	71	0.9577465
NODE_57409_length_445_cov_1.783237	256	331	0	43	75	0.5733333
NODE_57409_length_445_cov_1.783237	256	331	2	32	75	0.4266667
NODE_57409_length_445_cov_1.783237	256	278	0	22	22	1.0000000
NODE_57644_length_444_cov_34.075362	243	323	0	6	80	0.0750000
NODE_57644_length_444_cov_34.075362	243	323	10	74	80	0.9250000
NODE_57644_length_444_cov_34.075362	296	376	0	18	80	0.2250000
NODE_57644_length_444_cov_34.075362	296	376	10	62	80	0.7750000
NODE_57645_length_444_cov_22.524638	98	178	0	80	80	1.0000000
NODE_57645_length_444_cov_22.524638	151	231	0	80	80	1.0000000
NODE_57646_length_444_cov_16.544928	263	343	0	80	80	1.0000000
NODE_57646_length_444_cov_16.544928	316	396	0	80	80	1.0000000
NODE_57647_length_444_cov_12.684058	293	373	0	80	80	1.0000000
NODE_57647_length_444_cov_12.684058	346	426	0	80	80	1.0000000
NODE_57649_length_444_cov_9.284058	176	256	0	42	80	0.5250000
NODE_57649_length_444_cov_9.284058	176	256	4	14	80	0.1750000
NODE_57649_length_444_cov_9.284058	176	256	6	24	80	0.3000000
NODE_57649_length_444_cov_9.284058	229	309	0	12	80	0.1500000
NODE_57649_length_444_cov_9.284058	229	309	2	6	80	0.0750000
NODE_57649_length_444_cov_9.284058	229	309	4	3	80	0.0375000
NODE_57649_length_444_cov_9.284058	229	309	6	59	80	0.7375000
NODE_57666_length_444_cov_5.159420	170	241	0	71	71	1.0000000
NODE_57668_length_444_cov_5.060870	201	245	2	44	44	1.0000000
NODE_57668_length_444_cov_5.060870	218	298	2	62	80	0.7750000
NODE_57668_length_444_cov_5.060870	218	298	4	18	80	0.2250000
NODE_57717_length_444_cov_2.744928	73	136	0	2	63	0.0317460
NODE_57717_length_444_cov_2.744928	73	136	2	23	63	0.3650794
NODE_57717_length_444_cov_2.744928	73	136	4	10	63	0.1587302
NODE_57717_length_444_cov_2.744928	73	136	8	28	63	0.4444444
NODE_57770_length_444_cov_2.028986	46	113	16	1	67	0.0149254
NODE_57770_length_444_cov_2.028986	46	113	18	5	67	0.0746269
NODE_57770_length_444_cov_2.028986	46	113	20	2	67	0.0298507
NODE_57770_length_444_cov_2.028986	46	113	22	3	67	0.0447761
NODE_57770_length_444_cov_2.028986	46	113	24	1	67	0.0149254
NODE_57770_length_444_cov_2.028986	46	113	26	1	67	0.0149254
NODE_57770_length_444_cov_2.028986	46	113	27	1	67	0.0149254
NODE_57770_length_444_cov_2.028986	46	113	29	1	67	0.0149254
NODE_57770_length_444_cov_2.028986	46	113	31	2	67	0.0298507
NODE_57770_length_444_cov_2.028986	46	113	33	1	67	0.0149254
NODE_57770_length_444_cov_2.028986	46	113	34	5	67	0.0746269
NODE_57770_length_444_cov_2.028986	46	113	38	3	67	0.0447761
NODE_57770_length_444_cov_2.028986	46	113	40	1	67	0.0149254
NODE_57770_length_444_cov_2.028986	46	113	44	1	67	0.0149254
NODE_57770_length_444_cov_2.028986	46	113	46	3	67	0.0447761
NODE_57770_length_444_cov_2.028986	46	113	47	6	67	0.0895522
NODE_57770_length_444_cov_2.028986	46	113	53	2	67	0.0298507
NODE_57770_length_444_cov_2.028986	46	113	57	1	67	0.0149254
NODE_57770_length_444_cov_2.028986	46	113	59	3	67	0.0447761
NODE_57770_length_444_cov_2.028986	46	113	63	2	67	0.0298507
NODE_57770_length_444_cov_2.028986	46	113	65	1	67	0.0149254
NODE_57770_length_444_cov_2.028986	46	113	67	1	67	0.0149254
NODE_57770_length_444_cov_2.028986	46	113	68	1	67	0.0149254
NODE_57770_length_444_cov_2.028986	46	113	71	5	67	0.0746269
NODE_57770_length_444_cov_2.028986	46	113	75	2	67	0.0298507
NODE_57770_length_444_cov_2.028986	46	113	77	2	67	0.0298507
NODE_57770_length_444_cov_2.028986	46	113	79	2	67	0.0298507
NODE_57770_length_444_cov_2.028986	46	113	81	6	67	0.0895522
NODE_57770_length_444_cov_2.028986	46	113	83	2	67	0.0298507
NODE_57770_length_444_cov_2.028986	86	166	59	3	80	0.0375000
NODE_57770_length_444_cov_2.028986	86	166	63	2	80	0.0250000
NODE_57770_length_444_cov_2.028986	86	166	65	1	80	0.0125000
NODE_57770_length_444_cov_2.028986	86	166	67	1	80	0.0125000
NODE_57770_length_444_cov_2.028986	86	166	68	1	80	0.0125000
NODE_57770_length_444_cov_2.028986	86	166	71	5	80	0.0625000
NODE_57770_length_444_cov_2.028986	86	166	75	2	80	0.0250000
NODE_57770_length_444_cov_2.028986	86	166	77	2	80	0.0250000
NODE_57770_length_444_cov_2.028986	86	166	78	6	80	0.0750000
NODE_57770_length_444_cov_2.028986	86	166	79	2	80	0.0250000
NODE_57770_length_444_cov_2.028986	86	166	80	1	80	0.0125000
NODE_57770_length_444_cov_2.028986	86	166	81	8	80	0.1000000
NODE_57770_length_444_cov_2.028986	86	166	82	2	80	0.0250000
NODE_57770_length_444_cov_2.028986	86	166	83	2	80	0.0250000
NODE_57770_length_444_cov_2.028986	86	166	84	1	80	0.0125000
NODE_57770_length_444_cov_2.028986	86	166	85	1	80	0.0125000
NODE_57770_length_444_cov_2.028986	86	166	87	3	80	0.0375000
NODE_57770_length_444_cov_2.028986	86	166	88	3	80	0.0375000
NODE_57770_length_444_cov_2.028986	86	166	89	1	80	0.0125000
NODE_57770_length_444_cov_2.028986	86	166	90	4	80	0.0500000
NODE_57770_length_444_cov_2.028986	86	166	93	1	80	0.0125000
NODE_57770_length_444_cov_2.028986	86	166	95	16	80	0.2000000
NODE_57770_length_444_cov_2.028986	86	166	97	6	80	0.0750000
NODE_57770_length_444_cov_2.028986	86	166	99	6	80	0.0750000
NODE_57873_length_444_cov_1.234783	335	407	0	72	72	1.0000000
NODE_57892_length_444_cov_1.173913	7	87	2	80	80	1.0000000
NODE_58026_length_443_cov_71.284884	209	289	2	80	80	1.0000000
NODE_58026_length_443_cov_71.284884	262	342	1	4	80	0.0500000
NODE_58026_length_443_cov_71.284884	262	342	2	76	80	0.9500000
NODE_58026_length_443_cov_71.284884	338	418	0	63	80	0.7875000
NODE_58026_length_443_cov_71.284884	338	418	1	17	80	0.2125000
NODE_58026_length_443_cov_71.284884	391	443	0	52	52	1.0000000
NODE_58027_length_443_cov_68.973837	314	394	2	9	80	0.1125000
NODE_58027_length_443_cov_68.973837	314	394	4	7	80	0.0875000
NODE_58027_length_443_cov_68.973837	314	394	6	9	80	0.1125000
NODE_58027_length_443_cov_68.973837	314	394	8	39	80	0.4875000
NODE_58027_length_443_cov_68.973837	314	394	10	16	80	0.2000000
NODE_58027_length_443_cov_68.973837	367	443	0	1	76	0.0131579
NODE_58027_length_443_cov_68.973837	367	443	2	4	76	0.0526316
NODE_58027_length_443_cov_68.973837	367	443	6	32	76	0.4210526
NODE_58027_length_443_cov_68.973837	367	443	8	39	76	0.5131579
NODE_58028_length_443_cov_61.116279	34	114	2	75	80	0.9375000
NODE_58028_length_443_cov_61.116279	34	114	6	5	80	0.0625000
NODE_58028_length_443_cov_61.116279	87	167	2	22	80	0.2750000
NODE_58028_length_443_cov_61.116279	87	167	4	4	80	0.0500000
NODE_58028_length_443_cov_61.116279	87	167	6	54	80	0.6750000
NODE_58041_length_443_cov_4.895349	127	207	8	2	80	0.0250000
NODE_58041_length_443_cov_4.895349	127	207	11	37	80	0.4625000
NODE_58041_length_443_cov_4.895349	127	207	13	41	80	0.5125000
NODE_58086_length_443_cov_2.581395	121	195	0	22	74	0.2972973
NODE_58086_length_443_cov_2.581395	121	195	1	49	74	0.6621622
NODE_58086_length_443_cov_2.581395	121	195	2	3	74	0.0405405
NODE_58088_length_443_cov_2.508721	297	347	0	50	50	1.0000000
NODE_58088_length_443_cov_2.508721	320	395	0	75	75	1.0000000
NODE_58091_length_443_cov_2.456395	114	192	0	78	78	1.0000000
NODE_58091_length_443_cov_2.456395	118	141	0	23	23	1.0000000
NODE_58237_length_443_cov_1.151163	144	224	4	1	80	0.0125000
NODE_58237_length_443_cov_1.151163	144	224	6	28	80	0.3500000
NODE_58237_length_443_cov_1.151163	144	224	8	51	80	0.6375000
NODE_58321_length_443_cov_0.715116	52	104	0	52	52	1.0000000
NODE_58321_length_443_cov_0.715116	105	146	0	9	41	0.2195122
NODE_58321_length_443_cov_0.715116	105	146	2	32	41	0.7804878
NODE_58346_length_442_cov_42.956268	290	375	21	13	85	0.1529412
NODE_58346_length_442_cov_42.956268	290	375	23	5	85	0.0588235
NODE_58346_length_442_cov_42.956268	290	375	25	1	85	0.0117647
NODE_58346_length_442_cov_42.956268	290	375	29	3	85	0.0352941
NODE_58346_length_442_cov_42.956268	290	375	31	8	85	0.0941176
NODE_58346_length_442_cov_42.956268	290	375	33	4	85	0.0470588
NODE_58346_length_442_cov_42.956268	290	375	35	5	85	0.0588235
NODE_58346_length_442_cov_42.956268	290	375	37	1	85	0.0117647
NODE_58346_length_442_cov_42.956268	290	375	39	6	85	0.0705882
NODE_58346_length_442_cov_42.956268	290	375	45	5	85	0.0588235
NODE_58346_length_442_cov_42.956268	290	375	46	1	85	0.0117647
NODE_58346_length_442_cov_42.956268	290	375	47	3	85	0.0352941
NODE_58346_length_442_cov_42.956268	290	375	48	7	85	0.0823529
NODE_58346_length_442_cov_42.956268	290	375	50	23	85	0.2705882
NODE_58346_length_442_cov_42.956268	290	375	21	13	85	0.1529412
NODE_58346_length_442_cov_42.956268	290	375	23	5	85	0.0588235
NODE_58346_length_442_cov_42.956268	290	375	25	1	85	0.0117647
NODE_58346_length_442_cov_42.956268	290	375	29	3	85	0.0352941
NODE_58346_length_442_cov_42.956268	290	375	31	8	85	0.0941176
NODE_58346_length_442_cov_42.956268	290	375	33	4	85	0.0470588
NODE_58346_length_442_cov_42.956268	290	375	35	5	85	0.0588235
NODE_58346_length_442_cov_42.956268	290	375	37	1	85	0.0117647
NODE_58346_length_442_cov_42.956268	290	375	39	6	85	0.0705882
NODE_58346_length_442_cov_42.956268	290	375	45	5	85	0.0588235
NODE_58346_length_442_cov_42.956268	290	375	46	1	85	0.0117647
NODE_58346_length_442_cov_42.956268	290	375	47	3	85	0.0352941
NODE_58346_length_442_cov_42.956268	290	375	48	7	85	0.0823529
NODE_58346_length_442_cov_42.956268	290	375	50	23	85	0.2705882
NODE_58347_length_442_cov_24.093294	225	305	0	80	80	1.0000000
NODE_58347_length_442_cov_24.093294	278	358	0	80	80	1.0000000
NODE_58348_length_442_cov_8.956268	173	192	0	19	19	1.0000000
NODE_58361_length_442_cov_5.052478	213	293	0	7	80	0.0875000
NODE_58361_length_442_cov_5.052478	213	293	2	73	80	0.9125000
NODE_58361_length_442_cov_5.052478	266	346	0	60	80	0.7500000
NODE_58361_length_442_cov_5.052478	266	346	2	20	80	0.2500000
NODE_58376_length_442_cov_3.871720	297	372	4	4	75	0.0533333
NODE_58376_length_442_cov_3.871720	297	372	6	8	75	0.1066667
NODE_58376_length_442_cov_3.871720	297	372	8	19	75	0.2533333
NODE_58376_length_442_cov_3.871720	297	372	10	13	75	0.1733333
NODE_58376_length_442_cov_3.871720	297	372	12	31	75	0.4133333
NODE_58376_length_442_cov_3.871720	360	413	6	5	53	0.0943396
NODE_58376_length_442_cov_3.871720	360	413	10	45	53	0.8490566
NODE_58376_length_442_cov_3.871720	360	413	12	3	53	0.0566038
NODE_58378_length_442_cov_3.804665	211	244	0	30	33	0.9090909
NODE_58378_length_442_cov_3.804665	211	244	2	1	33	0.0303030
NODE_58378_length_442_cov_3.804665	211	244	4	1	33	0.0303030
NODE_58378_length_442_cov_3.804665	211	244	9	1	33	0.0303030
NODE_58405_length_442_cov_3.206997	149	217	2	18	68	0.2647059
NODE_58405_length_442_cov_3.206997	149	217	4	50	68	0.7352941
NODE_58438_length_442_cov_2.434402	203	274	60	1	71	0.0140845
NODE_58438_length_442_cov_2.434402	203	274	62	2	71	0.0281690
NODE_58438_length_442_cov_2.434402	203	274	63	3	71	0.0422535
NODE_58438_length_442_cov_2.434402	203	274	64	1	71	0.0140845
NODE_58438_length_442_cov_2.434402	203	274	65	3	71	0.0422535
NODE_58438_length_442_cov_2.434402	203	274	66	4	71	0.0563380
NODE_58438_length_442_cov_2.434402	203	274	67	2	71	0.0281690
NODE_58438_length_442_cov_2.434402	203	274	74	16	71	0.2253521
NODE_58438_length_442_cov_2.434402	203	274	77	6	71	0.0845070
NODE_58438_length_442_cov_2.434402	203	274	78	1	71	0.0140845
NODE_58438_length_442_cov_2.434402	203	274	79	28	71	0.3943662
NODE_58438_length_442_cov_2.434402	203	274	81	1	71	0.0140845
NODE_58438_length_442_cov_2.434402	203	274	83	1	71	0.0140845
NODE_58438_length_442_cov_2.434402	203	274	85	2	71	0.0281690
NODE_58438_length_442_cov_2.434402	247	327	79	23	80	0.2875000
NODE_58438_length_442_cov_2.434402	247	327	81	1	80	0.0125000
NODE_58438_length_442_cov_2.434402	247	327	83	1	80	0.0125000
NODE_58438_length_442_cov_2.434402	247	327	85	2	80	0.0250000
NODE_58438_length_442_cov_2.434402	247	327	86	2	80	0.0250000
NODE_58438_length_442_cov_2.434402	247	327	88	2	80	0.0250000
NODE_58438_length_442_cov_2.434402	247	327	90	3	80	0.0375000
NODE_58438_length_442_cov_2.434402	247	327	91	1	80	0.0125000
NODE_58438_length_442_cov_2.434402	247	327	92	2	80	0.0250000
NODE_58438_length_442_cov_2.434402	247	327	93	4	80	0.0500000
NODE_58438_length_442_cov_2.434402	247	327	95	5	80	0.0625000
NODE_58438_length_442_cov_2.434402	247	327	96	6	80	0.0750000
NODE_58438_length_442_cov_2.434402	247	327	97	7	80	0.0875000
NODE_58438_length_442_cov_2.434402	247	327	98	4	80	0.0500000
NODE_58438_length_442_cov_2.434402	247	327	99	5	80	0.0625000
NODE_58438_length_442_cov_2.434402	247	327	100	7	80	0.0875000
NODE_58438_length_442_cov_2.434402	247	327	101	1	80	0.0125000
NODE_58438_length_442_cov_2.434402	247	327	102	1	80	0.0125000
NODE_58438_length_442_cov_2.434402	247	327	104	3	80	0.0375000
NODE_58503_length_442_cov_1.746356	95	161	0	32	66	0.4848485
NODE_58503_length_442_cov_1.746356	95	161	4	3	66	0.0454545
NODE_58503_length_442_cov_1.746356	95	161	6	5	66	0.0757576
NODE_58503_length_442_cov_1.746356	95	161	8	23	66	0.3484848
NODE_58503_length_442_cov_1.746356	95	161	9	3	66	0.0454545
NODE_58503_length_442_cov_1.746356	95	122	0	27	27	1.0000000
NODE_58759_length_441_cov_21.877193	28	108	0	80	80	1.0000000
NODE_58759_length_441_cov_21.877193	81	161	0	33	80	0.4125000
NODE_58759_length_441_cov_21.877193	81	161	4	47	80	0.5875000
NODE_58760_length_441_cov_13.546784	152	232	0	67	80	0.8375000
NODE_58760_length_441_cov_13.546784	152	232	4	13	80	0.1625000
NODE_58760_length_441_cov_13.546784	205	285	0	14	80	0.1750000
NODE_58760_length_441_cov_13.546784	205	285	4	66	80	0.8250000
NODE_58771_length_441_cov_5.710526	200	280	0	80	80	1.0000000
NODE_58771_length_441_cov_5.710526	253	333	0	80	80	1.0000000
NODE_58817_length_441_cov_3.096491	240	324	0	84	84	1.0000000
NODE_58820_length_441_cov_3.023392	105	163	0	1	58	0.0172414
NODE_58820_length_441_cov_3.023392	105	163	6	19	58	0.3275862
NODE_58820_length_441_cov_3.023392	105	163	8	20	58	0.3448276
NODE_58820_length_441_cov_3.023392	105	163	10	15	58	0.2586207
NODE_58820_length_441_cov_3.023392	105	163	12	3	58	0.0517241
NODE_58852_length_441_cov_2.438596	19	99	0	80	80	1.0000000
NODE_58852_length_441_cov_2.438596	72	126	0	54	54	1.0000000
NODE_58970_length_441_cov_1.435673	105	156	2	51	51	1.0000000
NODE_59142_length_440_cov_43.131965	122	202	0	80	80	1.0000000
NODE_59142_length_440_cov_43.131965	175	255	0	29	80	0.3625000
NODE_59142_length_440_cov_43.131965	175	255	2	51	80	0.6375000
NODE_59142_length_440_cov_43.131965	251	331	2	11	80	0.1375000
NODE_59142_length_440_cov_43.131965	251	331	6	34	80	0.4250000
NODE_59142_length_440_cov_43.131965	251	331	8	35	80	0.4375000
NODE_59142_length_440_cov_43.131965	304	384	0	31	80	0.3875000
NODE_59142_length_440_cov_43.131965	304	384	6	49	80	0.6125000
NODE_59143_length_440_cov_42.929619	116	196	4	80	80	1.0000000
NODE_59143_length_440_cov_42.929619	169	249	0	51	80	0.6375000
NODE_59143_length_440_cov_42.929619	169	249	4	29	80	0.3625000
NODE_59147_length_440_cov_8.164223	45	125	0	80	80	1.0000000
NODE_59147_length_440_cov_8.164223	98	178	0	80	80	1.0000000
NODE_59157_length_440_cov_5.193548	146	210	4	8	64	0.1250000
NODE_59157_length_440_cov_5.193548	146	210	8	7	64	0.1093750
NODE_59157_length_440_cov_5.193548	146	210	12	2	64	0.0312500
NODE_59157_length_440_cov_5.193548	146	210	19	4	64	0.0625000
NODE_59157_length_440_cov_5.193548	146	210	20	5	64	0.0781250
NODE_59157_length_440_cov_5.193548	146	210	21	8	64	0.1250000
NODE_59157_length_440_cov_5.193548	146	210	22	30	64	0.4687500
NODE_59157_length_440_cov_5.193548	146	210	4	8	64	0.1250000
NODE_59157_length_440_cov_5.193548	146	210	8	7	64	0.1093750
NODE_59157_length_440_cov_5.193548	146	210	12	2	64	0.0312500
NODE_59157_length_440_cov_5.193548	146	210	19	4	64	0.0625000
NODE_59157_length_440_cov_5.193548	146	210	20	5	64	0.0781250
NODE_59157_length_440_cov_5.193548	146	210	21	8	64	0.1250000
NODE_59157_length_440_cov_5.193548	146	210	22	30	64	0.4687500
NODE_59157_length_440_cov_5.193548	146	210	4	8	64	0.1250000
NODE_59157_length_440_cov_5.193548	146	210	8	7	64	0.1093750
NODE_59157_length_440_cov_5.193548	146	210	12	2	64	0.0312500
NODE_59157_length_440_cov_5.193548	146	210	19	4	64	0.0625000
NODE_59157_length_440_cov_5.193548	146	210	20	5	64	0.0781250
NODE_59157_length_440_cov_5.193548	146	210	21	8	64	0.1250000
NODE_59157_length_440_cov_5.193548	146	210	22	30	64	0.4687500
NODE_59164_length_440_cov_4.595308	153	233	2	80	80	1.0000000
NODE_59164_length_440_cov_4.595308	153	180	2	27	27	1.0000000
NODE_59188_length_440_cov_3.431085	84	150	0	23	66	0.3484848
NODE_59188_length_440_cov_3.431085	84	150	6	14	66	0.2121212
NODE_59188_length_440_cov_3.431085	84	150	8	29	66	0.4393939
NODE_59191_length_440_cov_3.331378	139	195	4	56	56	1.0000000
NODE_59517_length_439_cov_76.552941	0	68	2	19	68	0.2794118
NODE_59517_length_439_cov_76.552941	0	68	8	49	68	0.7205882
NODE_59517_length_439_cov_76.552941	0	68	2	19	68	0.2794118
NODE_59517_length_439_cov_76.552941	0	68	8	49	68	0.7205882
NODE_59517_length_439_cov_76.552941	0	68	2	19	68	0.2794118
NODE_59517_length_439_cov_76.552941	0	68	8	49	68	0.7205882
NODE_59517_length_439_cov_76.552941	1	68	2	18	67	0.2686567
NODE_59517_length_439_cov_76.552941	1	68	8	49	67	0.7313433
NODE_59517_length_439_cov_76.552941	64	144	2	22	80	0.2750000
NODE_59517_length_439_cov_76.552941	64	144	4	11	80	0.1375000
NODE_59517_length_439_cov_76.552941	64	144	8	14	80	0.1750000
NODE_59517_length_439_cov_76.552941	64	144	10	33	80	0.4125000
NODE_59517_length_439_cov_76.552941	64	144	2	22	80	0.2750000
NODE_59517_length_439_cov_76.552941	64	144	4	11	80	0.1375000
NODE_59517_length_439_cov_76.552941	64	144	8	14	80	0.1750000
NODE_59517_length_439_cov_76.552941	64	144	10	33	80	0.4125000
NODE_59517_length_439_cov_76.552941	117	197	0	24	80	0.3000000
NODE_59517_length_439_cov_76.552941	117	197	2	51	80	0.6375000
NODE_59517_length_439_cov_76.552941	117	197	4	5	80	0.0625000
NODE_59517_length_439_cov_76.552941	117	195	0	22	78	0.2820513
NODE_59517_length_439_cov_76.552941	117	195	2	51	78	0.6538461
NODE_59517_length_439_cov_76.552941	117	195	4	5	78	0.0641026
NODE_59533_length_439_cov_4.408824	174	238	6	16	64	0.2500000
NODE_59533_length_439_cov_4.408824	174	238	11	1	64	0.0156250
NODE_59533_length_439_cov_4.408824	174	238	12	47	64	0.7343750
NODE_59536_length_439_cov_4.255882	258	318	0	26	60	0.4333333
NODE_59536_length_439_cov_4.255882	258	318	6	34	60	0.5666667
NODE_59560_length_439_cov_3.011765	57	128	20	41	71	0.5774648
NODE_59560_length_439_cov_3.011765	57	128	22	30	71	0.4225352
NODE_59560_length_439_cov_3.011765	101	140	20	39	39	1.0000000
NODE_59592_length_439_cov_2.252941	227	269	4	42	42	1.0000000
NODE_59599_length_439_cov_2.135294	116	179	0	4	63	0.0634921
NODE_59599_length_439_cov_2.135294	116	179	4	1	63	0.0158730
NODE_59599_length_439_cov_2.135294	116	179	6	21	63	0.3333333
NODE_59599_length_439_cov_2.135294	116	179	8	8	63	0.1269841
NODE_59599_length_439_cov_2.135294	116	179	12	29	63	0.4603175
NODE_59617_length_439_cov_1.929412	388	439	0	51	51	1.0000000
NODE_59897_length_438_cov_29.952802	196	276	0	80	80	1.0000000
NODE_59897_length_438_cov_29.952802	249	329	0	80	80	1.0000000
NODE_59898_length_438_cov_16.330383	225	305	0	80	80	1.0000000
NODE_59898_length_438_cov_16.330383	278	358	0	80	80	1.0000000
NODE_59899_length_438_cov_15.436578	74	154	0	80	80	1.0000000
NODE_59899_length_438_cov_15.436578	127	207	0	80	80	1.0000000
NODE_59901_length_438_cov_9.306785	256	309	0	14	53	0.2641509
NODE_59901_length_438_cov_9.306785	256	309	1	1	53	0.0188679
NODE_59901_length_438_cov_9.306785	256	309	2	38	53	0.7169811
NODE_59901_length_438_cov_9.306785	282	327	2	45	45	1.0000000
NODE_59916_length_438_cov_4.808260	46	133	0	41	87	0.4712644
NODE_59916_length_438_cov_4.808260	46	133	4	46	87	0.5287356
NODE_59916_length_438_cov_4.808260	106	186	0	35	80	0.4375000
NODE_59916_length_438_cov_4.808260	106	186	2	17	80	0.2125000
NODE_59916_length_438_cov_4.808260	106	186	4	28	80	0.3500000
NODE_59920_length_438_cov_4.622419	135	184	0	49	49	1.0000000
NODE_59936_length_438_cov_3.651917	86	166	0	14	80	0.1750000
NODE_59936_length_438_cov_3.651917	86	166	2	66	80	0.8250000
NODE_59936_length_438_cov_3.651917	139	219	0	67	80	0.8375000
NODE_59936_length_438_cov_3.651917	139	219	2	13	80	0.1625000
NODE_59952_length_438_cov_3.109145	215	273	0	58	58	1.0000000
NODE_59957_length_438_cov_3.005900	175	258	0	63	83	0.7590361
NODE_59957_length_438_cov_3.005900	175	258	3	11	83	0.1325301
NODE_59957_length_438_cov_3.005900	175	258	5	9	83	0.1084337
NODE_60317_length_437_cov_57.260355	272	352	0	80	80	1.0000000
NODE_60317_length_437_cov_57.260355	325	405	0	80	80	1.0000000
NODE_60318_length_437_cov_40.964497	0	73	0	73	73	1.0000000
NODE_60318_length_437_cov_40.964497	46	126	0	80	80	1.0000000
NODE_60319_length_437_cov_30.843195	140	220	0	80	80	1.0000000
NODE_60319_length_437_cov_30.843195	193	273	0	80	80	1.0000000
NODE_60320_length_437_cov_14.736686	164	244	0	80	80	1.0000000
NODE_60320_length_437_cov_14.736686	217	297	0	80	80	1.0000000
NODE_60331_length_437_cov_6.032544	249	320	0	71	71	1.0000000
NODE_60332_length_437_cov_6.020710	272	352	0	40	80	0.5000000
NODE_60332_length_437_cov_6.020710	272	352	2	40	80	0.5000000
NODE_60332_length_437_cov_6.020710	325	405	0	17	80	0.2125000
NODE_60332_length_437_cov_6.020710	325	405	2	63	80	0.7875000
NODE_60336_length_437_cov_5.526627	129	209	0	80	80	1.0000000
NODE_60336_length_437_cov_5.526627	182	262	0	80	80	1.0000000
NODE_60348_length_437_cov_4.505917	247	327	0	26	80	0.3250000
NODE_60348_length_437_cov_4.505917	247	327	6	47	80	0.5875000
NODE_60348_length_437_cov_4.505917	247	327	7	1	80	0.0125000
NODE_60348_length_437_cov_4.505917	247	327	8	6	80	0.0750000
NODE_60361_length_437_cov_3.470414	204	259	0	16	55	0.2909091
NODE_60361_length_437_cov_3.470414	204	259	1	11	55	0.2000000
NODE_60361_length_437_cov_3.470414	204	259	2	28	55	0.5090909
NODE_60369_length_437_cov_3.301775	95	149	2	54	54	1.0000000
NODE_60381_length_437_cov_2.911243	91	171	0	21	80	0.2625000
NODE_60381_length_437_cov_2.911243	91	171	8	8	80	0.1000000
NODE_60381_length_437_cov_2.911243	91	171	10	1	80	0.0125000
NODE_60381_length_437_cov_2.911243	91	171	11	1	80	0.0125000
NODE_60381_length_437_cov_2.911243	91	171	13	5	80	0.0625000
NODE_60381_length_437_cov_2.911243	91	171	15	1	80	0.0125000
NODE_60381_length_437_cov_2.911243	91	171	17	1	80	0.0125000
NODE_60381_length_437_cov_2.911243	91	171	18	1	80	0.0125000
NODE_60381_length_437_cov_2.911243	91	171	20	3	80	0.0375000
NODE_60381_length_437_cov_2.911243	91	171	21	8	80	0.1000000
NODE_60381_length_437_cov_2.911243	91	171	23	12	80	0.1500000
NODE_60381_length_437_cov_2.911243	91	171	25	1	80	0.0125000
NODE_60381_length_437_cov_2.911243	91	171	26	8	80	0.1000000
NODE_60381_length_437_cov_2.911243	91	171	28	9	80	0.1125000
NODE_60400_length_437_cov_2.650888	190	239	0	49	49	1.0000000
NODE_60400_length_437_cov_2.650888	212	292	0	80	80	1.0000000
NODE_60411_length_437_cov_2.514793	292	333	0	41	41	1.0000000
NODE_60509_length_437_cov_1.473373	252	324	0	72	72	1.0000000
NODE_60709_length_436_cov_125.940653	204	284	9	3	80	0.0375000
NODE_60709_length_436_cov_125.940653	204	284	10	3	80	0.0375000
NODE_60709_length_436_cov_125.940653	204	284	11	19	80	0.2375000
NODE_60709_length_436_cov_125.940653	204	284	13	5	80	0.0625000
NODE_60709_length_436_cov_125.940653	204	284	15	14	80	0.1750000
NODE_60709_length_436_cov_125.940653	204	284	17	6	80	0.0750000
NODE_60709_length_436_cov_125.940653	204	284	19	3	80	0.0375000
NODE_60709_length_436_cov_125.940653	204	284	21	8	80	0.1000000
NODE_60709_length_436_cov_125.940653	204	284	22	9	80	0.1125000
NODE_60709_length_436_cov_125.940653	204	284	24	10	80	0.1250000
NODE_60709_length_436_cov_125.940653	255	301	5	5	46	0.1086956
NODE_60709_length_436_cov_125.940653	255	301	7	5	46	0.1086956
NODE_60709_length_436_cov_125.940653	255	301	9	10	46	0.2173913
NODE_60709_length_436_cov_125.940653	255	301	10	3	46	0.0652174
NODE_60709_length_436_cov_125.940653	255	301	11	19	46	0.4130435
NODE_60709_length_436_cov_125.940653	255	301	13	4	46	0.0869565
NODE_60709_length_436_cov_125.940653	257	337	3	9	80	0.1125000
NODE_60709_length_436_cov_125.940653	257	337	4	25	80	0.3125000
NODE_60709_length_436_cov_125.940653	257	337	5	7	80	0.0875000
NODE_60709_length_436_cov_125.940653	257	337	7	5	80	0.0625000
NODE_60709_length_436_cov_125.940653	257	337	9	10	80	0.1250000
NODE_60709_length_436_cov_125.940653	257	337	10	3	80	0.0375000
NODE_60709_length_436_cov_125.940653	257	337	11	19	80	0.2375000
NODE_60709_length_436_cov_125.940653	257	337	13	2	80	0.0250000
NODE_60709_length_436_cov_125.940653	333	413	0	65	80	0.8125000
NODE_60709_length_436_cov_125.940653	333	413	3	15	80	0.1875000
NODE_60709_length_436_cov_125.940653	386	436	0	50	50	1.0000000
NODE_60712_length_436_cov_45.459941	166	246	0	80	80	1.0000000
NODE_60712_length_436_cov_45.459941	219	299	0	80	80	1.0000000
NODE_60712_length_436_cov_45.459941	295	375	0	80	80	1.0000000
NODE_60712_length_436_cov_45.459941	348	428	0	80	80	1.0000000
NODE_60713_length_436_cov_10.560831	74	154	0	38	80	0.4750000
NODE_60713_length_436_cov_10.560831	74	154	2	42	80	0.5250000
NODE_60713_length_436_cov_10.560831	127	207	0	3	80	0.0375000
NODE_60713_length_436_cov_10.560831	127	207	2	77	80	0.9625000
NODE_60716_length_436_cov_8.317507	51	127	0	76	76	1.0000000
NODE_60716_length_436_cov_8.317507	104	182	0	31	78	0.3974359
NODE_60716_length_436_cov_8.317507	104	182	2	47	78	0.6025641
NODE_60760_length_436_cov_3.109792	153	205	0	52	52	1.0000000
NODE_60786_length_436_cov_2.551929	182	258	0	29	76	0.3815790
NODE_60786_length_436_cov_2.551929	182	258	2	47	76	0.6184211
NODE_60786_length_436_cov_2.551929	235	315	0	38	80	0.4750000
NODE_60786_length_436_cov_2.551929	235	315	2	18	80	0.2250000
NODE_60786_length_436_cov_2.551929	235	315	4	7	80	0.0875000
NODE_60786_length_436_cov_2.551929	235	315	6	17	80	0.2125000
NODE_60934_length_436_cov_1.207715	105	181	0	76	76	1.0000000
NODE_61088_length_435_cov_17.401786	55	135	4	66	80	0.8250000
NODE_61088_length_435_cov_17.401786	55	135	9	14	80	0.1750000
NODE_61088_length_435_cov_17.401786	108	188	0	29	80	0.3625000
NODE_61088_length_435_cov_17.401786	108	188	4	51	80	0.6375000
NODE_61094_length_435_cov_6.910714	113	193	0	9	80	0.1125000
NODE_61094_length_435_cov_6.910714	113	193	2	3	80	0.0375000
NODE_61094_length_435_cov_6.910714	113	193	4	23	80	0.2875000
NODE_61094_length_435_cov_6.910714	113	193	6	7	80	0.0875000
NODE_61094_length_435_cov_6.910714	113	193	7	12	80	0.1500000
NODE_61094_length_435_cov_6.910714	113	193	8	26	80	0.3250000
NODE_61094_length_435_cov_6.910714	147	194	0	10	47	0.2127660
NODE_61094_length_435_cov_6.910714	147	194	2	3	47	0.0638298
NODE_61094_length_435_cov_6.910714	147	194	4	23	47	0.4893617
NODE_61094_length_435_cov_6.910714	147	194	6	7	47	0.1489362
NODE_61094_length_435_cov_6.910714	147	194	7	4	47	0.0851064
NODE_61094_length_435_cov_6.910714	149	184	2	3	35	0.0857143
NODE_61094_length_435_cov_6.910714	149	184	4	23	35	0.6571429
NODE_61094_length_435_cov_6.910714	149	184	6	7	35	0.2000000
NODE_61094_length_435_cov_6.910714	149	184	7	2	35	0.0571429
NODE_61094_length_435_cov_6.910714	151	193	0	9	42	0.2142857
NODE_61094_length_435_cov_6.910714	151	193	2	3	42	0.0714286
NODE_61094_length_435_cov_6.910714	151	193	4	23	42	0.5476190
NODE_61094_length_435_cov_6.910714	151	193	6	7	42	0.1666667
NODE_61094_length_435_cov_6.910714	166	251	0	67	85	0.7882353
NODE_61094_length_435_cov_6.910714	166	251	2	3	85	0.0352941
NODE_61094_length_435_cov_6.910714	166	251	4	15	85	0.1764706
NODE_61094_length_435_cov_6.910714	167	251	0	67	84	0.7976190
NODE_61094_length_435_cov_6.910714	167	251	2	3	84	0.0357143
NODE_61094_length_435_cov_6.910714	167	251	4	14	84	0.1666667
NODE_61102_length_435_cov_5.630952	159	217	0	58	58	1.0000000
NODE_61102_length_435_cov_5.630952	190	270	0	80	80	1.0000000
NODE_61112_length_435_cov_4.601190	271	309	0	38	38	1.0000000
NODE_61112_length_435_cov_4.601190	282	344	0	46	62	0.7419355
NODE_61112_length_435_cov_4.601190	282	344	2	16	62	0.2580645
NODE_61122_length_435_cov_3.770833	209	240	2	31	31	1.0000000
NODE_61137_length_435_cov_2.836310	113	194	6	10	81	0.1234568
NODE_61137_length_435_cov_2.836310	113	194	8	23	81	0.2839506
NODE_61137_length_435_cov_2.836310	113	194	10	32	81	0.3950617
NODE_61137_length_435_cov_2.836310	113	194	14	10	81	0.1234568
NODE_61137_length_435_cov_2.836310	113	194	16	6	81	0.0740741
NODE_61357_length_435_cov_0.988095	286	322	0	36	36	1.0000000
NODE_61451_length_434_cov_136.483582	0	58	28	1	58	0.0172414
NODE_61451_length_434_cov_136.483582	0	58	31	1	58	0.0172414
NODE_61451_length_434_cov_136.483582	0	58	49	1	58	0.0172414
NODE_61451_length_434_cov_136.483582	0	58	82	1	58	0.0172414
NODE_61451_length_434_cov_136.483582	0	58	84	1	58	0.0172414
NODE_61451_length_434_cov_136.483582	0	58	91	1	58	0.0172414
NODE_61451_length_434_cov_136.483582	0	58	112	1	58	0.0172414
NODE_61451_length_434_cov_136.483582	0	58	114	1	58	0.0172414
NODE_61451_length_434_cov_136.483582	0	58	148	1	58	0.0172414
NODE_61451_length_434_cov_136.483582	0	58	151	1	58	0.0172414
NODE_61451_length_434_cov_136.483582	0	58	156	1	58	0.0172414
NODE_61451_length_434_cov_136.483582	0	58	169	2	58	0.0344828
NODE_61451_length_434_cov_136.483582	0	58	175	2	58	0.0344828
NODE_61451_length_434_cov_136.483582	0	58	176	1	58	0.0172414
NODE_61451_length_434_cov_136.483582	0	58	182	1	58	0.0172414
NODE_61451_length_434_cov_136.483582	0	58	183	1	58	0.0172414
NODE_61451_length_434_cov_136.483582	0	58	188	1	58	0.0172414
NODE_61451_length_434_cov_136.483582	0	58	192	1	58	0.0172414
NODE_61451_length_434_cov_136.483582	0	58	194	1	58	0.0172414
NODE_61451_length_434_cov_136.483582	0	58	202	1	58	0.0172414
NODE_61451_length_434_cov_136.483582	0	58	210	1	58	0.0172414
NODE_61451_length_434_cov_136.483582	0	58	214	1	58	0.0172414
NODE_61451_length_434_cov_136.483582	0	58	217	1	58	0.0172414
NODE_61451_length_434_cov_136.483582	0	58	218	1	58	0.0172414
NODE_61451_length_434_cov_136.483582	0	58	222	1	58	0.0172414
NODE_61451_length_434_cov_136.483582	0	58	225	1	58	0.0172414
NODE_61451_length_434_cov_136.483582	0	58	235	1	58	0.0172414
NODE_61451_length_434_cov_136.483582	0	58	244	1	58	0.0172414
NODE_61451_length_434_cov_136.483582	0	58	248	1	58	0.0172414
NODE_61451_length_434_cov_136.483582	0	58	253	1	58	0.0172414
NODE_61451_length_434_cov_136.483582	0	58	255	2	58	0.0344828
NODE_61451_length_434_cov_136.483582	0	58	263	2	58	0.0344828
NODE_61451_length_434_cov_136.483582	0	58	270	1	58	0.0172414
NODE_61451_length_434_cov_136.483582	0	58	274	1	58	0.0172414
NODE_61451_length_434_cov_136.483582	0	58	281	2	58	0.0344828
NODE_61451_length_434_cov_136.483582	0	58	283	5	58	0.0862069
NODE_61451_length_434_cov_136.483582	0	58	286	2	58	0.0344828
NODE_61451_length_434_cov_136.483582	0	58	294	1	58	0.0172414
NODE_61451_length_434_cov_136.483582	0	58	296	1	58	0.0172414
NODE_61451_length_434_cov_136.483582	0	58	300	1	58	0.0172414
NODE_61451_length_434_cov_136.483582	0	58	303	3	58	0.0517241
NODE_61451_length_434_cov_136.483582	0	58	305	1	58	0.0172414
NODE_61451_length_434_cov_136.483582	0	58	306	1	58	0.0172414
NODE_61451_length_434_cov_136.483582	0	58	308	3	58	0.0517241
NODE_61451_length_434_cov_136.483582	31	111	253	1	80	0.0125000
NODE_61451_length_434_cov_136.483582	31	111	255	2	80	0.0250000
NODE_61451_length_434_cov_136.483582	31	111	263	2	80	0.0250000
NODE_61451_length_434_cov_136.483582	31	111	270	1	80	0.0125000
NODE_61451_length_434_cov_136.483582	31	111	274	1	80	0.0125000
NODE_61451_length_434_cov_136.483582	31	111	281	2	80	0.0250000
NODE_61451_length_434_cov_136.483582	31	111	283	5	80	0.0625000
NODE_61451_length_434_cov_136.483582	31	111	286	2	80	0.0250000
NODE_61451_length_434_cov_136.483582	31	111	294	1	80	0.0125000
NODE_61451_length_434_cov_136.483582	31	111	296	1	80	0.0125000
NODE_61451_length_434_cov_136.483582	31	111	300	1	80	0.0125000
NODE_61451_length_434_cov_136.483582	31	111	303	3	80	0.0375000
NODE_61451_length_434_cov_136.483582	31	111	305	1	80	0.0125000
NODE_61451_length_434_cov_136.483582	31	111	306	1	80	0.0125000
NODE_61451_length_434_cov_136.483582	31	111	308	4	80	0.0500000
NODE_61451_length_434_cov_136.483582	31	111	309	2	80	0.0250000
NODE_61451_length_434_cov_136.483582	31	111	311	1	80	0.0125000
NODE_61451_length_434_cov_136.483582	31	111	318	1	80	0.0125000
NODE_61451_length_434_cov_136.483582	31	111	320	2	80	0.0250000
NODE_61451_length_434_cov_136.483582	31	111	326	1	80	0.0125000
NODE_61451_length_434_cov_136.483582	31	111	327	2	80	0.0250000
NODE_61451_length_434_cov_136.483582	31	111	331	2	80	0.0250000
NODE_61451_length_434_cov_136.483582	31	111	335	4	80	0.0500000
NODE_61451_length_434_cov_136.483582	31	111	337	1	80	0.0125000
NODE_61451_length_434_cov_136.483582	31	111	339	3	80	0.0375000
NODE_61451_length_434_cov_136.483582	31	111	341	1	80	0.0125000
NODE_61451_length_434_cov_136.483582	31	111	346	1	80	0.0125000
NODE_61451_length_434_cov_136.483582	31	111	350	2	80	0.0250000
NODE_61451_length_434_cov_136.483582	31	111	352	3	80	0.0375000
NODE_61451_length_434_cov_136.483582	31	111	356	2	80	0.0250000
NODE_61451_length_434_cov_136.483582	31	111	361	3	80	0.0375000
NODE_61451_length_434_cov_136.483582	31	111	365	1	80	0.0125000
NODE_61451_length_434_cov_136.483582	31	111	366	1	80	0.0125000
NODE_61451_length_434_cov_136.483582	31	111	367	1	80	0.0125000
NODE_61451_length_434_cov_136.483582	31	111	372	1	80	0.0125000
NODE_61451_length_434_cov_136.483582	31	111	374	2	80	0.0250000
NODE_61451_length_434_cov_136.483582	31	111	383	3	80	0.0375000
NODE_61451_length_434_cov_136.483582	31	111	385	1	80	0.0125000
NODE_61451_length_434_cov_136.483582	31	111	387	1	80	0.0125000
NODE_61451_length_434_cov_136.483582	31	111	388	1	80	0.0125000
NODE_61451_length_434_cov_136.483582	31	111	389	2	80	0.0250000
NODE_61451_length_434_cov_136.483582	31	111	391	3	80	0.0375000
NODE_61451_length_434_cov_136.483582	31	111	393	3	80	0.0375000
NODE_61451_length_434_cov_136.483582	31	111	396	1	80	0.0125000
NODE_61452_length_434_cov_43.214925	291	366	0	11	75	0.1466667
NODE_61452_length_434_cov_43.214925	291	366	2	64	75	0.8533334
NODE_61452_length_434_cov_43.214925	344	424	0	69	80	0.8625000
NODE_61452_length_434_cov_43.214925	344	424	2	11	80	0.1375000
NODE_61452_length_434_cov_43.214925	344	424	0	69	80	0.8625000
NODE_61452_length_434_cov_43.214925	344	424	2	11	80	0.1375000
NODE_61453_length_434_cov_22.373134	80	160	0	7	80	0.0875000
NODE_61453_length_434_cov_22.373134	80	160	4	73	80	0.9125000
NODE_61453_length_434_cov_22.373134	133	213	0	60	80	0.7500000
NODE_61453_length_434_cov_22.373134	133	213	4	20	80	0.2500000
NODE_61455_length_434_cov_11.549254	74	145	12	71	71	1.0000000
NODE_61455_length_434_cov_11.549254	118	198	6	20	80	0.2500000
NODE_61455_length_434_cov_11.549254	118	198	10	1	80	0.0125000
NODE_61455_length_434_cov_11.549254	118	198	11	14	80	0.1750000
NODE_61455_length_434_cov_11.549254	118	198	12	45	80	0.5625000
NODE_61477_length_434_cov_4.125373	191	233	0	42	42	1.0000000
NODE_61477_length_434_cov_4.125373	200	235	0	35	35	1.0000000
NODE_61497_length_434_cov_3.104478	191	263	0	32	72	0.4444444
NODE_61497_length_434_cov_3.104478	191	263	2	40	72	0.5555556
NODE_61528_length_434_cov_2.197015	129	168	0	32	39	0.8205128
NODE_61528_length_434_cov_2.197015	129	168	1	7	39	0.1794872
NODE_61563_length_434_cov_1.883582	88	133	0	5	45	0.1111111
NODE_61563_length_434_cov_1.883582	88	133	2	40	45	0.8888889
NODE_61563_length_434_cov_1.883582	141	182	0	31	41	0.7560976
NODE_61563_length_434_cov_1.883582	141	182	2	10	41	0.2439024
NODE_61603_length_434_cov_1.626866	163	243	2	22	80	0.2750000
NODE_61603_length_434_cov_1.626866	163	243	4	24	80	0.3000000
NODE_61603_length_434_cov_1.626866	163	243	5	20	80	0.2500000
NODE_61603_length_434_cov_1.626866	163	243	6	14	80	0.1750000
NODE_61676_length_434_cov_1.220896	118	198	201	1	80	0.0125000
NODE_61676_length_434_cov_1.220896	118	198	202	1	80	0.0125000
NODE_61676_length_434_cov_1.220896	118	198	205	1	80	0.0125000
NODE_61676_length_434_cov_1.220896	118	198	207	2	80	0.0250000
NODE_61676_length_434_cov_1.220896	118	198	208	1	80	0.0125000
NODE_61676_length_434_cov_1.220896	118	198	216	1	80	0.0125000
NODE_61676_length_434_cov_1.220896	118	198	220	1	80	0.0125000
NODE_61676_length_434_cov_1.220896	118	198	223	1	80	0.0125000
NODE_61676_length_434_cov_1.220896	118	198	228	1	80	0.0125000
NODE_61676_length_434_cov_1.220896	118	198	229	1	80	0.0125000
NODE_61676_length_434_cov_1.220896	118	198	230	1	80	0.0125000
NODE_61676_length_434_cov_1.220896	118	198	233	1	80	0.0125000
NODE_61676_length_434_cov_1.220896	118	198	238	1	80	0.0125000
NODE_61676_length_434_cov_1.220896	118	198	250	1	80	0.0125000
NODE_61676_length_434_cov_1.220896	118	198	251	1	80	0.0125000
NODE_61676_length_434_cov_1.220896	118	198	253	1	80	0.0125000
NODE_61676_length_434_cov_1.220896	118	198	257	1	80	0.0125000
NODE_61676_length_434_cov_1.220896	118	198	259	1	80	0.0125000
NODE_61676_length_434_cov_1.220896	118	198	262	1	80	0.0125000
NODE_61676_length_434_cov_1.220896	118	198	265	1	80	0.0125000
NODE_61676_length_434_cov_1.220896	118	198	271	1	80	0.0125000
NODE_61676_length_434_cov_1.220896	118	198	273	1	80	0.0125000
NODE_61676_length_434_cov_1.220896	118	198	275	1	80	0.0125000
NODE_61676_length_434_cov_1.220896	118	198	279	1	80	0.0125000
NODE_61676_length_434_cov_1.220896	118	198	281	2	80	0.0250000
NODE_61676_length_434_cov_1.220896	118	198	286	1	80	0.0125000
NODE_61676_length_434_cov_1.220896	118	198	289	1	80	0.0125000
NODE_61676_length_434_cov_1.220896	118	198	291	1	80	0.0125000
NODE_61676_length_434_cov_1.220896	118	198	294	2	80	0.0250000
NODE_61676_length_434_cov_1.220896	118	198	295	3	80	0.0375000
NODE_61676_length_434_cov_1.220896	118	198	297	1	80	0.0125000
NODE_61676_length_434_cov_1.220896	118	198	298	7	80	0.0875000
NODE_61676_length_434_cov_1.220896	118	198	300	1	80	0.0125000
NODE_61676_length_434_cov_1.220896	118	198	302	2	80	0.0250000
NODE_61676_length_434_cov_1.220896	118	198	303	8	80	0.1000000
NODE_61676_length_434_cov_1.220896	118	198	304	1	80	0.0125000
NODE_61676_length_434_cov_1.220896	118	198	305	5	80	0.0625000
NODE_61676_length_434_cov_1.220896	118	198	306	4	80	0.0500000
NODE_61676_length_434_cov_1.220896	118	198	307	1	80	0.0125000
NODE_61676_length_434_cov_1.220896	118	198	309	1	80	0.0125000
NODE_61676_length_434_cov_1.220896	118	198	310	4	80	0.0500000
NODE_61676_length_434_cov_1.220896	118	198	311	1	80	0.0125000
NODE_61676_length_434_cov_1.220896	118	198	312	2	80	0.0250000
NODE_61676_length_434_cov_1.220896	118	198	313	1	80	0.0125000
NODE_61676_length_434_cov_1.220896	118	198	314	1	80	0.0125000
NODE_61676_length_434_cov_1.220896	118	198	315	1	80	0.0125000
NODE_61676_length_434_cov_1.220896	118	198	317	1	80	0.0125000
NODE_61676_length_434_cov_1.220896	118	198	318	2	80	0.0250000
NODE_61676_length_434_cov_1.220896	118	198	320	1	80	0.0125000
NODE_61727_length_434_cov_1.002985	245	286	2	9	41	0.2195122
NODE_61727_length_434_cov_1.002985	245	286	4	9	41	0.2195122
NODE_61727_length_434_cov_1.002985	245	286	6	23	41	0.5609756
NODE_61727_length_434_cov_1.002985	258	339	2	9	81	0.1111111
NODE_61727_length_434_cov_1.002985	258	339	4	62	81	0.7654321
NODE_61727_length_434_cov_1.002985	258	339	6	10	81	0.1234568
NODE_61826_length_433_cov_51.392216	2	82	0	80	80	1.0000000
NODE_61826_length_433_cov_51.392216	55	135	0	80	80	1.0000000
NODE_61826_length_433_cov_51.392216	131	213	0	82	82	1.0000000
NODE_61826_length_433_cov_51.392216	189	266	0	77	77	1.0000000
NODE_61827_length_433_cov_46.344311	248	328	0	80	80	1.0000000
NODE_61827_length_433_cov_46.344311	301	381	0	80	80	1.0000000
NODE_61828_length_433_cov_41.808383	92	172	0	80	80	1.0000000
NODE_61828_length_433_cov_41.808383	145	225	0	80	80	1.0000000
NODE_61835_length_433_cov_6.227545	157	237	0	80	80	1.0000000
NODE_61836_length_433_cov_6.080838	164	244	0	80	80	1.0000000
NODE_61838_length_433_cov_5.547904	10	80	15	1	70	0.0142857
NODE_61838_length_433_cov_5.547904	10	80	17	1	70	0.0142857
NODE_61838_length_433_cov_5.547904	10	80	18	18	70	0.2571429
NODE_61838_length_433_cov_5.547904	10	80	19	10	70	0.1428571
NODE_61838_length_433_cov_5.547904	10	80	20	25	70	0.3571429
NODE_61838_length_433_cov_5.547904	10	80	22	15	70	0.2142857
NODE_61838_length_433_cov_5.547904	51	133	13	13	82	0.1585366
NODE_61838_length_433_cov_5.547904	51	133	19	10	82	0.1219512
NODE_61838_length_433_cov_5.547904	51	133	20	4	82	0.0487805
NODE_61838_length_433_cov_5.547904	51	133	21	7	82	0.0853659
NODE_61838_length_433_cov_5.547904	51	133	22	48	82	0.5853658
NODE_61839_length_433_cov_5.476048	81	141	0	56	60	0.9333333
NODE_61839_length_433_cov_5.476048	81	141	2	4	60	0.0666667
NODE_61855_length_433_cov_3.907186	77	107	10	12	30	0.4000000
NODE_61855_length_433_cov_3.907186	77	107	12	2	30	0.0666667
NODE_61855_length_433_cov_3.907186	77	107	14	16	30	0.5333334
NODE_61862_length_433_cov_3.595808	231	316	7	3	85	0.0352941
NODE_61862_length_433_cov_3.595808	231	316	8	1	85	0.0117647
NODE_61862_length_433_cov_3.595808	231	316	11	6	85	0.0705882
NODE_61862_length_433_cov_3.595808	231	316	13	3	85	0.0352941
NODE_61862_length_433_cov_3.595808	231	316	14	2	85	0.0235294
NODE_61862_length_433_cov_3.595808	231	316	16	4	85	0.0470588
NODE_61862_length_433_cov_3.595808	231	316	18	12	85	0.1411765
NODE_61862_length_433_cov_3.595808	231	316	19	4	85	0.0470588
NODE_61862_length_433_cov_3.595808	231	316	21	5	85	0.0588235
NODE_61862_length_433_cov_3.595808	231	316	22	15	85	0.1764706
NODE_61862_length_433_cov_3.595808	231	316	24	2	85	0.0235294
NODE_61862_length_433_cov_3.595808	231	316	26	28	85	0.3294118
NODE_61864_length_433_cov_3.526946	107	178	2	30	71	0.4225352
NODE_61864_length_433_cov_3.526946	107	178	4	1	71	0.0140845
NODE_61864_length_433_cov_3.526946	107	178	10	12	71	0.1690141
NODE_61864_length_433_cov_3.526946	107	178	14	28	71	0.3943662
NODE_61931_length_433_cov_2.137725	123	203	0	80	80	1.0000000
NODE_62258_length_432_cov_17.540541	150	230	2	80	80	1.0000000
NODE_62258_length_432_cov_17.540541	203	288	0	43	85	0.5058824
NODE_62258_length_432_cov_17.540541	203	288	2	42	85	0.4941176
NODE_62264_length_432_cov_6.555556	52	82	0	30	30	1.0000000
NODE_62268_length_432_cov_5.720721	77	157	0	80	80	1.0000000
NODE_62268_length_432_cov_5.720721	130	202	0	72	72	1.0000000
NODE_62269_length_432_cov_5.387387	65	95	2	30	30	1.0000000
NODE_62270_length_432_cov_5.345345	271	324	2	3	53	0.0566038
NODE_62270_length_432_cov_5.345345	271	324	4	11	53	0.2075472
NODE_62270_length_432_cov_5.345345	271	324	6	39	53	0.7358491
NODE_62293_length_432_cov_3.678679	78	121	0	43	43	1.0000000
NODE_62304_length_432_cov_3.246246	87	128	5	1	41	0.0243902
NODE_62304_length_432_cov_3.246246	87	128	9	2	41	0.0487805
NODE_62304_length_432_cov_3.246246	87	128	10	7	41	0.1707317
NODE_62304_length_432_cov_3.246246	87	128	12	3	41	0.0731707
NODE_62304_length_432_cov_3.246246	87	128	14	9	41	0.2195122
NODE_62304_length_432_cov_3.246246	87	128	16	1	41	0.0243902
NODE_62304_length_432_cov_3.246246	87	128	20	5	41	0.1219512
NODE_62304_length_432_cov_3.246246	87	128	22	9	41	0.2195122
NODE_62304_length_432_cov_3.246246	87	128	24	3	41	0.0731707
NODE_62304_length_432_cov_3.246246	87	128	26	1	41	0.0243902
NODE_62304_length_432_cov_3.246246	101	167	14	8	66	0.1212121
NODE_62304_length_432_cov_3.246246	101	167	16	1	66	0.0151515
NODE_62304_length_432_cov_3.246246	101	167	20	5	66	0.0757576
NODE_62304_length_432_cov_3.246246	101	167	22	9	66	0.1363636
NODE_62304_length_432_cov_3.246246	101	167	24	3	66	0.0454545
NODE_62304_length_432_cov_3.246246	101	167	26	8	66	0.1212121
NODE_62304_length_432_cov_3.246246	101	167	28	14	66	0.2121212
NODE_62304_length_432_cov_3.246246	101	167	30	18	66	0.2727273
NODE_62396_length_432_cov_1.762763	4	71	0	2	67	0.0298507
NODE_62396_length_432_cov_1.762763	4	71	2	65	67	0.9701493
NODE_62544_length_432_cov_1.027027	44	68	0	24	24	1.0000000
NODE_62650_length_431_cov_35.355422	202	284	0	82	82	1.0000000
NODE_62650_length_431_cov_35.355422	257	333	0	76	76	1.0000000
NODE_62652_length_431_cov_11.207831	185	265	4	80	80	1.0000000
NODE_62652_length_431_cov_11.207831	238	318	0	38	80	0.4750000
NODE_62652_length_431_cov_11.207831	238	318	2	13	80	0.1625000
NODE_62652_length_431_cov_11.207831	238	318	4	29	80	0.3625000
NODE_62657_length_431_cov_7.018072	110	190	0	59	80	0.7375000
NODE_62657_length_431_cov_7.018072	110	190	2	21	80	0.2625000
NODE_62657_length_431_cov_7.018072	163	243	0	80	80	1.0000000
NODE_62661_length_431_cov_6.292169	123	203	0	24	80	0.3000000
NODE_62661_length_431_cov_6.292169	123	203	2	56	80	0.7000000
NODE_62668_length_431_cov_5.608434	170	241	2	71	71	1.0000000
NODE_62681_length_431_cov_4.250000	146	216	0	70	70	1.0000000
NODE_62684_length_431_cov_3.993976	210	290	4	64	80	0.8000000
NODE_62684_length_431_cov_3.993976	210	290	5	4	80	0.0500000
NODE_62684_length_431_cov_3.993976	210	290	6	12	80	0.1500000
NODE_62794_length_431_cov_1.695783	76	156	6	10	80	0.1250000
NODE_62794_length_431_cov_1.695783	76	156	10	2	80	0.0250000
NODE_62794_length_431_cov_1.695783	76	156	11	11	80	0.1375000
NODE_62794_length_431_cov_1.695783	76	156	12	31	80	0.3875000
NODE_62794_length_431_cov_1.695783	76	156	13	8	80	0.1000000
NODE_62794_length_431_cov_1.695783	76	156	14	5	80	0.0625000
NODE_62794_length_431_cov_1.695783	76	156	16	1	80	0.0125000
NODE_62794_length_431_cov_1.695783	76	156	18	12	80	0.1500000
NODE_62794_length_431_cov_1.695783	129	199	11	1	70	0.0142857
NODE_62794_length_431_cov_1.695783	129	199	13	8	70	0.1142857
NODE_62794_length_431_cov_1.695783	129	199	14	5	70	0.0714286
NODE_62794_length_431_cov_1.695783	129	199	16	1	70	0.0142857
NODE_62794_length_431_cov_1.695783	129	199	18	14	70	0.2000000
NODE_62794_length_431_cov_1.695783	129	199	20	8	70	0.1142857
NODE_62794_length_431_cov_1.695783	129	199	22	7	70	0.1000000
NODE_62794_length_431_cov_1.695783	129	199	24	5	70	0.0714286
NODE_62794_length_431_cov_1.695783	129	199	28	8	70	0.1142857
NODE_62794_length_431_cov_1.695783	129	199	30	1	70	0.0142857
NODE_62794_length_431_cov_1.695783	129	199	35	10	70	0.1428571
NODE_62794_length_431_cov_1.695783	129	199	39	2	70	0.0285714
NODE_63043_length_430_cov_49.791541	319	399	80	2	80	0.0250000
NODE_63043_length_430_cov_49.791541	319	399	82	4	80	0.0500000
NODE_63043_length_430_cov_49.791541	319	399	85	2	80	0.0250000
NODE_63043_length_430_cov_49.791541	319	399	87	1	80	0.0125000
NODE_63043_length_430_cov_49.791541	319	399	98	1	80	0.0125000
NODE_63043_length_430_cov_49.791541	319	399	100	2	80	0.0250000
NODE_63043_length_430_cov_49.791541	319	399	114	1	80	0.0125000
NODE_63043_length_430_cov_49.791541	319	399	116	1	80	0.0125000
NODE_63043_length_430_cov_49.791541	319	399	121	2	80	0.0250000
NODE_63043_length_430_cov_49.791541	319	399	123	1	80	0.0125000
NODE_63043_length_430_cov_49.791541	319	399	125	1	80	0.0125000
NODE_63043_length_430_cov_49.791541	319	399	131	1	80	0.0125000
NODE_63043_length_430_cov_49.791541	319	399	133	3	80	0.0375000
NODE_63043_length_430_cov_49.791541	319	399	142	1	80	0.0125000
NODE_63043_length_430_cov_49.791541	319	399	144	1	80	0.0125000
NODE_63043_length_430_cov_49.791541	319	399	148	1	80	0.0125000
NODE_63043_length_430_cov_49.791541	319	399	149	1	80	0.0125000
NODE_63043_length_430_cov_49.791541	319	399	151	1	80	0.0125000
NODE_63043_length_430_cov_49.791541	319	399	159	1	80	0.0125000
NODE_63043_length_430_cov_49.791541	319	399	161	1	80	0.0125000
NODE_63043_length_430_cov_49.791541	319	399	165	2	80	0.0250000
NODE_63043_length_430_cov_49.791541	319	399	167	2	80	0.0250000
NODE_63043_length_430_cov_49.791541	319	399	171	3	80	0.0375000
NODE_63043_length_430_cov_49.791541	319	399	173	1	80	0.0125000
NODE_63043_length_430_cov_49.791541	319	399	174	2	80	0.0250000
NODE_63043_length_430_cov_49.791541	319	399	175	2	80	0.0250000
NODE_63043_length_430_cov_49.791541	319	399	179	2	80	0.0250000
NODE_63043_length_430_cov_49.791541	319	399	181	1	80	0.0125000
NODE_63043_length_430_cov_49.791541	319	399	185	2	80	0.0250000
NODE_63043_length_430_cov_49.791541	319	399	191	2	80	0.0250000
NODE_63043_length_430_cov_49.791541	319	399	196	1	80	0.0125000
NODE_63043_length_430_cov_49.791541	319	399	204	2	80	0.0250000
NODE_63043_length_430_cov_49.791541	319	399	206	6	80	0.0750000
NODE_63043_length_430_cov_49.791541	319	399	208	1	80	0.0125000
NODE_63043_length_430_cov_49.791541	319	399	210	1	80	0.0125000
NODE_63043_length_430_cov_49.791541	319	399	214	2	80	0.0250000
NODE_63043_length_430_cov_49.791541	319	399	220	1	80	0.0125000
NODE_63043_length_430_cov_49.791541	319	399	224	4	80	0.0500000
NODE_63043_length_430_cov_49.791541	319	399	228	3	80	0.0375000
NODE_63043_length_430_cov_49.791541	319	399	229	3	80	0.0375000
NODE_63043_length_430_cov_49.791541	319	399	230	1	80	0.0125000
NODE_63043_length_430_cov_49.791541	319	399	231	5	80	0.0625000
NODE_63043_length_430_cov_49.791541	319	399	232	1	80	0.0125000
NODE_63043_length_430_cov_49.791541	319	399	235	1	80	0.0125000
NODE_63043_length_430_cov_49.791541	372	430	18	1	58	0.0172414
NODE_63043_length_430_cov_49.791541	372	430	25	1	58	0.0172414
NODE_63043_length_430_cov_49.791541	372	430	28	1	58	0.0172414
NODE_63043_length_430_cov_49.791541	372	430	34	2	58	0.0344828
NODE_63043_length_430_cov_49.791541	372	430	38	1	58	0.0172414
NODE_63043_length_430_cov_49.791541	372	430	47	2	58	0.0344828
NODE_63043_length_430_cov_49.791541	372	430	53	1	58	0.0172414
NODE_63043_length_430_cov_49.791541	372	430	57	1	58	0.0172414
NODE_63043_length_430_cov_49.791541	372	430	59	4	58	0.0689655
NODE_63043_length_430_cov_49.791541	372	430	62	4	58	0.0689655
NODE_63043_length_430_cov_49.791541	372	430	63	3	58	0.0517241
NODE_63043_length_430_cov_49.791541	372	430	66	1	58	0.0172414
NODE_63043_length_430_cov_49.791541	372	430	67	1	58	0.0172414
NODE_63043_length_430_cov_49.791541	372	430	68	2	58	0.0344828
NODE_63043_length_430_cov_49.791541	372	430	70	1	58	0.0172414
NODE_63043_length_430_cov_49.791541	372	430	72	1	58	0.0172414
NODE_63043_length_430_cov_49.791541	372	430	75	1	58	0.0172414
NODE_63043_length_430_cov_49.791541	372	430	80	5	58	0.0862069
NODE_63043_length_430_cov_49.791541	372	430	82	4	58	0.0689655
NODE_63043_length_430_cov_49.791541	372	430	85	2	58	0.0344828
NODE_63043_length_430_cov_49.791541	372	430	87	1	58	0.0172414
NODE_63043_length_430_cov_49.791541	372	430	98	1	58	0.0172414
NODE_63043_length_430_cov_49.791541	372	430	100	2	58	0.0344828
NODE_63043_length_430_cov_49.791541	372	430	114	1	58	0.0172414
NODE_63043_length_430_cov_49.791541	372	430	116	1	58	0.0172414
NODE_63043_length_430_cov_49.791541	372	430	121	2	58	0.0344828
NODE_63043_length_430_cov_49.791541	372	430	123	1	58	0.0172414
NODE_63043_length_430_cov_49.791541	372	430	125	1	58	0.0172414
NODE_63043_length_430_cov_49.791541	372	430	131	1	58	0.0172414
NODE_63043_length_430_cov_49.791541	372	430	133	3	58	0.0517241
NODE_63043_length_430_cov_49.791541	372	430	142	1	58	0.0172414
NODE_63043_length_430_cov_49.791541	372	430	144	1	58	0.0172414
NODE_63043_length_430_cov_49.791541	372	430	148	1	58	0.0172414
NODE_63043_length_430_cov_49.791541	372	430	149	1	58	0.0172414
NODE_63043_length_430_cov_49.791541	372	430	151	1	58	0.0172414
NODE_63044_length_430_cov_44.365559	109	189	0	54	80	0.6750000
NODE_63044_length_430_cov_44.365559	109	189	2	26	80	0.3250000
NODE_63044_length_430_cov_44.365559	162	242	0	1	80	0.0125000
NODE_63044_length_430_cov_44.365559	162	242	2	79	80	0.9875000
NODE_63045_length_430_cov_16.746224	92	172	0	50	80	0.6250000
NODE_63045_length_430_cov_16.746224	92	172	2	30	80	0.3750000
NODE_63045_length_430_cov_16.746224	145	225	0	80	80	1.0000000
NODE_63048_length_430_cov_7.737160	180	263	0	61	83	0.7349398
NODE_63048_length_430_cov_7.737160	180	263	2	22	83	0.2650602
NODE_63050_length_430_cov_6.163142	135	197	0	31	62	0.5000000
NODE_63050_length_430_cov_6.163142	135	197	2	31	62	0.5000000
NODE_63051_length_430_cov_5.873112	7	90	0	53	83	0.6385542
NODE_63051_length_430_cov_5.873112	7	90	2	30	83	0.3614458
NODE_63051_length_430_cov_5.873112	60	126	2	30	66	0.4545455
NODE_63051_length_430_cov_5.873112	60	126	4	6	66	0.0909091
NODE_63051_length_430_cov_5.873112	60	126	6	30	66	0.4545455
NODE_63066_length_430_cov_4.323263	18	90	0	72	72	1.0000000
NODE_63161_length_430_cov_1.945619	153	233	2	13	80	0.1625000
NODE_63161_length_430_cov_1.945619	153	233	4	67	80	0.8375000
NODE_63401_length_430_cov_0.664653	391	430	0	39	39	1.0000000
NODE_63437_length_429_cov_10.424242	78	158	0	80	80	1.0000000
NODE_63437_length_429_cov_10.424242	207	287	2	80	80	1.0000000
NODE_63437_length_429_cov_10.424242	260	340	0	5	80	0.0625000
NODE_63437_length_429_cov_10.424242	260	340	2	75	80	0.9375000
NODE_63439_length_429_cov_8.957576	213	293	0	80	80	1.0000000
NODE_63439_length_429_cov_8.957576	266	346	0	80	80	1.0000000
NODE_63441_length_429_cov_6.772727	337	366	0	29	29	1.0000000
NODE_63485_length_429_cov_3.003030	173	251	0	17	78	0.2179487
NODE_63485_length_429_cov_3.003030	173	251	2	61	78	0.7820513
NODE_63516_length_429_cov_2.433333	220	300	4	80	80	1.0000000
NODE_63519_length_429_cov_2.360606	24	85	6	61	61	1.0000000
NODE_63527_length_429_cov_2.224242	115	195	0	80	80	1.0000000
NODE_63547_length_429_cov_2.051515	114	143	0	29	29	1.0000000
NODE_63547_length_429_cov_2.051515	286	348	0	11	62	0.1774193
NODE_63547_length_429_cov_2.051515	286	348	2	11	62	0.1774193
NODE_63547_length_429_cov_2.051515	286	348	4	40	62	0.6451613
NODE_63864_length_428_cov_40.449848	217	297	0	80	80	1.0000000
NODE_63864_length_428_cov_40.449848	270	350	0	80	80	1.0000000
NODE_63864_length_428_cov_40.449848	346	426	0	80	80	1.0000000
NODE_63865_length_428_cov_31.066869	249	325	0	25	76	0.3289474
NODE_63865_length_428_cov_31.066869	249	325	2	3	76	0.0394737
NODE_63865_length_428_cov_31.066869	249	325	3	16	76	0.2105263
NODE_63865_length_428_cov_31.066869	249	325	4	8	76	0.1052632
NODE_63865_length_428_cov_31.066869	249	325	6	2	76	0.0263158
NODE_63865_length_428_cov_31.066869	249	325	8	12	76	0.1578947
NODE_63865_length_428_cov_31.066869	249	325	10	10	76	0.1315790
NODE_63865_length_428_cov_31.066869	297	378	0	78	81	0.9629630
NODE_63865_length_428_cov_31.066869	297	378	2	3	81	0.0370370
NODE_63866_length_428_cov_11.799392	62	142	0	80	80	1.0000000
NODE_63866_length_428_cov_11.799392	115	195	0	80	80	1.0000000
NODE_63867_length_428_cov_10.595745	227	307	0	80	80	1.0000000
NODE_63870_length_428_cov_6.784195	344	374	0	30	30	1.0000000
NODE_63871_length_428_cov_6.768997	131	194	0	13	63	0.2063492
NODE_63871_length_428_cov_6.768997	131	194	3	1	63	0.0158730
NODE_63871_length_428_cov_6.768997	131	194	4	2	63	0.0317460
NODE_63871_length_428_cov_6.768997	131	194	5	6	63	0.0952381
NODE_63871_length_428_cov_6.768997	131	194	7	15	63	0.2380952
NODE_63871_length_428_cov_6.768997	131	194	9	8	63	0.1269841
NODE_63871_length_428_cov_6.768997	131	194	11	18	63	0.2857143
NODE_63895_length_428_cov_4.206687	224	304	6	8	80	0.1000000
NODE_63895_length_428_cov_4.206687	224	304	7	10	80	0.1250000
NODE_63895_length_428_cov_4.206687	224	304	8	1	80	0.0125000
NODE_63895_length_428_cov_4.206687	224	304	9	30	80	0.3750000
NODE_63895_length_428_cov_4.206687	224	304	11	31	80	0.3875000
NODE_63905_length_428_cov_3.525836	168	236	0	68	68	1.0000000
NODE_63905_length_428_cov_3.525836	209	244	0	35	35	1.0000000
NODE_63959_length_428_cov_2.322188	1	42	0	41	41	1.0000000
NODE_63977_length_428_cov_2.124620	228	308	0	12	80	0.1500000
NODE_63977_length_428_cov_2.124620	228	308	2	68	80	0.8500000
NODE_64011_length_428_cov_1.848024	178	260	8	8	82	0.0975610
NODE_64011_length_428_cov_1.848024	178	260	9	4	82	0.0487805
NODE_64011_length_428_cov_1.848024	178	260	10	24	82	0.2926829
NODE_64011_length_428_cov_1.848024	178	260	11	16	82	0.1951219
NODE_64011_length_428_cov_1.848024	178	260	12	1	82	0.0121951
NODE_64011_length_428_cov_1.848024	178	260	13	29	82	0.3536585
NODE_64027_length_428_cov_1.772036	187	255	0	2	68	0.0294118
NODE_64027_length_428_cov_1.772036	187	255	2	22	68	0.3235294
NODE_64027_length_428_cov_1.772036	187	255	4	44	68	0.6470588
NODE_64245_length_428_cov_0.790274	275	308	0	33	33	1.0000000
NODE_64245_length_428_cov_0.790274	276	302	0	26	26	1.0000000
NODE_64310_length_427_cov_29.628049	312	392	14	9	80	0.1125000
NODE_64310_length_427_cov_29.628049	312	392	15	42	80	0.5250000
NODE_64310_length_427_cov_29.628049	312	392	16	29	80	0.3625000
NODE_64310_length_427_cov_29.628049	365	427	5	3	62	0.0483871
NODE_64310_length_427_cov_29.628049	365	427	6	8	62	0.1290323
NODE_64310_length_427_cov_29.628049	365	427	7	7	62	0.1129032
NODE_64310_length_427_cov_29.628049	365	427	10	8	62	0.1290323
NODE_64310_length_427_cov_29.628049	365	427	13	1	62	0.0161290
NODE_64310_length_427_cov_29.628049	365	427	15	35	62	0.5645161
NODE_64310_length_427_cov_29.628049	365	427	5	3	62	0.0483871
NODE_64310_length_427_cov_29.628049	365	427	6	8	62	0.1290323
NODE_64310_length_427_cov_29.628049	365	427	7	7	62	0.1129032
NODE_64310_length_427_cov_29.628049	365	427	10	8	62	0.1290323
NODE_64310_length_427_cov_29.628049	365	427	13	1	62	0.0161290
NODE_64310_length_427_cov_29.628049	365	427	15	35	62	0.5645161
NODE_64312_length_427_cov_9.371951	184	239	0	6	55	0.1090909
NODE_64312_length_427_cov_9.371951	184	239	4	2	55	0.0363636
NODE_64312_length_427_cov_9.371951	184	239	6	23	55	0.4181818
NODE_64312_length_427_cov_9.371951	184	239	8	24	55	0.4363636
NODE_64313_length_427_cov_9.359756	11	82	0	71	71	1.0000000
NODE_64313_length_427_cov_9.359756	70	149	0	79	79	1.0000000
NODE_64313_length_427_cov_9.359756	145	225	0	80	80	1.0000000
NODE_64313_length_427_cov_9.359756	198	278	0	80	80	1.0000000
NODE_64321_length_427_cov_5.929878	405	424	0	19	19	1.0000000
NODE_64324_length_427_cov_5.088415	257	332	0	75	75	1.0000000
NODE_64345_length_427_cov_3.884146	212	260	0	48	48	1.0000000
NODE_64383_length_427_cov_2.765244	312	363	2	51	51	1.0000000
NODE_64409_length_427_cov_2.362805	142	177	0	35	35	1.0000000
NODE_64537_length_427_cov_1.359756	56	139	0	83	83	1.0000000
NODE_64728_length_426_cov_21.837920	178	258	0	20	80	0.2500000
NODE_64728_length_426_cov_21.837920	178	258	2	60	80	0.7500000
NODE_64729_length_426_cov_16.850153	76	156	0	80	80	1.0000000
NODE_64729_length_426_cov_16.850153	129	209	0	80	80	1.0000000
NODE_64731_length_426_cov_9.033639	152	232	0	80	80	1.0000000
NODE_64731_length_426_cov_9.033639	205	285	0	80	80	1.0000000
NODE_64734_length_426_cov_8.314985	133	213	0	80	80	1.0000000
NODE_64734_length_426_cov_8.314985	186	266	0	80	80	1.0000000
NODE_64735_length_426_cov_8.278287	132	212	0	80	80	1.0000000
NODE_64735_length_426_cov_8.278287	185	265	0	80	80	1.0000000
NODE_64752_length_426_cov_4.926606	116	196	0	80	80	1.0000000
NODE_64754_length_426_cov_4.743119	119	199	0	42	80	0.5250000
NODE_64754_length_426_cov_4.743119	119	199	4	38	80	0.4750000
NODE_64754_length_426_cov_4.743119	172	252	4	80	80	1.0000000
NODE_64833_length_426_cov_2.278287	92	132	0	40	40	1.0000000
NODE_64833_length_426_cov_2.278287	139	205	0	66	66	1.0000000
NODE_64865_length_426_cov_1.896024	80	154	0	74	74	1.0000000
NODE_64948_length_426_cov_1.397554	240	290	0	50	50	1.0000000
NODE_65135_length_426_cov_0.602446	127	158	2	31	31	1.0000000
NODE_65152_length_425_cov_63.938650	0	61	0	61	61	1.0000000
NODE_65152_length_425_cov_63.938650	34	114	0	80	80	1.0000000
NODE_65164_length_425_cov_4.877301	171	229	41	2	58	0.0344828
NODE_65164_length_425_cov_4.877301	171	229	42	15	58	0.2586207
NODE_65164_length_425_cov_4.877301	171	229	44	3	58	0.0517241
NODE_65164_length_425_cov_4.877301	171	229	54	3	58	0.0517241
NODE_65164_length_425_cov_4.877301	171	229	56	5	58	0.0862069
NODE_65164_length_425_cov_4.877301	171	229	57	6	58	0.1034483
NODE_65164_length_425_cov_4.877301	171	229	58	3	58	0.0517241
NODE_65164_length_425_cov_4.877301	171	229	62	6	58	0.1034483
NODE_65164_length_425_cov_4.877301	171	229	64	3	58	0.0517241
NODE_65164_length_425_cov_4.877301	171	229	66	5	58	0.0862069
NODE_65164_length_425_cov_4.877301	171	229	68	7	58	0.1206897
NODE_65165_length_425_cov_4.822086	295	377	0	3	82	0.0365854
NODE_65165_length_425_cov_4.822086	295	377	4	7	82	0.0853659
NODE_65165_length_425_cov_4.822086	295	377	6	1	82	0.0121951
NODE_65165_length_425_cov_4.822086	295	377	8	24	82	0.2926829
NODE_65165_length_425_cov_4.822086	295	377	18	21	82	0.2560976
NODE_65165_length_425_cov_4.822086	295	377	19	2	82	0.0243902
NODE_65165_length_425_cov_4.822086	295	377	20	21	82	0.2560976
NODE_65165_length_425_cov_4.822086	295	377	21	3	82	0.0365854
NODE_65218_length_425_cov_2.809816	38	118	0	80	80	1.0000000
NODE_65278_length_425_cov_1.935583	93	138	2	45	45	1.0000000
NODE_65278_length_425_cov_1.935583	170	225	0	55	55	1.0000000
NODE_65278_length_425_cov_1.935583	312	355	12	43	43	1.0000000
NODE_65565_length_425_cov_0.628834	104	131	0	27	27	1.0000000
NODE_65602_length_424_cov_5.295385	224	270	2	6	46	0.1304348
NODE_65602_length_424_cov_5.295385	224	270	4	40	46	0.8695652
NODE_65634_length_424_cov_3.255385	266	329	0	63	63	1.0000000
NODE_65669_length_424_cov_2.578462	403	422	0	19	19	1.0000000
NODE_65670_length_424_cov_2.578462	122	144	0	22	22	1.0000000
NODE_66111_length_423_cov_2.728395	150	229	0	47	79	0.5949367
NODE_66111_length_423_cov_2.728395	150	229	2	32	79	0.4050633
NODE_66181_length_423_cov_1.879630	94	142	0	48	48	1.0000000
NODE_66222_length_423_cov_1.580247	128	208	0	52	80	0.6500000
NODE_66222_length_423_cov_1.580247	128	208	3	21	80	0.2625000
NODE_66222_length_423_cov_1.580247	128	208	5	7	80	0.0875000
NODE_66258_length_423_cov_1.410494	206	286	0	9	80	0.1125000
NODE_66258_length_423_cov_1.410494	206	286	1	29	80	0.3625000
NODE_66258_length_423_cov_1.410494	206	286	2	42	80	0.5250000
NODE_66459_length_422_cov_12.021672	201	236	0	35	35	1.0000000
NODE_66459_length_422_cov_12.021672	247	289	0	28	42	0.6666667
NODE_66459_length_422_cov_12.021672	247	289	2	14	42	0.3333333
NODE_66460_length_422_cov_10.712074	62	140	0	78	78	1.0000000
NODE_66460_length_422_cov_10.712074	115	195	0	80	80	1.0000000
NODE_66468_length_422_cov_6.281734	37	117	0	80	80	1.0000000
NODE_66468_length_422_cov_6.281734	90	170	0	80	80	1.0000000
NODE_66474_length_422_cov_5.266254	176	256	2	80	80	1.0000000
NODE_66485_length_422_cov_4.148607	159	224	0	65	65	1.0000000
NODE_66485_length_422_cov_4.148607	197	277	0	80	80	1.0000000
NODE_66488_length_422_cov_4.003096	146	226	6	16	80	0.2000000
NODE_66488_length_422_cov_4.003096	146	226	7	18	80	0.2250000
NODE_66488_length_422_cov_4.003096	146	226	8	9	80	0.1125000
NODE_66488_length_422_cov_4.003096	146	226	9	25	80	0.3125000
NODE_66488_length_422_cov_4.003096	146	226	10	1	80	0.0125000
NODE_66488_length_422_cov_4.003096	146	226	11	11	80	0.1375000
NODE_66488_length_422_cov_4.003096	199	279	7	33	80	0.4125000
NODE_66488_length_422_cov_4.003096	199	279	9	21	80	0.2625000
NODE_66488_length_422_cov_4.003096	199	279	10	2	80	0.0250000
NODE_66488_length_422_cov_4.003096	199	279	11	13	80	0.1625000
NODE_66488_length_422_cov_4.003096	199	279	14	7	80	0.0875000
NODE_66488_length_422_cov_4.003096	199	279	15	4	80	0.0500000
NODE_66512_length_422_cov_3.130031	93	173	1	2	80	0.0250000
NODE_66512_length_422_cov_3.130031	93	173	2	78	80	0.9750000
NODE_66512_length_422_cov_3.130031	146	226	0	48	80	0.6000000
NODE_66512_length_422_cov_3.130031	146	226	1	7	80	0.0875000
NODE_66512_length_422_cov_3.130031	146	226	2	25	80	0.3125000
NODE_66515_length_422_cov_3.077399	291	359	10	3	68	0.0441176
NODE_66515_length_422_cov_3.077399	291	359	12	3	68	0.0441176
NODE_66515_length_422_cov_3.077399	291	359	14	1	68	0.0147059
NODE_66515_length_422_cov_3.077399	291	359	16	5	68	0.0735294
NODE_66515_length_422_cov_3.077399	291	359	18	5	68	0.0735294
NODE_66515_length_422_cov_3.077399	291	359	19	2	68	0.0294118
NODE_66515_length_422_cov_3.077399	291	359	20	3	68	0.0441176
NODE_66515_length_422_cov_3.077399	291	359	22	3	68	0.0441176
NODE_66515_length_422_cov_3.077399	291	359	23	3	68	0.0441176
NODE_66515_length_422_cov_3.077399	291	359	24	14	68	0.2058824
NODE_66515_length_422_cov_3.077399	291	359	25	23	68	0.3382353
NODE_66515_length_422_cov_3.077399	291	359	26	2	68	0.0294118
NODE_66515_length_422_cov_3.077399	291	359	28	1	68	0.0147059
NODE_66550_length_422_cov_2.191950	5	24	2	19	19	1.0000000
NODE_66560_length_422_cov_2.108359	97	177	0	2	80	0.0250000
NODE_66560_length_422_cov_2.108359	97	177	2	18	80	0.2250000
NODE_66560_length_422_cov_2.108359	97	177	4	10	80	0.1250000
NODE_66560_length_422_cov_2.108359	97	177	6	16	80	0.2000000
NODE_66560_length_422_cov_2.108359	97	177	8	14	80	0.1750000
NODE_66560_length_422_cov_2.108359	97	177	10	10	80	0.1250000
NODE_66560_length_422_cov_2.108359	97	177	12	3	80	0.0375000
NODE_66560_length_422_cov_2.108359	97	177	14	2	80	0.0250000
NODE_66560_length_422_cov_2.108359	97	177	22	2	80	0.0250000
NODE_66560_length_422_cov_2.108359	97	177	24	3	80	0.0375000
NODE_66560_length_422_cov_2.108359	150	189	2	3	39	0.0769231
NODE_66560_length_422_cov_2.108359	150	189	4	7	39	0.1794872
NODE_66560_length_422_cov_2.108359	150	189	6	11	39	0.2820513
NODE_66560_length_422_cov_2.108359	150	189	8	9	39	0.2307692
NODE_66560_length_422_cov_2.108359	150	189	10	9	39	0.2307692
NODE_66560_length_422_cov_2.108359	249	289	43	21	40	0.5250000
NODE_66560_length_422_cov_2.108359	249	289	45	17	40	0.4250000
NODE_66560_length_422_cov_2.108359	249	289	47	1	40	0.0250000
NODE_66560_length_422_cov_2.108359	249	289	48	1	40	0.0250000
NODE_66806_length_422_cov_0.845201	2	76	0	74	74	1.0000000
NODE_66869_length_421_cov_10.664596	178	256	0	78	78	1.0000000
NODE_66869_length_421_cov_10.664596	229	309	0	80	80	1.0000000
NODE_66874_length_421_cov_7.552795	325	407	0	80	82	0.9756098
NODE_66874_length_421_cov_7.552795	325	407	4	2	82	0.0243902
NODE_66874_length_421_cov_7.552795	380	421	0	41	41	1.0000000
NODE_66875_length_421_cov_7.431677	96	118	0	22	22	1.0000000
NODE_66883_length_421_cov_5.279503	245	310	1	12	65	0.1846154
NODE_66883_length_421_cov_5.279503	245	310	2	17	65	0.2615385
NODE_66883_length_421_cov_5.279503	245	310	3	36	65	0.5538462
NODE_66884_length_421_cov_5.158385	68	145	0	77	77	1.0000000
NODE_66897_length_421_cov_4.114907	221	287	0	66	66	1.0000000
NODE_66898_length_421_cov_4.102484	202	277	0	75	75	1.0000000
NODE_66899_length_421_cov_4.040373	192	272	0	80	80	1.0000000
NODE_66899_length_421_cov_4.040373	245	314	0	69	69	1.0000000
NODE_66923_length_421_cov_3.319876	0	57	0	57	57	1.0000000
NODE_66955_length_421_cov_2.708075	95	118	0	23	23	1.0000000
NODE_66955_length_421_cov_2.708075	109	189	0	80	80	1.0000000
NODE_66955_length_421_cov_2.708075	248	300	0	52	52	1.0000000
NODE_67073_length_421_cov_1.559006	240	309	0	69	69	1.0000000
NODE_67073_length_421_cov_1.559006	240	310	0	70	70	1.0000000
NODE_67077_length_421_cov_1.537267	305	383	0	78	78	1.0000000
NODE_67098_length_421_cov_1.413043	254	303	0	49	49	1.0000000
NODE_67283_length_421_cov_0.633540	132	156	0	24	24	1.0000000
NODE_67317_length_420_cov_80.766355	90	170	0	80	80	1.0000000
NODE_67317_length_420_cov_80.766355	143	223	0	80	80	1.0000000
NODE_67319_length_420_cov_51.473520	171	250	0	79	79	1.0000000
NODE_67319_length_420_cov_51.473520	223	307	0	84	84	1.0000000
NODE_67319_length_420_cov_51.473520	303	383	0	80	80	1.0000000
NODE_67319_length_420_cov_51.473520	356	420	0	64	64	1.0000000
NODE_67330_length_420_cov_5.071651	230	310	2	20	80	0.2500000
NODE_67330_length_420_cov_5.071651	230	310	4	39	80	0.4875000
NODE_67330_length_420_cov_5.071651	230	310	6	21	80	0.2625000
NODE_67334_length_420_cov_4.775701	177	221	0	44	44	1.0000000
NODE_67345_length_420_cov_4.037383	161	240	2	6	79	0.0759494
NODE_67345_length_420_cov_4.037383	161	240	8	12	79	0.1518987
NODE_67345_length_420_cov_4.037383	161	240	10	61	79	0.7721519
NODE_67358_length_420_cov_3.657321	291	373	0	32	82	0.3902439
NODE_67358_length_420_cov_3.657321	291	373	2	2	82	0.0243902
NODE_67358_length_420_cov_3.657321	291	373	4	12	82	0.1463415
NODE_67358_length_420_cov_3.657321	291	373	7	3	82	0.0365854
NODE_67358_length_420_cov_3.657321	291	373	11	22	82	0.2682927
NODE_67358_length_420_cov_3.657321	291	373	12	11	82	0.1341463
NODE_67398_length_420_cov_2.542056	96	176	0	47	80	0.5875000
NODE_67398_length_420_cov_2.542056	96	176	2	33	80	0.4125000
NODE_67398_length_420_cov_2.542056	148	202	2	54	54	1.0000000
NODE_67398_length_420_cov_2.542056	149	195	2	46	46	1.0000000
NODE_67414_length_420_cov_2.323988	89	108	0	19	19	1.0000000
NODE_67506_length_420_cov_1.641745	277	312	2	35	35	1.0000000
NODE_67547_length_420_cov_1.429907	15	68	0	1	53	0.0188679
NODE_67547_length_420_cov_1.429907	15	68	1	21	53	0.3962264
NODE_67547_length_420_cov_1.429907	15	68	2	12	53	0.2264151
NODE_67547_length_420_cov_1.429907	15	68	4	6	53	0.1132075
NODE_67547_length_420_cov_1.429907	15	68	6	13	53	0.2452830
NODE_67547_length_420_cov_1.429907	69	111	6	13	42	0.3095238
NODE_67547_length_420_cov_1.429907	69	111	8	25	42	0.5952381
NODE_67547_length_420_cov_1.429907	69	111	10	4	42	0.0952381
NODE_67770_length_419_cov_491.015625	0	67	1	1	67	0.0149254
NODE_67770_length_419_cov_491.015625	0	67	5	2	67	0.0298507
NODE_67770_length_419_cov_491.015625	0	67	11	6	67	0.0895522
NODE_67770_length_419_cov_491.015625	0	67	13	6	67	0.0895522
NODE_67770_length_419_cov_491.015625	0	67	16	11	67	0.1641791
NODE_67770_length_419_cov_491.015625	0	67	18	12	67	0.1791045
NODE_67770_length_419_cov_491.015625	0	67	22	12	67	0.1791045
NODE_67770_length_419_cov_491.015625	0	67	26	1	67	0.0149254
NODE_67770_length_419_cov_491.015625	0	67	28	6	67	0.0895522
NODE_67770_length_419_cov_491.015625	0	67	32	7	67	0.1044776
NODE_67770_length_419_cov_491.015625	0	67	37	1	67	0.0149254
NODE_67770_length_419_cov_491.015625	0	67	39	2	67	0.0298507
NODE_67770_length_419_cov_491.015625	0	67	1	1	67	0.0149254
NODE_67770_length_419_cov_491.015625	0	67	5	2	67	0.0298507
NODE_67770_length_419_cov_491.015625	0	67	11	6	67	0.0895522
NODE_67770_length_419_cov_491.015625	0	67	13	6	67	0.0895522
NODE_67770_length_419_cov_491.015625	0	67	16	11	67	0.1641791
NODE_67770_length_419_cov_491.015625	0	67	18	12	67	0.1791045
NODE_67770_length_419_cov_491.015625	0	67	22	12	67	0.1791045
NODE_67770_length_419_cov_491.015625	0	67	26	1	67	0.0149254
NODE_67770_length_419_cov_491.015625	0	67	28	6	67	0.0895522
NODE_67770_length_419_cov_491.015625	0	67	32	7	67	0.1044776
NODE_67770_length_419_cov_491.015625	0	67	37	1	67	0.0149254
NODE_67770_length_419_cov_491.015625	0	67	39	2	67	0.0298507
NODE_67770_length_419_cov_491.015625	0	67	1	1	67	0.0149254
NODE_67770_length_419_cov_491.015625	0	67	5	2	67	0.0298507
NODE_67770_length_419_cov_491.015625	0	67	11	6	67	0.0895522
NODE_67770_length_419_cov_491.015625	0	67	13	6	67	0.0895522
NODE_67770_length_419_cov_491.015625	0	67	16	11	67	0.1641791
NODE_67770_length_419_cov_491.015625	0	67	18	12	67	0.1791045
NODE_67770_length_419_cov_491.015625	0	67	22	12	67	0.1791045
NODE_67770_length_419_cov_491.015625	0	67	26	1	67	0.0149254
NODE_67770_length_419_cov_491.015625	0	67	28	6	67	0.0895522
NODE_67770_length_419_cov_491.015625	0	67	32	7	67	0.1044776
NODE_67770_length_419_cov_491.015625	0	67	37	1	67	0.0149254
NODE_67770_length_419_cov_491.015625	0	67	39	2	67	0.0298507
NODE_67770_length_419_cov_491.015625	0	67	1	1	67	0.0149254
NODE_67770_length_419_cov_491.015625	0	67	5	2	67	0.0298507
NODE_67770_length_419_cov_491.015625	0	67	11	6	67	0.0895522
NODE_67770_length_419_cov_491.015625	0	67	13	6	67	0.0895522
NODE_67770_length_419_cov_491.015625	0	67	16	11	67	0.1641791
NODE_67770_length_419_cov_491.015625	0	67	18	12	67	0.1791045
NODE_67770_length_419_cov_491.015625	0	67	22	12	67	0.1791045
NODE_67770_length_419_cov_491.015625	0	67	26	1	67	0.0149254
NODE_67770_length_419_cov_491.015625	0	67	28	6	67	0.0895522
NODE_67770_length_419_cov_491.015625	0	67	32	7	67	0.1044776
NODE_67770_length_419_cov_491.015625	0	67	37	1	67	0.0149254
NODE_67770_length_419_cov_491.015625	0	67	39	2	67	0.0298507
NODE_67770_length_419_cov_491.015625	63	143	32	1	80	0.0125000
NODE_67770_length_419_cov_491.015625	63	143	37	1	80	0.0125000
NODE_67770_length_419_cov_491.015625	63	143	39	7	80	0.0875000
NODE_67770_length_419_cov_491.015625	63	143	43	5	80	0.0625000
NODE_67770_length_419_cov_491.015625	63	143	45	3	80	0.0375000
NODE_67770_length_419_cov_491.015625	63	143	47	8	80	0.1000000
NODE_67770_length_419_cov_491.015625	63	143	49	1	80	0.0125000
NODE_67770_length_419_cov_491.015625	63	143	50	1	80	0.0125000
NODE_67770_length_419_cov_491.015625	63	143	52	4	80	0.0500000
NODE_67770_length_419_cov_491.015625	63	143	62	3	80	0.0375000
NODE_67770_length_419_cov_491.015625	63	143	67	5	80	0.0625000
NODE_67770_length_419_cov_491.015625	63	143	68	1	80	0.0125000
NODE_67770_length_419_cov_491.015625	63	143	69	8	80	0.1000000
NODE_67770_length_419_cov_491.015625	63	143	73	1	80	0.0125000
NODE_67770_length_419_cov_491.015625	63	143	75	8	80	0.1000000
NODE_67770_length_419_cov_491.015625	63	143	76	2	80	0.0250000
NODE_67770_length_419_cov_491.015625	63	143	77	2	80	0.0250000
NODE_67770_length_419_cov_491.015625	63	143	78	4	80	0.0500000
NODE_67770_length_419_cov_491.015625	63	143	80	7	80	0.0875000
NODE_67770_length_419_cov_491.015625	63	143	81	2	80	0.0250000
NODE_67770_length_419_cov_491.015625	63	143	82	1	80	0.0125000
NODE_67770_length_419_cov_491.015625	63	143	85	5	80	0.0625000
NODE_67770_length_419_cov_491.015625	63	143	32	1	80	0.0125000
NODE_67770_length_419_cov_491.015625	63	143	37	1	80	0.0125000
NODE_67770_length_419_cov_491.015625	63	143	39	7	80	0.0875000
NODE_67770_length_419_cov_491.015625	63	143	43	5	80	0.0625000
NODE_67770_length_419_cov_491.015625	63	143	45	3	80	0.0375000
NODE_67770_length_419_cov_491.015625	63	143	47	8	80	0.1000000
NODE_67770_length_419_cov_491.015625	63	143	49	1	80	0.0125000
NODE_67770_length_419_cov_491.015625	63	143	50	1	80	0.0125000
NODE_67770_length_419_cov_491.015625	63	143	52	4	80	0.0500000
NODE_67770_length_419_cov_491.015625	63	143	62	3	80	0.0375000
NODE_67770_length_419_cov_491.015625	63	143	67	5	80	0.0625000
NODE_67770_length_419_cov_491.015625	63	143	68	1	80	0.0125000
NODE_67770_length_419_cov_491.015625	63	143	69	8	80	0.1000000
NODE_67770_length_419_cov_491.015625	63	143	73	1	80	0.0125000
NODE_67770_length_419_cov_491.015625	63	143	75	8	80	0.1000000
NODE_67770_length_419_cov_491.015625	63	143	76	2	80	0.0250000
NODE_67770_length_419_cov_491.015625	63	143	77	2	80	0.0250000
NODE_67770_length_419_cov_491.015625	63	143	78	4	80	0.0500000
NODE_67770_length_419_cov_491.015625	63	143	80	7	80	0.0875000
NODE_67770_length_419_cov_491.015625	63	143	81	2	80	0.0250000
NODE_67770_length_419_cov_491.015625	63	143	82	1	80	0.0125000
NODE_67770_length_419_cov_491.015625	63	143	85	5	80	0.0625000
NODE_67770_length_419_cov_491.015625	63	143	32	1	80	0.0125000
NODE_67770_length_419_cov_491.015625	63	143	37	1	80	0.0125000
NODE_67770_length_419_cov_491.015625	63	143	39	7	80	0.0875000
NODE_67770_length_419_cov_491.015625	63	143	43	5	80	0.0625000
NODE_67770_length_419_cov_491.015625	63	143	45	3	80	0.0375000
NODE_67770_length_419_cov_491.015625	63	143	47	8	80	0.1000000
NODE_67770_length_419_cov_491.015625	63	143	49	1	80	0.0125000
NODE_67770_length_419_cov_491.015625	63	143	50	1	80	0.0125000
NODE_67770_length_419_cov_491.015625	63	143	52	4	80	0.0500000
NODE_67770_length_419_cov_491.015625	63	143	62	3	80	0.0375000
NODE_67770_length_419_cov_491.015625	63	143	67	5	80	0.0625000
NODE_67770_length_419_cov_491.015625	63	143	68	1	80	0.0125000
NODE_67770_length_419_cov_491.015625	63	143	69	8	80	0.1000000
NODE_67770_length_419_cov_491.015625	63	143	73	1	80	0.0125000
NODE_67770_length_419_cov_491.015625	63	143	75	8	80	0.1000000
NODE_67770_length_419_cov_491.015625	63	143	76	2	80	0.0250000
NODE_67770_length_419_cov_491.015625	63	143	77	2	80	0.0250000
NODE_67770_length_419_cov_491.015625	63	143	78	4	80	0.0500000
NODE_67770_length_419_cov_491.015625	63	143	80	7	80	0.0875000
NODE_67770_length_419_cov_491.015625	63	143	81	2	80	0.0250000
NODE_67770_length_419_cov_491.015625	63	143	82	1	80	0.0125000
NODE_67770_length_419_cov_491.015625	63	143	85	5	80	0.0625000
NODE_67770_length_419_cov_491.015625	116	196	75	6	80	0.0750000
NODE_67770_length_419_cov_491.015625	116	196	76	2	80	0.0250000
NODE_67770_length_419_cov_491.015625	116	196	78	11	80	0.1375000
NODE_67770_length_419_cov_491.015625	116	196	79	6	80	0.0750000
NODE_67770_length_419_cov_491.015625	116	196	80	11	80	0.1375000
NODE_67770_length_419_cov_491.015625	116	196	81	11	80	0.1375000
NODE_67770_length_419_cov_491.015625	116	196	82	6	80	0.0750000
NODE_67770_length_419_cov_491.015625	116	196	84	12	80	0.1500000
NODE_67770_length_419_cov_491.015625	116	196	85	9	80	0.1125000
NODE_67770_length_419_cov_491.015625	116	196	88	1	80	0.0125000
NODE_67770_length_419_cov_491.015625	116	196	89	5	80	0.0625000
NODE_67770_length_419_cov_491.015625	116	196	75	6	80	0.0750000
NODE_67770_length_419_cov_491.015625	116	196	76	2	80	0.0250000
NODE_67770_length_419_cov_491.015625	116	196	78	11	80	0.1375000
NODE_67770_length_419_cov_491.015625	116	196	79	6	80	0.0750000
NODE_67770_length_419_cov_491.015625	116	196	80	11	80	0.1375000
NODE_67770_length_419_cov_491.015625	116	196	81	11	80	0.1375000
NODE_67770_length_419_cov_491.015625	116	196	82	6	80	0.0750000
NODE_67770_length_419_cov_491.015625	116	196	84	12	80	0.1500000
NODE_67770_length_419_cov_491.015625	116	196	85	9	80	0.1125000
NODE_67770_length_419_cov_491.015625	116	196	88	1	80	0.0125000
NODE_67770_length_419_cov_491.015625	116	196	89	5	80	0.0625000
NODE_67770_length_419_cov_491.015625	116	196	75	6	80	0.0750000
NODE_67770_length_419_cov_491.015625	116	196	76	2	80	0.0250000
NODE_67770_length_419_cov_491.015625	116	196	78	11	80	0.1375000
NODE_67770_length_419_cov_491.015625	116	196	79	6	80	0.0750000
NODE_67770_length_419_cov_491.015625	116	196	80	11	80	0.1375000
NODE_67770_length_419_cov_491.015625	116	196	81	11	80	0.1375000
NODE_67770_length_419_cov_491.015625	116	196	82	6	80	0.0750000
NODE_67770_length_419_cov_491.015625	116	196	84	12	80	0.1500000
NODE_67770_length_419_cov_491.015625	116	196	85	9	80	0.1125000
NODE_67770_length_419_cov_491.015625	116	196	88	1	80	0.0125000
NODE_67770_length_419_cov_491.015625	116	196	89	5	80	0.0625000
NODE_67770_length_419_cov_491.015625	116	196	75	6	80	0.0750000
NODE_67770_length_419_cov_491.015625	116	196	76	2	80	0.0250000
NODE_67770_length_419_cov_491.015625	116	196	78	11	80	0.1375000
NODE_67770_length_419_cov_491.015625	116	196	79	6	80	0.0750000
NODE_67770_length_419_cov_491.015625	116	196	80	11	80	0.1375000
NODE_67770_length_419_cov_491.015625	116	196	81	11	80	0.1375000
NODE_67770_length_419_cov_491.015625	116	196	82	6	80	0.0750000
NODE_67770_length_419_cov_491.015625	116	196	84	12	80	0.1500000
NODE_67770_length_419_cov_491.015625	116	196	85	9	80	0.1125000
NODE_67770_length_419_cov_491.015625	116	196	88	1	80	0.0125000
NODE_67770_length_419_cov_491.015625	116	196	89	5	80	0.0625000
NODE_67770_length_419_cov_491.015625	116	196	75	6	80	0.0750000
NODE_67770_length_419_cov_491.015625	116	196	76	2	80	0.0250000
NODE_67770_length_419_cov_491.015625	116	196	78	11	80	0.1375000
NODE_67770_length_419_cov_491.015625	116	196	79	6	80	0.0750000
NODE_67770_length_419_cov_491.015625	116	196	80	11	80	0.1375000
NODE_67770_length_419_cov_491.015625	116	196	81	11	80	0.1375000
NODE_67770_length_419_cov_491.015625	116	196	82	6	80	0.0750000
NODE_67770_length_419_cov_491.015625	116	196	84	12	80	0.1500000
NODE_67770_length_419_cov_491.015625	116	196	85	9	80	0.1125000
NODE_67770_length_419_cov_491.015625	116	196	88	1	80	0.0125000
NODE_67770_length_419_cov_491.015625	116	196	89	5	80	0.0625000
NODE_67772_length_419_cov_31.725000	12	92	0	80	80	1.0000000
NODE_67772_length_419_cov_31.725000	65	145	0	80	80	1.0000000
NODE_67789_length_419_cov_4.862500	47	103	0	56	56	1.0000000
NODE_67789_length_419_cov_4.862500	258	327	2	10	69	0.1449275
NODE_67789_length_419_cov_4.862500	258	327	4	59	69	0.8550724
NODE_67789_length_419_cov_4.862500	284	328	0	1	44	0.0227273
NODE_67789_length_419_cov_4.862500	284	328	2	6	44	0.1363636
NODE_67789_length_419_cov_4.862500	284	328	4	37	44	0.8409091
NODE_67803_length_419_cov_4.193750	215	262	0	7	47	0.1489362
NODE_67803_length_419_cov_4.193750	215	262	2	4	47	0.0851064
NODE_67803_length_419_cov_4.193750	215	262	4	36	47	0.7659575
NODE_67803_length_419_cov_4.193750	235	275	4	40	40	1.0000000
NODE_67817_length_419_cov_3.696875	165	215	0	50	50	1.0000000
NODE_67854_length_419_cov_2.628125	234	314	0	45	80	0.5625000
NODE_67854_length_419_cov_2.628125	234	314	2	35	80	0.4375000
NODE_67856_length_419_cov_2.603125	154	196	0	42	42	1.0000000
NODE_67878_length_419_cov_2.350000	156	220	26	1	64	0.0156250
NODE_67878_length_419_cov_2.350000	156	220	28	1	64	0.0156250
NODE_67878_length_419_cov_2.350000	156	220	29	4	64	0.0625000
NODE_67878_length_419_cov_2.350000	156	220	31	1	64	0.0156250
NODE_67878_length_419_cov_2.350000	156	220	32	7	64	0.1093750
NODE_67878_length_419_cov_2.350000	156	220	35	1	64	0.0156250
NODE_67878_length_419_cov_2.350000	156	220	36	14	64	0.2187500
NODE_67878_length_419_cov_2.350000	156	220	37	5	64	0.0781250
NODE_67878_length_419_cov_2.350000	156	220	38	5	64	0.0781250
NODE_67878_length_419_cov_2.350000	156	220	39	7	64	0.1093750
NODE_67878_length_419_cov_2.350000	156	220	41	1	64	0.0156250
NODE_67878_length_419_cov_2.350000	156	220	42	7	64	0.1093750
NODE_67878_length_419_cov_2.350000	156	220	43	2	64	0.0312500
NODE_67878_length_419_cov_2.350000	156	220	44	8	64	0.1250000
NODE_67961_length_419_cov_1.593750	339	358	0	19	19	1.0000000
NODE_68250_length_418_cov_63.059561	105	186	0	81	81	1.0000000
NODE_68250_length_418_cov_63.059561	159	239	0	80	80	1.0000000
NODE_68251_length_418_cov_49.796238	325	405	29	2	80	0.0250000
NODE_68251_length_418_cov_49.796238	325	405	31	3	80	0.0375000
NODE_68251_length_418_cov_49.796238	325	405	35	3	80	0.0375000
NODE_68251_length_418_cov_49.796238	325	405	39	1	80	0.0125000
NODE_68251_length_418_cov_49.796238	325	405	40	5	80	0.0625000
NODE_68251_length_418_cov_49.796238	325	405	43	1	80	0.0125000
NODE_68251_length_418_cov_49.796238	325	405	50	6	80	0.0750000
NODE_68251_length_418_cov_49.796238	325	405	52	3	80	0.0375000
NODE_68251_length_418_cov_49.796238	325	405	53	2	80	0.0250000
NODE_68251_length_418_cov_49.796238	325	405	57	1	80	0.0125000
NODE_68251_length_418_cov_49.796238	325	405	58	29	80	0.3625000
NODE_68251_length_418_cov_49.796238	325	405	60	9	80	0.1125000
NODE_68251_length_418_cov_49.796238	325	405	63	2	80	0.0250000
NODE_68251_length_418_cov_49.796238	325	405	66	9	80	0.1125000
NODE_68251_length_418_cov_49.796238	325	405	68	4	80	0.0500000
NODE_68251_length_418_cov_49.796238	378	415	8	1	37	0.0270270
NODE_68251_length_418_cov_49.796238	378	415	12	2	37	0.0540541
NODE_68251_length_418_cov_49.796238	378	415	20	5	37	0.1351351
NODE_68251_length_418_cov_49.796238	378	415	27	2	37	0.0540541
NODE_68251_length_418_cov_49.796238	378	415	29	2	37	0.0540541
NODE_68251_length_418_cov_49.796238	378	415	31	3	37	0.0810811
NODE_68251_length_418_cov_49.796238	378	415	35	3	37	0.0810811
NODE_68251_length_418_cov_49.796238	378	415	39	1	37	0.0270270
NODE_68251_length_418_cov_49.796238	378	415	40	5	37	0.1351351
NODE_68251_length_418_cov_49.796238	378	415	43	1	37	0.0270270
NODE_68251_length_418_cov_49.796238	378	415	50	6	37	0.1621622
NODE_68251_length_418_cov_49.796238	378	415	52	3	37	0.0810811
NODE_68251_length_418_cov_49.796238	378	415	53	2	37	0.0540541
NODE_68251_length_418_cov_49.796238	378	415	57	1	37	0.0270270
NODE_68252_length_418_cov_42.764890	119	196	0	77	77	1.0000000
NODE_68252_length_418_cov_42.764890	172	250	0	78	78	1.0000000
NODE_68253_length_418_cov_23.830721	73	153	0	80	80	1.0000000
NODE_68253_length_418_cov_23.830721	126	200	0	74	74	1.0000000
NODE_68255_length_418_cov_7.216301	211	291	2	29	80	0.3625000
NODE_68255_length_418_cov_7.216301	211	291	4	40	80	0.5000000
NODE_68255_length_418_cov_7.216301	211	291	6	11	80	0.1375000
NODE_68265_length_418_cov_5.382445	134	215	0	81	81	1.0000000
NODE_68265_length_418_cov_5.382445	187	268	0	81	81	1.0000000
NODE_68275_length_418_cov_4.463950	191	272	6	9	81	0.1111111
NODE_68275_length_418_cov_4.463950	191	272	8	12	81	0.1481481
NODE_68275_length_418_cov_4.463950	191	272	10	60	81	0.7407407
NODE_68280_length_418_cov_4.216301	148	230	2	9	82	0.1097561
NODE_68280_length_418_cov_4.216301	148	230	6	73	82	0.8902439
NODE_68281_length_418_cov_4.065831	211	280	2	5	69	0.0724638
NODE_68281_length_418_cov_4.065831	211	280	4	52	69	0.7536232
NODE_68281_length_418_cov_4.065831	211	280	6	12	69	0.1739130
NODE_68284_length_418_cov_3.909091	95	175	6	3	80	0.0375000
NODE_68284_length_418_cov_3.909091	95	175	8	2	80	0.0250000
NODE_68284_length_418_cov_3.909091	95	175	13	1	80	0.0125000
NODE_68284_length_418_cov_3.909091	95	175	14	1	80	0.0125000
NODE_68284_length_418_cov_3.909091	95	175	16	5	80	0.0625000
NODE_68284_length_418_cov_3.909091	95	175	18	13	80	0.1625000
NODE_68284_length_418_cov_3.909091	95	175	23	6	80	0.0750000
NODE_68284_length_418_cov_3.909091	95	175	27	1	80	0.0125000
NODE_68284_length_418_cov_3.909091	95	175	28	3	80	0.0375000
NODE_68284_length_418_cov_3.909091	95	175	32	8	80	0.1000000
NODE_68284_length_418_cov_3.909091	95	175	33	11	80	0.1375000
NODE_68284_length_418_cov_3.909091	95	175	34	2	80	0.0250000
NODE_68284_length_418_cov_3.909091	95	175	36	1	80	0.0125000
NODE_68284_length_418_cov_3.909091	95	175	37	8	80	0.1000000
NODE_68284_length_418_cov_3.909091	95	175	39	1	80	0.0125000
NODE_68284_length_418_cov_3.909091	95	175	41	14	80	0.1750000
NODE_68284_length_418_cov_3.909091	148	224	4	3	76	0.0394737
NODE_68284_length_418_cov_3.909091	148	224	6	9	76	0.1184211
NODE_68284_length_418_cov_3.909091	148	224	7	3	76	0.0394737
NODE_68284_length_418_cov_3.909091	148	224	8	2	76	0.0263158
NODE_68284_length_418_cov_3.909091	148	224	9	1	76	0.0131579
NODE_68284_length_418_cov_3.909091	148	224	10	4	76	0.0526316
NODE_68284_length_418_cov_3.909091	148	224	12	4	76	0.0526316
NODE_68284_length_418_cov_3.909091	148	224	13	1	76	0.0131579
NODE_68284_length_418_cov_3.909091	148	224	14	15	76	0.1973684
NODE_68284_length_418_cov_3.909091	148	224	15	1	76	0.0131579
NODE_68284_length_418_cov_3.909091	148	224	16	5	76	0.0657895
NODE_68284_length_418_cov_3.909091	148	224	17	13	76	0.1710526
NODE_68284_length_418_cov_3.909091	148	224	18	13	76	0.1710526
NODE_68284_length_418_cov_3.909091	148	224	23	2	76	0.0263158
NODE_68288_length_418_cov_3.749216	181	247	0	66	66	1.0000000
NODE_68289_length_418_cov_3.711599	249	313	0	23	64	0.3593750
NODE_68289_length_418_cov_3.711599	249	313	2	41	64	0.6406250
NODE_68307_length_418_cov_3.012539	101	181	0	17	80	0.2125000
NODE_68307_length_418_cov_3.012539	101	181	2	63	80	0.7875000
NODE_68354_length_418_cov_2.376176	95	115	0	20	20	1.0000000
NODE_68436_length_418_cov_1.623824	47	128	0	81	81	1.0000000
NODE_68436_length_418_cov_1.623824	239	268	16	6	29	0.2068966
NODE_68436_length_418_cov_1.623824	239	268	18	23	29	0.7931035
NODE_68682_length_418_cov_0.626959	255	299	0	44	44	1.0000000
NODE_68708_length_417_cov_45.267296	212	292	0	80	80	1.0000000
NODE_68708_length_417_cov_45.267296	265	345	0	80	80	1.0000000
NODE_68708_length_417_cov_45.267296	341	417	0	76	76	1.0000000
NODE_68709_length_417_cov_36.006289	159	239	0	80	80	1.0000000
NODE_68711_length_417_cov_12.886792	193	273	2	78	80	0.9750000
NODE_68711_length_417_cov_12.886792	193	273	4	2	80	0.0250000
NODE_68711_length_417_cov_12.886792	246	326	2	67	80	0.8375000
NODE_68711_length_417_cov_12.886792	246	326	4	13	80	0.1625000
NODE_68717_length_417_cov_7.056604	210	271	2	61	61	1.0000000
NODE_68717_length_417_cov_7.056604	263	315	0	20	52	0.3846154
NODE_68717_length_417_cov_7.056604	263	315	2	32	52	0.6153846
NODE_68718_length_417_cov_6.669811	194	264	2	12	70	0.1714286
NODE_68718_length_417_cov_6.669811	194	264	3	54	70	0.7714286
NODE_68718_length_417_cov_6.669811	194	264	4	4	70	0.0571429
NODE_68779_length_417_cov_2.795597	20	91	0	71	71	1.0000000
NODE_69163_length_416_cov_115.782334	174	259	2	22	85	0.2588235
NODE_69163_length_416_cov_115.782334	174	259	4	36	85	0.4235294
NODE_69163_length_416_cov_115.782334	174	259	6	27	85	0.3176471
NODE_69164_length_416_cov_70.678233	180	244	24	1	64	0.0156250
NODE_69164_length_416_cov_70.678233	180	244	35	3	64	0.0468750
NODE_69164_length_416_cov_70.678233	180	244	36	11	64	0.1718750
NODE_69164_length_416_cov_70.678233	180	244	41	1	64	0.0156250
NODE_69164_length_416_cov_70.678233	180	244	42	2	64	0.0312500
NODE_69164_length_416_cov_70.678233	180	244	45	3	64	0.0468750
NODE_69164_length_416_cov_70.678233	180	244	47	4	64	0.0625000
NODE_69164_length_416_cov_70.678233	180	244	49	3	64	0.0468750
NODE_69164_length_416_cov_70.678233	180	244	55	2	64	0.0312500
NODE_69164_length_416_cov_70.678233	180	244	58	9	64	0.1406250
NODE_69164_length_416_cov_70.678233	180	244	59	1	64	0.0156250
NODE_69164_length_416_cov_70.678233	180	244	60	10	64	0.1562500
NODE_69164_length_416_cov_70.678233	180	244	62	13	64	0.2031250
NODE_69164_length_416_cov_70.678233	180	244	64	1	64	0.0156250
NODE_69166_length_416_cov_39.933754	288	368	0	80	80	1.0000000
NODE_69166_length_416_cov_39.933754	341	416	0	75	75	1.0000000
NODE_69167_length_416_cov_37.334385	158	238	0	80	80	1.0000000
NODE_69167_length_416_cov_37.334385	211	291	0	80	80	1.0000000
NODE_69167_length_416_cov_37.334385	287	367	0	80	80	1.0000000
NODE_69167_length_416_cov_37.334385	340	416	0	76	76	1.0000000
NODE_69179_length_416_cov_5.242902	89	169	0	80	80	1.0000000
NODE_69179_length_416_cov_5.242902	142	222	0	80	80	1.0000000
NODE_69184_length_416_cov_4.892744	79	145	0	66	66	1.0000000
NODE_69184_length_416_cov_4.892744	194	272	2	15	78	0.1923077
NODE_69184_length_416_cov_4.892744	194	272	3	4	78	0.0512821
NODE_69184_length_416_cov_4.892744	194	272	5	22	78	0.2820513
NODE_69184_length_416_cov_4.892744	194	272	6	37	78	0.4743590
NODE_69184_length_416_cov_4.892744	247	272	6	25	25	1.0000000
NODE_69204_length_416_cov_3.886435	79	136	0	2	57	0.0350877
NODE_69204_length_416_cov_3.886435	79	136	2	11	57	0.1929825
NODE_69204_length_416_cov_3.886435	79	136	6	7	57	0.1228070
NODE_69204_length_416_cov_3.886435	79	136	8	37	57	0.6491228
NODE_69279_length_416_cov_2.230284	10	90	2	34	80	0.4250000
NODE_69279_length_416_cov_2.230284	10	90	4	46	80	0.5750000
NODE_69399_length_416_cov_1.520505	198	244	1	13	46	0.2826087
NODE_69399_length_416_cov_1.520505	198	244	3	15	46	0.3260870
NODE_69399_length_416_cov_1.520505	198	244	7	9	46	0.1956522
NODE_69399_length_416_cov_1.520505	198	244	8	9	46	0.1956522
NODE_69399_length_416_cov_1.520505	261	328	20	4	67	0.0597015
NODE_69399_length_416_cov_1.520505	261	328	22	8	67	0.1194030
NODE_69399_length_416_cov_1.520505	261	328	24	1	67	0.0149254
NODE_69399_length_416_cov_1.520505	261	328	26	7	67	0.1044776
NODE_69399_length_416_cov_1.520505	261	328	28	19	67	0.2835821
NODE_69399_length_416_cov_1.520505	261	328	30	5	67	0.0746269
NODE_69399_length_416_cov_1.520505	261	328	32	12	67	0.1791045
NODE_69399_length_416_cov_1.520505	261	328	34	2	67	0.0298507
NODE_69399_length_416_cov_1.520505	261	328	36	9	67	0.1343284
NODE_69673_length_415_cov_35.924051	260	339	0	79	79	1.0000000
NODE_69673_length_415_cov_35.924051	316	392	0	76	76	1.0000000
NODE_69679_length_415_cov_6.376582	117	197	2	80	80	1.0000000
NODE_69679_length_415_cov_6.376582	254	334	0	80	80	1.0000000
NODE_69774_length_415_cov_2.224684	144	224	4	4	80	0.0500000
NODE_69774_length_415_cov_2.224684	144	224	5	12	80	0.1500000
NODE_69774_length_415_cov_2.224684	144	224	9	1	80	0.0125000
NODE_69774_length_415_cov_2.224684	144	224	13	1	80	0.0125000
NODE_69774_length_415_cov_2.224684	144	224	14	4	80	0.0500000
NODE_69774_length_415_cov_2.224684	144	224	15	45	80	0.5625000
NODE_69774_length_415_cov_2.224684	144	224	17	13	80	0.1625000
NODE_69795_length_415_cov_2.069620	207	273	3	1	66	0.0151515
NODE_69795_length_415_cov_2.069620	207	273	4	9	66	0.1363636
NODE_69795_length_415_cov_2.069620	207	273	5	2	66	0.0303030
NODE_69795_length_415_cov_2.069620	207	273	7	29	66	0.4393939
NODE_69795_length_415_cov_2.069620	207	273	8	6	66	0.0909091
NODE_69795_length_415_cov_2.069620	207	273	10	19	66	0.2878788
NODE_69817_length_415_cov_1.832278	225	283	5	5	58	0.0862069
NODE_69817_length_415_cov_1.832278	225	283	7	1	58	0.0172414
NODE_69817_length_415_cov_1.832278	225	283	8	2	58	0.0344828
NODE_69817_length_415_cov_1.832278	225	283	9	18	58	0.3103448
NODE_69817_length_415_cov_1.832278	225	283	14	12	58	0.2068966
NODE_69817_length_415_cov_1.832278	225	283	16	16	58	0.2758621
NODE_69817_length_415_cov_1.832278	225	283	18	1	58	0.0172414
NODE_69817_length_415_cov_1.832278	225	283	20	2	58	0.0344828
NODE_69817_length_415_cov_1.832278	225	283	22	1	58	0.0172414
NODE_69845_length_415_cov_1.610759	90	170	42	2	80	0.0250000
NODE_69845_length_415_cov_1.610759	90	170	44	1	80	0.0125000
NODE_69845_length_415_cov_1.610759	90	170	56	1	80	0.0125000
NODE_69845_length_415_cov_1.610759	90	170	58	1	80	0.0125000
NODE_69845_length_415_cov_1.610759	90	170	60	7	80	0.0875000
NODE_69845_length_415_cov_1.610759	90	170	64	2	80	0.0250000
NODE_69845_length_415_cov_1.610759	90	170	68	2	80	0.0250000
NODE_69845_length_415_cov_1.610759	90	170	70	1	80	0.0125000
NODE_69845_length_415_cov_1.610759	90	170	72	1	80	0.0125000
NODE_69845_length_415_cov_1.610759	90	170	85	2	80	0.0250000
NODE_69845_length_415_cov_1.610759	90	170	90	16	80	0.2000000
NODE_69845_length_415_cov_1.610759	90	170	98	2	80	0.0250000
NODE_69845_length_415_cov_1.610759	90	170	104	2	80	0.0250000
NODE_69845_length_415_cov_1.610759	90	170	110	9	80	0.1125000
NODE_69845_length_415_cov_1.610759	90	170	112	9	80	0.1125000
NODE_69845_length_415_cov_1.610759	90	170	114	1	80	0.0125000
NODE_69845_length_415_cov_1.610759	90	170	116	2	80	0.0250000
NODE_69845_length_415_cov_1.610759	90	170	118	13	80	0.1625000
NODE_69845_length_415_cov_1.610759	90	170	120	6	80	0.0750000
NODE_69845_length_415_cov_1.610759	335	376	0	41	41	1.0000000
NODE_70175_length_414_cov_46.263492	0	49	0	49	49	1.0000000
NODE_70175_length_414_cov_46.263492	22	102	0	80	80	1.0000000
NODE_70183_length_414_cov_7.460317	167	247	0	80	80	1.0000000
NODE_70183_length_414_cov_7.460317	220	300	0	80	80	1.0000000
NODE_70192_length_414_cov_5.676190	54	134	0	80	80	1.0000000
NODE_70192_length_414_cov_5.676190	107	187	0	80	80	1.0000000
NODE_70222_length_414_cov_4.130159	257	303	6	44	46	0.9565217
NODE_70222_length_414_cov_4.130159	257	303	8	2	46	0.0434783
NODE_70222_length_414_cov_4.130159	276	356	0	9	80	0.1125000
NODE_70222_length_414_cov_4.130159	276	356	2	6	80	0.0750000
NODE_70222_length_414_cov_4.130159	276	356	6	65	80	0.8125000
NODE_70254_length_414_cov_2.996825	75	135	0	4	60	0.0666667
NODE_70254_length_414_cov_2.996825	75	135	2	2	60	0.0333333
NODE_70254_length_414_cov_2.996825	75	135	4	4	60	0.0666667
NODE_70254_length_414_cov_2.996825	75	135	8	13	60	0.2166667
NODE_70254_length_414_cov_2.996825	75	135	10	9	60	0.1500000
NODE_70254_length_414_cov_2.996825	75	135	12	28	60	0.4666667
NODE_70271_length_414_cov_2.631746	68	145	0	74	77	0.9610389
NODE_70271_length_414_cov_2.631746	68	145	2	3	77	0.0389610
NODE_70284_length_414_cov_2.473016	164	197	0	33	33	1.0000000
NODE_70284_length_414_cov_2.473016	170	255	0	85	85	1.0000000
NODE_70305_length_414_cov_2.222222	185	260	0	14	75	0.1866667
NODE_70305_length_414_cov_2.222222	185	260	2	61	75	0.8133333
NODE_70305_length_414_cov_2.222222	233	304	0	6	71	0.0845070
NODE_70305_length_414_cov_2.222222	233	304	2	65	71	0.9154930
NODE_70307_length_414_cov_2.206349	88	163	2	21	75	0.2800000
NODE_70307_length_414_cov_2.206349	88	163	4	26	75	0.3466667
NODE_70307_length_414_cov_2.206349	88	163	6	28	75	0.3733333
NODE_70326_length_414_cov_2.047619	298	349	2	51	51	1.0000000
NODE_70486_length_414_cov_1.177778	106	190	0	35	84	0.4166667
NODE_70486_length_414_cov_1.177778	106	190	2	49	84	0.5833333
NODE_70494_length_414_cov_1.155556	0	23	0	23	23	1.0000000
NODE_70690_length_413_cov_41.471338	35	115	0	80	80	1.0000000
NODE_70690_length_413_cov_41.471338	35	115	0	80	80	1.0000000
NODE_70690_length_413_cov_41.471338	88	168	0	80	80	1.0000000
NODE_70690_length_413_cov_41.471338	88	168	0	80	80	1.0000000
NODE_70691_length_413_cov_16.687898	222	302	4	74	80	0.9250000
NODE_70691_length_413_cov_16.687898	222	302	6	6	80	0.0750000
NODE_70691_length_413_cov_16.687898	275	355	0	30	80	0.3750000
NODE_70691_length_413_cov_16.687898	275	355	2	6	80	0.0750000
NODE_70691_length_413_cov_16.687898	275	355	4	44	80	0.5500000
NODE_70699_length_413_cov_7.057325	170	250	4	18	80	0.2250000
NODE_70699_length_413_cov_7.057325	170	250	6	1	80	0.0125000
NODE_70699_length_413_cov_7.057325	170	250	8	22	80	0.2750000
NODE_70699_length_413_cov_7.057325	170	250	10	39	80	0.4875000
NODE_70699_length_413_cov_7.057325	223	300	9	17	77	0.2207792
NODE_70699_length_413_cov_7.057325	223	300	10	60	77	0.7792208
NODE_70703_length_413_cov_5.665605	125	182	12	1	57	0.0175439
NODE_70703_length_413_cov_5.665605	125	182	14	54	57	0.9473684
NODE_70703_length_413_cov_5.665605	125	182	18	2	57	0.0350877
NODE_70712_length_413_cov_4.754777	140	184	2	44	44	1.0000000
NODE_70743_length_413_cov_3.506369	113	193	2	80	80	1.0000000
NODE_70749_length_413_cov_3.235669	251	331	0	80	80	1.0000000
NODE_70749_length_413_cov_3.235669	304	356	0	52	52	1.0000000
NODE_70792_length_413_cov_2.484076	209	257	4	47	48	0.9791667
NODE_70792_length_413_cov_2.484076	209	257	8	1	48	0.0208333
NODE_70835_length_413_cov_1.949045	224	296	0	72	72	1.0000000
NODE_71196_length_412_cov_9.996805	172	244	0	72	72	1.0000000
NODE_71218_length_412_cov_4.686901	112	167	0	55	55	1.0000000
NODE_71253_length_412_cov_3.204473	44	124	0	80	80	1.0000000
NODE_71276_length_412_cov_2.824281	225	305	6	80	80	1.0000000
NODE_71371_length_412_cov_1.782748	262	342	2	14	80	0.1750000
NODE_71371_length_412_cov_1.782748	262	342	4	66	80	0.8250000
NODE_71398_length_412_cov_1.603834	143	182	10	7	39	0.1794872
NODE_71398_length_412_cov_1.603834	143	182	12	1	39	0.0256410
NODE_71398_length_412_cov_1.603834	143	182	14	6	39	0.1538462
NODE_71398_length_412_cov_1.603834	143	182	16	7	39	0.1794872
NODE_71398_length_412_cov_1.603834	143	182	18	3	39	0.0769231
NODE_71398_length_412_cov_1.603834	143	182	20	4	39	0.1025641
NODE_71398_length_412_cov_1.603834	143	182	22	1	39	0.0256410
NODE_71398_length_412_cov_1.603834	143	182	28	2	39	0.0512821
NODE_71398_length_412_cov_1.603834	143	182	30	3	39	0.0769231
NODE_71398_length_412_cov_1.603834	143	182	38	5	39	0.1282051
NODE_71665_length_411_cov_44.701923	4	72	0	68	68	1.0000000
NODE_71665_length_411_cov_44.701923	35	116	0	77	81	0.9506173
NODE_71665_length_411_cov_44.701923	35	116	2	4	81	0.0493827
NODE_71665_length_411_cov_44.701923	161	242	0	42	81	0.5185185
NODE_71665_length_411_cov_44.701923	161	242	2	39	81	0.4814815
NODE_71665_length_411_cov_44.701923	293	374	0	81	81	1.0000000
NODE_71665_length_411_cov_44.701923	337	411	0	74	74	1.0000000
NODE_71666_length_411_cov_43.144231	102	183	0	81	81	1.0000000
NODE_71666_length_411_cov_43.144231	156	236	0	80	80	1.0000000
NODE_71666_length_411_cov_43.144231	232	312	0	80	80	1.0000000
NODE_71666_length_411_cov_43.144231	285	365	0	80	80	1.0000000
NODE_71672_length_411_cov_8.471154	133	213	0	80	80	1.0000000
NODE_71672_length_411_cov_8.471154	186	266	0	80	80	1.0000000
NODE_71673_length_411_cov_8.407051	133	220	16	8	87	0.0919540
NODE_71673_length_411_cov_8.407051	133	220	20	13	87	0.1494253
NODE_71673_length_411_cov_8.407051	133	220	22	14	87	0.1609195
NODE_71673_length_411_cov_8.407051	133	220	23	7	87	0.0804598
NODE_71673_length_411_cov_8.407051	133	220	25	7	87	0.0804598
NODE_71673_length_411_cov_8.407051	133	220	27	1	87	0.0114943
NODE_71673_length_411_cov_8.407051	133	220	29	2	87	0.0229885
NODE_71673_length_411_cov_8.407051	133	220	30	26	87	0.2988506
NODE_71673_length_411_cov_8.407051	133	220	34	3	87	0.0344828
NODE_71673_length_411_cov_8.407051	133	220	36	6	87	0.0689655
NODE_71675_length_411_cov_6.455128	249	316	0	17	67	0.2537313
NODE_71675_length_411_cov_6.455128	249	316	2	50	67	0.7462686
NODE_71675_length_411_cov_6.455128	292	344	2	52	52	1.0000000
NODE_71687_length_411_cov_4.782051	98	178	2	66	80	0.8250000
NODE_71687_length_411_cov_4.782051	98	178	4	14	80	0.1750000
NODE_71687_length_411_cov_4.782051	151	228	2	59	77	0.7662337
NODE_71687_length_411_cov_4.782051	151	228	4	18	77	0.2337662
NODE_71705_length_411_cov_3.698718	282	347	0	23	65	0.3538462
NODE_71705_length_411_cov_3.698718	282	347	2	42	65	0.6461539
NODE_71713_length_411_cov_3.378205	88	148	26	1	60	0.0166667
NODE_71713_length_411_cov_3.378205	88	148	30	2	60	0.0333333
NODE_71713_length_411_cov_3.378205	88	148	33	15	60	0.2500000
NODE_71713_length_411_cov_3.378205	88	148	37	4	60	0.0666667
NODE_71713_length_411_cov_3.378205	88	148	39	11	60	0.1833333
NODE_71713_length_411_cov_3.378205	88	148	41	27	60	0.4500000
NODE_71714_length_411_cov_3.371795	145	225	0	8	80	0.1000000
NODE_71714_length_411_cov_3.371795	145	225	1	63	80	0.7875000
NODE_71714_length_411_cov_3.371795	145	225	3	9	80	0.1125000
NODE_71714_length_411_cov_3.371795	198	274	1	18	76	0.2368421
NODE_71714_length_411_cov_3.371795	198	274	3	58	76	0.7631579
NODE_72163_length_410_cov_49.331190	320	400	0	16	80	0.2000000
NODE_72163_length_410_cov_49.331190	320	400	1	12	80	0.1500000
NODE_72163_length_410_cov_49.331190	320	400	3	10	80	0.1250000
NODE_72163_length_410_cov_49.331190	320	400	6	7	80	0.0875000
NODE_72163_length_410_cov_49.331190	320	400	9	3	80	0.0375000
NODE_72163_length_410_cov_49.331190	320	400	11	32	80	0.4000000
NODE_72163_length_410_cov_49.331190	320	400	0	16	80	0.2000000
NODE_72163_length_410_cov_49.331190	320	400	1	12	80	0.1500000
NODE_72163_length_410_cov_49.331190	320	400	3	10	80	0.1250000
NODE_72163_length_410_cov_49.331190	320	400	6	7	80	0.0875000
NODE_72163_length_410_cov_49.331190	320	400	9	3	80	0.0375000
NODE_72163_length_410_cov_49.331190	320	400	11	32	80	0.4000000
NODE_72163_length_410_cov_49.331190	320	400	0	16	80	0.2000000
NODE_72163_length_410_cov_49.331190	320	400	1	12	80	0.1500000
NODE_72163_length_410_cov_49.331190	320	400	3	10	80	0.1250000
NODE_72163_length_410_cov_49.331190	320	400	6	7	80	0.0875000
NODE_72163_length_410_cov_49.331190	320	400	9	3	80	0.0375000
NODE_72163_length_410_cov_49.331190	320	400	11	32	80	0.4000000
NODE_72163_length_410_cov_49.331190	320	400	0	16	80	0.2000000
NODE_72163_length_410_cov_49.331190	320	400	1	12	80	0.1500000
NODE_72163_length_410_cov_49.331190	320	400	3	10	80	0.1250000
NODE_72163_length_410_cov_49.331190	320	400	6	7	80	0.0875000
NODE_72163_length_410_cov_49.331190	320	400	9	3	80	0.0375000
NODE_72163_length_410_cov_49.331190	320	400	11	32	80	0.4000000
NODE_72163_length_410_cov_49.331190	320	400	0	16	80	0.2000000
NODE_72163_length_410_cov_49.331190	320	400	1	12	80	0.1500000
NODE_72163_length_410_cov_49.331190	320	400	3	10	80	0.1250000
NODE_72163_length_410_cov_49.331190	320	400	6	7	80	0.0875000
NODE_72163_length_410_cov_49.331190	320	400	9	3	80	0.0375000
NODE_72163_length_410_cov_49.331190	320	400	11	32	80	0.4000000
NODE_72163_length_410_cov_49.331190	329	400	0	16	71	0.2253521
NODE_72163_length_410_cov_49.331190	329	400	1	12	71	0.1690141
NODE_72163_length_410_cov_49.331190	329	400	3	10	71	0.1408451
NODE_72163_length_410_cov_49.331190	329	400	6	7	71	0.0985916
NODE_72163_length_410_cov_49.331190	329	400	9	3	71	0.0422535
NODE_72163_length_410_cov_49.331190	329	400	11	23	71	0.3239437
NODE_72169_length_410_cov_6.797428	179	259	0	58	80	0.7250000
NODE_72169_length_410_cov_6.797428	179	259	2	22	80	0.2750000
NODE_72169_length_410_cov_6.797428	232	312	0	5	80	0.0625000
NODE_72169_length_410_cov_6.797428	232	312	2	41	80	0.5125000
NODE_72169_length_410_cov_6.797428	232	312	4	34	80	0.4250000
NODE_72184_length_410_cov_5.102894	153	222	0	24	69	0.3478261
NODE_72184_length_410_cov_5.102894	153	222	2	45	69	0.6521739
NODE_72186_length_410_cov_4.884244	101	179	0	78	78	1.0000000
NODE_72187_length_410_cov_4.787781	287	344	0	57	57	1.0000000
NODE_72187_length_410_cov_4.787781	340	397	0	57	57	1.0000000
NODE_72194_length_410_cov_4.591640	245	303	20	1	58	0.0172414
NODE_72194_length_410_cov_4.591640	245	303	23	5	58	0.0862069
NODE_72194_length_410_cov_4.591640	245	303	25	7	58	0.1206897
NODE_72194_length_410_cov_4.591640	245	303	29	1	58	0.0172414
NODE_72194_length_410_cov_4.591640	245	303	34	1	58	0.0172414
NODE_72194_length_410_cov_4.591640	245	303	39	5	58	0.0862069
NODE_72194_length_410_cov_4.591640	245	303	48	1	58	0.0172414
NODE_72194_length_410_cov_4.591640	245	303	50	2	58	0.0344828
NODE_72194_length_410_cov_4.591640	245	303	51	3	58	0.0517241
NODE_72194_length_410_cov_4.591640	245	303	52	6	58	0.1034483
NODE_72194_length_410_cov_4.591640	245	303	53	2	58	0.0344828
NODE_72194_length_410_cov_4.591640	245	303	54	1	58	0.0172414
NODE_72194_length_410_cov_4.591640	245	303	55	9	58	0.1551724
NODE_72194_length_410_cov_4.591640	245	303	56	4	58	0.0689655
NODE_72194_length_410_cov_4.591640	245	303	58	10	58	0.1724138
NODE_72194_length_410_cov_4.591640	298	356	42	3	58	0.0517241
NODE_72194_length_410_cov_4.591640	298	356	44	2	58	0.0344828
NODE_72194_length_410_cov_4.591640	298	356	46	5	58	0.0862069
NODE_72194_length_410_cov_4.591640	298	356	48	14	58	0.2413793
NODE_72194_length_410_cov_4.591640	298	356	52	5	58	0.0862069
NODE_72194_length_410_cov_4.591640	298	356	54	3	58	0.0517241
NODE_72194_length_410_cov_4.591640	298	356	56	9	58	0.1551724
NODE_72194_length_410_cov_4.591640	298	356	58	17	58	0.2931035
NODE_72230_length_410_cov_3.215434	32	112	2	18	80	0.2250000
NODE_72230_length_410_cov_3.215434	32	112	6	62	80	0.7750000
NODE_72230_length_410_cov_3.215434	85	165	4	28	80	0.3500000
NODE_72230_length_410_cov_3.215434	85	165	6	52	80	0.6500000
NODE_72327_length_410_cov_1.913183	227	285	2	6	58	0.1034483
NODE_72327_length_410_cov_1.913183	227	285	4	24	58	0.4137931
NODE_72327_length_410_cov_1.913183	227	285	5	4	58	0.0689655
NODE_72327_length_410_cov_1.913183	227	285	6	19	58	0.3275862
NODE_72327_length_410_cov_1.913183	227	285	7	5	58	0.0862069
NODE_72526_length_410_cov_1.038585	272	316	0	10	44	0.2272727
NODE_72526_length_410_cov_1.038585	272	316	2	22	44	0.5000000
NODE_72526_length_410_cov_1.038585	272	316	4	12	44	0.2727273
NODE_72688_length_409_cov_11.506452	56	136	0	67	80	0.8375000
NODE_72688_length_409_cov_11.506452	56	136	2	13	80	0.1625000
NODE_72688_length_409_cov_11.506452	109	189	0	14	80	0.1750000
NODE_72688_length_409_cov_11.506452	109	189	2	66	80	0.8250000
NODE_72689_length_409_cov_10.329032	131	186	0	55	55	1.0000000
NODE_72690_length_409_cov_9.625806	62	142	0	80	80	1.0000000
NODE_72690_length_409_cov_9.625806	115	195	0	80	80	1.0000000
NODE_72697_length_409_cov_6.867742	41	71	0	30	30	1.0000000
NODE_72730_length_409_cov_3.822581	103	158	0	19	55	0.3454545
NODE_72730_length_409_cov_3.822581	103	158	4	36	55	0.6545454
NODE_72730_length_409_cov_3.822581	151	232	0	2	81	0.0246914
NODE_72730_length_409_cov_3.822581	151	232	3	2	81	0.0246914
NODE_72730_length_409_cov_3.822581	151	232	4	77	81	0.9506173
NODE_72754_length_409_cov_2.987097	240	287	0	47	47	1.0000000
NODE_72951_length_409_cov_1.319355	49	131	0	4	82	0.0487805
NODE_72951_length_409_cov_1.319355	49	131	4	78	82	0.9512195
NODE_72951_length_409_cov_1.319355	104	161	0	2	57	0.0350877
NODE_72951_length_409_cov_1.319355	104	161	4	55	57	0.9649123
NODE_73196_length_408_cov_8.585761	57	137	2	8	80	0.1000000
NODE_73196_length_408_cov_8.585761	57	137	4	60	80	0.7500000
NODE_73196_length_408_cov_8.585761	57	137	6	12	80	0.1500000
NODE_73196_length_408_cov_8.585761	110	190	2	61	80	0.7625000
NODE_73196_length_408_cov_8.585761	110	190	4	7	80	0.0875000
NODE_73196_length_408_cov_8.585761	110	190	6	12	80	0.1500000
NODE_73198_length_408_cov_6.948220	71	151	0	80	80	1.0000000
NODE_73198_length_408_cov_6.948220	124	204	0	67	80	0.8375000
NODE_73198_length_408_cov_6.948220	124	204	4	13	80	0.1625000
NODE_73219_length_408_cov_3.957929	83	132	2	35	49	0.7142857
NODE_73219_length_408_cov_3.957929	83	132	6	14	49	0.2857143
NODE_73226_length_408_cov_3.511327	40	97	2	57	57	1.0000000
NODE_73226_length_408_cov_3.511327	357	398	0	41	41	1.0000000
NODE_73262_length_408_cov_2.724919	128	180	6	5	52	0.0961538
NODE_73262_length_408_cov_2.724919	128	180	7	47	52	0.9038461
NODE_73269_length_408_cov_2.563107	164	241	0	7	77	0.0909091
NODE_73269_length_408_cov_2.563107	164	241	2	4	77	0.0519481
NODE_73269_length_408_cov_2.563107	164	241	4	15	77	0.1948052
NODE_73269_length_408_cov_2.563107	164	241	6	7	77	0.0909091
NODE_73269_length_408_cov_2.563107	164	241	9	3	77	0.0389610
NODE_73269_length_408_cov_2.563107	164	241	10	35	77	0.4545455
NODE_73269_length_408_cov_2.563107	164	241	11	2	77	0.0259740
NODE_73269_length_408_cov_2.563107	164	241	17	1	77	0.0129870
NODE_73269_length_408_cov_2.563107	164	241	19	1	77	0.0129870
NODE_73269_length_408_cov_2.563107	164	241	21	2	77	0.0259740
NODE_73271_length_408_cov_2.456311	314	379	0	65	65	1.0000000
NODE_73271_length_408_cov_2.456311	352	408	0	56	56	1.0000000
NODE_73690_length_407_cov_6.191558	144	208	2	13	64	0.2031250
NODE_73690_length_407_cov_6.191558	144	208	3	3	64	0.0468750
NODE_73690_length_407_cov_6.191558	144	208	4	7	64	0.1093750
NODE_73690_length_407_cov_6.191558	144	208	5	5	64	0.0781250
NODE_73690_length_407_cov_6.191558	144	208	6	36	64	0.5625000
NODE_73698_length_407_cov_4.961039	212	291	1	9	79	0.1139240
NODE_73698_length_407_cov_4.961039	212	291	3	13	79	0.1645570
NODE_73698_length_407_cov_4.961039	212	291	4	44	79	0.5569620
NODE_73698_length_407_cov_4.961039	212	291	5	13	79	0.1645570
NODE_73719_length_407_cov_3.681818	314	375	0	61	61	1.0000000
NODE_73732_length_407_cov_3.344156	199	247	0	48	48	1.0000000
NODE_73736_length_407_cov_3.250000	142	223	0	8	81	0.0987654
NODE_73736_length_407_cov_3.250000	142	223	2	12	81	0.1481481
NODE_73736_length_407_cov_3.250000	142	223	4	2	81	0.0246914
NODE_73736_length_407_cov_3.250000	142	223	6	9	81	0.1111111
NODE_73736_length_407_cov_3.250000	142	223	10	50	81	0.6172839
NODE_73762_length_407_cov_2.594156	194	257	0	63	63	1.0000000
NODE_73769_length_407_cov_2.538961	34	114	0	1	80	0.0125000
NODE_73769_length_407_cov_2.538961	34	114	2	13	80	0.1625000
NODE_73769_length_407_cov_2.538961	34	114	6	27	80	0.3375000
NODE_73769_length_407_cov_2.538961	34	114	8	30	80	0.3750000
NODE_73769_length_407_cov_2.538961	34	114	12	9	80	0.1125000
NODE_73853_length_407_cov_1.737013	208	264	0	56	56	1.0000000
NODE_74200_length_406_cov_176.856678	200	271	122	1	71	0.0140845
NODE_74200_length_406_cov_176.856678	200	271	125	4	71	0.0563380
NODE_74200_length_406_cov_176.856678	200	271	128	1	71	0.0140845
NODE_74200_length_406_cov_176.856678	200	271	129	1	71	0.0140845
NODE_74200_length_406_cov_176.856678	200	271	132	1	71	0.0140845
NODE_74200_length_406_cov_176.856678	200	271	134	1	71	0.0140845
NODE_74200_length_406_cov_176.856678	200	271	136	1	71	0.0140845
NODE_74200_length_406_cov_176.856678	200	271	140	5	71	0.0704225
NODE_74200_length_406_cov_176.856678	200	271	141	5	71	0.0704225
NODE_74200_length_406_cov_176.856678	200	271	143	1	71	0.0140845
NODE_74200_length_406_cov_176.856678	200	271	147	2	71	0.0281690
NODE_74200_length_406_cov_176.856678	200	271	149	1	71	0.0140845
NODE_74200_length_406_cov_176.856678	200	271	151	2	71	0.0281690
NODE_74200_length_406_cov_176.856678	200	271	153	1	71	0.0140845
NODE_74200_length_406_cov_176.856678	200	271	155	1	71	0.0140845
NODE_74200_length_406_cov_176.856678	200	271	167	1	71	0.0140845
NODE_74200_length_406_cov_176.856678	200	271	168	1	71	0.0140845
NODE_74200_length_406_cov_176.856678	200	271	169	2	71	0.0281690
NODE_74200_length_406_cov_176.856678	200	271	170	1	71	0.0140845
NODE_74200_length_406_cov_176.856678	200	271	171	1	71	0.0140845
NODE_74200_length_406_cov_176.856678	200	271	172	1	71	0.0140845
NODE_74200_length_406_cov_176.856678	200	271	174	3	71	0.0422535
NODE_74200_length_406_cov_176.856678	200	271	178	1	71	0.0140845
NODE_74200_length_406_cov_176.856678	200	271	179	2	71	0.0281690
NODE_74200_length_406_cov_176.856678	200	271	180	2	71	0.0281690
NODE_74200_length_406_cov_176.856678	200	271	181	3	71	0.0422535
NODE_74200_length_406_cov_176.856678	200	271	182	1	71	0.0140845
NODE_74200_length_406_cov_176.856678	200	271	183	2	71	0.0281690
NODE_74200_length_406_cov_176.856678	200	271	184	2	71	0.0281690
NODE_74200_length_406_cov_176.856678	200	271	185	1	71	0.0140845
NODE_74200_length_406_cov_176.856678	200	271	186	1	71	0.0140845
NODE_74200_length_406_cov_176.856678	200	271	187	1	71	0.0140845
NODE_74200_length_406_cov_176.856678	200	271	188	3	71	0.0422535
NODE_74200_length_406_cov_176.856678	200	271	189	3	71	0.0422535
NODE_74200_length_406_cov_176.856678	200	271	190	2	71	0.0281690
NODE_74200_length_406_cov_176.856678	200	271	191	3	71	0.0422535
NODE_74200_length_406_cov_176.856678	200	271	193	1	71	0.0140845
NODE_74200_length_406_cov_176.856678	200	271	194	3	71	0.0422535
NODE_74200_length_406_cov_176.856678	200	271	196	2	71	0.0281690
NODE_74200_length_406_cov_176.856678	244	321	162	3	77	0.0389610
NODE_74200_length_406_cov_176.856678	244	321	163	1	77	0.0129870
NODE_74200_length_406_cov_176.856678	244	321	164	4	77	0.0519481
NODE_74200_length_406_cov_176.856678	244	321	168	3	77	0.0389610
NODE_74200_length_406_cov_176.856678	244	321	169	1	77	0.0129870
NODE_74200_length_406_cov_176.856678	244	321	172	1	77	0.0129870
NODE_74200_length_406_cov_176.856678	244	321	178	3	77	0.0389610
NODE_74200_length_406_cov_176.856678	244	321	179	3	77	0.0389610
NODE_74200_length_406_cov_176.856678	244	321	180	2	77	0.0259740
NODE_74200_length_406_cov_176.856678	244	321	181	3	77	0.0389610
NODE_74200_length_406_cov_176.856678	244	321	183	3	77	0.0389610
NODE_74200_length_406_cov_176.856678	244	321	184	1	77	0.0129870
NODE_74200_length_406_cov_176.856678	244	321	185	1	77	0.0129870
NODE_74200_length_406_cov_176.856678	244	321	186	2	77	0.0259740
NODE_74200_length_406_cov_176.856678	244	321	187	1	77	0.0129870
NODE_74200_length_406_cov_176.856678	244	321	188	2	77	0.0259740
NODE_74200_length_406_cov_176.856678	244	321	189	2	77	0.0259740
NODE_74200_length_406_cov_176.856678	244	321	190	4	77	0.0519481
NODE_74200_length_406_cov_176.856678	244	321	191	7	77	0.0909091
NODE_74200_length_406_cov_176.856678	244	321	194	2	77	0.0259740
NODE_74200_length_406_cov_176.856678	244	321	195	6	77	0.0779221
NODE_74200_length_406_cov_176.856678	244	321	196	7	77	0.0909091
NODE_74200_length_406_cov_176.856678	244	321	198	2	77	0.0259740
NODE_74200_length_406_cov_176.856678	244	321	199	2	77	0.0259740
NODE_74200_length_406_cov_176.856678	244	321	200	1	77	0.0129870
NODE_74200_length_406_cov_176.856678	244	321	201	4	77	0.0519481
NODE_74200_length_406_cov_176.856678	244	321	202	2	77	0.0259740
NODE_74200_length_406_cov_176.856678	244	321	203	1	77	0.0129870
NODE_74200_length_406_cov_176.856678	244	321	204	3	77	0.0389610
NODE_74203_length_406_cov_37.723127	15	95	0	77	80	0.9625000
NODE_74203_length_406_cov_37.723127	15	95	13	1	80	0.0125000
NODE_74203_length_406_cov_37.723127	15	95	23	1	80	0.0125000
NODE_74203_length_406_cov_37.723127	15	95	36	1	80	0.0125000
NODE_74219_length_406_cov_4.960912	268	327	0	59	59	1.0000000
NODE_74253_length_406_cov_3.087948	261	302	2	21	41	0.5121951
NODE_74253_length_406_cov_3.087948	261	302	4	20	41	0.4878049
NODE_74284_length_406_cov_2.475570	220	270	0	30	50	0.6000000
NODE_74284_length_406_cov_2.475570	220	270	2	20	50	0.4000000
NODE_74332_length_406_cov_1.986971	238	276	0	38	38	1.0000000
NODE_74368_length_406_cov_1.778502	159	195	2	36	36	1.0000000
NODE_74368_length_406_cov_1.778502	234	294	6	7	60	0.1166667
NODE_74368_length_406_cov_1.778502	234	294	10	2	60	0.0333333
NODE_74368_length_406_cov_1.778502	234	294	12	1	60	0.0166667
NODE_74368_length_406_cov_1.778502	234	294	13	1	60	0.0166667
NODE_74368_length_406_cov_1.778502	234	294	14	7	60	0.1166667
NODE_74368_length_406_cov_1.778502	234	294	16	29	60	0.4833333
NODE_74368_length_406_cov_1.778502	234	294	18	13	60	0.2166667
NODE_74368_length_406_cov_1.778502	267	347	2	10	80	0.1250000
NODE_74368_length_406_cov_1.778502	267	347	4	5	80	0.0625000
NODE_74368_length_406_cov_1.778502	267	347	6	13	80	0.1625000
NODE_74368_length_406_cov_1.778502	267	347	10	3	80	0.0375000
NODE_74368_length_406_cov_1.778502	267	347	12	1	80	0.0125000
NODE_74368_length_406_cov_1.778502	267	347	14	1	80	0.0125000
NODE_74368_length_406_cov_1.778502	267	347	16	39	80	0.4875000
NODE_74368_length_406_cov_1.778502	267	347	18	8	80	0.1000000
NODE_74427_length_406_cov_1.495114	173	212	0	39	39	1.0000000
NODE_74476_length_406_cov_1.325733	367	398	0	31	31	1.0000000
NODE_74588_length_406_cov_0.934853	1	32	0	31	31	1.0000000
NODE_74588_length_406_cov_0.934853	5	85	0	47	80	0.5875000
NODE_74588_length_406_cov_0.934853	5	85	4	33	80	0.4125000
NODE_74696_length_405_cov_5.107843	332	380	0	48	48	1.0000000
NODE_74697_length_405_cov_4.915033	15	46	2	10	31	0.3225806
NODE_74697_length_405_cov_4.915033	15	46	4	21	31	0.6774194
NODE_74727_length_405_cov_3.346405	195	240	2	45	45	1.0000000
NODE_74727_length_405_cov_3.346405	274	329	0	15	55	0.2727273
NODE_74727_length_405_cov_3.346405	274	329	2	40	55	0.7272727
NODE_74737_length_405_cov_3.124183	210	260	0	31	50	0.6200000
NODE_74737_length_405_cov_3.124183	210	260	3	19	50	0.3800000
NODE_74737_length_405_cov_3.124183	240	286	0	46	46	1.0000000
NODE_74737_length_405_cov_3.124183	260	339	0	79	79	1.0000000
NODE_74737_length_405_cov_3.124183	272	339	0	67	67	1.0000000
NODE_74780_length_405_cov_2.503268	352	399	0	43	47	0.9148936
NODE_74780_length_405_cov_2.503268	352	399	2	4	47	0.0851064
NODE_74787_length_405_cov_2.460784	0	73	0	9	73	0.1232877
NODE_74787_length_405_cov_2.460784	0	73	2	14	73	0.1917808
NODE_74787_length_405_cov_2.460784	0	73	4	50	73	0.6849315
NODE_75145_length_405_cov_0.666667	207	268	0	61	61	1.0000000
NODE_75196_length_404_cov_40.937705	40	120	0	80	80	1.0000000
NODE_75196_length_404_cov_40.937705	93	173	0	80	80	1.0000000
NODE_75197_length_404_cov_32.940984	46	126	0	34	80	0.4250000
NODE_75197_length_404_cov_32.940984	46	126	2	46	80	0.5750000
NODE_75197_length_404_cov_32.940984	99	179	0	18	80	0.2250000
NODE_75197_length_404_cov_32.940984	99	179	2	62	80	0.7750000
NODE_75197_length_404_cov_32.940984	175	255	2	80	80	1.0000000
NODE_75197_length_404_cov_32.940984	228	308	0	39	80	0.4875000
NODE_75197_length_404_cov_32.940984	228	308	2	41	80	0.5125000
NODE_75198_length_404_cov_11.731148	130	210	0	80	80	1.0000000
NODE_75198_length_404_cov_11.731148	183	263	0	80	80	1.0000000
NODE_75200_length_404_cov_9.170492	201	257	0	56	56	1.0000000
NODE_75236_length_404_cov_3.613115	323	385	0	62	62	1.0000000
NODE_75259_length_404_cov_2.914754	181	261	3	4	80	0.0500000
NODE_75259_length_404_cov_2.914754	181	261	4	14	80	0.1750000
NODE_75259_length_404_cov_2.914754	181	261	5	28	80	0.3500000
NODE_75259_length_404_cov_2.914754	181	261	6	34	80	0.4250000
NODE_75345_length_404_cov_2.085246	245	325	0	80	80	1.0000000
NODE_75357_length_404_cov_1.993443	95	148	0	53	53	1.0000000
NODE_75399_length_404_cov_1.672131	32	106	0	74	74	1.0000000
NODE_75440_length_404_cov_1.498361	94	174	3	8	80	0.1000000
NODE_75440_length_404_cov_1.498361	94	174	4	1	80	0.0125000
NODE_75440_length_404_cov_1.498361	94	174	8	13	80	0.1625000
NODE_75440_length_404_cov_1.498361	94	174	10	58	80	0.7250000
NODE_75446_length_404_cov_1.485246	234	282	2	6	48	0.1250000
NODE_75446_length_404_cov_1.485246	234	282	4	42	48	0.8750000
NODE_75545_length_404_cov_1.121311	114	194	6	2	80	0.0250000
NODE_75545_length_404_cov_1.121311	114	194	7	1	80	0.0125000
NODE_75545_length_404_cov_1.121311	114	194	8	1	80	0.0125000
NODE_75545_length_404_cov_1.121311	114	194	10	1	80	0.0125000
NODE_75545_length_404_cov_1.121311	114	194	12	33	80	0.4125000
NODE_75545_length_404_cov_1.121311	114	194	14	19	80	0.2375000
NODE_75545_length_404_cov_1.121311	114	194	15	1	80	0.0125000
NODE_75545_length_404_cov_1.121311	114	194	16	22	80	0.2750000
NODE_75750_length_403_cov_7.325658	80	146	0	66	66	1.0000000
NODE_75750_length_403_cov_7.325658	165	234	0	69	69	1.0000000
NODE_75750_length_403_cov_7.325658	215	255	0	40	40	1.0000000
NODE_75751_length_403_cov_7.217105	207	284	0	77	77	1.0000000
NODE_75751_length_403_cov_7.217105	257	334	0	77	77	1.0000000
NODE_75752_length_403_cov_6.776316	192	250	7	14	58	0.2413793
NODE_75752_length_403_cov_6.776316	192	250	9	37	58	0.6379310
NODE_75752_length_403_cov_6.776316	192	250	11	1	58	0.0172414
NODE_75752_length_403_cov_6.776316	192	250	12	3	58	0.0517241
NODE_75752_length_403_cov_6.776316	192	250	13	3	58	0.0517241
NODE_75788_length_403_cov_3.710526	327	373	0	46	46	1.0000000
NODE_75788_length_403_cov_3.710526	346	403	0	57	57	1.0000000
NODE_75793_length_403_cov_3.611842	283	363	18	20	80	0.2500000
NODE_75793_length_403_cov_3.611842	283	363	20	16	80	0.2000000
NODE_75793_length_403_cov_3.611842	283	363	22	7	80	0.0875000
NODE_75793_length_403_cov_3.611842	283	363	24	32	80	0.4000000
NODE_75793_length_403_cov_3.611842	283	363	26	5	80	0.0625000
NODE_75824_length_403_cov_2.822368	201	282	8	41	81	0.5061728
NODE_75824_length_403_cov_2.822368	201	282	10	12	81	0.1481481
NODE_75824_length_403_cov_2.822368	201	282	12	11	81	0.1358025
NODE_75824_length_403_cov_2.822368	201	282	13	6	81	0.0740741
NODE_75824_length_403_cov_2.822368	201	282	14	11	81	0.1358025
NODE_75871_length_403_cov_2.082237	102	145	0	14	43	0.3255814
NODE_75871_length_403_cov_2.082237	102	145	2	29	43	0.6744186
NODE_75908_length_403_cov_1.871711	130	166	0	36	36	1.0000000
NODE_75993_length_403_cov_1.398026	79	116	0	37	37	1.0000000
NODE_76029_length_403_cov_1.269737	82	111	0	29	29	1.0000000
NODE_76239_length_402_cov_6.293729	217	297	0	80	80	1.0000000
NODE_76239_length_402_cov_6.293729	270	350	0	80	80	1.0000000
NODE_76246_length_402_cov_5.227723	176	236	14	10	60	0.1666667
NODE_76246_length_402_cov_5.227723	176	236	16	45	60	0.7500000
NODE_76246_length_402_cov_5.227723	176	236	18	5	60	0.0833333
NODE_76261_length_402_cov_4.356436	44	123	0	77	79	0.9746835
NODE_76261_length_402_cov_4.356436	44	123	2	2	79	0.0253165
NODE_76261_length_402_cov_4.356436	119	199	0	2	80	0.0250000
NODE_76261_length_402_cov_4.356436	119	199	2	18	80	0.2250000
NODE_76261_length_402_cov_4.356436	119	199	4	60	80	0.7500000
NODE_76261_length_402_cov_4.356436	172	252	4	34	80	0.4250000
NODE_76261_length_402_cov_4.356436	172	252	6	14	80	0.1750000
NODE_76261_length_402_cov_4.356436	172	252	8	32	80	0.4000000
NODE_76276_length_402_cov_3.564356	197	257	0	60	60	1.0000000
NODE_76276_length_402_cov_3.564356	230	310	0	80	80	1.0000000
NODE_76328_length_402_cov_2.633663	335	402	0	67	67	1.0000000
NODE_76336_length_402_cov_2.514851	82	162	8	27	80	0.3375000
NODE_76336_length_402_cov_2.514851	82	162	10	17	80	0.2125000
NODE_76336_length_402_cov_2.514851	82	162	11	5	80	0.0625000
NODE_76336_length_402_cov_2.514851	82	162	12	31	80	0.3875000
NODE_76336_length_402_cov_2.514851	135	200	0	11	65	0.1692308
NODE_76336_length_402_cov_2.514851	135	200	2	11	65	0.1692308
NODE_76336_length_402_cov_2.514851	135	200	3	14	65	0.2153846
NODE_76336_length_402_cov_2.514851	135	200	4	1	65	0.0153846
NODE_76336_length_402_cov_2.514851	135	200	8	28	65	0.4307692
NODE_76380_length_402_cov_2.102310	114	165	6	51	51	1.0000000
NODE_76380_length_402_cov_2.102310	138	195	0	25	57	0.4385965
NODE_76380_length_402_cov_2.102310	138	195	3	2	57	0.0350877
NODE_76380_length_402_cov_2.102310	138	195	6	30	57	0.5263158
NODE_76560_length_402_cov_1.214521	0	33	0	33	33	1.0000000
NODE_76646_length_402_cov_1.000000	119	188	0	69	69	1.0000000
NODE_76752_length_402_cov_0.663366	0	46	0	46	46	1.0000000
NODE_76780_length_401_cov_43.675497	285	343	14	11	58	0.1896552
NODE_76780_length_401_cov_43.675497	285	343	16	47	58	0.8103448
NODE_76801_length_401_cov_4.377483	309	389	0	80	80	1.0000000
NODE_76804_length_401_cov_4.241722	125	180	0	46	55	0.8363636
NODE_76804_length_401_cov_4.241722	125	180	2	9	55	0.1636364
NODE_76808_length_401_cov_4.132450	195	275	1	1	80	0.0125000
NODE_76808_length_401_cov_4.132450	195	275	3	14	80	0.1750000
NODE_76808_length_401_cov_4.132450	195	275	4	18	80	0.2250000
NODE_76808_length_401_cov_4.132450	195	275	7	1	80	0.0125000
NODE_76808_length_401_cov_4.132450	195	275	8	46	80	0.5750000
NODE_76811_length_401_cov_3.973510	138	181	0	43	43	1.0000000
NODE_76828_length_401_cov_3.370861	141	221	0	45	80	0.5625000
NODE_76828_length_401_cov_3.370861	141	221	2	35	80	0.4375000
NODE_76828_length_401_cov_3.370861	194	273	0	79	79	1.0000000
NODE_76830_length_401_cov_3.317881	67	147	0	42	80	0.5250000
NODE_76830_length_401_cov_3.317881	67	147	2	11	80	0.1375000
NODE_76830_length_401_cov_3.317881	67	147	4	27	80	0.3375000
NODE_76918_length_401_cov_1.937086	160	239	0	5	79	0.0632911
NODE_76918_length_401_cov_1.937086	160	239	1	9	79	0.1139240
NODE_76918_length_401_cov_1.937086	160	239	2	3	79	0.0379747
NODE_76918_length_401_cov_1.937086	160	239	4	37	79	0.4683544
NODE_76918_length_401_cov_1.937086	160	239	6	25	79	0.3164557
NODE_76978_length_401_cov_1.615894	205	269	18	3	64	0.0468750
NODE_76978_length_401_cov_1.615894	205	269	19	4	64	0.0625000
NODE_76978_length_401_cov_1.615894	205	269	21	2	64	0.0312500
NODE_76978_length_401_cov_1.615894	205	269	23	3	64	0.0468750
NODE_76978_length_401_cov_1.615894	205	269	35	1	64	0.0156250
NODE_76978_length_401_cov_1.615894	205	269	37	1	64	0.0156250
NODE_76978_length_401_cov_1.615894	205	269	41	1	64	0.0156250
NODE_76978_length_401_cov_1.615894	205	269	43	1	64	0.0156250
NODE_76978_length_401_cov_1.615894	205	269	49	1	64	0.0156250
NODE_76978_length_401_cov_1.615894	205	269	51	1	64	0.0156250
NODE_76978_length_401_cov_1.615894	205	269	57	1	64	0.0156250
NODE_76978_length_401_cov_1.615894	205	269	59	1	64	0.0156250
NODE_76978_length_401_cov_1.615894	205	269	61	1	64	0.0156250
NODE_76978_length_401_cov_1.615894	205	269	63	1	64	0.0156250
NODE_76978_length_401_cov_1.615894	205	269	68	1	64	0.0156250
NODE_76978_length_401_cov_1.615894	205	269	69	1	64	0.0156250
NODE_76978_length_401_cov_1.615894	205	269	72	1	64	0.0156250
NODE_76978_length_401_cov_1.615894	205	269	77	1	64	0.0156250
NODE_76978_length_401_cov_1.615894	205	269	81	1	64	0.0156250
NODE_76978_length_401_cov_1.615894	205	269	82	1	64	0.0156250
NODE_76978_length_401_cov_1.615894	205	269	84	1	64	0.0156250
NODE_76978_length_401_cov_1.615894	205	269	86	1	64	0.0156250
NODE_76978_length_401_cov_1.615894	205	269	91	1	64	0.0156250
NODE_76978_length_401_cov_1.615894	205	269	93	1	64	0.0156250
NODE_76978_length_401_cov_1.615894	205	269	101	1	64	0.0156250
NODE_76978_length_401_cov_1.615894	205	269	105	1	64	0.0156250
NODE_76978_length_401_cov_1.615894	205	269	108	1	64	0.0156250
NODE_76978_length_401_cov_1.615894	205	269	109	1	64	0.0156250
NODE_76978_length_401_cov_1.615894	205	269	120	1	64	0.0156250
NODE_76978_length_401_cov_1.615894	205	269	122	2	64	0.0312500
NODE_76978_length_401_cov_1.615894	205	269	124	1	64	0.0156250
NODE_76978_length_401_cov_1.615894	205	269	126	2	64	0.0312500
NODE_76978_length_401_cov_1.615894	205	269	129	1	64	0.0156250
NODE_76978_length_401_cov_1.615894	205	269	130	4	64	0.0625000
NODE_76978_length_401_cov_1.615894	205	269	131	2	64	0.0312500
NODE_76978_length_401_cov_1.615894	205	269	132	1	64	0.0156250
NODE_76978_length_401_cov_1.615894	205	269	136	2	64	0.0312500
NODE_76978_length_401_cov_1.615894	205	269	140	1	64	0.0156250
NODE_76978_length_401_cov_1.615894	205	269	145	1	64	0.0156250
NODE_76978_length_401_cov_1.615894	205	269	148	1	64	0.0156250
NODE_76978_length_401_cov_1.615894	205	269	152	1	64	0.0156250
NODE_76978_length_401_cov_1.615894	205	269	156	1	64	0.0156250
NODE_76978_length_401_cov_1.615894	205	269	158	1	64	0.0156250
NODE_76978_length_401_cov_1.615894	205	269	160	1	64	0.0156250
NODE_76978_length_401_cov_1.615894	205	269	162	2	64	0.0312500
NODE_76978_length_401_cov_1.615894	205	269	164	1	64	0.0156250
NODE_76978_length_401_cov_1.615894	205	269	166	2	64	0.0312500
NODE_77017_length_401_cov_1.407285	23	92	0	69	69	1.0000000
NODE_77017_length_401_cov_1.407285	76	122	0	46	46	1.0000000
NODE_77236_length_401_cov_0.675497	292	372	0	80	80	1.0000000
NODE_77236_length_401_cov_0.675497	345	401	0	56	56	1.0000000
NODE_77284_length_400_cov_40.584718	205	281	0	63	76	0.8289474
NODE_77284_length_400_cov_40.584718	205	281	2	13	76	0.1710526
NODE_77284_length_400_cov_40.584718	254	334	0	80	80	1.0000000
NODE_77289_length_400_cov_8.631229	307	372	2	1	65	0.0153846
NODE_77289_length_400_cov_8.631229	307	372	4	64	65	0.9846154
NODE_77292_length_400_cov_6.850498	281	329	0	48	48	1.0000000
NODE_77322_length_400_cov_4.000000	82	140	0	21	58	0.3620690
NODE_77322_length_400_cov_4.000000	82	140	1	1	58	0.0172414
NODE_77322_length_400_cov_4.000000	82	140	2	36	58	0.6206896
NODE_77358_length_400_cov_3.029900	204	284	0	80	80	1.0000000
NODE_77358_length_400_cov_3.029900	205	231	0	26	26	1.0000000
NODE_77362_length_400_cov_3.009967	146	220	6	12	74	0.1621622
NODE_77362_length_400_cov_3.009967	146	220	8	16	74	0.2162162
NODE_77362_length_400_cov_3.009967	146	220	10	11	74	0.1486486
NODE_77362_length_400_cov_3.009967	146	220	12	10	74	0.1351351
NODE_77362_length_400_cov_3.009967	146	220	14	25	74	0.3378378
NODE_77362_length_400_cov_3.009967	195	261	10	18	66	0.2727273
NODE_77362_length_400_cov_3.009967	195	261	12	7	66	0.1060606
NODE_77362_length_400_cov_3.009967	195	261	14	41	66	0.6212121
NODE_77363_length_400_cov_2.990033	253	332	103	1	79	0.0126582
NODE_77363_length_400_cov_2.990033	253	332	106	1	79	0.0126582
NODE_77363_length_400_cov_2.990033	253	332	108	1	79	0.0126582
NODE_77363_length_400_cov_2.990033	253	332	109	2	79	0.0253165
NODE_77363_length_400_cov_2.990033	253	332	110	2	79	0.0253165
NODE_77363_length_400_cov_2.990033	253	332	114	1	79	0.0126582
NODE_77363_length_400_cov_2.990033	253	332	116	4	79	0.0506329
NODE_77363_length_400_cov_2.990033	253	332	121	1	79	0.0126582
NODE_77363_length_400_cov_2.990033	253	332	122	6	79	0.0759494
NODE_77363_length_400_cov_2.990033	253	332	124	1	79	0.0126582
NODE_77363_length_400_cov_2.990033	253	332	126	13	79	0.1645570
NODE_77363_length_400_cov_2.990033	253	332	128	1	79	0.0126582
NODE_77363_length_400_cov_2.990033	253	332	130	2	79	0.0253165
NODE_77363_length_400_cov_2.990033	253	332	132	1	79	0.0126582
NODE_77363_length_400_cov_2.990033	253	332	136	1	79	0.0126582
NODE_77363_length_400_cov_2.990033	253	332	143	3	79	0.0379747
NODE_77363_length_400_cov_2.990033	253	332	145	2	79	0.0253165
NODE_77363_length_400_cov_2.990033	253	332	146	1	79	0.0126582
NODE_77363_length_400_cov_2.990033	253	332	147	1	79	0.0126582
NODE_77363_length_400_cov_2.990033	253	332	149	3	79	0.0379747
NODE_77363_length_400_cov_2.990033	253	332	151	1	79	0.0126582
NODE_77363_length_400_cov_2.990033	253	332	152	1	79	0.0126582
NODE_77363_length_400_cov_2.990033	253	332	153	1	79	0.0126582
NODE_77363_length_400_cov_2.990033	253	332	155	2	79	0.0253165
NODE_77363_length_400_cov_2.990033	253	332	157	1	79	0.0126582
NODE_77363_length_400_cov_2.990033	253	332	161	1	79	0.0126582
NODE_77363_length_400_cov_2.990033	253	332	163	5	79	0.0632911
NODE_77363_length_400_cov_2.990033	253	332	164	2	79	0.0253165
NODE_77363_length_400_cov_2.990033	253	332	165	4	79	0.0506329
NODE_77363_length_400_cov_2.990033	253	332	166	2	79	0.0253165
NODE_77363_length_400_cov_2.990033	253	332	167	1	79	0.0126582
NODE_77363_length_400_cov_2.990033	253	332	169	2	79	0.0253165
NODE_77363_length_400_cov_2.990033	253	332	170	2	79	0.0253165
NODE_77363_length_400_cov_2.990033	253	332	171	1	79	0.0126582
NODE_77363_length_400_cov_2.990033	253	332	172	1	79	0.0126582
NODE_77363_length_400_cov_2.990033	253	332	173	1	79	0.0126582
NODE_77363_length_400_cov_2.990033	253	332	175	3	79	0.0379747
NODE_77363_length_400_cov_2.990033	306	385	115	1	79	0.0126582
NODE_77363_length_400_cov_2.990033	306	385	117	1	79	0.0126582
NODE_77363_length_400_cov_2.990033	306	385	119	10	79	0.1265823
NODE_77363_length_400_cov_2.990033	306	385	121	5	79	0.0632911
NODE_77363_length_400_cov_2.990033	306	385	126	5	79	0.0632911
NODE_77363_length_400_cov_2.990033	306	385	128	2	79	0.0253165
NODE_77363_length_400_cov_2.990033	306	385	130	1	79	0.0126582
NODE_77363_length_400_cov_2.990033	306	385	136	1	79	0.0126582
NODE_77363_length_400_cov_2.990033	306	385	137	2	79	0.0253165
NODE_77363_length_400_cov_2.990033	306	385	138	4	79	0.0506329
NODE_77363_length_400_cov_2.990033	306	385	139	5	79	0.0632911
NODE_77363_length_400_cov_2.990033	306	385	141	1	79	0.0126582
NODE_77363_length_400_cov_2.990033	306	385	143	1	79	0.0126582
NODE_77363_length_400_cov_2.990033	306	385	145	1	79	0.0126582
NODE_77363_length_400_cov_2.990033	306	385	146	1	79	0.0126582
NODE_77363_length_400_cov_2.990033	306	385	156	5	79	0.0632911
NODE_77363_length_400_cov_2.990033	306	385	157	1	79	0.0126582
NODE_77363_length_400_cov_2.990033	306	385	159	2	79	0.0253165
NODE_77363_length_400_cov_2.990033	306	385	160	1	79	0.0126582
NODE_77363_length_400_cov_2.990033	306	385	161	2	79	0.0253165
NODE_77363_length_400_cov_2.990033	306	385	162	1	79	0.0126582
NODE_77363_length_400_cov_2.990033	306	385	163	5	79	0.0632911
NODE_77363_length_400_cov_2.990033	306	385	164	3	79	0.0379747
NODE_77363_length_400_cov_2.990033	306	385	165	4	79	0.0506329
NODE_77363_length_400_cov_2.990033	306	385	166	3	79	0.0379747
NODE_77363_length_400_cov_2.990033	306	385	167	1	79	0.0126582
NODE_77363_length_400_cov_2.990033	306	385	169	2	79	0.0253165
NODE_77363_length_400_cov_2.990033	306	385	170	2	79	0.0253165
NODE_77363_length_400_cov_2.990033	306	385	171	1	79	0.0126582
NODE_77363_length_400_cov_2.990033	306	385	172	1	79	0.0126582
NODE_77363_length_400_cov_2.990033	306	385	173	1	79	0.0126582
NODE_77363_length_400_cov_2.990033	306	385	175	3	79	0.0379747
NODE_77368_length_400_cov_2.860465	365	400	0	35	35	1.0000000
NODE_77371_length_400_cov_2.797342	324	372	0	48	48	1.0000000
NODE_77380_length_400_cov_2.581395	192	254	0	8	62	0.1290323
NODE_77380_length_400_cov_2.581395	192	254	3	1	62	0.0161290
NODE_77380_length_400_cov_2.581395	192	254	4	3	62	0.0483871
NODE_77380_length_400_cov_2.581395	192	254	6	30	62	0.4838710
NODE_77380_length_400_cov_2.581395	192	254	10	3	62	0.0483871
NODE_77380_length_400_cov_2.581395	192	254	12	17	62	0.2741936
NODE_77460_length_400_cov_1.940199	225	268	0	3	43	0.0697674
NODE_77460_length_400_cov_1.940199	225	268	2	40	43	0.9302326
NODE_77460_length_400_cov_1.940199	293	374	0	66	81	0.8148148
NODE_77460_length_400_cov_1.940199	293	374	2	15	81	0.1851852
NODE_77821_length_399_cov_71.493333	215	295	0	80	80	1.0000000
NODE_77821_length_399_cov_71.493333	268	348	0	80	80	1.0000000
NODE_77823_length_399_cov_7.510000	229	309	0	80	80	1.0000000
NODE_77823_length_399_cov_7.510000	282	362	0	80	80	1.0000000
NODE_77825_length_399_cov_7.310000	125	187	0	62	62	1.0000000
NODE_77854_length_399_cov_4.293333	86	164	2	45	78	0.5769231
NODE_77854_length_399_cov_4.293333	86	164	4	33	78	0.4230769
NODE_77877_length_399_cov_3.406667	51	124	0	73	73	1.0000000
NODE_77933_length_399_cov_2.286667	310	390	16	80	80	1.0000000
NODE_77966_length_399_cov_1.916667	76	136	0	19	60	0.3166667
NODE_77966_length_399_cov_1.916667	76	136	2	11	60	0.1833333
NODE_77966_length_399_cov_1.916667	76	136	4	14	60	0.2333333
NODE_77966_length_399_cov_1.916667	76	136	6	16	60	0.2666667
NODE_77966_length_399_cov_1.916667	123	189	6	19	66	0.2878788
NODE_77966_length_399_cov_1.916667	123	189	8	47	66	0.7121212
NODE_78276_length_399_cov_0.710000	313	392	0	67	79	0.8481013
NODE_78276_length_399_cov_0.710000	313	392	2	12	79	0.1518987
NODE_78354_length_398_cov_9.688963	1	81	0	9	80	0.1125000
NODE_78354_length_398_cov_9.688963	1	81	2	71	80	0.8875000
NODE_78354_length_398_cov_9.688963	247	327	0	80	80	1.0000000
NODE_78354_length_398_cov_9.688963	300	380	0	80	80	1.0000000
NODE_78360_length_398_cov_6.488294	130	210	0	80	80	1.0000000
NODE_78364_length_398_cov_5.765886	253	333	1	4	80	0.0500000
NODE_78364_length_398_cov_5.765886	253	333	2	28	80	0.3500000
NODE_78364_length_398_cov_5.765886	253	333	4	48	80	0.6000000
NODE_78372_length_398_cov_5.244147	248	312	2	9	64	0.1406250
NODE_78372_length_398_cov_5.244147	248	312	6	1	64	0.0156250
NODE_78372_length_398_cov_5.244147	248	312	7	1	64	0.0156250
NODE_78372_length_398_cov_5.244147	248	312	17	5	64	0.0781250
NODE_78372_length_398_cov_5.244147	248	312	18	3	64	0.0468750
NODE_78372_length_398_cov_5.244147	248	312	20	8	64	0.1250000
NODE_78372_length_398_cov_5.244147	248	312	21	11	64	0.1718750
NODE_78372_length_398_cov_5.244147	248	312	23	26	64	0.4062500
NODE_78376_length_398_cov_5.006689	116	196	0	80	80	1.0000000
NODE_78376_length_398_cov_5.006689	169	251	0	82	82	1.0000000
NODE_78383_length_398_cov_4.284281	63	117	0	54	54	1.0000000
NODE_78383_length_398_cov_4.284281	135	160	0	25	25	1.0000000
NODE_78420_length_398_cov_2.993311	229	309	2	2	80	0.0250000
NODE_78420_length_398_cov_2.993311	229	309	4	3	80	0.0375000
NODE_78420_length_398_cov_2.993311	229	309	5	11	80	0.1375000
NODE_78420_length_398_cov_2.993311	229	309	7	5	80	0.0625000
NODE_78420_length_398_cov_2.993311	229	309	8	19	80	0.2375000
NODE_78420_length_398_cov_2.993311	229	309	9	23	80	0.2875000
NODE_78420_length_398_cov_2.993311	229	309	10	11	80	0.1375000
NODE_78420_length_398_cov_2.993311	229	309	12	6	80	0.0750000
NODE_78429_length_398_cov_2.822742	236	271	0	35	35	1.0000000
NODE_78891_length_397_cov_52.855705	124	204	0	80	80	1.0000000
NODE_78891_length_397_cov_52.855705	177	257	0	80	80	1.0000000
NODE_78894_length_397_cov_35.036913	173	253	1	4	80	0.0500000
NODE_78894_length_397_cov_35.036913	173	253	2	5	80	0.0625000
NODE_78894_length_397_cov_35.036913	173	253	6	1	80	0.0125000
NODE_78894_length_397_cov_35.036913	173	253	8	22	80	0.2750000
NODE_78894_length_397_cov_35.036913	173	253	12	25	80	0.3125000
NODE_78894_length_397_cov_35.036913	173	253	14	23	80	0.2875000
NODE_78895_length_397_cov_13.667785	94	174	0	80	80	1.0000000
NODE_78895_length_397_cov_13.667785	147	227	0	80	80	1.0000000
NODE_78897_length_397_cov_7.496644	192	272	0	80	80	1.0000000
NODE_78897_length_397_cov_7.496644	245	325	0	80	80	1.0000000
NODE_78898_length_397_cov_6.828859	127	173	0	10	46	0.2173913
NODE_78898_length_397_cov_6.828859	127	173	2	36	46	0.7826087
NODE_78913_length_397_cov_4.902685	293	364	0	71	71	1.0000000
NODE_78933_length_397_cov_3.765101	164	244	0	80	80	1.0000000
NODE_78951_length_397_cov_3.325503	107	187	0	9	80	0.1125000
NODE_78951_length_397_cov_3.325503	107	187	2	5	80	0.0625000
NODE_78951_length_397_cov_3.325503	107	187	7	2	80	0.0250000
NODE_78951_length_397_cov_3.325503	107	187	8	9	80	0.1125000
NODE_78951_length_397_cov_3.325503	107	187	10	32	80	0.4000000
NODE_78951_length_397_cov_3.325503	107	187	12	23	80	0.2875000
NODE_78951_length_397_cov_3.325503	163	236	2	8	73	0.1095890
NODE_78951_length_397_cov_3.325503	163	236	4	6	73	0.0821918
NODE_78951_length_397_cov_3.325503	163	236	10	20	73	0.2739726
NODE_78951_length_397_cov_3.325503	163	236	12	39	73	0.5342466
NODE_78999_length_397_cov_2.530201	269	312	2	6	43	0.1395349
NODE_78999_length_397_cov_2.530201	269	312	4	37	43	0.8604651
NODE_79047_length_397_cov_1.959732	154	193	0	39	39	1.0000000
NODE_79072_length_397_cov_1.791946	218	283	0	24	65	0.3692308
NODE_79072_length_397_cov_1.791946	218	283	2	1	65	0.0153846
NODE_79072_length_397_cov_1.791946	218	283	4	1	65	0.0153846
NODE_79072_length_397_cov_1.791946	218	283	8	2	65	0.0307692
NODE_79072_length_397_cov_1.791946	218	283	11	4	65	0.0615385
NODE_79072_length_397_cov_1.791946	218	283	13	3	65	0.0461538
NODE_79072_length_397_cov_1.791946	218	283	14	23	65	0.3538462
NODE_79072_length_397_cov_1.791946	218	283	16	7	65	0.1076923
NODE_79127_length_397_cov_1.560403	183	240	0	57	57	1.0000000
NODE_79456_length_396_cov_11.632997	162	242	0	80	80	1.0000000
NODE_79456_length_396_cov_11.632997	215	295	0	80	80	1.0000000
NODE_79460_length_396_cov_7.053872	71	101	0	30	30	1.0000000
NODE_79464_length_396_cov_6.097643	229	309	0	80	80	1.0000000
NODE_79464_length_396_cov_6.097643	282	362	0	80	80	1.0000000
NODE_79471_length_396_cov_5.484848	125	205	8	80	80	1.0000000
NODE_79471_length_396_cov_5.484848	178	259	4	53	81	0.6543210
NODE_79471_length_396_cov_5.484848	178	259	8	28	81	0.3456790
NODE_79473_length_396_cov_5.434343	224	275	0	44	51	0.8627451
NODE_79473_length_396_cov_5.434343	224	275	2	1	51	0.0196078
NODE_79473_length_396_cov_5.434343	224	275	4	6	51	0.1176471
NODE_79473_length_396_cov_5.434343	272	331	0	5	59	0.0847458
NODE_79473_length_396_cov_5.434343	272	331	2	54	59	0.9152542
NODE_79483_length_396_cov_4.414141	189	264	4	11	75	0.1466667
NODE_79483_length_396_cov_4.414141	189	264	6	64	75	0.8533334
NODE_79483_length_396_cov_4.414141	241	317	0	42	76	0.5526316
NODE_79483_length_396_cov_4.414141	241	317	1	4	76	0.0526316
NODE_79483_length_396_cov_4.414141	241	317	2	4	76	0.0526316
NODE_79483_length_396_cov_4.414141	241	317	3	1	76	0.0131579
NODE_79483_length_396_cov_4.414141	241	317	4	13	76	0.1710526
NODE_79483_length_396_cov_4.414141	241	317	6	12	76	0.1578947
NODE_79493_length_396_cov_4.010101	163	205	0	42	42	1.0000000
NODE_79522_length_396_cov_3.080808	95	161	0	26	66	0.3939394
NODE_79522_length_396_cov_3.080808	95	161	2	40	66	0.6060606
NODE_79524_length_396_cov_3.067340	252	316	2	16	64	0.2500000
NODE_79524_length_396_cov_3.067340	252	316	4	48	64	0.7500000
NODE_79535_length_396_cov_2.892256	136	217	2	81	81	1.0000000
NODE_79557_length_396_cov_2.710438	88	168	3	14	80	0.1750000
NODE_79557_length_396_cov_2.710438	88	168	6	1	80	0.0125000
NODE_79557_length_396_cov_2.710438	88	168	8	5	80	0.0625000
NODE_79557_length_396_cov_2.710438	88	168	12	2	80	0.0250000
NODE_79557_length_396_cov_2.710438	88	168	14	1	80	0.0125000
NODE_79557_length_396_cov_2.710438	88	168	18	9	80	0.1125000
NODE_79557_length_396_cov_2.710438	88	168	20	2	80	0.0250000
NODE_79557_length_396_cov_2.710438	88	168	22	46	80	0.5750000
NODE_79561_length_396_cov_2.680135	297	335	2	38	38	1.0000000
NODE_79562_length_396_cov_2.659933	68	148	0	80	80	1.0000000
NODE_79562_length_396_cov_2.659933	121	168	0	47	47	1.0000000
NODE_79616_length_396_cov_2.060606	308	388	0	80	80	1.0000000
NODE_79643_length_396_cov_1.939394	63	142	4	3	79	0.0379747
NODE_79643_length_396_cov_1.939394	63	142	8	17	79	0.2151899
NODE_79643_length_396_cov_1.939394	63	142	10	4	79	0.0506329
NODE_79643_length_396_cov_1.939394	63	142	14	12	79	0.1518987
NODE_79643_length_396_cov_1.939394	63	142	16	7	79	0.0886076
NODE_79643_length_396_cov_1.939394	63	142	20	10	79	0.1265823
NODE_79643_length_396_cov_1.939394	63	142	22	26	79	0.3291139
NODE_79643_length_396_cov_1.939394	115	164	14	3	49	0.0612245
NODE_79643_length_396_cov_1.939394	115	164	18	5	49	0.1020408
NODE_79643_length_396_cov_1.939394	115	164	20	15	49	0.3061225
NODE_79643_length_396_cov_1.939394	115	164	22	26	49	0.5306122
NODE_79683_length_396_cov_1.811448	82	162	2	45	80	0.5625000
NODE_79683_length_396_cov_1.811448	82	162	4	35	80	0.4375000
NODE_79692_length_396_cov_1.734007	88	119	0	31	31	1.0000000
NODE_79930_length_396_cov_0.905724	101	151	30	17	50	0.3400000
NODE_79930_length_396_cov_0.905724	101	151	32	9	50	0.1800000
NODE_79930_length_396_cov_0.905724	101	151	34	5	50	0.1000000
NODE_79930_length_396_cov_0.905724	101	151	36	14	50	0.2800000
NODE_79930_length_396_cov_0.905724	101	151	38	5	50	0.1000000
NODE_80057_length_395_cov_449.327703	0	79	53	1	79	0.0126582
NODE_80057_length_395_cov_449.327703	0	79	68	1	79	0.0126582
NODE_80057_length_395_cov_449.327703	0	79	76	1	79	0.0126582
NODE_80057_length_395_cov_449.327703	0	79	87	1	79	0.0126582
NODE_80057_length_395_cov_449.327703	0	79	90	1	79	0.0126582
NODE_80057_length_395_cov_449.327703	0	79	111	1	79	0.0126582
NODE_80057_length_395_cov_449.327703	0	79	116	1	79	0.0126582
NODE_80057_length_395_cov_449.327703	0	79	117	1	79	0.0126582
NODE_80057_length_395_cov_449.327703	0	79	119	2	79	0.0253165
NODE_80057_length_395_cov_449.327703	0	79	138	1	79	0.0126582
NODE_80057_length_395_cov_449.327703	0	79	141	1	79	0.0126582
NODE_80057_length_395_cov_449.327703	0	79	146	1	79	0.0126582
NODE_80057_length_395_cov_449.327703	0	79	150	2	79	0.0253165
NODE_80057_length_395_cov_449.327703	0	79	154	1	79	0.0126582
NODE_80057_length_395_cov_449.327703	0	79	162	1	79	0.0126582
NODE_80057_length_395_cov_449.327703	0	79	166	1	79	0.0126582
NODE_80057_length_395_cov_449.327703	0	79	173	1	79	0.0126582
NODE_80057_length_395_cov_449.327703	0	79	177	1	79	0.0126582
NODE_80057_length_395_cov_449.327703	0	79	190	1	79	0.0126582
NODE_80057_length_395_cov_449.327703	0	79	217	1	79	0.0126582
NODE_80057_length_395_cov_449.327703	0	79	224	1	79	0.0126582
NODE_80057_length_395_cov_449.327703	0	79	239	1	79	0.0126582
NODE_80057_length_395_cov_449.327703	0	79	241	1	79	0.0126582
NODE_80057_length_395_cov_449.327703	0	79	262	1	79	0.0126582
NODE_80057_length_395_cov_449.327703	0	79	267	1	79	0.0126582
NODE_80057_length_395_cov_449.327703	0	79	287	1	79	0.0126582
NODE_80057_length_395_cov_449.327703	0	79	294	1	79	0.0126582
NODE_80057_length_395_cov_449.327703	0	79	301	1	79	0.0126582
NODE_80057_length_395_cov_449.327703	0	79	305	1	79	0.0126582
NODE_80057_length_395_cov_449.327703	0	79	320	1	79	0.0126582
NODE_80057_length_395_cov_449.327703	0	79	334	1	79	0.0126582
NODE_80057_length_395_cov_449.327703	0	79	346	1	79	0.0126582
NODE_80057_length_395_cov_449.327703	0	79	349	1	79	0.0126582
NODE_80057_length_395_cov_449.327703	0	79	350	1	79	0.0126582
NODE_80057_length_395_cov_449.327703	0	79	357	1	79	0.0126582
NODE_80057_length_395_cov_449.327703	0	79	364	1	79	0.0126582
NODE_80057_length_395_cov_449.327703	0	79	376	1	79	0.0126582
NODE_80057_length_395_cov_449.327703	0	79	383	1	79	0.0126582
NODE_80057_length_395_cov_449.327703	0	79	389	1	79	0.0126582
NODE_80057_length_395_cov_449.327703	0	79	395	1	79	0.0126582
NODE_80057_length_395_cov_449.327703	0	79	402	1	79	0.0126582
NODE_80057_length_395_cov_449.327703	0	79	420	1	79	0.0126582
NODE_80057_length_395_cov_449.327703	0	79	423	1	79	0.0126582
NODE_80057_length_395_cov_449.327703	0	79	430	1	79	0.0126582
NODE_80057_length_395_cov_449.327703	0	79	432	1	79	0.0126582
NODE_80057_length_395_cov_449.327703	0	79	434	1	79	0.0126582
NODE_80057_length_395_cov_449.327703	0	79	435	1	79	0.0126582
NODE_80057_length_395_cov_449.327703	0	79	437	1	79	0.0126582
NODE_80057_length_395_cov_449.327703	0	79	440	2	79	0.0253165
NODE_80057_length_395_cov_449.327703	0	79	446	1	79	0.0126582
NODE_80057_length_395_cov_449.327703	0	79	460	1	79	0.0126582
NODE_80057_length_395_cov_449.327703	0	79	465	1	79	0.0126582
NODE_80057_length_395_cov_449.327703	0	79	470	1	79	0.0126582
NODE_80057_length_395_cov_449.327703	0	79	472	4	79	0.0506329
NODE_80057_length_395_cov_449.327703	0	79	476	1	79	0.0126582
NODE_80057_length_395_cov_449.327703	0	79	479	1	79	0.0126582
NODE_80057_length_395_cov_449.327703	0	79	480	1	79	0.0126582
NODE_80057_length_395_cov_449.327703	0	79	493	1	79	0.0126582
NODE_80057_length_395_cov_449.327703	0	79	499	1	79	0.0126582
NODE_80057_length_395_cov_449.327703	0	79	504	2	79	0.0253165
NODE_80057_length_395_cov_449.327703	0	79	523	1	79	0.0126582
NODE_80057_length_395_cov_449.327703	0	79	526	1	79	0.0126582
NODE_80057_length_395_cov_449.327703	0	79	543	1	79	0.0126582
NODE_80057_length_395_cov_449.327703	0	79	544	1	79	0.0126582
NODE_80057_length_395_cov_449.327703	0	79	550	1	79	0.0126582
NODE_80057_length_395_cov_449.327703	0	79	553	1	79	0.0126582
NODE_80057_length_395_cov_449.327703	0	79	557	1	79	0.0126582
NODE_80057_length_395_cov_449.327703	0	79	561	1	79	0.0126582
NODE_80057_length_395_cov_449.327703	0	79	567	1	79	0.0126582
NODE_80057_length_395_cov_449.327703	0	79	570	2	79	0.0253165
NODE_80057_length_395_cov_449.327703	0	79	573	1	79	0.0126582
NODE_80058_length_395_cov_13.695946	113	193	0	80	80	1.0000000
NODE_80058_length_395_cov_13.695946	166	246	0	80	80	1.0000000
NODE_80086_length_395_cov_4.179054	152	232	17	30	80	0.3750000
NODE_80086_length_395_cov_4.179054	152	232	21	1	80	0.0125000
NODE_80086_length_395_cov_4.179054	152	232	23	1	80	0.0125000
NODE_80086_length_395_cov_4.179054	152	232	34	48	80	0.6000000
NODE_80116_length_395_cov_2.962838	118	198	6	1	80	0.0125000
NODE_80116_length_395_cov_2.962838	118	198	8	73	80	0.9125000
NODE_80116_length_395_cov_2.962838	118	198	10	6	80	0.0750000
NODE_80116_length_395_cov_2.962838	171	237	2	39	66	0.5909091
NODE_80116_length_395_cov_2.962838	171	237	6	1	66	0.0151515
NODE_80116_length_395_cov_2.962838	171	237	8	25	66	0.3787879
NODE_80116_length_395_cov_2.962838	171	237	10	1	66	0.0151515
NODE_80121_length_395_cov_2.878378	261	301	5	2	40	0.0500000
NODE_80121_length_395_cov_2.878378	261	301	6	38	40	0.9500000
NODE_80139_length_395_cov_2.587838	111	188	2	15	77	0.1948052
NODE_80139_length_395_cov_2.587838	111	188	4	18	77	0.2337662
NODE_80139_length_395_cov_2.587838	111	188	5	20	77	0.2597403
NODE_80139_length_395_cov_2.587838	111	188	6	10	77	0.1298701
NODE_80139_length_395_cov_2.587838	111	188	7	14	77	0.1818182
NODE_80139_length_395_cov_2.587838	232	301	0	6	69	0.0869565
NODE_80139_length_395_cov_2.587838	232	301	3	17	69	0.2463768
NODE_80139_length_395_cov_2.587838	232	301	5	2	69	0.0289855
NODE_80139_length_395_cov_2.587838	232	301	8	26	69	0.3768116
NODE_80139_length_395_cov_2.587838	232	301	10	18	69	0.2608696
NODE_80139_length_395_cov_2.587838	258	302	8	25	44	0.5681818
NODE_80139_length_395_cov_2.587838	258	302	10	19	44	0.4318182
NODE_80141_length_395_cov_2.560811	123	187	0	64	64	1.0000000
NODE_80146_length_395_cov_2.527027	194	274	0	80	80	1.0000000
NODE_80146_length_395_cov_2.527027	247	327	0	80	80	1.0000000
NODE_80439_length_395_cov_1.033784	103	151	0	48	48	1.0000000
NODE_80448_length_395_cov_1.010135	85	105	0	20	20	1.0000000
NODE_80639_length_394_cov_9.464407	211	291	0	80	80	1.0000000
NODE_80639_length_394_cov_9.464407	264	344	0	80	80	1.0000000
NODE_80643_length_394_cov_7.437288	221	301	0	80	80	1.0000000
NODE_80643_length_394_cov_7.437288	274	331	0	57	57	1.0000000
NODE_80647_length_394_cov_6.444068	187	267	0	80	80	1.0000000
NODE_80647_length_394_cov_6.444068	240	320	0	80	80	1.0000000
NODE_80709_length_394_cov_2.932203	119	140	0	21	21	1.0000000
NODE_80710_length_394_cov_2.894915	79	135	0	5	56	0.0892857
NODE_80710_length_394_cov_2.894915	79	135	2	25	56	0.4464286
NODE_80710_length_394_cov_2.894915	79	135	4	20	56	0.3571429
NODE_80710_length_394_cov_2.894915	79	135	6	6	56	0.1071429
NODE_80710_length_394_cov_2.894915	166	202	6	36	36	1.0000000
NODE_81216_length_393_cov_4.261905	201	267	0	66	66	1.0000000
NODE_81216_length_393_cov_4.261905	240	282	0	42	42	1.0000000
NODE_81240_length_393_cov_3.503401	121	201	0	80	80	1.0000000
NODE_81240_length_393_cov_3.503401	174	246	0	72	72	1.0000000
NODE_81277_length_393_cov_2.704082	198	271	0	68	73	0.9315069
NODE_81277_length_393_cov_2.704082	198	271	2	5	73	0.0684932
NODE_81289_length_393_cov_2.493197	136	216	0	80	80	1.0000000
NODE_81289_length_393_cov_2.493197	189	269	0	80	80	1.0000000
NODE_81296_length_393_cov_2.360544	195	252	0	29	57	0.5087720
NODE_81296_length_393_cov_2.360544	195	252	4	13	57	0.2280702
NODE_81296_length_393_cov_2.360544	195	252	6	15	57	0.2631579
NODE_81416_length_393_cov_1.608844	207	270	0	63	63	1.0000000
NODE_81778_length_392_cov_7.873720	161	241	0	80	80	1.0000000
NODE_81778_length_392_cov_7.873720	214	294	0	80	80	1.0000000
NODE_81790_length_392_cov_5.262799	218	248	0	30	30	1.0000000
NODE_81805_length_392_cov_3.655290	109	157	0	33	48	0.6875000
NODE_81805_length_392_cov_3.655290	109	157	2	15	48	0.3125000
NODE_81805_length_392_cov_3.655290	306	386	0	80	80	1.0000000
NODE_81823_length_392_cov_3.197952	102	171	0	21	69	0.3043478
NODE_81823_length_392_cov_3.197952	102	171	2	16	69	0.2318841
NODE_81823_length_392_cov_3.197952	102	171	4	5	69	0.0724638
NODE_81823_length_392_cov_3.197952	102	171	6	4	69	0.0579710
NODE_81823_length_392_cov_3.197952	102	171	8	13	69	0.1884058
NODE_81823_length_392_cov_3.197952	102	171	10	10	69	0.1449275
NODE_81823_length_392_cov_3.197952	233	314	2	22	81	0.2716049
NODE_81823_length_392_cov_3.197952	233	314	4	59	81	0.7283950
NODE_81857_length_392_cov_2.511945	67	133	73	2	66	0.0303030
NODE_81857_length_392_cov_2.511945	67	133	78	2	66	0.0303030
NODE_81857_length_392_cov_2.511945	67	133	82	1	66	0.0151515
NODE_81857_length_392_cov_2.511945	67	133	83	1	66	0.0151515
NODE_81857_length_392_cov_2.511945	67	133	87	1	66	0.0151515
NODE_81857_length_392_cov_2.511945	67	133	88	1	66	0.0151515
NODE_81857_length_392_cov_2.511945	67	133	91	2	66	0.0303030
NODE_81857_length_392_cov_2.511945	67	133	92	5	66	0.0757576
NODE_81857_length_392_cov_2.511945	67	133	96	3	66	0.0454545
NODE_81857_length_392_cov_2.511945	67	133	104	2	66	0.0303030
NODE_81857_length_392_cov_2.511945	67	133	105	1	66	0.0151515
NODE_81857_length_392_cov_2.511945	67	133	108	1	66	0.0151515
NODE_81857_length_392_cov_2.511945	67	133	112	1	66	0.0151515
NODE_81857_length_392_cov_2.511945	67	133	114	1	66	0.0151515
NODE_81857_length_392_cov_2.511945	67	133	121	1	66	0.0151515
NODE_81857_length_392_cov_2.511945	67	133	126	1	66	0.0151515
NODE_81857_length_392_cov_2.511945	67	133	130	3	66	0.0454545
NODE_81857_length_392_cov_2.511945	67	133	138	2	66	0.0303030
NODE_81857_length_392_cov_2.511945	67	133	144	1	66	0.0151515
NODE_81857_length_392_cov_2.511945	67	133	145	2	66	0.0303030
NODE_81857_length_392_cov_2.511945	67	133	147	1	66	0.0151515
NODE_81857_length_392_cov_2.511945	67	133	148	1	66	0.0151515
NODE_81857_length_392_cov_2.511945	67	133	154	1	66	0.0151515
NODE_81857_length_392_cov_2.511945	67	133	156	2	66	0.0303030
NODE_81857_length_392_cov_2.511945	67	133	164	1	66	0.0151515
NODE_81857_length_392_cov_2.511945	67	133	167	1	66	0.0151515
NODE_81857_length_392_cov_2.511945	67	133	170	1	66	0.0151515
NODE_81857_length_392_cov_2.511945	67	133	172	4	66	0.0606061
NODE_81857_length_392_cov_2.511945	67	133	174	1	66	0.0151515
NODE_81857_length_392_cov_2.511945	67	133	185	1	66	0.0151515
NODE_81857_length_392_cov_2.511945	67	133	188	6	66	0.0909091
NODE_81857_length_392_cov_2.511945	67	133	196	2	66	0.0303030
NODE_81857_length_392_cov_2.511945	67	133	200	1	66	0.0151515
NODE_81857_length_392_cov_2.511945	67	133	201	1	66	0.0151515
NODE_81857_length_392_cov_2.511945	67	133	204	3	66	0.0454545
NODE_81857_length_392_cov_2.511945	67	133	207	2	66	0.0303030
NODE_81857_length_392_cov_2.511945	67	133	208	1	66	0.0151515
NODE_81857_length_392_cov_2.511945	67	133	209	2	66	0.0303030
NODE_81857_length_392_cov_2.511945	120	206	142	3	86	0.0348837
NODE_81857_length_392_cov_2.511945	120	206	149	3	86	0.0348837
NODE_81857_length_392_cov_2.511945	120	206	150	1	86	0.0116279
NODE_81857_length_392_cov_2.511945	120	206	154	1	86	0.0116279
NODE_81857_length_392_cov_2.511945	120	206	156	3	86	0.0348837
NODE_81857_length_392_cov_2.511945	120	206	160	5	86	0.0581395
NODE_81857_length_392_cov_2.511945	120	206	162	1	86	0.0116279
NODE_81857_length_392_cov_2.511945	120	206	163	1	86	0.0116279
NODE_81857_length_392_cov_2.511945	120	206	169	1	86	0.0116279
NODE_81857_length_392_cov_2.511945	120	206	170	2	86	0.0232558
NODE_81857_length_392_cov_2.511945	120	206	172	2	86	0.0232558
NODE_81857_length_392_cov_2.511945	120	206	173	1	86	0.0116279
NODE_81857_length_392_cov_2.511945	120	206	175	1	86	0.0116279
NODE_81857_length_392_cov_2.511945	120	206	182	1	86	0.0116279
NODE_81857_length_392_cov_2.511945	120	206	184	5	86	0.0581395
NODE_81857_length_392_cov_2.511945	120	206	188	1	86	0.0116279
NODE_81857_length_392_cov_2.511945	120	206	189	1	86	0.0116279
NODE_81857_length_392_cov_2.511945	120	206	193	1	86	0.0116279
NODE_81857_length_392_cov_2.511945	120	206	196	2	86	0.0232558
NODE_81857_length_392_cov_2.511945	120	206	200	1	86	0.0116279
NODE_81857_length_392_cov_2.511945	120	206	201	1	86	0.0116279
NODE_81857_length_392_cov_2.511945	120	206	202	2	86	0.0232558
NODE_81857_length_392_cov_2.511945	120	206	204	7	86	0.0813954
NODE_81857_length_392_cov_2.511945	120	206	205	2	86	0.0232558
NODE_81857_length_392_cov_2.511945	120	206	206	3	86	0.0348837
NODE_81857_length_392_cov_2.511945	120	206	207	5	86	0.0581395
NODE_81857_length_392_cov_2.511945	120	206	208	3	86	0.0348837
NODE_81857_length_392_cov_2.511945	120	206	209	5	86	0.0581395
NODE_81857_length_392_cov_2.511945	120	206	211	2	86	0.0232558
NODE_81857_length_392_cov_2.511945	120	206	212	5	86	0.0581395
NODE_81857_length_392_cov_2.511945	120	206	213	2	86	0.0232558
NODE_81857_length_392_cov_2.511945	120	206	214	2	86	0.0232558
NODE_81857_length_392_cov_2.511945	120	206	215	1	86	0.0116279
NODE_81857_length_392_cov_2.511945	120	206	216	2	86	0.0232558
NODE_81857_length_392_cov_2.511945	120	206	218	4	86	0.0465116
NODE_81857_length_392_cov_2.511945	120	206	219	2	86	0.0232558
NODE_81857_length_392_cov_2.511945	120	206	221	1	86	0.0116279
NODE_81914_length_392_cov_2.075085	268	349	4	4	81	0.0493827
NODE_81914_length_392_cov_2.075085	268	349	6	14	81	0.1728395
NODE_81914_length_392_cov_2.075085	268	349	7	33	81	0.4074074
NODE_81914_length_392_cov_2.075085	268	349	9	30	81	0.3703704
NODE_81914_length_392_cov_2.075085	322	387	5	15	65	0.2307692
NODE_81914_length_392_cov_2.075085	322	387	7	50	65	0.7692308
NODE_81928_length_392_cov_1.955631	11	56	0	45	45	1.0000000
NODE_81929_length_392_cov_1.952218	40	59	0	19	19	1.0000000
NODE_81940_length_392_cov_1.911263	238	315	0	77	77	1.0000000
NODE_81994_length_392_cov_1.631399	114	139	24	4	25	0.1600000
NODE_81994_length_392_cov_1.631399	114	139	26	5	25	0.2000000
NODE_81994_length_392_cov_1.631399	114	139	28	1	25	0.0400000
NODE_81994_length_392_cov_1.631399	114	139	32	1	25	0.0400000
NODE_81994_length_392_cov_1.631399	114	139	34	9	25	0.3600000
NODE_81994_length_392_cov_1.631399	114	139	36	5	25	0.2000000
NODE_82008_length_392_cov_1.559727	83	163	7	5	80	0.0625000
NODE_82008_length_392_cov_1.559727	83	163	9	10	80	0.1250000
NODE_82008_length_392_cov_1.559727	83	163	11	65	80	0.8125000
NODE_82015_length_392_cov_1.552901	32	52	0	20	20	1.0000000
NODE_82390_length_391_cov_69.510274	9	89	116	1	80	0.0125000
NODE_82390_length_391_cov_69.510274	9	89	120	1	80	0.0125000
NODE_82390_length_391_cov_69.510274	9	89	138	1	80	0.0125000
NODE_82390_length_391_cov_69.510274	9	89	149	1	80	0.0125000
NODE_82390_length_391_cov_69.510274	9	89	157	1	80	0.0125000
NODE_82390_length_391_cov_69.510274	9	89	159	1	80	0.0125000
NODE_82390_length_391_cov_69.510274	9	89	178	1	80	0.0125000
NODE_82390_length_391_cov_69.510274	9	89	179	3	80	0.0375000
NODE_82390_length_391_cov_69.510274	9	89	189	1	80	0.0125000
NODE_82390_length_391_cov_69.510274	9	89	192	2	80	0.0250000
NODE_82390_length_391_cov_69.510274	9	89	198	1	80	0.0125000
NODE_82390_length_391_cov_69.510274	9	89	200	1	80	0.0125000
NODE_82390_length_391_cov_69.510274	9	89	202	1	80	0.0125000
NODE_82390_length_391_cov_69.510274	9	89	208	1	80	0.0125000
NODE_82390_length_391_cov_69.510274	9	89	222	2	80	0.0250000
NODE_82390_length_391_cov_69.510274	9	89	224	1	80	0.0125000
NODE_82390_length_391_cov_69.510274	9	89	231	1	80	0.0125000
NODE_82390_length_391_cov_69.510274	9	89	237	1	80	0.0125000
NODE_82390_length_391_cov_69.510274	9	89	247	1	80	0.0125000
NODE_82390_length_391_cov_69.510274	9	89	249	1	80	0.0125000
NODE_82390_length_391_cov_69.510274	9	89	257	1	80	0.0125000
NODE_82390_length_391_cov_69.510274	9	89	261	1	80	0.0125000
NODE_82390_length_391_cov_69.510274	9	89	275	1	80	0.0125000
NODE_82390_length_391_cov_69.510274	9	89	280	1	80	0.0125000
NODE_82390_length_391_cov_69.510274	9	89	284	1	80	0.0125000
NODE_82390_length_391_cov_69.510274	9	89	286	1	80	0.0125000
NODE_82390_length_391_cov_69.510274	9	89	290	1	80	0.0125000
NODE_82390_length_391_cov_69.510274	9	89	295	1	80	0.0125000
NODE_82390_length_391_cov_69.510274	9	89	304	1	80	0.0125000
NODE_82390_length_391_cov_69.510274	9	89	309	1	80	0.0125000
NODE_82390_length_391_cov_69.510274	9	89	321	1	80	0.0125000
NODE_82390_length_391_cov_69.510274	9	89	323	1	80	0.0125000
NODE_82390_length_391_cov_69.510274	9	89	326	1	80	0.0125000
NODE_82390_length_391_cov_69.510274	9	89	333	1	80	0.0125000
NODE_82390_length_391_cov_69.510274	9	89	340	1	80	0.0125000
NODE_82390_length_391_cov_69.510274	9	89	344	1	80	0.0125000
NODE_82390_length_391_cov_69.510274	9	89	354	2	80	0.0250000
NODE_82390_length_391_cov_69.510274	9	89	355	2	80	0.0250000
NODE_82390_length_391_cov_69.510274	9	89	369	2	80	0.0250000
NODE_82390_length_391_cov_69.510274	9	89	373	1	80	0.0125000
NODE_82390_length_391_cov_69.510274	9	89	375	2	80	0.0250000
NODE_82390_length_391_cov_69.510274	9	89	379	1	80	0.0125000
NODE_82390_length_391_cov_69.510274	9	89	382	3	80	0.0375000
NODE_82390_length_391_cov_69.510274	9	89	386	1	80	0.0125000
NODE_82390_length_391_cov_69.510274	9	89	388	1	80	0.0125000
NODE_82390_length_391_cov_69.510274	9	89	389	4	80	0.0500000
NODE_82390_length_391_cov_69.510274	9	89	391	1	80	0.0125000
NODE_82390_length_391_cov_69.510274	9	89	393	1	80	0.0125000
NODE_82390_length_391_cov_69.510274	9	89	395	1	80	0.0125000
NODE_82390_length_391_cov_69.510274	9	89	397	2	80	0.0250000
NODE_82390_length_391_cov_69.510274	9	89	398	2	80	0.0250000
NODE_82390_length_391_cov_69.510274	9	89	404	1	80	0.0125000
NODE_82390_length_391_cov_69.510274	9	89	405	1	80	0.0125000
NODE_82390_length_391_cov_69.510274	9	89	410	1	80	0.0125000
NODE_82390_length_391_cov_69.510274	9	89	412	1	80	0.0125000
NODE_82390_length_391_cov_69.510274	9	89	418	2	80	0.0250000
NODE_82390_length_391_cov_69.510274	9	89	419	1	80	0.0125000
NODE_82390_length_391_cov_69.510274	9	89	425	1	80	0.0125000
NODE_82390_length_391_cov_69.510274	9	89	427	1	80	0.0125000
NODE_82390_length_391_cov_69.510274	9	89	431	2	80	0.0250000
NODE_82390_length_391_cov_69.510274	9	89	432	1	80	0.0125000
NODE_82390_length_391_cov_69.510274	9	89	440	1	80	0.0125000
NODE_82390_length_391_cov_69.510274	9	89	445	1	80	0.0125000
NODE_82391_length_391_cov_39.414384	0	66	1	11	66	0.1666667
NODE_82391_length_391_cov_39.414384	0	66	2	11	66	0.1666667
NODE_82391_length_391_cov_39.414384	0	66	8	2	66	0.0303030
NODE_82391_length_391_cov_39.414384	0	66	10	6	66	0.0909091
NODE_82391_length_391_cov_39.414384	0	66	20	4	66	0.0606061
NODE_82391_length_391_cov_39.414384	0	66	22	16	66	0.2424242
NODE_82391_length_391_cov_39.414384	0	66	29	2	66	0.0303030
NODE_82391_length_391_cov_39.414384	0	66	39	3	66	0.0454545
NODE_82391_length_391_cov_39.414384	0	66	40	11	66	0.1666667
NODE_82391_length_391_cov_39.414384	0	71	1	11	71	0.1549296
NODE_82391_length_391_cov_39.414384	0	71	2	11	71	0.1549296
NODE_82391_length_391_cov_39.414384	0	71	8	2	71	0.0281690
NODE_82391_length_391_cov_39.414384	0	71	10	6	71	0.0845070
NODE_82391_length_391_cov_39.414384	0	71	20	4	71	0.0563380
NODE_82391_length_391_cov_39.414384	0	71	22	16	71	0.2253521
NODE_82391_length_391_cov_39.414384	0	71	29	2	71	0.0281690
NODE_82391_length_391_cov_39.414384	0	71	39	3	71	0.0422535
NODE_82391_length_391_cov_39.414384	0	71	40	16	71	0.2253521
NODE_82391_length_391_cov_39.414384	44	124	22	6	80	0.0750000
NODE_82391_length_391_cov_39.414384	44	124	28	7	80	0.0875000
NODE_82391_length_391_cov_39.414384	44	124	29	2	80	0.0250000
NODE_82391_length_391_cov_39.414384	44	124	30	5	80	0.0625000
NODE_82391_length_391_cov_39.414384	44	124	32	1	80	0.0125000
NODE_82391_length_391_cov_39.414384	44	124	36	3	80	0.0375000
NODE_82391_length_391_cov_39.414384	44	124	38	1	80	0.0125000
NODE_82391_length_391_cov_39.414384	44	124	39	3	80	0.0375000
NODE_82391_length_391_cov_39.414384	44	124	40	52	80	0.6500000
NODE_82394_length_391_cov_10.352740	156	235	0	79	79	1.0000000
NODE_82415_length_391_cov_5.030822	85	166	6	4	81	0.0493827
NODE_82415_length_391_cov_5.030822	85	166	10	2	81	0.0246914
NODE_82415_length_391_cov_5.030822	85	166	11	3	81	0.0370370
NODE_82415_length_391_cov_5.030822	85	166	12	8	81	0.0987654
NODE_82415_length_391_cov_5.030822	85	166	14	23	81	0.2839506
NODE_82415_length_391_cov_5.030822	85	166	15	1	81	0.0123457
NODE_82415_length_391_cov_5.030822	85	166	16	40	81	0.4938272
NODE_82498_length_391_cov_2.660959	267	343	2	8	76	0.1052632
NODE_82498_length_391_cov_2.660959	267	343	4	68	76	0.8947368
NODE_82552_length_391_cov_2.089041	176	256	7	1	80	0.0125000
NODE_82552_length_391_cov_2.089041	176	256	9	6	80	0.0750000
NODE_82552_length_391_cov_2.089041	176	256	10	7	80	0.0875000
NODE_82552_length_391_cov_2.089041	176	256	12	49	80	0.6125000
NODE_82552_length_391_cov_2.089041	176	256	14	17	80	0.2125000
NODE_82552_length_391_cov_2.089041	229	280	4	2	51	0.0392157
NODE_82552_length_391_cov_2.089041	229	280	6	11	51	0.2156863
NODE_82552_length_391_cov_2.089041	229	280	7	12	51	0.2352941
NODE_82552_length_391_cov_2.089041	229	280	9	6	51	0.1176471
NODE_82552_length_391_cov_2.089041	229	280	10	7	51	0.1372549
NODE_82552_length_391_cov_2.089041	229	280	12	13	51	0.2549020
NODE_82574_length_391_cov_1.907534	200	257	0	57	57	1.0000000
NODE_82597_length_391_cov_1.773973	160	190	0	30	30	1.0000000
NODE_82632_length_391_cov_1.647260	298	378	2	37	80	0.4625000
NODE_82632_length_391_cov_1.647260	298	378	4	43	80	0.5375000
NODE_82662_length_391_cov_1.561644	241	261	0	3	20	0.1500000
NODE_82662_length_391_cov_1.561644	241	261	1	17	20	0.8500000
NODE_83015_length_390_cov_29.030928	86	166	0	3	80	0.0375000
NODE_83015_length_390_cov_29.030928	86	166	2	77	80	0.9625000
NODE_83015_length_390_cov_29.030928	139	219	0	21	80	0.2625000
NODE_83015_length_390_cov_29.030928	139	219	2	59	80	0.7375000
NODE_83016_length_390_cov_22.319588	118	198	2	80	80	1.0000000
NODE_83016_length_390_cov_22.319588	171	251	0	20	80	0.2500000
NODE_83016_length_390_cov_22.319588	171	251	2	60	80	0.7500000
NODE_83044_length_390_cov_4.481100	208	277	0	69	69	1.0000000
NODE_83044_length_390_cov_4.481100	286	327	0	41	41	1.0000000
NODE_83045_length_390_cov_4.481100	93	171	0	78	78	1.0000000
NODE_83045_length_390_cov_4.481100	144	210	0	66	66	1.0000000
NODE_83060_length_390_cov_3.814433	66	99	0	33	33	1.0000000
NODE_83061_length_390_cov_3.783505	188	268	0	80	80	1.0000000
NODE_83061_length_390_cov_3.783505	241	321	0	80	80	1.0000000
NODE_83066_length_390_cov_3.560137	304	367	0	2	63	0.0317460
NODE_83066_length_390_cov_3.560137	304	367	2	61	63	0.9682540
NODE_83066_length_390_cov_3.560137	340	381	0	16	41	0.3902439
NODE_83066_length_390_cov_3.560137	340	381	2	25	41	0.6097561
NODE_83169_length_390_cov_2.127148	242	322	2	3	80	0.0375000
NODE_83169_length_390_cov_2.127148	242	322	4	4	80	0.0500000
NODE_83169_length_390_cov_2.127148	242	322	6	2	80	0.0250000
NODE_83169_length_390_cov_2.127148	242	322	8	3	80	0.0375000
NODE_83169_length_390_cov_2.127148	242	322	10	40	80	0.5000000
NODE_83169_length_390_cov_2.127148	242	322	12	28	80	0.3500000
NODE_83171_length_390_cov_2.123711	133	177	12	3	44	0.0681818
NODE_83171_length_390_cov_2.123711	133	177	14	5	44	0.1136364
NODE_83171_length_390_cov_2.123711	133	177	16	9	44	0.2045455
NODE_83171_length_390_cov_2.123711	133	177	17	3	44	0.0681818
NODE_83171_length_390_cov_2.123711	133	177	19	1	44	0.0227273
NODE_83171_length_390_cov_2.123711	133	177	21	1	44	0.0227273
NODE_83171_length_390_cov_2.123711	133	177	25	4	44	0.0909091
NODE_83171_length_390_cov_2.123711	133	177	28	6	44	0.1363636
NODE_83171_length_390_cov_2.123711	133	177	29	2	44	0.0454545
NODE_83171_length_390_cov_2.123711	133	177	31	4	44	0.0909091
NODE_83171_length_390_cov_2.123711	133	177	33	2	44	0.0454545
NODE_83171_length_390_cov_2.123711	133	177	37	2	44	0.0454545
NODE_83171_length_390_cov_2.123711	133	177	39	2	44	0.0454545
NODE_83171_length_390_cov_2.123711	157	237	25	2	80	0.0250000
NODE_83171_length_390_cov_2.123711	157	237	28	6	80	0.0750000
NODE_83171_length_390_cov_2.123711	157	237	29	2	80	0.0250000
NODE_83171_length_390_cov_2.123711	157	237	31	4	80	0.0500000
NODE_83171_length_390_cov_2.123711	157	237	33	3	80	0.0375000
NODE_83171_length_390_cov_2.123711	157	237	34	6	80	0.0750000
NODE_83171_length_390_cov_2.123711	157	237	35	11	80	0.1375000
NODE_83171_length_390_cov_2.123711	157	237	36	7	80	0.0875000
NODE_83171_length_390_cov_2.123711	157	237	37	9	80	0.1125000
NODE_83171_length_390_cov_2.123711	157	237	38	1	80	0.0125000
NODE_83171_length_390_cov_2.123711	157	237	39	22	80	0.2750000
NODE_83171_length_390_cov_2.123711	157	237	40	7	80	0.0875000
NODE_83288_length_390_cov_1.536082	223	276	0	53	53	1.0000000
NODE_83338_length_390_cov_1.398625	49	110	52	1	61	0.0163934
NODE_83338_length_390_cov_1.398625	49	110	54	1	61	0.0163934
NODE_83338_length_390_cov_1.398625	49	110	58	2	61	0.0327869
NODE_83338_length_390_cov_1.398625	49	110	64	2	61	0.0327869
NODE_83338_length_390_cov_1.398625	49	110	76	1	61	0.0163934
NODE_83338_length_390_cov_1.398625	49	110	80	2	61	0.0327869
NODE_83338_length_390_cov_1.398625	49	110	82	1	61	0.0163934
NODE_83338_length_390_cov_1.398625	49	110	84	2	61	0.0327869
NODE_83338_length_390_cov_1.398625	49	110	85	1	61	0.0163934
NODE_83338_length_390_cov_1.398625	49	110	89	3	61	0.0491803
NODE_83338_length_390_cov_1.398625	49	110	91	1	61	0.0163934
NODE_83338_length_390_cov_1.398625	49	110	94	2	61	0.0327869
NODE_83338_length_390_cov_1.398625	49	110	96	8	61	0.1311475
NODE_83338_length_390_cov_1.398625	49	110	98	3	61	0.0491803
NODE_83338_length_390_cov_1.398625	49	110	100	5	61	0.0819672
NODE_83338_length_390_cov_1.398625	49	110	102	2	61	0.0327869
NODE_83338_length_390_cov_1.398625	49	110	104	24	61	0.3934426
NODE_83463_length_390_cov_1.034364	78	158	0	80	80	1.0000000
NODE_83633_length_389_cov_63.710345	32	112	0	80	80	1.0000000
NODE_83633_length_389_cov_63.710345	85	165	0	80	80	1.0000000
NODE_83633_length_389_cov_63.710345	161	241	0	80	80	1.0000000
NODE_83633_length_389_cov_63.710345	214	294	0	80	80	1.0000000
NODE_83650_length_389_cov_5.382759	154	234	0	80	80	1.0000000
NODE_83662_length_389_cov_4.468966	199	269	0	70	70	1.0000000
NODE_83663_length_389_cov_4.424138	68	148	101	2	80	0.0250000
NODE_83663_length_389_cov_4.424138	68	148	108	2	80	0.0250000
NODE_83663_length_389_cov_4.424138	68	148	112	2	80	0.0250000
NODE_83663_length_389_cov_4.424138	68	148	114	1	80	0.0125000
NODE_83663_length_389_cov_4.424138	68	148	116	2	80	0.0250000
NODE_83663_length_389_cov_4.424138	68	148	118	1	80	0.0125000
NODE_83663_length_389_cov_4.424138	68	148	120	1	80	0.0125000
NODE_83663_length_389_cov_4.424138	68	148	122	6	80	0.0750000
NODE_83663_length_389_cov_4.424138	68	148	124	6	80	0.0750000
NODE_83663_length_389_cov_4.424138	68	148	126	1	80	0.0125000
NODE_83663_length_389_cov_4.424138	68	148	128	3	80	0.0375000
NODE_83663_length_389_cov_4.424138	68	148	130	26	80	0.3250000
NODE_83663_length_389_cov_4.424138	68	148	131	3	80	0.0375000
NODE_83663_length_389_cov_4.424138	68	148	132	5	80	0.0625000
NODE_83663_length_389_cov_4.424138	68	148	134	10	80	0.1250000
NODE_83663_length_389_cov_4.424138	68	148	136	9	80	0.1125000
NODE_83685_length_389_cov_3.782759	194	225	0	31	31	1.0000000
NODE_83689_length_389_cov_3.555172	107	153	0	1	46	0.0217391
NODE_83689_length_389_cov_3.555172	107	153	1	5	46	0.1086956
NODE_83689_length_389_cov_3.555172	107	153	2	40	46	0.8695652
NODE_83695_length_389_cov_3.251724	120	163	2	5	43	0.1162791
NODE_83695_length_389_cov_3.251724	120	163	4	13	43	0.3023256
NODE_83695_length_389_cov_3.251724	120	163	6	25	43	0.5813953
NODE_83695_length_389_cov_3.251724	136	206	4	3	70	0.0428571
NODE_83695_length_389_cov_3.251724	136	206	6	67	70	0.9571428
NODE_83816_length_389_cov_1.951724	68	148	0	80	80	1.0000000
NODE_83819_length_389_cov_1.937931	53	82	0	29	29	1.0000000
NODE_83819_length_389_cov_1.937931	153	233	11	1	80	0.0125000
NODE_83819_length_389_cov_1.937931	153	233	13	79	80	0.9875000
NODE_83829_length_389_cov_1.920690	296	365	3	69	69	1.0000000
NODE_84182_length_389_cov_0.720690	294	374	2	51	80	0.6375000
NODE_84182_length_389_cov_0.720690	294	374	4	29	80	0.3625000
NODE_84267_length_388_cov_9.179931	47	127	0	76	80	0.9500000
NODE_84267_length_388_cov_9.179931	47	127	2	4	80	0.0500000
NODE_84267_length_388_cov_9.179931	100	180	0	23	80	0.2875000
NODE_84267_length_388_cov_9.179931	100	180	2	57	80	0.7125000
NODE_84270_length_388_cov_7.249135	171	251	2	64	80	0.8000000
NODE_84270_length_388_cov_7.249135	171	251	4	16	80	0.2000000
NODE_84270_length_388_cov_7.249135	224	304	2	53	80	0.6625000
NODE_84270_length_388_cov_7.249135	224	304	4	27	80	0.3375000
NODE_84305_length_388_cov_3.913495	151	231	4	3	80	0.0375000
NODE_84305_length_388_cov_3.913495	151	231	6	3	80	0.0375000
NODE_84305_length_388_cov_3.913495	151	231	8	30	80	0.3750000
NODE_84305_length_388_cov_3.913495	151	231	10	25	80	0.3125000
NODE_84305_length_388_cov_3.913495	151	231	12	14	80	0.1750000
NODE_84305_length_388_cov_3.913495	151	231	14	5	80	0.0625000
NODE_84308_length_388_cov_3.809689	233	277	0	44	44	1.0000000
NODE_84332_length_388_cov_3.103806	101	166	2	35	65	0.5384616
NODE_84332_length_388_cov_3.103806	101	166	4	22	65	0.3384615
NODE_84332_length_388_cov_3.103806	101	166	6	8	65	0.1230769
NODE_84332_length_388_cov_3.103806	147	227	4	72	80	0.9000000
NODE_84332_length_388_cov_3.103806	147	227	6	8	80	0.1000000
NODE_84334_length_388_cov_3.041522	48	128	4	80	80	1.0000000
NODE_84410_length_388_cov_2.114187	82	141	0	59	59	1.0000000
NODE_84410_length_388_cov_2.114187	135	194	0	59	59	1.0000000
NODE_84423_length_388_cov_2.017301	99	151	0	49	52	0.9423077
NODE_84423_length_388_cov_2.017301	99	151	2	3	52	0.0576923
NODE_84427_length_388_cov_1.989619	0	76	0	14	76	0.1842105
NODE_84427_length_388_cov_1.989619	0	76	2	62	76	0.8157895
NODE_84427_length_388_cov_1.989619	49	114	0	41	65	0.6307693
NODE_84427_length_388_cov_1.989619	49	114	2	24	65	0.3692308
NODE_84587_length_388_cov_1.352941	172	247	0	75	75	1.0000000
NODE_84631_length_388_cov_1.228374	308	339	6	18	31	0.5806451
NODE_84631_length_388_cov_1.228374	308	339	8	13	31	0.4193548
NODE_84885_length_387_cov_33.052083	194	274	0	27	80	0.3375000
NODE_84885_length_387_cov_33.052083	194	274	2	53	80	0.6625000
NODE_84885_length_387_cov_33.052083	247	327	0	44	80	0.5500000
NODE_84885_length_387_cov_33.052083	247	327	2	36	80	0.4500000
NODE_84890_length_387_cov_6.871528	26	106	0	19	80	0.2375000
NODE_84890_length_387_cov_6.871528	26	106	2	61	80	0.7625000
NODE_84890_length_387_cov_6.871528	79	159	0	72	80	0.9000000
NODE_84890_length_387_cov_6.871528	79	159	2	8	80	0.1000000
NODE_84902_length_387_cov_5.420139	286	341	0	55	55	1.0000000
NODE_84946_length_387_cov_3.364583	287	367	0	80	80	1.0000000
NODE_85007_length_387_cov_2.260417	140	210	8	70	70	1.0000000
NODE_85019_length_387_cov_2.128472	220	286	0	66	66	1.0000000
NODE_85019_length_387_cov_2.128472	273	329	0	56	56	1.0000000
NODE_85032_length_387_cov_2.090278	318	352	0	34	34	1.0000000
NODE_85037_length_387_cov_2.055556	23	45	0	22	22	1.0000000
NODE_85047_length_387_cov_1.979167	259	316	0	57	57	1.0000000
NODE_85047_length_387_cov_1.979167	312	369	0	57	57	1.0000000
NODE_85091_length_387_cov_1.770833	315	361	2	14	46	0.3043478
NODE_85091_length_387_cov_1.770833	315	361	7	16	46	0.3478261
NODE_85091_length_387_cov_1.770833	315	361	9	8	46	0.1739130
NODE_85091_length_387_cov_1.770833	315	361	11	8	46	0.1739130
NODE_85528_length_386_cov_9.979094	38	118	0	13	80	0.1625000
NODE_85528_length_386_cov_9.979094	38	118	2	67	80	0.8375000
NODE_85528_length_386_cov_9.979094	91	174	0	69	83	0.8313253
NODE_85528_length_386_cov_9.979094	91	174	2	14	83	0.1686747
NODE_85546_length_386_cov_4.428571	197	249	0	52	52	1.0000000
NODE_85570_length_386_cov_3.355401	151	231	0	80	80	1.0000000
NODE_85570_length_386_cov_3.355401	204	265	0	61	61	1.0000000
NODE_85602_length_386_cov_2.686411	293	325	8	32	32	1.0000000
NODE_85602_length_386_cov_2.686411	349	379	0	28	30	0.9333333
NODE_85602_length_386_cov_2.686411	349	379	4	2	30	0.0666667
NODE_85629_length_386_cov_2.442509	55	135	0	80	80	1.0000000
NODE_85629_length_386_cov_2.442509	108	164	0	56	56	1.0000000
NODE_85793_length_386_cov_1.494774	79	121	4	42	42	1.0000000
NODE_85793_length_386_cov_1.494774	93	156	4	63	63	1.0000000
NODE_85816_length_386_cov_1.421603	160	236	0	53	76	0.6973684
NODE_85816_length_386_cov_1.421603	160	236	3	1	76	0.0131579
NODE_85816_length_386_cov_1.421603	160	236	4	22	76	0.2894737
NODE_85845_length_386_cov_1.372822	62	142	0	80	80	1.0000000
NODE_85845_length_386_cov_1.372822	115	195	0	80	80	1.0000000
NODE_85858_length_386_cov_1.317073	124	161	32	12	37	0.3243243
NODE_85858_length_386_cov_1.317073	124	161	34	10	37	0.2702703
NODE_85858_length_386_cov_1.317073	124	161	36	15	37	0.4054054
NODE_85902_length_386_cov_1.170732	260	308	10	2	48	0.0416667
NODE_85902_length_386_cov_1.170732	260	308	12	1	48	0.0208333
NODE_85902_length_386_cov_1.170732	260	308	13	10	48	0.2083333
NODE_85902_length_386_cov_1.170732	260	308	15	25	48	0.5208333
NODE_85902_length_386_cov_1.170732	260	308	17	10	48	0.2083333
NODE_86143_length_385_cov_167.877622	103	164	388	1	61	0.0163934
NODE_86143_length_385_cov_167.877622	103	164	391	1	61	0.0163934
NODE_86143_length_385_cov_167.877622	103	164	398	1	61	0.0163934
NODE_86143_length_385_cov_167.877622	103	164	399	1	61	0.0163934
NODE_86143_length_385_cov_167.877622	103	164	400	1	61	0.0163934
NODE_86143_length_385_cov_167.877622	103	164	401	1	61	0.0163934
NODE_86143_length_385_cov_167.877622	103	164	402	2	61	0.0327869
NODE_86143_length_385_cov_167.877622	103	164	403	1	61	0.0163934
NODE_86143_length_385_cov_167.877622	103	164	404	2	61	0.0327869
NODE_86143_length_385_cov_167.877622	103	164	406	2	61	0.0327869
NODE_86143_length_385_cov_167.877622	103	164	407	4	61	0.0655738
NODE_86143_length_385_cov_167.877622	103	164	410	1	61	0.0163934
NODE_86143_length_385_cov_167.877622	103	164	411	1	61	0.0163934
NODE_86143_length_385_cov_167.877622	103	164	412	2	61	0.0327869
NODE_86143_length_385_cov_167.877622	103	164	413	2	61	0.0327869
NODE_86143_length_385_cov_167.877622	103	164	414	4	61	0.0655738
NODE_86143_length_385_cov_167.877622	103	164	415	4	61	0.0655738
NODE_86143_length_385_cov_167.877622	103	164	416	1	61	0.0163934
NODE_86143_length_385_cov_167.877622	103	164	417	1	61	0.0163934
NODE_86143_length_385_cov_167.877622	103	164	418	2	61	0.0327869
NODE_86143_length_385_cov_167.877622	103	164	421	3	61	0.0491803
NODE_86143_length_385_cov_167.877622	103	164	422	1	61	0.0163934
NODE_86143_length_385_cov_167.877622	103	164	423	6	61	0.0983607
NODE_86143_length_385_cov_167.877622	103	164	424	3	61	0.0491803
NODE_86143_length_385_cov_167.877622	103	164	425	2	61	0.0327869
NODE_86143_length_385_cov_167.877622	103	164	426	2	61	0.0327869
NODE_86143_length_385_cov_167.877622	103	164	427	3	61	0.0491803
NODE_86143_length_385_cov_167.877622	103	164	430	4	61	0.0655738
NODE_86143_length_385_cov_167.877622	103	164	431	1	61	0.0163934
NODE_86143_length_385_cov_167.877622	103	164	432	1	61	0.0163934
NODE_86144_length_385_cov_38.695804	164	244	0	80	80	1.0000000
NODE_86144_length_385_cov_38.695804	217	297	0	80	80	1.0000000
NODE_86169_length_385_cov_4.335664	173	250	0	47	77	0.6103896
NODE_86169_length_385_cov_4.335664	173	250	4	2	77	0.0259740
NODE_86169_length_385_cov_4.335664	173	250	7	5	77	0.0649351
NODE_86169_length_385_cov_4.335664	173	250	9	4	77	0.0519481
NODE_86169_length_385_cov_4.335664	173	250	11	1	77	0.0129870
NODE_86169_length_385_cov_4.335664	173	250	15	2	77	0.0259740
NODE_86169_length_385_cov_4.335664	173	250	18	16	77	0.2077922
NODE_86185_length_385_cov_3.793706	215	297	0	41	82	0.5000000
NODE_86185_length_385_cov_3.793706	215	297	2	41	82	0.5000000
NODE_86230_length_385_cov_2.786713	99	179	4	15	80	0.1875000
NODE_86230_length_385_cov_2.786713	99	179	7	1	80	0.0125000
NODE_86230_length_385_cov_2.786713	99	179	10	7	80	0.0875000
NODE_86230_length_385_cov_2.786713	99	179	14	5	80	0.0625000
NODE_86230_length_385_cov_2.786713	99	179	15	15	80	0.1875000
NODE_86230_length_385_cov_2.786713	99	179	16	37	80	0.4625000
NODE_86230_length_385_cov_2.786713	152	232	2	4	80	0.0500000
NODE_86230_length_385_cov_2.786713	152	232	4	1	80	0.0125000
NODE_86230_length_385_cov_2.786713	152	232	7	1	80	0.0125000
NODE_86230_length_385_cov_2.786713	152	232	8	1	80	0.0125000
NODE_86230_length_385_cov_2.786713	152	232	10	19	80	0.2375000
NODE_86230_length_385_cov_2.786713	152	232	12	23	80	0.2875000
NODE_86230_length_385_cov_2.786713	152	232	14	1	80	0.0125000
NODE_86230_length_385_cov_2.786713	152	232	16	30	80	0.3750000
NODE_86230_length_385_cov_2.786713	281	362	0	81	81	1.0000000
NODE_86448_length_385_cov_1.381119	71	145	6	35	74	0.4729730
NODE_86448_length_385_cov_1.381119	71	145	7	1	74	0.0135135
NODE_86448_length_385_cov_1.381119	71	145	9	10	74	0.1351351
NODE_86448_length_385_cov_1.381119	71	145	11	1	74	0.0135135
NODE_86448_length_385_cov_1.381119	71	145	17	4	74	0.0540541
NODE_86448_length_385_cov_1.381119	71	145	19	17	74	0.2297297
NODE_86448_length_385_cov_1.381119	71	145	20	1	74	0.0135135
NODE_86448_length_385_cov_1.381119	71	145	22	5	74	0.0675676
NODE_86448_length_385_cov_1.381119	118	198	17	4	80	0.0500000
NODE_86448_length_385_cov_1.381119	118	198	19	17	80	0.2125000
NODE_86448_length_385_cov_1.381119	118	198	20	1	80	0.0125000
NODE_86448_length_385_cov_1.381119	118	198	22	12	80	0.1500000
NODE_86448_length_385_cov_1.381119	118	198	27	2	80	0.0250000
NODE_86448_length_385_cov_1.381119	118	198	28	32	80	0.4000000
NODE_86448_length_385_cov_1.381119	118	198	29	1	80	0.0125000
NODE_86448_length_385_cov_1.381119	118	198	30	10	80	0.1250000
NODE_86448_length_385_cov_1.381119	118	198	32	1	80	0.0125000
NODE_86798_length_384_cov_3.996491	135	217	2	20	82	0.2439024
NODE_86798_length_384_cov_3.996491	135	217	4	37	82	0.4512195
NODE_86798_length_384_cov_3.996491	135	217	6	25	82	0.3048781
NODE_86809_length_384_cov_3.729825	181	228	0	47	47	1.0000000
NODE_86812_length_384_cov_3.715789	145	221	2	5	76	0.0657895
NODE_86812_length_384_cov_3.715789	145	221	4	50	76	0.6578947
NODE_86812_length_384_cov_3.715789	145	221	6	21	76	0.2763158
NODE_86841_length_384_cov_2.996491	147	227	16	2	80	0.0250000
NODE_86841_length_384_cov_2.996491	147	227	18	6	80	0.0750000
NODE_86841_length_384_cov_2.996491	147	227	20	4	80	0.0500000
NODE_86841_length_384_cov_2.996491	147	227	22	9	80	0.1125000
NODE_86841_length_384_cov_2.996491	147	227	24	12	80	0.1500000
NODE_86841_length_384_cov_2.996491	147	227	26	18	80	0.2250000
NODE_86841_length_384_cov_2.996491	147	227	32	2	80	0.0250000
NODE_86841_length_384_cov_2.996491	147	227	34	9	80	0.1125000
NODE_86841_length_384_cov_2.996491	147	227	36	18	80	0.2250000
NODE_86847_length_384_cov_2.835088	65	145	4	1	80	0.0125000
NODE_86847_length_384_cov_2.835088	65	145	6	10	80	0.1250000
NODE_86847_length_384_cov_2.835088	65	145	8	13	80	0.1625000
NODE_86847_length_384_cov_2.835088	65	145	10	3	80	0.0375000
NODE_86847_length_384_cov_2.835088	65	145	12	12	80	0.1500000
NODE_86847_length_384_cov_2.835088	65	145	14	4	80	0.0500000
NODE_86847_length_384_cov_2.835088	65	145	16	24	80	0.3000000
NODE_86847_length_384_cov_2.835088	65	145	17	6	80	0.0750000
NODE_86847_length_384_cov_2.835088	65	145	18	7	80	0.0875000
NODE_86866_length_384_cov_2.575439	151	224	20	14	73	0.1917808
NODE_86866_length_384_cov_2.575439	151	224	22	8	73	0.1095890
NODE_86866_length_384_cov_2.575439	151	224	24	51	73	0.6986302
NODE_86866_length_384_cov_2.575439	197	281	0	9	84	0.1071429
NODE_86866_length_384_cov_2.575439	197	281	4	4	84	0.0476190
NODE_86866_length_384_cov_2.575439	197	281	6	12	84	0.1428571
NODE_86866_length_384_cov_2.575439	197	281	7	1	84	0.0119048
NODE_86866_length_384_cov_2.575439	197	281	8	15	84	0.1785714
NODE_86866_length_384_cov_2.575439	197	281	10	1	84	0.0119048
NODE_86866_length_384_cov_2.575439	197	281	12	5	84	0.0595238
NODE_86866_length_384_cov_2.575439	197	281	14	5	84	0.0595238
NODE_86866_length_384_cov_2.575439	197	281	16	1	84	0.0119048
NODE_86866_length_384_cov_2.575439	197	281	20	18	84	0.2142857
NODE_86866_length_384_cov_2.575439	197	281	22	4	84	0.0476190
NODE_86866_length_384_cov_2.575439	197	281	24	9	84	0.1071429
NODE_86907_length_384_cov_2.231579	78	153	0	75	75	1.0000000
NODE_86942_length_384_cov_1.940351	73	153	0	80	80	1.0000000
NODE_87431_length_383_cov_4.869718	117	197	0	80	80	1.0000000
NODE_87431_length_383_cov_4.869718	170	250	0	80	80	1.0000000
NODE_87432_length_383_cov_4.841549	121	180	0	59	59	1.0000000
NODE_87438_length_383_cov_4.559859	33	109	0	76	76	1.0000000
NODE_87487_length_383_cov_2.940141	185	265	2	1	80	0.0125000
NODE_87487_length_383_cov_2.940141	185	265	4	1	80	0.0125000
NODE_87487_length_383_cov_2.940141	185	265	6	38	80	0.4750000
NODE_87487_length_383_cov_2.940141	185	265	8	40	80	0.5000000
NODE_87495_length_383_cov_2.760563	123	203	269	1	80	0.0125000
NODE_87495_length_383_cov_2.760563	123	203	279	1	80	0.0125000
NODE_87495_length_383_cov_2.760563	123	203	286	2	80	0.0250000
NODE_87495_length_383_cov_2.760563	123	203	297	1	80	0.0125000
NODE_87495_length_383_cov_2.760563	123	203	300	2	80	0.0250000
NODE_87495_length_383_cov_2.760563	123	203	306	7	80	0.0875000
NODE_87495_length_383_cov_2.760563	123	203	309	1	80	0.0125000
NODE_87495_length_383_cov_2.760563	123	203	313	1	80	0.0125000
NODE_87495_length_383_cov_2.760563	123	203	316	3	80	0.0375000
NODE_87495_length_383_cov_2.760563	123	203	318	2	80	0.0250000
NODE_87495_length_383_cov_2.760563	123	203	320	3	80	0.0375000
NODE_87495_length_383_cov_2.760563	123	203	321	1	80	0.0125000
NODE_87495_length_383_cov_2.760563	123	203	324	4	80	0.0500000
NODE_87495_length_383_cov_2.760563	123	203	325	1	80	0.0125000
NODE_87495_length_383_cov_2.760563	123	203	328	1	80	0.0125000
NODE_87495_length_383_cov_2.760563	123	203	329	1	80	0.0125000
NODE_87495_length_383_cov_2.760563	123	203	330	1	80	0.0125000
NODE_87495_length_383_cov_2.760563	123	203	335	1	80	0.0125000
NODE_87495_length_383_cov_2.760563	123	203	338	1	80	0.0125000
NODE_87495_length_383_cov_2.760563	123	203	341	1	80	0.0125000
NODE_87495_length_383_cov_2.760563	123	203	343	1	80	0.0125000
NODE_87495_length_383_cov_2.760563	123	203	345	2	80	0.0250000
NODE_87495_length_383_cov_2.760563	123	203	349	2	80	0.0250000
NODE_87495_length_383_cov_2.760563	123	203	351	1	80	0.0125000
NODE_87495_length_383_cov_2.760563	123	203	353	1	80	0.0125000
NODE_87495_length_383_cov_2.760563	123	203	354	1	80	0.0125000
NODE_87495_length_383_cov_2.760563	123	203	359	2	80	0.0250000
NODE_87495_length_383_cov_2.760563	123	203	361	1	80	0.0125000
NODE_87495_length_383_cov_2.760563	123	203	362	1	80	0.0125000
NODE_87495_length_383_cov_2.760563	123	203	369	4	80	0.0500000
NODE_87495_length_383_cov_2.760563	123	203	371	3	80	0.0375000
NODE_87495_length_383_cov_2.760563	123	203	372	1	80	0.0125000
NODE_87495_length_383_cov_2.760563	123	203	373	2	80	0.0250000
NODE_87495_length_383_cov_2.760563	123	203	375	1	80	0.0125000
NODE_87495_length_383_cov_2.760563	123	203	376	5	80	0.0625000
NODE_87495_length_383_cov_2.760563	123	203	377	2	80	0.0250000
NODE_87495_length_383_cov_2.760563	123	203	378	3	80	0.0375000
NODE_87495_length_383_cov_2.760563	123	203	380	1	80	0.0125000
NODE_87495_length_383_cov_2.760563	123	203	382	1	80	0.0125000
NODE_87495_length_383_cov_2.760563	123	203	385	1	80	0.0125000
NODE_87495_length_383_cov_2.760563	123	203	389	1	80	0.0125000
NODE_87495_length_383_cov_2.760563	123	203	390	3	80	0.0375000
NODE_87495_length_383_cov_2.760563	123	203	393	2	80	0.0250000
NODE_87495_length_383_cov_2.760563	123	203	396	1	80	0.0125000
NODE_87495_length_383_cov_2.760563	123	203	398	1	80	0.0125000
NODE_87495_length_383_cov_2.760563	169	249	113	1	80	0.0125000
NODE_87495_length_383_cov_2.760563	169	249	116	1	80	0.0125000
NODE_87495_length_383_cov_2.760563	169	249	121	1	80	0.0125000
NODE_87495_length_383_cov_2.760563	169	249	127	1	80	0.0125000
NODE_87495_length_383_cov_2.760563	169	249	141	1	80	0.0125000
NODE_87495_length_383_cov_2.760563	169	249	145	1	80	0.0125000
NODE_87495_length_383_cov_2.760563	169	249	146	1	80	0.0125000
NODE_87495_length_383_cov_2.760563	169	249	156	1	80	0.0125000
NODE_87495_length_383_cov_2.760563	169	249	160	2	80	0.0250000
NODE_87495_length_383_cov_2.760563	169	249	163	2	80	0.0250000
NODE_87495_length_383_cov_2.760563	169	249	165	2	80	0.0250000
NODE_87495_length_383_cov_2.760563	169	249	171	1	80	0.0125000
NODE_87495_length_383_cov_2.760563	169	249	176	2	80	0.0250000
NODE_87495_length_383_cov_2.760563	169	249	183	1	80	0.0125000
NODE_87495_length_383_cov_2.760563	169	249	185	1	80	0.0125000
NODE_87495_length_383_cov_2.760563	169	249	187	1	80	0.0125000
NODE_87495_length_383_cov_2.760563	169	249	194	1	80	0.0125000
NODE_87495_length_383_cov_2.760563	169	249	200	1	80	0.0125000
NODE_87495_length_383_cov_2.760563	169	249	203	1	80	0.0125000
NODE_87495_length_383_cov_2.760563	169	249	206	2	80	0.0250000
NODE_87495_length_383_cov_2.760563	169	249	208	1	80	0.0125000
NODE_87495_length_383_cov_2.760563	169	249	218	5	80	0.0625000
NODE_87495_length_383_cov_2.760563	169	249	219	2	80	0.0250000
NODE_87495_length_383_cov_2.760563	169	249	221	3	80	0.0375000
NODE_87495_length_383_cov_2.760563	169	249	222	1	80	0.0125000
NODE_87495_length_383_cov_2.760563	169	249	227	1	80	0.0125000
NODE_87495_length_383_cov_2.760563	169	249	239	2	80	0.0250000
NODE_87495_length_383_cov_2.760563	169	249	243	2	80	0.0250000
NODE_87495_length_383_cov_2.760563	169	249	245	1	80	0.0125000
NODE_87495_length_383_cov_2.760563	169	249	247	1	80	0.0125000
NODE_87495_length_383_cov_2.760563	169	249	249	1	80	0.0125000
NODE_87495_length_383_cov_2.760563	169	249	257	1	80	0.0125000
NODE_87495_length_383_cov_2.760563	169	249	269	1	80	0.0125000
NODE_87495_length_383_cov_2.760563	169	249	279	1	80	0.0125000
NODE_87495_length_383_cov_2.760563	169	249	286	2	80	0.0250000
NODE_87495_length_383_cov_2.760563	169	249	297	1	80	0.0125000
NODE_87495_length_383_cov_2.760563	169	249	300	2	80	0.0250000
NODE_87495_length_383_cov_2.760563	169	249	306	7	80	0.0875000
NODE_87495_length_383_cov_2.760563	169	249	309	1	80	0.0125000
NODE_87495_length_383_cov_2.760563	169	249	324	1	80	0.0125000
NODE_87495_length_383_cov_2.760563	169	249	330	1	80	0.0125000
NODE_87495_length_383_cov_2.760563	169	249	338	1	80	0.0125000
NODE_87495_length_383_cov_2.760563	169	249	343	1	80	0.0125000
NODE_87495_length_383_cov_2.760563	169	249	345	1	80	0.0125000
NODE_87495_length_383_cov_2.760563	169	249	349	1	80	0.0125000
NODE_87495_length_383_cov_2.760563	169	249	353	1	80	0.0125000
NODE_87495_length_383_cov_2.760563	169	249	354	1	80	0.0125000
NODE_87495_length_383_cov_2.760563	169	249	359	1	80	0.0125000
NODE_87495_length_383_cov_2.760563	169	249	361	1	80	0.0125000
NODE_87495_length_383_cov_2.760563	169	249	362	1	80	0.0125000
NODE_87495_length_383_cov_2.760563	169	249	372	1	80	0.0125000
NODE_87495_length_383_cov_2.760563	169	249	376	2	80	0.0250000
NODE_87495_length_383_cov_2.760563	169	249	378	3	80	0.0375000
NODE_87495_length_383_cov_2.760563	169	249	380	1	80	0.0125000
NODE_87495_length_383_cov_2.760563	169	249	382	1	80	0.0125000
NODE_87495_length_383_cov_2.760563	222	302	4	7	80	0.0875000
NODE_87495_length_383_cov_2.760563	222	302	6	10	80	0.1250000
NODE_87495_length_383_cov_2.760563	222	302	8	8	80	0.1000000
NODE_87495_length_383_cov_2.760563	222	302	9	1	80	0.0125000
NODE_87495_length_383_cov_2.760563	222	302	10	3	80	0.0375000
NODE_87495_length_383_cov_2.760563	222	302	11	2	80	0.0250000
NODE_87495_length_383_cov_2.760563	222	302	14	1	80	0.0125000
NODE_87495_length_383_cov_2.760563	222	302	21	1	80	0.0125000
NODE_87495_length_383_cov_2.760563	222	302	22	1	80	0.0125000
NODE_87495_length_383_cov_2.760563	222	302	23	5	80	0.0625000
NODE_87495_length_383_cov_2.760563	222	302	39	1	80	0.0125000
NODE_87495_length_383_cov_2.760563	222	302	74	3	80	0.0375000
NODE_87495_length_383_cov_2.760563	222	302	83	1	80	0.0125000
NODE_87495_length_383_cov_2.760563	222	302	87	1	80	0.0125000
NODE_87495_length_383_cov_2.760563	222	302	89	2	80	0.0250000
NODE_87495_length_383_cov_2.760563	222	302	92	2	80	0.0250000
NODE_87495_length_383_cov_2.760563	222	302	98	1	80	0.0125000
NODE_87495_length_383_cov_2.760563	222	302	99	1	80	0.0125000
NODE_87495_length_383_cov_2.760563	222	302	105	2	80	0.0250000
NODE_87495_length_383_cov_2.760563	222	302	113	1	80	0.0125000
NODE_87495_length_383_cov_2.760563	222	302	116	1	80	0.0125000
NODE_87495_length_383_cov_2.760563	222	302	121	1	80	0.0125000
NODE_87495_length_383_cov_2.760563	222	302	127	1	80	0.0125000
NODE_87495_length_383_cov_2.760563	222	302	141	1	80	0.0125000
NODE_87495_length_383_cov_2.760563	222	302	145	1	80	0.0125000
NODE_87495_length_383_cov_2.760563	222	302	146	1	80	0.0125000
NODE_87495_length_383_cov_2.760563	222	302	156	1	80	0.0125000
NODE_87495_length_383_cov_2.760563	222	302	160	2	80	0.0250000
NODE_87495_length_383_cov_2.760563	222	302	163	2	80	0.0250000
NODE_87495_length_383_cov_2.760563	222	302	165	2	80	0.0250000
NODE_87495_length_383_cov_2.760563	222	302	171	1	80	0.0125000
NODE_87495_length_383_cov_2.760563	222	302	176	2	80	0.0250000
NODE_87495_length_383_cov_2.760563	222	302	183	1	80	0.0125000
NODE_87495_length_383_cov_2.760563	222	302	185	1	80	0.0125000
NODE_87495_length_383_cov_2.760563	222	302	187	1	80	0.0125000
NODE_87495_length_383_cov_2.760563	222	302	194	1	80	0.0125000
NODE_87495_length_383_cov_2.760563	222	302	200	1	80	0.0125000
NODE_87495_length_383_cov_2.760563	222	302	203	1	80	0.0125000
NODE_87495_length_383_cov_2.760563	222	302	206	2	80	0.0250000
NODE_87495_length_383_cov_2.760563	222	302	208	1	80	0.0125000
NODE_87495_length_383_cov_2.760563	222	302	218	1	80	0.0125000
NODE_87566_length_383_cov_2.123239	29	94	0	65	65	1.0000000
NODE_87566_length_383_cov_2.123239	93	173	0	72	80	0.9000000
NODE_87566_length_383_cov_2.123239	93	173	1	8	80	0.1000000
NODE_87566_length_383_cov_2.123239	146	193	0	19	47	0.4042553
NODE_87566_length_383_cov_2.123239	146	193	1	28	47	0.5957447
NODE_87634_length_383_cov_1.728873	196	257	25	2	61	0.0327869
NODE_87634_length_383_cov_1.728873	196	257	26	7	61	0.1147541
NODE_87634_length_383_cov_1.728873	196	257	27	1	61	0.0163934
NODE_87634_length_383_cov_1.728873	196	257	28	3	61	0.0491803
NODE_87634_length_383_cov_1.728873	196	257	30	3	61	0.0491803
NODE_87634_length_383_cov_1.728873	196	257	32	7	61	0.1147541
NODE_87634_length_383_cov_1.728873	196	257	33	15	61	0.2459016
NODE_87634_length_383_cov_1.728873	196	257	34	13	61	0.2131148
NODE_87634_length_383_cov_1.728873	196	257	35	4	61	0.0655738
NODE_87634_length_383_cov_1.728873	196	257	36	6	61	0.0983607
NODE_87634_length_383_cov_1.728873	239	310	16	1	71	0.0140845
NODE_87634_length_383_cov_1.728873	239	310	18	8	71	0.1126761
NODE_87634_length_383_cov_1.728873	239	310	20	19	71	0.2676056
NODE_87634_length_383_cov_1.728873	239	310	21	3	71	0.0422535
NODE_87634_length_383_cov_1.728873	239	310	22	14	71	0.1971831
NODE_87634_length_383_cov_1.728873	239	310	23	2	71	0.0281690
NODE_87634_length_383_cov_1.728873	239	310	24	4	71	0.0563380
NODE_87634_length_383_cov_1.728873	239	310	25	4	71	0.0563380
NODE_87634_length_383_cov_1.728873	239	310	26	7	71	0.0985916
NODE_87634_length_383_cov_1.728873	239	310	27	1	71	0.0140845
NODE_87634_length_383_cov_1.728873	239	310	28	3	71	0.0422535
NODE_87634_length_383_cov_1.728873	239	310	30	3	71	0.0422535
NODE_87634_length_383_cov_1.728873	239	310	32	2	71	0.0281690
NODE_88039_length_382_cov_43.724382	245	325	0	70	80	0.8750000
NODE_88039_length_382_cov_43.724382	245	325	2	10	80	0.1250000
NODE_88039_length_382_cov_43.724382	298	378	0	80	80	1.0000000
NODE_88040_length_382_cov_35.908127	163	243	0	80	80	1.0000000
NODE_88040_length_382_cov_35.908127	216	296	0	80	80	1.0000000
NODE_88040_length_382_cov_35.908127	292	372	0	80	80	1.0000000
NODE_88041_length_382_cov_26.240283	57	137	0	80	80	1.0000000
NODE_88041_length_382_cov_26.240283	110	190	0	80	80	1.0000000
NODE_88054_length_382_cov_5.583039	63	143	0	80	80	1.0000000
NODE_88054_length_382_cov_5.583039	116	196	0	80	80	1.0000000
NODE_88063_length_382_cov_4.837456	19	78	0	59	59	1.0000000
NODE_88067_length_382_cov_4.618375	0	55	0	4	55	0.0727273
NODE_88067_length_382_cov_4.618375	0	55	1	11	55	0.2000000
NODE_88067_length_382_cov_4.618375	0	55	2	3	55	0.0545455
NODE_88067_length_382_cov_4.618375	0	55	4	37	55	0.6727273
NODE_88067_length_382_cov_4.618375	104	184	6	2	80	0.0250000
NODE_88067_length_382_cov_4.618375	104	184	8	4	80	0.0500000
NODE_88067_length_382_cov_4.618375	104	184	10	1	80	0.0125000
NODE_88067_length_382_cov_4.618375	104	184	12	14	80	0.1750000
NODE_88067_length_382_cov_4.618375	104	184	14	13	80	0.1625000
NODE_88067_length_382_cov_4.618375	104	184	15	10	80	0.1250000
NODE_88067_length_382_cov_4.618375	104	184	16	27	80	0.3375000
NODE_88067_length_382_cov_4.618375	104	184	17	9	80	0.1125000
NODE_88067_length_382_cov_4.618375	157	237	15	17	80	0.2125000
NODE_88067_length_382_cov_4.618375	157	237	16	18	80	0.2250000
NODE_88067_length_382_cov_4.618375	157	237	17	14	80	0.1750000
NODE_88067_length_382_cov_4.618375	157	237	18	9	80	0.1125000
NODE_88067_length_382_cov_4.618375	157	237	19	15	80	0.1875000
NODE_88067_length_382_cov_4.618375	157	237	20	1	80	0.0125000
NODE_88067_length_382_cov_4.618375	157	237	21	6	80	0.0750000
NODE_88075_length_382_cov_4.268551	71	152	0	81	81	1.0000000
NODE_88075_length_382_cov_4.268551	124	205	0	81	81	1.0000000
NODE_88080_length_382_cov_4.091873	30	92	0	62	62	1.0000000
NODE_88121_length_382_cov_3.031802	173	253	0	10	80	0.1250000
NODE_88121_length_382_cov_3.031802	173	253	2	6	80	0.0750000
NODE_88121_length_382_cov_3.031802	173	253	3	8	80	0.1000000
NODE_88121_length_382_cov_3.031802	173	253	4	31	80	0.3875000
NODE_88121_length_382_cov_3.031802	173	253	6	1	80	0.0125000
NODE_88121_length_382_cov_3.031802	173	253	8	1	80	0.0125000
NODE_88121_length_382_cov_3.031802	173	253	10	7	80	0.0875000
NODE_88121_length_382_cov_3.031802	173	253	12	16	80	0.2000000
NODE_88121_length_382_cov_3.031802	226	295	4	2	69	0.0289855
NODE_88121_length_382_cov_3.031802	226	295	6	1	69	0.0144928
NODE_88121_length_382_cov_3.031802	226	295	8	1	69	0.0144928
NODE_88121_length_382_cov_3.031802	226	295	10	24	69	0.3478261
NODE_88121_length_382_cov_3.031802	226	295	12	41	69	0.5942029
NODE_88135_length_382_cov_2.798587	231	293	0	62	62	1.0000000
NODE_88136_length_382_cov_2.791519	195	244	2	27	49	0.5510204
NODE_88136_length_382_cov_2.791519	195	244	4	1	49	0.0204082
NODE_88136_length_382_cov_2.791519	195	244	6	21	49	0.4285714
NODE_88136_length_382_cov_2.791519	217	297	2	5	80	0.0625000
NODE_88136_length_382_cov_2.791519	217	297	4	1	80	0.0125000
NODE_88136_length_382_cov_2.791519	217	297	6	74	80	0.9250000
NODE_88164_length_382_cov_2.611307	301	368	0	67	67	1.0000000
NODE_88276_length_382_cov_1.802120	0	60	0	60	60	1.0000000
NODE_88660_length_382_cov_0.738516	48	95	30	1	47	0.0212766
NODE_88660_length_382_cov_0.738516	48	95	31	1	47	0.0212766
NODE_88660_length_382_cov_0.738516	48	95	33	11	47	0.2340426
NODE_88660_length_382_cov_0.738516	48	95	34	34	47	0.7234042
NODE_88660_length_382_cov_0.738516	68	148	34	80	80	1.0000000
NODE_88758_length_381_cov_12.010638	195	274	2	23	79	0.2911392
NODE_88758_length_381_cov_12.010638	195	274	4	56	79	0.7088608
NODE_88865_length_381_cov_2.606383	68	98	2	30	30	1.0000000
NODE_88867_length_381_cov_2.570922	115	175	0	60	60	1.0000000
NODE_88872_length_381_cov_2.514184	225	307	0	10	82	0.1219512
NODE_88872_length_381_cov_2.514184	225	307	2	36	82	0.4390244
NODE_88872_length_381_cov_2.514184	225	307	4	4	82	0.0487805
NODE_88872_length_381_cov_2.514184	225	307	6	32	82	0.3902439
NODE_88900_length_381_cov_2.198582	193	276	0	57	83	0.6867470
NODE_88900_length_381_cov_2.198582	193	276	2	26	83	0.3132530
NODE_88935_length_381_cov_1.989362	279	325	0	46	46	1.0000000
NODE_89009_length_381_cov_1.663121	51	128	9	5	77	0.0649351
NODE_89009_length_381_cov_1.663121	51	128	13	23	77	0.2987013
NODE_89009_length_381_cov_1.663121	51	128	14	5	77	0.0649351
NODE_89009_length_381_cov_1.663121	51	128	16	22	77	0.2857143
NODE_89009_length_381_cov_1.663121	51	128	18	22	77	0.2857143
NODE_89009_length_381_cov_1.663121	101	181	9	2	80	0.0250000
NODE_89009_length_381_cov_1.663121	101	181	10	18	80	0.2250000
NODE_89009_length_381_cov_1.663121	101	181	11	5	80	0.0625000
NODE_89009_length_381_cov_1.663121	101	181	13	3	80	0.0375000
NODE_89009_length_381_cov_1.663121	101	181	16	13	80	0.1625000
NODE_89009_length_381_cov_1.663121	101	181	18	39	80	0.4875000
NODE_89090_length_381_cov_1.400709	254	334	0	31	80	0.3875000
NODE_89090_length_381_cov_1.400709	254	334	2	2	80	0.0250000
NODE_89090_length_381_cov_1.400709	254	334	4	47	80	0.5875000
NODE_89090_length_381_cov_1.400709	254	334	0	31	80	0.3875000
NODE_89090_length_381_cov_1.400709	254	334	2	2	80	0.0250000
NODE_89090_length_381_cov_1.400709	254	334	4	47	80	0.5875000
NODE_89090_length_381_cov_1.400709	309	373	0	2	64	0.0312500
NODE_89090_length_381_cov_1.400709	309	373	2	16	64	0.2500000
NODE_89090_length_381_cov_1.400709	309	373	4	46	64	0.7187500
NODE_89482_length_380_cov_57.604982	196	276	1	21	80	0.2625000
NODE_89482_length_380_cov_57.604982	196	276	3	11	80	0.1375000
NODE_89482_length_380_cov_57.604982	196	276	4	24	80	0.3000000
NODE_89482_length_380_cov_57.604982	196	276	6	24	80	0.3000000
NODE_89482_length_380_cov_57.604982	249	329	1	19	80	0.2375000
NODE_89482_length_380_cov_57.604982	249	329	2	41	80	0.5125000
NODE_89482_length_380_cov_57.604982	249	329	3	20	80	0.2500000
NODE_89482_length_380_cov_57.604982	325	359	0	30	34	0.8823529
NODE_89482_length_380_cov_57.604982	325	359	2	4	34	0.1176471
NODE_89483_length_380_cov_11.185053	79	161	0	82	82	1.0000000
NODE_89483_length_380_cov_11.185053	134	214	0	38	80	0.4750000
NODE_89483_length_380_cov_11.185053	134	214	2	42	80	0.5250000
NODE_89491_length_380_cov_5.811388	100	156	2	56	56	1.0000000
NODE_89491_length_380_cov_5.811388	177	213	0	20	36	0.5555556
NODE_89491_length_380_cov_5.811388	177	213	2	16	36	0.4444444
NODE_89495_length_380_cov_5.377224	242	271	77	3	29	0.1034483
NODE_89495_length_380_cov_5.377224	242	271	78	5	29	0.1724138
NODE_89495_length_380_cov_5.377224	242	271	80	2	29	0.0689655
NODE_89495_length_380_cov_5.377224	242	271	81	3	29	0.1034483
NODE_89495_length_380_cov_5.377224	242	271	83	13	29	0.4482759
NODE_89495_length_380_cov_5.377224	242	271	85	2	29	0.0689655
NODE_89495_length_380_cov_5.377224	242	271	87	1	29	0.0344828
NODE_89508_length_380_cov_4.185053	158	230	0	1	72	0.0138889
NODE_89508_length_380_cov_4.185053	158	230	2	71	72	0.9861111
NODE_89508_length_380_cov_4.185053	159	229	2	70	70	1.0000000
NODE_89508_length_380_cov_4.185053	203	283	0	54	80	0.6750000
NODE_89508_length_380_cov_4.185053	203	283	2	26	80	0.3250000
NODE_89508_length_380_cov_4.185053	203	283	0	54	80	0.6750000
NODE_89508_length_380_cov_4.185053	203	283	2	26	80	0.3250000
NODE_89527_length_380_cov_3.423488	164	233	2	17	69	0.2463768
NODE_89527_length_380_cov_3.423488	164	233	4	52	69	0.7536232
NODE_89540_length_380_cov_3.153025	188	260	12	15	72	0.2083333
NODE_89540_length_380_cov_3.153025	188	260	14	12	72	0.1666667
NODE_89540_length_380_cov_3.153025	188	260	16	45	72	0.6250000
NODE_89568_length_380_cov_2.718861	51	131	0	80	80	1.0000000
NODE_89568_length_380_cov_2.718861	104	184	0	80	80	1.0000000
NODE_89658_length_380_cov_1.943060	22	56	4	5	34	0.1470588
NODE_89658_length_380_cov_1.943060	22	56	6	1	34	0.0294118
NODE_89658_length_380_cov_1.943060	22	56	8	19	34	0.5588235
NODE_89658_length_380_cov_1.943060	22	56	10	7	34	0.2058824
NODE_89658_length_380_cov_1.943060	22	56	12	2	34	0.0588235
NODE_89750_length_380_cov_1.601423	292	332	62	1	40	0.0250000
NODE_89750_length_380_cov_1.601423	292	332	63	1	40	0.0250000
NODE_89750_length_380_cov_1.601423	292	332	65	2	40	0.0500000
NODE_89750_length_380_cov_1.601423	292	332	67	4	40	0.1000000
NODE_89750_length_380_cov_1.601423	292	332	69	1	40	0.0250000
NODE_89750_length_380_cov_1.601423	292	332	71	1	40	0.0250000
NODE_89750_length_380_cov_1.601423	292	332	72	1	40	0.0250000
NODE_89750_length_380_cov_1.601423	292	332	76	2	40	0.0500000
NODE_89750_length_380_cov_1.601423	292	332	85	1	40	0.0250000
NODE_89750_length_380_cov_1.601423	292	332	91	1	40	0.0250000
NODE_89750_length_380_cov_1.601423	292	332	92	1	40	0.0250000
NODE_89750_length_380_cov_1.601423	292	332	96	2	40	0.0500000
NODE_89750_length_380_cov_1.601423	292	332	100	2	40	0.0500000
NODE_89750_length_380_cov_1.601423	292	332	102	1	40	0.0250000
NODE_89750_length_380_cov_1.601423	292	332	104	1	40	0.0250000
NODE_89750_length_380_cov_1.601423	292	332	106	1	40	0.0250000
NODE_89750_length_380_cov_1.601423	292	332	110	1	40	0.0250000
NODE_89750_length_380_cov_1.601423	292	332	113	1	40	0.0250000
NODE_89750_length_380_cov_1.601423	292	332	116	3	40	0.0750000
NODE_89750_length_380_cov_1.601423	292	332	124	1	40	0.0250000
NODE_89750_length_380_cov_1.601423	292	332	127	2	40	0.0500000
NODE_89750_length_380_cov_1.601423	292	332	129	1	40	0.0250000
NODE_89750_length_380_cov_1.601423	292	332	132	1	40	0.0250000
NODE_89750_length_380_cov_1.601423	292	332	133	2	40	0.0500000
NODE_89750_length_380_cov_1.601423	292	332	141	1	40	0.0250000
NODE_89750_length_380_cov_1.601423	292	332	143	2	40	0.0500000
NODE_89750_length_380_cov_1.601423	292	332	147	1	40	0.0250000
NODE_89750_length_380_cov_1.601423	292	332	148	1	40	0.0250000
NODE_89911_length_380_cov_1.088968	312	353	0	41	41	1.0000000
NODE_89911_length_380_cov_1.088968	326	380	0	54	54	1.0000000
NODE_90152_length_379_cov_42.339286	10	90	0	80	80	1.0000000
NODE_90152_length_379_cov_42.339286	86	166	0	80	80	1.0000000
NODE_90152_length_379_cov_42.339286	139	219	0	80	80	1.0000000
NODE_90153_length_379_cov_32.075000	0	62	0	62	62	1.0000000
NODE_90165_length_379_cov_5.607143	279	338	0	59	59	1.0000000
NODE_90180_length_379_cov_4.432143	219	243	0	24	24	1.0000000
NODE_90193_length_379_cov_3.778571	271	300	0	29	29	1.0000000
NODE_90198_length_379_cov_3.585714	128	152	0	24	24	1.0000000
NODE_90198_length_379_cov_3.585714	169	249	0	80	80	1.0000000
NODE_90203_length_379_cov_3.375000	19	43	6	24	24	1.0000000
NODE_90247_length_379_cov_2.692857	121	201	13	1	80	0.0125000
NODE_90247_length_379_cov_2.692857	121	201	16	79	80	0.9875000
NODE_90247_length_379_cov_2.692857	174	221	3	3	47	0.0638298
NODE_90247_length_379_cov_2.692857	174	221	5	4	47	0.0851064
NODE_90247_length_379_cov_2.692857	174	221	9	4	47	0.0851064
NODE_90247_length_379_cov_2.692857	174	221	13	10	47	0.2127660
NODE_90247_length_379_cov_2.692857	174	221	16	26	47	0.5531915
NODE_90789_length_378_cov_53.039427	147	227	0	80	80	1.0000000
NODE_90789_length_378_cov_53.039427	200	280	0	80	80	1.0000000
NODE_90789_length_378_cov_53.039427	276	356	0	80	80	1.0000000
NODE_90789_length_378_cov_53.039427	329	378	0	49	49	1.0000000
NODE_90794_length_378_cov_6.569892	223	304	9	1	81	0.0123457
NODE_90794_length_378_cov_6.569892	223	304	11	3	81	0.0370370
NODE_90794_length_378_cov_6.569892	223	304	15	9	81	0.1111111
NODE_90794_length_378_cov_6.569892	223	304	16	2	81	0.0246914
NODE_90794_length_378_cov_6.569892	223	304	17	15	81	0.1851852
NODE_90794_length_378_cov_6.569892	223	304	18	41	81	0.5061728
NODE_90794_length_378_cov_6.569892	223	304	19	7	81	0.0864198
NODE_90794_length_378_cov_6.569892	223	304	20	3	81	0.0370370
NODE_90795_length_378_cov_6.444444	217	297	0	80	80	1.0000000
NODE_90795_length_378_cov_6.444444	270	350	0	80	80	1.0000000
NODE_90808_length_378_cov_4.899642	135	191	10	2	56	0.0357143
NODE_90808_length_378_cov_4.899642	135	191	12	54	56	0.9642857
NODE_90855_length_378_cov_3.236559	143	212	14	5	69	0.0724638
NODE_90855_length_378_cov_3.236559	143	212	16	64	69	0.9275362
NODE_90859_length_378_cov_3.132616	238	280	0	24	42	0.5714286
NODE_90859_length_378_cov_3.132616	238	280	2	18	42	0.4285714
NODE_90898_length_378_cov_2.534050	203	243	4	40	40	1.0000000
NODE_90898_length_378_cov_2.534050	271	347	0	76	76	1.0000000
NODE_90898_length_378_cov_2.534050	331	360	0	29	29	1.0000000
NODE_90948_length_378_cov_2.093190	179	250	4	63	71	0.8873239
NODE_90948_length_378_cov_2.093190	179	250	6	8	71	0.1126761
NODE_90948_length_378_cov_2.093190	183	219	4	28	36	0.7777778
NODE_90948_length_378_cov_2.093190	183	219	6	8	36	0.2222222
NODE_91002_length_378_cov_1.813620	36	89	0	53	53	1.0000000
NODE_91475_length_377_cov_71.723022	19	99	0	20	80	0.2500000
NODE_91475_length_377_cov_71.723022	19	99	2	40	80	0.5000000
NODE_91475_length_377_cov_71.723022	19	99	4	20	80	0.2500000
NODE_91475_length_377_cov_71.723022	72	152	2	7	80	0.0875000
NODE_91475_length_377_cov_71.723022	72	152	4	73	80	0.9125000
NODE_91475_length_377_cov_71.723022	148	228	4	5	80	0.0625000
NODE_91475_length_377_cov_71.723022	148	228	5	10	80	0.1250000
NODE_91475_length_377_cov_71.723022	148	228	7	14	80	0.1750000
NODE_91475_length_377_cov_71.723022	148	228	11	39	80	0.4875000
NODE_91475_length_377_cov_71.723022	148	228	13	12	80	0.1500000
NODE_91475_length_377_cov_71.723022	201	281	9	1	80	0.0125000
NODE_91475_length_377_cov_71.723022	201	281	11	28	80	0.3500000
NODE_91475_length_377_cov_71.723022	201	281	13	51	80	0.6375000
NODE_91477_length_377_cov_41.787770	210	290	0	19	80	0.2375000
NODE_91477_length_377_cov_41.787770	210	290	2	61	80	0.7625000
NODE_91477_length_377_cov_41.787770	263	343	0	72	80	0.9000000
NODE_91477_length_377_cov_41.787770	263	343	2	8	80	0.1000000
NODE_91478_length_377_cov_9.982014	32	83	6	27	51	0.5294118
NODE_91478_length_377_cov_9.982014	32	83	8	24	51	0.4705882
NODE_91486_length_377_cov_6.244604	101	177	2	2	76	0.0263158
NODE_91486_length_377_cov_6.244604	101	177	3	1	76	0.0131579
NODE_91486_length_377_cov_6.244604	101	177	4	25	76	0.3289474
NODE_91486_length_377_cov_6.244604	101	177	6	48	76	0.6315789
NODE_91494_length_377_cov_5.183453	169	224	0	55	55	1.0000000
NODE_91499_length_377_cov_4.586331	186	266	0	80	80	1.0000000
NODE_91499_length_377_cov_4.586331	239	319	0	80	80	1.0000000
NODE_91500_length_377_cov_4.431655	139	216	0	77	77	1.0000000
NODE_91502_length_377_cov_4.330935	134	214	0	80	80	1.0000000
NODE_91502_length_377_cov_4.330935	187	267	0	80	80	1.0000000
NODE_91506_length_377_cov_4.032374	124	181	6	34	57	0.5964912
NODE_91506_length_377_cov_4.032374	124	181	8	23	57	0.4035088
NODE_91506_length_377_cov_4.032374	154	201	4	1	47	0.0212766
NODE_91506_length_377_cov_4.032374	154	201	6	46	47	0.9787234
NODE_91526_length_377_cov_3.615108	82	140	0	58	58	1.0000000
NODE_91526_length_377_cov_3.615108	82	140	0	58	58	1.0000000
NODE_91526_length_377_cov_3.615108	113	193	0	80	80	1.0000000
NODE_91526_length_377_cov_3.615108	113	193	0	80	80	1.0000000
NODE_91526_length_377_cov_3.615108	189	258	0	69	69	1.0000000
NODE_91526_length_377_cov_3.615108	243	313	0	70	70	1.0000000
NODE_91553_length_377_cov_2.913669	38	61	0	23	23	1.0000000
NODE_91553_length_377_cov_2.913669	167	228	0	61	61	1.0000000
NODE_91619_length_377_cov_2.104317	137	188	0	51	51	1.0000000
NODE_91619_length_377_cov_2.104317	168	211	0	43	43	1.0000000
NODE_91619_length_377_cov_2.104317	190	241	0	51	51	1.0000000
NODE_91727_length_377_cov_1.622302	123	181	4	58	58	1.0000000
NODE_91727_length_377_cov_1.622302	176	234	0	37	58	0.6379310
NODE_91727_length_377_cov_1.622302	176	234	2	1	58	0.0172414
NODE_91727_length_377_cov_1.622302	176	234	4	20	58	0.3448276
NODE_91749_length_377_cov_1.539568	230	310	1	1	80	0.0125000
NODE_91749_length_377_cov_1.539568	230	310	2	13	80	0.1625000
NODE_91749_length_377_cov_1.539568	230	310	4	57	80	0.7125000
NODE_91749_length_377_cov_1.539568	230	310	5	1	80	0.0125000
NODE_91749_length_377_cov_1.539568	230	310	6	3	80	0.0375000
NODE_91749_length_377_cov_1.539568	230	310	8	5	80	0.0625000
NODE_91749_length_377_cov_1.539568	230	310	1	1	80	0.0125000
NODE_91749_length_377_cov_1.539568	230	310	2	13	80	0.1625000
NODE_91749_length_377_cov_1.539568	230	310	4	57	80	0.7125000
NODE_91749_length_377_cov_1.539568	230	310	5	1	80	0.0125000
NODE_91749_length_377_cov_1.539568	230	310	6	3	80	0.0375000
NODE_91749_length_377_cov_1.539568	230	310	8	5	80	0.0625000
NODE_91749_length_377_cov_1.539568	306	377	0	45	71	0.6338028
NODE_91749_length_377_cov_1.539568	306	377	1	23	71	0.3239437
NODE_91749_length_377_cov_1.539568	306	377	2	3	71	0.0422535
NODE_91749_length_377_cov_1.539568	327	351	0	19	24	0.7916667
NODE_91749_length_377_cov_1.539568	327	351	1	5	24	0.2083333
NODE_91765_length_377_cov_1.471223	118	198	23	1	80	0.0125000
NODE_91765_length_377_cov_1.471223	118	198	25	1	80	0.0125000
NODE_91765_length_377_cov_1.471223	118	198	36	8	80	0.1000000
NODE_91765_length_377_cov_1.471223	118	198	37	5	80	0.0625000
NODE_91765_length_377_cov_1.471223	118	198	41	2	80	0.0250000
NODE_91765_length_377_cov_1.471223	118	198	45	2	80	0.0250000
NODE_91765_length_377_cov_1.471223	118	198	46	4	80	0.0500000
NODE_91765_length_377_cov_1.471223	118	198	47	3	80	0.0375000
NODE_91765_length_377_cov_1.471223	118	198	48	2	80	0.0250000
NODE_91765_length_377_cov_1.471223	118	198	49	11	80	0.1375000
NODE_91765_length_377_cov_1.471223	118	198	51	3	80	0.0375000
NODE_91765_length_377_cov_1.471223	118	198	52	38	80	0.4750000
NODE_91790_length_377_cov_1.456835	177	257	0	80	80	1.0000000
NODE_91790_length_377_cov_1.456835	230	310	0	80	80	1.0000000
NODE_91817_length_377_cov_1.330935	0	44	0	44	44	1.0000000
NODE_91817_length_377_cov_1.330935	45	117	0	72	72	1.0000000
NODE_92046_length_377_cov_0.762590	299	330	0	31	31	1.0000000
NODE_92166_length_376_cov_6.938628	0	63	14	3	63	0.0476190
NODE_92166_length_376_cov_6.938628	0	63	15	1	63	0.0158730
NODE_92166_length_376_cov_6.938628	0	63	26	7	63	0.1111111
NODE_92166_length_376_cov_6.938628	0	63	28	1	63	0.0158730
NODE_92166_length_376_cov_6.938628	0	63	32	4	63	0.0634921
NODE_92166_length_376_cov_6.938628	0	63	35	5	63	0.0793651
NODE_92166_length_376_cov_6.938628	0	63	37	1	63	0.0158730
NODE_92166_length_376_cov_6.938628	0	63	41	8	63	0.1269841
NODE_92166_length_376_cov_6.938628	0	63	43	3	63	0.0476190
NODE_92166_length_376_cov_6.938628	0	63	45	1	63	0.0158730
NODE_92166_length_376_cov_6.938628	0	63	47	3	63	0.0476190
NODE_92166_length_376_cov_6.938628	0	63	53	6	63	0.0952381
NODE_92166_length_376_cov_6.938628	0	63	55	1	63	0.0158730
NODE_92166_length_376_cov_6.938628	0	63	57	2	63	0.0317460
NODE_92166_length_376_cov_6.938628	0	63	59	1	63	0.0158730
NODE_92166_length_376_cov_6.938628	0	63	61	1	63	0.0158730
NODE_92166_length_376_cov_6.938628	0	63	63	1	63	0.0158730
NODE_92166_length_376_cov_6.938628	0	63	65	1	63	0.0158730
NODE_92166_length_376_cov_6.938628	0	63	67	2	63	0.0317460
NODE_92166_length_376_cov_6.938628	0	63	69	3	63	0.0476190
NODE_92166_length_376_cov_6.938628	0	63	73	1	63	0.0158730
NODE_92166_length_376_cov_6.938628	0	63	75	1	63	0.0158730
NODE_92166_length_376_cov_6.938628	0	63	84	3	63	0.0476190
NODE_92166_length_376_cov_6.938628	0	63	88	3	63	0.0476190
NODE_92166_length_376_cov_6.938628	269	340	18	3	71	0.0422535
NODE_92166_length_376_cov_6.938628	269	340	22	12	71	0.1690141
NODE_92166_length_376_cov_6.938628	269	340	26	12	71	0.1690141
NODE_92166_length_376_cov_6.938628	269	340	28	18	71	0.2535211
NODE_92166_length_376_cov_6.938628	269	340	34	2	71	0.0281690
NODE_92166_length_376_cov_6.938628	269	340	36	2	71	0.0281690
NODE_92166_length_376_cov_6.938628	269	340	38	2	71	0.0281690
NODE_92166_length_376_cov_6.938628	269	340	40	20	71	0.2816902
NODE_92168_length_376_cov_6.415162	177	257	0	25	80	0.3125000
NODE_92168_length_376_cov_6.415162	177	257	2	15	80	0.1875000
NODE_92168_length_376_cov_6.415162	177	257	4	40	80	0.5000000
NODE_92168_length_376_cov_6.415162	230	310	4	80	80	1.0000000
NODE_92173_length_376_cov_5.722022	100	171	8	22	71	0.3098592
NODE_92173_length_376_cov_5.722022	100	171	12	19	71	0.2676056
NODE_92173_length_376_cov_5.722022	100	171	14	30	71	0.4225352
NODE_92173_length_376_cov_5.722022	155	192	4	10	37	0.2702703
NODE_92173_length_376_cov_5.722022	155	192	8	24	37	0.6486486
NODE_92173_length_376_cov_5.722022	155	192	14	3	37	0.0810811
NODE_92191_length_376_cov_4.148014	300	330	6	30	30	1.0000000
NODE_92196_length_376_cov_3.859206	168	236	2	24	68	0.3529412
NODE_92196_length_376_cov_3.859206	168	236	3	2	68	0.0294118
NODE_92196_length_376_cov_3.859206	168	236	4	42	68	0.6176471
NODE_92219_length_376_cov_3.140794	122	188	0	66	66	1.0000000
NODE_92442_length_376_cov_1.516245	57	106	4	49	49	1.0000000
NODE_92879_length_375_cov_4.217391	321	350	2	25	29	0.8620690
NODE_92879_length_375_cov_4.217391	321	350	4	4	29	0.1379310
NODE_92897_length_375_cov_3.699275	287	367	0	80	80	1.0000000
NODE_92911_length_375_cov_3.376812	70	136	1	6	66	0.0909091
NODE_92911_length_375_cov_3.376812	70	136	2	26	66	0.3939394
NODE_92911_length_375_cov_3.376812	70	136	3	34	66	0.5151515
NODE_93031_length_375_cov_2.032609	162	224	4	2	62	0.0322581
NODE_93031_length_375_cov_2.032609	162	224	6	2	62	0.0322581
NODE_93031_length_375_cov_2.032609	162	224	7	1	62	0.0161290
NODE_93031_length_375_cov_2.032609	162	224	9	1	62	0.0161290
NODE_93031_length_375_cov_2.032609	162	224	11	5	62	0.0806452
NODE_93031_length_375_cov_2.032609	162	224	12	13	62	0.2096774
NODE_93031_length_375_cov_2.032609	162	224	14	15	62	0.2419355
NODE_93031_length_375_cov_2.032609	162	224	16	6	62	0.0967742
NODE_93031_length_375_cov_2.032609	162	224	18	2	62	0.0322581
NODE_93031_length_375_cov_2.032609	162	224	24	4	62	0.0645161
NODE_93031_length_375_cov_2.032609	162	224	26	1	62	0.0161290
NODE_93031_length_375_cov_2.032609	162	224	30	10	62	0.1612903
NODE_93031_length_375_cov_2.032609	215	272	24	4	57	0.0701754
NODE_93031_length_375_cov_2.032609	215	272	26	1	57	0.0175439
NODE_93031_length_375_cov_2.032609	215	272	28	25	57	0.4385965
NODE_93031_length_375_cov_2.032609	215	272	30	27	57	0.4736842
NODE_93050_length_375_cov_1.967391	131	190	0	59	59	1.0000000
NODE_93050_length_375_cov_1.967391	184	235	0	51	51	1.0000000
NODE_93081_length_375_cov_1.840580	195	276	0	45	81	0.5555556
NODE_93081_length_375_cov_1.840580	195	276	2	36	81	0.4444444
NODE_93386_length_375_cov_1.000000	320	375	0	55	55	1.0000000
NODE_93609_length_374_cov_4.563636	93	160	12	67	67	1.0000000
NODE_93609_length_374_cov_4.563636	146	213	4	20	67	0.2985075
NODE_93609_length_374_cov_4.563636	146	213	9	18	67	0.2686567
NODE_93609_length_374_cov_4.563636	146	213	12	23	67	0.3432836
NODE_93609_length_374_cov_4.563636	146	213	13	1	67	0.0149254
NODE_93609_length_374_cov_4.563636	146	213	14	5	67	0.0746269
NODE_93612_length_374_cov_4.523636	23	101	0	8	78	0.1025641
NODE_93612_length_374_cov_4.523636	23	101	2	70	78	0.8974359
NODE_93612_length_374_cov_4.523636	81	154	0	53	73	0.7260274
NODE_93612_length_374_cov_4.523636	81	154	2	20	73	0.2739726
NODE_93628_length_374_cov_3.810909	130	189	2	1	59	0.0169492
NODE_93628_length_374_cov_3.810909	130	189	3	1	59	0.0169492
NODE_93628_length_374_cov_3.810909	130	189	4	11	59	0.1864407
NODE_93628_length_374_cov_3.810909	130	189	6	2	59	0.0338983
NODE_93628_length_374_cov_3.810909	130	189	8	8	59	0.1355932
NODE_93628_length_374_cov_3.810909	130	189	12	20	59	0.3389831
NODE_93628_length_374_cov_3.810909	130	189	14	16	59	0.2711864
NODE_93628_length_374_cov_3.810909	162	242	8	11	80	0.1375000
NODE_93628_length_374_cov_3.810909	162	242	10	12	80	0.1500000
NODE_93628_length_374_cov_3.810909	162	242	12	13	80	0.1625000
NODE_93628_length_374_cov_3.810909	162	242	14	44	80	0.5500000
NODE_93630_length_374_cov_3.789091	236	271	1	35	35	1.0000000
NODE_93630_length_374_cov_3.789091	238	280	1	42	42	1.0000000
NODE_93637_length_374_cov_3.458182	190	248	0	54	58	0.9310345
NODE_93637_length_374_cov_3.458182	190	248	2	4	58	0.0689655
NODE_93688_length_374_cov_2.600000	142	217	0	1	75	0.0133333
NODE_93688_length_374_cov_2.600000	142	217	1	4	75	0.0533333
NODE_93688_length_374_cov_2.600000	142	217	5	4	75	0.0533333
NODE_93688_length_374_cov_2.600000	142	217	7	66	75	0.8800000
NODE_93688_length_374_cov_2.600000	190	270	7	38	80	0.4750000
NODE_93688_length_374_cov_2.600000	190	270	9	11	80	0.1375000
NODE_93688_length_374_cov_2.600000	190	270	11	12	80	0.1500000
NODE_93688_length_374_cov_2.600000	190	270	13	19	80	0.2375000
NODE_93718_length_374_cov_2.330909	40	120	2	80	80	1.0000000
NODE_93769_length_374_cov_2.010909	40	105	2	65	65	1.0000000
NODE_93821_length_374_cov_1.796364	254	288	0	34	34	1.0000000
NODE_93852_length_374_cov_1.661818	95	157	2	12	62	0.1935484
NODE_93852_length_374_cov_1.661818	95	157	4	3	62	0.0483871
NODE_93852_length_374_cov_1.661818	95	157	5	22	62	0.3548387
NODE_93852_length_374_cov_1.661818	95	157	6	25	62	0.4032258
NODE_93859_length_374_cov_1.621818	202	254	0	52	52	1.0000000
NODE_93936_length_374_cov_1.360000	211	291	4	27	80	0.3375000
NODE_93936_length_374_cov_1.360000	211	291	5	6	80	0.0750000
NODE_93936_length_374_cov_1.360000	211	291	6	18	80	0.2250000
NODE_93936_length_374_cov_1.360000	211	291	8	4	80	0.0500000
NODE_93936_length_374_cov_1.360000	211	291	10	1	80	0.0125000
NODE_93936_length_374_cov_1.360000	211	291	11	5	80	0.0625000
NODE_93936_length_374_cov_1.360000	211	291	13	6	80	0.0750000
NODE_93936_length_374_cov_1.360000	211	291	15	5	80	0.0625000
NODE_93936_length_374_cov_1.360000	211	291	16	3	80	0.0375000
NODE_93936_length_374_cov_1.360000	211	291	17	5	80	0.0625000
NODE_93981_length_374_cov_1.236364	263	336	0	73	73	1.0000000
NODE_94321_length_373_cov_31.302920	0	53	1	2	53	0.0377358
NODE_94321_length_373_cov_31.302920	0	53	7	1	53	0.0188679
NODE_94321_length_373_cov_31.302920	0	53	11	1	53	0.0188679
NODE_94321_length_373_cov_31.302920	0	53	19	1	53	0.0188679
NODE_94321_length_373_cov_31.302920	0	53	23	8	53	0.1509434
NODE_94321_length_373_cov_31.302920	0	53	33	5	53	0.0943396
NODE_94321_length_373_cov_31.302920	0	53	43	2	53	0.0377358
NODE_94321_length_373_cov_31.302920	0	53	44	5	53	0.0943396
NODE_94321_length_373_cov_31.302920	0	53	46	4	53	0.0754717
NODE_94321_length_373_cov_31.302920	0	53	52	2	53	0.0377358
NODE_94321_length_373_cov_31.302920	0	53	59	5	53	0.0943396
NODE_94321_length_373_cov_31.302920	0	53	60	1	53	0.0188679
NODE_94321_length_373_cov_31.302920	0	53	95	4	53	0.0754717
NODE_94321_length_373_cov_31.302920	0	53	96	2	53	0.0377358
NODE_94321_length_373_cov_31.302920	0	53	99	5	53	0.0943396
NODE_94321_length_373_cov_31.302920	0	53	102	3	53	0.0566038
NODE_94321_length_373_cov_31.302920	0	53	103	2	53	0.0377358
NODE_94321_length_373_cov_31.302920	0	53	1	2	53	0.0377358
NODE_94321_length_373_cov_31.302920	0	53	7	1	53	0.0188679
NODE_94321_length_373_cov_31.302920	0	53	11	1	53	0.0188679
NODE_94321_length_373_cov_31.302920	0	53	19	1	53	0.0188679
NODE_94321_length_373_cov_31.302920	0	53	23	8	53	0.1509434
NODE_94321_length_373_cov_31.302920	0	53	33	5	53	0.0943396
NODE_94321_length_373_cov_31.302920	0	53	43	2	53	0.0377358
NODE_94321_length_373_cov_31.302920	0	53	44	5	53	0.0943396
NODE_94321_length_373_cov_31.302920	0	53	46	4	53	0.0754717
NODE_94321_length_373_cov_31.302920	0	53	52	2	53	0.0377358
NODE_94321_length_373_cov_31.302920	0	53	59	5	53	0.0943396
NODE_94321_length_373_cov_31.302920	0	53	60	1	53	0.0188679
NODE_94321_length_373_cov_31.302920	0	53	95	4	53	0.0754717
NODE_94321_length_373_cov_31.302920	0	53	96	2	53	0.0377358
NODE_94321_length_373_cov_31.302920	0	53	99	5	53	0.0943396
NODE_94321_length_373_cov_31.302920	0	53	102	3	53	0.0566038
NODE_94321_length_373_cov_31.302920	0	53	103	2	53	0.0377358
NODE_94321_length_373_cov_31.302920	0	53	1	2	53	0.0377358
NODE_94321_length_373_cov_31.302920	0	53	7	1	53	0.0188679
NODE_94321_length_373_cov_31.302920	0	53	11	1	53	0.0188679
NODE_94321_length_373_cov_31.302920	0	53	19	1	53	0.0188679
NODE_94321_length_373_cov_31.302920	0	53	23	8	53	0.1509434
NODE_94321_length_373_cov_31.302920	0	53	33	5	53	0.0943396
NODE_94321_length_373_cov_31.302920	0	53	43	2	53	0.0377358
NODE_94321_length_373_cov_31.302920	0	53	44	5	53	0.0943396
NODE_94321_length_373_cov_31.302920	0	53	46	4	53	0.0754717
NODE_94321_length_373_cov_31.302920	0	53	52	2	53	0.0377358
NODE_94321_length_373_cov_31.302920	0	53	59	5	53	0.0943396
NODE_94321_length_373_cov_31.302920	0	53	60	1	53	0.0188679
NODE_94321_length_373_cov_31.302920	0	53	95	4	53	0.0754717
NODE_94321_length_373_cov_31.302920	0	53	96	2	53	0.0377358
NODE_94321_length_373_cov_31.302920	0	53	99	5	53	0.0943396
NODE_94321_length_373_cov_31.302920	0	53	102	3	53	0.0566038
NODE_94321_length_373_cov_31.302920	0	53	103	2	53	0.0377358
NODE_94321_length_373_cov_31.302920	26	106	46	3	80	0.0375000
NODE_94321_length_373_cov_31.302920	26	106	52	2	80	0.0250000
NODE_94321_length_373_cov_31.302920	26	106	59	5	80	0.0625000
NODE_94321_length_373_cov_31.302920	26	106	60	1	80	0.0125000
NODE_94321_length_373_cov_31.302920	26	106	95	4	80	0.0500000
NODE_94321_length_373_cov_31.302920	26	106	96	2	80	0.0250000
NODE_94321_length_373_cov_31.302920	26	106	99	5	80	0.0625000
NODE_94321_length_373_cov_31.302920	26	106	102	3	80	0.0375000
NODE_94321_length_373_cov_31.302920	26	106	103	2	80	0.0250000
NODE_94321_length_373_cov_31.302920	26	106	104	2	80	0.0250000
NODE_94321_length_373_cov_31.302920	26	106	107	1	80	0.0125000
NODE_94321_length_373_cov_31.302920	26	106	109	2	80	0.0250000
NODE_94321_length_373_cov_31.302920	26	106	110	1	80	0.0125000
NODE_94321_length_373_cov_31.302920	26	106	115	12	80	0.1500000
NODE_94321_length_373_cov_31.302920	26	106	116	6	80	0.0750000
NODE_94321_length_373_cov_31.302920	26	106	118	3	80	0.0375000
NODE_94321_length_373_cov_31.302920	26	106	120	2	80	0.0250000
NODE_94321_length_373_cov_31.302920	26	106	122	1	80	0.0125000
NODE_94321_length_373_cov_31.302920	26	106	123	10	80	0.1250000
NODE_94321_length_373_cov_31.302920	26	106	126	13	80	0.1625000
NODE_94340_length_373_cov_4.671533	76	142	2	66	66	1.0000000
NODE_94340_length_373_cov_4.671533	115	195	0	27	80	0.3375000
NODE_94340_length_373_cov_4.671533	115	195	2	53	80	0.6625000
NODE_94340_length_373_cov_4.671533	115	195	0	27	80	0.3375000
NODE_94340_length_373_cov_4.671533	115	195	2	53	80	0.6625000
NODE_94340_length_373_cov_4.671533	288	368	0	80	80	1.0000000
NODE_94352_length_373_cov_4.080292	109	189	3	25	80	0.3125000
NODE_94352_length_373_cov_4.080292	109	189	4	1	80	0.0125000
NODE_94352_length_373_cov_4.080292	109	189	5	15	80	0.1875000
NODE_94352_length_373_cov_4.080292	109	189	6	8	80	0.1000000
NODE_94352_length_373_cov_4.080292	109	189	7	10	80	0.1250000
NODE_94352_length_373_cov_4.080292	109	189	8	21	80	0.2625000
NODE_94352_length_373_cov_4.080292	162	220	3	56	58	0.9655172
NODE_94352_length_373_cov_4.080292	162	220	6	2	58	0.0344828
NODE_94380_length_373_cov_3.167883	131	210	0	79	79	1.0000000
NODE_94414_length_373_cov_2.751825	80	151	0	71	71	1.0000000
NODE_94414_length_373_cov_2.751825	124	162	0	38	38	1.0000000
NODE_94493_length_373_cov_2.036496	248	326	2	20	78	0.2564103
NODE_94493_length_373_cov_2.036496	248	326	4	51	78	0.6538461
NODE_94493_length_373_cov_2.036496	248	326	8	7	78	0.0897436
NODE_94493_length_373_cov_2.036496	299	359	2	44	60	0.7333333
NODE_94493_length_373_cov_2.036496	299	359	4	16	60	0.2666667
NODE_94500_length_373_cov_2.003650	150	194	0	44	44	1.0000000
NODE_94937_length_373_cov_0.759124	62	114	0	52	52	1.0000000
NODE_95051_length_372_cov_30.135531	111	191	0	80	80	1.0000000
NODE_95051_length_372_cov_30.135531	159	222	0	63	63	1.0000000
NODE_95051_length_372_cov_30.135531	164	239	0	75	75	1.0000000
NODE_95051_length_372_cov_30.135531	182	253	0	71	71	1.0000000
NODE_95051_length_372_cov_30.135531	195	275	0	80	80	1.0000000
NODE_95051_length_372_cov_30.135531	213	276	0	63	63	1.0000000
NODE_95053_length_372_cov_9.091575	150	230	0	80	80	1.0000000
NODE_95053_length_372_cov_9.091575	203	283	0	80	80	1.0000000
NODE_95063_length_372_cov_5.706960	168	208	0	40	40	1.0000000
NODE_95067_length_372_cov_5.124542	146	211	0	11	65	0.1692308
NODE_95067_length_372_cov_5.124542	146	211	2	54	65	0.8307692
NODE_95067_length_372_cov_5.124542	189	264	2	75	75	1.0000000
NODE_95090_length_372_cov_3.761905	177	221	0	44	44	1.0000000
NODE_95109_length_372_cov_3.186813	137	218	0	81	81	1.0000000
NODE_95159_length_372_cov_2.582418	167	239	19	1	72	0.0138889
NODE_95159_length_372_cov_2.582418	167	239	21	1	72	0.0138889
NODE_95159_length_372_cov_2.582418	167	239	23	5	72	0.0694444
NODE_95159_length_372_cov_2.582418	167	239	24	1	72	0.0138889
NODE_95159_length_372_cov_2.582418	167	239	30	2	72	0.0277778
NODE_95159_length_372_cov_2.582418	167	239	32	1	72	0.0138889
NODE_95159_length_372_cov_2.582418	167	239	34	3	72	0.0416667
NODE_95159_length_372_cov_2.582418	167	239	36	31	72	0.4305556
NODE_95159_length_372_cov_2.582418	167	239	38	27	72	0.3750000
NODE_95159_length_372_cov_2.582418	212	292	10	4	80	0.0500000
NODE_95159_length_372_cov_2.582418	212	292	12	1	80	0.0125000
NODE_95159_length_372_cov_2.582418	212	292	13	3	80	0.0375000
NODE_95159_length_372_cov_2.582418	212	292	14	5	80	0.0625000
NODE_95159_length_372_cov_2.582418	212	292	16	2	80	0.0250000
NODE_95159_length_372_cov_2.582418	212	292	17	1	80	0.0125000
NODE_95159_length_372_cov_2.582418	212	292	22	1	80	0.0125000
NODE_95159_length_372_cov_2.582418	212	292	24	3	80	0.0375000
NODE_95159_length_372_cov_2.582418	212	292	26	3	80	0.0375000
NODE_95159_length_372_cov_2.582418	212	292	28	7	80	0.0875000
NODE_95159_length_372_cov_2.582418	212	292	30	10	80	0.1250000
NODE_95159_length_372_cov_2.582418	212	292	32	3	80	0.0375000
NODE_95159_length_372_cov_2.582418	212	292	34	1	80	0.0125000
NODE_95159_length_372_cov_2.582418	212	292	38	36	80	0.4500000
NODE_95183_length_372_cov_2.347985	97	141	0	44	44	1.0000000
NODE_95183_length_372_cov_2.347985	98	133	0	35	35	1.0000000
NODE_95183_length_372_cov_2.347985	178	243	2	40	65	0.6153846
NODE_95183_length_372_cov_2.347985	178	243	4	25	65	0.3846154
NODE_95303_length_372_cov_1.699634	195	276	10	2	81	0.0246914
NODE_95303_length_372_cov_1.699634	195	276	12	2	81	0.0246914
NODE_95303_length_372_cov_1.699634	195	276	14	35	81	0.4320988
NODE_95303_length_372_cov_1.699634	195	276	16	42	81	0.5185185
NODE_95453_length_372_cov_1.223443	264	334	0	70	70	1.0000000
NODE_95784_length_371_cov_52.040441	104	184	0	77	80	0.9625000
NODE_95784_length_371_cov_52.040441	104	184	5	3	80	0.0375000
NODE_95784_length_371_cov_52.040441	157	237	0	24	80	0.3000000
NODE_95784_length_371_cov_52.040441	157	237	5	4	80	0.0500000
NODE_95784_length_371_cov_52.040441	157	237	6	3	80	0.0375000
NODE_95784_length_371_cov_52.040441	157	237	7	5	80	0.0625000
NODE_95784_length_371_cov_52.040441	157	237	8	1	80	0.0125000
NODE_95784_length_371_cov_52.040441	157	237	9	3	80	0.0375000
NODE_95784_length_371_cov_52.040441	157	237	10	1	80	0.0125000
NODE_95784_length_371_cov_52.040441	157	237	14	11	80	0.1375000
NODE_95784_length_371_cov_52.040441	157	237	16	4	80	0.0500000
NODE_95784_length_371_cov_52.040441	157	237	17	1	80	0.0125000
NODE_95784_length_371_cov_52.040441	157	237	19	1	80	0.0125000
NODE_95784_length_371_cov_52.040441	157	237	20	2	80	0.0250000
NODE_95784_length_371_cov_52.040441	157	237	23	1	80	0.0125000
NODE_95784_length_371_cov_52.040441	157	237	24	5	80	0.0625000
NODE_95784_length_371_cov_52.040441	157	237	26	13	80	0.1625000
NODE_95784_length_371_cov_52.040441	157	237	28	1	80	0.0125000
NODE_95784_length_371_cov_52.040441	180	232	0	1	52	0.0192308
NODE_95784_length_371_cov_52.040441	180	232	5	4	52	0.0769231
NODE_95784_length_371_cov_52.040441	180	232	6	3	52	0.0576923
NODE_95784_length_371_cov_52.040441	180	232	7	5	52	0.0961538
NODE_95784_length_371_cov_52.040441	180	232	8	1	52	0.0192308
NODE_95784_length_371_cov_52.040441	180	232	9	3	52	0.0576923
NODE_95784_length_371_cov_52.040441	180	232	10	1	52	0.0192308
NODE_95784_length_371_cov_52.040441	180	232	14	11	52	0.2115385
NODE_95784_length_371_cov_52.040441	180	232	16	4	52	0.0769231
NODE_95784_length_371_cov_52.040441	180	232	17	1	52	0.0192308
NODE_95784_length_371_cov_52.040441	180	232	19	1	52	0.0192308
NODE_95784_length_371_cov_52.040441	180	232	20	2	52	0.0384615
NODE_95784_length_371_cov_52.040441	180	232	23	1	52	0.0192308
NODE_95784_length_371_cov_52.040441	180	232	24	5	52	0.0961538
NODE_95784_length_371_cov_52.040441	180	232	26	9	52	0.1730769
NODE_95785_length_371_cov_24.878676	91	171	0	80	80	1.0000000
NODE_95785_length_371_cov_24.878676	144	224	0	80	80	1.0000000
NODE_95797_length_371_cov_5.738971	170	245	15	6	75	0.0800000
NODE_95797_length_371_cov_5.738971	170	245	16	1	75	0.0133333
NODE_95797_length_371_cov_5.738971	170	245	18	2	75	0.0266667
NODE_95797_length_371_cov_5.738971	170	245	19	5	75	0.0666667
NODE_95797_length_371_cov_5.738971	170	245	20	9	75	0.1200000
NODE_95797_length_371_cov_5.738971	170	245	22	4	75	0.0533333
NODE_95797_length_371_cov_5.738971	170	245	24	20	75	0.2666667
NODE_95797_length_371_cov_5.738971	170	245	26	28	75	0.3733333
NODE_95797_length_371_cov_5.738971	218	298	16	10	80	0.1250000
NODE_95797_length_371_cov_5.738971	218	298	18	19	80	0.2375000
NODE_95797_length_371_cov_5.738971	218	298	19	5	80	0.0625000
NODE_95797_length_371_cov_5.738971	218	298	20	26	80	0.3250000
NODE_95797_length_371_cov_5.738971	218	298	24	20	80	0.2500000
NODE_95807_length_371_cov_4.452206	65	145	0	80	80	1.0000000
NODE_95807_length_371_cov_4.452206	118	198	0	80	80	1.0000000
NODE_95863_length_371_cov_2.841912	288	350	0	58	62	0.9354839
NODE_95863_length_371_cov_2.841912	288	350	1	2	62	0.0322581
NODE_95863_length_371_cov_2.841912	288	350	18	2	62	0.0322581
NODE_96013_length_371_cov_1.790441	188	235	2	47	47	1.0000000
NODE_96105_length_371_cov_1.422794	199	287	0	88	88	1.0000000
NODE_96500_length_370_cov_50.380074	144	224	0	80	80	1.0000000
NODE_96500_length_370_cov_50.380074	197	277	0	80	80	1.0000000
NODE_96504_length_370_cov_7.553506	105	162	6	28	57	0.4912281
NODE_96504_length_370_cov_7.553506	105	162	8	29	57	0.5087720
NODE_96510_length_370_cov_5.811808	153	221	0	68	68	1.0000000
NODE_96510_length_370_cov_5.811808	206	286	0	80	80	1.0000000
NODE_96522_length_370_cov_4.915129	157	207	2	50	50	1.0000000
NODE_96528_length_370_cov_4.535055	141	221	0	72	80	0.9000000
NODE_96528_length_370_cov_4.535055	141	221	2	8	80	0.1000000
NODE_96528_length_370_cov_4.535055	194	274	0	19	80	0.2375000
NODE_96528_length_370_cov_4.535055	194	274	2	61	80	0.7625000
NODE_96532_length_370_cov_4.199262	230	275	2	45	45	1.0000000
NODE_96533_length_370_cov_4.151292	142	209	16	2	67	0.0298507
NODE_96533_length_370_cov_4.151292	142	209	18	14	67	0.2089552
NODE_96533_length_370_cov_4.151292	142	209	20	11	67	0.1641791
NODE_96533_length_370_cov_4.151292	142	209	22	40	67	0.5970149
NODE_96542_length_370_cov_3.719557	214	251	19	19	37	0.5135135
NODE_96542_length_370_cov_3.719557	214	251	21	15	37	0.4054054
NODE_96542_length_370_cov_3.719557	214	251	23	3	37	0.0810811
NODE_96581_length_370_cov_2.822878	126	173	2	14	47	0.2978723
NODE_96581_length_370_cov_2.822878	126	173	4	33	47	0.7021276
NODE_96668_length_370_cov_2.081181	0	52	2	1	52	0.0192308
NODE_96668_length_370_cov_2.081181	0	52	3	1	52	0.0192308
NODE_96668_length_370_cov_2.081181	0	52	7	16	52	0.3076923
NODE_96668_length_370_cov_2.081181	0	52	8	13	52	0.2500000
NODE_96668_length_370_cov_2.081181	0	52	10	3	52	0.0576923
NODE_96668_length_370_cov_2.081181	0	52	14	3	52	0.0576923
NODE_96668_length_370_cov_2.081181	0	52	16	2	52	0.0384615
NODE_96668_length_370_cov_2.081181	0	52	18	5	52	0.0961538
NODE_96668_length_370_cov_2.081181	0	52	20	1	52	0.0192308
NODE_96668_length_370_cov_2.081181	0	52	21	2	52	0.0384615
NODE_96668_length_370_cov_2.081181	0	52	23	5	52	0.0961538
NODE_97207_length_369_cov_36.811111	273	358	0	22	85	0.2588235
NODE_97207_length_369_cov_36.811111	273	358	3	1	85	0.0117647
NODE_97207_length_369_cov_36.811111	273	358	7	12	85	0.1411765
NODE_97207_length_369_cov_36.811111	273	358	13	1	85	0.0117647
NODE_97207_length_369_cov_36.811111	273	358	14	49	85	0.5764706
NODE_97207_length_369_cov_36.811111	273	358	0	22	85	0.2588235
NODE_97207_length_369_cov_36.811111	273	358	3	1	85	0.0117647
NODE_97207_length_369_cov_36.811111	273	358	7	12	85	0.1411765
NODE_97207_length_369_cov_36.811111	273	358	13	1	85	0.0117647
NODE_97207_length_369_cov_36.811111	273	358	14	49	85	0.5764706
NODE_97207_length_369_cov_36.811111	273	358	0	22	85	0.2588235
NODE_97207_length_369_cov_36.811111	273	358	3	1	85	0.0117647
NODE_97207_length_369_cov_36.811111	273	358	7	12	85	0.1411765
NODE_97207_length_369_cov_36.811111	273	358	13	1	85	0.0117647
NODE_97207_length_369_cov_36.811111	273	358	14	49	85	0.5764706
NODE_97211_length_369_cov_8.751852	107	187	0	21	80	0.2625000
NODE_97211_length_369_cov_8.751852	107	187	2	59	80	0.7375000
NODE_97226_length_369_cov_6.677778	189	269	0	10	80	0.1250000
NODE_97226_length_369_cov_6.677778	189	269	2	70	80	0.8750000
NODE_97226_length_369_cov_6.677778	242	323	0	64	81	0.7901235
NODE_97226_length_369_cov_6.677778	242	323	2	17	81	0.2098765
NODE_97236_length_369_cov_5.337037	199	264	8	65	65	1.0000000
NODE_97249_length_369_cov_4.459259	89	157	0	68	68	1.0000000
NODE_97249_length_369_cov_4.459259	130	210	0	80	80	1.0000000
NODE_97255_length_369_cov_4.111111	216	279	0	63	63	1.0000000
NODE_97265_length_369_cov_3.837037	205	238	0	33	33	1.0000000
NODE_97265_length_369_cov_3.837037	211	291	0	80	80	1.0000000
NODE_97265_length_369_cov_3.837037	287	316	0	29	29	1.0000000
NODE_97346_length_369_cov_2.355556	62	142	0	19	80	0.2375000
NODE_97346_length_369_cov_2.355556	62	142	3	13	80	0.1625000
NODE_97346_length_369_cov_2.355556	62	142	6	48	80	0.6000000
NODE_97346_length_369_cov_2.355556	114	195	6	81	81	1.0000000
NODE_97440_length_369_cov_1.803704	170	235	0	65	65	1.0000000
NODE_97936_length_368_cov_42.208178	231	311	0	80	80	1.0000000
NODE_97936_length_368_cov_42.208178	284	364	0	80	80	1.0000000
NODE_97939_length_368_cov_11.988848	47	127	0	1	80	0.0125000
NODE_97939_length_368_cov_11.988848	47	127	2	79	80	0.9875000
NODE_97939_length_368_cov_11.988848	100	180	2	80	80	1.0000000
NODE_97945_length_368_cov_6.267658	133	213	0	80	80	1.0000000
NODE_97945_length_368_cov_6.267658	186	266	0	80	80	1.0000000
NODE_97997_length_368_cov_3.486989	127	207	0	19	80	0.2375000
NODE_97997_length_368_cov_3.486989	127	207	2	33	80	0.4125000
NODE_97997_length_368_cov_3.486989	127	207	4	28	80	0.3500000
NODE_98008_length_368_cov_3.282528	182	255	0	73	73	1.0000000
NODE_98058_length_368_cov_2.605948	192	246	0	54	54	1.0000000
NODE_98123_length_368_cov_2.182156	85	145	0	16	60	0.2666667
NODE_98123_length_368_cov_2.182156	85	145	2	2	60	0.0333333
NODE_98123_length_368_cov_2.182156	85	145	3	3	60	0.0500000
NODE_98123_length_368_cov_2.182156	85	145	4	39	60	0.6500000
NODE_98129_length_368_cov_2.137546	66	107	6	6	41	0.1463415
NODE_98129_length_368_cov_2.137546	66	107	8	7	41	0.1707317
NODE_98129_length_368_cov_2.137546	66	107	10	28	41	0.6829268
NODE_98157_length_368_cov_1.944238	192	272	2	24	80	0.3000000
NODE_98157_length_368_cov_1.944238	192	272	4	16	80	0.2000000
NODE_98157_length_368_cov_1.944238	192	272	5	5	80	0.0625000
NODE_98157_length_368_cov_1.944238	192	272	6	20	80	0.2500000
NODE_98157_length_368_cov_1.944238	192	272	8	15	80	0.1875000
NODE_98723_length_367_cov_7.156716	174	254	0	80	80	1.0000000
NODE_98723_length_367_cov_7.156716	227	307	0	80	80	1.0000000
NODE_98734_length_367_cov_5.313433	148	206	2	2	58	0.0344828
NODE_98734_length_367_cov_5.313433	148	206	3	9	58	0.1551724
NODE_98734_length_367_cov_5.313433	148	206	5	4	58	0.0689655
NODE_98734_length_367_cov_5.313433	148	206	9	3	58	0.0517241
NODE_98734_length_367_cov_5.313433	148	206	10	4	58	0.0689655
NODE_98734_length_367_cov_5.313433	148	206	12	6	58	0.1034483
NODE_98734_length_367_cov_5.313433	148	206	16	12	58	0.2068966
NODE_98734_length_367_cov_5.313433	148	206	22	18	58	0.3103448
NODE_98737_length_367_cov_5.138060	58	138	0	80	80	1.0000000
NODE_98737_length_367_cov_5.138060	111	191	0	27	80	0.3375000
NODE_98737_length_367_cov_5.138060	111	191	2	53	80	0.6625000
NODE_98796_length_367_cov_3.059701	110	154	0	27	44	0.6136364
NODE_98796_length_367_cov_3.059701	110	154	2	17	44	0.3863636
NODE_98796_length_367_cov_3.059701	111	146	0	19	35	0.5428572
NODE_98796_length_367_cov_3.059701	111	146	2	16	35	0.4571429
NODE_98843_length_367_cov_2.384328	246	326	13	2	80	0.0250000
NODE_98843_length_367_cov_2.384328	246	326	15	33	80	0.4125000
NODE_98843_length_367_cov_2.384328	246	326	16	6	80	0.0750000
NODE_98843_length_367_cov_2.384328	246	326	17	3	80	0.0375000
NODE_98843_length_367_cov_2.384328	246	326	18	2	80	0.0250000
NODE_98843_length_367_cov_2.384328	246	326	20	34	80	0.4250000
NODE_98843_length_367_cov_2.384328	299	367	4	2	68	0.0294118
NODE_98843_length_367_cov_2.384328	299	367	6	3	68	0.0441176
NODE_98843_length_367_cov_2.384328	299	367	11	1	68	0.0147059
NODE_98843_length_367_cov_2.384328	299	367	13	3	68	0.0441176
NODE_98843_length_367_cov_2.384328	299	367	14	8	68	0.1176471
NODE_98843_length_367_cov_2.384328	299	367	15	51	68	0.7500000
NODE_98849_length_367_cov_2.332090	127	207	0	80	80	1.0000000
NODE_98909_length_367_cov_1.944030	91	156	0	4	65	0.0615385
NODE_98909_length_367_cov_1.944030	91	156	1	1	65	0.0153846
NODE_98909_length_367_cov_1.944030	91	156	2	1	65	0.0153846
NODE_98909_length_367_cov_1.944030	91	156	4	59	65	0.9076923
NODE_98980_length_367_cov_1.679104	173	252	10	5	79	0.0632911
NODE_98980_length_367_cov_1.679104	173	252	12	46	79	0.5822785
NODE_98980_length_367_cov_1.679104	173	252	14	17	79	0.2151899
NODE_98980_length_367_cov_1.679104	173	252	16	3	79	0.0379747
NODE_98980_length_367_cov_1.679104	173	252	18	1	79	0.0126582
NODE_98980_length_367_cov_1.679104	173	252	20	7	79	0.0886076
NODE_99005_length_367_cov_1.552239	148	200	0	52	52	1.0000000
NODE_99138_length_367_cov_1.201493	79	159	0	80	80	1.0000000
NODE_99138_length_367_cov_1.201493	136	179	0	43	43	1.0000000
NODE_99318_length_367_cov_0.761194	288	357	0	69	69	1.0000000
NODE_99451_length_366_cov_5.239700	193	253	0	60	60	1.0000000
NODE_99472_length_366_cov_4.168539	302	355	0	53	53	1.0000000
NODE_99478_length_366_cov_3.913858	183	229	10	46	46	1.0000000
NODE_99478_length_366_cov_3.913858	203	282	0	11	79	0.1392405
NODE_99478_length_366_cov_3.913858	203	282	4	4	79	0.0506329
NODE_99478_length_366_cov_3.913858	203	282	6	8	79	0.1012658
NODE_99478_length_366_cov_3.913858	203	282	10	56	79	0.7088608
NODE_99496_length_366_cov_3.168539	88	160	0	72	72	1.0000000
NODE_99496_length_366_cov_3.168539	133	193	0	60	60	1.0000000
NODE_100137_length_365_cov_140.101504	40	107	145	1	67	0.0149254
NODE_100137_length_365_cov_140.101504	40	107	147	1	67	0.0149254
NODE_100137_length_365_cov_140.101504	40	107	155	1	67	0.0149254
NODE_100137_length_365_cov_140.101504	40	107	156	1	67	0.0149254
NODE_100137_length_365_cov_140.101504	40	107	159	3	67	0.0447761
NODE_100137_length_365_cov_140.101504	40	107	168	1	67	0.0149254
NODE_100137_length_365_cov_140.101504	40	107	169	2	67	0.0298507
NODE_100137_length_365_cov_140.101504	40	107	171	2	67	0.0298507
NODE_100137_length_365_cov_140.101504	40	107	173	1	67	0.0149254
NODE_100137_length_365_cov_140.101504	40	107	179	1	67	0.0149254
NODE_100137_length_365_cov_140.101504	40	107	181	2	67	0.0298507
NODE_100137_length_365_cov_140.101504	40	107	183	2	67	0.0298507
NODE_100137_length_365_cov_140.101504	40	107	185	1	67	0.0149254
NODE_100137_length_365_cov_140.101504	40	107	189	1	67	0.0149254
NODE_100137_length_365_cov_140.101504	40	107	199	1	67	0.0149254
NODE_100137_length_365_cov_140.101504	40	107	207	1	67	0.0149254
NODE_100137_length_365_cov_140.101504	40	107	211	1	67	0.0149254
NODE_100137_length_365_cov_140.101504	40	107	213	1	67	0.0149254
NODE_100137_length_365_cov_140.101504	40	107	215	1	67	0.0149254
NODE_100137_length_365_cov_140.101504	40	107	221	1	67	0.0149254
NODE_100137_length_365_cov_140.101504	40	107	223	1	67	0.0149254
NODE_100137_length_365_cov_140.101504	40	107	227	1	67	0.0149254
NODE_100137_length_365_cov_140.101504	40	107	229	1	67	0.0149254
NODE_100137_length_365_cov_140.101504	40	107	235	1	67	0.0149254
NODE_100137_length_365_cov_140.101504	40	107	245	1	67	0.0149254
NODE_100137_length_365_cov_140.101504	40	107	247	3	67	0.0447761
NODE_100137_length_365_cov_140.101504	40	107	251	1	67	0.0149254
NODE_100137_length_365_cov_140.101504	40	107	255	2	67	0.0298507
NODE_100137_length_365_cov_140.101504	40	107	257	2	67	0.0298507
NODE_100137_length_365_cov_140.101504	40	107	259	5	67	0.0746269
NODE_100137_length_365_cov_140.101504	40	107	261	1	67	0.0149254
NODE_100137_length_365_cov_140.101504	40	107	263	1	67	0.0149254
NODE_100137_length_365_cov_140.101504	40	107	265	4	67	0.0597015
NODE_100137_length_365_cov_140.101504	40	107	267	3	67	0.0447761
NODE_100137_length_365_cov_140.101504	40	107	269	11	67	0.1641791
NODE_100137_length_365_cov_140.101504	40	107	271	3	67	0.0447761
NODE_100138_length_365_cov_45.815789	0	38	0	38	38	1.0000000
NODE_100138_length_365_cov_45.815789	11	91	0	80	80	1.0000000
NODE_100140_length_365_cov_8.169173	191	244	2	53	53	1.0000000
NODE_100140_length_365_cov_8.169173	217	297	0	10	80	0.1250000
NODE_100140_length_365_cov_8.169173	217	297	2	70	80	0.8750000
NODE_100145_length_365_cov_5.954887	136	216	0	9	80	0.1125000
NODE_100145_length_365_cov_5.954887	136	216	1	15	80	0.1875000
NODE_100145_length_365_cov_5.954887	136	216	2	56	80	0.7000000
NODE_100145_length_365_cov_5.954887	189	269	0	7	80	0.0875000
NODE_100145_length_365_cov_5.954887	189	269	1	15	80	0.1875000
NODE_100145_length_365_cov_5.954887	189	269	2	58	80	0.7250000
NODE_100147_length_365_cov_5.721805	37	78	0	41	41	1.0000000
NODE_100168_length_365_cov_4.195489	269	329	0	14	60	0.2333333
NODE_100168_length_365_cov_4.195489	269	329	2	46	60	0.7666667
NODE_100172_length_365_cov_4.071429	106	186	0	80	80	1.0000000
NODE_100172_length_365_cov_4.071429	159	239	0	80	80	1.0000000
NODE_100180_length_365_cov_3.879699	131	187	8	8	56	0.1428571
NODE_100180_length_365_cov_3.879699	131	187	14	48	56	0.8571429
NODE_100206_length_365_cov_3.270677	211	280	3	32	69	0.4637681
NODE_100206_length_365_cov_3.270677	211	280	4	37	69	0.5362319
NODE_100253_length_365_cov_2.601504	189	265	0	76	76	1.0000000
NODE_100293_length_365_cov_2.289474	169	249	0	80	80	1.0000000
NODE_100407_length_365_cov_1.635338	156	235	12	14	79	0.1772152
NODE_100407_length_365_cov_1.635338	156	235	14	5	79	0.0632911
NODE_100407_length_365_cov_1.635338	156	235	22	35	79	0.4430380
NODE_100407_length_365_cov_1.635338	156	235	24	7	79	0.0886076
NODE_100407_length_365_cov_1.635338	156	235	26	13	79	0.1645570
NODE_100407_length_365_cov_1.635338	156	235	28	5	79	0.0632911
NODE_100485_length_365_cov_1.421053	228	309	0	81	81	1.0000000
NODE_100570_length_365_cov_1.169173	57	137	0	80	80	1.0000000
NODE_100570_length_365_cov_1.169173	65	145	0	80	80	1.0000000
NODE_100570_length_365_cov_1.169173	194	274	12	4	80	0.0500000
NODE_100570_length_365_cov_1.169173	194	274	14	5	80	0.0625000
NODE_100570_length_365_cov_1.169173	194	274	20	19	80	0.2375000
NODE_100570_length_365_cov_1.169173	194	274	22	9	80	0.1125000
NODE_100570_length_365_cov_1.169173	194	274	23	1	80	0.0125000
NODE_100570_length_365_cov_1.169173	194	274	24	42	80	0.5250000
NODE_100893_length_364_cov_24.600000	101	181	0	80	80	1.0000000
NODE_100893_length_364_cov_24.600000	154	234	0	80	80	1.0000000
NODE_100896_length_364_cov_7.377358	0	50	0	50	50	1.0000000
NODE_100933_length_364_cov_3.988679	122	168	0	46	46	1.0000000
NODE_100935_length_364_cov_3.913208	151	208	0	1	57	0.0175439
NODE_100935_length_364_cov_3.913208	151	208	1	28	57	0.4912281
NODE_100935_length_364_cov_3.913208	151	208	2	15	57	0.2631579
NODE_100935_length_364_cov_3.913208	151	208	3	13	57	0.2280702
NODE_100959_length_364_cov_3.305660	296	358	0	62	62	1.0000000
NODE_100966_length_364_cov_3.181132	78	138	0	60	60	1.0000000
NODE_100975_length_364_cov_3.041509	264	321	0	2	57	0.0350877
NODE_100975_length_364_cov_3.041509	264	321	2	55	57	0.9649123
NODE_100975_length_364_cov_3.041509	294	359	0	24	65	0.3692308
NODE_100975_length_364_cov_3.041509	294	359	2	41	65	0.6307693
NODE_100978_length_364_cov_3.015094	238	274	0	36	36	1.0000000
NODE_101087_length_364_cov_1.977358	126	201	14	13	75	0.1733333
NODE_101087_length_364_cov_1.977358	126	201	16	1	75	0.0133333
NODE_101087_length_364_cov_1.977358	126	201	18	6	75	0.0800000
NODE_101087_length_364_cov_1.977358	126	201	22	7	75	0.0933333
NODE_101087_length_364_cov_1.977358	126	201	24	33	75	0.4400000
NODE_101087_length_364_cov_1.977358	126	201	26	4	75	0.0533333
NODE_101087_length_364_cov_1.977358	126	201	30	5	75	0.0666667
NODE_101087_length_364_cov_1.977358	126	201	32	2	75	0.0266667
NODE_101087_length_364_cov_1.977358	126	201	34	2	75	0.0266667
NODE_101087_length_364_cov_1.977358	126	201	36	2	75	0.0266667
NODE_101141_length_364_cov_1.811321	209	256	0	47	47	1.0000000
NODE_101148_length_364_cov_1.781132	130	203	0	1	73	0.0136986
NODE_101148_length_364_cov_1.781132	130	203	3	33	73	0.4520548
NODE_101148_length_364_cov_1.781132	130	203	5	4	73	0.0547945
NODE_101148_length_364_cov_1.781132	130	203	7	2	73	0.0273973
NODE_101148_length_364_cov_1.781132	130	203	9	3	73	0.0410959
NODE_101148_length_364_cov_1.781132	130	203	10	2	73	0.0273973
NODE_101148_length_364_cov_1.781132	130	203	12	8	73	0.1095890
NODE_101148_length_364_cov_1.781132	130	203	13	1	73	0.0136986
NODE_101148_length_364_cov_1.781132	130	203	19	3	73	0.0410959
NODE_101148_length_364_cov_1.781132	130	203	30	2	73	0.0273973
NODE_101148_length_364_cov_1.781132	130	203	32	14	73	0.1917808
NODE_101148_length_364_cov_1.781132	183	203	0	1	20	0.0500000
NODE_101148_length_364_cov_1.781132	183	203	3	19	20	0.9500000
NODE_101720_length_363_cov_7.791667	121	200	0	19	79	0.2405063
NODE_101720_length_363_cov_7.791667	121	200	2	60	79	0.7594936
NODE_101725_length_363_cov_6.484848	33	90	8	7	57	0.1228070
NODE_101725_length_363_cov_6.484848	33	90	10	50	57	0.8771930
NODE_101725_length_363_cov_6.484848	93	146	0	10	53	0.1886792
NODE_101725_length_363_cov_6.484848	93	146	2	7	53	0.1320755
NODE_101725_length_363_cov_6.484848	93	146	4	16	53	0.3018868
NODE_101725_length_363_cov_6.484848	93	146	6	3	53	0.0566038
NODE_101725_length_363_cov_6.484848	93	146	10	17	53	0.3207547
NODE_101734_length_363_cov_4.825758	154	215	0	3	61	0.0491803
NODE_101734_length_363_cov_4.825758	154	215	2	58	61	0.9508197
NODE_101760_length_363_cov_3.950758	112	183	0	61	71	0.8591549
NODE_101760_length_363_cov_3.950758	112	183	4	10	71	0.1408451
NODE_101760_length_363_cov_3.950758	156	236	0	80	80	1.0000000
NODE_101769_length_363_cov_3.617424	16	79	0	2	63	0.0317460
NODE_101769_length_363_cov_3.617424	16	79	1	37	63	0.5873016
NODE_101769_length_363_cov_3.617424	16	79	2	24	63	0.3809524
NODE_101774_length_363_cov_3.409091	241	267	0	26	26	1.0000000
NODE_101791_length_363_cov_3.087121	228	308	8	8	80	0.1000000
NODE_101791_length_363_cov_3.087121	228	308	10	13	80	0.1625000
NODE_101791_length_363_cov_3.087121	228	308	12	45	80	0.5625000
NODE_101791_length_363_cov_3.087121	228	308	14	14	80	0.1750000
NODE_101809_length_363_cov_2.795455	240	320	29	1	80	0.0125000
NODE_101809_length_363_cov_2.795455	240	320	34	1	80	0.0125000
NODE_101809_length_363_cov_2.795455	240	320	36	4	80	0.0500000
NODE_101809_length_363_cov_2.795455	240	320	38	1	80	0.0125000
NODE_101809_length_363_cov_2.795455	240	320	40	2	80	0.0250000
NODE_101809_length_363_cov_2.795455	240	320	42	2	80	0.0250000
NODE_101809_length_363_cov_2.795455	240	320	43	3	80	0.0375000
NODE_101809_length_363_cov_2.795455	240	320	45	1	80	0.0125000
NODE_101809_length_363_cov_2.795455	240	320	49	1	80	0.0125000
NODE_101809_length_363_cov_2.795455	240	320	51	2	80	0.0250000
NODE_101809_length_363_cov_2.795455	240	320	55	1	80	0.0125000
NODE_101809_length_363_cov_2.795455	240	320	56	3	80	0.0375000
NODE_101809_length_363_cov_2.795455	240	320	58	8	80	0.1000000
NODE_101809_length_363_cov_2.795455	240	320	59	13	80	0.1625000
NODE_101809_length_363_cov_2.795455	240	320	60	2	80	0.0250000
NODE_101809_length_363_cov_2.795455	240	320	61	1	80	0.0125000
NODE_101809_length_363_cov_2.795455	240	320	62	26	80	0.3250000
NODE_101809_length_363_cov_2.795455	240	320	64	2	80	0.0250000
NODE_101809_length_363_cov_2.795455	240	320	66	6	80	0.0750000
NODE_101822_length_363_cov_2.481061	86	166	0	23	80	0.2875000
NODE_101822_length_363_cov_2.481061	86	166	2	57	80	0.7125000
NODE_101822_length_363_cov_2.481061	139	219	0	76	80	0.9500000
NODE_101822_length_363_cov_2.481061	139	219	2	4	80	0.0500000
NODE_101879_length_363_cov_2.034091	46	126	0	80	80	1.0000000
NODE_101879_length_363_cov_2.034091	99	153	0	54	54	1.0000000
NODE_101992_length_363_cov_1.541667	235	315	4	46	80	0.5750000
NODE_101992_length_363_cov_1.541667	235	315	6	34	80	0.4250000
NODE_102022_length_363_cov_1.477273	141	202	2	12	61	0.1967213
NODE_102022_length_363_cov_1.477273	141	202	4	2	61	0.0327869
NODE_102022_length_363_cov_1.477273	141	202	8	3	61	0.0491803
NODE_102022_length_363_cov_1.477273	141	202	12	4	61	0.0655738
NODE_102022_length_363_cov_1.477273	141	202	16	2	61	0.0327869
NODE_102022_length_363_cov_1.477273	141	202	20	13	61	0.2131148
NODE_102022_length_363_cov_1.477273	141	202	22	2	61	0.0327869
NODE_102022_length_363_cov_1.477273	141	202	26	6	61	0.0983607
NODE_102022_length_363_cov_1.477273	141	202	28	1	61	0.0163934
NODE_102022_length_363_cov_1.477273	141	202	30	16	61	0.2622951
NODE_102022_length_363_cov_1.477273	153	210	4	2	57	0.0350877
NODE_102022_length_363_cov_1.477273	153	210	8	3	57	0.0526316
NODE_102022_length_363_cov_1.477273	153	210	12	4	57	0.0701754
NODE_102022_length_363_cov_1.477273	153	210	16	2	57	0.0350877
NODE_102022_length_363_cov_1.477273	153	210	20	13	57	0.2280702
NODE_102022_length_363_cov_1.477273	153	210	22	2	57	0.0350877
NODE_102022_length_363_cov_1.477273	153	210	26	6	57	0.1052632
NODE_102022_length_363_cov_1.477273	153	210	28	1	57	0.0175439
NODE_102022_length_363_cov_1.477273	153	210	30	24	57	0.4210526
NODE_102187_length_363_cov_1.113636	245	316	2	6	71	0.0845070
NODE_102187_length_363_cov_1.113636	245	316	4	65	71	0.9154930
NODE_102464_length_362_cov_54.927757	52	116	0	64	64	1.0000000
NODE_102465_length_362_cov_29.273764	86	166	0	80	80	1.0000000
NODE_102465_length_362_cov_29.273764	139	219	0	80	80	1.0000000
NODE_102467_length_362_cov_14.847909	130	210	0	39	80	0.4875000
NODE_102467_length_362_cov_14.847909	130	210	2	41	80	0.5125000
NODE_102467_length_362_cov_14.847909	183	263	0	80	80	1.0000000
NODE_102633_length_362_cov_2.159696	133	216	0	83	83	1.0000000
NODE_103259_length_361_cov_4.641221	249	312	0	14	63	0.2222222
NODE_103259_length_361_cov_4.641221	249	312	1	7	63	0.1111111
NODE_103259_length_361_cov_4.641221	249	312	3	16	63	0.2539683
NODE_103259_length_361_cov_4.641221	249	312	5	1	63	0.0158730
NODE_103259_length_361_cov_4.641221	249	312	9	6	63	0.0952381
NODE_103259_length_361_cov_4.641221	249	312	10	19	63	0.3015873
NODE_103280_length_361_cov_3.717557	185	265	2	29	80	0.3625000
NODE_103280_length_361_cov_3.717557	185	265	4	33	80	0.4125000
NODE_103280_length_361_cov_3.717557	185	265	6	18	80	0.2250000
NODE_103280_length_361_cov_3.717557	238	265	2	26	27	0.9629630
NODE_103280_length_361_cov_3.717557	238	265	4	1	27	0.0370370
NODE_103314_length_361_cov_2.988550	121	201	8	1	80	0.0125000
NODE_103314_length_361_cov_2.988550	121	201	12	24	80	0.3000000
NODE_103314_length_361_cov_2.988550	121	201	14	55	80	0.6875000
NODE_103314_length_361_cov_2.988550	174	216	8	12	42	0.2857143
NODE_103314_length_361_cov_2.988550	174	216	10	3	42	0.0714286
NODE_103314_length_361_cov_2.988550	174	216	12	10	42	0.2380952
NODE_103314_length_361_cov_2.988550	174	216	14	17	42	0.4047619
NODE_103338_length_361_cov_2.641221	4	33	0	29	29	1.0000000
NODE_103338_length_361_cov_2.641221	101	182	0	81	81	1.0000000
NODE_103391_length_361_cov_2.137405	138	194	0	56	56	1.0000000
NODE_103396_length_361_cov_2.106870	192	256	0	64	64	1.0000000
NODE_103418_length_361_cov_1.969466	137	198	6	23	61	0.3770492
NODE_103418_length_361_cov_1.969466	137	198	12	22	61	0.3606557
NODE_103418_length_361_cov_1.969466	137	198	14	7	61	0.1147541
NODE_103418_length_361_cov_1.969466	137	198	16	9	61	0.1475410
NODE_103632_length_361_cov_1.343511	171	250	0	79	79	1.0000000
NODE_103802_length_361_cov_1.000000	60	123	0	63	63	1.0000000
NODE_104057_length_360_cov_8.191571	171	242	24	1	71	0.0140845
NODE_104057_length_360_cov_8.191571	171	242	26	5	71	0.0704225
NODE_104057_length_360_cov_8.191571	171	242	28	7	71	0.0985916
NODE_104057_length_360_cov_8.191571	171	242	30	10	71	0.1408451
NODE_104057_length_360_cov_8.191571	171	242	36	2	71	0.0281690
NODE_104057_length_360_cov_8.191571	171	242	38	12	71	0.1690141
NODE_104057_length_360_cov_8.191571	171	242	42	34	71	0.4788733
NODE_104057_length_360_cov_8.191571	176	242	26	1	66	0.0151515
NODE_104057_length_360_cov_8.191571	176	242	28	7	66	0.1060606
NODE_104057_length_360_cov_8.191571	176	242	30	10	66	0.1515152
NODE_104057_length_360_cov_8.191571	176	242	36	2	66	0.0303030
NODE_104057_length_360_cov_8.191571	176	242	38	12	66	0.1818182
NODE_104057_length_360_cov_8.191571	176	242	42	34	66	0.5151515
NODE_104057_length_360_cov_8.191571	215	279	22	5	64	0.0781250
NODE_104057_length_360_cov_8.191571	215	279	28	2	64	0.0312500
NODE_104057_length_360_cov_8.191571	215	279	34	11	64	0.1718750
NODE_104057_length_360_cov_8.191571	215	279	38	2	64	0.0312500
NODE_104057_length_360_cov_8.191571	215	279	42	44	64	0.6875000
NODE_104057_length_360_cov_8.191571	215	279	22	5	64	0.0781250
NODE_104057_length_360_cov_8.191571	215	279	28	2	64	0.0312500
NODE_104057_length_360_cov_8.191571	215	279	34	11	64	0.1718750
NODE_104057_length_360_cov_8.191571	215	279	38	2	64	0.0312500
NODE_104057_length_360_cov_8.191571	215	279	42	44	64	0.6875000
NODE_104079_length_360_cov_5.003831	86	166	2	80	80	1.0000000
NODE_104091_length_360_cov_4.111111	158	238	75	8	80	0.1000000
NODE_104091_length_360_cov_4.111111	158	238	76	1	80	0.0125000
NODE_104091_length_360_cov_4.111111	158	238	79	3	80	0.0375000
NODE_104091_length_360_cov_4.111111	158	238	80	4	80	0.0500000
NODE_104091_length_360_cov_4.111111	158	238	81	3	80	0.0375000
NODE_104091_length_360_cov_4.111111	158	238	82	1	80	0.0125000
NODE_104091_length_360_cov_4.111111	158	238	83	1	80	0.0125000
NODE_104091_length_360_cov_4.111111	158	238	84	2	80	0.0250000
NODE_104091_length_360_cov_4.111111	158	238	85	2	80	0.0250000
NODE_104091_length_360_cov_4.111111	158	238	86	2	80	0.0250000
NODE_104091_length_360_cov_4.111111	158	238	88	5	80	0.0625000
NODE_104091_length_360_cov_4.111111	158	238	91	3	80	0.0375000
NODE_104091_length_360_cov_4.111111	158	238	92	2	80	0.0250000
NODE_104091_length_360_cov_4.111111	158	238	93	2	80	0.0250000
NODE_104091_length_360_cov_4.111111	158	238	94	20	80	0.2500000
NODE_104091_length_360_cov_4.111111	158	238	95	21	80	0.2625000
NODE_104102_length_360_cov_3.613027	123	203	0	46	80	0.5750000
NODE_104102_length_360_cov_3.613027	123	203	2	34	80	0.4250000
NODE_104102_length_360_cov_3.613027	176	256	0	80	80	1.0000000
NODE_104129_length_360_cov_3.080460	48	70	0	22	22	1.0000000
NODE_104162_length_360_cov_2.689655	118	198	10	10	80	0.1250000
NODE_104162_length_360_cov_2.689655	118	198	11	8	80	0.1000000
NODE_104162_length_360_cov_2.689655	118	198	12	62	80	0.7750000
NODE_104261_length_360_cov_1.977011	235	286	8	44	51	0.8627451
NODE_104261_length_360_cov_1.977011	235	286	10	7	51	0.1372549
NODE_104572_length_360_cov_1.149425	273	353	0	69	80	0.8625000
NODE_104572_length_360_cov_1.149425	273	353	2	11	80	0.1375000
NODE_104669_length_360_cov_0.965517	119	175	0	56	56	1.0000000
NODE_104671_length_360_cov_0.957854	140	186	0	46	46	1.0000000
NODE_104858_length_359_cov_45.519231	140	220	0	80	80	1.0000000
NODE_104858_length_359_cov_45.519231	193	273	0	80	80	1.0000000
NODE_104932_length_359_cov_3.296154	67	147	0	3	80	0.0375000
NODE_104932_length_359_cov_3.296154	67	147	2	42	80	0.5250000
NODE_104932_length_359_cov_3.296154	67	147	4	9	80	0.1125000
NODE_104932_length_359_cov_3.296154	67	147	6	26	80	0.3250000
NODE_104932_length_359_cov_3.296154	120	177	4	1	57	0.0175439
NODE_104932_length_359_cov_3.296154	120	177	6	26	57	0.4561403
NODE_104932_length_359_cov_3.296154	120	177	10	30	57	0.5263158
NODE_104932_length_359_cov_3.296154	201	256	2	10	55	0.1818182
NODE_104932_length_359_cov_3.296154	201	256	4	18	55	0.3272727
NODE_104932_length_359_cov_3.296154	201	256	6	27	55	0.4909091
NODE_104936_length_359_cov_3.276923	5	95	0	50	90	0.5555556
NODE_104936_length_359_cov_3.276923	5	95	1	40	90	0.4444444
NODE_104954_length_359_cov_3.007692	156	212	16	16	56	0.2857143
NODE_104954_length_359_cov_3.007692	156	212	19	8	56	0.1428571
NODE_104954_length_359_cov_3.007692	156	212	20	3	56	0.0535714
NODE_104954_length_359_cov_3.007692	156	212	22	8	56	0.1428571
NODE_104954_length_359_cov_3.007692	156	212	23	1	56	0.0178571
NODE_104954_length_359_cov_3.007692	156	212	24	20	56	0.3571429
NODE_104998_length_359_cov_2.523077	148	228	0	80	80	1.0000000
NODE_104998_length_359_cov_2.523077	201	278	0	31	77	0.4025974
NODE_104998_length_359_cov_2.523077	201	278	2	46	77	0.5974026
NODE_105002_length_359_cov_2.419231	106	186	2	18	80	0.2250000
NODE_105002_length_359_cov_2.419231	106	186	4	2	80	0.0250000
NODE_105002_length_359_cov_2.419231	106	186	6	41	80	0.5125000
NODE_105002_length_359_cov_2.419231	106	186	8	19	80	0.2375000
NODE_105002_length_359_cov_2.419231	159	211	2	41	52	0.7884616
NODE_105002_length_359_cov_2.419231	159	211	4	2	52	0.0384615
NODE_105002_length_359_cov_2.419231	159	211	6	7	52	0.1346154
NODE_105002_length_359_cov_2.419231	159	211	8	2	52	0.0384615
NODE_105006_length_359_cov_2.353846	172	243	0	71	71	1.0000000
NODE_105006_length_359_cov_2.353846	216	296	0	80	80	1.0000000
NODE_105026_length_359_cov_2.257692	211	270	0	31	59	0.5254237
NODE_105026_length_359_cov_2.257692	211	270	2	28	59	0.4745763
NODE_105063_length_359_cov_2.003846	8	88	0	80	80	1.0000000
NODE_105063_length_359_cov_2.003846	61	139	0	78	78	1.0000000
NODE_105106_length_359_cov_1.815385	126	207	0	81	81	1.0000000
NODE_105106_length_359_cov_1.815385	180	227	0	47	47	1.0000000
NODE_105142_length_359_cov_1.692308	88	116	0	28	28	1.0000000
NODE_105373_length_359_cov_1.096154	64	89	0	25	25	1.0000000
NODE_105599_length_359_cov_0.711538	222	248	0	26	26	1.0000000
NODE_105600_length_359_cov_0.707692	10	90	0	72	80	0.9000000
NODE_105600_length_359_cov_0.707692	10	90	2	8	80	0.1000000
NODE_105600_length_359_cov_0.707692	10	90	0	72	80	0.9000000
NODE_105600_length_359_cov_0.707692	10	90	2	8	80	0.1000000
NODE_105600_length_359_cov_0.707692	63	143	0	19	80	0.2375000
NODE_105600_length_359_cov_0.707692	63	143	2	61	80	0.7625000
NODE_105678_length_358_cov_19.760618	213	293	0	31	80	0.3875000
NODE_105678_length_358_cov_19.760618	213	293	4	49	80	0.6125000
NODE_105678_length_358_cov_19.760618	266	346	0	80	80	1.0000000
NODE_105679_length_358_cov_18.455598	303	358	2	5	55	0.0909091
NODE_105679_length_358_cov_18.455598	303	358	4	4	55	0.0727273
NODE_105679_length_358_cov_18.455598	303	358	6	13	55	0.2363636
NODE_105679_length_358_cov_18.455598	303	358	12	12	55	0.2181818
NODE_105679_length_358_cov_18.455598	303	358	14	21	55	0.3818182
NODE_105680_length_358_cov_17.023166	0	63	21	1	63	0.0158730
NODE_105680_length_358_cov_17.023166	0	63	24	2	63	0.0317460
NODE_105680_length_358_cov_17.023166	0	63	32	2	63	0.0317460
NODE_105680_length_358_cov_17.023166	0	63	33	1	63	0.0158730
NODE_105680_length_358_cov_17.023166	0	63	35	3	63	0.0476190
NODE_105680_length_358_cov_17.023166	0	63	37	5	63	0.0793651
NODE_105680_length_358_cov_17.023166	0	63	41	4	63	0.0634921
NODE_105680_length_358_cov_17.023166	0	63	55	1	63	0.0158730
NODE_105680_length_358_cov_17.023166	0	63	58	3	63	0.0476190
NODE_105680_length_358_cov_17.023166	0	63	62	2	63	0.0317460
NODE_105680_length_358_cov_17.023166	0	63	76	2	63	0.0317460
NODE_105680_length_358_cov_17.023166	0	63	77	3	63	0.0476190
NODE_105680_length_358_cov_17.023166	0	63	79	1	63	0.0158730
NODE_105680_length_358_cov_17.023166	0	63	80	13	63	0.2063492
NODE_105680_length_358_cov_17.023166	0	63	94	2	63	0.0317460
NODE_105680_length_358_cov_17.023166	0	63	99	1	63	0.0158730
NODE_105680_length_358_cov_17.023166	0	63	103	1	63	0.0158730
NODE_105680_length_358_cov_17.023166	0	63	104	6	63	0.0952381
NODE_105680_length_358_cov_17.023166	0	63	109	9	63	0.1428571
NODE_105680_length_358_cov_17.023166	0	63	111	1	63	0.0158730
NODE_105680_length_358_cov_17.023166	0	63	21	1	63	0.0158730
NODE_105680_length_358_cov_17.023166	0	63	24	2	63	0.0317460
NODE_105680_length_358_cov_17.023166	0	63	32	2	63	0.0317460
NODE_105680_length_358_cov_17.023166	0	63	33	1	63	0.0158730
NODE_105680_length_358_cov_17.023166	0	63	35	3	63	0.0476190
NODE_105680_length_358_cov_17.023166	0	63	37	5	63	0.0793651
NODE_105680_length_358_cov_17.023166	0	63	41	4	63	0.0634921
NODE_105680_length_358_cov_17.023166	0	63	55	1	63	0.0158730
NODE_105680_length_358_cov_17.023166	0	63	58	3	63	0.0476190
NODE_105680_length_358_cov_17.023166	0	63	62	2	63	0.0317460
NODE_105680_length_358_cov_17.023166	0	63	76	2	63	0.0317460
NODE_105680_length_358_cov_17.023166	0	63	77	3	63	0.0476190
NODE_105680_length_358_cov_17.023166	0	63	79	1	63	0.0158730
NODE_105680_length_358_cov_17.023166	0	63	80	13	63	0.2063492
NODE_105680_length_358_cov_17.023166	0	63	94	2	63	0.0317460
NODE_105680_length_358_cov_17.023166	0	63	99	1	63	0.0158730
NODE_105680_length_358_cov_17.023166	0	63	103	1	63	0.0158730
NODE_105680_length_358_cov_17.023166	0	63	104	6	63	0.0952381
NODE_105680_length_358_cov_17.023166	0	63	109	9	63	0.1428571
NODE_105680_length_358_cov_17.023166	0	63	111	1	63	0.0158730
NODE_105680_length_358_cov_17.023166	0	63	21	1	63	0.0158730
NODE_105680_length_358_cov_17.023166	0	63	24	2	63	0.0317460
NODE_105680_length_358_cov_17.023166	0	63	32	2	63	0.0317460
NODE_105680_length_358_cov_17.023166	0	63	33	1	63	0.0158730
NODE_105680_length_358_cov_17.023166	0	63	35	3	63	0.0476190
NODE_105680_length_358_cov_17.023166	0	63	37	5	63	0.0793651
NODE_105680_length_358_cov_17.023166	0	63	41	4	63	0.0634921
NODE_105680_length_358_cov_17.023166	0	63	55	1	63	0.0158730
NODE_105680_length_358_cov_17.023166	0	63	58	3	63	0.0476190
NODE_105680_length_358_cov_17.023166	0	63	62	2	63	0.0317460
NODE_105680_length_358_cov_17.023166	0	63	76	2	63	0.0317460
NODE_105680_length_358_cov_17.023166	0	63	77	3	63	0.0476190
NODE_105680_length_358_cov_17.023166	0	63	79	1	63	0.0158730
NODE_105680_length_358_cov_17.023166	0	63	80	13	63	0.2063492
NODE_105680_length_358_cov_17.023166	0	63	94	2	63	0.0317460
NODE_105680_length_358_cov_17.023166	0	63	99	1	63	0.0158730
NODE_105680_length_358_cov_17.023166	0	63	103	1	63	0.0158730
NODE_105680_length_358_cov_17.023166	0	63	104	6	63	0.0952381
NODE_105680_length_358_cov_17.023166	0	63	109	9	63	0.1428571
NODE_105680_length_358_cov_17.023166	0	63	111	1	63	0.0158730
NODE_105680_length_358_cov_17.023166	36	116	80	7	80	0.0875000
NODE_105680_length_358_cov_17.023166	36	116	94	2	80	0.0250000
NODE_105680_length_358_cov_17.023166	36	116	99	1	80	0.0125000
NODE_105680_length_358_cov_17.023166	36	116	103	1	80	0.0125000
NODE_105680_length_358_cov_17.023166	36	116	104	6	80	0.0750000
NODE_105680_length_358_cov_17.023166	36	116	109	9	80	0.1125000
NODE_105680_length_358_cov_17.023166	36	116	111	2	80	0.0250000
NODE_105680_length_358_cov_17.023166	36	116	113	4	80	0.0500000
NODE_105680_length_358_cov_17.023166	36	116	114	24	80	0.3000000
NODE_105680_length_358_cov_17.023166	36	116	116	15	80	0.1875000
NODE_105680_length_358_cov_17.023166	36	116	117	1	80	0.0125000
NODE_105680_length_358_cov_17.023166	36	116	118	6	80	0.0750000
NODE_105680_length_358_cov_17.023166	36	116	119	2	80	0.0250000
NODE_105680_length_358_cov_17.023166	53	115	109	9	62	0.1451613
NODE_105680_length_358_cov_17.023166	53	115	111	2	62	0.0322581
NODE_105680_length_358_cov_17.023166	53	115	113	4	62	0.0645161
NODE_105680_length_358_cov_17.023166	53	115	114	24	62	0.3870968
NODE_105680_length_358_cov_17.023166	53	115	116	15	62	0.2419355
NODE_105680_length_358_cov_17.023166	53	115	117	1	62	0.0161290
NODE_105680_length_358_cov_17.023166	53	115	118	5	62	0.0806452
NODE_105680_length_358_cov_17.023166	53	115	119	2	62	0.0322581
NODE_105686_length_358_cov_6.509653	109	155	0	46	46	1.0000000
NODE_105710_length_358_cov_4.239382	114	143	6	19	29	0.6551724
NODE_105710_length_358_cov_4.239382	114	143	8	1	29	0.0344828
NODE_105710_length_358_cov_4.239382	114	143	10	1	29	0.0344828
NODE_105710_length_358_cov_4.239382	114	143	12	8	29	0.2758621
NODE_105710_length_358_cov_4.239382	180	245	18	3	65	0.0461538
NODE_105710_length_358_cov_4.239382	180	245	20	3	65	0.0461538
NODE_105710_length_358_cov_4.239382	180	245	21	17	65	0.2615385
NODE_105710_length_358_cov_4.239382	180	245	24	16	65	0.2461538
NODE_105710_length_358_cov_4.239382	180	245	25	6	65	0.0923077
NODE_105710_length_358_cov_4.239382	180	245	26	6	65	0.0923077
NODE_105710_length_358_cov_4.239382	180	245	28	14	65	0.2153846
NODE_105710_length_358_cov_4.239382	218	298	12	16	80	0.2000000
NODE_105710_length_358_cov_4.239382	218	298	14	20	80	0.2500000
NODE_105710_length_358_cov_4.239382	218	298	16	6	80	0.0750000
NODE_105710_length_358_cov_4.239382	218	298	18	14	80	0.1750000
NODE_105710_length_358_cov_4.239382	218	298	20	3	80	0.0375000
NODE_105710_length_358_cov_4.239382	218	298	21	17	80	0.2125000
NODE_105710_length_358_cov_4.239382	218	298	25	4	80	0.0500000
NODE_105846_length_358_cov_2.162162	229	305	0	35	76	0.4605263
NODE_105846_length_358_cov_2.162162	229	305	2	35	76	0.4605263
NODE_105846_length_358_cov_2.162162	229	305	4	2	76	0.0263158
NODE_105846_length_358_cov_2.162162	229	305	6	1	76	0.0131579
NODE_105846_length_358_cov_2.162162	229	305	7	3	76	0.0394737
NODE_105902_length_358_cov_1.926641	290	358	0	3	68	0.0441176
NODE_105902_length_358_cov_1.926641	290	358	2	11	68	0.1617647
NODE_105902_length_358_cov_1.926641	290	358	4	54	68	0.7941176
NODE_105910_length_358_cov_1.884170	250	317	0	67	67	1.0000000
NODE_105923_length_358_cov_1.841699	189	269	0	4	80	0.0500000
NODE_105923_length_358_cov_1.841699	189	269	2	20	80	0.2500000
NODE_105923_length_358_cov_1.841699	189	269	4	48	80	0.6000000
NODE_105923_length_358_cov_1.841699	189	269	6	8	80	0.1000000
NODE_106096_length_358_cov_1.235521	99	179	10	2	80	0.0250000
NODE_106096_length_358_cov_1.235521	99	179	14	6	80	0.0750000
NODE_106096_length_358_cov_1.235521	99	179	16	12	80	0.1500000
NODE_106096_length_358_cov_1.235521	99	179	18	9	80	0.1125000
NODE_106096_length_358_cov_1.235521	99	179	20	7	80	0.0875000
NODE_106096_length_358_cov_1.235521	99	179	22	8	80	0.1000000
NODE_106096_length_358_cov_1.235521	99	179	24	13	80	0.1625000
NODE_106096_length_358_cov_1.235521	99	179	26	7	80	0.0875000
NODE_106096_length_358_cov_1.235521	99	179	28	14	80	0.1750000
NODE_106096_length_358_cov_1.235521	99	179	30	2	80	0.0250000
NODE_106096_length_358_cov_1.235521	152	222	0	23	70	0.3285714
NODE_106096_length_358_cov_1.235521	152	222	8	4	70	0.0571429
NODE_106096_length_358_cov_1.235521	152	222	10	18	70	0.2571429
NODE_106096_length_358_cov_1.235521	152	222	14	6	70	0.0857143
NODE_106096_length_358_cov_1.235521	152	222	16	12	70	0.1714286
NODE_106096_length_358_cov_1.235521	152	222	18	7	70	0.1000000
NODE_106189_length_358_cov_1.096525	148	228	0	80	80	1.0000000
NODE_106233_length_358_cov_0.984556	193	265	4	3	72	0.0416667
NODE_106233_length_358_cov_0.984556	193	265	6	26	72	0.3611111
NODE_106233_length_358_cov_0.984556	193	265	8	43	72	0.5972222
NODE_106489_length_357_cov_381.833333	244	324	32	10	80	0.1250000
NODE_106489_length_357_cov_381.833333	244	324	38	1	80	0.0125000
NODE_106489_length_357_cov_381.833333	244	324	42	1	80	0.0125000
NODE_106489_length_357_cov_381.833333	244	324	44	4	80	0.0500000
NODE_106489_length_357_cov_381.833333	244	324	46	1	80	0.0125000
NODE_106489_length_357_cov_381.833333	244	324	50	3	80	0.0375000
NODE_106489_length_357_cov_381.833333	244	324	53	1	80	0.0125000
NODE_106489_length_357_cov_381.833333	244	324	58	8	80	0.1000000
NODE_106489_length_357_cov_381.833333	244	324	60	51	80	0.6375000
NODE_106493_length_357_cov_7.643411	45	125	0	55	80	0.6875000
NODE_106493_length_357_cov_7.643411	45	125	2	25	80	0.3125000
NODE_106493_length_357_cov_7.643411	98	178	0	2	80	0.0250000
NODE_106493_length_357_cov_7.643411	98	178	2	78	80	0.9750000
NODE_106495_length_357_cov_7.027132	157	237	0	80	80	1.0000000
NODE_106495_length_357_cov_7.027132	210	252	0	42	42	1.0000000
NODE_106496_length_357_cov_6.732558	183	263	18	1	80	0.0125000
NODE_106496_length_357_cov_6.732558	183	263	20	27	80	0.3375000
NODE_106496_length_357_cov_6.732558	183	263	22	52	80	0.6500000
NODE_106529_length_357_cov_4.081395	145	225	0	80	80	1.0000000
NODE_106529_length_357_cov_4.081395	198	271	0	73	73	1.0000000
NODE_106542_length_357_cov_3.724806	192	265	2	37	73	0.5068493
NODE_106542_length_357_cov_3.724806	192	265	4	36	73	0.4931507
NODE_106558_length_357_cov_3.341085	205	285	0	80	80	1.0000000
NODE_106558_length_357_cov_3.341085	258	338	0	80	80	1.0000000
NODE_106625_length_357_cov_2.414729	245	302	0	11	57	0.1929825
NODE_106625_length_357_cov_2.414729	245	302	2	46	57	0.8070176
NODE_106625_length_357_cov_2.414729	275	355	0	23	80	0.2875000
NODE_106625_length_357_cov_2.414729	275	355	2	57	80	0.7125000
NODE_106661_length_357_cov_2.174419	250	330	0	10	80	0.1250000
NODE_106661_length_357_cov_2.174419	250	330	2	70	80	0.8750000
NODE_106666_length_357_cov_2.166667	103	133	4	30	30	1.0000000
NODE_106666_length_357_cov_2.166667	112	133	4	21	21	1.0000000
NODE_106702_length_357_cov_1.961240	150	169	2	19	19	1.0000000
NODE_106708_length_357_cov_1.918605	173	253	23	1	80	0.0125000
NODE_106708_length_357_cov_1.918605	173	253	25	4	80	0.0500000
NODE_106708_length_357_cov_1.918605	173	253	27	32	80	0.4000000
NODE_106708_length_357_cov_1.918605	173	253	28	1	80	0.0125000
NODE_106708_length_357_cov_1.918605	173	253	29	2	80	0.0250000
NODE_106708_length_357_cov_1.918605	173	253	30	2	80	0.0250000
NODE_106708_length_357_cov_1.918605	173	253	34	16	80	0.2000000
NODE_106708_length_357_cov_1.918605	173	253	35	18	80	0.2250000
NODE_106708_length_357_cov_1.918605	173	253	36	3	80	0.0375000
NODE_106708_length_357_cov_1.918605	173	253	38	1	80	0.0125000
NODE_106737_length_357_cov_1.782946	73	142	0	36	69	0.5217391
NODE_106737_length_357_cov_1.782946	73	142	2	33	69	0.4782609
NODE_106737_length_357_cov_1.782946	115	195	2	80	80	1.0000000
NODE_107002_length_357_cov_1.127907	98	129	6	15	31	0.4838710
NODE_107002_length_357_cov_1.127907	98	129	8	16	31	0.5161290
NODE_107306_length_356_cov_5.299611	140	200	12	16	60	0.2666667
NODE_107306_length_356_cov_5.299611	140	200	14	1	60	0.0166667
NODE_107306_length_356_cov_5.299611	140	200	16	4	60	0.0666667
NODE_107306_length_356_cov_5.299611	140	200	20	39	60	0.6500000
NODE_107347_length_356_cov_3.400778	255	317	2	6	62	0.0967742
NODE_107347_length_356_cov_3.400778	255	317	4	56	62	0.9032258
NODE_107347_length_356_cov_3.400778	308	353	0	10	45	0.2222222
NODE_107347_length_356_cov_3.400778	308	353	2	4	45	0.0888889
NODE_107347_length_356_cov_3.400778	308	353	4	31	45	0.6888889
NODE_107402_length_356_cov_2.657588	256	298	93	4	42	0.0952381
NODE_107402_length_356_cov_2.657588	256	298	94	12	42	0.2857143
NODE_107402_length_356_cov_2.657588	256	298	98	5	42	0.1190476
NODE_107402_length_356_cov_2.657588	256	298	100	16	42	0.3809524
NODE_107402_length_356_cov_2.657588	256	298	101	1	42	0.0238095
NODE_107402_length_356_cov_2.657588	256	298	105	4	42	0.0952381
NODE_107402_length_356_cov_2.657588	265	338	39	2	73	0.0273973
NODE_107402_length_356_cov_2.657588	265	338	51	4	73	0.0547945
NODE_107402_length_356_cov_2.657588	265	338	53	2	73	0.0273973
NODE_107402_length_356_cov_2.657588	265	338	56	1	73	0.0136986
NODE_107402_length_356_cov_2.657588	265	338	58	3	73	0.0410959
NODE_107402_length_356_cov_2.657588	265	338	63	1	73	0.0136986
NODE_107402_length_356_cov_2.657588	265	338	70	1	73	0.0136986
NODE_107402_length_356_cov_2.657588	265	338	76	4	73	0.0547945
NODE_107402_length_356_cov_2.657588	265	338	80	1	73	0.0136986
NODE_107402_length_356_cov_2.657588	265	338	82	6	73	0.0821918
NODE_107402_length_356_cov_2.657588	265	338	84	2	73	0.0273973
NODE_107402_length_356_cov_2.657588	265	338	87	3	73	0.0410959
NODE_107402_length_356_cov_2.657588	265	338	89	3	73	0.0410959
NODE_107402_length_356_cov_2.657588	265	338	90	3	73	0.0410959
NODE_107402_length_356_cov_2.657588	265	338	91	4	73	0.0547945
NODE_107402_length_356_cov_2.657588	265	338	93	4	73	0.0547945
NODE_107402_length_356_cov_2.657588	265	338	94	12	73	0.1643836
NODE_107402_length_356_cov_2.657588	265	338	98	5	73	0.0684932
NODE_107402_length_356_cov_2.657588	265	338	100	12	73	0.1643836
NODE_107402_length_356_cov_2.657588	299	351	17	3	52	0.0576923
NODE_107402_length_356_cov_2.657588	299	351	20	1	52	0.0192308
NODE_107402_length_356_cov_2.657588	299	351	21	1	52	0.0192308
NODE_107402_length_356_cov_2.657588	299	351	23	1	52	0.0192308
NODE_107402_length_356_cov_2.657588	299	351	27	2	52	0.0384615
NODE_107402_length_356_cov_2.657588	299	351	29	1	52	0.0192308
NODE_107402_length_356_cov_2.657588	299	351	33	4	52	0.0769231
NODE_107402_length_356_cov_2.657588	299	351	39	2	52	0.0384615
NODE_107402_length_356_cov_2.657588	299	351	51	4	52	0.0769231
NODE_107402_length_356_cov_2.657588	299	351	53	2	52	0.0384615
NODE_107402_length_356_cov_2.657588	299	351	56	1	52	0.0192308
NODE_107402_length_356_cov_2.657588	299	351	58	3	52	0.0576923
NODE_107402_length_356_cov_2.657588	299	351	63	1	52	0.0192308
NODE_107402_length_356_cov_2.657588	299	351	70	1	52	0.0192308
NODE_107402_length_356_cov_2.657588	299	351	76	4	52	0.0769231
NODE_107402_length_356_cov_2.657588	299	351	80	1	52	0.0192308
NODE_107402_length_356_cov_2.657588	299	351	82	6	52	0.1153846
NODE_107402_length_356_cov_2.657588	299	351	84	2	52	0.0384615
NODE_107402_length_356_cov_2.657588	299	351	87	3	52	0.0576923
NODE_107402_length_356_cov_2.657588	299	351	89	3	52	0.0576923
NODE_107402_length_356_cov_2.657588	299	351	90	3	52	0.0576923
NODE_107402_length_356_cov_2.657588	299	351	91	3	52	0.0576923
NODE_107452_length_356_cov_2.237354	90	135	2	44	45	0.9777778
NODE_107452_length_356_cov_2.237354	90	135	4	1	45	0.0222222
NODE_107475_length_356_cov_1.996109	127	194	2	67	67	1.0000000
NODE_107521_length_356_cov_1.813230	296	341	0	45	45	1.0000000
NODE_107606_length_356_cov_1.560311	192	272	0	4	80	0.0500000
NODE_107606_length_356_cov_1.560311	192	272	2	71	80	0.8875000
NODE_107606_length_356_cov_1.560311	192	272	4	5	80	0.0625000
NODE_107606_length_356_cov_1.560311	245	319	0	33	74	0.4459459
NODE_107606_length_356_cov_1.560311	245	319	2	41	74	0.5540541
NODE_108122_length_355_cov_6.796875	127	173	0	46	46	1.0000000
NODE_108210_length_355_cov_2.734375	111	162	0	51	51	1.0000000
NODE_108210_length_355_cov_2.734375	142	222	0	80	80	1.0000000
NODE_108215_length_355_cov_2.707031	277	314	0	37	37	1.0000000
NODE_108215_length_355_cov_2.707031	287	353	0	66	66	1.0000000
NODE_108239_length_355_cov_2.500000	38	82	0	17	44	0.3863636
NODE_108239_length_355_cov_2.500000	38	82	1	2	44	0.0454545
NODE_108239_length_355_cov_2.500000	38	82	2	25	44	0.5681818
NODE_108278_length_355_cov_2.207031	258	308	0	50	50	1.0000000
NODE_108284_length_355_cov_2.179688	153	233	11	12	80	0.1500000
NODE_108284_length_355_cov_2.179688	153	233	15	1	80	0.0125000
NODE_108284_length_355_cov_2.179688	153	233	17	12	80	0.1500000
NODE_108284_length_355_cov_2.179688	153	233	18	33	80	0.4125000
NODE_108284_length_355_cov_2.179688	153	233	20	22	80	0.2750000
NODE_108284_length_355_cov_2.179688	206	286	13	2	80	0.0250000
NODE_108284_length_355_cov_2.179688	206	286	17	3	80	0.0375000
NODE_108284_length_355_cov_2.179688	206	286	18	44	80	0.5500000
NODE_108284_length_355_cov_2.179688	206	286	20	31	80	0.3875000
NODE_108291_length_355_cov_2.132812	261	334	0	73	73	1.0000000
NODE_108291_length_355_cov_2.132812	301	342	0	41	41	1.0000000
NODE_108315_length_355_cov_2.007812	281	347	0	66	66	1.0000000
NODE_108395_length_355_cov_1.765625	186	247	8	10	61	0.1639344
NODE_108395_length_355_cov_1.765625	186	247	10	32	61	0.5245901
NODE_108395_length_355_cov_1.765625	186	247	16	18	61	0.2950820
NODE_108395_length_355_cov_1.765625	186	247	18	1	61	0.0163934
NODE_108395_length_355_cov_1.765625	220	300	2	3	80	0.0375000
NODE_108395_length_355_cov_1.765625	220	300	4	22	80	0.2750000
NODE_108395_length_355_cov_1.765625	220	300	6	18	80	0.2250000
NODE_108395_length_355_cov_1.765625	220	300	8	20	80	0.2500000
NODE_108395_length_355_cov_1.765625	220	300	10	17	80	0.2125000
NODE_109015_length_354_cov_6.843137	53	132	0	79	79	1.0000000
NODE_109015_length_354_cov_6.843137	53	132	0	79	79	1.0000000
NODE_109015_length_354_cov_6.843137	105	185	0	80	80	1.0000000
NODE_109015_length_354_cov_6.843137	105	185	0	80	80	1.0000000
NODE_109033_length_354_cov_4.823529	208	255	0	47	47	1.0000000
NODE_109054_length_354_cov_3.956863	145	208	0	63	63	1.0000000
NODE_109054_length_354_cov_3.956863	181	261	0	80	80	1.0000000
NODE_109057_length_354_cov_3.878431	198	244	0	46	46	1.0000000
NODE_109089_length_354_cov_3.207843	130	199	0	69	69	1.0000000
NODE_109126_length_354_cov_2.725490	179	259	0	22	80	0.2750000
NODE_109126_length_354_cov_2.725490	179	259	1	27	80	0.3375000
NODE_109126_length_354_cov_2.725490	179	259	9	1	80	0.0125000
NODE_109126_length_354_cov_2.725490	179	259	11	1	80	0.0125000
NODE_109126_length_354_cov_2.725490	179	259	12	1	80	0.0125000
NODE_109126_length_354_cov_2.725490	179	259	13	4	80	0.0500000
NODE_109126_length_354_cov_2.725490	179	259	14	1	80	0.0125000
NODE_109126_length_354_cov_2.725490	179	259	16	1	80	0.0125000
NODE_109126_length_354_cov_2.725490	179	259	18	22	80	0.2750000
NODE_109126_length_354_cov_2.725490	235	312	14	1	77	0.0129870
NODE_109126_length_354_cov_2.725490	235	312	16	16	77	0.2077922
NODE_109126_length_354_cov_2.725490	235	312	18	60	77	0.7792208
NODE_109128_length_354_cov_2.713725	16	76	0	34	60	0.5666667
NODE_109128_length_354_cov_2.713725	16	76	2	26	60	0.4333333
NODE_109128_length_354_cov_2.713725	90	149	0	25	59	0.4237288
NODE_109128_length_354_cov_2.713725	90	149	2	34	59	0.5762712
NODE_109140_length_354_cov_2.580392	176	234	0	5	58	0.0862069
NODE_109140_length_354_cov_2.580392	176	234	2	10	58	0.1724138
NODE_109140_length_354_cov_2.580392	176	234	4	43	58	0.7413793
NODE_109140_length_354_cov_2.580392	207	251	4	44	44	1.0000000
NODE_109237_length_354_cov_1.996078	79	145	0	66	66	1.0000000
NODE_109237_length_354_cov_1.996078	118	200	0	82	82	1.0000000
NODE_109244_length_354_cov_1.988235	7	77	0	39	70	0.5571429
NODE_109244_length_354_cov_1.988235	7	77	3	1	70	0.0142857
NODE_109244_length_354_cov_1.988235	7	77	4	10	70	0.1428571
NODE_109244_length_354_cov_1.988235	7	77	6	20	70	0.2857143
NODE_109244_length_354_cov_1.988235	64	130	6	66	66	1.0000000
NODE_109321_length_354_cov_1.682353	99	171	0	72	72	1.0000000
NODE_109321_length_354_cov_1.682353	144	224	0	80	80	1.0000000
NODE_109852_length_353_cov_11.169291	14	90	0	76	76	1.0000000
NODE_109852_length_353_cov_11.169291	67	143	0	76	76	1.0000000
NODE_109911_length_353_cov_3.874016	220	256	0	36	36	1.0000000
NODE_109911_length_353_cov_3.874016	265	334	0	69	69	1.0000000
NODE_109928_length_353_cov_3.488189	200	282	10	36	82	0.4390244
NODE_109928_length_353_cov_3.488189	200	282	12	1	82	0.0121951
NODE_109928_length_353_cov_3.488189	200	282	13	13	82	0.1585366
NODE_109928_length_353_cov_3.488189	200	282	14	32	82	0.3902439
NODE_109976_length_353_cov_2.826772	8	88	0	31	80	0.3875000
NODE_109976_length_353_cov_2.826772	8	88	2	49	80	0.6125000
NODE_109976_length_353_cov_2.826772	61	120	2	59	59	1.0000000
NODE_110022_length_353_cov_2.417323	260	336	0	76	76	1.0000000
NODE_110610_length_353_cov_0.744094	299	318	0	12	19	0.6315789
NODE_110610_length_353_cov_0.744094	299	318	2	7	19	0.3684210
NODE_110708_length_352_cov_34.691700	110	203	0	39	93	0.4193548
NODE_110708_length_352_cov_34.691700	110	203	2	50	93	0.5376344
NODE_110708_length_352_cov_34.691700	110	203	4	1	93	0.0107527
NODE_110708_length_352_cov_34.691700	110	203	12	1	93	0.0107527
NODE_110708_length_352_cov_34.691700	110	203	29	1	93	0.0107527
NODE_110708_length_352_cov_34.691700	110	203	52	1	93	0.0107527
NODE_110710_length_352_cov_17.944664	20	100	0	80	80	1.0000000
NODE_110710_length_352_cov_17.944664	73	153	0	80	80	1.0000000
NODE_110710_length_352_cov_17.944664	273	352	0	79	79	1.0000000
NODE_110735_length_352_cov_4.707510	157	237	0	24	80	0.3000000
NODE_110735_length_352_cov_4.707510	157	237	2	24	80	0.3000000
NODE_110735_length_352_cov_4.707510	157	237	4	32	80	0.4000000
NODE_110749_length_352_cov_4.221344	144	205	0	61	61	1.0000000
NODE_110749_length_352_cov_4.221344	178	259	0	81	81	1.0000000
NODE_110754_length_352_cov_4.011858	98	143	0	45	45	1.0000000
NODE_110754_length_352_cov_4.011858	151	228	0	19	77	0.2467532
NODE_110754_length_352_cov_4.011858	151	228	2	18	77	0.2337662
NODE_110754_length_352_cov_4.011858	151	228	4	40	77	0.5194805
NODE_110798_length_352_cov_2.849802	74	154	0	77	80	0.9625000
NODE_110798_length_352_cov_2.849802	74	154	2	3	80	0.0375000
NODE_110798_length_352_cov_2.849802	127	198	0	24	71	0.3380282
NODE_110798_length_352_cov_2.849802	127	198	2	47	71	0.6619718
NODE_110820_length_352_cov_2.683794	0	77	0	14	77	0.1818182
NODE_110820_length_352_cov_2.683794	0	77	2	43	77	0.5584416
NODE_110820_length_352_cov_2.683794	0	77	4	20	77	0.2597403
NODE_110820_length_352_cov_2.683794	50	130	2	17	80	0.2125000
NODE_110820_length_352_cov_2.683794	50	130	4	63	80	0.7875000
NODE_110832_length_352_cov_2.608696	90	136	0	46	46	1.0000000
NODE_110832_length_352_cov_2.608696	144	189	0	45	45	1.0000000
NODE_110838_length_352_cov_2.577075	111	191	0	29	80	0.3625000
NODE_110838_length_352_cov_2.577075	111	191	2	51	80	0.6375000
NODE_110876_length_352_cov_2.264822	171	251	0	80	80	1.0000000
NODE_110938_length_352_cov_2.007905	277	326	0	32	49	0.6530612
NODE_110938_length_352_cov_2.007905	277	326	2	17	49	0.3469388
NODE_111439_length_352_cov_0.806324	165	238	33	1	73	0.0136986
NODE_111439_length_352_cov_0.806324	165	238	34	1	73	0.0136986
NODE_111439_length_352_cov_0.806324	165	238	37	1	73	0.0136986
NODE_111439_length_352_cov_0.806324	165	238	39	2	73	0.0273973
NODE_111439_length_352_cov_0.806324	165	238	46	1	73	0.0136986
NODE_111439_length_352_cov_0.806324	165	238	48	2	73	0.0273973
NODE_111439_length_352_cov_0.806324	165	238	50	2	73	0.0273973
NODE_111439_length_352_cov_0.806324	165	238	52	1	73	0.0136986
NODE_111439_length_352_cov_0.806324	165	238	55	1	73	0.0136986
NODE_111439_length_352_cov_0.806324	165	238	57	2	73	0.0273973
NODE_111439_length_352_cov_0.806324	165	238	58	1	73	0.0136986
NODE_111439_length_352_cov_0.806324	165	238	61	1	73	0.0136986
NODE_111439_length_352_cov_0.806324	165	238	63	2	73	0.0273973
NODE_111439_length_352_cov_0.806324	165	238	65	2	73	0.0273973
NODE_111439_length_352_cov_0.806324	165	238	67	2	73	0.0273973
NODE_111439_length_352_cov_0.806324	165	238	70	3	73	0.0410959
NODE_111439_length_352_cov_0.806324	165	238	72	1	73	0.0136986
NODE_111439_length_352_cov_0.806324	165	238	73	1	73	0.0136986
NODE_111439_length_352_cov_0.806324	165	238	76	1	73	0.0136986
NODE_111439_length_352_cov_0.806324	165	238	78	2	73	0.0273973
NODE_111439_length_352_cov_0.806324	165	238	82	1	73	0.0136986
NODE_111439_length_352_cov_0.806324	165	238	84	2	73	0.0273973
NODE_111439_length_352_cov_0.806324	165	238	86	1	73	0.0136986
NODE_111439_length_352_cov_0.806324	165	238	92	2	73	0.0273973
NODE_111439_length_352_cov_0.806324	165	238	93	4	73	0.0547945
NODE_111439_length_352_cov_0.806324	165	238	95	1	73	0.0136986
NODE_111439_length_352_cov_0.806324	165	238	97	4	73	0.0547945
NODE_111439_length_352_cov_0.806324	165	238	99	5	73	0.0684932
NODE_111439_length_352_cov_0.806324	165	238	103	14	73	0.1917808
NODE_111439_length_352_cov_0.806324	165	238	105	8	73	0.1095890
NODE_111439_length_352_cov_0.806324	165	238	107	1	73	0.0136986
NODE_111593_length_351_cov_5.003968	115	195	0	80	80	1.0000000
NODE_111662_length_351_cov_2.900794	289	320	0	31	31	1.0000000
NODE_111738_length_351_cov_2.376984	79	159	10	1	80	0.0125000
NODE_111738_length_351_cov_2.376984	79	159	14	5	80	0.0625000
NODE_111738_length_351_cov_2.376984	79	159	16	19	80	0.2375000
NODE_111738_length_351_cov_2.376984	79	159	18	3	80	0.0375000
NODE_111738_length_351_cov_2.376984	79	159	20	10	80	0.1250000
NODE_111738_length_351_cov_2.376984	79	159	22	2	80	0.0250000
NODE_111738_length_351_cov_2.376984	79	159	27	1	80	0.0125000
NODE_111738_length_351_cov_2.376984	79	159	29	23	80	0.2875000
NODE_111738_length_351_cov_2.376984	79	159	31	16	80	0.2000000
NODE_111759_length_351_cov_2.226190	116	170	21	5	54	0.0925926
NODE_111759_length_351_cov_2.226190	116	170	23	10	54	0.1851852
NODE_111759_length_351_cov_2.226190	116	170	25	1	54	0.0185185
NODE_111759_length_351_cov_2.226190	116	170	27	2	54	0.0370370
NODE_111759_length_351_cov_2.226190	116	170	29	36	54	0.6666667
NODE_111769_length_351_cov_2.186508	198	277	0	39	79	0.4936709
NODE_111769_length_351_cov_2.186508	198	277	2	40	79	0.5063291
NODE_111861_length_351_cov_1.809524	276	309	1	25	33	0.7575758
NODE_111861_length_351_cov_1.809524	276	309	2	8	33	0.2424242
NODE_111969_length_351_cov_1.515873	228	299	0	71	71	1.0000000
NODE_112493_length_350_cov_232.529880	25	92	97	1	67	0.0149254
NODE_112493_length_350_cov_232.529880	25	92	101	1	67	0.0149254
NODE_112493_length_350_cov_232.529880	25	92	108	2	67	0.0298507
NODE_112493_length_350_cov_232.529880	25	92	112	3	67	0.0447761
NODE_112493_length_350_cov_232.529880	25	92	116	2	67	0.0298507
NODE_112493_length_350_cov_232.529880	25	92	122	1	67	0.0149254
NODE_112493_length_350_cov_232.529880	25	92	124	2	67	0.0298507
NODE_112493_length_350_cov_232.529880	25	92	128	1	67	0.0149254
NODE_112493_length_350_cov_232.529880	25	92	134	2	67	0.0298507
NODE_112493_length_350_cov_232.529880	25	92	136	1	67	0.0149254
NODE_112493_length_350_cov_232.529880	25	92	141	1	67	0.0149254
NODE_112493_length_350_cov_232.529880	25	92	144	1	67	0.0149254
NODE_112493_length_350_cov_232.529880	25	92	146	1	67	0.0149254
NODE_112493_length_350_cov_232.529880	25	92	152	1	67	0.0149254
NODE_112493_length_350_cov_232.529880	25	92	158	1	67	0.0149254
NODE_112493_length_350_cov_232.529880	25	92	160	1	67	0.0149254
NODE_112493_length_350_cov_232.529880	25	92	166	1	67	0.0149254
NODE_112493_length_350_cov_232.529880	25	92	168	2	67	0.0298507
NODE_112493_length_350_cov_232.529880	25	92	170	4	67	0.0597015
NODE_112493_length_350_cov_232.529880	25	92	182	2	67	0.0298507
NODE_112493_length_350_cov_232.529880	25	92	184	1	67	0.0149254
NODE_112493_length_350_cov_232.529880	25	92	188	2	67	0.0298507
NODE_112493_length_350_cov_232.529880	25	92	192	1	67	0.0149254
NODE_112493_length_350_cov_232.529880	25	92	198	1	67	0.0149254
NODE_112493_length_350_cov_232.529880	25	92	199	2	67	0.0298507
NODE_112493_length_350_cov_232.529880	25	92	203	2	67	0.0298507
NODE_112493_length_350_cov_232.529880	25	92	205	2	67	0.0298507
NODE_112493_length_350_cov_232.529880	25	92	207	4	67	0.0597015
NODE_112493_length_350_cov_232.529880	25	92	211	2	67	0.0298507
NODE_112493_length_350_cov_232.529880	25	92	213	2	67	0.0298507
NODE_112493_length_350_cov_232.529880	25	92	217	3	67	0.0447761
NODE_112493_length_350_cov_232.529880	25	92	219	8	67	0.1194030
NODE_112493_length_350_cov_232.529880	25	92	221	2	67	0.0298507
NODE_112493_length_350_cov_232.529880	25	92	223	4	67	0.0597015
NODE_112494_length_350_cov_40.677291	181	246	268	1	65	0.0153846
NODE_112494_length_350_cov_40.677291	181	246	270	2	65	0.0307692
NODE_112494_length_350_cov_40.677291	181	246	271	1	65	0.0153846
NODE_112494_length_350_cov_40.677291	181	246	276	1	65	0.0153846
NODE_112494_length_350_cov_40.677291	181	246	277	1	65	0.0153846
NODE_112494_length_350_cov_40.677291	181	246	278	1	65	0.0153846
NODE_112494_length_350_cov_40.677291	181	246	279	3	65	0.0461538
NODE_112494_length_350_cov_40.677291	181	246	281	1	65	0.0153846
NODE_112494_length_350_cov_40.677291	181	246	282	1	65	0.0153846
NODE_112494_length_350_cov_40.677291	181	246	283	1	65	0.0153846
NODE_112494_length_350_cov_40.677291	181	246	284	3	65	0.0461538
NODE_112494_length_350_cov_40.677291	181	246	285	3	65	0.0461538
NODE_112494_length_350_cov_40.677291	181	246	286	3	65	0.0461538
NODE_112494_length_350_cov_40.677291	181	246	291	3	65	0.0461538
NODE_112494_length_350_cov_40.677291	181	246	293	1	65	0.0153846
NODE_112494_length_350_cov_40.677291	181	246	295	3	65	0.0461538
NODE_112494_length_350_cov_40.677291	181	246	297	4	65	0.0615385
NODE_112494_length_350_cov_40.677291	181	246	298	4	65	0.0615385
NODE_112494_length_350_cov_40.677291	181	246	299	4	65	0.0615385
NODE_112494_length_350_cov_40.677291	181	246	300	1	65	0.0153846
NODE_112494_length_350_cov_40.677291	181	246	301	2	65	0.0307692
NODE_112494_length_350_cov_40.677291	181	246	302	1	65	0.0153846
NODE_112494_length_350_cov_40.677291	181	246	304	1	65	0.0153846
NODE_112494_length_350_cov_40.677291	181	246	305	1	65	0.0153846
NODE_112494_length_350_cov_40.677291	181	246	306	1	65	0.0153846
NODE_112494_length_350_cov_40.677291	181	246	307	1	65	0.0153846
NODE_112494_length_350_cov_40.677291	181	246	308	1	65	0.0153846
NODE_112494_length_350_cov_40.677291	181	246	309	2	65	0.0307692
NODE_112494_length_350_cov_40.677291	181	246	310	1	65	0.0153846
NODE_112494_length_350_cov_40.677291	181	246	312	2	65	0.0307692
NODE_112494_length_350_cov_40.677291	181	246	313	2	65	0.0307692
NODE_112494_length_350_cov_40.677291	181	246	314	2	65	0.0307692
NODE_112494_length_350_cov_40.677291	181	246	315	1	65	0.0153846
NODE_112494_length_350_cov_40.677291	181	246	316	3	65	0.0461538
NODE_112494_length_350_cov_40.677291	181	246	317	1	65	0.0153846
NODE_112494_length_350_cov_40.677291	181	246	319	1	65	0.0153846
NODE_112535_length_350_cov_4.179283	114	194	0	80	80	1.0000000
NODE_112535_length_350_cov_4.179283	167	244	0	29	77	0.3766234
NODE_112535_length_350_cov_4.179283	167	244	2	2	77	0.0259740
NODE_112535_length_350_cov_4.179283	167	244	3	1	77	0.0129870
NODE_112535_length_350_cov_4.179283	167	244	6	9	77	0.1168831
NODE_112535_length_350_cov_4.179283	167	244	10	16	77	0.2077922
NODE_112535_length_350_cov_4.179283	167	244	14	8	77	0.1038961
NODE_112535_length_350_cov_4.179283	167	244	16	9	77	0.1168831
NODE_112535_length_350_cov_4.179283	167	244	18	3	77	0.0389610
NODE_112554_length_350_cov_3.573705	128	202	17	13	74	0.1756757
NODE_112554_length_350_cov_3.573705	128	202	19	20	74	0.2702703
NODE_112554_length_350_cov_3.573705	128	202	35	3	74	0.0405405
NODE_112554_length_350_cov_3.573705	128	202	39	3	74	0.0405405
NODE_112554_length_350_cov_3.573705	128	202	43	5	74	0.0675676
NODE_112554_length_350_cov_3.573705	128	202	45	24	74	0.3243243
NODE_112554_length_350_cov_3.573705	128	202	47	2	74	0.0270270
NODE_112554_length_350_cov_3.573705	128	202	49	4	74	0.0540541
NODE_112554_length_350_cov_3.573705	178	241	4	13	63	0.2063492
NODE_112554_length_350_cov_3.573705	178	241	7	1	63	0.0158730
NODE_112554_length_350_cov_3.573705	178	241	8	5	63	0.0793651
NODE_112554_length_350_cov_3.573705	178	241	10	2	63	0.0317460
NODE_112554_length_350_cov_3.573705	178	241	11	2	63	0.0317460
NODE_112554_length_350_cov_3.573705	178	241	14	16	63	0.2539683
NODE_112554_length_350_cov_3.573705	178	241	17	4	63	0.0634921
NODE_112554_length_350_cov_3.573705	178	241	19	20	63	0.3174603
NODE_112627_length_350_cov_2.478088	266	297	0	31	31	1.0000000
NODE_112647_length_350_cov_2.346614	97	148	69	2	51	0.0392157
NODE_112647_length_350_cov_2.346614	97	148	74	2	51	0.0392157
NODE_112647_length_350_cov_2.346614	97	148	77	7	51	0.1372549
NODE_112647_length_350_cov_2.346614	97	148	78	6	51	0.1176471
NODE_112647_length_350_cov_2.346614	97	148	79	8	51	0.1568628
NODE_112647_length_350_cov_2.346614	97	148	80	4	51	0.0784314
NODE_112647_length_350_cov_2.346614	97	148	81	4	51	0.0784314
NODE_112647_length_350_cov_2.346614	97	148	82	6	51	0.1176471
NODE_112647_length_350_cov_2.346614	97	148	83	10	51	0.1960784
NODE_112647_length_350_cov_2.346614	97	148	84	2	51	0.0392157
NODE_112714_length_350_cov_2.031873	181	238	5	11	57	0.1929825
NODE_112714_length_350_cov_2.031873	181	238	8	3	57	0.0526316
NODE_112714_length_350_cov_2.031873	181	238	10	10	57	0.1754386
NODE_112714_length_350_cov_2.031873	181	238	12	28	57	0.4912281
NODE_112714_length_350_cov_2.031873	181	238	14	5	57	0.0877193
NODE_112997_length_350_cov_1.223108	202	275	2	18	73	0.2465753
NODE_112997_length_350_cov_1.223108	202	275	3	19	73	0.2602740
NODE_112997_length_350_cov_1.223108	202	275	5	5	73	0.0684932
NODE_112997_length_350_cov_1.223108	202	275	11	3	73	0.0410959
NODE_112997_length_350_cov_1.223108	202	275	13	5	73	0.0684932
NODE_112997_length_350_cov_1.223108	202	275	14	2	73	0.0273973
NODE_112997_length_350_cov_1.223108	202	275	15	1	73	0.0136986
NODE_112997_length_350_cov_1.223108	202	275	17	3	73	0.0410959
NODE_112997_length_350_cov_1.223108	202	275	19	5	73	0.0684932
NODE_112997_length_350_cov_1.223108	202	275	21	1	73	0.0136986
NODE_112997_length_350_cov_1.223108	202	275	26	3	73	0.0410959
NODE_112997_length_350_cov_1.223108	202	275	28	6	73	0.0821918
NODE_112997_length_350_cov_1.223108	202	275	32	2	73	0.0273973
NODE_113450_length_349_cov_4.268000	83	163	0	11	80	0.1375000
NODE_113450_length_349_cov_4.268000	83	163	2	69	80	0.8625000
NODE_113450_length_349_cov_4.268000	83	163	0	11	80	0.1375000
NODE_113450_length_349_cov_4.268000	83	163	2	69	80	0.8625000
NODE_113450_length_349_cov_4.268000	136	216	0	64	80	0.8000000
NODE_113450_length_349_cov_4.268000	136	216	2	16	80	0.2000000
NODE_113450_length_349_cov_4.268000	145	180	0	28	35	0.8000000
NODE_113450_length_349_cov_4.268000	145	180	2	7	35	0.2000000
NODE_113473_length_349_cov_3.648000	219	300	6	10	81	0.1234568
NODE_113473_length_349_cov_3.648000	219	300	8	21	81	0.2592593
NODE_113473_length_349_cov_3.648000	219	300	10	6	81	0.0740741
NODE_113473_length_349_cov_3.648000	219	300	12	36	81	0.4444444
NODE_113473_length_349_cov_3.648000	219	300	14	8	81	0.0987654
NODE_113480_length_349_cov_3.484000	196	276	8	2	80	0.0250000
NODE_113480_length_349_cov_3.484000	196	276	10	3	80	0.0375000
NODE_113480_length_349_cov_3.484000	196	276	12	3	80	0.0375000
NODE_113480_length_349_cov_3.484000	196	276	16	13	80	0.1625000
NODE_113480_length_349_cov_3.484000	196	276	18	7	80	0.0875000
NODE_113480_length_349_cov_3.484000	196	276	19	3	80	0.0375000
NODE_113480_length_349_cov_3.484000	196	276	20	8	80	0.1000000
NODE_113480_length_349_cov_3.484000	196	276	21	18	80	0.2250000
NODE_113480_length_349_cov_3.484000	196	276	22	23	80	0.2875000
NODE_113486_length_349_cov_3.364000	219	284	0	10	65	0.1538462
NODE_113486_length_349_cov_3.364000	219	284	4	15	65	0.2307692
NODE_113486_length_349_cov_3.364000	219	284	6	40	65	0.6153846
NODE_113511_length_349_cov_2.916000	94	189	0	95	95	1.0000000
NODE_113571_length_349_cov_2.420000	35	54	0	19	19	1.0000000
NODE_113647_length_349_cov_1.964000	32	63	0	1	31	0.0322581
NODE_113647_length_349_cov_1.964000	32	63	2	30	31	0.9677419
NODE_113654_length_349_cov_1.928000	9	77	0	22	68	0.3235294
NODE_113654_length_349_cov_1.928000	9	77	2	27	68	0.3970588
NODE_113654_length_349_cov_1.928000	9	77	4	19	68	0.2794118
NODE_113654_length_349_cov_1.928000	62	115	0	53	53	1.0000000
NODE_113710_length_349_cov_1.684000	225	265	14	3	40	0.0750000
NODE_113710_length_349_cov_1.684000	225	265	16	30	40	0.7500000
NODE_113710_length_349_cov_1.684000	225	265	17	1	40	0.0250000
NODE_113710_length_349_cov_1.684000	225	265	18	1	40	0.0250000
NODE_113710_length_349_cov_1.684000	225	265	20	2	40	0.0500000
NODE_113710_length_349_cov_1.684000	225	265	22	3	40	0.0750000
NODE_113825_length_349_cov_1.392000	32	95	0	63	63	1.0000000
NODE_113961_length_349_cov_1.056000	316	339	2	23	23	1.0000000
NODE_114002_length_349_cov_1.020000	177	257	0	3	80	0.0375000
NODE_114002_length_349_cov_1.020000	177	257	1	39	80	0.4875000
NODE_114002_length_349_cov_1.020000	177	257	2	38	80	0.4750000
NODE_114263_length_348_cov_34.867470	156	236	0	37	80	0.4625000
NODE_114263_length_348_cov_34.867470	156	236	2	43	80	0.5375000
NODE_114263_length_348_cov_34.867470	209	289	0	35	80	0.4375000
NODE_114263_length_348_cov_34.867470	209	289	2	45	80	0.5625000
NODE_114296_length_348_cov_4.180723	106	186	0	80	80	1.0000000
NODE_114296_length_348_cov_4.180723	159	239	0	80	80	1.0000000
NODE_114330_length_348_cov_3.277108	83	137	0	54	54	1.0000000
NODE_114330_length_348_cov_3.277108	145	197	0	52	52	1.0000000
NODE_114424_length_348_cov_2.305221	204	273	2	10	69	0.1449275
NODE_114424_length_348_cov_2.305221	204	273	6	1	69	0.0144928
NODE_114424_length_348_cov_2.305221	204	273	8	58	69	0.8405797
NODE_114448_length_348_cov_2.216867	103	152	2	49	49	1.0000000
NODE_114505_length_348_cov_1.995984	170	239	8	26	69	0.3768116
NODE_114505_length_348_cov_1.995984	170	239	10	33	69	0.4782609
NODE_114505_length_348_cov_1.995984	170	239	12	10	69	0.1449275
NODE_114591_length_348_cov_1.638554	309	346	0	36	37	0.9729730
NODE_114591_length_348_cov_1.638554	309	346	2	1	37	0.0270270
NODE_114643_length_348_cov_1.485944	9	60	0	51	51	1.0000000
NODE_115147_length_347_cov_15.100806	57	137	2	20	80	0.2500000
NODE_115147_length_347_cov_15.100806	57	137	6	60	80	0.7500000
NODE_115147_length_347_cov_15.100806	110	152	6	42	42	1.0000000
NODE_115147_length_347_cov_15.100806	182	209	0	27	27	1.0000000
NODE_115147_length_347_cov_15.100806	290	317	0	27	27	1.0000000
NODE_115161_length_347_cov_5.967742	110	173	6	63	63	1.0000000
NODE_115195_length_347_cov_4.028226	260	329	0	69	69	1.0000000
NODE_115321_length_347_cov_2.463710	99	141	0	42	42	1.0000000
NODE_115321_length_347_cov_2.463710	108	143	0	35	35	1.0000000
NODE_115331_length_347_cov_2.391129	35	70	0	35	35	1.0000000
NODE_115331_length_347_cov_2.391129	37	79	0	42	42	1.0000000
NODE_115331_length_347_cov_2.391129	77	105	0	28	28	1.0000000
NODE_115397_length_347_cov_2.048387	15	34	0	19	19	1.0000000
NODE_115417_length_347_cov_1.967742	205	268	0	63	63	1.0000000
NODE_115450_length_347_cov_1.818548	109	156	0	47	47	1.0000000
NODE_115771_length_347_cov_1.028226	230	255	0	25	25	1.0000000
NODE_116114_length_346_cov_74.433198	10	90	14	80	80	1.0000000
NODE_116114_length_346_cov_74.433198	19	90	14	71	71	1.0000000
NODE_116114_length_346_cov_74.433198	192	272	0	80	80	1.0000000
NODE_116115_length_346_cov_67.834008	133	213	0	39	80	0.4875000
NODE_116115_length_346_cov_67.834008	133	213	2	41	80	0.5125000
NODE_116115_length_346_cov_67.834008	186	266	0	80	80	1.0000000
NODE_116117_length_346_cov_10.299595	190	270	4	80	80	1.0000000
NODE_116117_length_346_cov_10.299595	243	323	0	34	80	0.4250000
NODE_116117_length_346_cov_10.299595	243	323	4	46	80	0.5750000
NODE_116119_length_346_cov_9.566802	159	239	0	27	80	0.3375000
NODE_116119_length_346_cov_9.566802	159	239	1	33	80	0.4125000
NODE_116119_length_346_cov_9.566802	159	239	2	20	80	0.2500000
NODE_116119_length_346_cov_9.566802	212	292	0	80	80	1.0000000
NODE_116134_length_346_cov_5.506073	157	238	6	10	81	0.1234568
NODE_116134_length_346_cov_5.506073	157	238	8	15	81	0.1851852
NODE_116134_length_346_cov_5.506073	157	238	10	56	81	0.6913580
NODE_116155_length_346_cov_4.368421	205	264	0	59	59	1.0000000
NODE_116159_length_346_cov_4.032389	121	141	0	20	20	1.0000000
NODE_116184_length_346_cov_3.400810	194	253	0	59	59	1.0000000
NODE_116212_length_346_cov_3.008097	183	263	0	80	80	1.0000000
NODE_116257_length_346_cov_2.538462	47	102	0	55	55	1.0000000
NODE_116257_length_346_cov_2.538462	118	173	0	55	55	1.0000000
NODE_116439_length_346_cov_1.700405	71	107	0	36	36	1.0000000
NODE_117035_length_345_cov_47.699187	0	66	0	66	66	1.0000000
NODE_117035_length_345_cov_47.699187	39	119	0	80	80	1.0000000
NODE_117035_length_345_cov_47.699187	115	182	0	67	67	1.0000000
NODE_117035_length_345_cov_47.699187	246	311	0	65	65	1.0000000
NODE_117036_length_345_cov_13.439024	28	108	0	80	80	1.0000000
NODE_117036_length_345_cov_13.439024	81	161	0	80	80	1.0000000
NODE_117037_length_345_cov_9.906504	224	283	0	59	59	1.0000000
NODE_117051_length_345_cov_5.475610	52	132	1	31	80	0.3875000
NODE_117051_length_345_cov_5.475610	52	132	2	10	80	0.1250000
NODE_117051_length_345_cov_5.475610	52	132	3	9	80	0.1125000
NODE_117051_length_345_cov_5.475610	52	132	4	30	80	0.3750000
NODE_117051_length_345_cov_5.475610	105	185	1	74	80	0.9250000
NODE_117051_length_345_cov_5.475610	105	185	3	6	80	0.0750000
NODE_117055_length_345_cov_5.321138	104	152	0	48	48	1.0000000
NODE_117065_length_345_cov_4.524390	205	269	0	64	64	1.0000000
NODE_117075_length_345_cov_4.109756	95	157	2	15	62	0.2419355
NODE_117075_length_345_cov_4.109756	95	157	4	38	62	0.6129032
NODE_117075_length_345_cov_4.109756	95	157	6	9	62	0.1451613
NODE_117075_length_345_cov_4.109756	162	204	2	42	42	1.0000000
NODE_117076_length_345_cov_4.073171	251	326	0	75	75	1.0000000
NODE_117084_length_345_cov_3.776423	199	273	0	74	74	1.0000000
NODE_117084_length_345_cov_3.776423	246	326	0	80	80	1.0000000
NODE_117148_length_345_cov_2.821138	61	141	0	8	80	0.1000000
NODE_117148_length_345_cov_2.821138	61	141	4	72	80	0.9000000
NODE_117205_length_345_cov_2.333333	47	90	11	2	43	0.0465116
NODE_117205_length_345_cov_2.333333	47	90	13	1	43	0.0232558
NODE_117205_length_345_cov_2.333333	47	90	17	8	43	0.1860465
NODE_117205_length_345_cov_2.333333	47	90	19	1	43	0.0232558
NODE_117205_length_345_cov_2.333333	47	90	22	2	43	0.0465116
NODE_117205_length_345_cov_2.333333	47	90	23	6	43	0.1395349
NODE_117205_length_345_cov_2.333333	47	90	25	2	43	0.0465116
NODE_117205_length_345_cov_2.333333	47	90	26	13	43	0.3023256
NODE_117205_length_345_cov_2.333333	47	90	28	5	43	0.1162791
NODE_117205_length_345_cov_2.333333	47	90	30	3	43	0.0697674
NODE_117205_length_345_cov_2.333333	63	147	23	4	84	0.0476190
NODE_117205_length_345_cov_2.333333	63	147	25	2	84	0.0238095
NODE_117205_length_345_cov_2.333333	63	147	26	13	84	0.1547619
NODE_117205_length_345_cov_2.333333	63	147	28	5	84	0.0595238
NODE_117205_length_345_cov_2.333333	63	147	30	9	84	0.1071429
NODE_117205_length_345_cov_2.333333	63	147	32	22	84	0.2619048
NODE_117205_length_345_cov_2.333333	63	147	34	14	84	0.1666667
NODE_117205_length_345_cov_2.333333	63	147	36	1	84	0.0119048
NODE_117205_length_345_cov_2.333333	63	147	38	4	84	0.0476190
NODE_117205_length_345_cov_2.333333	63	147	40	10	84	0.1190476
NODE_117219_length_345_cov_2.239837	0	81	0	2	81	0.0246914
NODE_117219_length_345_cov_2.239837	0	81	2	3	81	0.0370370
NODE_117219_length_345_cov_2.239837	0	81	7	1	81	0.0123457
NODE_117219_length_345_cov_2.239837	0	81	10	1	81	0.0123457
NODE_117219_length_345_cov_2.239837	0	81	12	1	81	0.0123457
NODE_117219_length_345_cov_2.239837	0	81	14	2	81	0.0246914
NODE_117219_length_345_cov_2.239837	0	81	16	8	81	0.0987654
NODE_117219_length_345_cov_2.239837	0	81	18	3	81	0.0370370
NODE_117219_length_345_cov_2.239837	0	81	20	4	81	0.0493827
NODE_117219_length_345_cov_2.239837	0	81	22	5	81	0.0617284
NODE_117219_length_345_cov_2.239837	0	81	24	6	81	0.0740741
NODE_117219_length_345_cov_2.239837	0	81	25	1	81	0.0123457
NODE_117219_length_345_cov_2.239837	0	81	26	2	81	0.0246914
NODE_117219_length_345_cov_2.239837	0	81	27	2	81	0.0246914
NODE_117219_length_345_cov_2.239837	0	81	28	3	81	0.0370370
NODE_117219_length_345_cov_2.239837	0	81	30	11	81	0.1358025
NODE_117219_length_345_cov_2.239837	0	81	32	4	81	0.0493827
NODE_117219_length_345_cov_2.239837	0	81	34	22	81	0.2716049
NODE_117669_length_345_cov_1.040650	6	73	9	16	67	0.2388060
NODE_117669_length_345_cov_1.040650	6	73	10	51	67	0.7611941
NODE_117989_length_344_cov_54.020408	6	55	2	15	49	0.3061225
NODE_117989_length_344_cov_54.020408	6	55	4	12	49	0.2448980
NODE_117989_length_344_cov_54.020408	6	55	12	12	49	0.2448980
NODE_117989_length_344_cov_54.020408	6	55	18	10	49	0.2040816
NODE_117989_length_344_cov_54.020408	28	105	4	5	77	0.0649351
NODE_117989_length_344_cov_54.020408	28	105	12	12	77	0.1558442
NODE_117989_length_344_cov_54.020408	28	105	18	56	77	0.7272727
NODE_117989_length_344_cov_54.020408	28	105	20	4	77	0.0519481
NODE_117989_length_344_cov_54.020408	28	105	4	5	77	0.0649351
NODE_117989_length_344_cov_54.020408	28	105	12	12	77	0.1558442
NODE_117989_length_344_cov_54.020408	28	105	18	56	77	0.7272727
NODE_117989_length_344_cov_54.020408	28	105	20	4	77	0.0519481
NODE_117989_length_344_cov_54.020408	112	178	10	11	66	0.1666667
NODE_117989_length_344_cov_54.020408	112	178	18	42	66	0.6363636
NODE_117989_length_344_cov_54.020408	112	178	20	13	66	0.1969697
NODE_118009_length_344_cov_5.016327	72	125	27	4	53	0.0754717
NODE_118009_length_344_cov_5.016327	72	125	29	1	53	0.0188679
NODE_118009_length_344_cov_5.016327	72	125	30	1	53	0.0188679
NODE_118009_length_344_cov_5.016327	72	125	34	2	53	0.0377358
NODE_118009_length_344_cov_5.016327	72	125	40	7	53	0.1320755
NODE_118009_length_344_cov_5.016327	72	125	42	1	53	0.0188679
NODE_118009_length_344_cov_5.016327	72	125	45	1	53	0.0188679
NODE_118009_length_344_cov_5.016327	72	125	47	2	53	0.0377358
NODE_118009_length_344_cov_5.016327	72	125	51	4	53	0.0754717
NODE_118009_length_344_cov_5.016327	72	125	52	5	53	0.0943396
NODE_118009_length_344_cov_5.016327	72	125	56	3	53	0.0566038
NODE_118009_length_344_cov_5.016327	72	125	58	3	53	0.0566038
NODE_118009_length_344_cov_5.016327	72	125	60	19	53	0.3584906
NODE_118009_length_344_cov_5.016327	136	203	26	1	67	0.0149254
NODE_118009_length_344_cov_5.016327	136	203	28	4	67	0.0597015
NODE_118009_length_344_cov_5.016327	136	203	29	3	67	0.0447761
NODE_118009_length_344_cov_5.016327	136	203	30	2	67	0.0298507
NODE_118009_length_344_cov_5.016327	136	203	31	1	67	0.0149254
NODE_118009_length_344_cov_5.016327	136	203	35	4	67	0.0597015
NODE_118009_length_344_cov_5.016327	136	203	37	11	67	0.1641791
NODE_118009_length_344_cov_5.016327	136	203	41	2	67	0.0298507
NODE_118009_length_344_cov_5.016327	136	203	43	1	67	0.0149254
NODE_118009_length_344_cov_5.016327	136	203	49	1	67	0.0149254
NODE_118009_length_344_cov_5.016327	136	203	51	26	67	0.3880597
NODE_118009_length_344_cov_5.016327	136	203	52	11	67	0.1641791
NODE_118017_length_344_cov_4.579592	172	254	2	1	82	0.0121951
NODE_118017_length_344_cov_4.579592	172	254	4	81	82	0.9878049
NODE_118045_length_344_cov_3.840816	197	240	4	33	43	0.7674419
NODE_118045_length_344_cov_3.840816	197	240	6	10	43	0.2325581
NODE_118074_length_344_cov_3.293878	149	189	4	40	40	1.0000000
NODE_118074_length_344_cov_3.293878	162	229	2	5	67	0.0746269
NODE_118074_length_344_cov_3.293878	162	229	4	62	67	0.9253731
NODE_118111_length_344_cov_2.751020	24	87	0	30	63	0.4761905
NODE_118111_length_344_cov_2.751020	24	87	2	31	63	0.4920635
NODE_118111_length_344_cov_2.751020	24	87	4	2	63	0.0317460
NODE_118179_length_344_cov_2.126531	274	305	0	31	31	1.0000000
NODE_118243_length_344_cov_1.914286	114	194	0	80	80	1.0000000
NODE_118243_length_344_cov_1.914286	167	247	0	65	80	0.8125000
NODE_118243_length_344_cov_1.914286	167	247	2	6	80	0.0750000
NODE_118243_length_344_cov_1.914286	167	247	4	9	80	0.1125000
NODE_118297_length_344_cov_1.685714	180	220	0	21	40	0.5250000
NODE_118297_length_344_cov_1.685714	180	220	2	1	40	0.0250000
NODE_118297_length_344_cov_1.685714	180	220	4	18	40	0.4500000
NODE_118393_length_344_cov_1.457143	160	240	28	2	80	0.0250000
NODE_118393_length_344_cov_1.457143	160	240	31	5	80	0.0625000
NODE_118393_length_344_cov_1.457143	160	240	32	16	80	0.2000000
NODE_118393_length_344_cov_1.457143	160	240	34	14	80	0.1750000
NODE_118393_length_344_cov_1.457143	160	240	35	2	80	0.0250000
NODE_118393_length_344_cov_1.457143	160	240	36	1	80	0.0125000
NODE_118393_length_344_cov_1.457143	160	240	37	3	80	0.0375000
NODE_118393_length_344_cov_1.457143	160	240	38	3	80	0.0375000
NODE_118393_length_344_cov_1.457143	160	240	39	1	80	0.0125000
NODE_118393_length_344_cov_1.457143	160	240	40	13	80	0.1625000
NODE_118393_length_344_cov_1.457143	160	240	41	9	80	0.1125000
NODE_118393_length_344_cov_1.457143	160	240	42	11	80	0.1375000
NODE_118393_length_344_cov_1.457143	213	273	12	2	60	0.0333333
NODE_118393_length_344_cov_1.457143	213	273	14	1	60	0.0166667
NODE_118393_length_344_cov_1.457143	213	273	16	1	60	0.0166667
NODE_118393_length_344_cov_1.457143	213	273	17	2	60	0.0333333
NODE_118393_length_344_cov_1.457143	213	273	18	1	60	0.0166667
NODE_118393_length_344_cov_1.457143	213	273	23	1	60	0.0166667
NODE_118393_length_344_cov_1.457143	213	273	24	3	60	0.0500000
NODE_118393_length_344_cov_1.457143	213	273	26	10	60	0.1666667
NODE_118393_length_344_cov_1.457143	213	273	27	1	60	0.0166667
NODE_118393_length_344_cov_1.457143	213	273	28	13	60	0.2166667
NODE_118393_length_344_cov_1.457143	213	273	31	5	60	0.0833333
NODE_118393_length_344_cov_1.457143	213	273	35	2	60	0.0333333
NODE_118393_length_344_cov_1.457143	213	273	37	3	60	0.0500000
NODE_118393_length_344_cov_1.457143	213	273	38	2	60	0.0333333
NODE_118393_length_344_cov_1.457143	213	273	39	1	60	0.0166667
NODE_118393_length_344_cov_1.457143	213	273	41	9	60	0.1500000
NODE_118393_length_344_cov_1.457143	213	273	42	3	60	0.0500000
NODE_118743_length_344_cov_0.800000	123	163	0	40	40	1.0000000
NODE_118899_length_343_cov_3.770492	2	60	0	58	58	1.0000000
NODE_118905_length_343_cov_3.598361	97	170	17	8	73	0.1095890
NODE_118905_length_343_cov_3.598361	97	170	18	20	73	0.2739726
NODE_118905_length_343_cov_3.598361	97	170	20	10	73	0.1369863
NODE_118905_length_343_cov_3.598361	97	170	22	30	73	0.4109589
NODE_118905_length_343_cov_3.598361	97	170	24	5	73	0.0684932
NODE_118905_length_343_cov_3.598361	150	223	3	5	73	0.0684932
NODE_118905_length_343_cov_3.598361	150	223	4	18	73	0.2465753
NODE_118905_length_343_cov_3.598361	150	223	10	3	73	0.0410959
NODE_118905_length_343_cov_3.598361	150	223	18	7	73	0.0958904
NODE_118905_length_343_cov_3.598361	150	223	20	9	73	0.1232877
NODE_118905_length_343_cov_3.598361	150	223	22	31	73	0.4246575
NODE_118911_length_343_cov_3.401639	48	128	16	2	80	0.0250000
NODE_118911_length_343_cov_3.401639	48	128	22	1	80	0.0125000
NODE_118911_length_343_cov_3.401639	48	128	29	2	80	0.0250000
NODE_118911_length_343_cov_3.401639	48	128	31	4	80	0.0500000
NODE_118911_length_343_cov_3.401639	48	128	32	4	80	0.0500000
NODE_118911_length_343_cov_3.401639	48	128	34	2	80	0.0250000
NODE_118911_length_343_cov_3.401639	48	128	36	1	80	0.0125000
NODE_118911_length_343_cov_3.401639	48	128	38	4	80	0.0500000
NODE_118911_length_343_cov_3.401639	48	128	42	2	80	0.0250000
NODE_118911_length_343_cov_3.401639	48	128	44	1	80	0.0125000
NODE_118911_length_343_cov_3.401639	48	128	50	4	80	0.0500000
NODE_118911_length_343_cov_3.401639	48	128	52	5	80	0.0625000
NODE_118911_length_343_cov_3.401639	48	128	54	7	80	0.0875000
NODE_118911_length_343_cov_3.401639	48	128	56	23	80	0.2875000
NODE_118911_length_343_cov_3.401639	48	128	58	12	80	0.1500000
NODE_118911_length_343_cov_3.401639	48	128	59	1	80	0.0125000
NODE_118911_length_343_cov_3.401639	48	128	60	5	80	0.0625000
NODE_118941_length_343_cov_3.049180	12	62	0	50	50	1.0000000
NODE_118941_length_343_cov_3.049180	82	111	2	11	29	0.3793103
NODE_118941_length_343_cov_3.049180	82	111	4	13	29	0.4482759
NODE_118941_length_343_cov_3.049180	82	111	6	5	29	0.1724138
NODE_118941_length_343_cov_3.049180	133	205	6	43	72	0.5972222
NODE_118941_length_343_cov_3.049180	133	205	8	29	72	0.4027778
NODE_118957_length_343_cov_2.770492	236	316	20	5	80	0.0625000
NODE_118957_length_343_cov_2.770492	236	316	23	5	80	0.0625000
NODE_118957_length_343_cov_2.770492	236	316	27	1	80	0.0125000
NODE_118957_length_343_cov_2.770492	236	316	29	4	80	0.0500000
NODE_118957_length_343_cov_2.770492	236	316	31	1	80	0.0125000
NODE_118957_length_343_cov_2.770492	236	316	33	9	80	0.1125000
NODE_118957_length_343_cov_2.770492	236	316	35	4	80	0.0500000
NODE_118957_length_343_cov_2.770492	236	316	39	2	80	0.0250000
NODE_118957_length_343_cov_2.770492	236	316	43	2	80	0.0250000
NODE_118957_length_343_cov_2.770492	236	316	46	1	80	0.0125000
NODE_118957_length_343_cov_2.770492	236	316	48	1	80	0.0125000
NODE_118957_length_343_cov_2.770492	236	316	58	1	80	0.0125000
NODE_118957_length_343_cov_2.770492	236	316	64	1	80	0.0125000
NODE_118957_length_343_cov_2.770492	236	316	68	1	80	0.0125000
NODE_118957_length_343_cov_2.770492	236	316	76	5	80	0.0625000
NODE_118957_length_343_cov_2.770492	236	316	78	1	80	0.0125000
NODE_118957_length_343_cov_2.770492	236	316	80	1	80	0.0125000
NODE_118957_length_343_cov_2.770492	236	316	82	6	80	0.0750000
NODE_118957_length_343_cov_2.770492	236	316	84	1	80	0.0125000
NODE_118957_length_343_cov_2.770492	236	316	86	2	80	0.0250000
NODE_118957_length_343_cov_2.770492	236	316	88	1	80	0.0125000
NODE_118957_length_343_cov_2.770492	236	316	90	9	80	0.1125000
NODE_118957_length_343_cov_2.770492	236	316	92	3	80	0.0375000
NODE_118957_length_343_cov_2.770492	236	316	93	1	80	0.0125000
NODE_118957_length_343_cov_2.770492	236	316	95	3	80	0.0375000
NODE_118957_length_343_cov_2.770492	236	316	97	5	80	0.0625000
NODE_118957_length_343_cov_2.770492	236	316	99	4	80	0.0500000
NODE_118978_length_343_cov_2.590164	167	225	2	38	58	0.6551724
NODE_118978_length_343_cov_2.590164	167	225	4	15	58	0.2586207
NODE_118978_length_343_cov_2.590164	167	225	6	3	58	0.0517241
NODE_118978_length_343_cov_2.590164	167	225	7	1	58	0.0172414
NODE_118978_length_343_cov_2.590164	167	225	8	1	58	0.0172414
NODE_118998_length_343_cov_2.430328	208	274	0	54	66	0.8181818
NODE_118998_length_343_cov_2.430328	208	274	2	12	66	0.1818182
NODE_119040_length_343_cov_2.209016	32	111	0	79	79	1.0000000
NODE_119067_length_343_cov_2.081967	95	177	2	72	82	0.8780488
NODE_119067_length_343_cov_2.081967	95	177	4	10	82	0.1219512
NODE_119067_length_343_cov_2.081967	150	199	2	39	49	0.7959183
NODE_119067_length_343_cov_2.081967	150	199	4	10	49	0.2040816
NODE_119202_length_343_cov_1.635246	0	52	0	52	52	1.0000000
NODE_119439_length_343_cov_1.143443	60	120	3	7	60	0.1166667
NODE_119439_length_343_cov_1.143443	60	120	5	53	60	0.8833333
NODE_119834_length_342_cov_3.872428	136	216	10	8	80	0.1000000
NODE_119834_length_342_cov_3.872428	136	216	12	12	80	0.1500000
NODE_119834_length_342_cov_3.872428	136	216	13	1	80	0.0125000
NODE_119834_length_342_cov_3.872428	136	216	14	45	80	0.5625000
NODE_119834_length_342_cov_3.872428	136	216	18	14	80	0.1750000
NODE_119834_length_342_cov_3.872428	189	259	6	6	70	0.0857143
NODE_119834_length_342_cov_3.872428	189	259	10	37	70	0.5285714
NODE_119834_length_342_cov_3.872428	189	259	12	10	70	0.1428571
NODE_119834_length_342_cov_3.872428	189	259	14	15	70	0.2142857
NODE_119834_length_342_cov_3.872428	189	259	18	2	70	0.0285714
NODE_119840_length_342_cov_3.769547	146	212	0	66	66	1.0000000
NODE_119841_length_342_cov_3.740741	113	146	0	15	33	0.4545455
NODE_119841_length_342_cov_3.740741	113	146	2	18	33	0.5454546
NODE_119846_length_342_cov_3.674897	20	100	2	80	80	1.0000000
NODE_119846_length_342_cov_3.674897	73	153	0	21	80	0.2625000
NODE_119846_length_342_cov_3.674897	73	153	2	59	80	0.7375000
NODE_119847_length_342_cov_3.588477	117	197	4	2	80	0.0250000
NODE_119847_length_342_cov_3.588477	117	197	6	78	80	0.9750000
NODE_119849_length_342_cov_3.530864	72	151	0	79	79	1.0000000
NODE_119852_length_342_cov_3.423868	172	252	0	29	80	0.3625000
NODE_119852_length_342_cov_3.423868	172	252	2	18	80	0.2250000
NODE_119852_length_342_cov_3.423868	172	252	4	33	80	0.4125000
NODE_119852_length_342_cov_3.423868	225	283	4	58	58	1.0000000
NODE_119922_length_342_cov_2.432099	16	81	0	5	65	0.0769231
NODE_119922_length_342_cov_2.432099	16	81	4	1	65	0.0153846
NODE_119922_length_342_cov_2.432099	16	81	6	59	65	0.9076923
NODE_119993_length_342_cov_2.049383	249	317	0	68	68	1.0000000
NODE_120047_length_342_cov_1.864198	138	190	16	14	52	0.2692308
NODE_120047_length_342_cov_1.864198	138	190	18	10	52	0.1923077
NODE_120047_length_342_cov_1.864198	138	190	20	28	52	0.5384616
NODE_120047_length_342_cov_1.864198	183	243	2	26	60	0.4333333
NODE_120047_length_342_cov_1.864198	183	243	3	16	60	0.2666667
NODE_120047_length_342_cov_1.864198	183	243	11	5	60	0.0833333
NODE_120047_length_342_cov_1.864198	183	243	12	3	60	0.0500000
NODE_120047_length_342_cov_1.864198	183	243	15	1	60	0.0166667
NODE_120047_length_342_cov_1.864198	183	243	16	9	60	0.1500000
NODE_120073_length_342_cov_1.720165	91	147	18	2	56	0.0357143
NODE_120073_length_342_cov_1.720165	91	147	20	1	56	0.0178571
NODE_120073_length_342_cov_1.720165	91	147	21	3	56	0.0535714
NODE_120073_length_342_cov_1.720165	91	147	25	1	56	0.0178571
NODE_120073_length_342_cov_1.720165	91	147	26	5	56	0.0892857
NODE_120073_length_342_cov_1.720165	91	147	28	44	56	0.7857143
NODE_120284_length_342_cov_1.271605	201	240	0	39	39	1.0000000
NODE_120755_length_341_cov_15.896694	50	130	2	40	80	0.5000000
NODE_120755_length_341_cov_15.896694	50	130	4	40	80	0.5000000
NODE_120755_length_341_cov_15.896694	103	183	0	32	80	0.4000000
NODE_120755_length_341_cov_15.896694	103	183	2	48	80	0.6000000
NODE_120757_length_341_cov_9.756198	117	196	0	34	79	0.4303797
NODE_120757_length_341_cov_9.756198	117	196	2	11	79	0.1392405
NODE_120757_length_341_cov_9.756198	117	196	4	4	79	0.0506329
NODE_120757_length_341_cov_9.756198	117	196	6	29	79	0.3670886
NODE_120757_length_341_cov_9.756198	117	196	8	1	79	0.0126582
NODE_120770_length_341_cov_5.404959	141	220	0	20	79	0.2531646
NODE_120770_length_341_cov_5.404959	141	220	1	13	79	0.1645570
NODE_120770_length_341_cov_5.404959	141	220	3	5	79	0.0632911
NODE_120770_length_341_cov_5.404959	141	220	5	3	79	0.0379747
NODE_120770_length_341_cov_5.404959	141	220	7	6	79	0.0759494
NODE_120770_length_341_cov_5.404959	141	220	9	9	79	0.1139240
NODE_120770_length_341_cov_5.404959	141	220	13	11	79	0.1392405
NODE_120770_length_341_cov_5.404959	141	220	15	5	79	0.0632911
NODE_120770_length_341_cov_5.404959	141	220	17	2	79	0.0253165
NODE_120770_length_341_cov_5.404959	141	220	18	5	79	0.0632911
NODE_120780_length_341_cov_4.669421	301	320	0	19	19	1.0000000
NODE_120783_length_341_cov_4.438017	57	132	2	1	75	0.0133333
NODE_120783_length_341_cov_4.438017	57	132	8	5	75	0.0666667
NODE_120783_length_341_cov_4.438017	57	132	12	3	75	0.0400000
NODE_120783_length_341_cov_4.438017	57	132	14	4	75	0.0533333
NODE_120783_length_341_cov_4.438017	57	132	16	9	75	0.1200000
NODE_120783_length_341_cov_4.438017	57	132	18	53	75	0.7066666
NODE_120783_length_341_cov_4.438017	110	185	4	6	75	0.0800000
NODE_120783_length_341_cov_4.438017	110	185	5	2	75	0.0266667
NODE_120783_length_341_cov_4.438017	110	185	6	3	75	0.0400000
NODE_120783_length_341_cov_4.438017	110	185	16	18	75	0.2400000
NODE_120783_length_341_cov_4.438017	110	185	18	28	75	0.3733333
NODE_120783_length_341_cov_4.438017	110	185	19	17	75	0.2266667
NODE_120783_length_341_cov_4.438017	110	185	20	1	75	0.0133333
NODE_120785_length_341_cov_4.400826	164	244	0	64	80	0.8000000
NODE_120785_length_341_cov_4.400826	164	244	4	16	80	0.2000000
NODE_120785_length_341_cov_4.400826	224	297	0	4	73	0.0547945
NODE_120785_length_341_cov_4.400826	224	297	4	69	73	0.9452055
NODE_120797_length_341_cov_3.896694	58	122	6	8	64	0.1250000
NODE_120797_length_341_cov_3.896694	58	122	7	9	64	0.1406250
NODE_120797_length_341_cov_3.896694	58	122	9	3	64	0.0468750
NODE_120797_length_341_cov_3.896694	58	122	10	1	64	0.0156250
NODE_120797_length_341_cov_3.896694	58	122	14	6	64	0.0937500
NODE_120797_length_341_cov_3.896694	58	122	16	5	64	0.0781250
NODE_120797_length_341_cov_3.896694	58	122	17	1	64	0.0156250
NODE_120797_length_341_cov_3.896694	58	122	19	4	64	0.0625000
NODE_120797_length_341_cov_3.896694	58	122	22	1	64	0.0156250
NODE_120797_length_341_cov_3.896694	58	122	23	3	64	0.0468750
NODE_120797_length_341_cov_3.896694	58	122	24	1	64	0.0156250
NODE_120797_length_341_cov_3.896694	58	122	25	1	64	0.0156250
NODE_120797_length_341_cov_3.896694	58	122	26	1	64	0.0156250
NODE_120797_length_341_cov_3.896694	58	122	27	4	64	0.0625000
NODE_120797_length_341_cov_3.896694	58	122	28	1	64	0.0156250
NODE_120797_length_341_cov_3.896694	58	122	29	3	64	0.0468750
NODE_120797_length_341_cov_3.896694	58	122	33	2	64	0.0312500
NODE_120797_length_341_cov_3.896694	58	122	34	1	64	0.0156250
NODE_120797_length_341_cov_3.896694	58	122	35	1	64	0.0156250
NODE_120797_length_341_cov_3.896694	58	122	39	1	64	0.0156250
NODE_120797_length_341_cov_3.896694	58	122	40	2	64	0.0312500
NODE_120797_length_341_cov_3.896694	58	122	41	2	64	0.0312500
NODE_120797_length_341_cov_3.896694	58	122	42	3	64	0.0468750
NODE_120805_length_341_cov_3.727273	191	273	4	12	82	0.1463415
NODE_120805_length_341_cov_3.727273	191	273	6	52	82	0.6341463
NODE_120805_length_341_cov_3.727273	191	273	7	1	82	0.0121951
NODE_120805_length_341_cov_3.727273	191	273	9	2	82	0.0243902
NODE_120805_length_341_cov_3.727273	191	273	10	11	82	0.1341463
NODE_120805_length_341_cov_3.727273	191	273	12	4	82	0.0487805
NODE_120805_length_341_cov_3.727273	253	326	4	65	73	0.8904110
NODE_120805_length_341_cov_3.727273	253	326	6	8	73	0.1095890
NODE_120839_length_341_cov_3.000000	91	161	2	70	70	1.0000000
NODE_120839_length_341_cov_3.000000	146	215	0	40	69	0.5797101
NODE_120839_length_341_cov_3.000000	146	215	2	29	69	0.4202898
NODE_120840_length_341_cov_3.000000	127	207	2	7	80	0.0875000
NODE_120840_length_341_cov_3.000000	127	207	6	35	80	0.4375000
NODE_120840_length_341_cov_3.000000	127	207	8	38	80	0.4750000
NODE_120892_length_341_cov_2.533058	92	172	4	80	80	1.0000000
NODE_120901_length_341_cov_2.495868	8	89	0	74	81	0.9135802
NODE_120901_length_341_cov_2.495868	8	89	1	1	81	0.0123457
NODE_120901_length_341_cov_2.495868	8	89	2	5	81	0.0617284
NODE_120901_length_341_cov_2.495868	8	89	4	1	81	0.0123457
NODE_120946_length_341_cov_2.235537	10	90	0	80	80	1.0000000
NODE_120972_length_341_cov_2.103306	46	125	0	1	79	0.0126582
NODE_120972_length_341_cov_2.103306	46	125	2	78	79	0.9873418
NODE_120994_length_341_cov_2.066116	147	184	8	10	37	0.2702703
NODE_120994_length_341_cov_2.066116	147	184	10	27	37	0.7297297
NODE_121052_length_341_cov_1.772727	179	250	0	17	71	0.2394366
NODE_121052_length_341_cov_1.772727	179	250	1	14	71	0.1971831
NODE_121052_length_341_cov_1.772727	179	250	2	40	71	0.5633803
NODE_121064_length_341_cov_1.727273	105	185	0	80	80	1.0000000
NODE_121160_length_341_cov_1.475207	120	185	14	10	65	0.1538462
NODE_121160_length_341_cov_1.475207	120	185	15	3	65	0.0461538
NODE_121160_length_341_cov_1.475207	120	185	16	34	65	0.5230770
NODE_121160_length_341_cov_1.475207	120	185	18	18	65	0.2769231
NODE_121160_length_341_cov_1.475207	158	238	6	3	80	0.0375000
NODE_121160_length_341_cov_1.475207	158	238	12	7	80	0.0875000
NODE_121160_length_341_cov_1.475207	158	238	14	34	80	0.4250000
NODE_121160_length_341_cov_1.475207	158	238	16	36	80	0.4500000
NODE_121173_length_341_cov_1.471074	186	266	0	6	80	0.0750000
NODE_121173_length_341_cov_1.471074	186	266	6	74	80	0.9250000
NODE_121173_length_341_cov_1.471074	239	319	0	8	80	0.1000000
NODE_121173_length_341_cov_1.471074	239	319	6	72	80	0.9000000
NODE_121211_length_341_cov_1.342975	284	322	0	38	38	1.0000000
NODE_121431_length_341_cov_0.991736	36	89	1	22	53	0.4150943
NODE_121431_length_341_cov_0.991736	36	89	2	31	53	0.5849057
NODE_121693_length_340_cov_541.348548	86	144	735	1	58	0.0172414
NODE_121693_length_340_cov_541.348548	86	144	737	1	58	0.0172414
NODE_121693_length_340_cov_541.348548	86	144	755	1	58	0.0172414
NODE_121693_length_340_cov_541.348548	86	144	765	1	58	0.0172414
NODE_121693_length_340_cov_541.348548	86	144	783	1	58	0.0172414
NODE_121693_length_340_cov_541.348548	86	144	798	1	58	0.0172414
NODE_121693_length_340_cov_541.348548	86	144	818	1	58	0.0172414
NODE_121693_length_340_cov_541.348548	86	144	830	1	58	0.0172414
NODE_121693_length_340_cov_541.348548	86	144	848	1	58	0.0172414
NODE_121693_length_340_cov_541.348548	86	144	897	1	58	0.0172414
NODE_121693_length_340_cov_541.348548	86	144	905	1	58	0.0172414
NODE_121693_length_340_cov_541.348548	86	144	930	1	58	0.0172414
NODE_121693_length_340_cov_541.348548	86	144	943	1	58	0.0172414
NODE_121693_length_340_cov_541.348548	86	144	951	1	58	0.0172414
NODE_121693_length_340_cov_541.348548	86	144	969	1	58	0.0172414
NODE_121693_length_340_cov_541.348548	86	144	986	1	58	0.0172414
NODE_121693_length_340_cov_541.348548	86	144	1021	1	58	0.0172414
NODE_121693_length_340_cov_541.348548	86	144	1036	1	58	0.0172414
NODE_121693_length_340_cov_541.348548	86	144	1043	1	58	0.0172414
NODE_121693_length_340_cov_541.348548	86	144	1061	1	58	0.0172414
NODE_121693_length_340_cov_541.348548	86	144	1082	1	58	0.0172414
NODE_121693_length_340_cov_541.348548	86	144	1114	1	58	0.0172414
NODE_121693_length_340_cov_541.348548	86	144	1121	1	58	0.0172414
NODE_121693_length_340_cov_541.348548	86	144	1131	1	58	0.0172414
NODE_121693_length_340_cov_541.348548	86	144	1132	1	58	0.0172414
NODE_121693_length_340_cov_541.348548	86	144	1141	1	58	0.0172414
NODE_121693_length_340_cov_541.348548	86	144	1161	1	58	0.0172414
NODE_121693_length_340_cov_541.348548	86	144	1165	1	58	0.0172414
NODE_121693_length_340_cov_541.348548	86	144	1179	1	58	0.0172414
NODE_121693_length_340_cov_541.348548	86	144	1185	1	58	0.0172414
NODE_121693_length_340_cov_541.348548	86	144	1208	1	58	0.0172414
NODE_121693_length_340_cov_541.348548	86	144	1226	1	58	0.0172414
NODE_121693_length_340_cov_541.348548	86	144	1240	1	58	0.0172414
NODE_121693_length_340_cov_541.348548	86	144	1250	1	58	0.0172414
NODE_121693_length_340_cov_541.348548	86	144	1269	1	58	0.0172414
NODE_121693_length_340_cov_541.348548	86	144	1276	1	58	0.0172414
NODE_121693_length_340_cov_541.348548	86	144	1281	1	58	0.0172414
NODE_121693_length_340_cov_541.348548	86	144	1282	1	58	0.0172414
NODE_121693_length_340_cov_541.348548	86	144	1292	1	58	0.0172414
NODE_121693_length_340_cov_541.348548	86	144	1305	1	58	0.0172414
NODE_121693_length_340_cov_541.348548	86	144	1331	1	58	0.0172414
NODE_121693_length_340_cov_541.348548	86	144	1345	1	58	0.0172414
NODE_121693_length_340_cov_541.348548	86	144	1349	1	58	0.0172414
NODE_121693_length_340_cov_541.348548	86	144	1360	1	58	0.0172414
NODE_121693_length_340_cov_541.348548	86	144	1371	1	58	0.0172414
NODE_121693_length_340_cov_541.348548	86	144	1411	1	58	0.0172414
NODE_121693_length_340_cov_541.348548	86	144	1412	1	58	0.0172414
NODE_121693_length_340_cov_541.348548	86	144	1415	1	58	0.0172414
NODE_121693_length_340_cov_541.348548	86	144	1436	1	58	0.0172414
NODE_121693_length_340_cov_541.348548	86	144	1469	1	58	0.0172414
NODE_121693_length_340_cov_541.348548	86	144	1485	1	58	0.0172414
NODE_121693_length_340_cov_541.348548	86	144	1498	1	58	0.0172414
NODE_121693_length_340_cov_541.348548	86	144	1525	1	58	0.0172414
NODE_121693_length_340_cov_541.348548	86	144	1539	1	58	0.0172414
NODE_121693_length_340_cov_541.348548	86	144	1554	1	58	0.0172414
NODE_121693_length_340_cov_541.348548	86	144	1568	1	58	0.0172414
NODE_121693_length_340_cov_541.348548	86	144	1571	1	58	0.0172414
NODE_121693_length_340_cov_541.348548	86	144	1598	1	58	0.0172414
NODE_121693_length_340_cov_541.348548	86	154	735	1	68	0.0147059
NODE_121693_length_340_cov_541.348548	86	154	737	1	68	0.0147059
NODE_121693_length_340_cov_541.348548	86	154	755	1	68	0.0147059
NODE_121693_length_340_cov_541.348548	86	154	765	1	68	0.0147059
NODE_121693_length_340_cov_541.348548	86	154	783	1	68	0.0147059
NODE_121693_length_340_cov_541.348548	86	154	798	1	68	0.0147059
NODE_121693_length_340_cov_541.348548	86	154	818	1	68	0.0147059
NODE_121693_length_340_cov_541.348548	86	154	830	1	68	0.0147059
NODE_121693_length_340_cov_541.348548	86	154	848	1	68	0.0147059
NODE_121693_length_340_cov_541.348548	86	154	897	1	68	0.0147059
NODE_121693_length_340_cov_541.348548	86	154	905	1	68	0.0147059
NODE_121693_length_340_cov_541.348548	86	154	930	1	68	0.0147059
NODE_121693_length_340_cov_541.348548	86	154	943	1	68	0.0147059
NODE_121693_length_340_cov_541.348548	86	154	951	1	68	0.0147059
NODE_121693_length_340_cov_541.348548	86	154	969	1	68	0.0147059
NODE_121693_length_340_cov_541.348548	86	154	986	1	68	0.0147059
NODE_121693_length_340_cov_541.348548	86	154	1021	1	68	0.0147059
NODE_121693_length_340_cov_541.348548	86	154	1036	1	68	0.0147059
NODE_121693_length_340_cov_541.348548	86	154	1043	1	68	0.0147059
NODE_121693_length_340_cov_541.348548	86	154	1061	1	68	0.0147059
NODE_121693_length_340_cov_541.348548	86	154	1082	1	68	0.0147059
NODE_121693_length_340_cov_541.348548	86	154	1114	1	68	0.0147059
NODE_121693_length_340_cov_541.348548	86	154	1121	1	68	0.0147059
NODE_121693_length_340_cov_541.348548	86	154	1131	1	68	0.0147059
NODE_121693_length_340_cov_541.348548	86	154	1132	1	68	0.0147059
NODE_121693_length_340_cov_541.348548	86	154	1141	1	68	0.0147059
NODE_121693_length_340_cov_541.348548	86	154	1161	1	68	0.0147059
NODE_121693_length_340_cov_541.348548	86	154	1165	1	68	0.0147059
NODE_121693_length_340_cov_541.348548	86	154	1179	1	68	0.0147059
NODE_121693_length_340_cov_541.348548	86	154	1185	1	68	0.0147059
NODE_121693_length_340_cov_541.348548	86	154	1208	1	68	0.0147059
NODE_121693_length_340_cov_541.348548	86	154	1226	1	68	0.0147059
NODE_121693_length_340_cov_541.348548	86	154	1240	1	68	0.0147059
NODE_121693_length_340_cov_541.348548	86	154	1250	1	68	0.0147059
NODE_121693_length_340_cov_541.348548	86	154	1269	1	68	0.0147059
NODE_121693_length_340_cov_541.348548	86	154	1276	1	68	0.0147059
NODE_121693_length_340_cov_541.348548	86	154	1281	1	68	0.0147059
NODE_121693_length_340_cov_541.348548	86	154	1282	1	68	0.0147059
NODE_121693_length_340_cov_541.348548	86	154	1292	1	68	0.0147059
NODE_121693_length_340_cov_541.348548	86	154	1305	1	68	0.0147059
NODE_121693_length_340_cov_541.348548	86	154	1331	1	68	0.0147059
NODE_121693_length_340_cov_541.348548	86	154	1345	1	68	0.0147059
NODE_121693_length_340_cov_541.348548	86	154	1349	1	68	0.0147059
NODE_121693_length_340_cov_541.348548	86	154	1360	1	68	0.0147059
NODE_121693_length_340_cov_541.348548	86	154	1371	1	68	0.0147059
NODE_121693_length_340_cov_541.348548	86	154	1411	1	68	0.0147059
NODE_121693_length_340_cov_541.348548	86	154	1412	1	68	0.0147059
NODE_121693_length_340_cov_541.348548	86	154	1415	1	68	0.0147059
NODE_121693_length_340_cov_541.348548	86	154	1436	1	68	0.0147059
NODE_121693_length_340_cov_541.348548	86	154	1469	1	68	0.0147059
NODE_121693_length_340_cov_541.348548	86	154	1485	1	68	0.0147059
NODE_121693_length_340_cov_541.348548	86	154	1498	1	68	0.0147059
NODE_121693_length_340_cov_541.348548	86	154	1525	1	68	0.0147059
NODE_121693_length_340_cov_541.348548	86	154	1539	1	68	0.0147059
NODE_121693_length_340_cov_541.348548	86	154	1554	1	68	0.0147059
NODE_121693_length_340_cov_541.348548	86	154	1568	1	68	0.0147059
NODE_121693_length_340_cov_541.348548	86	154	1571	1	68	0.0147059
NODE_121693_length_340_cov_541.348548	86	154	1598	1	68	0.0147059
NODE_121693_length_340_cov_541.348548	86	154	1612	1	68	0.0147059
NODE_121693_length_340_cov_541.348548	86	154	1613	1	68	0.0147059
NODE_121693_length_340_cov_541.348548	86	154	1614	1	68	0.0147059
NODE_121693_length_340_cov_541.348548	86	154	1615	1	68	0.0147059
NODE_121693_length_340_cov_541.348548	86	154	1620	3	68	0.0441176
NODE_121693_length_340_cov_541.348548	86	154	1623	1	68	0.0147059
NODE_121693_length_340_cov_541.348548	86	154	1627	1	68	0.0147059
NODE_121693_length_340_cov_541.348548	86	154	1633	1	68	0.0147059
NODE_121693_length_340_cov_541.348548	86	107	735	1	21	0.0476190
NODE_121693_length_340_cov_541.348548	86	107	737	1	21	0.0476190
NODE_121693_length_340_cov_541.348548	86	107	755	1	21	0.0476190
NODE_121693_length_340_cov_541.348548	86	107	765	1	21	0.0476190
NODE_121693_length_340_cov_541.348548	86	107	783	1	21	0.0476190
NODE_121693_length_340_cov_541.348548	86	107	798	1	21	0.0476190
NODE_121693_length_340_cov_541.348548	86	107	818	1	21	0.0476190
NODE_121693_length_340_cov_541.348548	86	107	830	1	21	0.0476190
NODE_121693_length_340_cov_541.348548	86	107	848	1	21	0.0476190
NODE_121693_length_340_cov_541.348548	86	107	897	1	21	0.0476190
NODE_121693_length_340_cov_541.348548	86	107	905	1	21	0.0476190
NODE_121693_length_340_cov_541.348548	86	107	930	1	21	0.0476190
NODE_121693_length_340_cov_541.348548	86	107	943	1	21	0.0476190
NODE_121693_length_340_cov_541.348548	86	107	951	1	21	0.0476190
NODE_121693_length_340_cov_541.348548	86	107	969	1	21	0.0476190
NODE_121693_length_340_cov_541.348548	86	107	986	1	21	0.0476190
NODE_121693_length_340_cov_541.348548	86	107	1021	1	21	0.0476190
NODE_121693_length_340_cov_541.348548	86	107	1036	1	21	0.0476190
NODE_121693_length_340_cov_541.348548	86	107	1043	1	21	0.0476190
NODE_121693_length_340_cov_541.348548	86	107	1061	1	21	0.0476190
NODE_121693_length_340_cov_541.348548	86	107	1082	1	21	0.0476190
NODE_121694_length_340_cov_50.755187	196	266	28	1	70	0.0142857
NODE_121694_length_340_cov_50.755187	196	266	30	7	70	0.1000000
NODE_121694_length_340_cov_50.755187	196	266	34	3	70	0.0428571
NODE_121694_length_340_cov_50.755187	196	266	36	1	70	0.0142857
NODE_121694_length_340_cov_50.755187	196	266	38	1	70	0.0142857
NODE_121694_length_340_cov_50.755187	196	266	40	4	70	0.0571429
NODE_121694_length_340_cov_50.755187	196	266	42	5	70	0.0714286
NODE_121694_length_340_cov_50.755187	196	266	44	41	70	0.5857143
NODE_121694_length_340_cov_50.755187	196	266	45	6	70	0.0857143
NODE_121694_length_340_cov_50.755187	196	266	46	1	70	0.0142857
NODE_121696_length_340_cov_8.917012	240	270	0	1	30	0.0333333
NODE_121696_length_340_cov_8.917012	240	270	2	29	30	0.9666666
NODE_121696_length_340_cov_8.917012	243	315	0	46	72	0.6388889
NODE_121696_length_340_cov_8.917012	243	315	2	26	72	0.3611111
NODE_121702_length_340_cov_6.439834	175	255	0	80	80	1.0000000
NODE_121702_length_340_cov_6.439834	228	310	0	82	82	1.0000000
NODE_121708_length_340_cov_5.883817	72	121	0	1	49	0.0204082
NODE_121708_length_340_cov_5.883817	72	121	2	4	49	0.0816327
NODE_121708_length_340_cov_5.883817	72	121	6	3	49	0.0612245
NODE_121708_length_340_cov_5.883817	72	121	9	1	49	0.0204082
NODE_121708_length_340_cov_5.883817	72	121	10	2	49	0.0408163
NODE_121708_length_340_cov_5.883817	72	121	12	38	49	0.7755102
NODE_121708_length_340_cov_5.883817	82	113	9	1	31	0.0322581
NODE_121708_length_340_cov_5.883817	82	113	10	2	31	0.0645161
NODE_121708_length_340_cov_5.883817	82	113	12	28	31	0.9032258
NODE_121714_length_340_cov_5.228216	116	186	0	70	70	1.0000000
NODE_121714_length_340_cov_5.228216	159	201	0	42	42	1.0000000
NODE_121730_length_340_cov_4.497925	136	184	0	48	48	1.0000000
NODE_121752_length_340_cov_3.759336	88	169	2	81	81	1.0000000
NODE_121849_length_340_cov_2.506224	68	114	0	46	46	1.0000000
NODE_121951_length_340_cov_1.995851	29	101	0	6	72	0.0833333
NODE_121951_length_340_cov_1.995851	29	101	2	20	72	0.2777778
NODE_121951_length_340_cov_1.995851	29	101	3	2	72	0.0277778
NODE_121951_length_340_cov_1.995851	29	101	5	2	72	0.0277778
NODE_121951_length_340_cov_1.995851	29	101	6	7	72	0.0972222
NODE_121951_length_340_cov_1.995851	29	101	8	35	72	0.4861111
NODE_121951_length_340_cov_1.995851	96	143	6	9	47	0.1914894
NODE_121951_length_340_cov_1.995851	96	143	8	38	47	0.8085107
NODE_122154_length_340_cov_1.427386	244	274	0	30	30	1.0000000
NODE_122218_length_340_cov_1.282158	71	135	0	40	64	0.6250000
NODE_122218_length_340_cov_1.282158	71	135	2	8	64	0.1250000
NODE_122218_length_340_cov_1.282158	71	135	4	10	64	0.1562500
NODE_122218_length_340_cov_1.282158	71	135	5	1	64	0.0156250
NODE_122218_length_340_cov_1.282158	71	135	6	5	64	0.0781250
NODE_122218_length_340_cov_1.282158	128	188	4	1	60	0.0166667
NODE_122218_length_340_cov_1.282158	128	188	5	1	60	0.0166667
NODE_122218_length_340_cov_1.282158	128	188	6	58	60	0.9666666
NODE_122218_length_340_cov_1.282158	142	189	6	47	47	1.0000000
NODE_122220_length_340_cov_1.278008	51	102	0	33	51	0.6470588
NODE_122220_length_340_cov_1.278008	51	102	2	18	51	0.3529412
NODE_122321_length_340_cov_1.199170	98	160	0	62	62	1.0000000
NODE_122381_length_340_cov_1.070539	32	65	0	33	33	1.0000000
NODE_122429_length_340_cov_1.020747	209	228	0	19	19	1.0000000
NODE_122686_length_339_cov_87.841667	149	227	153	1	78	0.0128205
NODE_122686_length_339_cov_87.841667	149	227	156	1	78	0.0128205
NODE_122686_length_339_cov_87.841667	149	227	159	1	78	0.0128205
NODE_122686_length_339_cov_87.841667	149	227	166	1	78	0.0128205
NODE_122686_length_339_cov_87.841667	149	227	170	1	78	0.0128205
NODE_122686_length_339_cov_87.841667	149	227	174	1	78	0.0128205
NODE_122686_length_339_cov_87.841667	149	227	181	1	78	0.0128205
NODE_122686_length_339_cov_87.841667	149	227	191	1	78	0.0128205
NODE_122686_length_339_cov_87.841667	149	227	192	3	78	0.0384615
NODE_122686_length_339_cov_87.841667	149	227	194	2	78	0.0256410
NODE_122686_length_339_cov_87.841667	149	227	196	1	78	0.0128205
NODE_122686_length_339_cov_87.841667	149	227	198	2	78	0.0256410
NODE_122686_length_339_cov_87.841667	149	227	200	1	78	0.0128205
NODE_122686_length_339_cov_87.841667	149	227	209	3	78	0.0384615
NODE_122686_length_339_cov_87.841667	149	227	211	2	78	0.0256410
NODE_122686_length_339_cov_87.841667	149	227	218	1	78	0.0128205
NODE_122686_length_339_cov_87.841667	149	227	227	2	78	0.0256410
NODE_122686_length_339_cov_87.841667	149	227	230	3	78	0.0384615
NODE_122686_length_339_cov_87.841667	149	227	233	1	78	0.0128205
NODE_122686_length_339_cov_87.841667	149	227	239	1	78	0.0128205
NODE_122686_length_339_cov_87.841667	149	227	240	1	78	0.0128205
NODE_122686_length_339_cov_87.841667	149	227	242	1	78	0.0128205
NODE_122686_length_339_cov_87.841667	149	227	251	2	78	0.0256410
NODE_122686_length_339_cov_87.841667	149	227	252	2	78	0.0256410
NODE_122686_length_339_cov_87.841667	149	227	255	2	78	0.0256410
NODE_122686_length_339_cov_87.841667	149	227	257	1	78	0.0128205
NODE_122686_length_339_cov_87.841667	149	227	260	1	78	0.0128205
NODE_122686_length_339_cov_87.841667	149	227	267	1	78	0.0128205
NODE_122686_length_339_cov_87.841667	149	227	268	1	78	0.0128205
NODE_122686_length_339_cov_87.841667	149	227	269	1	78	0.0128205
NODE_122686_length_339_cov_87.841667	149	227	270	1	78	0.0128205
NODE_122686_length_339_cov_87.841667	149	227	271	1	78	0.0128205
NODE_122686_length_339_cov_87.841667	149	227	272	1	78	0.0128205
NODE_122686_length_339_cov_87.841667	149	227	275	1	78	0.0128205
NODE_122686_length_339_cov_87.841667	149	227	276	1	78	0.0128205
NODE_122686_length_339_cov_87.841667	149	227	279	1	78	0.0128205
NODE_122686_length_339_cov_87.841667	149	227	291	2	78	0.0256410
NODE_122686_length_339_cov_87.841667	149	227	297	2	78	0.0256410
NODE_122686_length_339_cov_87.841667	149	227	300	1	78	0.0128205
NODE_122686_length_339_cov_87.841667	149	227	301	1	78	0.0128205
NODE_122686_length_339_cov_87.841667	149	227	302	1	78	0.0128205
NODE_122686_length_339_cov_87.841667	149	227	308	1	78	0.0128205
NODE_122686_length_339_cov_87.841667	149	227	310	2	78	0.0256410
NODE_122686_length_339_cov_87.841667	149	227	312	1	78	0.0128205
NODE_122686_length_339_cov_87.841667	149	227	324	1	78	0.0128205
NODE_122686_length_339_cov_87.841667	149	227	327	1	78	0.0128205
NODE_122686_length_339_cov_87.841667	149	227	329	1	78	0.0128205
NODE_122686_length_339_cov_87.841667	149	227	340	1	78	0.0128205
NODE_122686_length_339_cov_87.841667	149	227	345	1	78	0.0128205
NODE_122686_length_339_cov_87.841667	149	227	347	2	78	0.0256410
NODE_122686_length_339_cov_87.841667	149	227	354	2	78	0.0256410
NODE_122686_length_339_cov_87.841667	149	227	355	1	78	0.0128205
NODE_122686_length_339_cov_87.841667	149	227	356	1	78	0.0128205
NODE_122686_length_339_cov_87.841667	149	227	362	1	78	0.0128205
NODE_122686_length_339_cov_87.841667	149	227	363	2	78	0.0256410
NODE_122686_length_339_cov_87.841667	149	227	364	1	78	0.0128205
NODE_122686_length_339_cov_87.841667	149	227	366	1	78	0.0128205
NODE_122686_length_339_cov_87.841667	149	227	368	1	78	0.0128205
NODE_122686_length_339_cov_87.841667	149	227	374	1	78	0.0128205
NODE_122687_length_339_cov_14.304167	69	138	8	19	69	0.2753623
NODE_122687_length_339_cov_14.304167	69	138	9	12	69	0.1739130
NODE_122687_length_339_cov_14.304167	69	138	13	38	69	0.5507246
NODE_122687_length_339_cov_14.304167	69	138	8	19	69	0.2753623
NODE_122687_length_339_cov_14.304167	69	138	9	12	69	0.1739130
NODE_122687_length_339_cov_14.304167	69	138	13	38	69	0.5507246
NODE_122687_length_339_cov_14.304167	69	138	8	19	69	0.2753623
NODE_122687_length_339_cov_14.304167	69	138	9	12	69	0.1739130
NODE_122687_length_339_cov_14.304167	69	138	13	38	69	0.5507246
NODE_122687_length_339_cov_14.304167	88	138	9	12	50	0.2400000
NODE_122687_length_339_cov_14.304167	88	138	13	38	50	0.7600000
NODE_122687_length_339_cov_14.304167	111	160	12	1	49	0.0204082
NODE_122687_length_339_cov_14.304167	111	160	13	48	49	0.9795918
NODE_122727_length_339_cov_4.320833	187	267	0	80	80	1.0000000
NODE_122804_length_339_cov_2.754167	45	125	2	6	80	0.0750000
NODE_122804_length_339_cov_2.754167	45	125	6	18	80	0.2250000
NODE_122804_length_339_cov_2.754167	45	125	7	11	80	0.1375000
NODE_122804_length_339_cov_2.754167	45	125	9	45	80	0.5625000
NODE_122971_length_339_cov_1.841667	265	312	0	47	47	1.0000000
NODE_123041_length_339_cov_1.662500	10	57	0	4	47	0.0851064
NODE_123041_length_339_cov_1.662500	10	57	2	43	47	0.9148936
NODE_123182_length_339_cov_1.275000	247	312	0	65	65	1.0000000
NODE_123285_length_339_cov_1.070833	147	169	0	22	22	1.0000000
NODE_123633_length_338_cov_57.163180	59	120	0	61	61	1.0000000
NODE_123633_length_338_cov_57.163180	102	176	0	74	74	1.0000000
NODE_123674_length_338_cov_4.263598	113	165	0	52	52	1.0000000
NODE_123679_length_338_cov_4.079498	96	151	8	5	55	0.0909091
NODE_123679_length_338_cov_4.079498	96	151	10	26	55	0.4727273
NODE_123679_length_338_cov_4.079498	96	151	12	24	55	0.4363636
NODE_123689_length_338_cov_3.841004	122	149	0	27	27	1.0000000
NODE_123793_length_338_cov_2.393305	216	288	6	72	72	1.0000000
NODE_123795_length_338_cov_2.380753	29	93	0	8	64	0.1250000
NODE_123795_length_338_cov_2.380753	29	93	2	56	64	0.8750000
NODE_123919_length_338_cov_1.878661	146	232	26	7	86	0.0813954
NODE_123919_length_338_cov_1.878661	146	232	27	14	86	0.1627907
NODE_123919_length_338_cov_1.878661	146	232	28	11	86	0.1279070
NODE_123919_length_338_cov_1.878661	146	232	30	9	86	0.1046512
NODE_123919_length_338_cov_1.878661	146	232	32	2	86	0.0232558
NODE_123919_length_338_cov_1.878661	146	232	34	2	86	0.0232558
NODE_123919_length_338_cov_1.878661	146	232	36	2	86	0.0232558
NODE_123919_length_338_cov_1.878661	146	232	37	6	86	0.0697674
NODE_123919_length_338_cov_1.878661	146	232	38	4	86	0.0465116
NODE_123919_length_338_cov_1.878661	146	232	39	2	86	0.0232558
NODE_123919_length_338_cov_1.878661	146	232	40	1	86	0.0116279
NODE_123919_length_338_cov_1.878661	146	232	42	3	86	0.0348837
NODE_123919_length_338_cov_1.878661	146	232	44	1	86	0.0116279
NODE_123919_length_338_cov_1.878661	146	232	45	2	86	0.0232558
NODE_123919_length_338_cov_1.878661	146	232	46	5	86	0.0581395
NODE_123919_length_338_cov_1.878661	146	232	49	4	86	0.0465116
NODE_123919_length_338_cov_1.878661	146	232	50	6	86	0.0697674
NODE_123919_length_338_cov_1.878661	146	232	51	2	86	0.0232558
NODE_123919_length_338_cov_1.878661	146	232	52	1	86	0.0116279
NODE_123919_length_338_cov_1.878661	146	232	53	1	86	0.0116279
NODE_123919_length_338_cov_1.878661	146	232	55	1	86	0.0116279
NODE_123944_length_338_cov_1.740586	79	159	10	5	80	0.0625000
NODE_123944_length_338_cov_1.740586	79	159	12	17	80	0.2125000
NODE_123944_length_338_cov_1.740586	79	159	14	40	80	0.5000000
NODE_123944_length_338_cov_1.740586	79	159	16	18	80	0.2250000
NODE_123946_length_338_cov_1.732218	216	257	4	41	41	1.0000000
NODE_124046_length_338_cov_1.493724	14	90	0	65	76	0.8552632
NODE_124046_length_338_cov_1.493724	14	90	2	11	76	0.1447368
NODE_124247_length_338_cov_1.100418	265	333	0	68	68	1.0000000
NODE_124456_length_338_cov_0.849372	281	338	2	57	57	1.0000000
NODE_124533_length_338_cov_0.711297	188	263	2	10	75	0.1333333
NODE_124533_length_338_cov_0.711297	188	263	4	36	75	0.4800000
NODE_124533_length_338_cov_0.711297	188	263	6	29	75	0.3866667
NODE_124625_length_337_cov_468.180672	107	187	15	1	80	0.0125000
NODE_124625_length_337_cov_468.180672	107	187	19	5	80	0.0625000
NODE_124625_length_337_cov_468.180672	107	187	20	6	80	0.0750000
NODE_124625_length_337_cov_468.180672	107	187	21	2	80	0.0250000
NODE_124625_length_337_cov_468.180672	107	187	22	4	80	0.0500000
NODE_124625_length_337_cov_468.180672	107	187	24	10	80	0.1250000
NODE_124625_length_337_cov_468.180672	107	187	26	6	80	0.0750000
NODE_124625_length_337_cov_468.180672	107	187	27	1	80	0.0125000
NODE_124625_length_337_cov_468.180672	107	187	29	3	80	0.0375000
NODE_124625_length_337_cov_468.180672	107	187	30	1	80	0.0125000
NODE_124625_length_337_cov_468.180672	107	187	32	3	80	0.0375000
NODE_124625_length_337_cov_468.180672	107	187	33	1	80	0.0125000
NODE_124625_length_337_cov_468.180672	107	187	37	2	80	0.0250000
NODE_124625_length_337_cov_468.180672	107	187	39	7	80	0.0875000
NODE_124625_length_337_cov_468.180672	107	187	40	1	80	0.0125000
NODE_124625_length_337_cov_468.180672	107	187	46	6	80	0.0750000
NODE_124625_length_337_cov_468.180672	107	187	47	8	80	0.1000000
NODE_124625_length_337_cov_468.180672	107	187	53	12	80	0.1500000
NODE_124625_length_337_cov_468.180672	107	187	55	1	80	0.0125000
NODE_124625_length_337_cov_468.180672	160	230	5	6	70	0.0857143
NODE_124625_length_337_cov_468.180672	160	230	7	11	70	0.1571429
NODE_124625_length_337_cov_468.180672	160	230	11	1	70	0.0142857
NODE_124625_length_337_cov_468.180672	160	230	12	1	70	0.0142857
NODE_124625_length_337_cov_468.180672	160	230	13	4	70	0.0571429
NODE_124625_length_337_cov_468.180672	160	230	14	5	70	0.0714286
NODE_124625_length_337_cov_468.180672	160	230	15	8	70	0.1142857
NODE_124625_length_337_cov_468.180672	160	230	16	4	70	0.0571429
NODE_124625_length_337_cov_468.180672	160	230	17	2	70	0.0285714
NODE_124625_length_337_cov_468.180672	160	230	18	2	70	0.0285714
NODE_124625_length_337_cov_468.180672	160	230	19	5	70	0.0714286
NODE_124625_length_337_cov_468.180672	160	230	20	6	70	0.0857143
NODE_124625_length_337_cov_468.180672	160	230	21	2	70	0.0285714
NODE_124625_length_337_cov_468.180672	160	230	22	4	70	0.0571429
NODE_124625_length_337_cov_468.180672	160	230	24	9	70	0.1285714
NODE_124625_length_337_cov_468.180672	226	306	8	7	80	0.0875000
NODE_124625_length_337_cov_468.180672	226	306	10	2	80	0.0250000
NODE_124625_length_337_cov_468.180672	226	306	12	14	80	0.1750000
NODE_124625_length_337_cov_468.180672	226	306	13	18	80	0.2250000
NODE_124625_length_337_cov_468.180672	226	306	15	5	80	0.0625000
NODE_124625_length_337_cov_468.180672	226	306	16	2	80	0.0250000
NODE_124625_length_337_cov_468.180672	226	306	17	13	80	0.1625000
NODE_124625_length_337_cov_468.180672	226	306	18	19	80	0.2375000
NODE_124625_length_337_cov_468.180672	279	337	0	13	58	0.2241379
NODE_124625_length_337_cov_468.180672	279	337	2	6	58	0.1034483
NODE_124625_length_337_cov_468.180672	279	337	4	4	58	0.0689655
NODE_124625_length_337_cov_468.180672	279	337	6	1	58	0.0172414
NODE_124625_length_337_cov_468.180672	279	337	8	14	58	0.2413793
NODE_124625_length_337_cov_468.180672	279	337	10	2	58	0.0344828
NODE_124625_length_337_cov_468.180672	279	337	12	14	58	0.2413793
NODE_124625_length_337_cov_468.180672	279	337	13	4	58	0.0689655
NODE_124626_length_337_cov_91.344538	1	50	12	5	49	0.1020408
NODE_124626_length_337_cov_91.344538	1	50	16	1	49	0.0204082
NODE_124626_length_337_cov_91.344538	1	50	26	4	49	0.0816327
NODE_124626_length_337_cov_91.344538	1	50	30	1	49	0.0204082
NODE_124626_length_337_cov_91.344538	1	50	31	1	49	0.0204082
NODE_124626_length_337_cov_91.344538	1	50	35	6	49	0.1224490
NODE_124626_length_337_cov_91.344538	1	50	36	1	49	0.0204082
NODE_124626_length_337_cov_91.344538	1	50	51	1	49	0.0204082
NODE_124626_length_337_cov_91.344538	1	50	58	5	49	0.1020408
NODE_124626_length_337_cov_91.344538	1	50	60	5	49	0.1020408
NODE_124626_length_337_cov_91.344538	1	50	62	1	49	0.0204082
NODE_124626_length_337_cov_91.344538	1	50	70	2	49	0.0408163
NODE_124626_length_337_cov_91.344538	1	50	72	1	49	0.0204082
NODE_124626_length_337_cov_91.344538	1	50	75	7	49	0.1428571
NODE_124626_length_337_cov_91.344538	1	50	79	1	49	0.0204082
NODE_124626_length_337_cov_91.344538	1	50	80	1	49	0.0204082
NODE_124626_length_337_cov_91.344538	1	50	82	1	49	0.0204082
NODE_124626_length_337_cov_91.344538	1	50	84	5	49	0.1020408
NODE_124626_length_337_cov_91.344538	23	103	58	3	80	0.0375000
NODE_124626_length_337_cov_91.344538	23	103	60	5	80	0.0625000
NODE_124626_length_337_cov_91.344538	23	103	62	1	80	0.0125000
NODE_124626_length_337_cov_91.344538	23	103	70	2	80	0.0250000
NODE_124626_length_337_cov_91.344538	23	103	72	1	80	0.0125000
NODE_124626_length_337_cov_91.344538	23	103	75	7	80	0.0875000
NODE_124626_length_337_cov_91.344538	23	103	79	1	80	0.0125000
NODE_124626_length_337_cov_91.344538	23	103	80	1	80	0.0125000
NODE_124626_length_337_cov_91.344538	23	103	82	1	80	0.0125000
NODE_124626_length_337_cov_91.344538	23	103	84	9	80	0.1125000
NODE_124626_length_337_cov_91.344538	23	103	87	1	80	0.0125000
NODE_124626_length_337_cov_91.344538	23	103	89	4	80	0.0500000
NODE_124626_length_337_cov_91.344538	23	103	91	1	80	0.0125000
NODE_124626_length_337_cov_91.344538	23	103	93	8	80	0.1000000
NODE_124626_length_337_cov_91.344538	23	103	94	2	80	0.0250000
NODE_124626_length_337_cov_91.344538	23	103	95	7	80	0.0875000
NODE_124626_length_337_cov_91.344538	23	103	97	6	80	0.0750000
NODE_124626_length_337_cov_91.344538	23	103	99	5	80	0.0625000
NODE_124626_length_337_cov_91.344538	23	103	101	7	80	0.0875000
NODE_124626_length_337_cov_91.344538	23	103	103	1	80	0.0125000
NODE_124626_length_337_cov_91.344538	23	103	105	7	80	0.0875000
NODE_124627_length_337_cov_73.352941	71	151	0	80	80	1.0000000
NODE_124627_length_337_cov_73.352941	124	204	0	80	80	1.0000000
NODE_124629_length_337_cov_46.978992	220	305	32	10	85	0.1176471
NODE_124629_length_337_cov_46.978992	220	305	36	4	85	0.0470588
NODE_124629_length_337_cov_46.978992	220	305	38	20	85	0.2352941
NODE_124629_length_337_cov_46.978992	220	305	40	51	85	0.6000000
NODE_124629_length_337_cov_46.978992	220	305	32	10	85	0.1176471
NODE_124629_length_337_cov_46.978992	220	305	36	4	85	0.0470588
NODE_124629_length_337_cov_46.978992	220	305	38	20	85	0.2352941
NODE_124629_length_337_cov_46.978992	220	305	40	51	85	0.6000000
NODE_124629_length_337_cov_46.978992	220	305	32	10	85	0.1176471
NODE_124629_length_337_cov_46.978992	220	305	36	4	85	0.0470588
NODE_124629_length_337_cov_46.978992	220	305	38	20	85	0.2352941
NODE_124629_length_337_cov_46.978992	220	305	40	51	85	0.6000000
NODE_124629_length_337_cov_46.978992	278	327	14	1	49	0.0204082
NODE_124629_length_337_cov_46.978992	278	327	16	6	49	0.1224490
NODE_124629_length_337_cov_46.978992	278	327	24	1	49	0.0204082
NODE_124629_length_337_cov_46.978992	278	327	26	2	49	0.0408163
NODE_124629_length_337_cov_46.978992	278	327	30	11	49	0.2244898
NODE_124629_length_337_cov_46.978992	278	327	34	1	49	0.0204082
NODE_124629_length_337_cov_46.978992	278	327	38	20	49	0.4081633
NODE_124629_length_337_cov_46.978992	278	327	40	7	49	0.1428571
NODE_124629_length_337_cov_46.978992	278	337	4	10	59	0.1694915
NODE_124629_length_337_cov_46.978992	278	337	14	1	59	0.0169492
NODE_124629_length_337_cov_46.978992	278	337	16	6	59	0.1016949
NODE_124629_length_337_cov_46.978992	278	337	24	1	59	0.0169492
NODE_124629_length_337_cov_46.978992	278	337	26	2	59	0.0338983
NODE_124629_length_337_cov_46.978992	278	337	30	11	59	0.1864407
NODE_124629_length_337_cov_46.978992	278	337	34	1	59	0.0169492
NODE_124629_length_337_cov_46.978992	278	337	38	20	59	0.3389831
NODE_124629_length_337_cov_46.978992	278	337	40	7	59	0.1186441
NODE_124629_length_337_cov_46.978992	283	337	4	10	54	0.1851852
NODE_124629_length_337_cov_46.978992	283	337	14	1	54	0.0185185
NODE_124629_length_337_cov_46.978992	283	337	16	6	54	0.1111111
NODE_124629_length_337_cov_46.978992	283	337	24	1	54	0.0185185
NODE_124629_length_337_cov_46.978992	283	337	26	2	54	0.0370370
NODE_124629_length_337_cov_46.978992	283	337	30	11	54	0.2037037
NODE_124629_length_337_cov_46.978992	283	337	34	1	54	0.0185185
NODE_124629_length_337_cov_46.978992	283	337	38	20	54	0.3703704
NODE_124629_length_337_cov_46.978992	283	337	40	2	54	0.0370370
NODE_124640_length_337_cov_6.214286	52	95	0	43	43	1.0000000
NODE_124669_length_337_cov_4.298319	5	58	0	53	53	1.0000000
NODE_124703_length_337_cov_3.478992	179	259	51	2	80	0.0250000
NODE_124703_length_337_cov_3.478992	179	259	54	13	80	0.1625000
NODE_124703_length_337_cov_3.478992	179	259	55	2	80	0.0250000
NODE_124703_length_337_cov_3.478992	179	259	56	7	80	0.0875000
NODE_124703_length_337_cov_3.478992	179	259	57	6	80	0.0750000
NODE_124703_length_337_cov_3.478992	179	259	59	1	80	0.0125000
NODE_124703_length_337_cov_3.478992	179	259	60	2	80	0.0250000
NODE_124703_length_337_cov_3.478992	179	259	61	3	80	0.0375000
NODE_124703_length_337_cov_3.478992	179	259	63	8	80	0.1000000
NODE_124703_length_337_cov_3.478992	179	259	65	6	80	0.0750000
NODE_124703_length_337_cov_3.478992	179	259	66	2	80	0.0250000
NODE_124703_length_337_cov_3.478992	179	259	70	1	80	0.0125000
NODE_124703_length_337_cov_3.478992	179	259	72	3	80	0.0375000
NODE_124703_length_337_cov_3.478992	179	259	73	13	80	0.1625000
NODE_124703_length_337_cov_3.478992	179	259	74	2	80	0.0250000
NODE_124703_length_337_cov_3.478992	179	259	76	1	80	0.0125000
NODE_124703_length_337_cov_3.478992	179	259	77	2	80	0.0250000
NODE_124703_length_337_cov_3.478992	179	259	78	4	80	0.0500000
NODE_124703_length_337_cov_3.478992	179	259	79	2	80	0.0250000
NODE_124703_length_337_cov_3.478992	232	307	8	1	75	0.0133333
NODE_124703_length_337_cov_3.478992	232	307	23	2	75	0.0266667
NODE_124703_length_337_cov_3.478992	232	307	25	1	75	0.0133333
NODE_124703_length_337_cov_3.478992	232	307	29	4	75	0.0533333
NODE_124703_length_337_cov_3.478992	232	307	31	1	75	0.0133333
NODE_124703_length_337_cov_3.478992	232	307	37	3	75	0.0400000
NODE_124703_length_337_cov_3.478992	232	307	41	1	75	0.0133333
NODE_124703_length_337_cov_3.478992	232	307	43	2	75	0.0266667
NODE_124703_length_337_cov_3.478992	232	307	44	4	75	0.0533333
NODE_124703_length_337_cov_3.478992	232	307	47	1	75	0.0133333
NODE_124703_length_337_cov_3.478992	232	307	49	12	75	0.1600000
NODE_124703_length_337_cov_3.478992	232	307	50	1	75	0.0133333
NODE_124703_length_337_cov_3.478992	232	307	52	2	75	0.0266667
NODE_124703_length_337_cov_3.478992	232	307	54	1	75	0.0133333
NODE_124703_length_337_cov_3.478992	232	307	58	1	75	0.0133333
NODE_124703_length_337_cov_3.478992	232	307	59	11	75	0.1466667
NODE_124703_length_337_cov_3.478992	232	307	60	1	75	0.0133333
NODE_124703_length_337_cov_3.478992	232	307	63	8	75	0.1066667
NODE_124703_length_337_cov_3.478992	232	307	65	3	75	0.0400000
NODE_124703_length_337_cov_3.478992	232	307	66	2	75	0.0266667
NODE_124703_length_337_cov_3.478992	232	307	70	1	75	0.0133333
NODE_124703_length_337_cov_3.478992	232	307	72	3	75	0.0400000
NODE_124703_length_337_cov_3.478992	232	307	73	9	75	0.1200000
NODE_124759_length_337_cov_2.647059	80	146	0	66	66	1.0000000
NODE_124858_length_337_cov_2.121849	23	103	15	2	80	0.0250000
NODE_124858_length_337_cov_2.121849	23	103	17	1	80	0.0125000
NODE_124858_length_337_cov_2.121849	23	103	18	77	80	0.9625000
NODE_124858_length_337_cov_2.121849	76	141	12	4	65	0.0615385
NODE_124858_length_337_cov_2.121849	76	141	16	29	65	0.4461538
NODE_124858_length_337_cov_2.121849	76	141	18	32	65	0.4923077
NODE_125001_length_337_cov_1.689076	138	218	0	46	80	0.5750000
NODE_125001_length_337_cov_1.689076	138	218	2	34	80	0.4250000
NODE_125024_length_337_cov_1.592437	109	151	0	42	42	1.0000000
NODE_125024_length_337_cov_1.592437	126	204	0	78	78	1.0000000
NODE_125074_length_337_cov_1.466387	266	332	0	66	66	1.0000000
NODE_125271_length_337_cov_1.071429	279	319	0	40	40	1.0000000
NODE_125332_length_337_cov_0.978992	227	272	0	7	45	0.1555556
NODE_125332_length_337_cov_0.978992	227	272	2	38	45	0.8444445
NODE_125633_length_336_cov_7.843882	151	231	0	80	80	1.0000000
NODE_125645_length_336_cov_5.578059	159	220	0	26	61	0.4262295
NODE_125645_length_336_cov_5.578059	159	220	2	35	61	0.5737705
NODE_125645_length_336_cov_5.578059	212	273	0	9	61	0.1475410
NODE_125645_length_336_cov_5.578059	212	273	2	52	61	0.8524590
NODE_125663_length_336_cov_4.481013	129	207	0	50	78	0.6410257
NODE_125663_length_336_cov_4.481013	129	207	2	4	78	0.0512821
NODE_125663_length_336_cov_4.481013	129	207	6	24	78	0.3076923
NODE_125752_length_336_cov_2.755274	83	112	12	6	29	0.2068966
NODE_125752_length_336_cov_2.755274	83	112	13	9	29	0.3103448
NODE_125752_length_336_cov_2.755274	83	112	15	14	29	0.4827586
NODE_125752_length_336_cov_2.755274	187	268	2	2	81	0.0246914
NODE_125752_length_336_cov_2.755274	187	268	3	4	81	0.0493827
NODE_125752_length_336_cov_2.755274	187	268	5	9	81	0.1111111
NODE_125752_length_336_cov_2.755274	187	268	7	19	81	0.2345679
NODE_125752_length_336_cov_2.755274	187	268	8	9	81	0.1111111
NODE_125752_length_336_cov_2.755274	187	268	10	1	81	0.0123457
NODE_125752_length_336_cov_2.755274	187	268	12	27	81	0.3333333
NODE_125752_length_336_cov_2.755274	187	268	14	6	81	0.0740741
NODE_125752_length_336_cov_2.755274	187	268	16	3	81	0.0370370
NODE_125752_length_336_cov_2.755274	187	268	18	1	81	0.0123457
NODE_125806_length_336_cov_2.358650	60	133	2	17	73	0.2328767
NODE_125806_length_336_cov_2.358650	60	133	4	56	73	0.7671233
NODE_125811_length_336_cov_2.337553	93	173	0	1	80	0.0125000
NODE_125811_length_336_cov_2.337553	93	173	2	79	80	0.9875000
NODE_125965_length_336_cov_1.729958	78	141	4	63	63	1.0000000
NODE_125965_length_336_cov_1.729958	131	194	0	36	63	0.5714286
NODE_125965_length_336_cov_1.729958	131	194	2	6	63	0.0952381
NODE_125965_length_336_cov_1.729958	131	194	3	1	63	0.0158730
NODE_125965_length_336_cov_1.729958	131	194	4	20	63	0.3174603
NODE_126134_length_336_cov_1.333333	34	114	0	45	80	0.5625000
NODE_126134_length_336_cov_1.333333	34	114	2	8	80	0.1000000
NODE_126134_length_336_cov_1.333333	34	114	3	11	80	0.1375000
NODE_126134_length_336_cov_1.333333	34	114	4	16	80	0.2000000
NODE_126134_length_336_cov_1.333333	87	124	3	11	37	0.2972973
NODE_126134_length_336_cov_1.333333	87	124	4	26	37	0.7027027
NODE_126134_length_336_cov_1.333333	182	213	0	3	31	0.0967742
NODE_126134_length_336_cov_1.333333	182	213	1	28	31	0.9032258
NODE_126216_length_336_cov_1.244726	222	276	2	15	54	0.2777778
NODE_126216_length_336_cov_1.244726	222	276	4	31	54	0.5740741
NODE_126216_length_336_cov_1.244726	222	276	6	8	54	0.1481481
NODE_126216_length_336_cov_1.244726	288	312	4	24	24	1.0000000
NODE_126260_length_336_cov_1.143460	129	154	0	25	25	1.0000000
NODE_126545_length_336_cov_0.670886	259	288	0	25	29	0.8620690
NODE_126545_length_336_cov_0.670886	259	288	2	4	29	0.1379310
NODE_126606_length_335_cov_16.114407	162	242	0	80	80	1.0000000
NODE_126606_length_335_cov_16.114407	215	295	0	80	80	1.0000000
NODE_126609_length_335_cov_9.258475	177	250	0	73	73	1.0000000
NODE_126614_length_335_cov_7.207627	29	109	0	80	80	1.0000000
NODE_126614_length_335_cov_7.207627	82	162	0	80	80	1.0000000
NODE_126636_length_335_cov_5.046610	182	263	0	81	81	1.0000000
NODE_126639_length_335_cov_4.995763	144	215	0	71	71	1.0000000
NODE_126665_length_335_cov_3.923729	163	231	0	68	68	1.0000000
NODE_126787_length_335_cov_2.411017	230	294	2	57	64	0.8906250
NODE_126787_length_335_cov_2.411017	230	294	7	4	64	0.0625000
NODE_126787_length_335_cov_2.411017	230	294	8	3	64	0.0468750
NODE_126791_length_335_cov_2.402542	164	240	0	27	76	0.3552631
NODE_126791_length_335_cov_2.402542	164	240	1	1	76	0.0131579
NODE_126791_length_335_cov_2.402542	164	240	3	1	76	0.0131579
NODE_126791_length_335_cov_2.402542	164	240	7	7	76	0.0921053
NODE_126791_length_335_cov_2.402542	164	240	13	4	76	0.0526316
NODE_126791_length_335_cov_2.402542	164	240	22	5	76	0.0657895
NODE_126791_length_335_cov_2.402542	164	240	24	2	76	0.0263158
NODE_126791_length_335_cov_2.402542	164	240	28	3	76	0.0394737
NODE_126791_length_335_cov_2.402542	164	240	30	17	76	0.2236842
NODE_126791_length_335_cov_2.402542	164	240	32	1	76	0.0131579
NODE_126791_length_335_cov_2.402542	164	240	39	1	76	0.0131579
NODE_126791_length_335_cov_2.402542	164	240	42	7	76	0.0921053
NODE_126792_length_335_cov_2.398305	116	179	5	1	63	0.0158730
NODE_126792_length_335_cov_2.398305	116	179	6	46	63	0.7301587
NODE_126792_length_335_cov_2.398305	116	179	8	14	63	0.2222222
NODE_126792_length_335_cov_2.398305	116	179	10	2	63	0.0317460
NODE_126826_length_335_cov_2.161017	82	141	4	31	59	0.5254237
NODE_126826_length_335_cov_2.161017	82	141	6	28	59	0.4745763
NODE_126835_length_335_cov_2.152542	61	134	0	35	73	0.4794520
NODE_126835_length_335_cov_2.152542	61	134	2	38	73	0.5205479
NODE_126835_length_335_cov_2.152542	114	134	2	20	20	1.0000000
NODE_126920_length_335_cov_1.766949	257	330	0	12	73	0.1643836
NODE_126920_length_335_cov_1.766949	257	330	2	14	73	0.1917808
NODE_126920_length_335_cov_1.766949	257	330	6	47	73	0.6438356
NODE_126920_length_335_cov_1.766949	297	335	0	17	38	0.4473684
NODE_126920_length_335_cov_1.766949	297	335	2	14	38	0.3684210
NODE_126920_length_335_cov_1.766949	297	335	6	7	38	0.1842105
NODE_127022_length_335_cov_1.529661	255	320	0	65	65	1.0000000
NODE_127023_length_335_cov_1.525424	222	266	4	44	44	1.0000000
NODE_127062_length_335_cov_1.457627	38	87	0	17	49	0.3469388
NODE_127062_length_335_cov_1.457627	38	87	2	32	49	0.6530612
NODE_127130_length_335_cov_1.296610	291	311	0	1	20	0.0500000
NODE_127130_length_335_cov_1.296610	291	311	2	19	20	0.9500000
NODE_127130_length_335_cov_1.296610	291	311	0	1	20	0.0500000
NODE_127130_length_335_cov_1.296610	291	311	2	19	20	0.9500000
NODE_127143_length_335_cov_1.292373	202	232	0	30	30	1.0000000
NODE_127200_length_335_cov_1.194915	75	156	24	14	81	0.1728395
NODE_127200_length_335_cov_1.194915	75	156	25	42	81	0.5185185
NODE_127200_length_335_cov_1.194915	75	156	26	13	81	0.1604938
NODE_127200_length_335_cov_1.194915	75	156	27	12	81	0.1481481
NODE_127200_length_335_cov_1.194915	129	195	8	2	66	0.0303030
NODE_127200_length_335_cov_1.194915	129	195	9	11	66	0.1666667
NODE_127200_length_335_cov_1.194915	129	195	11	2	66	0.0303030
NODE_127200_length_335_cov_1.194915	129	195	15	1	66	0.0151515
NODE_127200_length_335_cov_1.194915	129	195	20	12	66	0.1818182
NODE_127200_length_335_cov_1.194915	129	195	21	2	66	0.0303030
NODE_127200_length_335_cov_1.194915	129	195	23	3	66	0.0454545
NODE_127200_length_335_cov_1.194915	129	195	24	14	66	0.2121212
NODE_127200_length_335_cov_1.194915	129	195	25	5	66	0.0757576
NODE_127200_length_335_cov_1.194915	129	195	26	14	66	0.2121212
NODE_127310_length_335_cov_0.983051	96	117	0	21	21	1.0000000
NODE_127585_length_334_cov_275.425532	135	215	177	3	80	0.0375000
NODE_127585_length_334_cov_275.425532	135	215	179	1	80	0.0125000
NODE_127585_length_334_cov_275.425532	135	215	181	2	80	0.0250000
NODE_127585_length_334_cov_275.425532	135	215	186	1	80	0.0125000
NODE_127585_length_334_cov_275.425532	135	215	194	1	80	0.0125000
NODE_127585_length_334_cov_275.425532	135	215	195	2	80	0.0250000
NODE_127585_length_334_cov_275.425532	135	215	202	1	80	0.0125000
NODE_127585_length_334_cov_275.425532	135	215	205	2	80	0.0250000
NODE_127585_length_334_cov_275.425532	135	215	206	2	80	0.0250000
NODE_127585_length_334_cov_275.425532	135	215	207	4	80	0.0500000
NODE_127585_length_334_cov_275.425532	135	215	209	1	80	0.0125000
NODE_127585_length_334_cov_275.425532	135	215	210	1	80	0.0125000
NODE_127585_length_334_cov_275.425532	135	215	211	1	80	0.0125000
NODE_127585_length_334_cov_275.425532	135	215	215	1	80	0.0125000
NODE_127585_length_334_cov_275.425532	135	215	217	2	80	0.0250000
NODE_127585_length_334_cov_275.425532	135	215	219	1	80	0.0125000
NODE_127585_length_334_cov_275.425532	135	215	222	1	80	0.0125000
NODE_127585_length_334_cov_275.425532	135	215	223	1	80	0.0125000
NODE_127585_length_334_cov_275.425532	135	215	224	2	80	0.0250000
NODE_127585_length_334_cov_275.425532	135	215	225	3	80	0.0375000
NODE_127585_length_334_cov_275.425532	135	215	227	1	80	0.0125000
NODE_127585_length_334_cov_275.425532	135	215	229	5	80	0.0625000
NODE_127585_length_334_cov_275.425532	135	215	230	1	80	0.0125000
NODE_127585_length_334_cov_275.425532	135	215	231	5	80	0.0625000
NODE_127585_length_334_cov_275.425532	135	215	233	3	80	0.0375000
NODE_127585_length_334_cov_275.425532	135	215	234	2	80	0.0250000
NODE_127585_length_334_cov_275.425532	135	215	235	3	80	0.0375000
NODE_127585_length_334_cov_275.425532	135	215	236	1	80	0.0125000
NODE_127585_length_334_cov_275.425532	135	215	237	4	80	0.0500000
NODE_127585_length_334_cov_275.425532	135	215	239	4	80	0.0500000
NODE_127585_length_334_cov_275.425532	135	215	240	2	80	0.0250000
NODE_127585_length_334_cov_275.425532	135	215	241	2	80	0.0250000
NODE_127585_length_334_cov_275.425532	135	215	243	5	80	0.0625000
NODE_127585_length_334_cov_275.425532	135	215	245	7	80	0.0875000
NODE_127585_length_334_cov_275.425532	135	215	246	2	80	0.0250000
NODE_127585_length_334_cov_275.425532	188	269	115	4	81	0.0493827
NODE_127585_length_334_cov_275.425532	188	269	121	1	81	0.0123457
NODE_127585_length_334_cov_275.425532	188	269	122	3	81	0.0370370
NODE_127585_length_334_cov_275.425532	188	269	130	8	81	0.0987654
NODE_127585_length_334_cov_275.425532	188	269	131	3	81	0.0370370
NODE_127585_length_334_cov_275.425532	188	269	132	2	81	0.0246914
NODE_127585_length_334_cov_275.425532	188	269	134	2	81	0.0246914
NODE_127585_length_334_cov_275.425532	188	269	138	6	81	0.0740741
NODE_127585_length_334_cov_275.425532	188	269	139	1	81	0.0123457
NODE_127585_length_334_cov_275.425532	188	269	145	3	81	0.0370370
NODE_127585_length_334_cov_275.425532	188	269	147	2	81	0.0246914
NODE_127585_length_334_cov_275.425532	188	269	149	1	81	0.0123457
NODE_127585_length_334_cov_275.425532	188	269	164	2	81	0.0246914
NODE_127585_length_334_cov_275.425532	188	269	168	1	81	0.0123457
NODE_127585_length_334_cov_275.425532	188	269	172	1	81	0.0123457
NODE_127585_length_334_cov_275.425532	188	269	175	1	81	0.0123457
NODE_127585_length_334_cov_275.425532	188	269	179	1	81	0.0123457
NODE_127585_length_334_cov_275.425532	188	269	181	1	81	0.0123457
NODE_127585_length_334_cov_275.425532	188	269	183	3	81	0.0370370
NODE_127585_length_334_cov_275.425532	188	269	192	1	81	0.0123457
NODE_127585_length_334_cov_275.425532	188	269	197	1	81	0.0123457
NODE_127585_length_334_cov_275.425532	188	269	200	3	81	0.0370370
NODE_127585_length_334_cov_275.425532	188	269	201	1	81	0.0123457
NODE_127585_length_334_cov_275.425532	188	269	205	1	81	0.0123457
NODE_127585_length_334_cov_275.425532	188	269	207	4	81	0.0493827
NODE_127585_length_334_cov_275.425532	188	269	208	1	81	0.0123457
NODE_127585_length_334_cov_275.425532	188	269	210	2	81	0.0246914
NODE_127585_length_334_cov_275.425532	188	269	211	1	81	0.0123457
NODE_127585_length_334_cov_275.425532	188	269	215	1	81	0.0123457
NODE_127585_length_334_cov_275.425532	188	269	217	1	81	0.0123457
NODE_127585_length_334_cov_275.425532	188	269	219	1	81	0.0123457
NODE_127585_length_334_cov_275.425532	188	269	223	1	81	0.0123457
NODE_127585_length_334_cov_275.425532	188	269	224	2	81	0.0246914
NODE_127585_length_334_cov_275.425532	188	269	225	2	81	0.0246914
NODE_127585_length_334_cov_275.425532	188	269	227	1	81	0.0123457
NODE_127585_length_334_cov_275.425532	188	269	229	5	81	0.0617284
NODE_127585_length_334_cov_275.425532	188	269	230	1	81	0.0123457
NODE_127585_length_334_cov_275.425532	188	269	233	1	81	0.0123457
NODE_127585_length_334_cov_275.425532	188	269	234	2	81	0.0246914
NODE_127585_length_334_cov_275.425532	188	269	235	2	81	0.0246914
NODE_127586_length_334_cov_14.753191	135	215	0	16	80	0.2000000
NODE_127586_length_334_cov_14.753191	135	215	2	64	80	0.8000000
NODE_127586_length_334_cov_14.753191	188	268	0	69	80	0.8625000
NODE_127586_length_334_cov_14.753191	188	268	2	11	80	0.1375000
NODE_127610_length_334_cov_4.829787	92	174	0	82	82	1.0000000
NODE_127610_length_334_cov_4.829787	151	237	0	86	86	1.0000000
NODE_127612_length_334_cov_4.817021	179	231	0	52	52	1.0000000
NODE_127626_length_334_cov_4.438298	121	201	6	6	80	0.0750000
NODE_127626_length_334_cov_4.438298	121	201	8	3	80	0.0375000
NODE_127626_length_334_cov_4.438298	121	201	17	1	80	0.0125000
NODE_127626_length_334_cov_4.438298	121	201	18	15	80	0.1875000
NODE_127626_length_334_cov_4.438298	121	201	20	12	80	0.1500000
NODE_127626_length_334_cov_4.438298	121	201	22	3	80	0.0375000
NODE_127626_length_334_cov_4.438298	121	201	23	5	80	0.0625000
NODE_127626_length_334_cov_4.438298	121	201	24	20	80	0.2500000
NODE_127626_length_334_cov_4.438298	121	201	26	15	80	0.1875000
NODE_127672_length_334_cov_3.604255	248	314	0	66	66	1.0000000
NODE_127672_length_334_cov_3.604255	287	334	0	47	47	1.0000000
NODE_127844_length_334_cov_2.165957	0	48	0	48	48	1.0000000
NODE_128026_length_334_cov_1.595745	253	328	4	1	75	0.0133333
NODE_128026_length_334_cov_1.595745	253	328	6	74	75	0.9866667
NODE_128258_length_334_cov_1.157447	146	177	0	31	31	1.0000000
NODE_128665_length_333_cov_5.423077	172	242	0	12	70	0.1714286
NODE_128665_length_333_cov_5.423077	172	242	2	58	70	0.8285714
NODE_128673_length_333_cov_4.867521	122	172	7	1	50	0.0200000
NODE_128673_length_333_cov_4.867521	122	172	8	5	50	0.1000000
NODE_128673_length_333_cov_4.867521	122	172	9	1	50	0.0200000
NODE_128673_length_333_cov_4.867521	122	172	10	7	50	0.1400000
NODE_128673_length_333_cov_4.867521	122	172	12	33	50	0.6600000
NODE_128673_length_333_cov_4.867521	122	172	16	3	50	0.0600000
NODE_128673_length_333_cov_4.867521	175	255	8	3	80	0.0375000
NODE_128673_length_333_cov_4.867521	175	255	10	77	80	0.9625000
NODE_128673_length_333_cov_4.867521	194	219	10	25	25	1.0000000
NODE_128717_length_333_cov_3.717949	49	129	0	74	80	0.9250000
NODE_128717_length_333_cov_3.717949	49	129	1	3	80	0.0375000
NODE_128717_length_333_cov_3.717949	49	129	2	3	80	0.0375000
NODE_128717_length_333_cov_3.717949	102	182	0	21	80	0.2625000
NODE_128717_length_333_cov_3.717949	102	182	1	3	80	0.0375000
NODE_128717_length_333_cov_3.717949	102	182	2	5	80	0.0625000
NODE_128717_length_333_cov_3.717949	102	182	4	2	80	0.0250000
NODE_128717_length_333_cov_3.717949	102	182	5	10	80	0.1250000
NODE_128717_length_333_cov_3.717949	102	182	6	13	80	0.1625000
NODE_128717_length_333_cov_3.717949	102	182	8	26	80	0.3250000
NODE_128767_length_333_cov_2.897436	59	139	3	8	80	0.1000000
NODE_128767_length_333_cov_2.897436	59	139	5	1	80	0.0125000
NODE_128767_length_333_cov_2.897436	59	139	12	1	80	0.0125000
NODE_128767_length_333_cov_2.897436	59	139	16	2	80	0.0250000
NODE_128767_length_333_cov_2.897436	59	139	20	4	80	0.0500000
NODE_128767_length_333_cov_2.897436	59	139	22	1	80	0.0125000
NODE_128767_length_333_cov_2.897436	59	139	26	7	80	0.0875000
NODE_128767_length_333_cov_2.897436	59	139	28	10	80	0.1250000
NODE_128767_length_333_cov_2.897436	59	139	32	3	80	0.0375000
NODE_128767_length_333_cov_2.897436	59	139	34	14	80	0.1750000
NODE_128767_length_333_cov_2.897436	59	139	36	29	80	0.3625000
NODE_128850_length_333_cov_2.307692	68	148	1	9	80	0.1125000
NODE_128850_length_333_cov_2.307692	68	148	3	4	80	0.0500000
NODE_128850_length_333_cov_2.307692	68	148	4	47	80	0.5875000
NODE_128850_length_333_cov_2.307692	68	148	6	20	80	0.2500000
NODE_128933_length_333_cov_1.940171	135	215	0	80	80	1.0000000
NODE_129252_length_333_cov_1.200855	0	80	2	50	80	0.6250000
NODE_129252_length_333_cov_1.200855	0	80	4	26	80	0.3250000
NODE_129252_length_333_cov_1.200855	0	80	5	1	80	0.0125000
NODE_129252_length_333_cov_1.200855	0	80	6	3	80	0.0375000
NODE_129263_length_333_cov_1.170940	146	193	2	3	47	0.0638298
NODE_129263_length_333_cov_1.170940	146	193	4	18	47	0.3829787
NODE_129263_length_333_cov_1.170940	146	193	6	12	47	0.2553191
NODE_129263_length_333_cov_1.170940	146	193	8	14	47	0.2978723
NODE_129263_length_333_cov_1.170940	203	243	6	9	40	0.2250000
NODE_129263_length_333_cov_1.170940	203	243	8	12	40	0.3000000
NODE_129263_length_333_cov_1.170940	203	243	10	19	40	0.4750000
NODE_129303_length_333_cov_1.089744	241	306	0	65	65	1.0000000
NODE_129310_length_333_cov_1.089744	206	226	0	20	20	1.0000000
NODE_129665_length_332_cov_5.386266	101	167	0	66	66	1.0000000
NODE_129680_length_332_cov_4.768240	221	250	4	29	29	1.0000000
NODE_129695_length_332_cov_4.343348	130	179	0	49	49	1.0000000
NODE_129698_length_332_cov_4.201717	191	237	0	46	46	1.0000000
NODE_129698_length_332_cov_4.201717	211	290	0	79	79	1.0000000
NODE_129879_length_332_cov_2.274678	187	227	33	6	40	0.1500000
NODE_129879_length_332_cov_2.274678	187	227	34	2	40	0.0500000
NODE_129879_length_332_cov_2.274678	187	227	38	2	40	0.0500000
NODE_129879_length_332_cov_2.274678	187	227	44	2	40	0.0500000
NODE_129879_length_332_cov_2.274678	187	227	48	1	40	0.0250000
NODE_129879_length_332_cov_2.274678	187	227	66	1	40	0.0250000
NODE_129879_length_332_cov_2.274678	187	227	70	1	40	0.0250000
NODE_129879_length_332_cov_2.274678	187	227	76	2	40	0.0500000
NODE_129879_length_332_cov_2.274678	187	227	80	2	40	0.0500000
NODE_129879_length_332_cov_2.274678	187	227	82	1	40	0.0250000
NODE_129879_length_332_cov_2.274678	187	227	84	2	40	0.0500000
NODE_129879_length_332_cov_2.274678	187	227	86	1	40	0.0250000
NODE_129879_length_332_cov_2.274678	187	227	88	1	40	0.0250000
NODE_129879_length_332_cov_2.274678	187	227	90	2	40	0.0500000
NODE_129879_length_332_cov_2.274678	187	227	92	1	40	0.0250000
NODE_129879_length_332_cov_2.274678	187	227	96	2	40	0.0500000
NODE_129879_length_332_cov_2.274678	187	227	98	2	40	0.0500000
NODE_129879_length_332_cov_2.274678	187	227	100	2	40	0.0500000
NODE_129879_length_332_cov_2.274678	187	227	102	7	40	0.1750000
NODE_129901_length_332_cov_2.184549	194	258	2	6	64	0.0937500
NODE_129901_length_332_cov_2.184549	194	258	6	3	64	0.0468750
NODE_129901_length_332_cov_2.184549	194	258	8	55	64	0.8593750
NODE_130053_length_332_cov_1.682403	241	316	0	75	75	1.0000000
NODE_130055_length_332_cov_1.673820	157	220	4	37	63	0.5873016
NODE_130055_length_332_cov_1.673820	157	220	6	26	63	0.4126984
NODE_130183_length_332_cov_1.364807	132	212	0	23	80	0.2875000
NODE_130183_length_332_cov_1.364807	132	212	2	57	80	0.7125000
NODE_130187_length_332_cov_1.356223	276	332	0	1	56	0.0178571
NODE_130187_length_332_cov_1.356223	276	332	6	55	56	0.9821429
NODE_130312_length_332_cov_1.210300	120	176	0	28	56	0.5000000
NODE_130312_length_332_cov_1.210300	120	176	2	23	56	0.4107143
NODE_130312_length_332_cov_1.210300	120	176	4	5	56	0.0892857
NODE_130757_length_331_cov_5.254310	141	221	0	80	80	1.0000000
NODE_130757_length_331_cov_5.254310	194	274	0	80	80	1.0000000
NODE_130781_length_331_cov_4.323276	26	108	0	9	82	0.1097561
NODE_130781_length_331_cov_4.323276	26	108	2	6	82	0.0731707
NODE_130781_length_331_cov_4.323276	26	108	4	3	82	0.0365854
NODE_130781_length_331_cov_4.323276	26	108	6	15	82	0.1829268
NODE_130781_length_331_cov_4.323276	26	108	8	12	82	0.1463415
NODE_130781_length_331_cov_4.323276	26	108	12	5	82	0.0609756
NODE_130781_length_331_cov_4.323276	26	108	16	9	82	0.1097561
NODE_130781_length_331_cov_4.323276	26	108	18	2	82	0.0243902
NODE_130781_length_331_cov_4.323276	26	108	20	21	82	0.2560976
NODE_130902_length_331_cov_2.603448	128	181	0	53	53	1.0000000
NODE_131036_length_331_cov_1.965517	183	216	0	33	33	1.0000000
NODE_131054_length_331_cov_1.896552	266	331	0	11	65	0.1692308
NODE_131054_length_331_cov_1.896552	266	331	2	8	65	0.1230769
NODE_131054_length_331_cov_1.896552	266	331	4	42	65	0.6461539
NODE_131054_length_331_cov_1.896552	266	331	6	4	65	0.0615385
NODE_131817_length_330_cov_14.731602	209	280	0	2	71	0.0281690
NODE_131817_length_330_cov_14.731602	209	280	2	20	71	0.2816902
NODE_131817_length_330_cov_14.731602	209	280	4	49	71	0.6901408
NODE_131840_length_330_cov_4.935065	16	97	0	2	81	0.0246914
NODE_131840_length_330_cov_4.935065	16	97	2	79	81	0.9753087
NODE_131840_length_330_cov_4.935065	81	149	0	54	68	0.7941176
NODE_131840_length_330_cov_4.935065	81	149	2	14	68	0.2058824
NODE_131841_length_330_cov_4.891775	177	255	4	78	78	1.0000000
NODE_131845_length_330_cov_4.740260	134	209	0	29	75	0.3866667
NODE_131845_length_330_cov_4.740260	134	209	2	5	75	0.0666667
NODE_131845_length_330_cov_4.740260	134	209	4	41	75	0.5466667
NODE_131892_length_330_cov_3.467532	161	225	2	64	64	1.0000000
NODE_131969_length_330_cov_2.601732	8	88	0	80	80	1.0000000
NODE_132188_length_330_cov_1.623377	154	200	0	46	46	1.0000000
NODE_132238_length_330_cov_1.541126	98	156	0	58	58	1.0000000
NODE_132268_length_330_cov_1.467532	234	287	2	53	53	1.0000000
NODE_132268_length_330_cov_1.467532	242	283	2	41	41	1.0000000
NODE_132306_length_330_cov_1.346320	230	296	0	66	66	1.0000000
NODE_132306_length_330_cov_1.346320	230	257	0	27	27	1.0000000
NODE_132410_length_330_cov_1.220779	249	272	0	23	23	1.0000000
NODE_132478_length_330_cov_1.103896	189	227	2	18	38	0.4736842
NODE_132478_length_330_cov_1.103896	189	227	4	1	38	0.0263158
NODE_132478_length_330_cov_1.103896	189	227	5	1	38	0.0263158
NODE_132478_length_330_cov_1.103896	189	227	6	18	38	0.4736842
NODE_132542_length_330_cov_1.038961	219	297	26	11	78	0.1410256
NODE_132542_length_330_cov_1.038961	219	297	28	9	78	0.1153846
NODE_132542_length_330_cov_1.038961	219	297	36	1	78	0.0128205
NODE_132542_length_330_cov_1.038961	219	297	44	1	78	0.0128205
NODE_132542_length_330_cov_1.038961	219	297	45	3	78	0.0384615
NODE_132542_length_330_cov_1.038961	219	297	48	1	78	0.0128205
NODE_132542_length_330_cov_1.038961	219	297	49	1	78	0.0128205
NODE_132542_length_330_cov_1.038961	219	297	53	2	78	0.0256410
NODE_132542_length_330_cov_1.038961	219	297	54	1	78	0.0128205
NODE_132542_length_330_cov_1.038961	219	297	55	1	78	0.0128205
NODE_132542_length_330_cov_1.038961	219	297	57	1	78	0.0128205
NODE_132542_length_330_cov_1.038961	219	297	59	10	78	0.1282051
NODE_132542_length_330_cov_1.038961	219	297	60	1	78	0.0128205
NODE_132542_length_330_cov_1.038961	219	297	62	3	78	0.0384615
NODE_132542_length_330_cov_1.038961	219	297	68	2	78	0.0256410
NODE_132542_length_330_cov_1.038961	219	297	70	3	78	0.0384615
NODE_132542_length_330_cov_1.038961	219	297	72	2	78	0.0256410
NODE_132542_length_330_cov_1.038961	219	297	74	1	78	0.0128205
NODE_132542_length_330_cov_1.038961	219	297	78	4	78	0.0512821
NODE_132542_length_330_cov_1.038961	219	297	82	4	78	0.0512821
NODE_132542_length_330_cov_1.038961	219	297	85	3	78	0.0384615
NODE_132542_length_330_cov_1.038961	219	297	87	2	78	0.0256410
NODE_132542_length_330_cov_1.038961	219	297	92	3	78	0.0384615
NODE_132542_length_330_cov_1.038961	219	297	94	5	78	0.0641026
NODE_132542_length_330_cov_1.038961	219	297	96	2	78	0.0256410
NODE_132542_length_330_cov_1.038961	219	297	98	1	78	0.0128205
NODE_132688_length_330_cov_0.883117	284	330	0	46	46	1.0000000
NODE_132873_length_329_cov_110.178261	138	167	66	1	29	0.0344828
NODE_132873_length_329_cov_110.178261	138	167	67	5	29	0.1724138
NODE_132873_length_329_cov_110.178261	138	167	68	2	29	0.0689655
NODE_132873_length_329_cov_110.178261	138	167	69	14	29	0.4827586
NODE_132873_length_329_cov_110.178261	138	167	70	2	29	0.0689655
NODE_132873_length_329_cov_110.178261	138	167	72	5	29	0.1724138
NODE_132873_length_329_cov_110.178261	189	269	67	1	80	0.0125000
NODE_132873_length_329_cov_110.178261	189	269	73	3	80	0.0375000
NODE_132873_length_329_cov_110.178261	189	269	75	2	80	0.0250000
NODE_132873_length_329_cov_110.178261	189	269	79	2	80	0.0250000
NODE_132873_length_329_cov_110.178261	189	269	81	7	80	0.0875000
NODE_132873_length_329_cov_110.178261	189	269	83	3	80	0.0375000
NODE_132873_length_329_cov_110.178261	189	269	85	2	80	0.0250000
NODE_132873_length_329_cov_110.178261	189	269	87	28	80	0.3500000
NODE_132873_length_329_cov_110.178261	189	269	88	1	80	0.0125000
NODE_132873_length_329_cov_110.178261	189	269	90	2	80	0.0250000
NODE_132873_length_329_cov_110.178261	189	269	91	1	80	0.0125000
NODE_132873_length_329_cov_110.178261	189	269	92	1	80	0.0125000
NODE_132873_length_329_cov_110.178261	189	269	94	2	80	0.0250000
NODE_132873_length_329_cov_110.178261	189	269	97	3	80	0.0375000
NODE_132873_length_329_cov_110.178261	189	269	98	14	80	0.1750000
NODE_132873_length_329_cov_110.178261	189	269	101	1	80	0.0125000
NODE_132873_length_329_cov_110.178261	189	269	102	5	80	0.0625000
NODE_132873_length_329_cov_110.178261	189	269	103	2	80	0.0250000
NODE_132873_length_329_cov_110.178261	242	322	20	4	80	0.0500000
NODE_132873_length_329_cov_110.178261	242	322	24	4	80	0.0500000
NODE_132873_length_329_cov_110.178261	242	322	28	1	80	0.0125000
NODE_132873_length_329_cov_110.178261	242	322	30	1	80	0.0125000
NODE_132873_length_329_cov_110.178261	242	322	32	1	80	0.0125000
NODE_132873_length_329_cov_110.178261	242	322	33	2	80	0.0250000
NODE_132873_length_329_cov_110.178261	242	322	36	2	80	0.0250000
NODE_132873_length_329_cov_110.178261	242	322	38	4	80	0.0500000
NODE_132873_length_329_cov_110.178261	242	322	42	1	80	0.0125000
NODE_132873_length_329_cov_110.178261	242	322	44	11	80	0.1375000
NODE_132873_length_329_cov_110.178261	242	322	46	2	80	0.0250000
NODE_132873_length_329_cov_110.178261	242	322	50	2	80	0.0250000
NODE_132873_length_329_cov_110.178261	242	322	54	4	80	0.0500000
NODE_132873_length_329_cov_110.178261	242	322	56	1	80	0.0125000
NODE_132873_length_329_cov_110.178261	242	322	57	2	80	0.0250000
NODE_132873_length_329_cov_110.178261	242	322	60	1	80	0.0125000
NODE_132873_length_329_cov_110.178261	242	322	62	3	80	0.0375000
NODE_132873_length_329_cov_110.178261	242	322	64	3	80	0.0375000
NODE_132873_length_329_cov_110.178261	242	322	65	2	80	0.0250000
NODE_132873_length_329_cov_110.178261	242	322	67	3	80	0.0375000
NODE_132873_length_329_cov_110.178261	242	322	73	3	80	0.0375000
NODE_132873_length_329_cov_110.178261	242	322	75	2	80	0.0250000
NODE_132873_length_329_cov_110.178261	242	322	79	1	80	0.0125000
NODE_132873_length_329_cov_110.178261	242	322	81	3	80	0.0375000
NODE_132873_length_329_cov_110.178261	242	322	85	1	80	0.0125000
NODE_132873_length_329_cov_110.178261	242	322	87	16	80	0.2000000
NODE_132879_length_329_cov_8.882609	61	141	0	80	80	1.0000000
NODE_132879_length_329_cov_8.882609	114	194	0	80	80	1.0000000
NODE_132885_length_329_cov_6.586957	166	207	0	41	41	1.0000000
NODE_132908_length_329_cov_4.617391	175	229	2	54	54	1.0000000
NODE_132970_length_329_cov_3.160870	59	139	0	6	80	0.0750000
NODE_132970_length_329_cov_3.160870	59	139	2	74	80	0.9250000
NODE_133003_length_329_cov_2.821739	164	209	0	45	45	1.0000000
NODE_133003_length_329_cov_2.821739	184	262	0	62	78	0.7948718
NODE_133003_length_329_cov_2.821739	184	262	2	16	78	0.2051282
NODE_133033_length_329_cov_2.560870	139	201	0	17	62	0.2741936
NODE_133033_length_329_cov_2.560870	139	201	2	45	62	0.7258065
NODE_133036_length_329_cov_2.543478	145	206	8	13	61	0.2131148
NODE_133036_length_329_cov_2.543478	145	206	10	11	61	0.1803279
NODE_133036_length_329_cov_2.543478	145	206	11	1	61	0.0163934
NODE_133036_length_329_cov_2.543478	145	206	12	36	61	0.5901639
NODE_133123_length_329_cov_2.143478	39	119	10	8	80	0.1000000
NODE_133123_length_329_cov_2.143478	39	119	12	6	80	0.0750000
NODE_133123_length_329_cov_2.143478	39	119	14	3	80	0.0375000
NODE_133123_length_329_cov_2.143478	39	119	16	3	80	0.0375000
NODE_133123_length_329_cov_2.143478	39	119	18	4	80	0.0500000
NODE_133123_length_329_cov_2.143478	39	119	20	32	80	0.4000000
NODE_133123_length_329_cov_2.143478	39	119	22	24	80	0.3000000
NODE_133123_length_329_cov_2.143478	92	158	15	1	66	0.0151515
NODE_133123_length_329_cov_2.143478	92	158	17	9	66	0.1363636
NODE_133123_length_329_cov_2.143478	92	158	18	3	66	0.0454545
NODE_133123_length_329_cov_2.143478	92	158	19	11	66	0.1666667
NODE_133123_length_329_cov_2.143478	92	158	20	41	66	0.6212121
NODE_133123_length_329_cov_2.143478	92	158	22	1	66	0.0151515
NODE_133184_length_329_cov_1.865217	182	252	2	13	70	0.1857143
NODE_133184_length_329_cov_1.865217	182	252	4	20	70	0.2857143
NODE_133184_length_329_cov_1.865217	182	252	6	7	70	0.1000000
NODE_133184_length_329_cov_1.865217	182	252	8	30	70	0.4285714
NODE_133200_length_329_cov_1.791304	50	84	0	34	34	1.0000000
NODE_133200_length_329_cov_1.791304	92	149	0	57	57	1.0000000
NODE_133200_length_329_cov_1.791304	145	203	0	58	58	1.0000000
NODE_133332_length_329_cov_1.508696	261	323	0	62	62	1.0000000
NODE_133348_length_329_cov_1.469565	168	237	0	69	69	1.0000000
NODE_133376_length_329_cov_1.391304	275	307	49	2	32	0.0625000
NODE_133376_length_329_cov_1.391304	275	307	50	2	32	0.0625000
NODE_133376_length_329_cov_1.391304	275	307	52	2	32	0.0625000
NODE_133376_length_329_cov_1.391304	275	307	54	1	32	0.0312500
NODE_133376_length_329_cov_1.391304	275	307	55	25	32	0.7812500
NODE_133547_length_329_cov_1.165217	199	242	0	43	43	1.0000000
NODE_133768_length_329_cov_0.878261	221	296	0	75	75	1.0000000
NODE_133970_length_328_cov_4.484716	95	175	0	80	80	1.0000000
NODE_133989_length_328_cov_4.087336	79	159	2	80	80	1.0000000
NODE_133989_length_328_cov_4.087336	132	207	0	44	75	0.5866666
NODE_133989_length_328_cov_4.087336	132	207	2	31	75	0.4133333
NODE_133993_length_328_cov_3.895197	110	190	14	10	80	0.1250000
NODE_133993_length_328_cov_3.895197	110	190	16	70	80	0.8750000
NODE_134019_length_328_cov_3.393013	30	78	0	48	48	1.0000000
NODE_134144_length_328_cov_2.161572	103	134	24	4	31	0.1290323
NODE_134144_length_328_cov_2.161572	103	134	30	17	31	0.5483871
NODE_134144_length_328_cov_2.161572	103	134	32	10	31	0.3225806
NODE_134247_length_328_cov_1.781659	16	44	0	28	28	1.0000000
NODE_134335_length_328_cov_1.567686	0	76	0	1	76	0.0131579
NODE_134335_length_328_cov_1.567686	0	76	2	2	76	0.0263158
NODE_134335_length_328_cov_1.567686	0	76	4	9	76	0.1184211
NODE_134335_length_328_cov_1.567686	0	76	6	14	76	0.1842105
NODE_134335_length_328_cov_1.567686	0	76	8	1	76	0.0131579
NODE_134335_length_328_cov_1.567686	0	76	10	5	76	0.0657895
NODE_134335_length_328_cov_1.567686	0	76	14	1	76	0.0131579
NODE_134335_length_328_cov_1.567686	0	76	16	1	76	0.0131579
NODE_134335_length_328_cov_1.567686	0	76	18	6	76	0.0789474
NODE_134335_length_328_cov_1.567686	0	76	20	36	76	0.4736842
NODE_134335_length_328_cov_1.567686	49	94	20	44	45	0.9777778
NODE_134335_length_328_cov_1.567686	49	94	21	1	45	0.0222222
NODE_134452_length_328_cov_1.336245	0	73	0	73	73	1.0000000
NODE_134508_length_328_cov_1.266376	78	158	2	7	80	0.0875000
NODE_134508_length_328_cov_1.266376	78	158	4	67	80	0.8375000
NODE_134508_length_328_cov_1.266376	78	158	6	6	80	0.0750000
NODE_135002_length_327_cov_4.934211	170	250	0	80	80	1.0000000
NODE_135009_length_327_cov_4.701754	225	305	0	13	80	0.1625000
NODE_135009_length_327_cov_4.701754	225	305	2	67	80	0.8375000
NODE_135018_length_327_cov_4.241228	97	173	10	6	76	0.0789474
NODE_135018_length_327_cov_4.241228	97	173	16	2	76	0.0263158
NODE_135018_length_327_cov_4.241228	97	173	20	68	76	0.8947368
NODE_135037_length_327_cov_3.719298	70	150	0	80	80	1.0000000
NODE_135063_length_327_cov_3.350877	156	227	0	12	71	0.1690141
NODE_135063_length_327_cov_3.350877	156	227	2	59	71	0.8309859
NODE_135328_length_327_cov_1.780702	191	271	10	6	80	0.0750000
NODE_135328_length_327_cov_1.780702	191	271	14	2	80	0.0250000
NODE_135328_length_327_cov_1.780702	191	271	18	1	80	0.0125000
NODE_135328_length_327_cov_1.780702	191	271	20	1	80	0.0125000
NODE_135328_length_327_cov_1.780702	191	271	24	3	80	0.0375000
NODE_135328_length_327_cov_1.780702	191	271	30	1	80	0.0125000
NODE_135328_length_327_cov_1.780702	191	271	34	2	80	0.0250000
NODE_135328_length_327_cov_1.780702	191	271	36	1	80	0.0125000
NODE_135328_length_327_cov_1.780702	191	271	38	1	80	0.0125000
NODE_135328_length_327_cov_1.780702	191	271	40	1	80	0.0125000
NODE_135328_length_327_cov_1.780702	191	271	42	60	80	0.7500000
NODE_135328_length_327_cov_1.780702	191	271	43	1	80	0.0125000
NODE_136081_length_326_cov_3.964758	178	228	0	50	50	1.0000000
NODE_136100_length_326_cov_3.502203	211	253	0	6	42	0.1428571
NODE_136100_length_326_cov_3.502203	211	253	2	36	42	0.8571429
NODE_136100_length_326_cov_3.502203	220	255	0	8	35	0.2285714
NODE_136100_length_326_cov_3.502203	220	255	2	27	35	0.7714286
NODE_136116_length_326_cov_3.202643	149	203	0	4	54	0.0740741
NODE_136116_length_326_cov_3.202643	149	203	7	1	54	0.0185185
NODE_136116_length_326_cov_3.202643	149	203	8	5	54	0.0925926
NODE_136116_length_326_cov_3.202643	149	203	10	1	54	0.0185185
NODE_136116_length_326_cov_3.202643	149	203	11	3	54	0.0555556
NODE_136116_length_326_cov_3.202643	149	203	12	7	54	0.1296296
NODE_136116_length_326_cov_3.202643	149	203	14	7	54	0.1296296
NODE_136116_length_326_cov_3.202643	149	203	15	3	54	0.0555556
NODE_136116_length_326_cov_3.202643	149	203	16	23	54	0.4259259
NODE_136130_length_326_cov_3.057269	107	126	0	19	19	1.0000000
NODE_136176_length_326_cov_2.594714	125	196	0	65	71	0.9154930
NODE_136176_length_326_cov_2.594714	125	196	1	6	71	0.0845070
NODE_136283_length_326_cov_2.123348	184	244	0	46	60	0.7666667
NODE_136283_length_326_cov_2.123348	184	244	2	14	60	0.2333333
NODE_136496_length_326_cov_1.515419	86	166	8	80	80	1.0000000
NODE_137182_length_325_cov_4.893805	142	222	46	1	80	0.0125000
NODE_137182_length_325_cov_4.893805	142	222	50	8	80	0.1000000
NODE_137182_length_325_cov_4.893805	142	222	52	10	80	0.1250000
NODE_137182_length_325_cov_4.893805	142	222	53	10	80	0.1250000
NODE_137182_length_325_cov_4.893805	142	222	54	36	80	0.4500000
NODE_137182_length_325_cov_4.893805	142	222	56	1	80	0.0125000
NODE_137182_length_325_cov_4.893805	142	222	61	13	80	0.1625000
NODE_137182_length_325_cov_4.893805	142	222	62	1	80	0.0125000
NODE_137182_length_325_cov_4.893805	195	275	14	3	80	0.0375000
NODE_137182_length_325_cov_4.893805	195	275	16	1	80	0.0125000
NODE_137182_length_325_cov_4.893805	195	275	21	4	80	0.0500000
NODE_137182_length_325_cov_4.893805	195	275	22	4	80	0.0500000
NODE_137182_length_325_cov_4.893805	195	275	23	14	80	0.1750000
NODE_137182_length_325_cov_4.893805	195	275	24	3	80	0.0375000
NODE_137182_length_325_cov_4.893805	195	275	27	4	80	0.0500000
NODE_137182_length_325_cov_4.893805	195	275	31	1	80	0.0125000
NODE_137182_length_325_cov_4.893805	195	275	33	2	80	0.0250000
NODE_137182_length_325_cov_4.893805	195	275	35	2	80	0.0250000
NODE_137182_length_325_cov_4.893805	195	275	36	3	80	0.0375000
NODE_137182_length_325_cov_4.893805	195	275	37	1	80	0.0125000
NODE_137182_length_325_cov_4.893805	195	275	39	3	80	0.0375000
NODE_137182_length_325_cov_4.893805	195	275	40	4	80	0.0500000
NODE_137182_length_325_cov_4.893805	195	275	42	4	80	0.0500000
NODE_137182_length_325_cov_4.893805	195	275	46	1	80	0.0125000
NODE_137182_length_325_cov_4.893805	195	275	50	8	80	0.1000000
NODE_137182_length_325_cov_4.893805	195	275	52	5	80	0.0625000
NODE_137182_length_325_cov_4.893805	195	275	54	13	80	0.1625000
NODE_137199_length_325_cov_4.000000	134	198	0	64	64	1.0000000
NODE_137221_length_325_cov_3.513274	191	266	0	16	75	0.2133333
NODE_137221_length_325_cov_3.513274	191	266	4	3	75	0.0400000
NODE_137221_length_325_cov_3.513274	191	266	6	12	75	0.1600000
NODE_137221_length_325_cov_3.513274	191	266	8	10	75	0.1333333
NODE_137221_length_325_cov_3.513274	191	266	10	19	75	0.2533333
NODE_137221_length_325_cov_3.513274	191	266	12	15	75	0.2000000
NODE_137221_length_325_cov_3.513274	240	319	8	6	79	0.0759494
NODE_137221_length_325_cov_3.513274	240	319	10	24	79	0.3037975
NODE_137221_length_325_cov_3.513274	240	319	12	49	79	0.6202531
NODE_137223_length_325_cov_3.469027	216	278	0	62	62	1.0000000
NODE_137224_length_325_cov_3.429204	178	224	0	46	46	1.0000000
NODE_137243_length_325_cov_3.168142	188	274	0	86	86	1.0000000
NODE_137268_length_325_cov_2.880531	72	152	0	9	80	0.1125000
NODE_137268_length_325_cov_2.880531	72	152	2	9	80	0.1125000
NODE_137268_length_325_cov_2.880531	72	152	4	27	80	0.3375000
NODE_137268_length_325_cov_2.880531	72	152	5	8	80	0.1000000
NODE_137268_length_325_cov_2.880531	72	152	6	27	80	0.3375000
NODE_137268_length_325_cov_2.880531	125	205	2	19	80	0.2375000
NODE_137268_length_325_cov_2.880531	125	205	4	6	80	0.0750000
NODE_137268_length_325_cov_2.880531	125	205	6	55	80	0.6875000
NODE_137291_length_325_cov_2.707965	203	261	0	58	58	1.0000000
NODE_137296_length_325_cov_2.703540	68	148	0	7	80	0.0875000
NODE_137296_length_325_cov_2.703540	68	148	2	73	80	0.9125000
NODE_137330_length_325_cov_2.500000	0	42	0	19	42	0.4523810
NODE_137330_length_325_cov_2.500000	0	42	1	23	42	0.5476190
NODE_137407_length_325_cov_2.048673	122	202	27	5	80	0.0625000
NODE_137407_length_325_cov_2.048673	122	202	28	3	80	0.0375000
NODE_137407_length_325_cov_2.048673	122	202	30	5	80	0.0625000
NODE_137407_length_325_cov_2.048673	122	202	32	32	80	0.4000000
NODE_137407_length_325_cov_2.048673	122	202	34	10	80	0.1250000
NODE_137407_length_325_cov_2.048673	122	202	36	25	80	0.3125000
NODE_137409_length_325_cov_2.035398	83	154	0	71	71	1.0000000
NODE_137642_length_325_cov_1.464602	153	224	0	71	71	1.0000000
NODE_137939_length_325_cov_1.017699	103	134	4	31	31	1.0000000
NODE_138113_length_325_cov_0.827434	258	308	2	50	50	1.0000000
NODE_138309_length_324_cov_4.737778	113	160	0	47	47	1.0000000
NODE_138309_length_324_cov_4.737778	142	213	0	71	71	1.0000000
NODE_138358_length_324_cov_3.626667	218	273	2	55	55	1.0000000
NODE_138396_length_324_cov_3.124444	101	181	0	43	80	0.5375000
NODE_138396_length_324_cov_3.124444	101	181	2	37	80	0.4625000
NODE_138396_length_324_cov_3.124444	256	285	2	6	29	0.2068966
NODE_138396_length_324_cov_3.124444	256	285	4	23	29	0.7931035
NODE_138416_length_324_cov_2.924444	114	198	6	32	84	0.3809524
NODE_138416_length_324_cov_2.924444	114	198	7	8	84	0.0952381
NODE_138416_length_324_cov_2.924444	114	198	9	16	84	0.1904762
NODE_138416_length_324_cov_2.924444	114	198	10	24	84	0.2857143
NODE_138416_length_324_cov_2.924444	114	198	12	4	84	0.0476190
NODE_138416_length_324_cov_2.924444	178	237	4	31	59	0.5254237
NODE_138416_length_324_cov_2.924444	178	237	6	28	59	0.4745763
NODE_138418_length_324_cov_2.915556	141	221	4	15	80	0.1875000
NODE_138418_length_324_cov_2.915556	141	221	8	65	80	0.8125000
NODE_138434_length_324_cov_2.715556	4	51	0	47	47	1.0000000
NODE_138434_length_324_cov_2.715556	24	104	0	32	80	0.4000000
NODE_138434_length_324_cov_2.715556	24	104	2	48	80	0.6000000
NODE_138463_length_324_cov_2.506667	270	306	0	36	36	1.0000000
NODE_138483_length_324_cov_2.448889	187	238	0	22	51	0.4313726
NODE_138483_length_324_cov_2.448889	187	238	2	29	51	0.5686275
NODE_138527_length_324_cov_2.248889	30	96	2	66	66	1.0000000
NODE_138778_length_324_cov_1.502222	10	90	0	5	80	0.0625000
NODE_138778_length_324_cov_1.502222	10	90	2	12	80	0.1500000
NODE_138778_length_324_cov_1.502222	10	90	6	55	80	0.6875000
NODE_138778_length_324_cov_1.502222	10	90	8	8	80	0.1000000
NODE_138792_length_324_cov_1.457778	0	45	0	45	45	1.0000000
NODE_138792_length_324_cov_1.457778	18	75	0	30	57	0.5263158
NODE_138792_length_324_cov_1.457778	18	75	2	19	57	0.3333333
NODE_138792_length_324_cov_1.457778	18	75	8	1	57	0.0175439
NODE_138792_length_324_cov_1.457778	18	75	18	1	57	0.0175439
NODE_138792_length_324_cov_1.457778	18	75	22	2	57	0.0350877
NODE_138792_length_324_cov_1.457778	18	75	24	4	57	0.0701754
NODE_138808_length_324_cov_1.382222	263	304	0	41	41	1.0000000
NODE_139129_length_324_cov_1.017778	0	59	0	59	59	1.0000000
NODE_139497_length_323_cov_6.669643	215	286	0	71	71	1.0000000
NODE_139497_length_323_cov_6.669643	268	315	0	47	47	1.0000000
NODE_139511_length_323_cov_5.089286	224	290	0	12	66	0.1818182
NODE_139511_length_323_cov_5.089286	224	290	2	54	66	0.8181818
NODE_139511_length_323_cov_5.089286	263	319	0	1	56	0.0178571
NODE_139511_length_323_cov_5.089286	263	319	2	55	56	0.9821429
NODE_139572_length_323_cov_3.276786	189	269	1	1	80	0.0125000
NODE_139572_length_323_cov_3.276786	189	269	4	10	80	0.1250000
NODE_139572_length_323_cov_3.276786	189	269	5	17	80	0.2125000
NODE_139572_length_323_cov_3.276786	189	269	6	5	80	0.0625000
NODE_139572_length_323_cov_3.276786	189	269	18	12	80	0.1500000
NODE_139572_length_323_cov_3.276786	189	269	20	2	80	0.0250000
NODE_139572_length_323_cov_3.276786	189	269	22	3	80	0.0375000
NODE_139572_length_323_cov_3.276786	189	269	24	11	80	0.1375000
NODE_139572_length_323_cov_3.276786	189	269	25	16	80	0.2000000
NODE_139572_length_323_cov_3.276786	189	269	26	2	80	0.0250000
NODE_139572_length_323_cov_3.276786	189	269	27	1	80	0.0125000
NODE_139575_length_323_cov_3.263393	101	181	10	11	80	0.1375000
NODE_139575_length_323_cov_3.263393	101	181	12	43	80	0.5375000
NODE_139575_length_323_cov_3.263393	101	181	14	26	80	0.3250000
NODE_139591_length_323_cov_3.089286	128	208	0	36	80	0.4500000
NODE_139591_length_323_cov_3.089286	128	208	1	14	80	0.1750000
NODE_139591_length_323_cov_3.089286	128	208	2	30	80	0.3750000
NODE_139591_length_323_cov_3.089286	166	208	0	14	42	0.3333333
NODE_139591_length_323_cov_3.089286	166	208	2	28	42	0.6666667
NODE_139591_length_323_cov_3.089286	181	261	2	80	80	1.0000000
NODE_139591_length_323_cov_3.089286	181	261	2	80	80	1.0000000
NODE_139629_length_323_cov_2.683036	144	215	8	5	71	0.0704225
NODE_139629_length_323_cov_2.683036	144	215	10	66	71	0.9295775
NODE_139746_length_323_cov_2.089286	64	144	2	8	80	0.1000000
NODE_139746_length_323_cov_2.089286	64	144	3	27	80	0.3375000
NODE_139746_length_323_cov_2.089286	64	144	4	45	80	0.5625000
NODE_139797_length_323_cov_1.888393	148	207	1	4	59	0.0677966
NODE_139797_length_323_cov_1.888393	148	207	3	23	59	0.3898305
NODE_139797_length_323_cov_1.888393	148	207	4	32	59	0.5423729
NODE_139901_length_323_cov_1.705357	195	262	0	38	67	0.5671642
NODE_139901_length_323_cov_1.705357	195	262	2	29	67	0.4328358
NODE_139901_length_323_cov_1.705357	235	315	0	10	80	0.1250000
NODE_139901_length_323_cov_1.705357	235	315	2	70	80	0.8750000
NODE_140651_length_322_cov_5.475336	56	136	0	80	80	1.0000000
NODE_140651_length_322_cov_5.475336	113	189	0	46	76	0.6052632
NODE_140651_length_322_cov_5.475336	113	189	2	7	76	0.0921053
NODE_140651_length_322_cov_5.475336	113	189	4	23	76	0.3026316
NODE_140692_length_322_cov_3.753363	63	133	0	70	70	1.0000000
NODE_140692_length_322_cov_3.753363	116	190	0	74	74	1.0000000
NODE_140693_length_322_cov_3.735426	60	86	0	26	26	1.0000000
NODE_140693_length_322_cov_3.735426	99	139	0	40	40	1.0000000
NODE_140701_length_322_cov_3.605381	73	116	18	1	43	0.0232558
NODE_140701_length_322_cov_3.605381	73	116	20	4	43	0.0930233
NODE_140701_length_322_cov_3.605381	73	116	23	1	43	0.0232558
NODE_140701_length_322_cov_3.605381	73	116	25	1	43	0.0232558
NODE_140701_length_322_cov_3.605381	73	116	27	3	43	0.0697674
NODE_140701_length_322_cov_3.605381	73	116	32	33	43	0.7674419
NODE_140702_length_322_cov_3.600897	75	145	2	24	70	0.3428572
NODE_140702_length_322_cov_3.600897	75	145	4	46	70	0.6571429
NODE_140820_length_322_cov_2.304933	182	213	2	15	31	0.4838710
NODE_140820_length_322_cov_2.304933	182	213	6	16	31	0.5161290
NODE_141738_length_321_cov_8.527027	176	240	7	1	64	0.0156250
NODE_141738_length_321_cov_8.527027	176	240	8	36	64	0.5625000
NODE_141738_length_321_cov_8.527027	176	240	10	27	64	0.4218750
NODE_141786_length_321_cov_4.094595	196	266	0	70	70	1.0000000
NODE_141811_length_321_cov_3.563063	59	131	0	16	72	0.2222222
NODE_141811_length_321_cov_3.563063	59	131	2	20	72	0.2777778
NODE_141811_length_321_cov_3.563063	59	131	4	12	72	0.1666667
NODE_141811_length_321_cov_3.563063	59	131	6	24	72	0.3333333
NODE_141811_length_321_cov_3.563063	112	183	0	27	71	0.3802817
NODE_141811_length_321_cov_3.563063	112	183	2	11	71	0.1549296
NODE_141811_length_321_cov_3.563063	112	183	4	33	71	0.4647887
NODE_141813_length_321_cov_3.540541	112	141	6	29	29	1.0000000
NODE_141833_length_321_cov_3.049550	65	115	41	11	50	0.2200000
NODE_141833_length_321_cov_3.049550	65	115	43	3	50	0.0600000
NODE_141833_length_321_cov_3.049550	65	115	45	1	50	0.0200000
NODE_141833_length_321_cov_3.049550	65	115	51	5	50	0.1000000
NODE_141833_length_321_cov_3.049550	65	115	53	1	50	0.0200000
NODE_141833_length_321_cov_3.049550	65	115	55	5	50	0.1000000
NODE_141833_length_321_cov_3.049550	65	115	57	24	50	0.4800000
NODE_141833_length_321_cov_3.049550	95	138	49	3	43	0.0697674
NODE_141833_length_321_cov_3.049550	95	138	53	16	43	0.3720930
NODE_141833_length_321_cov_3.049550	95	138	55	8	43	0.1860465
NODE_141833_length_321_cov_3.049550	95	138	57	16	43	0.3720930
NODE_141833_length_321_cov_3.049550	118	168	9	3	50	0.0600000
NODE_141833_length_321_cov_3.049550	118	168	13	2	50	0.0400000
NODE_141833_length_321_cov_3.049550	118	168	15	1	50	0.0200000
NODE_141833_length_321_cov_3.049550	118	168	21	1	50	0.0200000
NODE_141833_length_321_cov_3.049550	118	168	23	1	50	0.0200000
NODE_141833_length_321_cov_3.049550	118	168	27	1	50	0.0200000
NODE_141833_length_321_cov_3.049550	118	168	33	2	50	0.0400000
NODE_141833_length_321_cov_3.049550	118	168	35	2	50	0.0400000
NODE_141833_length_321_cov_3.049550	118	168	37	1	50	0.0200000
NODE_141833_length_321_cov_3.049550	118	168	38	1	50	0.0200000
NODE_141833_length_321_cov_3.049550	118	168	40	1	50	0.0200000
NODE_141833_length_321_cov_3.049550	118	168	43	6	50	0.1200000
NODE_141833_length_321_cov_3.049550	118	168	45	1	50	0.0200000
NODE_141833_length_321_cov_3.049550	118	168	47	3	50	0.0600000
NODE_141833_length_321_cov_3.049550	118	168	49	7	50	0.1400000
NODE_141833_length_321_cov_3.049550	118	168	53	16	50	0.3200000
NODE_141833_length_321_cov_3.049550	118	168	55	1	50	0.0200000
NODE_141837_length_321_cov_2.995495	146	220	0	74	74	1.0000000
NODE_141842_length_321_cov_2.981982	251	304	0	53	53	1.0000000
NODE_141876_length_321_cov_2.734234	239	306	6	67	67	1.0000000
NODE_141910_length_321_cov_2.427928	221	265	0	44	44	1.0000000
NODE_141922_length_321_cov_2.315315	22	65	2	43	43	1.0000000
NODE_141951_length_321_cov_2.270270	43	105	2	13	62	0.2096774
NODE_141951_length_321_cov_2.270270	43	105	4	39	62	0.6290323
NODE_141951_length_321_cov_2.270270	43	105	6	3	62	0.0483871
NODE_141951_length_321_cov_2.270270	43	105	8	7	62	0.1129032
NODE_141951_length_321_cov_2.270270	120	203	6	76	83	0.9156626
NODE_141951_length_321_cov_2.270270	120	203	7	5	83	0.0602410
NODE_141951_length_321_cov_2.270270	120	203	8	2	83	0.0240964
NODE_141951_length_321_cov_2.270270	127	208	4	4	81	0.0493827
NODE_141951_length_321_cov_2.270270	127	208	6	74	81	0.9135802
NODE_141951_length_321_cov_2.270270	127	208	7	3	81	0.0370370
NODE_142200_length_321_cov_1.576577	241	321	0	80	80	1.0000000
NODE_142363_length_321_cov_1.319820	253	304	0	51	51	1.0000000
NODE_142484_length_321_cov_1.130631	0	43	0	43	43	1.0000000
NODE_142700_length_321_cov_0.869369	248	294	0	17	46	0.3695652
NODE_142700_length_321_cov_0.869369	248	294	5	1	46	0.0217391
NODE_142700_length_321_cov_0.869369	248	294	6	28	46	0.6086956
NODE_142885_length_320_cov_200.484163	264	320	11	1	56	0.0178571
NODE_142885_length_320_cov_200.484163	264	320	14	3	56	0.0535714
NODE_142885_length_320_cov_200.484163	264	320	19	1	56	0.0178571
NODE_142885_length_320_cov_200.484163	264	320	26	1	56	0.0178571
NODE_142885_length_320_cov_200.484163	264	320	28	2	56	0.0357143
NODE_142885_length_320_cov_200.484163	264	320	29	1	56	0.0178571
NODE_142885_length_320_cov_200.484163	264	320	31	2	56	0.0357143
NODE_142885_length_320_cov_200.484163	264	320	33	1	56	0.0178571
NODE_142885_length_320_cov_200.484163	264	320	35	1	56	0.0178571
NODE_142885_length_320_cov_200.484163	264	320	37	1	56	0.0178571
NODE_142885_length_320_cov_200.484163	264	320	39	3	56	0.0535714
NODE_142885_length_320_cov_200.484163	264	320	47	1	56	0.0178571
NODE_142885_length_320_cov_200.484163	264	320	49	1	56	0.0178571
NODE_142885_length_320_cov_200.484163	264	320	50	3	56	0.0535714
NODE_142885_length_320_cov_200.484163	264	320	54	1	56	0.0178571
NODE_142885_length_320_cov_200.484163	264	320	60	2	56	0.0357143
NODE_142885_length_320_cov_200.484163	264	320	64	16	56	0.2857143
NODE_142885_length_320_cov_200.484163	264	320	66	7	56	0.1250000
NODE_142885_length_320_cov_200.484163	264	320	70	1	56	0.0178571
NODE_142885_length_320_cov_200.484163	264	320	74	7	56	0.1250000
NODE_142886_length_320_cov_73.357466	51	97	0	46	46	1.0000000
NODE_142886_length_320_cov_73.357466	108	154	0	46	46	1.0000000
NODE_142886_length_320_cov_73.357466	165	245	0	6	80	0.0750000
NODE_142886_length_320_cov_73.357466	165	245	17	34	80	0.4250000
NODE_142886_length_320_cov_73.357466	165	245	18	5	80	0.0625000
NODE_142886_length_320_cov_73.357466	165	245	20	35	80	0.4375000
NODE_142886_length_320_cov_73.357466	218	296	18	29	78	0.3717949
NODE_142886_length_320_cov_73.357466	218	296	20	49	78	0.6282051
NODE_142887_length_320_cov_35.787330	212	292	8	2	80	0.0250000
NODE_142887_length_320_cov_35.787330	212	292	24	4	80	0.0500000
NODE_142887_length_320_cov_35.787330	212	292	26	4	80	0.0500000
NODE_142887_length_320_cov_35.787330	212	292	27	1	80	0.0125000
NODE_142887_length_320_cov_35.787330	212	292	28	10	80	0.1250000
NODE_142887_length_320_cov_35.787330	212	292	30	59	80	0.7375000
NODE_142887_length_320_cov_35.787330	212	292	8	2	80	0.0250000
NODE_142887_length_320_cov_35.787330	212	292	24	4	80	0.0500000
NODE_142887_length_320_cov_35.787330	212	292	26	4	80	0.0500000
NODE_142887_length_320_cov_35.787330	212	292	27	1	80	0.0125000
NODE_142887_length_320_cov_35.787330	212	292	28	10	80	0.1250000
NODE_142887_length_320_cov_35.787330	212	292	30	59	80	0.7375000
NODE_142887_length_320_cov_35.787330	212	292	8	2	80	0.0250000
NODE_142887_length_320_cov_35.787330	212	292	24	4	80	0.0500000
NODE_142887_length_320_cov_35.787330	212	292	26	4	80	0.0500000
NODE_142887_length_320_cov_35.787330	212	292	27	1	80	0.0125000
NODE_142887_length_320_cov_35.787330	212	292	28	10	80	0.1250000
NODE_142887_length_320_cov_35.787330	212	292	30	59	80	0.7375000
NODE_142887_length_320_cov_35.787330	212	292	8	2	80	0.0250000
NODE_142887_length_320_cov_35.787330	212	292	24	4	80	0.0500000
NODE_142887_length_320_cov_35.787330	212	292	26	4	80	0.0500000
NODE_142887_length_320_cov_35.787330	212	292	27	1	80	0.0125000
NODE_142887_length_320_cov_35.787330	212	292	28	10	80	0.1250000
NODE_142887_length_320_cov_35.787330	212	292	30	59	80	0.7375000
NODE_142887_length_320_cov_35.787330	212	292	8	2	80	0.0250000
NODE_142887_length_320_cov_35.787330	212	292	24	4	80	0.0500000
NODE_142887_length_320_cov_35.787330	212	292	26	4	80	0.0500000
NODE_142887_length_320_cov_35.787330	212	292	27	1	80	0.0125000
NODE_142887_length_320_cov_35.787330	212	292	28	10	80	0.1250000
NODE_142887_length_320_cov_35.787330	212	292	30	59	80	0.7375000
NODE_142887_length_320_cov_35.787330	265	314	15	1	49	0.0204082
NODE_142887_length_320_cov_35.787330	265	314	16	7	49	0.1428571
NODE_142887_length_320_cov_35.787330	265	314	20	4	49	0.0816327
NODE_142887_length_320_cov_35.787330	265	314	22	10	49	0.2040816
NODE_142887_length_320_cov_35.787330	265	314	24	4	49	0.0816327
NODE_142887_length_320_cov_35.787330	265	314	26	4	49	0.0816327
NODE_142887_length_320_cov_35.787330	265	314	28	9	49	0.1836735
NODE_142887_length_320_cov_35.787330	265	314	30	10	49	0.2040816
NODE_142887_length_320_cov_35.787330	265	320	0	6	55	0.1090909
NODE_142887_length_320_cov_35.787330	265	320	15	1	55	0.0181818
NODE_142887_length_320_cov_35.787330	265	320	16	7	55	0.1272727
NODE_142887_length_320_cov_35.787330	265	320	20	4	55	0.0727273
NODE_142887_length_320_cov_35.787330	265	320	22	10	55	0.1818182
NODE_142887_length_320_cov_35.787330	265	320	24	4	55	0.0727273
NODE_142887_length_320_cov_35.787330	265	320	26	4	55	0.0727273
NODE_142887_length_320_cov_35.787330	265	320	28	9	55	0.1636364
NODE_142887_length_320_cov_35.787330	265	320	30	10	55	0.1818182
NODE_142887_length_320_cov_35.787330	265	320	0	6	55	0.1090909
NODE_142887_length_320_cov_35.787330	265	320	15	1	55	0.0181818
NODE_142887_length_320_cov_35.787330	265	320	16	7	55	0.1272727
NODE_142887_length_320_cov_35.787330	265	320	20	4	55	0.0727273
NODE_142887_length_320_cov_35.787330	265	320	22	10	55	0.1818182
NODE_142887_length_320_cov_35.787330	265	320	24	4	55	0.0727273
NODE_142887_length_320_cov_35.787330	265	320	26	4	55	0.0727273
NODE_142887_length_320_cov_35.787330	265	320	28	9	55	0.1636364
NODE_142887_length_320_cov_35.787330	265	320	30	10	55	0.1818182
NODE_142887_length_320_cov_35.787330	268	320	0	6	52	0.1153846
NODE_142887_length_320_cov_35.787330	268	320	15	1	52	0.0192308
NODE_142887_length_320_cov_35.787330	268	320	16	7	52	0.1346154
NODE_142887_length_320_cov_35.787330	268	320	20	4	52	0.0769231
NODE_142887_length_320_cov_35.787330	268	320	22	10	52	0.1923077
NODE_142887_length_320_cov_35.787330	268	320	24	4	52	0.0769231
NODE_142887_length_320_cov_35.787330	268	320	26	4	52	0.0769231
NODE_142887_length_320_cov_35.787330	268	320	28	9	52	0.1730769
NODE_142887_length_320_cov_35.787330	268	320	30	7	52	0.1346154
NODE_142887_length_320_cov_35.787330	270	320	0	6	50	0.1200000
NODE_142887_length_320_cov_35.787330	270	320	15	1	50	0.0200000
NODE_142887_length_320_cov_35.787330	270	320	16	7	50	0.1400000
NODE_142887_length_320_cov_35.787330	270	320	20	4	50	0.0800000
NODE_142887_length_320_cov_35.787330	270	320	22	10	50	0.2000000
NODE_142887_length_320_cov_35.787330	270	320	24	4	50	0.0800000
NODE_142887_length_320_cov_35.787330	270	320	26	4	50	0.0800000
NODE_142887_length_320_cov_35.787330	270	320	28	9	50	0.1800000
NODE_142887_length_320_cov_35.787330	270	320	30	5	50	0.1000000
NODE_142900_length_320_cov_5.841629	115	172	1	57	57	1.0000000
NODE_142900_length_320_cov_5.841629	168	225	0	1	57	0.0175439
NODE_142900_length_320_cov_5.841629	168	225	1	56	57	0.9824561
NODE_142934_length_320_cov_4.153846	134	200	0	66	66	1.0000000
NODE_142958_length_320_cov_3.733032	5	40	2	35	35	1.0000000
NODE_142985_length_320_cov_3.402715	142	222	0	10	80	0.1250000
NODE_142985_length_320_cov_3.402715	142	222	2	1	80	0.0125000
NODE_142985_length_320_cov_3.402715	142	222	4	1	80	0.0125000
NODE_142985_length_320_cov_3.402715	142	222	6	1	80	0.0125000
NODE_142985_length_320_cov_3.402715	142	222	8	2	80	0.0250000
NODE_142985_length_320_cov_3.402715	142	222	10	1	80	0.0125000
NODE_142985_length_320_cov_3.402715	142	222	12	2	80	0.0250000
NODE_142985_length_320_cov_3.402715	142	222	14	62	80	0.7750000
NODE_143076_length_320_cov_2.475113	120	187	4	13	67	0.1940299
NODE_143076_length_320_cov_2.475113	120	187	5	3	67	0.0447761
NODE_143076_length_320_cov_2.475113	120	187	6	1	67	0.0149254
NODE_143076_length_320_cov_2.475113	120	187	7	8	67	0.1194030
NODE_143076_length_320_cov_2.475113	120	187	11	5	67	0.0746269
NODE_143076_length_320_cov_2.475113	120	187	13	1	67	0.0149254
NODE_143076_length_320_cov_2.475113	120	187	14	5	67	0.0746269
NODE_143076_length_320_cov_2.475113	120	187	15	8	67	0.1194030
NODE_143076_length_320_cov_2.475113	120	187	17	2	67	0.0298507
NODE_143076_length_320_cov_2.475113	120	187	21	5	67	0.0746269
NODE_143076_length_320_cov_2.475113	120	187	23	6	67	0.0895522
NODE_143076_length_320_cov_2.475113	120	187	25	1	67	0.0149254
NODE_143076_length_320_cov_2.475113	120	187	29	1	67	0.0149254
NODE_143076_length_320_cov_2.475113	120	187	37	2	67	0.0298507
NODE_143076_length_320_cov_2.475113	120	187	38	6	67	0.0895522
NODE_143142_length_320_cov_2.171946	16	96	2	1	80	0.0125000
NODE_143142_length_320_cov_2.171946	16	96	3	1	80	0.0125000
NODE_143142_length_320_cov_2.171946	16	96	4	3	80	0.0375000
NODE_143142_length_320_cov_2.171946	16	96	5	2	80	0.0250000
NODE_143142_length_320_cov_2.171946	16	96	7	1	80	0.0125000
NODE_143142_length_320_cov_2.171946	16	96	11	11	80	0.1375000
NODE_143142_length_320_cov_2.171946	16	96	12	7	80	0.0875000
NODE_143142_length_320_cov_2.171946	16	96	16	8	80	0.1000000
NODE_143142_length_320_cov_2.171946	16	96	20	8	80	0.1000000
NODE_143142_length_320_cov_2.171946	16	96	21	33	80	0.4125000
NODE_143142_length_320_cov_2.171946	16	96	22	2	80	0.0250000
NODE_143142_length_320_cov_2.171946	16	96	24	3	80	0.0375000
NODE_143142_length_320_cov_2.171946	69	149	21	22	80	0.2750000
NODE_143142_length_320_cov_2.171946	69	149	22	29	80	0.3625000
NODE_143142_length_320_cov_2.171946	69	149	24	25	80	0.3125000
NODE_143142_length_320_cov_2.171946	69	149	25	1	80	0.0125000
NODE_143142_length_320_cov_2.171946	69	149	26	3	80	0.0375000
NODE_143207_length_320_cov_1.900452	37	117	25	1	80	0.0125000
NODE_143207_length_320_cov_1.900452	37	117	27	2	80	0.0250000
NODE_143207_length_320_cov_1.900452	37	117	29	14	80	0.1750000
NODE_143207_length_320_cov_1.900452	37	117	32	14	80	0.1750000
NODE_143207_length_320_cov_1.900452	37	117	33	5	80	0.0625000
NODE_143207_length_320_cov_1.900452	37	117	34	44	80	0.5500000
NODE_143207_length_320_cov_1.900452	90	164	3	29	74	0.3918919
NODE_143207_length_320_cov_1.900452	90	164	21	11	74	0.1486486
NODE_143207_length_320_cov_1.900452	90	164	22	2	74	0.0270270
NODE_143207_length_320_cov_1.900452	90	164	32	3	74	0.0405405
NODE_143207_length_320_cov_1.900452	90	164	34	29	74	0.3918919
NODE_143230_length_320_cov_1.846154	188	220	0	32	32	1.0000000
NODE_143309_length_320_cov_1.665158	144	198	0	54	54	1.0000000
NODE_143309_length_320_cov_1.665158	198	251	0	46	53	0.8679245
NODE_143309_length_320_cov_1.665158	198	251	2	7	53	0.1320755
NODE_143351_length_320_cov_1.601810	157	181	4	24	24	1.0000000
NODE_143351_length_320_cov_1.601810	231	290	2	1	59	0.0169492
NODE_143351_length_320_cov_1.601810	231	290	4	4	59	0.0677966
NODE_143351_length_320_cov_1.601810	231	290	5	1	59	0.0169492
NODE_143351_length_320_cov_1.601810	231	290	6	23	59	0.3898305
NODE_143351_length_320_cov_1.601810	231	290	8	30	59	0.5084746
NODE_143366_length_320_cov_1.556561	0	39	0	10	39	0.2564103
NODE_143366_length_320_cov_1.556561	0	39	2	2	39	0.0512821
NODE_143366_length_320_cov_1.556561	0	39	4	5	39	0.1282051
NODE_143366_length_320_cov_1.556561	0	39	6	9	39	0.2307692
NODE_143366_length_320_cov_1.556561	0	39	8	1	39	0.0256410
NODE_143366_length_320_cov_1.556561	0	39	14	2	39	0.0512821
NODE_143366_length_320_cov_1.556561	0	39	18	2	39	0.0512821
NODE_143366_length_320_cov_1.556561	0	39	20	4	39	0.1025641
NODE_143366_length_320_cov_1.556561	0	39	22	4	39	0.1025641
NODE_143442_length_320_cov_1.384615	18	98	2	6	80	0.0750000
NODE_143442_length_320_cov_1.384615	18	98	3	1	80	0.0125000
NODE_143442_length_320_cov_1.384615	18	98	5	8	80	0.1000000
NODE_143442_length_320_cov_1.384615	18	98	6	17	80	0.2125000
NODE_143442_length_320_cov_1.384615	18	98	7	15	80	0.1875000
NODE_143442_length_320_cov_1.384615	18	98	8	2	80	0.0250000
NODE_143442_length_320_cov_1.384615	18	98	10	22	80	0.2750000
NODE_143442_length_320_cov_1.384615	18	98	12	9	80	0.1125000
NODE_143442_length_320_cov_1.384615	71	145	10	18	74	0.2432432
NODE_143442_length_320_cov_1.384615	71	145	12	22	74	0.2972973
NODE_143442_length_320_cov_1.384615	71	145	14	25	74	0.3378378
NODE_143442_length_320_cov_1.384615	71	145	16	9	74	0.1216216
NODE_143521_length_320_cov_1.312217	117	170	0	46	53	0.8679245
NODE_143521_length_320_cov_1.312217	117	170	1	7	53	0.1320755
NODE_143670_length_320_cov_1.117647	58	109	4	51	51	1.0000000
NODE_144091_length_319_cov_5.940909	122	202	0	62	80	0.7750000
NODE_144091_length_319_cov_5.940909	122	202	2	18	80	0.2250000
NODE_144107_length_319_cov_4.700000	16	47	0	31	31	1.0000000
NODE_144137_length_319_cov_4.068182	5	36	0	31	31	1.0000000
NODE_144162_length_319_cov_3.568182	149	229	2	37	80	0.4625000
NODE_144162_length_319_cov_3.568182	149	229	4	43	80	0.5375000
NODE_144206_length_319_cov_3.036364	112	174	4	62	62	1.0000000
NODE_144226_length_319_cov_2.800000	25	106	0	4	81	0.0493827
NODE_144226_length_319_cov_2.800000	25	106	3	1	81	0.0123457
NODE_144226_length_319_cov_2.800000	25	106	8	1	81	0.0123457
NODE_144226_length_319_cov_2.800000	25	106	19	1	81	0.0123457
NODE_144226_length_319_cov_2.800000	25	106	33	1	81	0.0123457
NODE_144226_length_319_cov_2.800000	25	106	35	1	81	0.0123457
NODE_144226_length_319_cov_2.800000	25	106	41	2	81	0.0246914
NODE_144226_length_319_cov_2.800000	25	106	42	1	81	0.0123457
NODE_144226_length_319_cov_2.800000	25	106	43	1	81	0.0123457
NODE_144226_length_319_cov_2.800000	25	106	47	1	81	0.0123457
NODE_144226_length_319_cov_2.800000	25	106	51	1	81	0.0123457
NODE_144226_length_319_cov_2.800000	25	106	62	2	81	0.0246914
NODE_144226_length_319_cov_2.800000	25	106	71	2	81	0.0246914
NODE_144226_length_319_cov_2.800000	25	106	91	1	81	0.0123457
NODE_144226_length_319_cov_2.800000	25	106	102	1	81	0.0123457
NODE_144226_length_319_cov_2.800000	25	106	114	1	81	0.0123457
NODE_144226_length_319_cov_2.800000	25	106	115	1	81	0.0123457
NODE_144226_length_319_cov_2.800000	25	106	118	2	81	0.0246914
NODE_144226_length_319_cov_2.800000	25	106	133	1	81	0.0123457
NODE_144226_length_319_cov_2.800000	25	106	144	1	81	0.0123457
NODE_144226_length_319_cov_2.800000	25	106	147	1	81	0.0123457
NODE_144226_length_319_cov_2.800000	25	106	151	1	81	0.0123457
NODE_144226_length_319_cov_2.800000	25	106	158	1	81	0.0123457
NODE_144226_length_319_cov_2.800000	25	106	160	1	81	0.0123457
NODE_144226_length_319_cov_2.800000	25	106	162	1	81	0.0123457
NODE_144226_length_319_cov_2.800000	25	106	165	1	81	0.0123457
NODE_144226_length_319_cov_2.800000	25	106	167	3	81	0.0370370
NODE_144226_length_319_cov_2.800000	25	106	172	1	81	0.0123457
NODE_144226_length_319_cov_2.800000	25	106	174	1	81	0.0123457
NODE_144226_length_319_cov_2.800000	25	106	178	1	81	0.0123457
NODE_144226_length_319_cov_2.800000	25	106	181	1	81	0.0123457
NODE_144226_length_319_cov_2.800000	25	106	188	1	81	0.0123457
NODE_144226_length_319_cov_2.800000	25	106	193	1	81	0.0123457
NODE_144226_length_319_cov_2.800000	25	106	203	1	81	0.0123457
NODE_144226_length_319_cov_2.800000	25	106	219	1	81	0.0123457
NODE_144226_length_319_cov_2.800000	25	106	224	3	81	0.0370370
NODE_144226_length_319_cov_2.800000	25	106	234	1	81	0.0123457
NODE_144226_length_319_cov_2.800000	25	106	239	1	81	0.0123457
NODE_144226_length_319_cov_2.800000	25	106	245	2	81	0.0246914
NODE_144226_length_319_cov_2.800000	25	106	261	2	81	0.0246914
NODE_144226_length_319_cov_2.800000	25	106	263	1	81	0.0123457
NODE_144226_length_319_cov_2.800000	25	106	269	1	81	0.0123457
NODE_144226_length_319_cov_2.800000	25	106	276	1	81	0.0123457
NODE_144226_length_319_cov_2.800000	25	106	281	1	81	0.0123457
NODE_144226_length_319_cov_2.800000	25	106	284	1	81	0.0123457
NODE_144226_length_319_cov_2.800000	25	106	287	2	81	0.0246914
NODE_144226_length_319_cov_2.800000	25	106	297	1	81	0.0123457
NODE_144226_length_319_cov_2.800000	25	106	300	1	81	0.0123457
NODE_144226_length_319_cov_2.800000	25	106	302	1	81	0.0123457
NODE_144226_length_319_cov_2.800000	25	106	307	1	81	0.0123457
NODE_144226_length_319_cov_2.800000	25	106	314	1	81	0.0123457
NODE_144226_length_319_cov_2.800000	25	106	318	1	81	0.0123457
NODE_144226_length_319_cov_2.800000	25	106	322	1	81	0.0123457
NODE_144226_length_319_cov_2.800000	25	106	324	4	81	0.0493827
NODE_144226_length_319_cov_2.800000	25	106	327	1	81	0.0123457
NODE_144226_length_319_cov_2.800000	25	106	329	1	81	0.0123457
NODE_144226_length_319_cov_2.800000	25	106	331	5	81	0.0617284
NODE_144226_length_319_cov_2.800000	25	106	334	3	81	0.0370370
NODE_144226_length_319_cov_2.800000	79	158	269	1	79	0.0126582
NODE_144226_length_319_cov_2.800000	79	158	276	1	79	0.0126582
NODE_144226_length_319_cov_2.800000	79	158	281	1	79	0.0126582
NODE_144226_length_319_cov_2.800000	79	158	284	1	79	0.0126582
NODE_144226_length_319_cov_2.800000	79	158	287	2	79	0.0253165
NODE_144226_length_319_cov_2.800000	79	158	297	1	79	0.0126582
NODE_144226_length_319_cov_2.800000	79	158	300	1	79	0.0126582
NODE_144226_length_319_cov_2.800000	79	158	302	1	79	0.0126582
NODE_144226_length_319_cov_2.800000	79	158	304	7	79	0.0886076
NODE_144226_length_319_cov_2.800000	79	158	307	1	79	0.0126582
NODE_144226_length_319_cov_2.800000	79	158	309	4	79	0.0506329
NODE_144226_length_319_cov_2.800000	79	158	312	1	79	0.0126582
NODE_144226_length_319_cov_2.800000	79	158	314	1	79	0.0126582
NODE_144226_length_319_cov_2.800000	79	158	315	1	79	0.0126582
NODE_144226_length_319_cov_2.800000	79	158	318	1	79	0.0126582
NODE_144226_length_319_cov_2.800000	79	158	321	2	79	0.0253165
NODE_144226_length_319_cov_2.800000	79	158	322	2	79	0.0253165
NODE_144226_length_319_cov_2.800000	79	158	324	6	79	0.0759494
NODE_144226_length_319_cov_2.800000	79	158	325	3	79	0.0379747
NODE_144226_length_319_cov_2.800000	79	158	327	1	79	0.0126582
NODE_144226_length_319_cov_2.800000	79	158	329	1	79	0.0126582
NODE_144226_length_319_cov_2.800000	79	158	331	11	79	0.1392405
NODE_144226_length_319_cov_2.800000	79	158	332	3	79	0.0379747
NODE_144226_length_319_cov_2.800000	79	158	334	12	79	0.1518987
NODE_144226_length_319_cov_2.800000	79	158	336	3	79	0.0379747
NODE_144226_length_319_cov_2.800000	79	158	337	1	79	0.0126582
NODE_144226_length_319_cov_2.800000	79	158	338	9	79	0.1139240
NODE_144237_length_319_cov_2.740909	67	147	23	2	80	0.0250000
NODE_144237_length_319_cov_2.740909	67	147	24	8	80	0.1000000
NODE_144237_length_319_cov_2.740909	67	147	34	17	80	0.2125000
NODE_144237_length_319_cov_2.740909	67	147	36	2	80	0.0250000
NODE_144237_length_319_cov_2.740909	67	147	37	3	80	0.0375000
NODE_144237_length_319_cov_2.740909	67	147	38	27	80	0.3375000
NODE_144237_length_319_cov_2.740909	67	147	39	12	80	0.1500000
NODE_144237_length_319_cov_2.740909	67	147	40	2	80	0.0250000
NODE_144237_length_319_cov_2.740909	67	147	41	7	80	0.0875000
NODE_144252_length_319_cov_2.586364	247	319	0	72	72	1.0000000
NODE_144272_length_319_cov_2.463636	90	153	0	63	63	1.0000000
NODE_144272_length_319_cov_2.463636	163	216	0	53	53	1.0000000
NODE_144316_length_319_cov_2.259091	146	212	0	62	66	0.9393939
NODE_144316_length_319_cov_2.259091	146	212	2	4	66	0.0606061
NODE_144340_length_319_cov_2.163636	213	275	0	62	62	1.0000000
NODE_144390_length_319_cov_1.968182	120	200	0	80	80	1.0000000
NODE_144616_length_319_cov_1.431818	111	157	0	46	46	1.0000000
NODE_144629_length_319_cov_1.395455	129	179	0	50	50	1.0000000
NODE_144788_length_319_cov_1.190909	119	182	4	8	63	0.1269841
NODE_144788_length_319_cov_1.190909	119	182	6	36	63	0.5714286
NODE_144788_length_319_cov_1.190909	119	182	8	19	63	0.3015873
NODE_144788_length_319_cov_1.190909	197	232	0	29	35	0.8285714
NODE_144788_length_319_cov_1.190909	197	232	2	6	35	0.1714286
NODE_145289_length_318_cov_232.639269	169	198	489	2	29	0.0689655
NODE_145289_length_318_cov_232.639269	169	198	492	1	29	0.0344828
NODE_145289_length_318_cov_232.639269	169	198	495	1	29	0.0344828
NODE_145289_length_318_cov_232.639269	169	198	499	1	29	0.0344828
NODE_145289_length_318_cov_232.639269	169	198	502	1	29	0.0344828
NODE_145289_length_318_cov_232.639269	169	198	509	1	29	0.0344828
NODE_145289_length_318_cov_232.639269	169	198	512	1	29	0.0344828
NODE_145289_length_318_cov_232.639269	169	198	514	1	29	0.0344828
NODE_145289_length_318_cov_232.639269	169	198	518	1	29	0.0344828
NODE_145289_length_318_cov_232.639269	169	198	520	3	29	0.1034483
NODE_145289_length_318_cov_232.639269	169	198	521	2	29	0.0689655
NODE_145289_length_318_cov_232.639269	169	198	522	1	29	0.0344828
NODE_145289_length_318_cov_232.639269	169	198	523	1	29	0.0344828
NODE_145289_length_318_cov_232.639269	169	198	527	1	29	0.0344828
NODE_145289_length_318_cov_232.639269	169	198	529	1	29	0.0344828
NODE_145289_length_318_cov_232.639269	169	198	534	1	29	0.0344828
NODE_145289_length_318_cov_232.639269	169	198	536	1	29	0.0344828
NODE_145289_length_318_cov_232.639269	169	198	537	2	29	0.0689655
NODE_145289_length_318_cov_232.639269	169	198	538	2	29	0.0689655
NODE_145289_length_318_cov_232.639269	169	198	540	2	29	0.0689655
NODE_145289_length_318_cov_232.639269	169	198	544	1	29	0.0344828
NODE_145289_length_318_cov_232.639269	169	198	546	1	29	0.0344828
NODE_145289_length_318_cov_232.639269	171	246	402	1	75	0.0133333
NODE_145289_length_318_cov_232.639269	171	246	405	1	75	0.0133333
NODE_145289_length_318_cov_232.639269	171	246	411	1	75	0.0133333
NODE_145289_length_318_cov_232.639269	171	246	412	2	75	0.0266667
NODE_145289_length_318_cov_232.639269	171	246	417	2	75	0.0266667
NODE_145289_length_318_cov_232.639269	171	246	426	1	75	0.0133333
NODE_145289_length_318_cov_232.639269	171	246	428	1	75	0.0133333
NODE_145289_length_318_cov_232.639269	171	246	436	1	75	0.0133333
NODE_145289_length_318_cov_232.639269	171	246	438	2	75	0.0266667
NODE_145289_length_318_cov_232.639269	171	246	444	1	75	0.0133333
NODE_145289_length_318_cov_232.639269	171	246	451	1	75	0.0133333
NODE_145289_length_318_cov_232.639269	171	246	467	1	75	0.0133333
NODE_145289_length_318_cov_232.639269	171	246	470	1	75	0.0133333
NODE_145289_length_318_cov_232.639269	171	246	474	1	75	0.0133333
NODE_145289_length_318_cov_232.639269	171	246	487	1	75	0.0133333
NODE_145289_length_318_cov_232.639269	171	246	489	2	75	0.0266667
NODE_145289_length_318_cov_232.639269	171	246	493	1	75	0.0133333
NODE_145289_length_318_cov_232.639269	171	246	495	1	75	0.0133333
NODE_145289_length_318_cov_232.639269	171	246	497	1	75	0.0133333
NODE_145289_length_318_cov_232.639269	171	246	499	1	75	0.0133333
NODE_145289_length_318_cov_232.639269	171	246	502	2	75	0.0266667
NODE_145289_length_318_cov_232.639269	171	246	505	1	75	0.0133333
NODE_145289_length_318_cov_232.639269	171	246	509	1	75	0.0133333
NODE_145289_length_318_cov_232.639269	171	246	512	1	75	0.0133333
NODE_145289_length_318_cov_232.639269	171	246	514	1	75	0.0133333
NODE_145289_length_318_cov_232.639269	171	246	516	1	75	0.0133333
NODE_145289_length_318_cov_232.639269	171	246	518	1	75	0.0133333
NODE_145289_length_318_cov_232.639269	171	246	519	5	75	0.0666667
NODE_145289_length_318_cov_232.639269	171	246	520	3	75	0.0400000
NODE_145289_length_318_cov_232.639269	171	246	521	2	75	0.0266667
NODE_145289_length_318_cov_232.639269	171	246	522	1	75	0.0133333
NODE_145289_length_318_cov_232.639269	171	246	523	1	75	0.0133333
NODE_145289_length_318_cov_232.639269	171	246	527	3	75	0.0400000
NODE_145289_length_318_cov_232.639269	171	246	529	2	75	0.0266667
NODE_145289_length_318_cov_232.639269	171	246	532	3	75	0.0400000
NODE_145289_length_318_cov_232.639269	171	246	534	1	75	0.0133333
NODE_145289_length_318_cov_232.639269	171	246	535	2	75	0.0266667
NODE_145289_length_318_cov_232.639269	171	246	536	2	75	0.0266667
NODE_145289_length_318_cov_232.639269	171	246	537	5	75	0.0666667
NODE_145289_length_318_cov_232.639269	171	246	538	6	75	0.0800000
NODE_145289_length_318_cov_232.639269	171	246	539	1	75	0.0133333
NODE_145289_length_318_cov_232.639269	171	246	540	4	75	0.0533333
NODE_145289_length_318_cov_232.639269	171	246	544	1	75	0.0133333
NODE_145289_length_318_cov_232.639269	171	246	546	1	75	0.0133333
NODE_145333_length_318_cov_4.237443	222	294	18	10	72	0.1388889
NODE_145333_length_318_cov_4.237443	222	294	22	7	72	0.0972222
NODE_145333_length_318_cov_4.237443	222	294	24	55	72	0.7638889
NODE_145348_length_318_cov_3.721461	98	148	2	50	50	1.0000000
NODE_145362_length_318_cov_3.515982	60	129	0	69	69	1.0000000
NODE_145362_length_318_cov_3.515982	60	140	0	80	80	1.0000000
NODE_145362_length_318_cov_3.515982	60	140	0	80	80	1.0000000
NODE_145362_length_318_cov_3.515982	113	153	0	40	40	1.0000000
NODE_145362_length_318_cov_3.515982	122	153	0	31	31	1.0000000
NODE_145465_length_318_cov_2.557078	205	247	0	42	42	1.0000000
NODE_145551_length_318_cov_2.109589	70	150	0	38	80	0.4750000
NODE_145551_length_318_cov_2.109589	70	150	2	27	80	0.3375000
NODE_145551_length_318_cov_2.109589	70	150	3	3	80	0.0375000
NODE_145551_length_318_cov_2.109589	70	150	4	1	80	0.0125000
NODE_145551_length_318_cov_2.109589	70	150	7	1	80	0.0125000
NODE_145551_length_318_cov_2.109589	70	150	9	4	80	0.0500000
NODE_145551_length_318_cov_2.109589	70	150	10	2	80	0.0250000
NODE_145551_length_318_cov_2.109589	70	150	12	4	80	0.0500000
NODE_145619_length_318_cov_1.945205	229	286	0	57	57	1.0000000
NODE_145709_length_318_cov_1.739726	242	308	0	21	66	0.3181818
NODE_145709_length_318_cov_1.739726	242	308	2	45	66	0.6818182
NODE_145725_length_318_cov_1.684932	49	80	0	31	31	1.0000000
NODE_145787_length_318_cov_1.561644	99	158	7	5	59	0.0847458
NODE_145787_length_318_cov_1.561644	99	158	9	2	59	0.0338983
NODE_145787_length_318_cov_1.561644	99	158	11	13	59	0.2203390
NODE_145787_length_318_cov_1.561644	99	158	12	3	59	0.0508475
NODE_145787_length_318_cov_1.561644	99	158	14	5	59	0.0847458
NODE_145787_length_318_cov_1.561644	99	158	16	31	59	0.5254237
NODE_145807_length_318_cov_1.493151	151	195	2	44	44	1.0000000
NODE_145807_length_318_cov_1.493151	199	258	2	59	59	1.0000000
NODE_145968_length_318_cov_1.301370	91	141	2	50	50	1.0000000
NODE_146017_length_318_cov_1.173516	83	150	8	1	67	0.0149254
NODE_146017_length_318_cov_1.173516	83	150	9	23	67	0.3432836
NODE_146017_length_318_cov_1.173516	83	150	10	5	67	0.0746269
NODE_146017_length_318_cov_1.173516	83	150	11	21	67	0.3134328
NODE_146017_length_318_cov_1.173516	83	150	15	17	67	0.2537313
NODE_146065_length_318_cov_1.127854	24	51	0	27	27	1.0000000
NODE_146065_length_318_cov_1.127854	24	60	0	36	36	1.0000000
NODE_146467_length_317_cov_55.467890	172	243	67	3	71	0.0422535
NODE_146467_length_317_cov_55.467890	172	243	75	2	71	0.0281690
NODE_146467_length_317_cov_55.467890	172	243	77	1	71	0.0140845
NODE_146467_length_317_cov_55.467890	172	243	81	3	71	0.0422535
NODE_146467_length_317_cov_55.467890	172	243	85	4	71	0.0563380
NODE_146467_length_317_cov_55.467890	172	243	88	1	71	0.0140845
NODE_146467_length_317_cov_55.467890	172	243	89	1	71	0.0140845
NODE_146467_length_317_cov_55.467890	172	243	91	2	71	0.0281690
NODE_146467_length_317_cov_55.467890	172	243	93	4	71	0.0563380
NODE_146467_length_317_cov_55.467890	172	243	95	1	71	0.0140845
NODE_146467_length_317_cov_55.467890	172	243	99	1	71	0.0140845
NODE_146467_length_317_cov_55.467890	172	243	107	2	71	0.0281690
NODE_146467_length_317_cov_55.467890	172	243	109	1	71	0.0140845
NODE_146467_length_317_cov_55.467890	172	243	111	1	71	0.0140845
NODE_146467_length_317_cov_55.467890	172	243	114	2	71	0.0281690
NODE_146467_length_317_cov_55.467890	172	243	116	1	71	0.0140845
NODE_146467_length_317_cov_55.467890	172	243	122	1	71	0.0140845
NODE_146467_length_317_cov_55.467890	172	243	127	2	71	0.0281690
NODE_146467_length_317_cov_55.467890	172	243	132	6	71	0.0845070
NODE_146467_length_317_cov_55.467890	172	243	133	1	71	0.0140845
NODE_146467_length_317_cov_55.467890	172	243	135	1	71	0.0140845
NODE_146467_length_317_cov_55.467890	172	243	136	2	71	0.0281690
NODE_146467_length_317_cov_55.467890	172	243	137	1	71	0.0140845
NODE_146467_length_317_cov_55.467890	172	243	138	1	71	0.0140845
NODE_146467_length_317_cov_55.467890	172	243	139	1	71	0.0140845
NODE_146467_length_317_cov_55.467890	172	243	140	7	71	0.0985916
NODE_146467_length_317_cov_55.467890	172	243	141	4	71	0.0563380
NODE_146467_length_317_cov_55.467890	172	243	142	4	71	0.0563380
NODE_146467_length_317_cov_55.467890	172	243	143	10	71	0.1408451
NODE_146487_length_317_cov_5.252294	247	307	0	60	60	1.0000000
NODE_146503_length_317_cov_4.467890	105	185	0	73	80	0.9125000
NODE_146503_length_317_cov_4.467890	105	185	2	7	80	0.0875000
NODE_146503_length_317_cov_4.467890	113	193	0	65	80	0.8125000
NODE_146503_length_317_cov_4.467890	113	193	2	15	80	0.1875000
NODE_146554_length_317_cov_3.298165	146	206	0	1	60	0.0166667
NODE_146554_length_317_cov_3.298165	146	206	2	1	60	0.0166667
NODE_146554_length_317_cov_3.298165	146	206	4	1	60	0.0166667
NODE_146554_length_317_cov_3.298165	146	206	6	57	60	0.9500000
NODE_146562_length_317_cov_3.266055	111	191	6	2	80	0.0250000
NODE_146562_length_317_cov_3.266055	111	191	8	12	80	0.1500000
NODE_146562_length_317_cov_3.266055	111	191	10	6	80	0.0750000
NODE_146562_length_317_cov_3.266055	111	191	12	16	80	0.2000000
NODE_146562_length_317_cov_3.266055	111	191	14	6	80	0.0750000
NODE_146562_length_317_cov_3.266055	111	191	15	18	80	0.2250000
NODE_146562_length_317_cov_3.266055	111	191	16	20	80	0.2500000
NODE_146562_length_317_cov_3.266055	164	244	2	12	80	0.1500000
NODE_146562_length_317_cov_3.266055	164	244	4	6	80	0.0750000
NODE_146562_length_317_cov_3.266055	164	244	6	31	80	0.3875000
NODE_146562_length_317_cov_3.266055	164	244	8	18	80	0.2250000
NODE_146562_length_317_cov_3.266055	164	244	10	6	80	0.0750000
NODE_146562_length_317_cov_3.266055	164	244	12	7	80	0.0875000
NODE_146585_length_317_cov_3.036697	3	79	0	76	76	1.0000000
NODE_146601_length_317_cov_2.825688	14	94	0	55	80	0.6875000
NODE_146601_length_317_cov_2.825688	14	94	2	10	80	0.1250000
NODE_146601_length_317_cov_2.825688	14	94	4	15	80	0.1875000
NODE_146601_length_317_cov_2.825688	67	147	0	2	80	0.0250000
NODE_146601_length_317_cov_2.825688	67	147	2	10	80	0.1250000
NODE_146601_length_317_cov_2.825688	67	147	4	68	80	0.8500000
NODE_146602_length_317_cov_2.821101	142	208	4	17	66	0.2575758
NODE_146602_length_317_cov_2.821101	142	208	6	22	66	0.3333333
NODE_146602_length_317_cov_2.821101	142	208	7	15	66	0.2272727
NODE_146602_length_317_cov_2.821101	142	208	8	12	66	0.1818182
NODE_146604_length_317_cov_2.816514	121	201	0	35	80	0.4375000
NODE_146604_length_317_cov_2.816514	121	201	2	45	80	0.5625000
NODE_146612_length_317_cov_2.779817	67	138	2	5	71	0.0704225
NODE_146612_length_317_cov_2.779817	67	138	4	11	71	0.1549296
NODE_146612_length_317_cov_2.779817	67	138	10	55	71	0.7746479
NODE_147046_length_317_cov_1.353211	166	239	2	1	73	0.0136986
NODE_147046_length_317_cov_1.353211	166	239	4	1	73	0.0136986
NODE_147046_length_317_cov_1.353211	166	239	6	71	73	0.9726027
NODE_147046_length_317_cov_1.353211	212	292	0	18	80	0.2250000
NODE_147046_length_317_cov_1.353211	212	292	2	2	80	0.0250000
NODE_147046_length_317_cov_1.353211	212	292	4	13	80	0.1625000
NODE_147046_length_317_cov_1.353211	212	292	6	47	80	0.5875000
NODE_147172_length_317_cov_1.160550	58	117	2	27	59	0.4576271
NODE_147172_length_317_cov_1.160550	58	117	4	7	59	0.1186441
NODE_147172_length_317_cov_1.160550	58	117	6	10	59	0.1694915
NODE_147172_length_317_cov_1.160550	58	117	7	6	59	0.1016949
NODE_147172_length_317_cov_1.160550	58	117	8	9	59	0.1525424
NODE_147172_length_317_cov_1.160550	90	170	4	2	80	0.0250000
NODE_147172_length_317_cov_1.160550	90	170	6	10	80	0.1250000
NODE_147172_length_317_cov_1.160550	90	170	7	6	80	0.0750000
NODE_147172_length_317_cov_1.160550	90	170	8	27	80	0.3375000
NODE_147172_length_317_cov_1.160550	90	170	10	5	80	0.0625000
NODE_147172_length_317_cov_1.160550	90	170	12	11	80	0.1375000
NODE_147172_length_317_cov_1.160550	90	170	13	2	80	0.0250000
NODE_147172_length_317_cov_1.160550	90	170	14	7	80	0.0875000
NODE_147172_length_317_cov_1.160550	90	170	16	10	80	0.1250000
NODE_147187_length_317_cov_1.137615	245	313	0	68	68	1.0000000
NODE_147259_length_317_cov_0.967890	170	211	0	2	41	0.0487805
NODE_147259_length_317_cov_0.967890	170	211	2	39	41	0.9512195
NODE_147373_length_317_cov_0.926606	194	232	0	38	38	1.0000000
NODE_147383_length_317_cov_0.912844	186	244	0	58	58	1.0000000
NODE_147595_length_316_cov_31.502304	96	174	0	8	78	0.1025641
NODE_147595_length_316_cov_31.502304	96	174	4	1	78	0.0128205
NODE_147595_length_316_cov_31.502304	96	174	6	9	78	0.1153846
NODE_147595_length_316_cov_31.502304	96	174	8	2	78	0.0256410
NODE_147595_length_316_cov_31.502304	96	174	11	1	78	0.0128205
NODE_147595_length_316_cov_31.502304	96	174	12	4	78	0.0512821
NODE_147595_length_316_cov_31.502304	96	174	13	1	78	0.0128205
NODE_147595_length_316_cov_31.502304	96	174	17	1	78	0.0128205
NODE_147595_length_316_cov_31.502304	96	174	18	5	78	0.0641026
NODE_147595_length_316_cov_31.502304	96	174	21	9	78	0.1153846
NODE_147595_length_316_cov_31.502304	96	174	23	1	78	0.0128205
NODE_147595_length_316_cov_31.502304	96	174	29	10	78	0.1282051
NODE_147595_length_316_cov_31.502304	96	174	30	1	78	0.0128205
NODE_147595_length_316_cov_31.502304	96	174	34	14	78	0.1794872
NODE_147595_length_316_cov_31.502304	96	174	36	1	78	0.0128205
NODE_147595_length_316_cov_31.502304	96	174	38	1	78	0.0128205
NODE_147595_length_316_cov_31.502304	96	174	40	4	78	0.0512821
NODE_147595_length_316_cov_31.502304	96	174	42	1	78	0.0128205
NODE_147595_length_316_cov_31.502304	96	174	44	2	78	0.0256410
NODE_147595_length_316_cov_31.502304	96	174	54	2	78	0.0256410
NODE_147595_length_316_cov_31.502304	96	121	0	8	25	0.3200000
NODE_147595_length_316_cov_31.502304	96	121	4	1	25	0.0400000
NODE_147595_length_316_cov_31.502304	96	121	6	9	25	0.3600000
NODE_147595_length_316_cov_31.502304	96	121	8	2	25	0.0800000
NODE_147595_length_316_cov_31.502304	96	121	11	1	25	0.0400000
NODE_147595_length_316_cov_31.502304	96	121	12	4	25	0.1600000
NODE_147609_length_316_cov_6.179724	225	278	0	53	53	1.0000000
NODE_147623_length_316_cov_5.539171	91	171	2	9	80	0.1125000
NODE_147623_length_316_cov_5.539171	91	171	4	71	80	0.8875000
NODE_147668_length_316_cov_3.732719	128	208	0	80	80	1.0000000
NODE_147668_length_316_cov_3.732719	181	257	0	37	76	0.4868421
NODE_147668_length_316_cov_3.732719	181	257	2	39	76	0.5131579
NODE_147680_length_316_cov_3.589862	185	247	0	32	62	0.5161290
NODE_147680_length_316_cov_3.589862	185	247	2	1	62	0.0161290
NODE_147680_length_316_cov_3.589862	185	247	3	3	62	0.0483871
NODE_147680_length_316_cov_3.589862	185	247	6	26	62	0.4193548
NODE_147684_length_316_cov_3.520737	101	143	8	42	42	1.0000000
NODE_147702_length_316_cov_3.221198	108	184	0	7	76	0.0921053
NODE_147702_length_316_cov_3.221198	108	184	2	2	76	0.0263158
NODE_147702_length_316_cov_3.221198	108	184	4	44	76	0.5789474
NODE_147702_length_316_cov_3.221198	108	184	6	23	76	0.3026316
NODE_147734_length_316_cov_2.824885	274	311	0	15	37	0.4054054
NODE_147734_length_316_cov_2.824885	274	311	1	22	37	0.5945946
NODE_147736_length_316_cov_2.820276	200	280	0	45	80	0.5625000
NODE_147736_length_316_cov_2.820276	200	280	2	35	80	0.4375000
NODE_147757_length_316_cov_2.672811	23	80	0	57	57	1.0000000
NODE_147796_length_316_cov_2.456221	104	144	0	40	40	1.0000000
NODE_147985_length_316_cov_1.751152	73	122	2	33	49	0.6734694
NODE_147985_length_316_cov_1.751152	73	122	4	16	49	0.3265306
NODE_148030_length_316_cov_1.640553	218	300	0	82	82	1.0000000
NODE_148042_length_316_cov_1.631336	180	233	0	53	53	1.0000000
NODE_148042_length_316_cov_1.631336	180	215	0	35	35	1.0000000
NODE_148080_length_316_cov_1.520737	194	275	0	81	81	1.0000000
NODE_148080_length_316_cov_1.520737	248	302	0	54	54	1.0000000
NODE_148086_length_316_cov_1.493088	64	144	6	62	80	0.7750000
NODE_148086_length_316_cov_1.493088	64	144	8	18	80	0.2250000
NODE_148193_length_316_cov_1.377880	22	64	5	12	42	0.2857143
NODE_148193_length_316_cov_1.377880	22	64	6	30	42	0.7142857
NODE_148204_length_316_cov_1.350230	74	117	2	43	43	1.0000000
NODE_148204_length_316_cov_1.350230	90	140	2	50	50	1.0000000
NODE_148533_length_316_cov_0.940092	104	180	0	19	76	0.2500000
NODE_148533_length_316_cov_0.940092	104	180	2	57	76	0.7500000
NODE_148533_length_316_cov_0.940092	155	234	0	42	79	0.5316456
NODE_148533_length_316_cov_0.940092	155	234	2	37	79	0.4683544
NODE_148693_length_316_cov_0.695853	232	267	2	35	35	1.0000000
NODE_148778_length_315_cov_6.967593	127	191	2	18	64	0.2812500
NODE_148778_length_315_cov_6.967593	127	191	4	46	64	0.7187500
NODE_148786_length_315_cov_6.300926	67	147	0	80	80	1.0000000
NODE_148786_length_315_cov_6.300926	120	200	0	80	80	1.0000000
NODE_148812_length_315_cov_4.449074	125	205	7	28	80	0.3500000
NODE_148812_length_315_cov_4.449074	125	205	13	6	80	0.0750000
NODE_148812_length_315_cov_4.449074	125	205	14	6	80	0.0750000
NODE_148812_length_315_cov_4.449074	125	205	16	38	80	0.4750000
NODE_148812_length_315_cov_4.449074	125	205	18	2	80	0.0250000
NODE_148812_length_315_cov_4.449074	178	225	2	3	47	0.0638298
NODE_148812_length_315_cov_4.449074	178	225	5	2	47	0.0425532
NODE_148812_length_315_cov_4.449074	178	225	7	42	47	0.8936170
NODE_148834_length_315_cov_4.009259	0	61	0	61	61	1.0000000
NODE_148834_length_315_cov_4.009259	42	61	0	19	19	1.0000000
NODE_148872_length_315_cov_3.421296	37	120	8	9	83	0.1084337
NODE_148872_length_315_cov_3.421296	37	120	10	12	83	0.1445783
NODE_148872_length_315_cov_3.421296	37	120	11	23	83	0.2771084
NODE_148872_length_315_cov_3.421296	37	120	12	39	83	0.4698795
NODE_148915_length_315_cov_2.847222	0	74	0	74	74	1.0000000
NODE_148915_length_315_cov_2.847222	47	127	0	80	80	1.0000000
NODE_148921_length_315_cov_2.833333	186	253	0	54	67	0.8059701
NODE_148921_length_315_cov_2.833333	186	253	2	13	67	0.1940299
NODE_148921_length_315_cov_2.833333	186	253	0	54	67	0.8059701
NODE_148921_length_315_cov_2.833333	186	253	2	13	67	0.1940299
NODE_148991_length_315_cov_2.416667	44	117	57	3	73	0.0410959
NODE_148991_length_315_cov_2.416667	44	117	63	1	73	0.0136986
NODE_148991_length_315_cov_2.416667	44	117	73	4	73	0.0547945
NODE_148991_length_315_cov_2.416667	44	117	76	1	73	0.0136986
NODE_148991_length_315_cov_2.416667	44	117	80	4	73	0.0547945
NODE_148991_length_315_cov_2.416667	44	117	85	2	73	0.0273973
NODE_148991_length_315_cov_2.416667	44	117	86	1	73	0.0136986
NODE_148991_length_315_cov_2.416667	44	117	98	2	73	0.0273973
NODE_148991_length_315_cov_2.416667	44	117	106	1	73	0.0136986
NODE_148991_length_315_cov_2.416667	44	117	108	1	73	0.0136986
NODE_148991_length_315_cov_2.416667	44	117	126	1	73	0.0136986
NODE_148991_length_315_cov_2.416667	44	117	130	1	73	0.0136986
NODE_148991_length_315_cov_2.416667	44	117	141	1	73	0.0136986
NODE_148991_length_315_cov_2.416667	44	117	143	1	73	0.0136986
NODE_148991_length_315_cov_2.416667	44	117	153	1	73	0.0136986
NODE_148991_length_315_cov_2.416667	44	117	162	1	73	0.0136986
NODE_148991_length_315_cov_2.416667	44	117	170	5	73	0.0684932
NODE_148991_length_315_cov_2.416667	44	117	175	2	73	0.0273973
NODE_148991_length_315_cov_2.416667	44	117	176	1	73	0.0136986
NODE_148991_length_315_cov_2.416667	44	117	179	3	73	0.0410959
NODE_148991_length_315_cov_2.416667	44	117	184	1	73	0.0136986
NODE_148991_length_315_cov_2.416667	44	117	192	1	73	0.0136986
NODE_148991_length_315_cov_2.416667	44	117	199	2	73	0.0273973
NODE_148991_length_315_cov_2.416667	44	117	208	1	73	0.0136986
NODE_148991_length_315_cov_2.416667	44	117	212	1	73	0.0136986
NODE_148991_length_315_cov_2.416667	44	117	220	1	73	0.0136986
NODE_148991_length_315_cov_2.416667	44	117	225	1	73	0.0136986
NODE_148991_length_315_cov_2.416667	44	117	228	1	73	0.0136986
NODE_148991_length_315_cov_2.416667	44	117	229	1	73	0.0136986
NODE_148991_length_315_cov_2.416667	44	117	233	1	73	0.0136986
NODE_148991_length_315_cov_2.416667	44	117	239	1	73	0.0136986
NODE_148991_length_315_cov_2.416667	44	117	240	2	73	0.0273973
NODE_148991_length_315_cov_2.416667	44	117	254	1	73	0.0136986
NODE_148991_length_315_cov_2.416667	44	117	260	1	73	0.0136986
NODE_148991_length_315_cov_2.416667	44	117	263	1	73	0.0136986
NODE_148991_length_315_cov_2.416667	44	117	271	1	73	0.0136986
NODE_148991_length_315_cov_2.416667	44	117	273	2	73	0.0273973
NODE_148991_length_315_cov_2.416667	44	117	281	1	73	0.0136986
NODE_148991_length_315_cov_2.416667	44	117	288	3	73	0.0410959
NODE_148991_length_315_cov_2.416667	44	117	289	3	73	0.0410959
NODE_148991_length_315_cov_2.416667	44	117	290	2	73	0.0273973
NODE_148991_length_315_cov_2.416667	44	117	295	3	73	0.0410959
NODE_148991_length_315_cov_2.416667	44	117	299	1	73	0.0136986
NODE_148991_length_315_cov_2.416667	44	117	301	1	73	0.0136986
NODE_148991_length_315_cov_2.416667	44	117	307	1	73	0.0136986
NODE_148991_length_315_cov_2.416667	44	117	309	1	73	0.0136986
NODE_149074_length_315_cov_2.115741	128	193	0	65	65	1.0000000
NODE_149095_length_315_cov_2.004630	270	315	0	45	45	1.0000000
NODE_149201_length_315_cov_1.731481	125	202	0	44	77	0.5714286
NODE_149201_length_315_cov_1.731481	125	202	2	33	77	0.4285714
NODE_149391_length_315_cov_1.384259	183	233	2	50	50	1.0000000
NODE_149935_length_315_cov_0.430556	125	145	0	4	20	0.2000000
NODE_149935_length_315_cov_0.430556	125	145	2	16	20	0.8000000
NODE_149943_length_314_cov_108.139535	151	213	148	1	62	0.0161290
NODE_149943_length_314_cov_108.139535	151	213	159	2	62	0.0322581
NODE_149943_length_314_cov_108.139535	151	213	162	1	62	0.0161290
NODE_149943_length_314_cov_108.139535	151	213	172	1	62	0.0161290
NODE_149943_length_314_cov_108.139535	151	213	173	3	62	0.0483871
NODE_149943_length_314_cov_108.139535	151	213	174	3	62	0.0483871
NODE_149943_length_314_cov_108.139535	151	213	176	2	62	0.0322581
NODE_149943_length_314_cov_108.139535	151	213	177	2	62	0.0322581
NODE_149943_length_314_cov_108.139535	151	213	178	5	62	0.0806452
NODE_149943_length_314_cov_108.139535	151	213	179	4	62	0.0645161
NODE_149943_length_314_cov_108.139535	151	213	180	7	62	0.1129032
NODE_149943_length_314_cov_108.139535	151	213	182	8	62	0.1290323
NODE_149943_length_314_cov_108.139535	151	213	183	3	62	0.0483871
NODE_149943_length_314_cov_108.139535	151	213	184	4	62	0.0645161
NODE_149943_length_314_cov_108.139535	151	213	185	4	62	0.0645161
NODE_149943_length_314_cov_108.139535	151	213	186	6	62	0.0967742
NODE_149943_length_314_cov_108.139535	151	213	187	2	62	0.0322581
NODE_149943_length_314_cov_108.139535	151	213	189	4	62	0.0645161
NODE_149943_length_314_cov_108.139535	160	213	148	1	53	0.0188679
NODE_149943_length_314_cov_108.139535	160	213	159	1	53	0.0188679
NODE_149943_length_314_cov_108.139535	160	213	172	1	53	0.0188679
NODE_149943_length_314_cov_108.139535	160	213	173	3	53	0.0566038
NODE_149943_length_314_cov_108.139535	160	213	174	3	53	0.0566038
NODE_149943_length_314_cov_108.139535	160	213	176	1	53	0.0188679
NODE_149943_length_314_cov_108.139535	160	213	177	2	53	0.0377358
NODE_149943_length_314_cov_108.139535	160	213	178	3	53	0.0566038
NODE_149943_length_314_cov_108.139535	160	213	179	3	53	0.0566038
NODE_149943_length_314_cov_108.139535	160	213	180	6	53	0.1132075
NODE_149943_length_314_cov_108.139535	160	213	182	7	53	0.1320755
NODE_149943_length_314_cov_108.139535	160	213	183	3	53	0.0566038
NODE_149943_length_314_cov_108.139535	160	213	184	3	53	0.0566038
NODE_149943_length_314_cov_108.139535	160	213	185	4	53	0.0754717
NODE_149943_length_314_cov_108.139535	160	213	186	6	53	0.1132075
NODE_149943_length_314_cov_108.139535	160	213	187	2	53	0.0377358
NODE_149943_length_314_cov_108.139535	160	213	189	4	53	0.0754717
NODE_149944_length_314_cov_48.134884	245	314	0	69	69	1.0000000
NODE_149946_length_314_cov_9.097674	149	206	0	57	57	1.0000000
NODE_149967_length_314_cov_4.897674	109	189	0	2	80	0.0250000
NODE_149967_length_314_cov_4.897674	109	189	1	9	80	0.1125000
NODE_149967_length_314_cov_4.897674	109	189	3	2	80	0.0250000
NODE_149967_length_314_cov_4.897674	109	189	4	67	80	0.8375000
NODE_150004_length_314_cov_3.823256	119	199	4	80	80	1.0000000
NODE_150020_length_314_cov_3.558140	32	92	3	9	60	0.1500000
NODE_150020_length_314_cov_3.558140	32	92	7	51	60	0.8500000
NODE_150035_length_314_cov_3.316279	84	126	4	5	42	0.1190476
NODE_150035_length_314_cov_3.316279	84	126	6	4	42	0.0952381
NODE_150035_length_314_cov_3.316279	84	126	8	33	42	0.7857143
NODE_150035_length_314_cov_3.316279	127	180	0	9	53	0.1698113
NODE_150035_length_314_cov_3.316279	127	180	2	18	53	0.3396226
NODE_150035_length_314_cov_3.316279	127	180	4	26	53	0.4905660
NODE_150035_length_314_cov_3.316279	128	148	4	20	20	1.0000000
NODE_150066_length_314_cov_3.032558	252	308	2	23	56	0.4107143
NODE_150066_length_314_cov_3.032558	252	308	4	21	56	0.3750000
NODE_150066_length_314_cov_3.032558	252	308	6	10	56	0.1785714
NODE_150066_length_314_cov_3.032558	252	308	8	2	56	0.0357143
NODE_150141_length_314_cov_2.520930	0	61	0	61	61	1.0000000
NODE_150141_length_314_cov_2.520930	34	93	0	59	59	1.0000000
NODE_150153_length_314_cov_2.441860	48	84	0	36	36	1.0000000
NODE_150159_length_314_cov_2.395349	62	112	6	50	50	1.0000000
NODE_150200_length_314_cov_2.265116	7	53	0	30	46	0.6521739
NODE_150200_length_314_cov_2.265116	7	53	2	6	46	0.1304348
NODE_150200_length_314_cov_2.265116	7	53	4	10	46	0.2173913
NODE_150220_length_314_cov_2.144186	224	264	0	40	40	1.0000000
NODE_150257_length_314_cov_2.004651	68	148	2	80	80	1.0000000
NODE_150257_length_314_cov_2.004651	121	201	0	41	80	0.5125000
NODE_150257_length_314_cov_2.004651	121	201	2	39	80	0.4875000
NODE_150385_length_314_cov_1.665116	204	242	0	38	38	1.0000000
NODE_150385_length_314_cov_1.665116	215	295	0	80	80	1.0000000
NODE_150647_length_314_cov_1.223256	7	87	0	80	80	1.0000000
NODE_150709_length_314_cov_1.167442	1	69	0	68	68	1.0000000
NODE_151193_length_313_cov_156.051402	177	254	9	1	77	0.0129870
NODE_151193_length_313_cov_156.051402	177	254	10	6	77	0.0779221
NODE_151193_length_313_cov_156.051402	177	254	12	1	77	0.0129870
NODE_151193_length_313_cov_156.051402	177	254	15	2	77	0.0259740
NODE_151193_length_313_cov_156.051402	177	254	17	3	77	0.0389610
NODE_151193_length_313_cov_156.051402	177	254	20	4	77	0.0519481
NODE_151193_length_313_cov_156.051402	177	254	22	7	77	0.0909091
NODE_151193_length_313_cov_156.051402	177	254	24	2	77	0.0259740
NODE_151193_length_313_cov_156.051402	177	254	26	1	77	0.0129870
NODE_151193_length_313_cov_156.051402	177	254	28	1	77	0.0129870
NODE_151193_length_313_cov_156.051402	177	254	31	1	77	0.0129870
NODE_151193_length_313_cov_156.051402	177	254	32	3	77	0.0389610
NODE_151193_length_313_cov_156.051402	177	254	34	18	77	0.2337662
NODE_151193_length_313_cov_156.051402	177	254	36	27	77	0.3506494
NODE_151193_length_313_cov_156.051402	177	254	9	1	77	0.0129870
NODE_151193_length_313_cov_156.051402	177	254	10	6	77	0.0779221
NODE_151193_length_313_cov_156.051402	177	254	12	1	77	0.0129870
NODE_151193_length_313_cov_156.051402	177	254	15	2	77	0.0259740
NODE_151193_length_313_cov_156.051402	177	254	17	3	77	0.0389610
NODE_151193_length_313_cov_156.051402	177	254	20	4	77	0.0519481
NODE_151193_length_313_cov_156.051402	177	254	22	7	77	0.0909091
NODE_151193_length_313_cov_156.051402	177	254	24	2	77	0.0259740
NODE_151193_length_313_cov_156.051402	177	254	26	1	77	0.0129870
NODE_151193_length_313_cov_156.051402	177	254	28	1	77	0.0129870
NODE_151193_length_313_cov_156.051402	177	254	31	1	77	0.0129870
NODE_151193_length_313_cov_156.051402	177	254	32	3	77	0.0389610
NODE_151193_length_313_cov_156.051402	177	254	34	18	77	0.2337662
NODE_151193_length_313_cov_156.051402	177	254	36	27	77	0.3506494
NODE_151214_length_313_cov_5.359813	135	196	0	9	61	0.1475410
NODE_151214_length_313_cov_5.359813	135	196	2	14	61	0.2295082
NODE_151214_length_313_cov_5.359813	135	196	4	38	61	0.6229508
NODE_151214_length_313_cov_5.359813	169	241	4	72	72	1.0000000
NODE_151230_length_313_cov_4.794393	126	206	2	9	80	0.1125000
NODE_151230_length_313_cov_4.794393	126	206	4	28	80	0.3500000
NODE_151230_length_313_cov_4.794393	126	206	6	2	80	0.0250000
NODE_151230_length_313_cov_4.794393	126	206	10	10	80	0.1250000
NODE_151230_length_313_cov_4.794393	126	206	14	7	80	0.0875000
NODE_151230_length_313_cov_4.794393	126	206	18	24	80	0.3000000
NODE_151230_length_313_cov_4.794393	179	259	8	4	80	0.0500000
NODE_151230_length_313_cov_4.794393	179	259	12	1	80	0.0125000
NODE_151230_length_313_cov_4.794393	179	259	14	12	80	0.1500000
NODE_151230_length_313_cov_4.794393	179	259	16	7	80	0.0875000
NODE_151230_length_313_cov_4.794393	179	259	18	56	80	0.7000000
NODE_151232_length_313_cov_4.761682	104	162	0	58	58	1.0000000
NODE_151232_length_313_cov_4.761682	135	215	0	70	80	0.8750000
NODE_151232_length_313_cov_4.761682	135	215	2	10	80	0.1250000
NODE_151277_length_313_cov_3.560748	106	186	4	57	80	0.7125000
NODE_151277_length_313_cov_3.560748	106	186	6	23	80	0.2875000
NODE_151331_length_313_cov_2.953271	92	153	2	35	61	0.5737705
NODE_151331_length_313_cov_2.953271	92	153	4	6	61	0.0983607
NODE_151331_length_313_cov_2.953271	92	153	8	15	61	0.2459016
NODE_151331_length_313_cov_2.953271	92	153	10	5	61	0.0819672
NODE_151364_length_313_cov_2.640187	110	182	0	72	72	1.0000000
NODE_151364_length_313_cov_2.640187	113	184	0	71	71	1.0000000
NODE_151409_length_313_cov_2.383178	58	137	0	79	79	1.0000000
NODE_151409_length_313_cov_2.383178	110	190	0	72	80	0.9000000
NODE_151409_length_313_cov_2.383178	110	190	2	5	80	0.0625000
NODE_151409_length_313_cov_2.383178	110	190	3	1	80	0.0125000
NODE_151409_length_313_cov_2.383178	110	190	14	2	80	0.0250000
NODE_151474_length_313_cov_2.107477	153	221	2	4	68	0.0588235
NODE_151474_length_313_cov_2.107477	153	221	4	3	68	0.0441176
NODE_151474_length_313_cov_2.107477	153	221	6	13	68	0.1911765
NODE_151474_length_313_cov_2.107477	153	221	8	2	68	0.0294118
NODE_151474_length_313_cov_2.107477	153	221	10	46	68	0.6764706
NODE_151510_length_313_cov_1.934579	107	187	2	12	80	0.1500000
NODE_151510_length_313_cov_1.934579	107	187	4	3	80	0.0375000
NODE_151510_length_313_cov_1.934579	107	187	5	7	80	0.0875000
NODE_151510_length_313_cov_1.934579	107	187	7	5	80	0.0625000
NODE_151510_length_313_cov_1.934579	107	187	15	1	80	0.0125000
NODE_151510_length_313_cov_1.934579	107	187	25	1	80	0.0125000
NODE_151510_length_313_cov_1.934579	107	187	30	1	80	0.0125000
NODE_151510_length_313_cov_1.934579	107	187	32	1	80	0.0125000
NODE_151510_length_313_cov_1.934579	107	187	36	1	80	0.0125000
NODE_151510_length_313_cov_1.934579	107	187	39	1	80	0.0125000
NODE_151510_length_313_cov_1.934579	107	187	47	1	80	0.0125000
NODE_151510_length_313_cov_1.934579	107	187	49	1	80	0.0125000
NODE_151510_length_313_cov_1.934579	107	187	53	2	80	0.0250000
NODE_151510_length_313_cov_1.934579	107	187	58	1	80	0.0125000
NODE_151510_length_313_cov_1.934579	107	187	61	1	80	0.0125000
NODE_151510_length_313_cov_1.934579	107	187	66	1	80	0.0125000
NODE_151510_length_313_cov_1.934579	107	187	68	1	80	0.0125000
NODE_151510_length_313_cov_1.934579	107	187	70	1	80	0.0125000
NODE_151510_length_313_cov_1.934579	107	187	75	1	80	0.0125000
NODE_151510_length_313_cov_1.934579	107	187	77	2	80	0.0250000
NODE_151510_length_313_cov_1.934579	107	187	78	1	80	0.0125000
NODE_151510_length_313_cov_1.934579	107	187	84	2	80	0.0250000
NODE_151510_length_313_cov_1.934579	107	187	86	1	80	0.0125000
NODE_151510_length_313_cov_1.934579	107	187	96	2	80	0.0250000
NODE_151510_length_313_cov_1.934579	107	187	97	1	80	0.0125000
NODE_151510_length_313_cov_1.934579	107	187	103	3	80	0.0375000
NODE_151510_length_313_cov_1.934579	107	187	106	1	80	0.0125000
NODE_151510_length_313_cov_1.934579	107	187	108	1	80	0.0125000
NODE_151510_length_313_cov_1.934579	107	187	109	1	80	0.0125000
NODE_151510_length_313_cov_1.934579	107	187	119	1	80	0.0125000
NODE_151510_length_313_cov_1.934579	107	187	121	1	80	0.0125000
NODE_151510_length_313_cov_1.934579	107	187	123	1	80	0.0125000
NODE_151510_length_313_cov_1.934579	107	187	125	1	80	0.0125000
NODE_151510_length_313_cov_1.934579	107	187	129	1	80	0.0125000
NODE_151510_length_313_cov_1.934579	107	187	133	1	80	0.0125000
NODE_151510_length_313_cov_1.934579	107	187	139	1	80	0.0125000
NODE_151510_length_313_cov_1.934579	107	187	143	1	80	0.0125000
NODE_151510_length_313_cov_1.934579	107	187	154	1	80	0.0125000
NODE_151510_length_313_cov_1.934579	107	187	165	1	80	0.0125000
NODE_151510_length_313_cov_1.934579	107	187	170	1	80	0.0125000
NODE_151510_length_313_cov_1.934579	107	187	171	1	80	0.0125000
NODE_151510_length_313_cov_1.934579	107	187	172	1	80	0.0125000
NODE_151510_length_313_cov_1.934579	107	187	184	1	80	0.0125000
NODE_151510_length_313_cov_1.934579	107	187	187	1	80	0.0125000
NODE_151510_length_313_cov_1.934579	107	187	191	2	80	0.0250000
NODE_151510_length_313_cov_1.934579	107	187	193	5	80	0.0625000
NODE_151510_length_313_cov_1.934579	160	240	103	2	80	0.0250000
NODE_151510_length_313_cov_1.934579	160	240	106	1	80	0.0125000
NODE_151510_length_313_cov_1.934579	160	240	108	1	80	0.0125000
NODE_151510_length_313_cov_1.934579	160	240	109	1	80	0.0125000
NODE_151510_length_313_cov_1.934579	160	240	119	1	80	0.0125000
NODE_151510_length_313_cov_1.934579	160	240	121	1	80	0.0125000
NODE_151510_length_313_cov_1.934579	160	240	123	1	80	0.0125000
NODE_151510_length_313_cov_1.934579	160	240	125	1	80	0.0125000
NODE_151510_length_313_cov_1.934579	160	240	129	1	80	0.0125000
NODE_151510_length_313_cov_1.934579	160	240	133	1	80	0.0125000
NODE_151510_length_313_cov_1.934579	160	240	139	1	80	0.0125000
NODE_151510_length_313_cov_1.934579	160	240	143	1	80	0.0125000
NODE_151510_length_313_cov_1.934579	160	240	154	1	80	0.0125000
NODE_151510_length_313_cov_1.934579	160	240	165	1	80	0.0125000
NODE_151510_length_313_cov_1.934579	160	240	170	1	80	0.0125000
NODE_151510_length_313_cov_1.934579	160	240	171	1	80	0.0125000
NODE_151510_length_313_cov_1.934579	160	240	172	1	80	0.0125000
NODE_151510_length_313_cov_1.934579	160	240	176	7	80	0.0875000
NODE_151510_length_313_cov_1.934579	160	240	178	1	80	0.0125000
NODE_151510_length_313_cov_1.934579	160	240	180	1	80	0.0125000
NODE_151510_length_313_cov_1.934579	160	240	184	1	80	0.0125000
NODE_151510_length_313_cov_1.934579	160	240	186	1	80	0.0125000
NODE_151510_length_313_cov_1.934579	160	240	187	1	80	0.0125000
NODE_151510_length_313_cov_1.934579	160	240	188	5	80	0.0625000
NODE_151510_length_313_cov_1.934579	160	240	190	7	80	0.0875000
NODE_151510_length_313_cov_1.934579	160	240	191	7	80	0.0875000
NODE_151510_length_313_cov_1.934579	160	240	192	3	80	0.0375000
NODE_151510_length_313_cov_1.934579	160	240	193	19	80	0.2375000
NODE_151510_length_313_cov_1.934579	160	240	195	7	80	0.0875000
NODE_151510_length_313_cov_1.934579	160	240	197	2	80	0.0250000
NODE_151576_length_313_cov_1.780374	236	296	0	60	60	1.0000000
NODE_151623_length_313_cov_1.663551	58	135	5	4	77	0.0519481
NODE_151623_length_313_cov_1.663551	58	135	6	27	77	0.3506494
NODE_151623_length_313_cov_1.663551	58	135	7	46	77	0.5974026
NODE_151703_length_313_cov_1.439252	0	64	0	64	64	1.0000000
NODE_151703_length_313_cov_1.439252	37	82	0	45	45	1.0000000
NODE_151753_length_313_cov_1.429907	74	111	2	5	37	0.1351351
NODE_151753_length_313_cov_1.429907	74	111	4	32	37	0.8648649
NODE_151753_length_313_cov_1.429907	109	172	0	8	63	0.1269841
NODE_151753_length_313_cov_1.429907	109	172	2	9	63	0.1428571
NODE_151753_length_313_cov_1.429907	109	172	4	46	63	0.7301587
NODE_151953_length_313_cov_1.172897	106	161	2	52	55	0.9454545
NODE_151953_length_313_cov_1.172897	106	161	4	3	55	0.0545455
NODE_151953_length_313_cov_1.172897	149	214	2	9	65	0.1384615
NODE_151953_length_313_cov_1.172897	149	214	4	5	65	0.0769231
NODE_151953_length_313_cov_1.172897	149	214	6	3	65	0.0461538
NODE_151953_length_313_cov_1.172897	149	214	8	1	65	0.0153846
NODE_151953_length_313_cov_1.172897	149	214	9	12	65	0.1846154
NODE_151953_length_313_cov_1.172897	149	214	11	1	65	0.0153846
NODE_151953_length_313_cov_1.172897	149	214	12	6	65	0.0923077
NODE_151953_length_313_cov_1.172897	149	214	14	1	65	0.0153846
NODE_151953_length_313_cov_1.172897	149	214	15	1	65	0.0153846
NODE_151953_length_313_cov_1.172897	149	214	16	2	65	0.0307692
NODE_151953_length_313_cov_1.172897	149	214	20	4	65	0.0615385
NODE_151953_length_313_cov_1.172897	149	214	22	9	65	0.1384615
NODE_151953_length_313_cov_1.172897	149	214	24	11	65	0.1692308
NODE_152525_length_312_cov_3.723005	178	238	10	60	60	1.0000000
NODE_152525_length_312_cov_3.723005	231	291	4	31	60	0.5166667
NODE_152525_length_312_cov_3.723005	231	291	6	9	60	0.1500000
NODE_152525_length_312_cov_3.723005	231	291	8	11	60	0.1833333
NODE_152525_length_312_cov_3.723005	231	291	10	9	60	0.1500000
NODE_152609_length_312_cov_2.723005	34	96	0	62	62	1.0000000
NODE_152609_length_312_cov_2.723005	87	149	0	62	62	1.0000000
NODE_152680_length_312_cov_2.333333	6	70	0	64	64	1.0000000
NODE_152680_length_312_cov_2.333333	43	123	0	80	80	1.0000000
NODE_152686_length_312_cov_2.267606	176	208	7	2	32	0.0625000
NODE_152686_length_312_cov_2.267606	176	208	8	10	32	0.3125000
NODE_152686_length_312_cov_2.267606	176	208	9	20	32	0.6250000
NODE_152697_length_312_cov_2.234742	108	169	2	56	61	0.9180328
NODE_152697_length_312_cov_2.234742	108	169	6	5	61	0.0819672
NODE_152751_length_312_cov_2.014085	141	205	0	64	64	1.0000000
NODE_152751_length_312_cov_2.014085	178	258	0	80	80	1.0000000
NODE_152827_length_312_cov_1.835681	176	221	0	45	45	1.0000000
NODE_152827_length_312_cov_1.835681	194	269	0	75	75	1.0000000
NODE_153222_length_312_cov_1.173709	87	133	5	3	46	0.0652174
NODE_153222_length_312_cov_1.173709	87	133	7	1	46	0.0217391
NODE_153222_length_312_cov_1.173709	87	133	8	4	46	0.0869565
NODE_153222_length_312_cov_1.173709	87	133	13	1	46	0.0217391
NODE_153222_length_312_cov_1.173709	87	133	15	13	46	0.2826087
NODE_153222_length_312_cov_1.173709	87	133	16	1	46	0.0217391
NODE_153222_length_312_cov_1.173709	87	133	17	5	46	0.1086956
NODE_153222_length_312_cov_1.173709	87	133	21	5	46	0.1086956
NODE_153222_length_312_cov_1.173709	87	133	23	5	46	0.1086956
NODE_153222_length_312_cov_1.173709	87	133	30	1	46	0.0217391
NODE_153222_length_312_cov_1.173709	87	133	31	1	46	0.0217391
NODE_153222_length_312_cov_1.173709	87	133	32	3	46	0.0652174
NODE_153222_length_312_cov_1.173709	87	133	34	3	46	0.0652174
NODE_153222_length_312_cov_1.173709	150	217	55	2	67	0.0298507
NODE_153222_length_312_cov_1.173709	150	217	57	1	67	0.0149254
NODE_153222_length_312_cov_1.173709	150	217	61	1	67	0.0149254
NODE_153222_length_312_cov_1.173709	150	217	67	4	67	0.0597015
NODE_153222_length_312_cov_1.173709	150	217	69	2	67	0.0298507
NODE_153222_length_312_cov_1.173709	150	217	74	2	67	0.0298507
NODE_153222_length_312_cov_1.173709	150	217	76	9	67	0.1343284
NODE_153222_length_312_cov_1.173709	150	217	78	3	67	0.0447761
NODE_153222_length_312_cov_1.173709	150	217	80	17	67	0.2537313
NODE_153222_length_312_cov_1.173709	150	217	82	22	67	0.3283582
NODE_153222_length_312_cov_1.173709	150	217	84	4	67	0.0597015
NODE_153532_length_312_cov_0.788732	49	110	0	18	61	0.2950820
NODE_153532_length_312_cov_0.788732	49	110	1	11	61	0.1803279
NODE_153532_length_312_cov_0.788732	49	110	2	32	61	0.5245901
NODE_153532_length_312_cov_0.788732	102	163	2	32	61	0.5245901
NODE_153532_length_312_cov_0.788732	102	163	3	29	61	0.4754098
NODE_153708_length_311_cov_5.179245	155	235	2	80	80	1.0000000
NODE_153721_length_311_cov_4.589623	133	200	0	67	67	1.0000000
NODE_153730_length_311_cov_4.358491	199	263	0	64	64	1.0000000
NODE_153743_length_311_cov_3.929245	91	127	0	36	36	1.0000000
NODE_153755_length_311_cov_3.825472	224	304	0	41	80	0.5125000
NODE_153755_length_311_cov_3.825472	224	304	4	13	80	0.1625000
NODE_153755_length_311_cov_3.825472	224	304	6	26	80	0.3250000
NODE_153773_length_311_cov_3.466981	106	186	0	7	80	0.0875000
NODE_153773_length_311_cov_3.466981	106	186	2	73	80	0.9125000
NODE_153796_length_311_cov_3.188679	39	96	0	57	57	1.0000000
NODE_153846_length_311_cov_2.702830	144	193	6	4	49	0.0816327
NODE_153846_length_311_cov_2.702830	144	193	8	45	49	0.9183673
NODE_153850_length_311_cov_2.665094	43	113	0	17	70	0.2428571
NODE_153850_length_311_cov_2.665094	43	113	2	41	70	0.5857143
NODE_153850_length_311_cov_2.665094	43	113	4	12	70	0.1714286
NODE_153859_length_311_cov_2.617925	206	284	0	78	78	1.0000000
NODE_153859_length_311_cov_2.617925	257	301	0	44	44	1.0000000
NODE_153913_length_311_cov_2.349057	177	204	0	27	27	1.0000000
NODE_153919_length_311_cov_2.325472	74	138	0	50	64	0.7812500
NODE_153919_length_311_cov_2.325472	74	138	2	14	64	0.2187500
NODE_153947_length_311_cov_2.188679	21	92	0	71	71	1.0000000
NODE_154014_length_311_cov_1.924528	46	65	0	19	19	1.0000000
NODE_154056_length_311_cov_1.891509	122	180	4	22	58	0.3793103
NODE_154056_length_311_cov_1.891509	122	180	6	36	58	0.6206896
NODE_154188_length_311_cov_1.594340	0	35	0	35	35	1.0000000
NODE_154190_length_311_cov_1.589623	96	151	0	12	55	0.2181818
NODE_154190_length_311_cov_1.589623	96	151	2	13	55	0.2363636
NODE_154190_length_311_cov_1.589623	96	151	4	2	55	0.0363636
NODE_154190_length_311_cov_1.589623	96	151	5	14	55	0.2545455
NODE_154190_length_311_cov_1.589623	96	151	6	14	55	0.2545455
NODE_154194_length_311_cov_1.570755	125	145	0	20	20	1.0000000
NODE_154957_length_311_cov_0.613208	136	216	0	80	80	1.0000000
NODE_154957_length_311_cov_0.613208	189	264	0	75	75	1.0000000
NODE_154996_length_310_cov_96.995261	211	249	98	1	38	0.0263158
NODE_154996_length_310_cov_96.995261	211	249	99	2	38	0.0526316
NODE_154996_length_310_cov_96.995261	211	249	102	6	38	0.1578947
NODE_154996_length_310_cov_96.995261	211	249	104	4	38	0.1052632
NODE_154996_length_310_cov_96.995261	211	249	107	1	38	0.0263158
NODE_154996_length_310_cov_96.995261	211	249	111	1	38	0.0263158
NODE_154996_length_310_cov_96.995261	211	249	117	14	38	0.3684210
NODE_154996_length_310_cov_96.995261	211	249	121	1	38	0.0263158
NODE_154996_length_310_cov_96.995261	211	249	125	6	38	0.1578947
NODE_154996_length_310_cov_96.995261	211	249	127	2	38	0.0526316
NODE_155001_length_310_cov_7.767773	80	151	0	71	71	1.0000000
NODE_155001_length_310_cov_7.767773	134	189	0	55	55	1.0000000
NODE_155017_length_310_cov_5.914692	84	134	0	49	50	0.9800000
NODE_155017_length_310_cov_5.914692	84	134	2	1	50	0.0200000
NODE_155017_length_310_cov_5.914692	113	134	0	21	21	1.0000000
NODE_155017_length_310_cov_5.914692	113	188	0	75	75	1.0000000
NODE_155066_length_310_cov_3.777251	146	226	4	24	80	0.3000000
NODE_155066_length_310_cov_3.777251	146	226	8	56	80	0.7000000
NODE_155115_length_310_cov_3.180095	137	211	8	20	74	0.2702703
NODE_155115_length_310_cov_3.180095	137	211	10	11	74	0.1486486
NODE_155115_length_310_cov_3.180095	137	211	12	14	74	0.1891892
NODE_155115_length_310_cov_3.180095	137	211	14	9	74	0.1216216
NODE_155115_length_310_cov_3.180095	137	211	16	10	74	0.1351351
NODE_155115_length_310_cov_3.180095	137	211	18	6	74	0.0810811
NODE_155115_length_310_cov_3.180095	137	211	20	4	74	0.0540541
NODE_155179_length_310_cov_2.630332	122	174	0	4	52	0.0769231
NODE_155179_length_310_cov_2.630332	122	174	4	48	52	0.9230769
NODE_155179_length_310_cov_2.630332	175	222	0	12	47	0.2553191
NODE_155179_length_310_cov_2.630332	175	222	4	35	47	0.7446808
NODE_155180_length_310_cov_2.625592	258	301	0	43	43	1.0000000
NODE_155195_length_310_cov_2.563981	149	196	5	14	47	0.2978723
NODE_155195_length_310_cov_2.563981	149	196	7	23	47	0.4893617
NODE_155195_length_310_cov_2.563981	149	196	9	10	47	0.2127660
NODE_155195_length_310_cov_2.563981	169	249	5	14	80	0.1750000
NODE_155195_length_310_cov_2.563981	169	249	7	36	80	0.4500000
NODE_155195_length_310_cov_2.563981	169	249	9	30	80	0.3750000
NODE_155261_length_310_cov_2.298578	213	259	8	46	46	1.0000000
NODE_155334_length_310_cov_2.009479	223	303	0	80	80	1.0000000
NODE_155439_length_310_cov_1.729858	53	91	0	38	38	1.0000000
NODE_155768_length_310_cov_1.222749	181	244	6	12	63	0.1904762
NODE_155768_length_310_cov_1.222749	181	244	12	1	63	0.0158730
NODE_155768_length_310_cov_1.222749	181	244	13	18	63	0.2857143
NODE_155768_length_310_cov_1.222749	181	244	14	21	63	0.3333333
NODE_155768_length_310_cov_1.222749	181	244	15	11	63	0.1746032
NODE_155864_length_310_cov_1.142180	65	135	4	1	70	0.0142857
NODE_155864_length_310_cov_1.142180	65	135	10	1	70	0.0142857
NODE_155864_length_310_cov_1.142180	65	135	12	7	70	0.1000000
NODE_155864_length_310_cov_1.142180	65	135	14	30	70	0.4285714
NODE_155864_length_310_cov_1.142180	65	135	18	9	70	0.1285714
NODE_155864_length_310_cov_1.142180	65	135	20	9	70	0.1285714
NODE_155864_length_310_cov_1.142180	65	135	22	13	70	0.1857143
NODE_155937_length_310_cov_0.966825	131	212	0	28	81	0.3456790
NODE_155937_length_310_cov_0.966825	131	212	2	53	81	0.6543210
NODE_155937_length_310_cov_0.966825	193	256	0	9	63	0.1428571
NODE_155937_length_310_cov_0.966825	193	256	2	54	63	0.8571429
NODE_156078_length_310_cov_0.924171	180	222	0	7	42	0.1666667
NODE_156078_length_310_cov_0.924171	180	222	2	35	42	0.8333333
NODE_156174_length_310_cov_0.739336	208	288	0	80	80	1.0000000
NODE_156332_length_309_cov_8.552381	154	234	0	80	80	1.0000000
NODE_156340_length_309_cov_6.147619	20	83	0	61	63	0.9682540
NODE_156340_length_309_cov_6.147619	20	83	2	2	63	0.0317460
NODE_156349_length_309_cov_5.147619	213	291	0	78	78	1.0000000
NODE_156364_length_309_cov_4.585714	15	95	0	80	80	1.0000000
NODE_156472_length_309_cov_3.028571	0	47	0	47	47	1.0000000
NODE_156472_length_309_cov_3.028571	20	101	0	81	81	1.0000000
NODE_156563_length_309_cov_2.304762	179	218	4	1	39	0.0256410
NODE_156563_length_309_cov_2.304762	179	218	8	38	39	0.9743590
NODE_156615_length_309_cov_2.095238	55	85	4	4	30	0.1333333
NODE_156615_length_309_cov_2.095238	55	85	6	26	30	0.8666667
NODE_156678_length_309_cov_1.938095	2	73	0	71	71	1.0000000
NODE_156950_length_309_cov_1.414286	189	231	0	42	42	1.0000000
NODE_156978_length_309_cov_1.376190	94	168	0	58	74	0.7837838
NODE_156978_length_309_cov_1.376190	94	168	2	16	74	0.2162162
NODE_157334_length_309_cov_0.966667	134	153	0	19	19	1.0000000
NODE_157469_length_309_cov_0.738095	150	215	11	3	65	0.0461538
NODE_157469_length_309_cov_0.738095	150	215	13	9	65	0.1384615
NODE_157469_length_309_cov_0.738095	150	215	15	53	65	0.8153846
NODE_157661_length_308_cov_4.775120	137	174	7	37	37	1.0000000
NODE_157690_length_308_cov_3.966507	126	206	0	47	80	0.5875000
NODE_157690_length_308_cov_3.966507	126	206	2	33	80	0.4125000
NODE_157705_length_308_cov_3.665072	11	75	0	64	64	1.0000000
NODE_157819_length_308_cov_2.593301	137	193	0	1	56	0.0178571
NODE_157819_length_308_cov_2.593301	137	193	2	55	56	0.9821429
NODE_157852_length_308_cov_2.435407	14	58	0	44	44	1.0000000
NODE_157852_length_308_cov_2.435407	31	111	0	80	80	1.0000000
NODE_157898_length_308_cov_2.191388	14	80	0	66	66	1.0000000
NODE_157903_length_308_cov_2.191388	236	296	0	60	60	1.0000000
NODE_157969_length_308_cov_1.952153	251	296	0	45	45	1.0000000
NODE_158083_length_308_cov_1.708134	102	148	0	5	46	0.1086956
NODE_158083_length_308_cov_1.708134	102	148	2	41	46	0.8913044
NODE_158276_length_308_cov_1.435407	196	276	0	80	80	1.0000000
NODE_158439_length_308_cov_1.162679	260	300	0	40	40	1.0000000
NODE_158439_length_308_cov_1.162679	273	307	0	34	34	1.0000000
NODE_158447_length_308_cov_1.148325	35	83	0	48	48	1.0000000
NODE_158448_length_308_cov_1.148325	253	308	0	55	55	1.0000000
NODE_158510_length_308_cov_1.038278	147	202	0	55	55	1.0000000
NODE_158811_length_308_cov_0.684211	196	275	0	79	79	1.0000000
NODE_158821_length_308_cov_0.660287	109	157	2	32	48	0.6666667
NODE_158821_length_308_cov_0.660287	109	157	4	1	48	0.0208333
NODE_158821_length_308_cov_0.660287	109	157	6	12	48	0.2500000
NODE_158821_length_308_cov_0.660287	109	157	8	3	48	0.0625000
NODE_158821_length_308_cov_0.660287	130	210	2	11	80	0.1375000
NODE_158821_length_308_cov_0.660287	130	210	4	1	80	0.0125000
NODE_158821_length_308_cov_0.660287	130	210	6	17	80	0.2125000
NODE_158821_length_308_cov_0.660287	130	210	8	51	80	0.6375000
NODE_158905_length_307_cov_30.725962	0	73	0	73	73	1.0000000
NODE_158905_length_307_cov_30.725962	46	99	0	53	53	1.0000000
NODE_158906_length_307_cov_25.096154	84	164	0	20	80	0.2500000
NODE_158906_length_307_cov_25.096154	84	164	3	1	80	0.0125000
NODE_158906_length_307_cov_25.096154	84	164	6	59	80	0.7375000
NODE_158906_length_307_cov_25.096154	137	217	6	80	80	1.0000000
NODE_158933_length_307_cov_5.524038	150	221	0	71	71	1.0000000
NODE_158983_length_307_cov_3.730769	172	252	4	10	80	0.1250000
NODE_158983_length_307_cov_3.730769	172	252	6	36	80	0.4500000
NODE_158983_length_307_cov_3.730769	172	252	8	7	80	0.0875000
NODE_158983_length_307_cov_3.730769	172	252	9	13	80	0.1625000
NODE_158983_length_307_cov_3.730769	172	252	10	14	80	0.1750000
NODE_158983_length_307_cov_3.730769	225	305	2	12	80	0.1500000
NODE_158983_length_307_cov_3.730769	225	305	6	57	80	0.7125000
NODE_158983_length_307_cov_3.730769	225	305	8	2	80	0.0250000
NODE_158983_length_307_cov_3.730769	225	305	9	9	80	0.1125000
NODE_158999_length_307_cov_3.322115	20	100	2	7	80	0.0875000
NODE_158999_length_307_cov_3.322115	20	100	3	2	80	0.0250000
NODE_158999_length_307_cov_3.322115	20	100	4	1	80	0.0125000
NODE_158999_length_307_cov_3.322115	20	100	6	70	80	0.8750000
NODE_158999_length_307_cov_3.322115	78	153	3	15	75	0.2000000
NODE_158999_length_307_cov_3.322115	78	153	4	14	75	0.1866667
NODE_158999_length_307_cov_3.322115	78	153	6	46	75	0.6133333
NODE_159000_length_307_cov_3.317308	12	94	2	8	82	0.0975610
NODE_159000_length_307_cov_3.317308	12	94	4	6	82	0.0731707
NODE_159000_length_307_cov_3.317308	12	94	6	23	82	0.2804878
NODE_159000_length_307_cov_3.317308	12	94	8	45	82	0.5487805
NODE_159000_length_307_cov_3.317308	76	134	4	3	58	0.0517241
NODE_159000_length_307_cov_3.317308	76	134	6	8	58	0.1379310
NODE_159000_length_307_cov_3.317308	76	134	8	47	58	0.8103448
NODE_159053_length_307_cov_2.870192	43	108	0	65	65	1.0000000
NODE_159084_length_307_cov_2.653846	117	177	63	7	60	0.1166667
NODE_159084_length_307_cov_2.653846	117	177	64	1	60	0.0166667
NODE_159084_length_307_cov_2.653846	117	177	65	8	60	0.1333333
NODE_159084_length_307_cov_2.653846	117	177	66	1	60	0.0166667
NODE_159084_length_307_cov_2.653846	117	177	67	43	60	0.7166666
NODE_159142_length_307_cov_2.346154	54	105	0	51	51	1.0000000
NODE_159351_length_307_cov_1.716346	124	165	2	41	41	1.0000000
NODE_159362_length_307_cov_1.716346	30	93	10	37	63	0.5873016
NODE_159362_length_307_cov_1.716346	30	93	11	9	63	0.1428571
NODE_159362_length_307_cov_1.716346	30	93	13	9	63	0.1428571
NODE_159362_length_307_cov_1.716346	30	93	14	8	63	0.1269841
NODE_159407_length_307_cov_1.600962	221	269	2	48	48	1.0000000
NODE_159407_length_307_cov_1.600962	242	307	0	7	65	0.1076923
NODE_159407_length_307_cov_1.600962	242	307	2	58	65	0.8923077
NODE_159447_length_307_cov_1.475962	252	307	0	55	55	1.0000000
NODE_159585_length_307_cov_1.326923	96	142	0	46	46	1.0000000
NODE_159585_length_307_cov_1.326923	115	195	0	80	80	1.0000000
NODE_159618_length_307_cov_1.264423	13	61	0	48	48	1.0000000
NODE_159618_length_307_cov_1.264423	23	54	0	31	31	1.0000000
NODE_159696_length_307_cov_1.197115	92	121	4	13	29	0.4482759
NODE_159696_length_307_cov_1.197115	92	121	6	8	29	0.2758621
NODE_159696_length_307_cov_1.197115	92	121	8	8	29	0.2758621
NODE_159787_length_307_cov_1.000000	132	168	0	36	36	1.0000000
NODE_160213_length_306_cov_74.526570	68	136	0	43	68	0.6323529
NODE_160213_length_306_cov_74.526570	68	136	2	25	68	0.3676471
NODE_160213_length_306_cov_74.526570	68	148	0	43	80	0.5375000
NODE_160213_length_306_cov_74.526570	68	148	2	37	80	0.4625000
NODE_160213_length_306_cov_74.526570	121	201	2	46	80	0.5750000
NODE_160213_length_306_cov_74.526570	121	201	6	34	80	0.4250000
NODE_160213_length_306_cov_74.526570	121	201	2	46	80	0.5750000
NODE_160213_length_306_cov_74.526570	121	201	6	34	80	0.4250000
NODE_160213_length_306_cov_74.526570	197	277	4	58	80	0.7250000
NODE_160213_length_306_cov_74.526570	197	277	6	22	80	0.2750000
NODE_160213_length_306_cov_74.526570	197	277	4	58	80	0.7250000
NODE_160213_length_306_cov_74.526570	197	277	6	22	80	0.2750000
NODE_160213_length_306_cov_74.526570	197	277	4	58	80	0.7250000
NODE_160213_length_306_cov_74.526570	197	277	6	22	80	0.2750000
NODE_160213_length_306_cov_74.526570	250	299	0	18	49	0.3673469
NODE_160213_length_306_cov_74.526570	250	299	4	31	49	0.6326531
NODE_160213_length_306_cov_74.526570	250	306	0	25	56	0.4464286
NODE_160213_length_306_cov_74.526570	250	306	4	31	56	0.5535714
NODE_160213_length_306_cov_74.526570	255	306	0	25	51	0.4901961
NODE_160213_length_306_cov_74.526570	255	306	4	26	51	0.5098040
NODE_160217_length_306_cov_7.396135	23	117	0	94	94	1.0000000
NODE_160217_length_306_cov_7.396135	90	170	0	80	80	1.0000000
NODE_160261_length_306_cov_4.275362	67	147	4	80	80	1.0000000
NODE_160275_length_306_cov_3.937198	104	176	2	72	72	1.0000000
NODE_160300_length_306_cov_3.444444	130	206	0	76	76	1.0000000
NODE_160323_length_306_cov_3.217391	198	278	0	26	80	0.3250000
NODE_160323_length_306_cov_3.217391	198	278	2	54	80	0.6750000
NODE_160333_length_306_cov_3.043478	90	171	0	44	81	0.5432099
NODE_160333_length_306_cov_3.043478	90	171	4	37	81	0.4567901
NODE_160333_length_306_cov_3.043478	144	202	0	3	58	0.0517241
NODE_160333_length_306_cov_3.043478	144	202	4	55	58	0.9482759
NODE_160340_length_306_cov_2.956522	242	273	0	31	31	1.0000000
NODE_160355_length_306_cov_2.884058	173	243	0	2	70	0.0285714
NODE_160355_length_306_cov_2.884058	173	243	2	68	70	0.9714286
NODE_160403_length_306_cov_2.574879	122	203	6	67	81	0.8271605
NODE_160403_length_306_cov_2.574879	122	203	8	14	81	0.1728395
NODE_160403_length_306_cov_2.574879	176	254	2	45	78	0.5769231
NODE_160403_length_306_cov_2.574879	176	254	4	3	78	0.0384615
NODE_160403_length_306_cov_2.574879	176	254	6	30	78	0.3846154
NODE_160475_length_306_cov_2.265700	223	278	4	44	55	0.8000000
NODE_160475_length_306_cov_2.265700	223	278	5	11	55	0.2000000
NODE_160512_length_306_cov_2.106280	73	149	0	76	76	1.0000000
NODE_160512_length_306_cov_2.106280	125	205	0	37	80	0.4625000
NODE_160512_length_306_cov_2.106280	125	205	2	14	80	0.1750000
NODE_160512_length_306_cov_2.106280	125	205	4	29	80	0.3625000
NODE_160608_length_306_cov_1.879227	165	196	0	31	31	1.0000000
NODE_160752_length_306_cov_1.478261	206	237	6	31	31	1.0000000
NODE_160761_length_306_cov_1.478261	157	220	0	63	63	1.0000000
NODE_160833_length_306_cov_1.434783	40	88	0	48	48	1.0000000
NODE_160875_length_306_cov_1.357488	128	171	0	43	43	1.0000000
NODE_160992_length_306_cov_1.222222	216	252	0	36	36	1.0000000
NODE_160992_length_306_cov_1.222222	230	305	0	75	75	1.0000000
NODE_161018_length_306_cov_1.188406	79	159	0	80	80	1.0000000
NODE_161042_length_306_cov_1.130435	122	202	0	80	80	1.0000000
NODE_161042_length_306_cov_1.130435	175	255	0	80	80	1.0000000
NODE_161078_length_306_cov_1.067633	156	188	0	32	32	1.0000000
NODE_161234_length_306_cov_0.975845	219	247	0	28	28	1.0000000
NODE_161246_length_306_cov_0.956522	206	284	1	15	78	0.1923077
NODE_161246_length_306_cov_0.956522	206	284	6	16	78	0.2051282
NODE_161246_length_306_cov_0.956522	206	284	7	8	78	0.1025641
NODE_161246_length_306_cov_0.956522	206	284	8	39	78	0.5000000
NODE_161550_length_305_cov_5.718447	177	243	0	66	66	1.0000000
NODE_161566_length_305_cov_4.854369	55	135	0	19	80	0.2375000
NODE_161566_length_305_cov_4.854369	55	135	2	23	80	0.2875000
NODE_161566_length_305_cov_4.854369	55	135	4	38	80	0.4750000
NODE_161584_length_305_cov_4.266990	186	266	0	28	80	0.3500000
NODE_161584_length_305_cov_4.266990	186	266	2	10	80	0.1250000
NODE_161584_length_305_cov_4.266990	186	266	4	42	80	0.5250000
NODE_161723_length_305_cov_2.616505	220	263	0	11	43	0.2558140
NODE_161723_length_305_cov_2.616505	220	263	1	15	43	0.3488372
NODE_161723_length_305_cov_2.616505	220	263	2	17	43	0.3953488
NODE_161723_length_305_cov_2.616505	236	305	0	19	69	0.2753623
NODE_161723_length_305_cov_2.616505	236	305	1	49	69	0.7101449
NODE_161723_length_305_cov_2.616505	236	305	2	1	69	0.0144928
NODE_161726_length_305_cov_2.597087	171	256	292	1	85	0.0117647
NODE_161726_length_305_cov_2.597087	171	256	294	2	85	0.0235294
NODE_161726_length_305_cov_2.597087	171	256	297	1	85	0.0117647
NODE_161726_length_305_cov_2.597087	171	256	301	1	85	0.0117647
NODE_161726_length_305_cov_2.597087	171	256	303	1	85	0.0117647
NODE_161726_length_305_cov_2.597087	171	256	305	1	85	0.0117647
NODE_161726_length_305_cov_2.597087	171	256	307	1	85	0.0117647
NODE_161726_length_305_cov_2.597087	171	256	308	1	85	0.0117647
NODE_161726_length_305_cov_2.597087	171	256	311	1	85	0.0117647
NODE_161726_length_305_cov_2.597087	171	256	314	1	85	0.0117647
NODE_161726_length_305_cov_2.597087	171	256	320	1	85	0.0117647
NODE_161726_length_305_cov_2.597087	171	256	321	1	85	0.0117647
NODE_161726_length_305_cov_2.597087	171	256	322	2	85	0.0235294
NODE_161726_length_305_cov_2.597087	171	256	327	1	85	0.0117647
NODE_161726_length_305_cov_2.597087	171	256	333	1	85	0.0117647
NODE_161726_length_305_cov_2.597087	171	256	337	1	85	0.0117647
NODE_161726_length_305_cov_2.597087	171	256	339	1	85	0.0117647
NODE_161726_length_305_cov_2.597087	171	256	344	1	85	0.0117647
NODE_161726_length_305_cov_2.597087	171	256	350	1	85	0.0117647
NODE_161726_length_305_cov_2.597087	171	256	353	1	85	0.0117647
NODE_161726_length_305_cov_2.597087	171	256	366	1	85	0.0117647
NODE_161726_length_305_cov_2.597087	171	256	368	1	85	0.0117647
NODE_161726_length_305_cov_2.597087	171	256	370	1	85	0.0117647
NODE_161726_length_305_cov_2.597087	171	256	379	1	85	0.0117647
NODE_161726_length_305_cov_2.597087	171	256	384	1	85	0.0117647
NODE_161726_length_305_cov_2.597087	171	256	389	3	85	0.0352941
NODE_161726_length_305_cov_2.597087	171	256	391	1	85	0.0117647
NODE_161726_length_305_cov_2.597087	171	256	398	1	85	0.0117647
NODE_161726_length_305_cov_2.597087	171	256	414	1	85	0.0117647
NODE_161726_length_305_cov_2.597087	171	256	418	1	85	0.0117647
NODE_161726_length_305_cov_2.597087	171	256	428	1	85	0.0117647
NODE_161726_length_305_cov_2.597087	171	256	432	1	85	0.0117647
NODE_161726_length_305_cov_2.597087	171	256	438	1	85	0.0117647
NODE_161726_length_305_cov_2.597087	171	256	445	1	85	0.0117647
NODE_161726_length_305_cov_2.597087	171	256	447	1	85	0.0117647
NODE_161726_length_305_cov_2.597087	171	256	460	1	85	0.0117647
NODE_161726_length_305_cov_2.597087	171	256	469	1	85	0.0117647
NODE_161726_length_305_cov_2.597087	171	256	476	1	85	0.0117647
NODE_161726_length_305_cov_2.597087	171	256	479	1	85	0.0117647
NODE_161726_length_305_cov_2.597087	171	256	487	2	85	0.0235294
NODE_161726_length_305_cov_2.597087	171	256	492	1	85	0.0117647
NODE_161726_length_305_cov_2.597087	171	256	499	1	85	0.0117647
NODE_161726_length_305_cov_2.597087	171	256	502	1	85	0.0117647
NODE_161726_length_305_cov_2.597087	171	256	511	1	85	0.0117647
NODE_161726_length_305_cov_2.597087	171	256	519	1	85	0.0117647
NODE_161726_length_305_cov_2.597087	171	256	526	2	85	0.0235294
NODE_161726_length_305_cov_2.597087	171	256	527	1	85	0.0117647
NODE_161726_length_305_cov_2.597087	171	256	531	3	85	0.0352941
NODE_161726_length_305_cov_2.597087	171	256	532	19	85	0.2235294
NODE_161726_length_305_cov_2.597087	171	256	533	1	85	0.0117647
NODE_161726_length_305_cov_2.597087	171	256	534	1	85	0.0117647
NODE_161726_length_305_cov_2.597087	171	256	535	8	85	0.0941176
NODE_161732_length_305_cov_2.533981	3	57	0	54	54	1.0000000
NODE_161775_length_305_cov_2.339806	149	237	14	2	88	0.0227273
NODE_161775_length_305_cov_2.339806	149	237	16	3	88	0.0340909
NODE_161775_length_305_cov_2.339806	149	237	18	3	88	0.0340909
NODE_161775_length_305_cov_2.339806	149	237	20	8	88	0.0909091
NODE_161775_length_305_cov_2.339806	149	237	22	32	88	0.3636364
NODE_161775_length_305_cov_2.339806	149	237	24	23	88	0.2613636
NODE_161775_length_305_cov_2.339806	149	237	26	17	88	0.1931818
NODE_161795_length_305_cov_2.228155	194	274	0	80	80	1.0000000
NODE_161795_length_305_cov_2.228155	247	300	0	53	53	1.0000000
NODE_161877_length_305_cov_1.975728	44	116	2	5	72	0.0694444
NODE_161877_length_305_cov_1.975728	44	116	4	2	72	0.0277778
NODE_161877_length_305_cov_1.975728	44	116	6	8	72	0.1111111
NODE_161877_length_305_cov_1.975728	44	116	8	19	72	0.2638889
NODE_161877_length_305_cov_1.975728	44	116	10	38	72	0.5277778
NODE_161908_length_305_cov_1.883495	135	172	44	7	37	0.1891892
NODE_161908_length_305_cov_1.883495	135	172	45	1	37	0.0270270
NODE_161908_length_305_cov_1.883495	135	172	46	9	37	0.2432432
NODE_161908_length_305_cov_1.883495	135	172	49	1	37	0.0270270
NODE_161908_length_305_cov_1.883495	135	172	51	1	37	0.0270270
NODE_161908_length_305_cov_1.883495	135	172	54	1	37	0.0270270
NODE_161908_length_305_cov_1.883495	135	172	57	1	37	0.0270270
NODE_161908_length_305_cov_1.883495	135	172	59	1	37	0.0270270
NODE_161908_length_305_cov_1.883495	135	172	63	5	37	0.1351351
NODE_161908_length_305_cov_1.883495	135	172	66	10	37	0.2702703
NODE_161990_length_305_cov_1.674757	14	80	6	20	66	0.3030303
NODE_161990_length_305_cov_1.674757	14	80	7	8	66	0.1212121
NODE_161990_length_305_cov_1.674757	14	80	13	1	66	0.0151515
NODE_161990_length_305_cov_1.674757	14	80	15	6	66	0.0909091
NODE_161990_length_305_cov_1.674757	14	80	17	4	66	0.0606061
NODE_161990_length_305_cov_1.674757	14	80	19	27	66	0.4090909
NODE_161990_length_305_cov_1.674757	53	133	19	43	80	0.5375000
NODE_161990_length_305_cov_1.674757	53	133	20	4	80	0.0500000
NODE_161990_length_305_cov_1.674757	53	133	22	23	80	0.2875000
NODE_161990_length_305_cov_1.674757	53	133	24	3	80	0.0375000
NODE_161990_length_305_cov_1.674757	53	133	26	7	80	0.0875000
NODE_161996_length_305_cov_1.655340	110	179	6	36	69	0.5217391
NODE_161996_length_305_cov_1.655340	110	179	8	33	69	0.4782609
NODE_162123_length_305_cov_1.466019	153	238	17	4	85	0.0470588
NODE_162123_length_305_cov_1.466019	153	238	19	2	85	0.0235294
NODE_162123_length_305_cov_1.466019	153	238	21	3	85	0.0352941
NODE_162123_length_305_cov_1.466019	153	238	23	5	85	0.0588235
NODE_162123_length_305_cov_1.466019	153	238	31	4	85	0.0470588
NODE_162123_length_305_cov_1.466019	153	238	33	7	85	0.0823529
NODE_162123_length_305_cov_1.466019	153	238	34	2	85	0.0235294
NODE_162123_length_305_cov_1.466019	153	238	36	3	85	0.0352941
NODE_162123_length_305_cov_1.466019	153	238	37	6	85	0.0705882
NODE_162123_length_305_cov_1.466019	153	238	38	11	85	0.1294118
NODE_162123_length_305_cov_1.466019	153	238	39	13	85	0.1529412
NODE_162123_length_305_cov_1.466019	153	238	40	15	85	0.1764706
NODE_162123_length_305_cov_1.466019	153	238	41	7	85	0.0823529
NODE_162123_length_305_cov_1.466019	153	238	42	3	85	0.0352941
NODE_162123_length_305_cov_1.466019	222	284	27	16	62	0.2580645
NODE_162123_length_305_cov_1.466019	222	284	29	1	62	0.0161290
NODE_162123_length_305_cov_1.466019	222	284	33	1	62	0.0161290
NODE_162123_length_305_cov_1.466019	222	284	35	2	62	0.0322581
NODE_162123_length_305_cov_1.466019	222	284	37	5	62	0.0806452
NODE_162123_length_305_cov_1.466019	222	284	38	11	62	0.1774193
NODE_162123_length_305_cov_1.466019	222	284	39	12	62	0.1935484
NODE_162123_length_305_cov_1.466019	222	284	40	4	62	0.0645161
NODE_162123_length_305_cov_1.466019	222	284	41	7	62	0.1129032
NODE_162123_length_305_cov_1.466019	222	284	42	3	62	0.0483871
NODE_162169_length_305_cov_1.398058	28	75	2	16	47	0.3404255
NODE_162169_length_305_cov_1.398058	28	75	6	31	47	0.6595744
NODE_162198_length_305_cov_1.330097	212	292	10	4	80	0.0500000
NODE_162198_length_305_cov_1.330097	212	292	13	2	80	0.0250000
NODE_162198_length_305_cov_1.330097	212	292	15	2	80	0.0250000
NODE_162198_length_305_cov_1.330097	212	292	17	6	80	0.0750000
NODE_162198_length_305_cov_1.330097	212	292	21	7	80	0.0875000
NODE_162198_length_305_cov_1.330097	212	292	26	1	80	0.0125000
NODE_162198_length_305_cov_1.330097	212	292	29	1	80	0.0125000
NODE_162198_length_305_cov_1.330097	212	292	31	18	80	0.2250000
NODE_162198_length_305_cov_1.330097	212	292	33	3	80	0.0375000
NODE_162198_length_305_cov_1.330097	212	292	36	3	80	0.0375000
NODE_162198_length_305_cov_1.330097	212	292	37	1	80	0.0125000
NODE_162198_length_305_cov_1.330097	212	292	38	3	80	0.0375000
NODE_162198_length_305_cov_1.330097	212	292	40	2	80	0.0250000
NODE_162198_length_305_cov_1.330097	212	292	42	3	80	0.0375000
NODE_162198_length_305_cov_1.330097	212	292	44	3	80	0.0375000
NODE_162198_length_305_cov_1.330097	212	292	45	11	80	0.1375000
NODE_162198_length_305_cov_1.330097	212	292	48	1	80	0.0125000
NODE_162198_length_305_cov_1.330097	212	292	50	2	80	0.0250000
NODE_162198_length_305_cov_1.330097	212	292	51	7	80	0.0875000
NODE_162198_length_305_cov_1.330097	265	305	2	3	40	0.0750000
NODE_162198_length_305_cov_1.330097	265	305	7	1	40	0.0250000
NODE_162198_length_305_cov_1.330097	265	305	9	9	40	0.2250000
NODE_162198_length_305_cov_1.330097	265	305	10	4	40	0.1000000
NODE_162198_length_305_cov_1.330097	265	305	13	2	40	0.0500000
NODE_162198_length_305_cov_1.330097	265	305	15	2	40	0.0500000
NODE_162198_length_305_cov_1.330097	265	305	17	6	40	0.1500000
NODE_162198_length_305_cov_1.330097	265	305	21	7	40	0.1750000
NODE_162198_length_305_cov_1.330097	265	305	26	1	40	0.0250000
NODE_162198_length_305_cov_1.330097	265	305	29	1	40	0.0250000
NODE_162198_length_305_cov_1.330097	265	305	31	4	40	0.1000000
NODE_162359_length_305_cov_1.111650	245	275	0	30	30	1.0000000
NODE_162411_length_305_cov_0.990291	46	126	4	80	80	1.0000000
NODE_162593_length_305_cov_0.873786	73	109	0	36	36	1.0000000
NODE_162782_length_305_cov_0.631068	86	166	0	72	80	0.9000000
NODE_162782_length_305_cov_0.631068	86	166	2	8	80	0.1000000
NODE_162782_length_305_cov_0.631068	139	186	0	19	47	0.4042553
NODE_162782_length_305_cov_0.631068	139	186	2	28	47	0.5957447
NODE_162854_length_304_cov_44.482927	61	102	77	3	41	0.0731707
NODE_162854_length_304_cov_44.482927	61	102	79	1	41	0.0243902
NODE_162854_length_304_cov_44.482927	61	102	81	3	41	0.0731707
NODE_162854_length_304_cov_44.482927	61	102	83	2	41	0.0487805
NODE_162854_length_304_cov_44.482927	61	102	87	5	41	0.1219512
NODE_162854_length_304_cov_44.482927	61	102	89	1	41	0.0243902
NODE_162854_length_304_cov_44.482927	61	102	91	4	41	0.0975610
NODE_162854_length_304_cov_44.482927	61	102	92	2	41	0.0487805
NODE_162854_length_304_cov_44.482927	61	102	94	1	41	0.0243902
NODE_162854_length_304_cov_44.482927	61	102	95	3	41	0.0731707
NODE_162854_length_304_cov_44.482927	61	102	97	4	41	0.0975610
NODE_162854_length_304_cov_44.482927	61	102	99	4	41	0.0975610
NODE_162854_length_304_cov_44.482927	61	102	105	2	41	0.0487805
NODE_162854_length_304_cov_44.482927	61	102	106	5	41	0.1219512
NODE_162854_length_304_cov_44.482927	61	102	107	1	41	0.0243902
NODE_162855_length_304_cov_30.678049	205	281	0	76	76	1.0000000
NODE_162855_length_304_cov_30.678049	254	304	0	50	50	1.0000000
NODE_162886_length_304_cov_4.956098	72	152	6	5	80	0.0625000
NODE_162886_length_304_cov_4.956098	72	152	8	1	80	0.0125000
NODE_162886_length_304_cov_4.956098	72	152	10	19	80	0.2375000
NODE_162886_length_304_cov_4.956098	72	152	14	5	80	0.0625000
NODE_162886_length_304_cov_4.956098	72	152	16	4	80	0.0500000
NODE_162886_length_304_cov_4.956098	72	152	20	12	80	0.1500000
NODE_162886_length_304_cov_4.956098	72	152	22	34	80	0.4250000
NODE_162919_length_304_cov_3.980488	46	126	0	80	80	1.0000000
NODE_162919_length_304_cov_3.980488	99	179	0	80	80	1.0000000
NODE_162932_length_304_cov_3.809756	108	156	8	13	48	0.2708333
NODE_162932_length_304_cov_3.809756	108	156	10	7	48	0.1458333
NODE_162932_length_304_cov_3.809756	108	156	12	28	48	0.5833333
NODE_162955_length_304_cov_3.424390	67	129	0	32	62	0.5161290
NODE_162955_length_304_cov_3.424390	67	129	4	16	62	0.2580645
NODE_162955_length_304_cov_3.424390	67	129	6	14	62	0.2258064
NODE_162955_length_304_cov_3.424390	120	182	6	36	62	0.5806451
NODE_162955_length_304_cov_3.424390	120	182	8	26	62	0.4193548
NODE_162997_length_304_cov_2.980488	105	126	0	21	21	1.0000000
NODE_163048_length_304_cov_2.629268	106	186	20	35	80	0.4375000
NODE_163048_length_304_cov_2.629268	106	186	21	1	80	0.0125000
NODE_163048_length_304_cov_2.629268	106	186	22	4	80	0.0500000
NODE_163048_length_304_cov_2.629268	106	186	25	2	80	0.0250000
NODE_163048_length_304_cov_2.629268	106	186	26	38	80	0.4750000
NODE_163048_length_304_cov_2.629268	159	209	4	1	50	0.0200000
NODE_163048_length_304_cov_2.629268	159	209	16	5	50	0.1000000
NODE_163048_length_304_cov_2.629268	159	209	19	10	50	0.2000000
NODE_163048_length_304_cov_2.629268	159	209	20	1	50	0.0200000
NODE_163048_length_304_cov_2.629268	159	209	21	7	50	0.1400000
NODE_163048_length_304_cov_2.629268	159	209	22	3	50	0.0600000
NODE_163048_length_304_cov_2.629268	159	209	25	2	50	0.0400000
NODE_163048_length_304_cov_2.629268	159	209	26	21	50	0.4200000
NODE_163116_length_304_cov_2.239024	57	137	6	16	80	0.2000000
NODE_163116_length_304_cov_2.239024	57	137	8	64	80	0.8000000
NODE_163116_length_304_cov_2.239024	110	152	4	15	42	0.3571429
NODE_163116_length_304_cov_2.239024	110	152	6	16	42	0.3809524
NODE_163116_length_304_cov_2.239024	110	152	8	11	42	0.2619048
NODE_163148_length_304_cov_2.170732	112	145	0	17	33	0.5151515
NODE_163148_length_304_cov_2.170732	112	145	6	8	33	0.2424242
NODE_163148_length_304_cov_2.170732	112	145	8	8	33	0.2424242
NODE_163148_length_304_cov_2.170732	146	198	8	52	52	1.0000000
NODE_163333_length_304_cov_1.687805	219	288	0	69	69	1.0000000
NODE_163432_length_304_cov_1.492683	190	238	0	48	48	1.0000000
NODE_163559_length_304_cov_1.287805	99	165	6	9	66	0.1363636
NODE_163559_length_304_cov_1.287805	99	165	8	5	66	0.0757576
NODE_163559_length_304_cov_1.287805	99	165	13	1	66	0.0151515
NODE_163559_length_304_cov_1.287805	99	165	14	44	66	0.6666667
NODE_163559_length_304_cov_1.287805	99	165	22	3	66	0.0454545
NODE_163559_length_304_cov_1.287805	99	165	24	4	66	0.0606061
NODE_163670_length_304_cov_1.175610	0	30	0	30	30	1.0000000
NODE_163895_length_304_cov_0.951220	70	150	12	1	80	0.0125000
NODE_163895_length_304_cov_0.951220	70	150	13	5	80	0.0625000
NODE_163895_length_304_cov_0.951220	70	150	16	56	80	0.7000000
NODE_163895_length_304_cov_0.951220	70	150	18	5	80	0.0625000
NODE_163895_length_304_cov_0.951220	70	150	19	9	80	0.1125000
NODE_163895_length_304_cov_0.951220	70	150	20	4	80	0.0500000
NODE_164171_length_303_cov_30.843137	46	97	0	51	51	1.0000000
NODE_164194_length_303_cov_5.401961	33	79	0	35	46	0.7608696
NODE_164194_length_303_cov_5.401961	33	79	4	11	46	0.2391304
NODE_164224_length_303_cov_4.210784	136	205	2	28	69	0.4057971
NODE_164224_length_303_cov_4.210784	136	205	6	41	69	0.5942029
NODE_164224_length_303_cov_4.210784	178	259	0	17	81	0.2098765
NODE_164224_length_303_cov_4.210784	178	259	2	64	81	0.7901235
NODE_164251_length_303_cov_3.671569	9	75	0	1	66	0.0151515
NODE_164251_length_303_cov_3.671569	9	75	2	55	66	0.8333333
NODE_164251_length_303_cov_3.671569	9	75	4	10	66	0.1515152
NODE_164251_length_303_cov_3.671569	48	128	2	28	80	0.3500000
NODE_164251_length_303_cov_3.671569	48	128	4	52	80	0.6500000
NODE_164251_length_303_cov_3.671569	48	128	2	28	80	0.3500000
NODE_164251_length_303_cov_3.671569	48	128	4	52	80	0.6500000
NODE_164251_length_303_cov_3.671569	220	300	0	1	80	0.0125000
NODE_164251_length_303_cov_3.671569	220	300	2	79	80	0.9875000
NODE_164267_length_303_cov_3.500000	55	123	0	68	68	1.0000000
NODE_164272_length_303_cov_3.460784	0	67	1	1	67	0.0149254
NODE_164272_length_303_cov_3.460784	0	67	2	1	67	0.0149254
NODE_164272_length_303_cov_3.460784	0	67	6	3	67	0.0447761
NODE_164272_length_303_cov_3.460784	0	67	8	3	67	0.0447761
NODE_164272_length_303_cov_3.460784	0	67	9	4	67	0.0597015
NODE_164272_length_303_cov_3.460784	0	67	11	1	67	0.0149254
NODE_164272_length_303_cov_3.460784	0	67	13	1	67	0.0149254
NODE_164272_length_303_cov_3.460784	0	67	15	2	67	0.0298507
NODE_164272_length_303_cov_3.460784	0	67	17	1	67	0.0149254
NODE_164272_length_303_cov_3.460784	0	67	19	4	67	0.0597015
NODE_164272_length_303_cov_3.460784	0	67	24	1	67	0.0149254
NODE_164272_length_303_cov_3.460784	0	67	25	2	67	0.0298507
NODE_164272_length_303_cov_3.460784	0	67	27	1	67	0.0149254
NODE_164272_length_303_cov_3.460784	0	67	29	2	67	0.0298507
NODE_164272_length_303_cov_3.460784	0	67	33	1	67	0.0149254
NODE_164272_length_303_cov_3.460784	0	67	34	1	67	0.0149254
NODE_164272_length_303_cov_3.460784	0	67	41	1	67	0.0149254
NODE_164272_length_303_cov_3.460784	0	67	45	1	67	0.0149254
NODE_164272_length_303_cov_3.460784	0	67	52	1	67	0.0149254
NODE_164272_length_303_cov_3.460784	0	67	56	1	67	0.0149254
NODE_164272_length_303_cov_3.460784	0	67	63	5	67	0.0746269
NODE_164272_length_303_cov_3.460784	0	67	64	1	67	0.0149254
NODE_164272_length_303_cov_3.460784	0	67	70	3	67	0.0447761
NODE_164272_length_303_cov_3.460784	0	67	71	1	67	0.0149254
NODE_164272_length_303_cov_3.460784	0	67	73	1	67	0.0149254
NODE_164272_length_303_cov_3.460784	0	67	74	2	67	0.0298507
NODE_164272_length_303_cov_3.460784	0	67	76	2	67	0.0298507
NODE_164272_length_303_cov_3.460784	0	67	77	2	67	0.0298507
NODE_164272_length_303_cov_3.460784	0	67	83	2	67	0.0298507
NODE_164272_length_303_cov_3.460784	0	67	92	1	67	0.0149254
NODE_164272_length_303_cov_3.460784	0	67	100	1	67	0.0149254
NODE_164272_length_303_cov_3.460784	0	67	102	1	67	0.0149254
NODE_164272_length_303_cov_3.460784	0	67	111	1	67	0.0149254
NODE_164272_length_303_cov_3.460784	0	67	115	3	67	0.0447761
NODE_164272_length_303_cov_3.460784	0	67	116	1	67	0.0149254
NODE_164272_length_303_cov_3.460784	0	67	118	1	67	0.0149254
NODE_164272_length_303_cov_3.460784	0	67	120	1	67	0.0149254
NODE_164272_length_303_cov_3.460784	0	67	133	1	67	0.0149254
NODE_164272_length_303_cov_3.460784	0	67	134	2	67	0.0298507
NODE_164272_length_303_cov_3.460784	0	67	137	1	67	0.0149254
NODE_164272_length_303_cov_3.460784	0	67	140	1	67	0.0149254
NODE_164272_length_303_cov_3.460784	98	178	235	1	80	0.0125000
NODE_164272_length_303_cov_3.460784	98	178	246	1	80	0.0125000
NODE_164272_length_303_cov_3.460784	98	178	262	1	80	0.0125000
NODE_164272_length_303_cov_3.460784	98	178	266	1	80	0.0125000
NODE_164272_length_303_cov_3.460784	98	178	279	1	80	0.0125000
NODE_164272_length_303_cov_3.460784	98	178	281	1	80	0.0125000
NODE_164272_length_303_cov_3.460784	98	178	285	2	80	0.0250000
NODE_164272_length_303_cov_3.460784	98	178	288	1	80	0.0125000
NODE_164272_length_303_cov_3.460784	98	178	295	1	80	0.0125000
NODE_164272_length_303_cov_3.460784	98	178	298	1	80	0.0125000
NODE_164272_length_303_cov_3.460784	98	178	300	1	80	0.0125000
NODE_164272_length_303_cov_3.460784	98	178	306	2	80	0.0250000
NODE_164272_length_303_cov_3.460784	98	178	312	1	80	0.0125000
NODE_164272_length_303_cov_3.460784	98	178	318	1	80	0.0125000
NODE_164272_length_303_cov_3.460784	98	178	324	1	80	0.0125000
NODE_164272_length_303_cov_3.460784	98	178	334	1	80	0.0125000
NODE_164272_length_303_cov_3.460784	98	178	335	1	80	0.0125000
NODE_164272_length_303_cov_3.460784	98	178	337	2	80	0.0250000
NODE_164272_length_303_cov_3.460784	98	178	338	1	80	0.0125000
NODE_164272_length_303_cov_3.460784	98	178	339	2	80	0.0250000
NODE_164272_length_303_cov_3.460784	98	178	345	1	80	0.0125000
NODE_164272_length_303_cov_3.460784	98	178	350	1	80	0.0125000
NODE_164272_length_303_cov_3.460784	98	178	352	1	80	0.0125000
NODE_164272_length_303_cov_3.460784	98	178	355	1	80	0.0125000
NODE_164272_length_303_cov_3.460784	98	178	359	2	80	0.0250000
NODE_164272_length_303_cov_3.460784	98	178	363	1	80	0.0125000
NODE_164272_length_303_cov_3.460784	98	178	364	1	80	0.0125000
NODE_164272_length_303_cov_3.460784	98	178	367	1	80	0.0125000
NODE_164272_length_303_cov_3.460784	98	178	370	1	80	0.0125000
NODE_164272_length_303_cov_3.460784	98	178	373	1	80	0.0125000
NODE_164272_length_303_cov_3.460784	98	178	374	2	80	0.0250000
NODE_164272_length_303_cov_3.460784	98	178	380	1	80	0.0125000
NODE_164272_length_303_cov_3.460784	98	178	382	1	80	0.0125000
NODE_164272_length_303_cov_3.460784	98	178	387	1	80	0.0125000
NODE_164272_length_303_cov_3.460784	98	178	393	2	80	0.0250000
NODE_164272_length_303_cov_3.460784	98	178	397	2	80	0.0250000
NODE_164272_length_303_cov_3.460784	98	178	398	1	80	0.0125000
NODE_164272_length_303_cov_3.460784	98	178	403	3	80	0.0375000
NODE_164272_length_303_cov_3.460784	98	178	405	1	80	0.0125000
NODE_164272_length_303_cov_3.460784	98	178	407	6	80	0.0750000
NODE_164272_length_303_cov_3.460784	98	178	409	4	80	0.0500000
NODE_164272_length_303_cov_3.460784	98	178	410	1	80	0.0125000
NODE_164272_length_303_cov_3.460784	98	178	411	1	80	0.0125000
NODE_164272_length_303_cov_3.460784	98	178	412	2	80	0.0250000
NODE_164272_length_303_cov_3.460784	98	178	413	1	80	0.0125000
NODE_164272_length_303_cov_3.460784	98	178	415	4	80	0.0500000
NODE_164272_length_303_cov_3.460784	98	178	417	2	80	0.0250000
NODE_164272_length_303_cov_3.460784	98	178	419	1	80	0.0125000
NODE_164272_length_303_cov_3.460784	98	178	421	1	80	0.0125000
NODE_164272_length_303_cov_3.460784	98	178	423	1	80	0.0125000
NODE_164272_length_303_cov_3.460784	98	178	430	2	80	0.0250000
NODE_164272_length_303_cov_3.460784	98	178	432	3	80	0.0375000
NODE_164272_length_303_cov_3.460784	98	178	434	1	80	0.0125000
NODE_164272_length_303_cov_3.460784	98	178	438	1	80	0.0125000
NODE_164272_length_303_cov_3.460784	151	191	407	2	40	0.0500000
NODE_164272_length_303_cov_3.460784	151	191	409	4	40	0.1000000
NODE_164272_length_303_cov_3.460784	151	191	410	1	40	0.0250000
NODE_164272_length_303_cov_3.460784	151	191	411	1	40	0.0250000
NODE_164272_length_303_cov_3.460784	151	191	412	2	40	0.0500000
NODE_164272_length_303_cov_3.460784	151	191	413	1	40	0.0250000
NODE_164272_length_303_cov_3.460784	151	191	415	7	40	0.1750000
NODE_164272_length_303_cov_3.460784	151	191	416	1	40	0.0250000
NODE_164272_length_303_cov_3.460784	151	191	417	2	40	0.0500000
NODE_164272_length_303_cov_3.460784	151	191	419	2	40	0.0500000
NODE_164272_length_303_cov_3.460784	151	191	421	4	40	0.1000000
NODE_164272_length_303_cov_3.460784	151	191	423	1	40	0.0250000
NODE_164272_length_303_cov_3.460784	151	191	424	1	40	0.0250000
NODE_164272_length_303_cov_3.460784	151	191	428	1	40	0.0250000
NODE_164272_length_303_cov_3.460784	151	191	429	2	40	0.0500000
NODE_164272_length_303_cov_3.460784	151	191	430	2	40	0.0500000
NODE_164272_length_303_cov_3.460784	151	191	432	4	40	0.1000000
NODE_164272_length_303_cov_3.460784	151	191	434	1	40	0.0250000
NODE_164272_length_303_cov_3.460784	151	191	438	1	40	0.0250000
NODE_164283_length_303_cov_3.352941	77	146	0	69	69	1.0000000
NODE_164433_length_303_cov_2.284314	78	158	0	80	80	1.0000000
NODE_164433_length_303_cov_2.284314	215	295	0	18	80	0.2250000
NODE_164433_length_303_cov_2.284314	215	295	2	62	80	0.7750000
NODE_164581_length_303_cov_1.848039	90	170	0	80	80	1.0000000
NODE_164581_length_303_cov_1.848039	143	223	0	80	80	1.0000000
NODE_164581_length_303_cov_1.848039	212	235	0	23	23	1.0000000
NODE_164668_length_303_cov_1.686275	62	88	0	26	26	1.0000000
NODE_164695_length_303_cov_1.583333	206	270	0	64	64	1.0000000
NODE_164800_length_303_cov_1.475490	155	221	0	66	66	1.0000000
NODE_164846_length_303_cov_1.392157	135	213	24	3	78	0.0384615
NODE_164846_length_303_cov_1.392157	135	213	25	3	78	0.0384615
NODE_164846_length_303_cov_1.392157	135	213	27	18	78	0.2307692
NODE_164846_length_303_cov_1.392157	135	213	28	24	78	0.3076923
NODE_164846_length_303_cov_1.392157	135	213	30	30	78	0.3846154
NODE_164878_length_303_cov_1.318627	0	75	0	75	75	1.0000000
NODE_164974_length_303_cov_1.215686	278	297	0	19	19	1.0000000
NODE_165498_length_302_cov_10.852217	266	300	0	34	34	1.0000000
NODE_165502_length_302_cov_7.896552	46	131	0	85	85	1.0000000
NODE_165502_length_302_cov_7.896552	104	160	0	56	56	1.0000000
NODE_165505_length_302_cov_7.266010	135	191	0	56	56	1.0000000
NODE_165507_length_302_cov_7.216749	93	149	0	8	56	0.1428571
NODE_165507_length_302_cov_7.216749	93	149	2	48	56	0.8571429
NODE_165507_length_302_cov_7.216749	155	226	0	71	71	1.0000000
NODE_165517_length_302_cov_6.172414	179	243	0	64	64	1.0000000
NODE_165517_length_302_cov_6.172414	232	287	0	55	55	1.0000000
NODE_165528_length_302_cov_5.586207	221	293	6	3	72	0.0416667
NODE_165528_length_302_cov_5.586207	221	293	10	5	72	0.0694444
NODE_165528_length_302_cov_5.586207	221	293	12	35	72	0.4861111
NODE_165528_length_302_cov_5.586207	221	293	14	1	72	0.0138889
NODE_165528_length_302_cov_5.586207	221	293	17	1	72	0.0138889
NODE_165528_length_302_cov_5.586207	221	293	19	4	72	0.0555556
NODE_165528_length_302_cov_5.586207	221	293	23	1	72	0.0138889
NODE_165528_length_302_cov_5.586207	221	293	25	1	72	0.0138889
NODE_165528_length_302_cov_5.586207	221	293	27	1	72	0.0138889
NODE_165528_length_302_cov_5.586207	221	293	31	5	72	0.0694444
NODE_165528_length_302_cov_5.586207	221	293	33	2	72	0.0277778
NODE_165528_length_302_cov_5.586207	221	293	35	4	72	0.0555556
NODE_165528_length_302_cov_5.586207	221	293	37	9	72	0.1250000
NODE_165641_length_302_cov_2.985222	104	186	20	1	82	0.0121951
NODE_165641_length_302_cov_2.985222	104	186	23	1	82	0.0121951
NODE_165641_length_302_cov_2.985222	104	186	24	2	82	0.0243902
NODE_165641_length_302_cov_2.985222	104	186	25	2	82	0.0243902
NODE_165641_length_302_cov_2.985222	104	186	26	2	82	0.0243902
NODE_165641_length_302_cov_2.985222	104	186	27	1	82	0.0121951
NODE_165641_length_302_cov_2.985222	104	186	28	1	82	0.0121951
NODE_165641_length_302_cov_2.985222	104	186	30	2	82	0.0243902
NODE_165641_length_302_cov_2.985222	104	186	40	4	82	0.0487805
NODE_165641_length_302_cov_2.985222	104	186	46	18	82	0.2195122
NODE_165641_length_302_cov_2.985222	104	186	48	36	82	0.4390244
NODE_165641_length_302_cov_2.985222	104	186	50	2	82	0.0243902
NODE_165641_length_302_cov_2.985222	104	186	52	4	82	0.0487805
NODE_165641_length_302_cov_2.985222	104	186	53	1	82	0.0121951
NODE_165641_length_302_cov_2.985222	104	186	54	5	82	0.0609756
NODE_165848_length_302_cov_2.009852	12	34	0	22	22	1.0000000
NODE_165934_length_302_cov_1.758621	98	152	4	54	54	1.0000000
NODE_165945_length_302_cov_1.758621	230	294	0	58	64	0.9062500
NODE_165945_length_302_cov_1.758621	230	294	2	6	64	0.0937500
NODE_166007_length_302_cov_1.620690	172	232	4	7	60	0.1166667
NODE_166007_length_302_cov_1.620690	172	232	5	2	60	0.0333333
NODE_166007_length_302_cov_1.620690	172	232	8	15	60	0.2500000
NODE_166007_length_302_cov_1.620690	172	232	9	4	60	0.0666667
NODE_166007_length_302_cov_1.620690	172	232	10	32	60	0.5333334
NODE_166007_length_302_cov_1.620690	225	277	2	7	52	0.1346154
NODE_166007_length_302_cov_1.620690	225	277	4	45	52	0.8653846
NODE_166320_length_302_cov_1.172414	34	103	0	69	69	1.0000000
NODE_166381_length_302_cov_1.044335	54	130	0	54	76	0.7105263
NODE_166381_length_302_cov_1.044335	54	130	2	22	76	0.2894737
NODE_166617_length_302_cov_0.847291	94	172	19	1	78	0.0128205
NODE_166617_length_302_cov_0.847291	94	172	21	1	78	0.0128205
NODE_166617_length_302_cov_0.847291	94	172	25	1	78	0.0128205
NODE_166617_length_302_cov_0.847291	94	172	29	4	78	0.0512821
NODE_166617_length_302_cov_0.847291	94	172	31	2	78	0.0256410
NODE_166617_length_302_cov_0.847291	94	172	33	1	78	0.0128205
NODE_166617_length_302_cov_0.847291	94	172	35	1	78	0.0128205
NODE_166617_length_302_cov_0.847291	94	172	39	1	78	0.0128205
NODE_166617_length_302_cov_0.847291	94	172	41	1	78	0.0128205
NODE_166617_length_302_cov_0.847291	94	172	43	2	78	0.0256410
NODE_166617_length_302_cov_0.847291	94	172	45	4	78	0.0512821
NODE_166617_length_302_cov_0.847291	94	172	50	6	78	0.0769231
NODE_166617_length_302_cov_0.847291	94	172	52	11	78	0.1410256
NODE_166617_length_302_cov_0.847291	94	172	54	2	78	0.0256410
NODE_166617_length_302_cov_0.847291	94	172	56	1	78	0.0128205
NODE_166617_length_302_cov_0.847291	94	172	57	8	78	0.1025641
NODE_166617_length_302_cov_0.847291	94	172	61	1	78	0.0128205
NODE_166617_length_302_cov_0.847291	94	172	63	6	78	0.0769231
NODE_166617_length_302_cov_0.847291	94	172	65	3	78	0.0384615
NODE_166617_length_302_cov_0.847291	94	172	69	1	78	0.0128205
NODE_166617_length_302_cov_0.847291	94	172	71	10	78	0.1282051
NODE_166617_length_302_cov_0.847291	94	172	73	3	78	0.0384615
NODE_166617_length_302_cov_0.847291	94	172	75	1	78	0.0128205
NODE_166617_length_302_cov_0.847291	94	172	77	1	78	0.0128205
NODE_166617_length_302_cov_0.847291	94	172	79	5	78	0.0641026
NODE_166617_length_302_cov_0.847291	94	172	19	1	78	0.0128205
NODE_166617_length_302_cov_0.847291	94	172	21	1	78	0.0128205
NODE_166617_length_302_cov_0.847291	94	172	25	1	78	0.0128205
NODE_166617_length_302_cov_0.847291	94	172	29	4	78	0.0512821
NODE_166617_length_302_cov_0.847291	94	172	31	2	78	0.0256410
NODE_166617_length_302_cov_0.847291	94	172	33	1	78	0.0128205
NODE_166617_length_302_cov_0.847291	94	172	35	1	78	0.0128205
NODE_166617_length_302_cov_0.847291	94	172	39	1	78	0.0128205
NODE_166617_length_302_cov_0.847291	94	172	41	1	78	0.0128205
NODE_166617_length_302_cov_0.847291	94	172	43	2	78	0.0256410
NODE_166617_length_302_cov_0.847291	94	172	45	4	78	0.0512821
NODE_166617_length_302_cov_0.847291	94	172	50	6	78	0.0769231
NODE_166617_length_302_cov_0.847291	94	172	52	11	78	0.1410256
NODE_166617_length_302_cov_0.847291	94	172	54	2	78	0.0256410
NODE_166617_length_302_cov_0.847291	94	172	56	1	78	0.0128205
NODE_166617_length_302_cov_0.847291	94	172	57	8	78	0.1025641
NODE_166617_length_302_cov_0.847291	94	172	61	1	78	0.0128205
NODE_166617_length_302_cov_0.847291	94	172	63	6	78	0.0769231
NODE_166617_length_302_cov_0.847291	94	172	65	3	78	0.0384615
NODE_166617_length_302_cov_0.847291	94	172	69	1	78	0.0128205
NODE_166617_length_302_cov_0.847291	94	172	71	10	78	0.1282051
NODE_166617_length_302_cov_0.847291	94	172	73	3	78	0.0384615
NODE_166617_length_302_cov_0.847291	94	172	75	1	78	0.0128205
NODE_166617_length_302_cov_0.847291	94	172	77	1	78	0.0128205
NODE_166617_length_302_cov_0.847291	94	172	79	5	78	0.0641026
NODE_166617_length_302_cov_0.847291	103	172	33	1	69	0.0144928
NODE_166617_length_302_cov_0.847291	103	172	35	1	69	0.0144928
NODE_166617_length_302_cov_0.847291	103	172	39	1	69	0.0144928
NODE_166617_length_302_cov_0.847291	103	172	41	1	69	0.0144928
NODE_166617_length_302_cov_0.847291	103	172	43	2	69	0.0289855
NODE_166617_length_302_cov_0.847291	103	172	45	4	69	0.0579710
NODE_166617_length_302_cov_0.847291	103	172	50	6	69	0.0869565
NODE_166617_length_302_cov_0.847291	103	172	52	11	69	0.1594203
NODE_166617_length_302_cov_0.847291	103	172	54	2	69	0.0289855
NODE_166617_length_302_cov_0.847291	103	172	56	1	69	0.0144928
NODE_166617_length_302_cov_0.847291	103	172	57	8	69	0.1159420
NODE_166617_length_302_cov_0.847291	103	172	61	1	69	0.0144928
NODE_166617_length_302_cov_0.847291	103	172	63	6	69	0.0869565
NODE_166617_length_302_cov_0.847291	103	172	65	3	69	0.0434783
NODE_166617_length_302_cov_0.847291	103	172	69	1	69	0.0144928
NODE_166617_length_302_cov_0.847291	103	172	71	10	69	0.1449275
NODE_166617_length_302_cov_0.847291	103	172	73	3	69	0.0434783
NODE_166617_length_302_cov_0.847291	103	172	75	1	69	0.0144928
NODE_166617_length_302_cov_0.847291	103	172	77	1	69	0.0144928
NODE_166617_length_302_cov_0.847291	103	172	79	5	69	0.0724638
NODE_166638_length_302_cov_0.807882	97	177	0	80	80	1.0000000
NODE_166819_length_301_cov_6.960396	268	299	0	31	31	1.0000000
NODE_166827_length_301_cov_6.148515	214	283	0	69	69	1.0000000
NODE_166889_length_301_cov_3.747525	116	196	5	47	80	0.5875000
NODE_166889_length_301_cov_3.747525	116	196	7	17	80	0.2125000
NODE_166889_length_301_cov_3.747525	116	196	8	16	80	0.2000000
NODE_166904_length_301_cov_3.509901	217	277	5	1	60	0.0166667
NODE_166904_length_301_cov_3.509901	217	277	7	9	60	0.1500000
NODE_166904_length_301_cov_3.509901	217	277	11	2	60	0.0333333
NODE_166904_length_301_cov_3.509901	217	277	13	2	60	0.0333333
NODE_166904_length_301_cov_3.509901	217	277	15	2	60	0.0333333
NODE_166904_length_301_cov_3.509901	217	277	21	1	60	0.0166667
NODE_166904_length_301_cov_3.509901	217	277	22	1	60	0.0166667
NODE_166904_length_301_cov_3.509901	217	277	27	3	60	0.0500000
NODE_166904_length_301_cov_3.509901	217	277	29	5	60	0.0833333
NODE_166904_length_301_cov_3.509901	217	277	31	1	60	0.0166667
NODE_166904_length_301_cov_3.509901	217	277	37	2	60	0.0333333
NODE_166904_length_301_cov_3.509901	217	277	40	3	60	0.0500000
NODE_166904_length_301_cov_3.509901	217	277	43	1	60	0.0166667
NODE_166904_length_301_cov_3.509901	217	277	45	1	60	0.0166667
NODE_166904_length_301_cov_3.509901	217	277	48	2	60	0.0333333
NODE_166904_length_301_cov_3.509901	217	277	51	2	60	0.0333333
NODE_166904_length_301_cov_3.509901	217	277	53	1	60	0.0166667
NODE_166904_length_301_cov_3.509901	217	277	58	1	60	0.0166667
NODE_166904_length_301_cov_3.509901	217	277	59	2	60	0.0333333
NODE_166904_length_301_cov_3.509901	217	277	61	1	60	0.0166667
NODE_166904_length_301_cov_3.509901	217	277	63	1	60	0.0166667
NODE_166904_length_301_cov_3.509901	217	277	65	1	60	0.0166667
NODE_166904_length_301_cov_3.509901	217	277	66	1	60	0.0166667
NODE_166904_length_301_cov_3.509901	217	277	72	5	60	0.0833333
NODE_166904_length_301_cov_3.509901	217	277	76	1	60	0.0166667
NODE_166904_length_301_cov_3.509901	217	277	82	1	60	0.0166667
NODE_166904_length_301_cov_3.509901	217	277	84	2	60	0.0333333
NODE_166904_length_301_cov_3.509901	217	277	88	1	60	0.0166667
NODE_166904_length_301_cov_3.509901	217	277	90	4	60	0.0666667
NODE_166993_length_301_cov_2.653465	133	213	0	44	80	0.5500000
NODE_166993_length_301_cov_2.653465	133	213	6	5	80	0.0625000
NODE_166993_length_301_cov_2.653465	133	213	8	6	80	0.0750000
NODE_166993_length_301_cov_2.653465	133	213	12	2	80	0.0250000
NODE_166993_length_301_cov_2.653465	133	213	14	1	80	0.0125000
NODE_166993_length_301_cov_2.653465	133	213	16	22	80	0.2750000
NODE_167126_length_301_cov_2.084158	178	258	38	1	80	0.0125000
NODE_167126_length_301_cov_2.084158	178	258	40	1	80	0.0125000
NODE_167126_length_301_cov_2.084158	178	258	43	1	80	0.0125000
NODE_167126_length_301_cov_2.084158	178	258	44	5	80	0.0625000
NODE_167126_length_301_cov_2.084158	178	258	46	2	80	0.0250000
NODE_167126_length_301_cov_2.084158	178	258	48	1	80	0.0125000
NODE_167126_length_301_cov_2.084158	178	258	52	1	80	0.0125000
NODE_167126_length_301_cov_2.084158	178	258	54	1	80	0.0125000
NODE_167126_length_301_cov_2.084158	178	258	56	1	80	0.0125000
NODE_167126_length_301_cov_2.084158	178	258	60	1	80	0.0125000
NODE_167126_length_301_cov_2.084158	178	258	62	1	80	0.0125000
NODE_167126_length_301_cov_2.084158	178	258	64	17	80	0.2125000
NODE_167126_length_301_cov_2.084158	178	258	66	28	80	0.3500000
NODE_167126_length_301_cov_2.084158	178	258	68	19	80	0.2375000
NODE_167215_length_301_cov_1.831683	111	175	0	63	64	0.9843750
NODE_167215_length_301_cov_1.831683	111	175	1	1	64	0.0156250
NODE_167215_length_301_cov_1.831683	164	228	0	64	64	1.0000000
NODE_167308_length_301_cov_1.603960	173	233	3	20	60	0.3333333
NODE_167308_length_301_cov_1.603960	173	233	5	40	60	0.6666667
NODE_167313_length_301_cov_1.584158	30	108	0	19	78	0.2435897
NODE_167313_length_301_cov_1.584158	30	108	2	1	78	0.0128205
NODE_167313_length_301_cov_1.584158	30	108	3	16	78	0.2051282
NODE_167313_length_301_cov_1.584158	30	108	4	42	78	0.5384616
NODE_167434_length_301_cov_1.470297	90	165	0	75	75	1.0000000
NODE_167508_length_301_cov_1.326733	175	247	4	28	72	0.3888889
NODE_167508_length_301_cov_1.326733	175	247	6	44	72	0.6111111
NODE_167612_length_301_cov_1.247525	29	73	0	44	44	1.0000000
NODE_167642_length_301_cov_1.183168	123	203	6	4	80	0.0500000
NODE_167642_length_301_cov_1.183168	123	203	8	19	80	0.2375000
NODE_167642_length_301_cov_1.183168	123	203	10	9	80	0.1125000
NODE_167642_length_301_cov_1.183168	123	203	12	5	80	0.0625000
NODE_167642_length_301_cov_1.183168	123	203	14	3	80	0.0375000
NODE_167642_length_301_cov_1.183168	123	203	16	3	80	0.0375000
NODE_167642_length_301_cov_1.183168	123	203	18	37	80	0.4625000
NODE_167659_length_301_cov_1.163366	10	83	0	73	73	1.0000000
NODE_167659_length_301_cov_1.163366	91	121	0	30	30	1.0000000
NODE_167668_length_301_cov_1.148515	161	209	0	48	48	1.0000000
NODE_167880_length_301_cov_0.980198	242	297	0	55	55	1.0000000
NODE_167891_length_301_cov_0.960396	22	63	0	41	41	1.0000000
NODE_168253_length_300_cov_3.402985	44	124	0	23	80	0.2875000
NODE_168253_length_300_cov_3.402985	44	124	2	57	80	0.7125000
NODE_168253_length_300_cov_3.402985	97	177	0	25	80	0.3125000
NODE_168253_length_300_cov_3.402985	97	177	2	55	80	0.6875000
NODE_168253_length_300_cov_3.402985	173	254	2	24	81	0.2962963
NODE_168253_length_300_cov_3.402985	173	254	4	11	81	0.1358025
NODE_168253_length_300_cov_3.402985	173	254	8	14	81	0.1728395
NODE_168253_length_300_cov_3.402985	173	254	10	32	81	0.3950617
NODE_168253_length_300_cov_3.402985	233	300	0	3	67	0.0447761
NODE_168253_length_300_cov_3.402985	233	300	2	2	67	0.0298507
NODE_168253_length_300_cov_3.402985	233	300	10	62	67	0.9253731
NODE_168265_length_300_cov_3.298507	18	98	0	80	80	1.0000000
NODE_168360_length_300_cov_2.597015	110	182	33	11	72	0.1527778
NODE_168360_length_300_cov_2.597015	110	182	35	1	72	0.0138889
NODE_168360_length_300_cov_2.597015	110	182	37	4	72	0.0555556
NODE_168360_length_300_cov_2.597015	110	182	39	56	72	0.7777778
NODE_168363_length_300_cov_2.572139	28	102	2	9	74	0.1216216
NODE_168363_length_300_cov_2.572139	28	102	3	2	74	0.0270270
NODE_168363_length_300_cov_2.572139	28	102	4	3	74	0.0405405
NODE_168363_length_300_cov_2.572139	28	102	5	1	74	0.0135135
NODE_168363_length_300_cov_2.572139	28	102	6	2	74	0.0270270
NODE_168363_length_300_cov_2.572139	28	102	7	2	74	0.0270270
NODE_168363_length_300_cov_2.572139	28	102	8	5	74	0.0675676
NODE_168363_length_300_cov_2.572139	28	102	10	8	74	0.1081081
NODE_168363_length_300_cov_2.572139	28	102	12	1	74	0.0135135
NODE_168363_length_300_cov_2.572139	28	102	16	12	74	0.1621622
NODE_168363_length_300_cov_2.572139	28	102	18	3	74	0.0405405
NODE_168363_length_300_cov_2.572139	28	102	22	8	74	0.1081081
NODE_168363_length_300_cov_2.572139	28	102	24	2	74	0.0270270
NODE_168363_length_300_cov_2.572139	28	102	28	7	74	0.0945946
NODE_168363_length_300_cov_2.572139	28	102	30	9	74	0.1216216
NODE_168363_length_300_cov_2.572139	75	141	18	1	66	0.0151515
NODE_168363_length_300_cov_2.572139	75	141	22	8	66	0.1212121
NODE_168363_length_300_cov_2.572139	75	141	24	2	66	0.0303030
NODE_168363_length_300_cov_2.572139	75	141	28	7	66	0.1060606
NODE_168363_length_300_cov_2.572139	75	141	30	11	66	0.1666667
NODE_168363_length_300_cov_2.572139	75	141	32	37	66	0.5606061
NODE_168402_length_300_cov_2.417910	0	44	0	44	44	1.0000000
NODE_168459_length_300_cov_2.174129	117	197	6	6	80	0.0750000
NODE_168459_length_300_cov_2.174129	117	197	7	3	80	0.0375000
NODE_168459_length_300_cov_2.174129	117	197	8	7	80	0.0875000
NODE_168459_length_300_cov_2.174129	117	197	9	6	80	0.0750000
NODE_168459_length_300_cov_2.174129	117	197	10	4	80	0.0500000
NODE_168459_length_300_cov_2.174129	117	197	12	5	80	0.0625000
NODE_168459_length_300_cov_2.174129	117	197	13	2	80	0.0250000
NODE_168459_length_300_cov_2.174129	117	197	14	5	80	0.0625000
NODE_168459_length_300_cov_2.174129	117	197	15	5	80	0.0625000
NODE_168459_length_300_cov_2.174129	117	197	16	32	80	0.4000000
NODE_168459_length_300_cov_2.174129	117	197	18	5	80	0.0625000
NODE_168459_length_300_cov_2.174129	170	250	16	22	80	0.2750000
NODE_168459_length_300_cov_2.174129	170	250	18	9	80	0.1125000
NODE_168459_length_300_cov_2.174129	170	250	20	11	80	0.1375000
NODE_168459_length_300_cov_2.174129	170	250	22	1	80	0.0125000
NODE_168459_length_300_cov_2.174129	170	250	36	2	80	0.0250000
NODE_168459_length_300_cov_2.174129	170	250	40	1	80	0.0125000
NODE_168459_length_300_cov_2.174129	170	250	42	1	80	0.0125000
NODE_168459_length_300_cov_2.174129	170	250	48	1	80	0.0125000
NODE_168459_length_300_cov_2.174129	170	250	53	1	80	0.0125000
NODE_168459_length_300_cov_2.174129	170	250	54	2	80	0.0250000
NODE_168459_length_300_cov_2.174129	170	250	61	1	80	0.0125000
NODE_168459_length_300_cov_2.174129	170	250	62	3	80	0.0375000
NODE_168459_length_300_cov_2.174129	170	250	68	1	80	0.0125000
NODE_168459_length_300_cov_2.174129	170	250	72	5	80	0.0625000
NODE_168459_length_300_cov_2.174129	170	250	74	11	80	0.1375000
NODE_168459_length_300_cov_2.174129	170	250	76	8	80	0.1000000
NODE_168459_length_300_cov_2.174129	216	296	42	1	80	0.0125000
NODE_168459_length_300_cov_2.174129	216	296	48	1	80	0.0125000
NODE_168459_length_300_cov_2.174129	216	296	49	1	80	0.0125000
NODE_168459_length_300_cov_2.174129	216	296	53	1	80	0.0125000
NODE_168459_length_300_cov_2.174129	216	296	54	2	80	0.0250000
NODE_168459_length_300_cov_2.174129	216	296	55	1	80	0.0125000
NODE_168459_length_300_cov_2.174129	216	296	61	1	80	0.0125000
NODE_168459_length_300_cov_2.174129	216	296	62	3	80	0.0375000
NODE_168459_length_300_cov_2.174129	216	296	65	3	80	0.0375000
NODE_168459_length_300_cov_2.174129	216	296	66	2	80	0.0250000
NODE_168459_length_300_cov_2.174129	216	296	68	3	80	0.0375000
NODE_168459_length_300_cov_2.174129	216	296	70	2	80	0.0250000
NODE_168459_length_300_cov_2.174129	216	296	72	18	80	0.2250000
NODE_168459_length_300_cov_2.174129	216	296	74	33	80	0.4125000
NODE_168459_length_300_cov_2.174129	216	296	76	8	80	0.1000000
NODE_168462_length_300_cov_2.164179	122	141	0	19	19	1.0000000
NODE_168479_length_300_cov_2.079602	127	207	4	24	80	0.3000000
NODE_168479_length_300_cov_2.079602	127	207	6	36	80	0.4500000
NODE_168479_length_300_cov_2.079602	127	207	8	20	80	0.2500000
NODE_168479_length_300_cov_2.079602	203	273	1	15	70	0.2142857
NODE_168479_length_300_cov_2.079602	203	273	2	20	70	0.2857143
NODE_168479_length_300_cov_2.079602	203	273	4	12	70	0.1714286
NODE_168479_length_300_cov_2.079602	203	273	6	23	70	0.3285714
NODE_168541_length_300_cov_1.965174	15	86	0	71	71	1.0000000
NODE_168656_length_300_cov_1.731343	31	88	24	4	57	0.0701754
NODE_168656_length_300_cov_1.731343	31	88	30	15	57	0.2631579
NODE_168656_length_300_cov_1.731343	31	88	34	38	57	0.6666667
NODE_168906_length_300_cov_1.268657	62	98	0	36	36	1.0000000
NODE_168906_length_300_cov_1.268657	151	186	0	35	35	1.0000000
NODE_169014_length_300_cov_1.104478	86	165	2	4	79	0.0506329
NODE_169014_length_300_cov_1.104478	86	165	4	1	79	0.0126582
NODE_169014_length_300_cov_1.104478	86	165	6	2	79	0.0253165
NODE_169014_length_300_cov_1.104478	86	165	10	2	79	0.0253165
NODE_169014_length_300_cov_1.104478	86	165	12	9	79	0.1139240
NODE_169014_length_300_cov_1.104478	86	165	14	1	79	0.0126582
NODE_169014_length_300_cov_1.104478	86	165	16	50	79	0.6329114
NODE_169014_length_300_cov_1.104478	86	165	18	10	79	0.1265823
NODE_169053_length_300_cov_1.029851	110	177	0	15	67	0.2238806
NODE_169053_length_300_cov_1.029851	110	177	2	37	67	0.5522388
NODE_169053_length_300_cov_1.029851	110	177	4	10	67	0.1492537
NODE_169053_length_300_cov_1.029851	110	177	6	5	67	0.0746269
NODE_169053_length_300_cov_1.029851	120	177	0	15	57	0.2631579
NODE_169053_length_300_cov_1.029851	120	177	2	37	57	0.6491228
NODE_169053_length_300_cov_1.029851	120	177	4	5	57	0.0877193
NODE_169378_length_300_cov_0.716418	191	210	0	19	19	1.0000000
NODE_169528_length_299_cov_4.435000	48	128	4	80	80	1.0000000
NODE_169528_length_299_cov_4.435000	101	167	2	14	66	0.2121212
NODE_169528_length_299_cov_4.435000	101	167	4	52	66	0.7878788
NODE_169567_length_299_cov_3.780000	114	181	2	67	67	1.0000000
NODE_169631_length_299_cov_3.095000	0	73	0	73	73	1.0000000
NODE_169631_length_299_cov_3.095000	0	20	0	20	20	1.0000000
NODE_169725_length_299_cov_2.495000	46	126	0	1	80	0.0125000
NODE_169725_length_299_cov_2.495000	46	126	2	18	80	0.2250000
NODE_169725_length_299_cov_2.495000	46	126	4	40	80	0.5000000
NODE_169725_length_299_cov_2.495000	46	126	6	21	80	0.2625000
NODE_169725_length_299_cov_2.495000	99	179	0	11	80	0.1375000
NODE_169725_length_299_cov_2.495000	99	179	2	24	80	0.3000000
NODE_169725_length_299_cov_2.495000	99	179	4	32	80	0.4000000
NODE_169725_length_299_cov_2.495000	99	179	6	13	80	0.1625000
NODE_169769_length_299_cov_2.275000	127	192	0	31	65	0.4769231
NODE_169769_length_299_cov_2.275000	127	192	2	34	65	0.5230770
NODE_169781_length_299_cov_2.250000	72	135	2	63	63	1.0000000
NODE_169781_length_299_cov_2.250000	108	188	0	13	80	0.1625000
NODE_169781_length_299_cov_2.250000	108	188	2	67	80	0.8375000
NODE_169811_length_299_cov_2.090000	25	105	0	80	80	1.0000000
NODE_169888_length_299_cov_1.955000	173	214	7	1	41	0.0243902
NODE_169888_length_299_cov_1.955000	173	214	9	5	41	0.1219512
NODE_169888_length_299_cov_1.955000	173	214	10	3	41	0.0731707
NODE_169888_length_299_cov_1.955000	173	214	11	4	41	0.0975610
NODE_169888_length_299_cov_1.955000	173	214	13	4	41	0.0975610
NODE_169888_length_299_cov_1.955000	173	214	15	8	41	0.1951219
NODE_169888_length_299_cov_1.955000	173	214	17	16	41	0.3902439
NODE_169888_length_299_cov_1.955000	187	227	13	3	40	0.0750000
NODE_169888_length_299_cov_1.955000	187	227	15	8	40	0.2000000
NODE_169888_length_299_cov_1.955000	187	227	17	29	40	0.7250000
NODE_169916_length_299_cov_1.885000	29	109	2	7	80	0.0875000
NODE_169916_length_299_cov_1.885000	29	109	4	5	80	0.0625000
NODE_169916_length_299_cov_1.885000	29	109	5	1	80	0.0125000
NODE_169916_length_299_cov_1.885000	29	109	6	21	80	0.2625000
NODE_169916_length_299_cov_1.885000	29	109	8	41	80	0.5125000
NODE_169916_length_299_cov_1.885000	29	109	10	5	80	0.0625000
NODE_169920_length_299_cov_1.880000	204	236	0	2	32	0.0625000
NODE_169920_length_299_cov_1.880000	204	236	2	30	32	0.9375000
NODE_169938_length_299_cov_1.840000	154	190	0	36	36	1.0000000
NODE_169995_length_299_cov_1.710000	211	291	0	80	80	1.0000000
NODE_170048_length_299_cov_1.550000	174	205	6	31	31	1.0000000
NODE_170501_length_299_cov_1.020000	42	115	0	25	73	0.3424658
NODE_170501_length_299_cov_1.020000	42	115	2	48	73	0.6575342
NODE_170546_length_299_cov_1.020000	132	175	4	43	43	1.0000000
NODE_170620_length_299_cov_0.935000	173	216	4	2	43	0.0465116
NODE_170620_length_299_cov_0.935000	173	216	8	1	43	0.0232558
NODE_170620_length_299_cov_0.935000	173	216	10	40	43	0.9302326
NODE_170691_length_299_cov_0.765000	86	128	0	42	42	1.0000000
NODE_170887_length_298_cov_20.894472	70	150	0	80	80	1.0000000
NODE_170887_length_298_cov_20.894472	123	203	0	80	80	1.0000000
NODE_170888_length_298_cov_13.859296	228	298	6	9	70	0.1285714
NODE_170888_length_298_cov_13.859296	228	298	8	3	70	0.0428571
NODE_170888_length_298_cov_13.859296	228	298	13	3	70	0.0428571
NODE_170888_length_298_cov_13.859296	228	298	14	2	70	0.0285714
NODE_170888_length_298_cov_13.859296	228	298	16	1	70	0.0142857
NODE_170888_length_298_cov_13.859296	228	298	18	1	70	0.0142857
NODE_170888_length_298_cov_13.859296	228	298	22	2	70	0.0285714
NODE_170888_length_298_cov_13.859296	228	298	24	2	70	0.0285714
NODE_170888_length_298_cov_13.859296	228	298	25	2	70	0.0285714
NODE_170888_length_298_cov_13.859296	228	298	26	1	70	0.0142857
NODE_170888_length_298_cov_13.859296	228	298	29	7	70	0.1000000
NODE_170888_length_298_cov_13.859296	228	298	31	1	70	0.0142857
NODE_170888_length_298_cov_13.859296	228	298	33	2	70	0.0285714
NODE_170888_length_298_cov_13.859296	228	298	37	3	70	0.0428571
NODE_170888_length_298_cov_13.859296	228	298	39	4	70	0.0571429
NODE_170888_length_298_cov_13.859296	228	298	41	5	70	0.0714286
NODE_170888_length_298_cov_13.859296	228	298	43	1	70	0.0142857
NODE_170888_length_298_cov_13.859296	228	298	45	3	70	0.0428571
NODE_170888_length_298_cov_13.859296	228	298	49	9	70	0.1285714
NODE_170888_length_298_cov_13.859296	228	298	53	1	70	0.0142857
NODE_170888_length_298_cov_13.859296	228	298	55	4	70	0.0571429
NODE_170888_length_298_cov_13.859296	228	298	56	4	70	0.0571429
NODE_170909_length_298_cov_5.859296	1	65	0	1	64	0.0156250
NODE_170909_length_298_cov_5.859296	1	65	6	4	64	0.0625000
NODE_170909_length_298_cov_5.859296	1	65	10	4	64	0.0625000
NODE_170909_length_298_cov_5.859296	1	65	12	11	64	0.1718750
NODE_170909_length_298_cov_5.859296	1	65	14	12	64	0.1875000
NODE_170909_length_298_cov_5.859296	1	65	16	6	64	0.0937500
NODE_170909_length_298_cov_5.859296	1	65	17	4	64	0.0625000
NODE_170909_length_298_cov_5.859296	1	65	19	1	64	0.0156250
NODE_170909_length_298_cov_5.859296	1	65	21	14	64	0.2187500
NODE_170909_length_298_cov_5.859296	1	65	22	7	64	0.1093750
NODE_170909_length_298_cov_5.859296	38	118	16	11	80	0.1375000
NODE_170909_length_298_cov_5.859296	38	118	17	4	80	0.0500000
NODE_170909_length_298_cov_5.859296	38	118	18	16	80	0.2000000
NODE_170909_length_298_cov_5.859296	38	118	19	1	80	0.0125000
NODE_170909_length_298_cov_5.859296	38	118	20	7	80	0.0875000
NODE_170909_length_298_cov_5.859296	38	118	21	14	80	0.1750000
NODE_170909_length_298_cov_5.859296	38	118	22	27	80	0.3375000
NODE_170909_length_298_cov_5.859296	114	194	6	5	80	0.0625000
NODE_170909_length_298_cov_5.859296	114	194	7	27	80	0.3375000
NODE_170909_length_298_cov_5.859296	114	194	8	14	80	0.1750000
NODE_170909_length_298_cov_5.859296	114	194	12	6	80	0.0750000
NODE_170909_length_298_cov_5.859296	114	194	13	4	80	0.0500000
NODE_170909_length_298_cov_5.859296	114	194	14	18	80	0.2250000
NODE_170909_length_298_cov_5.859296	114	194	18	6	80	0.0750000
NODE_170909_length_298_cov_5.859296	167	238	6	7	71	0.0985916
NODE_170909_length_298_cov_5.859296	167	238	7	41	71	0.5774648
NODE_170909_length_298_cov_5.859296	167	238	8	23	71	0.3239437
NODE_170964_length_298_cov_3.829146	80	160	30	2	80	0.0250000
NODE_170964_length_298_cov_3.829146	80	160	31	11	80	0.1375000
NODE_170964_length_298_cov_3.829146	80	160	32	7	80	0.0875000
NODE_170964_length_298_cov_3.829146	80	160	35	11	80	0.1375000
NODE_170964_length_298_cov_3.829146	80	160	36	1	80	0.0125000
NODE_170964_length_298_cov_3.829146	80	160	37	1	80	0.0125000
NODE_170964_length_298_cov_3.829146	80	160	38	3	80	0.0375000
NODE_170964_length_298_cov_3.829146	80	160	39	1	80	0.0125000
NODE_170964_length_298_cov_3.829146	80	160	41	1	80	0.0125000
NODE_170964_length_298_cov_3.829146	80	160	42	4	80	0.0500000
NODE_170964_length_298_cov_3.829146	80	160	43	24	80	0.3000000
NODE_170964_length_298_cov_3.829146	80	160	44	7	80	0.0875000
NODE_170964_length_298_cov_3.829146	80	160	46	3	80	0.0375000
NODE_170964_length_298_cov_3.829146	80	160	50	4	80	0.0500000
NODE_170964_length_298_cov_3.829146	133	213	23	4	80	0.0500000
NODE_170964_length_298_cov_3.829146	133	213	25	4	80	0.0500000
NODE_170964_length_298_cov_3.829146	133	213	27	10	80	0.1250000
NODE_170964_length_298_cov_3.829146	133	213	29	3	80	0.0375000
NODE_170964_length_298_cov_3.829146	133	213	33	1	80	0.0125000
NODE_170964_length_298_cov_3.829146	133	213	34	2	80	0.0250000
NODE_170964_length_298_cov_3.829146	133	213	35	17	80	0.2125000
NODE_170964_length_298_cov_3.829146	133	213	36	1	80	0.0125000
NODE_170964_length_298_cov_3.829146	133	213	37	5	80	0.0625000
NODE_170964_length_298_cov_3.829146	133	213	38	3	80	0.0375000
NODE_170964_length_298_cov_3.829146	133	213	39	1	80	0.0125000
NODE_170964_length_298_cov_3.829146	133	213	40	2	80	0.0250000
NODE_170964_length_298_cov_3.829146	133	213	41	1	80	0.0125000
NODE_170964_length_298_cov_3.829146	133	213	42	5	80	0.0625000
NODE_170964_length_298_cov_3.829146	133	213	43	3	80	0.0375000
NODE_170964_length_298_cov_3.829146	133	213	44	3	80	0.0375000
NODE_170964_length_298_cov_3.829146	133	213	46	3	80	0.0375000
NODE_170964_length_298_cov_3.829146	133	213	47	5	80	0.0625000
NODE_170964_length_298_cov_3.829146	133	213	49	2	80	0.0250000
NODE_170964_length_298_cov_3.829146	133	213	50	5	80	0.0625000
NODE_170968_length_298_cov_3.733668	203	283	0	80	80	1.0000000
NODE_170972_length_298_cov_3.673367	117	175	9	2	58	0.0344828
NODE_170972_length_298_cov_3.673367	117	175	10	7	58	0.1206897
NODE_170972_length_298_cov_3.673367	117	175	11	21	58	0.3620690
NODE_170972_length_298_cov_3.673367	117	175	12	1	58	0.0172414
NODE_170972_length_298_cov_3.673367	117	175	14	18	58	0.3103448
NODE_170972_length_298_cov_3.673367	117	175	16	9	58	0.1551724
NODE_171043_length_298_cov_2.924623	159	239	0	31	80	0.3875000
NODE_171043_length_298_cov_2.924623	159	239	1	5	80	0.0625000
NODE_171043_length_298_cov_2.924623	159	239	2	13	80	0.1625000
NODE_171043_length_298_cov_2.924623	159	239	3	9	80	0.1125000
NODE_171043_length_298_cov_2.924623	159	239	4	1	80	0.0125000
NODE_171043_length_298_cov_2.924623	159	239	6	3	80	0.0375000
NODE_171043_length_298_cov_2.924623	159	239	7	9	80	0.1125000
NODE_171043_length_298_cov_2.924623	159	239	8	4	80	0.0500000
NODE_171043_length_298_cov_2.924623	159	239	11	1	80	0.0125000
NODE_171043_length_298_cov_2.924623	159	239	12	4	80	0.0500000
NODE_171043_length_298_cov_2.924623	212	265	0	53	53	1.0000000
NODE_171047_length_298_cov_2.854271	50	120	0	70	70	1.0000000
NODE_171082_length_298_cov_2.663317	87	167	4	70	80	0.8750000
NODE_171082_length_298_cov_2.663317	87	167	6	10	80	0.1250000
NODE_171082_length_298_cov_2.663317	140	192	2	1	52	0.0192308
NODE_171082_length_298_cov_2.663317	140	192	4	51	52	0.9807692
NODE_171191_length_298_cov_2.201005	112	166	0	54	54	1.0000000
NODE_171210_length_298_cov_2.120603	135	166	0	31	31	1.0000000
NODE_171226_length_298_cov_2.055276	69	132	2	38	63	0.6031746
NODE_171226_length_298_cov_2.055276	69	132	3	25	63	0.3968254
NODE_171286_length_298_cov_2.025126	21	92	0	71	71	1.0000000
NODE_171356_length_298_cov_1.798995	0	67	0	6	67	0.0895522
NODE_171356_length_298_cov_1.798995	0	67	2	14	67	0.2089552
NODE_171356_length_298_cov_1.798995	0	67	4	4	67	0.0597015
NODE_171356_length_298_cov_1.798995	0	67	6	43	67	0.6417910
NODE_171356_length_298_cov_1.798995	40	106	2	5	66	0.0757576
NODE_171356_length_298_cov_1.798995	40	106	4	9	66	0.1363636
NODE_171356_length_298_cov_1.798995	40	106	6	52	66	0.7878788
NODE_171391_length_298_cov_1.788945	140	197	0	57	57	1.0000000
NODE_171415_length_298_cov_1.733668	56	91	15	5	35	0.1428571
NODE_171415_length_298_cov_1.733668	56	91	17	1	35	0.0285714
NODE_171415_length_298_cov_1.733668	56	91	19	1	35	0.0285714
NODE_171415_length_298_cov_1.733668	56	91	21	4	35	0.1142857
NODE_171415_length_298_cov_1.733668	56	91	22	16	35	0.4571429
NODE_171415_length_298_cov_1.733668	56	91	24	8	35	0.2285714
NODE_171415_length_298_cov_1.733668	118	172	8	6	54	0.1111111
NODE_171415_length_298_cov_1.733668	118	172	10	15	54	0.2777778
NODE_171415_length_298_cov_1.733668	118	172	12	1	54	0.0185185
NODE_171415_length_298_cov_1.733668	118	172	16	11	54	0.2037037
NODE_171415_length_298_cov_1.733668	118	172	18	11	54	0.2037037
NODE_171415_length_298_cov_1.733668	118	172	20	6	54	0.1111111
NODE_171415_length_298_cov_1.733668	118	172	22	2	54	0.0370370
NODE_171415_length_298_cov_1.733668	118	172	24	2	54	0.0370370
NODE_171505_length_298_cov_1.537688	101	154	0	53	53	1.0000000
NODE_172083_length_298_cov_0.829146	34	96	0	62	62	1.0000000
NODE_172330_length_297_cov_6.525253	100	122	6	8	22	0.3636364
NODE_172330_length_297_cov_6.525253	100	122	8	14	22	0.6363636
NODE_172352_length_297_cov_4.888889	150	218	0	2	68	0.0294118
NODE_172352_length_297_cov_4.888889	150	218	2	5	68	0.0735294
NODE_172352_length_297_cov_4.888889	150	218	4	47	68	0.6911765
NODE_172352_length_297_cov_4.888889	150	218	6	8	68	0.1176471
NODE_172352_length_297_cov_4.888889	150	218	8	6	68	0.0882353
NODE_172356_length_297_cov_4.671717	56	120	0	34	64	0.5312500
NODE_172356_length_297_cov_4.671717	56	120	1	1	64	0.0156250
NODE_172356_length_297_cov_4.671717	56	120	2	29	64	0.4531250
NODE_172422_length_297_cov_3.338384	96	176	1	16	80	0.2000000
NODE_172422_length_297_cov_3.338384	96	176	2	64	80	0.8000000
NODE_172422_length_297_cov_3.338384	149	198	1	38	49	0.7755102
NODE_172422_length_297_cov_3.338384	149	198	2	11	49	0.2244898
NODE_172447_length_297_cov_3.040404	0	55	0	55	55	1.0000000
NODE_172447_length_297_cov_3.040404	14	55	0	41	41	1.0000000
NODE_172447_length_297_cov_3.040404	65	119	0	54	54	1.0000000
NODE_172574_length_297_cov_2.308081	8	70	0	62	62	1.0000000
NODE_172606_length_297_cov_2.196970	219	259	116	2	40	0.0500000
NODE_172606_length_297_cov_2.196970	219	259	120	1	40	0.0250000
NODE_172606_length_297_cov_2.196970	219	259	124	3	40	0.0750000
NODE_172606_length_297_cov_2.196970	219	259	129	1	40	0.0250000
NODE_172606_length_297_cov_2.196970	219	259	133	2	40	0.0500000
NODE_172606_length_297_cov_2.196970	219	259	144	1	40	0.0250000
NODE_172606_length_297_cov_2.196970	219	259	145	1	40	0.0250000
NODE_172606_length_297_cov_2.196970	219	259	147	1	40	0.0250000
NODE_172606_length_297_cov_2.196970	219	259	157	1	40	0.0250000
NODE_172606_length_297_cov_2.196970	219	259	158	3	40	0.0750000
NODE_172606_length_297_cov_2.196970	219	259	161	1	40	0.0250000
NODE_172606_length_297_cov_2.196970	219	259	169	1	40	0.0250000
NODE_172606_length_297_cov_2.196970	219	259	178	1	40	0.0250000
NODE_172606_length_297_cov_2.196970	219	259	182	1	40	0.0250000
NODE_172606_length_297_cov_2.196970	219	259	183	2	40	0.0500000
NODE_172606_length_297_cov_2.196970	219	259	192	2	40	0.0500000
NODE_172606_length_297_cov_2.196970	219	259	196	3	40	0.0750000
NODE_172606_length_297_cov_2.196970	219	259	197	5	40	0.1250000
NODE_172606_length_297_cov_2.196970	219	259	199	1	40	0.0250000
NODE_172606_length_297_cov_2.196970	219	259	200	7	40	0.1750000
NODE_172629_length_297_cov_2.106061	81	161	2	18	80	0.2250000
NODE_172629_length_297_cov_2.106061	81	161	4	6	80	0.0750000
NODE_172629_length_297_cov_2.106061	81	161	6	8	80	0.1000000
NODE_172629_length_297_cov_2.106061	81	161	8	48	80	0.6000000
NODE_172629_length_297_cov_2.106061	134	178	2	28	44	0.6363636
NODE_172629_length_297_cov_2.106061	134	178	4	13	44	0.2954545
NODE_172629_length_297_cov_2.106061	134	178	6	1	44	0.0227273
NODE_172629_length_297_cov_2.106061	134	178	8	2	44	0.0454545
NODE_172668_length_297_cov_2.060606	46	76	0	30	30	1.0000000
NODE_172697_length_297_cov_2.010101	9	85	16	6	76	0.0789474
NODE_172697_length_297_cov_2.010101	9	85	18	1	76	0.0131579
NODE_172697_length_297_cov_2.010101	9	85	20	2	76	0.0263158
NODE_172697_length_297_cov_2.010101	9	85	22	13	76	0.1710526
NODE_172697_length_297_cov_2.010101	9	85	24	54	76	0.7105263
NODE_172783_length_297_cov_1.777778	168	208	13	2	40	0.0500000
NODE_172783_length_297_cov_1.777778	168	208	14	1	40	0.0250000
NODE_172783_length_297_cov_1.777778	168	208	15	4	40	0.1000000
NODE_172783_length_297_cov_1.777778	168	208	16	5	40	0.1250000
NODE_172783_length_297_cov_1.777778	168	208	18	2	40	0.0500000
NODE_172783_length_297_cov_1.777778	168	208	19	5	40	0.1250000
NODE_172783_length_297_cov_1.777778	168	208	23	5	40	0.1250000
NODE_172783_length_297_cov_1.777778	168	208	25	16	40	0.4000000
NODE_172855_length_297_cov_1.595960	175	255	15	1	80	0.0125000
NODE_172855_length_297_cov_1.595960	175	255	17	2	80	0.0250000
NODE_172855_length_297_cov_1.595960	175	255	19	1	80	0.0125000
NODE_172855_length_297_cov_1.595960	175	255	21	6	80	0.0750000
NODE_172855_length_297_cov_1.595960	175	255	23	1	80	0.0125000
NODE_172855_length_297_cov_1.595960	175	255	25	4	80	0.0500000
NODE_172855_length_297_cov_1.595960	175	255	27	5	80	0.0625000
NODE_172855_length_297_cov_1.595960	175	255	29	4	80	0.0500000
NODE_172855_length_297_cov_1.595960	175	255	31	1	80	0.0125000
NODE_172855_length_297_cov_1.595960	175	255	33	2	80	0.0250000
NODE_172855_length_297_cov_1.595960	175	255	41	1	80	0.0125000
NODE_172855_length_297_cov_1.595960	175	255	43	3	80	0.0375000
NODE_172855_length_297_cov_1.595960	175	255	45	5	80	0.0625000
NODE_172855_length_297_cov_1.595960	175	255	46	1	80	0.0125000
NODE_172855_length_297_cov_1.595960	175	255	50	2	80	0.0250000
NODE_172855_length_297_cov_1.595960	175	255	58	4	80	0.0500000
NODE_172855_length_297_cov_1.595960	175	255	60	4	80	0.0500000
NODE_172855_length_297_cov_1.595960	175	255	64	1	80	0.0125000
NODE_172855_length_297_cov_1.595960	175	255	68	8	80	0.1000000
NODE_172855_length_297_cov_1.595960	175	255	70	13	80	0.1625000
NODE_172855_length_297_cov_1.595960	175	255	72	11	80	0.1375000
NODE_172862_length_297_cov_1.570707	100	177	0	2	77	0.0259740
NODE_172862_length_297_cov_1.570707	100	177	2	66	77	0.8571429
NODE_172862_length_297_cov_1.570707	100	177	4	9	77	0.1168831
NODE_172863_length_297_cov_1.570707	194	275	1	81	81	1.0000000
NODE_173063_length_297_cov_1.338384	140	199	0	30	59	0.5084746
NODE_173063_length_297_cov_1.338384	140	199	2	29	59	0.4915254
NODE_173136_length_297_cov_1.277778	39	115	0	58	76	0.7631579
NODE_173136_length_297_cov_1.277778	39	115	2	18	76	0.2368421
NODE_173176_length_297_cov_1.196970	7	87	0	30	80	0.3750000
NODE_173176_length_297_cov_1.196970	7	87	2	50	80	0.6250000
NODE_173176_length_297_cov_1.196970	60	116	2	56	56	1.0000000
NODE_173345_length_297_cov_1.030303	0	33	0	33	33	1.0000000
NODE_173467_length_297_cov_0.888889	109	172	0	63	63	1.0000000
NODE_173520_length_297_cov_0.782828	24	104	0	4	80	0.0500000
NODE_173520_length_297_cov_0.782828	24	104	1	76	80	0.9500000
NODE_173708_length_296_cov_41.390863	189	260	19	3	71	0.0422535
NODE_173708_length_296_cov_41.390863	189	260	21	5	71	0.0704225
NODE_173708_length_296_cov_41.390863	189	260	23	7	71	0.0985916
NODE_173708_length_296_cov_41.390863	189	260	25	12	71	0.1690141
NODE_173708_length_296_cov_41.390863	189	260	26	9	71	0.1267606
NODE_173708_length_296_cov_41.390863	189	260	27	14	71	0.1971831
NODE_173708_length_296_cov_41.390863	189	260	28	5	71	0.0704225
NODE_173708_length_296_cov_41.390863	189	260	30	14	71	0.1971831
NODE_173708_length_296_cov_41.390863	189	260	32	2	71	0.0281690
NODE_173709_length_296_cov_34.776650	214	294	0	80	80	1.0000000
NODE_173758_length_296_cov_4.243655	14	54	0	35	40	0.8750000
NODE_173758_length_296_cov_4.243655	14	54	2	5	40	0.1250000
NODE_173773_length_296_cov_3.954315	120	200	0	80	80	1.0000000
NODE_173787_length_296_cov_3.736041	6	46	0	40	40	1.0000000
NODE_173797_length_296_cov_3.619289	193	251	4	2	58	0.0344828
NODE_173797_length_296_cov_3.619289	193	251	10	56	58	0.9655172
NODE_173797_length_296_cov_3.619289	246	296	4	47	50	0.9400000
NODE_173797_length_296_cov_3.619289	246	296	10	3	50	0.0600000
NODE_173859_length_296_cov_3.015228	177	257	0	1	80	0.0125000
NODE_173859_length_296_cov_3.015228	177	257	4	8	80	0.1000000
NODE_173859_length_296_cov_3.015228	177	257	6	6	80	0.0750000
NODE_173859_length_296_cov_3.015228	177	257	8	10	80	0.1250000
NODE_173859_length_296_cov_3.015228	177	257	10	55	80	0.6875000
NODE_173992_length_296_cov_2.309645	5	77	6	11	72	0.1527778
NODE_173992_length_296_cov_2.309645	5	77	9	8	72	0.1111111
NODE_173992_length_296_cov_2.309645	5	77	11	3	72	0.0416667
NODE_173992_length_296_cov_2.309645	5	77	15	2	72	0.0277778
NODE_173992_length_296_cov_2.309645	5	77	17	5	72	0.0694444
NODE_173992_length_296_cov_2.309645	5	77	20	8	72	0.1111111
NODE_173992_length_296_cov_2.309645	5	77	22	4	72	0.0555556
NODE_173992_length_296_cov_2.309645	5	77	24	14	72	0.1944444
NODE_173992_length_296_cov_2.309645	5	77	27	1	72	0.0138889
NODE_173992_length_296_cov_2.309645	5	77	28	2	72	0.0277778
NODE_173992_length_296_cov_2.309645	5	77	30	2	72	0.0277778
NODE_173992_length_296_cov_2.309645	5	77	32	7	72	0.0972222
NODE_173992_length_296_cov_2.309645	5	77	34	3	72	0.0416667
NODE_173992_length_296_cov_2.309645	5	77	36	2	72	0.0277778
NODE_173992_length_296_cov_2.309645	50	130	24	10	80	0.1250000
NODE_173992_length_296_cov_2.309645	50	130	27	1	80	0.0125000
NODE_173992_length_296_cov_2.309645	50	130	28	2	80	0.0250000
NODE_173992_length_296_cov_2.309645	50	130	30	2	80	0.0250000
NODE_173992_length_296_cov_2.309645	50	130	32	7	80	0.0875000
NODE_173992_length_296_cov_2.309645	50	130	34	3	80	0.0375000
NODE_173992_length_296_cov_2.309645	50	130	36	5	80	0.0625000
NODE_173992_length_296_cov_2.309645	50	130	38	8	80	0.1000000
NODE_173992_length_296_cov_2.309645	50	130	40	16	80	0.2000000
NODE_173992_length_296_cov_2.309645	50	130	42	1	80	0.0125000
NODE_173992_length_296_cov_2.309645	50	130	44	3	80	0.0375000
NODE_173992_length_296_cov_2.309645	50	130	46	2	80	0.0250000
NODE_173992_length_296_cov_2.309645	50	130	47	1	80	0.0125000
NODE_173992_length_296_cov_2.309645	50	130	49	14	80	0.1750000
NODE_173992_length_296_cov_2.309645	50	130	50	3	80	0.0375000
NODE_173992_length_296_cov_2.309645	50	130	52	2	80	0.0250000
NODE_174040_length_296_cov_2.081218	90	139	0	49	49	1.0000000
NODE_174167_length_296_cov_1.807107	199	246	0	47	47	1.0000000
NODE_174167_length_296_cov_1.807107	219	296	0	77	77	1.0000000
NODE_174213_length_296_cov_1.670051	28	103	8	5	75	0.0666667
NODE_174213_length_296_cov_1.670051	28	103	10	5	75	0.0666667
NODE_174213_length_296_cov_1.670051	28	103	12	23	75	0.3066667
NODE_174213_length_296_cov_1.670051	28	103	14	21	75	0.2800000
NODE_174213_length_296_cov_1.670051	28	103	16	21	75	0.2800000
NODE_174274_length_296_cov_1.553299	102	179	0	7	77	0.0909091
NODE_174274_length_296_cov_1.553299	102	179	4	70	77	0.9090909
NODE_174274_length_296_cov_1.553299	160	179	0	7	19	0.3684210
NODE_174274_length_296_cov_1.553299	160	179	4	12	19	0.6315789
NODE_174438_length_296_cov_1.319797	82	162	0	80	80	1.0000000
NODE_174438_length_296_cov_1.319797	135	205	0	70	70	1.0000000
NODE_174545_length_296_cov_1.258883	222	280	0	58	58	1.0000000
NODE_174554_length_296_cov_1.238579	90	147	7	4	57	0.0701754
NODE_174554_length_296_cov_1.238579	90	147	11	4	57	0.0701754
NODE_174554_length_296_cov_1.238579	90	147	12	43	57	0.7543859
NODE_174554_length_296_cov_1.238579	90	147	14	6	57	0.1052632
NODE_174614_length_296_cov_1.116751	130	169	0	2	39	0.0512821
NODE_174614_length_296_cov_1.116751	130	169	2	2	39	0.0512821
NODE_174614_length_296_cov_1.116751	130	169	4	19	39	0.4871795
NODE_174614_length_296_cov_1.116751	130	169	6	16	39	0.4102564
NODE_175210_length_295_cov_4.290816	2	70	0	3	68	0.0441176
NODE_175210_length_295_cov_4.290816	2	70	2	4	68	0.0588235
NODE_175210_length_295_cov_4.290816	2	70	4	61	68	0.8970588
NODE_175210_length_295_cov_4.290816	55	123	0	17	68	0.2500000
NODE_175210_length_295_cov_4.290816	55	123	2	21	68	0.3088235
NODE_175210_length_295_cov_4.290816	55	123	4	30	68	0.4411765
NODE_175220_length_295_cov_4.040816	119	165	0	35	46	0.7608696
NODE_175220_length_295_cov_4.040816	119	165	2	11	46	0.2391304
NODE_175258_length_295_cov_3.576531	130	198	0	68	68	1.0000000
NODE_175324_length_295_cov_2.918367	0	77	0	10	77	0.1298701
NODE_175324_length_295_cov_2.918367	0	77	4	10	77	0.1298701
NODE_175324_length_295_cov_2.918367	0	77	8	57	77	0.7402598
NODE_175416_length_295_cov_2.454082	216	277	4	8	61	0.1311475
NODE_175416_length_295_cov_2.454082	216	277	6	30	61	0.4918033
NODE_175416_length_295_cov_2.454082	216	277	8	23	61	0.3770492
NODE_175475_length_295_cov_2.224490	11	91	8	7	80	0.0875000
NODE_175475_length_295_cov_2.224490	11	91	10	18	80	0.2250000
NODE_175475_length_295_cov_2.224490	11	91	12	55	80	0.6875000
NODE_175483_length_295_cov_2.183673	93	151	11	1	58	0.0172414
NODE_175483_length_295_cov_2.183673	93	151	12	2	58	0.0344828
NODE_175483_length_295_cov_2.183673	93	151	13	6	58	0.1034483
NODE_175483_length_295_cov_2.183673	93	151	19	1	58	0.0172414
NODE_175483_length_295_cov_2.183673	93	151	20	1	58	0.0172414
NODE_175483_length_295_cov_2.183673	93	151	25	1	58	0.0172414
NODE_175483_length_295_cov_2.183673	93	151	26	2	58	0.0344828
NODE_175483_length_295_cov_2.183673	93	151	30	1	58	0.0172414
NODE_175483_length_295_cov_2.183673	93	151	33	1	58	0.0172414
NODE_175483_length_295_cov_2.183673	93	151	34	1	58	0.0172414
NODE_175483_length_295_cov_2.183673	93	151	35	2	58	0.0344828
NODE_175483_length_295_cov_2.183673	93	151	38	1	58	0.0172414
NODE_175483_length_295_cov_2.183673	93	151	40	1	58	0.0172414
NODE_175483_length_295_cov_2.183673	93	151	42	1	58	0.0172414
NODE_175483_length_295_cov_2.183673	93	151	49	1	58	0.0172414
NODE_175483_length_295_cov_2.183673	93	151	51	1	58	0.0172414
NODE_175483_length_295_cov_2.183673	93	151	57	1	58	0.0172414
NODE_175483_length_295_cov_2.183673	93	151	64	1	58	0.0172414
NODE_175483_length_295_cov_2.183673	93	151	66	2	58	0.0344828
NODE_175483_length_295_cov_2.183673	93	151	67	1	58	0.0172414
NODE_175483_length_295_cov_2.183673	93	151	69	3	58	0.0517241
NODE_175483_length_295_cov_2.183673	93	151	70	6	58	0.1034483
NODE_175483_length_295_cov_2.183673	93	151	71	5	58	0.0862069
NODE_175483_length_295_cov_2.183673	93	151	72	3	58	0.0517241
NODE_175483_length_295_cov_2.183673	93	151	73	12	58	0.2068966
NODE_175483_length_295_cov_2.183673	124	204	69	3	80	0.0375000
NODE_175483_length_295_cov_2.183673	124	204	70	4	80	0.0500000
NODE_175483_length_295_cov_2.183673	124	204	71	5	80	0.0625000
NODE_175483_length_295_cov_2.183673	124	204	72	45	80	0.5625000
NODE_175483_length_295_cov_2.183673	124	204	73	23	80	0.2875000
NODE_175597_length_295_cov_1.867347	191	239	13	2	48	0.0416667
NODE_175597_length_295_cov_1.867347	191	239	14	46	48	0.9583333
NODE_175598_length_295_cov_1.862245	225	285	0	32	60	0.5333334
NODE_175598_length_295_cov_1.862245	225	285	2	28	60	0.4666667
NODE_175721_length_295_cov_1.596939	173	254	4	7	81	0.0864198
NODE_175721_length_295_cov_1.596939	173	254	6	29	81	0.3580247
NODE_175721_length_295_cov_1.596939	173	254	10	29	81	0.3580247
NODE_175721_length_295_cov_1.596939	173	254	12	16	81	0.1975309
NODE_175804_length_295_cov_1.520408	217	282	0	15	65	0.2307692
NODE_175804_length_295_cov_1.520408	217	282	3	13	65	0.2000000
NODE_175804_length_295_cov_1.520408	217	282	5	32	65	0.4923077
NODE_175804_length_295_cov_1.520408	217	282	6	5	65	0.0769231
NODE_175930_length_295_cov_1.301020	99	121	0	22	22	1.0000000
NODE_176250_length_295_cov_0.938776	200	247	0	24	47	0.5106383
NODE_176250_length_295_cov_0.938776	200	247	2	23	47	0.4893617
NODE_176367_length_295_cov_0.780612	24	44	0	20	20	1.0000000
NODE_176436_length_295_cov_0.724490	6	87	0	62	81	0.7654321
NODE_176436_length_295_cov_0.724490	6	87	2	19	81	0.2345679
NODE_176436_length_295_cov_0.724490	83	163	0	9	80	0.1125000
NODE_176436_length_295_cov_0.724490	83	163	2	71	80	0.8875000
NODE_176436_length_295_cov_0.724490	136	216	0	62	80	0.7750000
NODE_176436_length_295_cov_0.724490	136	216	2	18	80	0.2250000
NODE_176547_length_294_cov_83.882051	143	173	0	30	30	1.0000000
NODE_176547_length_294_cov_83.882051	209	239	0	30	30	1.0000000
NODE_176549_length_294_cov_50.589744	187	258	48	2	71	0.0281690
NODE_176549_length_294_cov_50.589744	187	258	53	1	71	0.0140845
NODE_176549_length_294_cov_50.589744	187	258	56	5	71	0.0704225
NODE_176549_length_294_cov_50.589744	187	258	60	6	71	0.0845070
NODE_176549_length_294_cov_50.589744	187	258	63	1	71	0.0140845
NODE_176549_length_294_cov_50.589744	187	258	79	2	71	0.0281690
NODE_176549_length_294_cov_50.589744	187	258	82	1	71	0.0140845
NODE_176549_length_294_cov_50.589744	187	258	84	1	71	0.0140845
NODE_176549_length_294_cov_50.589744	187	258	97	2	71	0.0281690
NODE_176549_length_294_cov_50.589744	187	258	98	4	71	0.0563380
NODE_176549_length_294_cov_50.589744	187	258	100	2	71	0.0281690
NODE_176549_length_294_cov_50.589744	187	258	102	2	71	0.0281690
NODE_176549_length_294_cov_50.589744	187	258	104	2	71	0.0281690
NODE_176549_length_294_cov_50.589744	187	258	105	1	71	0.0140845
NODE_176549_length_294_cov_50.589744	187	258	107	2	71	0.0281690
NODE_176549_length_294_cov_50.589744	187	258	111	1	71	0.0140845
NODE_176549_length_294_cov_50.589744	187	258	112	1	71	0.0140845
NODE_176549_length_294_cov_50.589744	187	258	114	1	71	0.0140845
NODE_176549_length_294_cov_50.589744	187	258	116	1	71	0.0140845
NODE_176549_length_294_cov_50.589744	187	258	121	2	71	0.0281690
NODE_176549_length_294_cov_50.589744	187	258	122	1	71	0.0140845
NODE_176549_length_294_cov_50.589744	187	258	124	2	71	0.0281690
NODE_176549_length_294_cov_50.589744	187	258	127	1	71	0.0140845
NODE_176549_length_294_cov_50.589744	187	258	129	1	71	0.0140845
NODE_176549_length_294_cov_50.589744	187	258	133	1	71	0.0140845
NODE_176549_length_294_cov_50.589744	187	258	135	1	71	0.0140845
NODE_176549_length_294_cov_50.589744	187	258	138	1	71	0.0140845
NODE_176549_length_294_cov_50.589744	187	258	143	4	71	0.0563380
NODE_176549_length_294_cov_50.589744	187	258	148	3	71	0.0422535
NODE_176549_length_294_cov_50.589744	187	258	149	1	71	0.0140845
NODE_176549_length_294_cov_50.589744	187	258	151	3	71	0.0422535
NODE_176549_length_294_cov_50.589744	187	258	153	4	71	0.0563380
NODE_176549_length_294_cov_50.589744	187	258	159	1	71	0.0140845
NODE_176549_length_294_cov_50.589744	187	258	161	1	71	0.0140845
NODE_176549_length_294_cov_50.589744	187	258	165	1	71	0.0140845
NODE_176549_length_294_cov_50.589744	187	258	169	1	71	0.0140845
NODE_176549_length_294_cov_50.589744	187	258	171	1	71	0.0140845
NODE_176549_length_294_cov_50.589744	187	258	172	1	71	0.0140845
NODE_176549_length_294_cov_50.589744	187	258	181	1	71	0.0140845
NODE_176549_length_294_cov_50.589744	187	258	183	1	71	0.0140845
NODE_176561_length_294_cov_6.676923	61	138	2	77	77	1.0000000
NODE_176596_length_294_cov_4.538462	127	214	0	13	87	0.1494253
NODE_176596_length_294_cov_4.538462	127	214	2	74	87	0.8505747
NODE_176598_length_294_cov_4.512821	218	248	0	30	30	1.0000000
NODE_176600_length_294_cov_4.497436	159	200	0	41	41	1.0000000
NODE_176697_length_294_cov_2.953846	114	194	2	17	80	0.2125000
NODE_176697_length_294_cov_2.953846	114	194	6	1	80	0.0125000
NODE_176697_length_294_cov_2.953846	114	194	8	6	80	0.0750000
NODE_176697_length_294_cov_2.953846	114	194	10	56	80	0.7000000
NODE_176727_length_294_cov_2.764103	103	183	2	44	80	0.5500000
NODE_176727_length_294_cov_2.764103	103	183	3	21	80	0.2625000
NODE_176727_length_294_cov_2.764103	103	183	4	10	80	0.1250000
NODE_176727_length_294_cov_2.764103	103	183	5	5	80	0.0625000
NODE_176727_length_294_cov_2.764103	156	236	2	80	80	1.0000000
NODE_176728_length_294_cov_2.764103	224	282	4	54	58	0.9310345
NODE_176728_length_294_cov_2.764103	224	282	8	3	58	0.0517241
NODE_176728_length_294_cov_2.764103	224	282	9	1	58	0.0172414
NODE_176728_length_294_cov_2.764103	225	277	4	49	52	0.9423077
NODE_176728_length_294_cov_2.764103	225	277	8	3	52	0.0576923
NODE_176735_length_294_cov_2.697436	204	261	0	57	57	1.0000000
NODE_176735_length_294_cov_2.697436	234	294	0	60	60	1.0000000
NODE_176779_length_294_cov_2.517949	23	85	0	1	62	0.0161290
NODE_176779_length_294_cov_2.517949	23	85	2	61	62	0.9838710
NODE_176816_length_294_cov_2.353846	129	167	4	4	38	0.1052632
NODE_176816_length_294_cov_2.353846	129	167	6	2	38	0.0526316
NODE_176816_length_294_cov_2.353846	129	167	8	32	38	0.8421053
NODE_176833_length_294_cov_2.338462	133	213	4	5	80	0.0625000
NODE_176833_length_294_cov_2.338462	133	213	5	1	80	0.0125000
NODE_176833_length_294_cov_2.338462	133	213	6	28	80	0.3500000
NODE_176833_length_294_cov_2.338462	133	213	7	7	80	0.0875000
NODE_176833_length_294_cov_2.338462	133	213	8	6	80	0.0750000
NODE_176833_length_294_cov_2.338462	133	213	10	7	80	0.0875000
NODE_176833_length_294_cov_2.338462	133	213	12	1	80	0.0125000
NODE_176833_length_294_cov_2.338462	133	213	14	3	80	0.0375000
NODE_176833_length_294_cov_2.338462	133	213	15	15	80	0.1875000
NODE_176833_length_294_cov_2.338462	133	213	17	6	80	0.0750000
NODE_176833_length_294_cov_2.338462	133	213	21	1	80	0.0125000
NODE_176943_length_294_cov_2.046154	219	269	0	50	50	1.0000000
NODE_176957_length_294_cov_2.010256	191	235	2	10	44	0.2272727
NODE_176957_length_294_cov_2.010256	191	235	4	22	44	0.5000000
NODE_176957_length_294_cov_2.010256	191	235	6	12	44	0.2727273
NODE_176999_length_294_cov_1.902564	52	83	0	31	31	1.0000000
NODE_177102_length_294_cov_1.692308	46	112	2	15	66	0.2272727
NODE_177102_length_294_cov_1.692308	46	112	4	51	66	0.7727273
NODE_177187_length_294_cov_1.569231	49	95	0	46	46	1.0000000
NODE_177252_length_294_cov_1.482051	28	108	0	80	80	1.0000000
NODE_177252_length_294_cov_1.482051	201	281	0	15	80	0.1875000
NODE_177252_length_294_cov_1.482051	201	281	2	65	80	0.8125000
NODE_177252_length_294_cov_1.482051	201	281	0	15	80	0.1875000
NODE_177252_length_294_cov_1.482051	201	281	2	65	80	0.8125000
NODE_177298_length_294_cov_1.420513	216	262	8	46	46	1.0000000
NODE_177298_length_294_cov_1.420513	235	294	0	4	59	0.0677966
NODE_177298_length_294_cov_1.420513	235	294	2	4	59	0.0677966
NODE_177298_length_294_cov_1.420513	235	294	4	7	59	0.1186441
NODE_177298_length_294_cov_1.420513	235	294	6	10	59	0.1694915
NODE_177298_length_294_cov_1.420513	235	294	8	34	59	0.5762712
NODE_177972_length_294_cov_0.666667	245	293	0	48	48	1.0000000
NODE_178066_length_293_cov_6.257732	167	247	0	80	80	1.0000000
NODE_178161_length_293_cov_3.567010	50	130	4	16	80	0.2000000
NODE_178161_length_293_cov_3.567010	50	130	6	57	80	0.7125000
NODE_178161_length_293_cov_3.567010	50	130	8	7	80	0.0875000
NODE_178226_length_293_cov_2.907216	218	281	0	16	63	0.2539683
NODE_178226_length_293_cov_2.907216	218	281	2	47	63	0.7460318
NODE_178246_length_293_cov_2.768041	95	175	0	80	80	1.0000000
NODE_178246_length_293_cov_2.768041	148	228	0	80	80	1.0000000
NODE_178268_length_293_cov_2.628866	207	266	4	47	59	0.7966102
NODE_178268_length_293_cov_2.628866	207	266	6	12	59	0.2033898
NODE_178277_length_293_cov_2.623711	182	223	8	39	41	0.9512195
NODE_178277_length_293_cov_2.623711	182	223	10	2	41	0.0487805
NODE_178299_length_293_cov_2.561856	139	192	0	53	53	1.0000000
NODE_178299_length_293_cov_2.561856	177	223	0	46	46	1.0000000
NODE_178317_length_293_cov_2.448454	98	158	0	60	60	1.0000000
NODE_178351_length_293_cov_2.335052	62	91	2	29	29	1.0000000
NODE_178357_length_293_cov_2.314433	35	89	0	54	54	1.0000000
NODE_178523_length_293_cov_1.840206	27	107	0	27	80	0.3375000
NODE_178523_length_293_cov_1.840206	27	107	2	11	80	0.1375000
NODE_178523_length_293_cov_1.840206	27	107	4	42	80	0.5250000
NODE_178523_length_293_cov_1.840206	80	160	0	25	80	0.3125000
NODE_178523_length_293_cov_1.840206	80	160	2	5	80	0.0625000
NODE_178523_length_293_cov_1.840206	80	160	4	50	80	0.6250000
NODE_178560_length_293_cov_1.804124	144	173	18	29	29	1.0000000
NODE_178570_length_293_cov_1.778351	224	258	0	34	34	1.0000000
NODE_178646_length_293_cov_1.577320	158	177	0	19	19	1.0000000
NODE_178692_length_293_cov_1.577320	161	225	0	31	64	0.4843750
NODE_178692_length_293_cov_1.577320	161	225	4	33	64	0.5156250
NODE_178693_length_293_cov_1.577320	15	55	0	40	40	1.0000000
NODE_178788_length_293_cov_1.402062	3	72	0	45	69	0.6521739
NODE_178788_length_293_cov_1.402062	3	72	2	24	69	0.3478261
NODE_178822_length_293_cov_1.319588	202	268	2	66	66	1.0000000
NODE_178927_length_293_cov_1.226804	84	141	0	57	57	1.0000000
NODE_179542_length_292_cov_4.523316	240	290	0	50	50	1.0000000
NODE_179552_length_292_cov_4.145078	106	186	0	3	80	0.0375000
NODE_179552_length_292_cov_4.145078	106	186	2	9	80	0.1125000
NODE_179552_length_292_cov_4.145078	106	186	4	68	80	0.8500000
NODE_179604_length_292_cov_3.502591	129	205	4	3	76	0.0394737
NODE_179604_length_292_cov_3.502591	129	205	6	11	76	0.1447368
NODE_179604_length_292_cov_3.502591	129	205	7	1	76	0.0131579
NODE_179604_length_292_cov_3.502591	129	205	8	5	76	0.0657895
NODE_179604_length_292_cov_3.502591	129	205	10	5	76	0.0657895
NODE_179604_length_292_cov_3.502591	129	205	12	1	76	0.0131579
NODE_179604_length_292_cov_3.502591	129	205	14	2	76	0.0263158
NODE_179604_length_292_cov_3.502591	129	205	18	1	76	0.0131579
NODE_179604_length_292_cov_3.502591	129	205	19	1	76	0.0131579
NODE_179604_length_292_cov_3.502591	129	205	20	46	76	0.6052632
NODE_179613_length_292_cov_3.435233	176	200	0	9	24	0.3750000
NODE_179613_length_292_cov_3.435233	176	200	2	15	24	0.6250000
NODE_179621_length_292_cov_3.341969	70	150	2	80	80	1.0000000
NODE_179621_length_292_cov_3.341969	118	175	0	12	57	0.2105263
NODE_179621_length_292_cov_3.341969	118	175	2	45	57	0.7894737
NODE_179627_length_292_cov_3.222798	47	127	0	80	80	1.0000000
NODE_179627_length_292_cov_3.222798	100	129	0	29	29	1.0000000
NODE_179819_length_292_cov_2.238342	211	290	0	6	79	0.0759494
NODE_179819_length_292_cov_2.238342	211	290	2	1	79	0.0126582
NODE_179819_length_292_cov_2.238342	211	290	6	72	79	0.9113924
NODE_179943_length_292_cov_1.865285	34	114	56	2	80	0.0250000
NODE_179943_length_292_cov_1.865285	34	114	57	7	80	0.0875000
NODE_179943_length_292_cov_1.865285	34	114	59	11	80	0.1375000
NODE_179943_length_292_cov_1.865285	34	114	61	17	80	0.2125000
NODE_179943_length_292_cov_1.865285	34	114	62	7	80	0.0875000
NODE_179943_length_292_cov_1.865285	34	114	63	10	80	0.1250000
NODE_179943_length_292_cov_1.865285	34	114	64	18	80	0.2250000
NODE_179943_length_292_cov_1.865285	34	114	65	8	80	0.1000000
NODE_179943_length_292_cov_1.865285	87	167	17	2	80	0.0250000
NODE_179943_length_292_cov_1.865285	87	167	18	1	80	0.0125000
NODE_179943_length_292_cov_1.865285	87	167	19	8	80	0.1000000
NODE_179943_length_292_cov_1.865285	87	167	21	1	80	0.0125000
NODE_179943_length_292_cov_1.865285	87	167	22	2	80	0.0250000
NODE_179943_length_292_cov_1.865285	87	167	23	1	80	0.0125000
NODE_179943_length_292_cov_1.865285	87	167	26	1	80	0.0125000
NODE_179943_length_292_cov_1.865285	87	167	30	1	80	0.0125000
NODE_179943_length_292_cov_1.865285	87	167	31	1	80	0.0125000
NODE_179943_length_292_cov_1.865285	87	167	33	14	80	0.1750000
NODE_179943_length_292_cov_1.865285	87	167	45	3	80	0.0375000
NODE_179943_length_292_cov_1.865285	87	167	57	9	80	0.1125000
NODE_179943_length_292_cov_1.865285	87	167	59	27	80	0.3375000
NODE_179943_length_292_cov_1.865285	87	167	63	3	80	0.0375000
NODE_179943_length_292_cov_1.865285	87	167	65	6	80	0.0750000
NODE_180013_length_292_cov_1.761658	174	254	0	80	80	1.0000000
NODE_180029_length_292_cov_1.699482	0	80	0	57	80	0.7125000
NODE_180029_length_292_cov_1.699482	0	80	2	5	80	0.0625000
NODE_180029_length_292_cov_1.699482	0	80	4	18	80	0.2250000
NODE_180068_length_292_cov_1.611399	89	157	0	57	68	0.8382353
NODE_180068_length_292_cov_1.611399	89	157	4	11	68	0.1617647
NODE_180210_length_292_cov_1.455959	72	115	2	43	43	1.0000000
NODE_180210_length_292_cov_1.455959	203	265	6	62	62	1.0000000
NODE_180302_length_292_cov_1.321244	102	182	0	80	80	1.0000000
NODE_180302_length_292_cov_1.321244	155	217	0	62	62	1.0000000
NODE_180968_length_291_cov_45.031250	71	145	14	8	74	0.1081081
NODE_180968_length_291_cov_45.031250	71	145	16	33	74	0.4459459
NODE_180968_length_291_cov_45.031250	71	145	17	10	74	0.1351351
NODE_180968_length_291_cov_45.031250	71	145	18	23	74	0.3108108
NODE_180968_length_291_cov_45.031250	71	145	14	8	74	0.1081081
NODE_180968_length_291_cov_45.031250	71	145	16	33	74	0.4459459
NODE_180968_length_291_cov_45.031250	71	145	17	10	74	0.1351351
NODE_180968_length_291_cov_45.031250	71	145	18	23	74	0.3108108
NODE_180968_length_291_cov_45.031250	118	184	4	8	66	0.1212121
NODE_180968_length_291_cov_45.031250	118	184	12	3	66	0.0454545
NODE_180968_length_291_cov_45.031250	118	184	15	13	66	0.1969697
NODE_180968_length_291_cov_45.031250	118	184	17	5	66	0.0757576
NODE_180968_length_291_cov_45.031250	118	184	18	37	66	0.5606061
NODE_180969_length_291_cov_14.791667	125	205	0	80	80	1.0000000
NODE_180969_length_291_cov_14.791667	178	258	0	80	80	1.0000000
NODE_180983_length_291_cov_5.536458	97	169	0	72	72	1.0000000
NODE_180986_length_291_cov_5.401042	77	130	5	53	53	1.0000000
NODE_180998_length_291_cov_4.859375	185	257	4	6	72	0.0833333
NODE_180998_length_291_cov_4.859375	185	257	6	18	72	0.2500000
NODE_180998_length_291_cov_4.859375	185	257	7	5	72	0.0694444
NODE_180998_length_291_cov_4.859375	185	257	8	9	72	0.1250000
NODE_180998_length_291_cov_4.859375	185	257	9	1	72	0.0138889
NODE_180998_length_291_cov_4.859375	185	257	10	4	72	0.0555556
NODE_180998_length_291_cov_4.859375	185	257	11	2	72	0.0277778
NODE_180998_length_291_cov_4.859375	185	257	12	21	72	0.2916667
NODE_180998_length_291_cov_4.859375	185	257	13	2	72	0.0277778
NODE_180998_length_291_cov_4.859375	185	257	15	4	72	0.0555556
NODE_181043_length_291_cov_3.723958	196	276	0	80	80	1.0000000
NODE_181057_length_291_cov_3.531250	129	152	2	23	23	1.0000000
NODE_181191_length_291_cov_2.390625	18	80	0	62	62	1.0000000
NODE_181272_length_291_cov_2.125000	70	117	2	47	47	1.0000000
NODE_181391_length_291_cov_1.859375	197	228	0	31	31	1.0000000
NODE_181497_length_291_cov_1.593750	144	175	2	31	31	1.0000000
NODE_181530_length_291_cov_1.593750	206	281	0	75	75	1.0000000
NODE_181599_length_291_cov_1.552083	189	269	3	9	80	0.1125000
NODE_181599_length_291_cov_1.552083	189	269	5	22	80	0.2750000
NODE_181599_length_291_cov_1.552083	189	269	6	2	80	0.0250000
NODE_181599_length_291_cov_1.552083	189	269	8	6	80	0.0750000
NODE_181599_length_291_cov_1.552083	189	269	10	41	80	0.5125000
NODE_181615_length_291_cov_1.520833	180	258	0	28	78	0.3589744
NODE_181615_length_291_cov_1.520833	180	258	1	41	78	0.5256410
NODE_181615_length_291_cov_1.520833	180	258	2	9	78	0.1153846
NODE_181623_length_291_cov_1.510417	245	291	0	46	46	1.0000000
NODE_181696_length_291_cov_1.385417	80	120	0	36	40	0.9000000
NODE_181696_length_291_cov_1.385417	80	120	2	4	40	0.1000000
NODE_181791_length_291_cov_1.322917	70	96	0	26	26	1.0000000
NODE_181799_length_291_cov_1.307292	108	188	0	13	80	0.1625000
NODE_181799_length_291_cov_1.307292	108	188	2	57	80	0.7125000
NODE_181799_length_291_cov_1.307292	108	188	4	1	80	0.0125000
NODE_181799_length_291_cov_1.307292	108	188	6	9	80	0.1125000
NODE_181907_length_291_cov_1.114583	79	174	7	1	95	0.0105263
NODE_181907_length_291_cov_1.114583	79	174	9	2	95	0.0210526
NODE_181907_length_291_cov_1.114583	79	174	11	1	95	0.0105263
NODE_181907_length_291_cov_1.114583	79	174	13	1	95	0.0105263
NODE_181907_length_291_cov_1.114583	79	174	14	15	95	0.1578947
NODE_181907_length_291_cov_1.114583	79	174	16	3	95	0.0315789
NODE_181907_length_291_cov_1.114583	79	174	17	3	95	0.0315789
NODE_181907_length_291_cov_1.114583	79	174	18	18	95	0.1894737
NODE_181907_length_291_cov_1.114583	79	174	20	6	95	0.0631579
NODE_181907_length_291_cov_1.114583	79	174	22	1	95	0.0105263
NODE_181907_length_291_cov_1.114583	79	174	24	44	95	0.4631579
NODE_181930_length_291_cov_1.078125	4	85	0	36	81	0.4444444
NODE_181930_length_291_cov_1.078125	4	85	4	13	81	0.1604938
NODE_181930_length_291_cov_1.078125	4	85	6	7	81	0.0864198
NODE_181930_length_291_cov_1.078125	4	85	8	11	81	0.1358025
NODE_181930_length_291_cov_1.078125	4	85	10	14	81	0.1728395
NODE_182112_length_291_cov_1.031250	5	50	0	38	45	0.8444445
NODE_182112_length_291_cov_1.031250	5	50	2	7	45	0.1555556
NODE_182205_length_291_cov_0.890625	0	55	0	15	55	0.2727273
NODE_182205_length_291_cov_0.890625	0	55	2	40	55	0.7272727
NODE_182252_length_291_cov_0.802083	80	160	6	2	80	0.0250000
NODE_182252_length_291_cov_0.802083	80	160	10	2	80	0.0250000
NODE_182252_length_291_cov_0.802083	80	160	12	10	80	0.1250000
NODE_182252_length_291_cov_0.802083	80	160	14	26	80	0.3250000
NODE_182252_length_291_cov_0.802083	80	160	16	1	80	0.0125000
NODE_182252_length_291_cov_0.802083	80	160	18	7	80	0.0875000
NODE_182252_length_291_cov_0.802083	80	160	19	1	80	0.0125000
NODE_182252_length_291_cov_0.802083	80	160	20	15	80	0.1875000
NODE_182252_length_291_cov_0.802083	80	160	22	1	80	0.0125000
NODE_182252_length_291_cov_0.802083	80	160	24	12	80	0.1500000
NODE_182252_length_291_cov_0.802083	80	160	26	3	80	0.0375000
NODE_182491_length_290_cov_96.963351	44	124	0	80	80	1.0000000
NODE_182491_length_290_cov_96.963351	97	177	0	80	80	1.0000000
NODE_182512_length_290_cov_5.968586	89	150	2	2	61	0.0327869
NODE_182512_length_290_cov_5.968586	89	150	5	6	61	0.0983607
NODE_182512_length_290_cov_5.968586	89	150	8	14	61	0.2295082
NODE_182512_length_290_cov_5.968586	89	150	14	7	61	0.1147541
NODE_182512_length_290_cov_5.968586	89	150	17	1	61	0.0163934
NODE_182512_length_290_cov_5.968586	89	150	18	3	61	0.0491803
NODE_182512_length_290_cov_5.968586	89	150	20	5	61	0.0819672
NODE_182512_length_290_cov_5.968586	89	150	26	2	61	0.0327869
NODE_182512_length_290_cov_5.968586	89	150	31	8	61	0.1311475
NODE_182512_length_290_cov_5.968586	89	150	33	2	61	0.0327869
NODE_182512_length_290_cov_5.968586	89	150	37	2	61	0.0327869
NODE_182512_length_290_cov_5.968586	89	150	40	9	61	0.1475410
NODE_182512_length_290_cov_5.968586	142	203	38	7	61	0.1147541
NODE_182512_length_290_cov_5.968586	142	203	39	3	61	0.0491803
NODE_182512_length_290_cov_5.968586	142	203	40	20	61	0.3278688
NODE_182512_length_290_cov_5.968586	142	203	41	23	61	0.3770492
NODE_182512_length_290_cov_5.968586	142	203	42	8	61	0.1311475
NODE_182535_length_290_cov_4.968586	32	52	0	20	20	1.0000000
NODE_182535_length_290_cov_4.968586	73	93	0	20	20	1.0000000
NODE_182547_length_290_cov_4.670157	63	139	0	18	76	0.2368421
NODE_182547_length_290_cov_4.670157	63	139	2	58	76	0.7631579
NODE_182550_length_290_cov_4.575916	110	153	0	43	43	1.0000000
NODE_182589_length_290_cov_3.816754	113	186	4	73	73	1.0000000
NODE_182607_length_290_cov_3.612565	114	181	0	67	67	1.0000000
NODE_182622_length_290_cov_3.445026	91	150	0	59	59	1.0000000
NODE_182772_length_290_cov_2.596859	189	218	0	15	29	0.5172414
NODE_182772_length_290_cov_2.596859	189	218	2	14	29	0.4827586
NODE_182844_length_290_cov_2.319372	45	74	0	29	29	1.0000000
NODE_182973_length_290_cov_2.041885	59	139	2	80	80	1.0000000
NODE_182995_length_290_cov_1.979058	229	271	29	13	42	0.3095238
NODE_182995_length_290_cov_1.979058	229	271	30	19	42	0.4523810
NODE_182995_length_290_cov_1.979058	229	271	31	10	42	0.2380952
NODE_183288_length_290_cov_1.602094	16	68	0	52	52	1.0000000
NODE_183347_length_290_cov_1.575916	173	250	0	77	77	1.0000000
NODE_183373_length_290_cov_1.544503	151	203	2	10	52	0.1923077
NODE_183373_length_290_cov_1.544503	151	203	4	42	52	0.8076923
NODE_183403_length_290_cov_1.513089	22	107	0	85	85	1.0000000
NODE_183436_length_290_cov_1.460733	11	91	0	1	80	0.0125000
NODE_183436_length_290_cov_1.460733	11	91	2	79	80	0.9875000
NODE_183546_length_290_cov_1.335079	91	163	4	6	72	0.0833333
NODE_183546_length_290_cov_1.335079	91	163	6	3	72	0.0416667
NODE_183546_length_290_cov_1.335079	91	163	8	15	72	0.2083333
NODE_183546_length_290_cov_1.335079	91	163	10	17	72	0.2361111
NODE_183546_length_290_cov_1.335079	91	163	12	1	72	0.0138889
NODE_183546_length_290_cov_1.335079	91	163	14	18	72	0.2500000
NODE_183546_length_290_cov_1.335079	91	163	16	12	72	0.1666667
NODE_183546_length_290_cov_1.335079	144	216	6	6	72	0.0833333
NODE_183546_length_290_cov_1.335079	144	216	8	8	72	0.1111111
NODE_183546_length_290_cov_1.335079	144	216	10	24	72	0.3333333
NODE_183546_length_290_cov_1.335079	144	216	12	2	72	0.0277778
NODE_183546_length_290_cov_1.335079	144	216	14	25	72	0.3472222
NODE_183546_length_290_cov_1.335079	144	216	16	7	72	0.0972222
NODE_183642_length_290_cov_1.314136	0	80	0	60	80	0.7500000
NODE_183642_length_290_cov_1.314136	0	80	2	20	80	0.2500000
NODE_183663_length_290_cov_1.287958	17	97	0	80	80	1.0000000
NODE_183946_length_290_cov_1.068063	0	60	0	60	60	1.0000000
NODE_183946_length_290_cov_1.068063	33	113	0	80	80	1.0000000
NODE_184119_length_290_cov_1.000000	198	254	74	1	56	0.0178571
NODE_184119_length_290_cov_1.000000	198	254	86	2	56	0.0357143
NODE_184119_length_290_cov_1.000000	198	254	88	1	56	0.0178571
NODE_184119_length_290_cov_1.000000	198	254	89	2	56	0.0357143
NODE_184119_length_290_cov_1.000000	198	254	91	4	56	0.0714286
NODE_184119_length_290_cov_1.000000	198	254	93	2	56	0.0357143
NODE_184119_length_290_cov_1.000000	198	254	97	3	56	0.0535714
NODE_184119_length_290_cov_1.000000	198	254	99	4	56	0.0714286
NODE_184119_length_290_cov_1.000000	198	254	100	1	56	0.0178571
NODE_184119_length_290_cov_1.000000	198	254	102	1	56	0.0178571
NODE_184119_length_290_cov_1.000000	198	254	104	3	56	0.0535714
NODE_184119_length_290_cov_1.000000	198	254	108	1	56	0.0178571
NODE_184119_length_290_cov_1.000000	198	254	110	4	56	0.0714286
NODE_184119_length_290_cov_1.000000	198	254	112	3	56	0.0535714
NODE_184119_length_290_cov_1.000000	198	254	114	2	56	0.0357143
NODE_184119_length_290_cov_1.000000	198	254	115	2	56	0.0357143
NODE_184119_length_290_cov_1.000000	198	254	116	4	56	0.0714286
NODE_184119_length_290_cov_1.000000	198	254	117	1	56	0.0178571
NODE_184119_length_290_cov_1.000000	198	254	118	5	56	0.0892857
NODE_184119_length_290_cov_1.000000	198	254	119	3	56	0.0535714
NODE_184119_length_290_cov_1.000000	198	254	120	2	56	0.0357143
NODE_184119_length_290_cov_1.000000	198	254	121	3	56	0.0535714
NODE_184119_length_290_cov_1.000000	198	254	122	2	56	0.0357143
NODE_184326_length_290_cov_0.832461	154	236	0	82	82	1.0000000
NODE_184585_length_290_cov_0.701571	201	281	0	80	80	1.0000000
NODE_184716_length_289_cov_554.947368	45	125	312	1	80	0.0125000
NODE_184716_length_289_cov_554.947368	45	125	323	1	80	0.0125000
NODE_184716_length_289_cov_554.947368	45	125	343	2	80	0.0250000
NODE_184716_length_289_cov_554.947368	45	125	351	1	80	0.0125000
NODE_184716_length_289_cov_554.947368	45	125	352	1	80	0.0125000
NODE_184716_length_289_cov_554.947368	45	125	354	2	80	0.0250000
NODE_184716_length_289_cov_554.947368	45	125	362	1	80	0.0125000
NODE_184716_length_289_cov_554.947368	45	125	373	1	80	0.0125000
NODE_184716_length_289_cov_554.947368	45	125	380	3	80	0.0375000
NODE_184716_length_289_cov_554.947368	45	125	388	1	80	0.0125000
NODE_184716_length_289_cov_554.947368	45	125	395	1	80	0.0125000
NODE_184716_length_289_cov_554.947368	45	125	396	1	80	0.0125000
NODE_184716_length_289_cov_554.947368	45	125	401	1	80	0.0125000
NODE_184716_length_289_cov_554.947368	45	125	403	1	80	0.0125000
NODE_184716_length_289_cov_554.947368	45	125	404	1	80	0.0125000
NODE_184716_length_289_cov_554.947368	45	125	420	2	80	0.0250000
NODE_184716_length_289_cov_554.947368	45	125	426	2	80	0.0250000
NODE_184716_length_289_cov_554.947368	45	125	429	1	80	0.0125000
NODE_184716_length_289_cov_554.947368	45	125	430	1	80	0.0125000
NODE_184716_length_289_cov_554.947368	45	125	431	5	80	0.0625000
NODE_184716_length_289_cov_554.947368	45	125	435	1	80	0.0125000
NODE_184716_length_289_cov_554.947368	45	125	439	1	80	0.0125000
NODE_184716_length_289_cov_554.947368	45	125	441	2	80	0.0250000
NODE_184716_length_289_cov_554.947368	45	125	443	1	80	0.0125000
NODE_184716_length_289_cov_554.947368	45	125	445	3	80	0.0375000
NODE_184716_length_289_cov_554.947368	45	125	446	2	80	0.0250000
NODE_184716_length_289_cov_554.947368	45	125	449	7	80	0.0875000
NODE_184716_length_289_cov_554.947368	45	125	453	2	80	0.0250000
NODE_184716_length_289_cov_554.947368	45	125	457	3	80	0.0375000
NODE_184716_length_289_cov_554.947368	45	125	459	1	80	0.0125000
NODE_184716_length_289_cov_554.947368	45	125	461	3	80	0.0375000
NODE_184716_length_289_cov_554.947368	45	125	462	1	80	0.0125000
NODE_184716_length_289_cov_554.947368	45	125	464	4	80	0.0500000
NODE_184716_length_289_cov_554.947368	45	125	465	3	80	0.0375000
NODE_184716_length_289_cov_554.947368	45	125	466	8	80	0.1000000
NODE_184716_length_289_cov_554.947368	45	125	467	8	80	0.1000000
NODE_184729_length_289_cov_7.436842	181	229	0	40	48	0.8333333
NODE_184729_length_289_cov_7.436842	181	229	2	8	48	0.1666667
NODE_184745_length_289_cov_5.789474	35	100	0	65	65	1.0000000
NODE_184745_length_289_cov_5.789474	85	153	0	68	68	1.0000000
NODE_184745_length_289_cov_5.789474	146	181	0	35	35	1.0000000
NODE_184781_length_289_cov_4.515789	192	254	0	62	62	1.0000000
NODE_184806_length_289_cov_4.136842	101	148	0	47	47	1.0000000
NODE_184892_length_289_cov_2.973684	38	83	0	45	45	1.0000000
NODE_184960_length_289_cov_2.678947	105	168	12	1	63	0.0158730
NODE_184960_length_289_cov_2.678947	105	168	14	54	63	0.8571429
NODE_184960_length_289_cov_2.678947	105	168	16	8	63	0.1269841
NODE_184960_length_289_cov_2.678947	158	204	8	25	46	0.5434783
NODE_184960_length_289_cov_2.678947	158	204	10	10	46	0.2173913
NODE_184960_length_289_cov_2.678947	158	204	12	2	46	0.0434783
NODE_184960_length_289_cov_2.678947	158	204	14	9	46	0.1956522
NODE_184963_length_289_cov_2.673684	216	263	0	47	47	1.0000000
NODE_185036_length_289_cov_2.378947	233	289	0	56	56	1.0000000
NODE_185152_length_289_cov_2.089474	26	91	0	65	65	1.0000000
NODE_185213_length_289_cov_1.921053	0	54	0	54	54	1.0000000
NODE_185383_length_289_cov_1.642105	58	123	0	65	65	1.0000000
NODE_185570_length_289_cov_1.547368	81	124	1	43	43	1.0000000
NODE_185617_length_289_cov_1.489474	192	274	0	82	82	1.0000000
NODE_185622_length_289_cov_1.484211	50	69	0	19	19	1.0000000
NODE_185708_length_289_cov_1.357895	31	74	0	43	43	1.0000000
NODE_185852_length_289_cov_1.278947	239	270	0	31	31	1.0000000
NODE_185864_length_289_cov_1.252632	23	66	2	43	43	1.0000000
NODE_185926_length_289_cov_1.168421	40	100	0	5	60	0.0833333
NODE_185926_length_289_cov_1.168421	40	100	2	55	60	0.9166667
NODE_185937_length_289_cov_1.152632	0	50	0	21	50	0.4200000
NODE_185937_length_289_cov_1.152632	0	50	2	29	50	0.5800000
NODE_185937_length_289_cov_1.152632	41	103	0	12	62	0.1935484
NODE_185937_length_289_cov_1.152632	41	103	2	50	62	0.8064516
NODE_186095_length_289_cov_1.073684	152	198	2	17	46	0.3695652
NODE_186095_length_289_cov_1.073684	152	198	4	29	46	0.6304348
NODE_186491_length_289_cov_0.878947	113	193	8	2	80	0.0250000
NODE_186491_length_289_cov_0.878947	113	193	16	3	80	0.0375000
NODE_186491_length_289_cov_0.878947	113	193	18	8	80	0.1000000
NODE_186491_length_289_cov_0.878947	113	193	20	1	80	0.0125000
NODE_186491_length_289_cov_0.878947	113	193	22	1	80	0.0125000
NODE_186491_length_289_cov_0.878947	113	193	24	11	80	0.1375000
NODE_186491_length_289_cov_0.878947	113	193	26	4	80	0.0500000
NODE_186491_length_289_cov_0.878947	113	193	28	36	80	0.4500000
NODE_186491_length_289_cov_0.878947	113	193	30	14	80	0.1750000
NODE_186491_length_289_cov_0.878947	166	246	2	13	80	0.1625000
NODE_186491_length_289_cov_0.878947	166	246	12	1	80	0.0125000
NODE_186491_length_289_cov_0.878947	166	246	15	2	80	0.0250000
NODE_186491_length_289_cov_0.878947	166	246	21	1	80	0.0125000
NODE_186491_length_289_cov_0.878947	166	246	24	1	80	0.0125000
NODE_186491_length_289_cov_0.878947	166	246	26	4	80	0.0500000
NODE_186491_length_289_cov_0.878947	166	246	28	21	80	0.2625000
NODE_186491_length_289_cov_0.878947	166	246	30	37	80	0.4625000
NODE_186507_length_289_cov_0.863158	116	211	2	11	95	0.1157895
NODE_186507_length_289_cov_0.863158	116	211	4	84	95	0.8842105
NODE_186515_length_289_cov_0.857895	6	75	0	69	69	1.0000000
NODE_186547_length_289_cov_0.831579	230	289	0	4	59	0.0677966
NODE_186547_length_289_cov_0.831579	230	289	1	2	59	0.0338983
NODE_186547_length_289_cov_0.831579	230	289	3	3	59	0.0508475
NODE_186547_length_289_cov_0.831579	230	289	4	14	59	0.2372881
NODE_186547_length_289_cov_0.831579	230	289	6	1	59	0.0169492
NODE_186547_length_289_cov_0.831579	230	289	8	14	59	0.2372881
NODE_186547_length_289_cov_0.831579	230	289	10	4	59	0.0677966
NODE_186547_length_289_cov_0.831579	230	289	12	2	59	0.0338983
NODE_186547_length_289_cov_0.831579	230	289	14	1	59	0.0169492
NODE_186547_length_289_cov_0.831579	230	289	15	11	59	0.1864407
NODE_186547_length_289_cov_0.831579	230	289	17	3	59	0.0508475
NODE_186631_length_289_cov_0.805263	98	159	0	5	61	0.0819672
NODE_186631_length_289_cov_0.805263	98	159	2	56	61	0.9180328
NODE_186865_length_289_cov_0.568421	141	213	0	3	72	0.0416667
NODE_186865_length_289_cov_0.568421	141	213	2	69	72	0.9583333
NODE_186934_length_288_cov_11.089947	135	195	8	6	60	0.1000000
NODE_186934_length_288_cov_11.089947	135	195	18	9	60	0.1500000
NODE_186934_length_288_cov_11.089947	135	195	19	24	60	0.4000000
NODE_186934_length_288_cov_11.089947	135	195	20	15	60	0.2500000
NODE_186934_length_288_cov_11.089947	135	195	22	3	60	0.0500000
NODE_186934_length_288_cov_11.089947	135	195	24	3	60	0.0500000
NODE_187025_length_288_cov_3.587302	108	188	0	80	80	1.0000000
NODE_187049_length_288_cov_3.296296	61	125	0	26	64	0.4062500
NODE_187049_length_288_cov_3.296296	61	125	2	38	64	0.5937500
NODE_187049_length_288_cov_3.296296	102	178	0	25	76	0.3289474
NODE_187049_length_288_cov_3.296296	102	178	2	51	76	0.6710526
NODE_187062_length_288_cov_3.206349	149	202	0	53	53	1.0000000
NODE_187170_length_288_cov_2.539683	4	68	34	1	64	0.0156250
NODE_187170_length_288_cov_2.539683	4	68	38	1	64	0.0156250
NODE_187170_length_288_cov_2.539683	4	68	40	1	64	0.0156250
NODE_187170_length_288_cov_2.539683	4	68	52	1	64	0.0156250
NODE_187170_length_288_cov_2.539683	4	68	56	3	64	0.0468750
NODE_187170_length_288_cov_2.539683	4	68	60	3	64	0.0468750
NODE_187170_length_288_cov_2.539683	4	68	62	2	64	0.0312500
NODE_187170_length_288_cov_2.539683	4	68	64	8	64	0.1250000
NODE_187170_length_288_cov_2.539683	4	68	66	2	64	0.0312500
NODE_187170_length_288_cov_2.539683	4	68	68	42	64	0.6562500
NODE_187187_length_288_cov_2.465608	137	182	0	11	45	0.2444444
NODE_187187_length_288_cov_2.465608	137	182	2	34	45	0.7555556
NODE_187191_length_288_cov_2.449735	216	278	4	10	62	0.1612903
NODE_187191_length_288_cov_2.449735	216	278	6	52	62	0.8387097
NODE_187191_length_288_cov_2.449735	237	273	4	5	36	0.1388889
NODE_187191_length_288_cov_2.449735	237	273	6	31	36	0.8611111
NODE_187248_length_288_cov_2.275132	10	46	4	5	36	0.1388889
NODE_187248_length_288_cov_2.275132	10	46	6	31	36	0.8611111
NODE_187248_length_288_cov_2.275132	13	86	4	2	73	0.0273973
NODE_187248_length_288_cov_2.275132	13	86	6	71	73	0.9726027
NODE_187248_length_288_cov_2.275132	47	100	4	3	53	0.0566038
NODE_187248_length_288_cov_2.275132	47	100	6	50	53	0.9433962
NODE_187318_length_288_cov_2.153439	50	81	2	31	31	1.0000000
NODE_187431_length_288_cov_1.915344	0	75	0	75	75	1.0000000
NODE_187443_length_288_cov_1.888889	49	125	0	76	76	1.0000000
NODE_187484_length_288_cov_1.878307	0	42	0	42	42	1.0000000
NODE_187484_length_288_cov_1.878307	15	63	0	48	48	1.0000000
NODE_187810_length_288_cov_1.492063	0	42	0	42	42	1.0000000
NODE_188135_length_288_cov_1.158730	213	288	0	74	75	0.9866667
NODE_188135_length_288_cov_1.158730	213	288	4	1	75	0.0133333
NODE_188161_length_288_cov_1.100529	256	288	4	32	32	1.0000000
NODE_188169_length_288_cov_1.079365	10	74	0	55	64	0.8593750
NODE_188169_length_288_cov_1.079365	10	74	2	9	64	0.1406250
NODE_188169_length_288_cov_1.079365	65	110	2	45	45	1.0000000
NODE_188760_length_288_cov_0.809524	141	170	10	5	29	0.1724138
NODE_188760_length_288_cov_0.809524	141	170	12	8	29	0.2758621
NODE_188760_length_288_cov_0.809524	141	170	14	16	29	0.5517241
NODE_189068_length_287_cov_7.632979	117	184	21	8	67	0.1194030
NODE_189068_length_287_cov_7.632979	117	184	23	6	67	0.0895522
NODE_189068_length_287_cov_7.632979	117	184	27	6	67	0.0895522
NODE_189068_length_287_cov_7.632979	117	184	28	47	67	0.7014925
NODE_189079_length_287_cov_6.510638	20	100	0	80	80	1.0000000
NODE_189097_length_287_cov_5.781915	164	246	0	82	82	1.0000000
NODE_189182_length_287_cov_3.590426	114	194	0	45	80	0.5625000
NODE_189182_length_287_cov_3.590426	114	194	1	6	80	0.0750000
NODE_189182_length_287_cov_3.590426	114	194	2	29	80	0.3625000
NODE_189192_length_287_cov_3.452128	0	52	0	52	52	1.0000000
NODE_189208_length_287_cov_3.281915	263	286	0	4	23	0.1739130
NODE_189208_length_287_cov_3.281915	263	286	4	17	23	0.7391304
NODE_189208_length_287_cov_3.281915	263	286	6	2	23	0.0869565
NODE_189266_length_287_cov_2.936170	41	110	0	69	69	1.0000000
NODE_189266_length_287_cov_2.936170	41	111	0	70	70	1.0000000
NODE_189266_length_287_cov_2.936170	94	167	0	56	73	0.7671233
NODE_189266_length_287_cov_2.936170	94	167	2	17	73	0.2328767
NODE_189266_length_287_cov_2.936170	156	179	2	23	23	1.0000000
NODE_189330_length_287_cov_2.638298	22	86	0	64	64	1.0000000
NODE_189381_length_287_cov_2.436170	182	262	8	2	80	0.0250000
NODE_189381_length_287_cov_2.436170	182	262	10	3	80	0.0375000
NODE_189381_length_287_cov_2.436170	182	262	12	75	80	0.9375000
NODE_189582_length_287_cov_1.984043	137	166	17	6	29	0.2068966
NODE_189582_length_287_cov_1.984043	137	166	22	4	29	0.1379310
NODE_189582_length_287_cov_1.984043	137	166	24	11	29	0.3793103
NODE_189582_length_287_cov_1.984043	137	166	26	2	29	0.0689655
NODE_189582_length_287_cov_1.984043	137	166	32	2	29	0.0689655
NODE_189582_length_287_cov_1.984043	137	166	34	4	29	0.1379310
NODE_189594_length_287_cov_1.941489	56	123	0	7	67	0.1044776
NODE_189594_length_287_cov_1.941489	56	123	2	60	67	0.8955224
NODE_189614_length_287_cov_1.904255	8	51	3	1	43	0.0232558
NODE_189614_length_287_cov_1.904255	8	51	4	6	43	0.1395349
NODE_189614_length_287_cov_1.904255	8	51	6	12	43	0.2790698
NODE_189614_length_287_cov_1.904255	8	51	8	2	43	0.0465116
NODE_189614_length_287_cov_1.904255	8	51	10	6	43	0.1395349
NODE_189614_length_287_cov_1.904255	8	51	12	16	43	0.3720930
NODE_189710_length_287_cov_1.803191	146	217	0	13	71	0.1830986
NODE_189710_length_287_cov_1.803191	146	217	2	58	71	0.8169014
NODE_189843_length_287_cov_1.627660	113	175	16	2	62	0.0322581
NODE_189843_length_287_cov_1.627660	113	175	18	54	62	0.8709677
NODE_189843_length_287_cov_1.627660	113	175	20	6	62	0.0967742
NODE_189843_length_287_cov_1.627660	148	228	16	4	80	0.0500000
NODE_189843_length_287_cov_1.627660	148	228	18	51	80	0.6375000
NODE_189843_length_287_cov_1.627660	148	228	19	15	80	0.1875000
NODE_189843_length_287_cov_1.627660	148	228	20	10	80	0.1250000
NODE_189864_length_287_cov_1.627660	14	59	0	12	45	0.2666667
NODE_189864_length_287_cov_1.627660	14	59	4	33	45	0.7333333
NODE_189864_length_287_cov_1.627660	41	112	4	71	71	1.0000000
NODE_189949_length_287_cov_1.574468	150	220	0	33	70	0.4714286
NODE_189949_length_287_cov_1.574468	150	220	2	37	70	0.5285714
NODE_189985_length_287_cov_1.531915	123	154	0	9	31	0.2903226
NODE_189985_length_287_cov_1.531915	123	154	2	22	31	0.7096774
NODE_190122_length_287_cov_1.356383	93	147	0	54	54	1.0000000
NODE_190142_length_287_cov_1.356383	135	199	2	1	64	0.0156250
NODE_190142_length_287_cov_1.356383	135	199	5	38	64	0.5937500
NODE_190142_length_287_cov_1.356383	135	199	7	25	64	0.3906250
NODE_190189_length_287_cov_1.335106	149	201	0	52	52	1.0000000
NODE_190654_length_287_cov_1.037234	23	44	0	21	21	1.0000000
NODE_190701_length_287_cov_0.994681	206	225	0	19	19	1.0000000
NODE_190802_length_287_cov_0.898936	0	57	0	2	57	0.0350877
NODE_190802_length_287_cov_0.898936	0	57	1	1	57	0.0175439
NODE_190802_length_287_cov_0.898936	0	57	2	2	57	0.0350877
NODE_190802_length_287_cov_0.898936	0	57	3	24	57	0.4210526
NODE_190802_length_287_cov_0.898936	0	57	5	1	57	0.0175439
NODE_190802_length_287_cov_0.898936	0	57	7	3	57	0.0526316
NODE_190802_length_287_cov_0.898936	0	57	9	2	57	0.0350877
NODE_190802_length_287_cov_0.898936	0	57	10	1	57	0.0175439
NODE_190802_length_287_cov_0.898936	0	57	12	2	57	0.0350877
NODE_190802_length_287_cov_0.898936	0	57	14	6	57	0.1052632
NODE_190802_length_287_cov_0.898936	0	57	16	1	57	0.0175439
NODE_190802_length_287_cov_0.898936	0	57	17	1	57	0.0175439
NODE_190802_length_287_cov_0.898936	0	57	18	9	57	0.1578947
NODE_190802_length_287_cov_0.898936	0	57	20	2	57	0.0350877
NODE_190873_length_287_cov_0.840426	46	121	0	10	75	0.1333333
NODE_190873_length_287_cov_0.840426	46	121	3	7	75	0.0933333
NODE_190873_length_287_cov_0.840426	46	121	6	58	75	0.7733333
NODE_191306_length_286_cov_141.540107	4	63	0	59	59	1.0000000
NODE_191389_length_286_cov_3.935829	79	123	2	44	44	1.0000000
NODE_191391_length_286_cov_3.871658	45	121	2	76	76	1.0000000
NODE_191391_length_286_cov_3.871658	102	169	0	26	67	0.3880597
NODE_191391_length_286_cov_3.871658	102	169	2	41	67	0.6119403
NODE_191393_length_286_cov_3.812834	62	142	0	26	80	0.3250000
NODE_191393_length_286_cov_3.812834	62	142	6	54	80	0.6750000
NODE_191430_length_286_cov_3.352941	63	143	0	80	80	1.0000000
NODE_191430_length_286_cov_3.352941	116	196	0	80	80	1.0000000
NODE_191466_length_286_cov_3.101604	217	271	2	54	54	1.0000000
NODE_191509_length_286_cov_2.823529	56	122	9	2	66	0.0303030
NODE_191509_length_286_cov_2.823529	56	122	11	3	66	0.0454545
NODE_191509_length_286_cov_2.823529	56	122	13	6	66	0.0909091
NODE_191509_length_286_cov_2.823529	56	122	15	2	66	0.0303030
NODE_191509_length_286_cov_2.823529	56	122	18	1	66	0.0151515
NODE_191509_length_286_cov_2.823529	56	122	19	3	66	0.0454545
NODE_191509_length_286_cov_2.823529	56	122	21	2	66	0.0303030
NODE_191509_length_286_cov_2.823529	56	122	23	1	66	0.0151515
NODE_191509_length_286_cov_2.823529	56	122	26	1	66	0.0151515
NODE_191509_length_286_cov_2.823529	56	122	28	1	66	0.0151515
NODE_191509_length_286_cov_2.823529	56	122	42	1	66	0.0151515
NODE_191509_length_286_cov_2.823529	56	122	50	1	66	0.0151515
NODE_191509_length_286_cov_2.823529	56	122	58	1	66	0.0151515
NODE_191509_length_286_cov_2.823529	56	122	64	1	66	0.0151515
NODE_191509_length_286_cov_2.823529	56	122	70	1	66	0.0151515
NODE_191509_length_286_cov_2.823529	56	122	74	1	66	0.0151515
NODE_191509_length_286_cov_2.823529	56	122	76	3	66	0.0454545
NODE_191509_length_286_cov_2.823529	56	122	78	1	66	0.0151515
NODE_191509_length_286_cov_2.823529	56	122	80	2	66	0.0303030
NODE_191509_length_286_cov_2.823529	56	122	82	1	66	0.0151515
NODE_191509_length_286_cov_2.823529	56	122	83	2	66	0.0303030
NODE_191509_length_286_cov_2.823529	56	122	87	1	66	0.0151515
NODE_191509_length_286_cov_2.823529	56	122	89	1	66	0.0151515
NODE_191509_length_286_cov_2.823529	56	122	91	1	66	0.0151515
NODE_191509_length_286_cov_2.823529	56	122	92	1	66	0.0151515
NODE_191509_length_286_cov_2.823529	56	122	95	3	66	0.0454545
NODE_191509_length_286_cov_2.823529	56	122	97	4	66	0.0606061
NODE_191509_length_286_cov_2.823529	56	122	98	1	66	0.0151515
NODE_191509_length_286_cov_2.823529	56	122	100	5	66	0.0757576
NODE_191509_length_286_cov_2.823529	56	122	102	6	66	0.0909091
NODE_191509_length_286_cov_2.823529	56	122	104	6	66	0.0909091
NODE_191598_length_286_cov_2.438503	151	218	0	47	67	0.7014925
NODE_191598_length_286_cov_2.438503	151	218	2	20	67	0.2985075
NODE_191754_length_286_cov_2.037433	57	138	2	7	81	0.0864198
NODE_191754_length_286_cov_2.037433	57	138	4	21	81	0.2592593
NODE_191754_length_286_cov_2.037433	57	138	8	53	81	0.6543210
NODE_191892_length_286_cov_1.807487	186	232	2	46	46	1.0000000
NODE_191892_length_286_cov_1.807487	239	285	0	39	46	0.8478261
NODE_191892_length_286_cov_1.807487	239	285	1	1	46	0.0217391
NODE_191892_length_286_cov_1.807487	239	285	2	6	46	0.1304348
NODE_192100_length_286_cov_1.566845	112	160	2	48	48	1.0000000
NODE_192100_length_286_cov_1.566845	165	213	1	48	48	1.0000000
NODE_192150_length_286_cov_1.497326	107	160	2	53	53	1.0000000
NODE_192233_length_286_cov_1.363636	20	87	0	67	67	1.0000000
NODE_192302_length_286_cov_1.358289	218	262	2	44	44	1.0000000
NODE_192357_length_286_cov_1.304813	147	205	1	9	58	0.1551724
NODE_192357_length_286_cov_1.304813	147	205	3	3	58	0.0517241
NODE_192357_length_286_cov_1.304813	147	205	5	14	58	0.2413793
NODE_192357_length_286_cov_1.304813	147	205	6	29	58	0.5000000
NODE_192357_length_286_cov_1.304813	147	205	8	3	58	0.0517241
NODE_192427_length_286_cov_1.203209	30	76	0	46	46	1.0000000
NODE_192427_length_286_cov_1.203209	49	129	0	80	80	1.0000000
NODE_192757_length_286_cov_1.074866	160	220	0	60	60	1.0000000
NODE_193023_length_286_cov_0.871658	218	279	0	61	61	1.0000000
NODE_193038_length_286_cov_0.855615	224	281	0	18	57	0.3157895
NODE_193038_length_286_cov_0.855615	224	281	2	10	57	0.1754386
NODE_193038_length_286_cov_0.855615	224	281	4	16	57	0.2807018
NODE_193038_length_286_cov_0.855615	224	281	6	2	57	0.0350877
NODE_193038_length_286_cov_0.855615	224	281	8	11	57	0.1929825
NODE_193362_length_286_cov_0.625668	110	190	2	80	80	1.0000000
NODE_193362_length_286_cov_0.625668	163	240	0	46	77	0.5974026
NODE_193362_length_286_cov_0.625668	163	240	1	3	77	0.0389610
NODE_193362_length_286_cov_0.625668	163	240	2	28	77	0.3636364
NODE_193481_length_285_cov_7.392473	91	152	0	61	61	1.0000000
NODE_193481_length_285_cov_7.392473	150	184	0	34	34	1.0000000
NODE_193513_length_285_cov_4.650538	0	74	0	74	74	1.0000000
NODE_193513_length_285_cov_4.650538	47	127	0	80	80	1.0000000
NODE_193513_length_285_cov_4.650538	123	203	0	80	80	1.0000000
NODE_193513_length_285_cov_4.650538	176	256	0	80	80	1.0000000
NODE_193532_length_285_cov_4.091398	91	154	2	63	63	1.0000000
NODE_193538_length_285_cov_4.010753	120	201	0	46	81	0.5679013
NODE_193538_length_285_cov_4.010753	120	201	2	16	81	0.1975309
NODE_193538_length_285_cov_4.010753	120	201	4	19	81	0.2345679
NODE_193547_length_285_cov_3.854839	97	151	0	54	54	1.0000000
NODE_193547_length_285_cov_3.854839	106	153	0	47	47	1.0000000
NODE_193566_length_285_cov_3.607527	197	258	0	20	61	0.3278688
NODE_193566_length_285_cov_3.607527	197	258	4	4	61	0.0655738
NODE_193566_length_285_cov_3.607527	197	258	6	4	61	0.0655738
NODE_193566_length_285_cov_3.607527	197	258	10	2	61	0.0327869
NODE_193566_length_285_cov_3.607527	197	258	12	1	61	0.0163934
NODE_193566_length_285_cov_3.607527	197	258	14	1	61	0.0163934
NODE_193566_length_285_cov_3.607527	197	258	16	16	61	0.2622951
NODE_193566_length_285_cov_3.607527	197	258	18	1	61	0.0163934
NODE_193566_length_285_cov_3.607527	197	258	20	11	61	0.1803279
NODE_193566_length_285_cov_3.607527	197	258	22	1	61	0.0163934
NODE_193624_length_285_cov_3.037634	190	272	0	50	82	0.6097561
NODE_193624_length_285_cov_3.037634	190	272	4	32	82	0.3902439
NODE_193660_length_285_cov_2.806452	215	279	0	64	64	1.0000000
NODE_193688_length_285_cov_2.736559	106	173	6	6	67	0.0895522
NODE_193688_length_285_cov_2.736559	106	173	8	61	67	0.9104478
NODE_193784_length_285_cov_2.311828	220	262	0	42	42	1.0000000
NODE_193883_length_285_cov_2.043011	77	150	0	73	73	1.0000000
NODE_193883_length_285_cov_2.043011	155	197	0	42	42	1.0000000
NODE_193978_length_285_cov_1.876344	67	110	0	43	43	1.0000000
NODE_194150_length_285_cov_1.645161	112	160	0	2	48	0.0416667
NODE_194150_length_285_cov_1.645161	112	160	2	1	48	0.0208333
NODE_194150_length_285_cov_1.645161	112	160	3	30	48	0.6250000
NODE_194150_length_285_cov_1.645161	112	160	4	15	48	0.3125000
NODE_194260_length_285_cov_1.548387	124	172	0	48	48	1.0000000
NODE_194332_length_285_cov_1.456989	210	277	0	8	67	0.1194030
NODE_194332_length_285_cov_1.456989	210	277	2	59	67	0.8805970
NODE_194499_length_285_cov_1.327957	114	191	10	11	77	0.1428571
NODE_194499_length_285_cov_1.327957	114	191	12	11	77	0.1428571
NODE_194499_length_285_cov_1.327957	114	191	14	3	77	0.0389610
NODE_194499_length_285_cov_1.327957	114	191	18	8	77	0.1038961
NODE_194499_length_285_cov_1.327957	114	191	20	16	77	0.2077922
NODE_194499_length_285_cov_1.327957	114	191	22	2	77	0.0259740
NODE_194499_length_285_cov_1.327957	114	191	24	26	77	0.3376623
NODE_194865_length_285_cov_1.096774	175	229	0	54	54	1.0000000
NODE_194865_length_285_cov_1.096774	230	271	0	41	41	1.0000000
NODE_195109_length_285_cov_0.924731	128	208	0	80	80	1.0000000
NODE_195115_length_285_cov_0.919355	5	65	0	60	60	1.0000000
NODE_195124_length_285_cov_0.913978	6	80	2	74	74	1.0000000
NODE_195124_length_285_cov_0.913978	58	133	2	70	75	0.9333333
NODE_195124_length_285_cov_0.913978	58	133	4	5	75	0.0666667
NODE_195642_length_284_cov_7.967568	143	207	4	31	64	0.4843750
NODE_195642_length_284_cov_7.967568	143	207	6	33	64	0.5156250
NODE_195667_length_284_cov_5.016216	115	169	3	19	54	0.3518519
NODE_195667_length_284_cov_5.016216	115	169	6	35	54	0.6481481
NODE_195715_length_284_cov_3.913514	26	82	0	56	56	1.0000000
NODE_195760_length_284_cov_3.405405	209	283	0	74	74	1.0000000
NODE_195863_length_284_cov_2.718919	138	162	0	10	24	0.4166667
NODE_195863_length_284_cov_2.718919	138	162	2	14	24	0.5833333
NODE_195863_length_284_cov_2.718919	138	215	0	10	77	0.1298701
NODE_195863_length_284_cov_2.718919	138	215	2	67	77	0.8701299
NODE_196090_length_284_cov_2.097297	46	122	4	36	76	0.4736842
NODE_196090_length_284_cov_2.097297	46	122	6	40	76	0.5263158
NODE_196253_length_284_cov_1.756757	27	100	0	3	73	0.0410959
NODE_196253_length_284_cov_1.756757	27	100	1	1	73	0.0136986
NODE_196253_length_284_cov_1.756757	27	100	2	34	73	0.4657534
NODE_196253_length_284_cov_1.756757	27	100	4	35	73	0.4794520
NODE_196253_length_284_cov_1.756757	97	153	4	56	56	1.0000000
NODE_196273_length_284_cov_1.713514	24	59	2	3	35	0.0857143
NODE_196273_length_284_cov_1.713514	24	59	6	32	35	0.9142857
NODE_196372_length_284_cov_1.654054	207	251	0	44	44	1.0000000
NODE_196426_length_284_cov_1.643243	180	239	0	58	59	0.9830508
NODE_196426_length_284_cov_1.643243	180	239	1	1	59	0.0169492
NODE_196505_length_284_cov_1.540541	148	186	18	1	38	0.0263158
NODE_196505_length_284_cov_1.540541	148	186	22	2	38	0.0526316
NODE_196505_length_284_cov_1.540541	148	186	24	13	38	0.3421053
NODE_196505_length_284_cov_1.540541	148	186	26	3	38	0.0789474
NODE_196505_length_284_cov_1.540541	148	186	28	1	38	0.0263158
NODE_196505_length_284_cov_1.540541	148	186	30	8	38	0.2105263
NODE_196505_length_284_cov_1.540541	148	186	32	6	38	0.1578947
NODE_196505_length_284_cov_1.540541	148	186	36	1	38	0.0263158
NODE_196505_length_284_cov_1.540541	148	186	46	3	38	0.0789474
NODE_196670_length_284_cov_1.378378	65	145	7	8	80	0.1000000
NODE_196670_length_284_cov_1.378378	65	145	9	11	80	0.1375000
NODE_196670_length_284_cov_1.378378	65	145	11	16	80	0.2000000
NODE_196670_length_284_cov_1.378378	65	145	12	16	80	0.2000000
NODE_196670_length_284_cov_1.378378	65	145	14	2	80	0.0250000
NODE_196670_length_284_cov_1.378378	65	145	16	3	80	0.0375000
NODE_196670_length_284_cov_1.378378	65	145	20	5	80	0.0625000
NODE_196670_length_284_cov_1.378378	65	145	22	1	80	0.0125000
NODE_196670_length_284_cov_1.378378	65	145	24	6	80	0.0750000
NODE_196670_length_284_cov_1.378378	65	145	26	5	80	0.0625000
NODE_196670_length_284_cov_1.378378	65	145	28	2	80	0.0250000
NODE_196670_length_284_cov_1.378378	65	145	30	4	80	0.0500000
NODE_196670_length_284_cov_1.378378	65	145	32	1	80	0.0125000
NODE_196670_length_284_cov_1.378378	118	165	16	3	47	0.0638298
NODE_196670_length_284_cov_1.378378	118	165	20	5	47	0.1063830
NODE_196670_length_284_cov_1.378378	118	165	22	1	47	0.0212766
NODE_196670_length_284_cov_1.378378	118	165	24	6	47	0.1276596
NODE_196670_length_284_cov_1.378378	118	165	26	5	47	0.1063830
NODE_196670_length_284_cov_1.378378	118	165	28	2	47	0.0425532
NODE_196670_length_284_cov_1.378378	118	165	30	4	47	0.0851064
NODE_196670_length_284_cov_1.378378	118	165	32	21	47	0.4468085
NODE_196733_length_284_cov_1.329730	114	170	0	7	56	0.1250000
NODE_196733_length_284_cov_1.329730	114	170	2	49	56	0.8750000
NODE_197755_length_284_cov_0.686486	13	94	0	81	81	1.0000000
NODE_197755_length_284_cov_0.686486	13	94	0	81	81	1.0000000
NODE_197755_length_284_cov_0.686486	13	94	0	81	81	1.0000000
NODE_197835_length_284_cov_0.551351	167	219	0	38	52	0.7307692
NODE_197835_length_284_cov_0.551351	167	219	2	14	52	0.2692308
NODE_197936_length_283_cov_4.434783	81	137	64	1	56	0.0178571
NODE_197936_length_283_cov_4.434783	81	137	66	1	56	0.0178571
NODE_197936_length_283_cov_4.434783	81	137	68	2	56	0.0357143
NODE_197936_length_283_cov_4.434783	81	137	70	1	56	0.0178571
NODE_197936_length_283_cov_4.434783	81	137	72	3	56	0.0535714
NODE_197936_length_283_cov_4.434783	81	137	74	3	56	0.0535714
NODE_197936_length_283_cov_4.434783	81	137	76	7	56	0.1250000
NODE_197936_length_283_cov_4.434783	81	137	80	3	56	0.0535714
NODE_197936_length_283_cov_4.434783	81	137	82	1	56	0.0178571
NODE_197936_length_283_cov_4.434783	81	137	84	16	56	0.2857143
NODE_197936_length_283_cov_4.434783	81	137	86	3	56	0.0535714
NODE_197936_length_283_cov_4.434783	81	137	87	1	56	0.0178571
NODE_197936_length_283_cov_4.434783	81	137	89	3	56	0.0535714
NODE_197936_length_283_cov_4.434783	81	137	91	3	56	0.0535714
NODE_197936_length_283_cov_4.434783	81	137	93	8	56	0.1428571
NODE_197936_length_283_cov_4.434783	114	190	9	1	76	0.0131579
NODE_197936_length_283_cov_4.434783	114	190	17	2	76	0.0263158
NODE_197936_length_283_cov_4.434783	114	190	19	2	76	0.0263158
NODE_197936_length_283_cov_4.434783	114	190	21	1	76	0.0131579
NODE_197936_length_283_cov_4.434783	114	190	23	5	76	0.0657895
NODE_197936_length_283_cov_4.434783	114	190	25	2	76	0.0263158
NODE_197936_length_283_cov_4.434783	114	190	27	1	76	0.0131579
NODE_197936_length_283_cov_4.434783	114	190	30	1	76	0.0131579
NODE_197936_length_283_cov_4.434783	114	190	31	2	76	0.0263158
NODE_197936_length_283_cov_4.434783	114	190	33	2	76	0.0263158
NODE_197936_length_283_cov_4.434783	114	190	35	6	76	0.0789474
NODE_197936_length_283_cov_4.434783	114	190	41	3	76	0.0394737
NODE_197936_length_283_cov_4.434783	114	190	43	2	76	0.0263158
NODE_197936_length_283_cov_4.434783	114	190	53	1	76	0.0131579
NODE_197936_length_283_cov_4.434783	114	190	56	1	76	0.0131579
NODE_197936_length_283_cov_4.434783	114	190	57	1	76	0.0131579
NODE_197936_length_283_cov_4.434783	114	190	58	4	76	0.0526316
NODE_197936_length_283_cov_4.434783	114	190	59	1	76	0.0131579
NODE_197936_length_283_cov_4.434783	114	190	61	3	76	0.0394737
NODE_197936_length_283_cov_4.434783	114	190	63	1	76	0.0131579
NODE_197936_length_283_cov_4.434783	114	190	64	12	76	0.1578947
NODE_197936_length_283_cov_4.434783	114	190	66	1	76	0.0131579
NODE_197936_length_283_cov_4.434783	114	190	68	2	76	0.0263158
NODE_197936_length_283_cov_4.434783	114	190	70	1	76	0.0131579
NODE_197936_length_283_cov_4.434783	114	190	72	3	76	0.0394737
NODE_197936_length_283_cov_4.434783	114	190	74	3	76	0.0394737
NODE_197936_length_283_cov_4.434783	114	190	76	7	76	0.0921053
NODE_197936_length_283_cov_4.434783	114	190	80	3	76	0.0394737
NODE_197936_length_283_cov_4.434783	114	190	82	1	76	0.0131579
NODE_197936_length_283_cov_4.434783	114	190	84	1	76	0.0131579
NODE_197936_length_283_cov_4.434783	190	270	4	5	80	0.0625000
NODE_197936_length_283_cov_4.434783	190	270	6	1	80	0.0125000
NODE_197936_length_283_cov_4.434783	190	270	8	8	80	0.1000000
NODE_197936_length_283_cov_4.434783	190	270	10	7	80	0.0875000
NODE_197936_length_283_cov_4.434783	190	270	12	59	80	0.7375000
NODE_197937_length_283_cov_4.429348	104	168	8	49	64	0.7656250
NODE_197937_length_283_cov_4.429348	104	168	10	15	64	0.2343750
NODE_197937_length_283_cov_4.429348	104	168	8	49	64	0.7656250
NODE_197937_length_283_cov_4.429348	104	168	10	15	64	0.2343750
NODE_197937_length_283_cov_4.429348	141	207	2	23	66	0.3484848
NODE_197937_length_283_cov_4.429348	141	207	3	1	66	0.0151515
NODE_197937_length_283_cov_4.429348	141	207	7	13	66	0.1969697
NODE_197937_length_283_cov_4.429348	141	207	8	28	66	0.4242424
NODE_197937_length_283_cov_4.429348	141	207	10	1	66	0.0151515
NODE_197937_length_283_cov_4.429348	141	221	2	37	80	0.4625000
NODE_197937_length_283_cov_4.429348	141	221	3	1	80	0.0125000
NODE_197937_length_283_cov_4.429348	141	221	7	13	80	0.1625000
NODE_197937_length_283_cov_4.429348	141	221	8	28	80	0.3500000
NODE_197937_length_283_cov_4.429348	141	221	10	1	80	0.0125000
NODE_198007_length_283_cov_3.369565	0	35	0	35	35	1.0000000
NODE_198022_length_283_cov_3.309783	47	91	0	44	44	1.0000000
NODE_198081_length_283_cov_2.923913	95	137	2	2	42	0.0476190
NODE_198081_length_283_cov_2.923913	95	137	3	1	42	0.0238095
NODE_198081_length_283_cov_2.923913	95	137	4	19	42	0.4523810
NODE_198081_length_283_cov_2.923913	95	137	6	20	42	0.4761905
NODE_198081_length_283_cov_2.923913	110	190	4	25	80	0.3125000
NODE_198081_length_283_cov_2.923913	110	190	6	55	80	0.6875000
NODE_198098_length_283_cov_2.782609	120	200	0	80	80	1.0000000
NODE_198109_length_283_cov_2.771739	29	72	0	43	43	1.0000000
NODE_198171_length_283_cov_2.494565	186	229	0	43	43	1.0000000
NODE_198176_length_283_cov_2.494565	181	238	6	57	57	1.0000000
NODE_198271_length_283_cov_2.217391	222	281	0	18	59	0.3050847
NODE_198271_length_283_cov_2.217391	222	281	1	41	59	0.6949152
NODE_198518_length_283_cov_1.777174	40	120	0	80	80	1.0000000
NODE_198745_length_283_cov_1.543478	125	161	5	1	36	0.0277778
NODE_198745_length_283_cov_1.543478	125	161	9	2	36	0.0555556
NODE_198745_length_283_cov_1.543478	125	161	20	1	36	0.0277778
NODE_198745_length_283_cov_1.543478	125	161	21	1	36	0.0277778
NODE_198745_length_283_cov_1.543478	125	161	23	2	36	0.0555556
NODE_198745_length_283_cov_1.543478	125	161	25	1	36	0.0277778
NODE_198745_length_283_cov_1.543478	125	161	27	3	36	0.0833333
NODE_198745_length_283_cov_1.543478	125	161	30	2	36	0.0555556
NODE_198745_length_283_cov_1.543478	125	161	34	7	36	0.1944444
NODE_198745_length_283_cov_1.543478	125	161	36	1	36	0.0277778
NODE_198745_length_283_cov_1.543478	125	161	38	8	36	0.2222222
NODE_198745_length_283_cov_1.543478	125	161	40	3	36	0.0833333
NODE_198745_length_283_cov_1.543478	125	161	42	4	36	0.1111111
NODE_198751_length_283_cov_1.538043	182	203	0	21	21	1.0000000
NODE_198986_length_283_cov_1.304348	208	270	10	1	62	0.0161290
NODE_198986_length_283_cov_1.304348	208	270	12	3	62	0.0483871
NODE_198986_length_283_cov_1.304348	208	270	14	6	62	0.0967742
NODE_198986_length_283_cov_1.304348	208	270	16	52	62	0.8387097
NODE_199042_length_283_cov_1.211957	157	234	6	1	77	0.0129870
NODE_199042_length_283_cov_1.211957	157	234	8	12	77	0.1558442
NODE_199042_length_283_cov_1.211957	157	234	10	64	77	0.8311688
NODE_199070_length_283_cov_1.168478	183	250	0	18	67	0.2686567
NODE_199070_length_283_cov_1.168478	183	250	2	49	67	0.7313433
NODE_199606_length_283_cov_0.918478	146	226	6	80	80	1.0000000
NODE_199606_length_283_cov_0.918478	199	279	1	13	80	0.1625000
NODE_199606_length_283_cov_0.918478	199	279	3	21	80	0.2625000
NODE_199606_length_283_cov_0.918478	199	279	4	19	80	0.2375000
NODE_199606_length_283_cov_0.918478	199	279	6	27	80	0.3375000
NODE_199641_length_283_cov_0.885870	143	205	0	14	62	0.2258064
NODE_199641_length_283_cov_0.885870	143	205	1	9	62	0.1451613
NODE_199641_length_283_cov_0.885870	143	205	2	8	62	0.1290323
NODE_199641_length_283_cov_0.885870	143	205	4	31	62	0.5000000
NODE_199958_length_283_cov_0.706522	119	159	14	40	40	1.0000000
NODE_200085_length_282_cov_51.027322	219	280	0	61	61	1.0000000
NODE_200085_length_282_cov_51.027322	219	282	0	63	63	1.0000000
NODE_200166_length_282_cov_3.901639	38	118	0	80	80	1.0000000
NODE_200166_length_282_cov_3.901639	91	171	0	80	80	1.0000000
NODE_200171_length_282_cov_3.874317	96	116	4	20	20	1.0000000
NODE_200201_length_282_cov_3.562842	224	279	0	55	55	1.0000000
NODE_200270_length_282_cov_2.890710	41	123	0	82	82	1.0000000
NODE_200276_length_282_cov_2.846995	26	47	0	21	21	1.0000000
NODE_200304_length_282_cov_2.770492	145	225	2	20	80	0.2500000
NODE_200304_length_282_cov_2.770492	145	225	4	8	80	0.1000000
NODE_200304_length_282_cov_2.770492	145	225	6	17	80	0.2125000
NODE_200304_length_282_cov_2.770492	145	225	8	35	80	0.4375000
NODE_200304_length_282_cov_2.770492	198	278	0	4	80	0.0500000
NODE_200304_length_282_cov_2.770492	198	278	2	7	80	0.0875000
NODE_200304_length_282_cov_2.770492	198	278	4	33	80	0.4125000
NODE_200304_length_282_cov_2.770492	198	278	8	36	80	0.4500000
NODE_200329_length_282_cov_2.655738	46	119	0	73	73	1.0000000
NODE_200329_length_282_cov_2.655738	100	159	0	59	59	1.0000000
NODE_200335_length_282_cov_2.622951	0	36	2	14	36	0.3888889
NODE_200335_length_282_cov_2.622951	0	36	4	22	36	0.6111111
NODE_200335_length_282_cov_2.622951	9	89	2	14	80	0.1750000
NODE_200335_length_282_cov_2.622951	9	89	4	66	80	0.8250000
NODE_200336_length_282_cov_2.622951	38	111	2	35	73	0.4794520
NODE_200336_length_282_cov_2.622951	38	111	3	1	73	0.0136986
NODE_200336_length_282_cov_2.622951	38	111	4	26	73	0.3561644
NODE_200336_length_282_cov_2.622951	38	111	6	6	73	0.0821918
NODE_200336_length_282_cov_2.622951	38	111	8	5	73	0.0684932
NODE_200336_length_282_cov_2.622951	98	144	4	2	46	0.0434783
NODE_200336_length_282_cov_2.622951	98	144	6	6	46	0.1304348
NODE_200336_length_282_cov_2.622951	98	144	8	14	46	0.3043478
NODE_200336_length_282_cov_2.622951	98	144	9	6	46	0.1304348
NODE_200336_length_282_cov_2.622951	98	144	10	18	46	0.3913043
NODE_200367_length_282_cov_2.508197	138	186	0	48	48	1.0000000
NODE_200367_length_282_cov_2.508197	191	234	0	43	43	1.0000000
NODE_200425_length_282_cov_2.289617	68	137	0	69	69	1.0000000
NODE_200443_length_282_cov_2.229508	169	249	0	80	80	1.0000000
NODE_200501_length_282_cov_2.163934	138	192	0	43	54	0.7962963
NODE_200501_length_282_cov_2.163934	138	192	2	11	54	0.2037037
NODE_200634_length_282_cov_1.901639	149	216	2	9	67	0.1343284
NODE_200634_length_282_cov_1.901639	149	216	4	3	67	0.0447761
NODE_200634_length_282_cov_1.901639	149	216	6	55	67	0.8208955
NODE_200924_length_282_cov_1.612022	123	162	0	39	39	1.0000000
NODE_201084_length_282_cov_1.393443	158	225	0	48	67	0.7164179
NODE_201084_length_282_cov_1.393443	158	225	4	19	67	0.2835821
NODE_201219_length_282_cov_1.273224	91	140	0	49	49	1.0000000
NODE_201413_length_282_cov_1.114754	5	53	0	48	48	1.0000000
NODE_202284_length_281_cov_7.895604	165	210	12	1	45	0.0222222
NODE_202284_length_281_cov_7.895604	165	210	13	2	45	0.0444444
NODE_202284_length_281_cov_7.895604	165	210	14	40	45	0.8888889
NODE_202284_length_281_cov_7.895604	165	210	15	1	45	0.0222222
NODE_202284_length_281_cov_7.895604	165	210	16	1	45	0.0222222
NODE_202284_length_281_cov_7.895604	183	263	2	6	80	0.0750000
NODE_202284_length_281_cov_7.895604	183	263	4	8	80	0.1000000
NODE_202284_length_281_cov_7.895604	183	263	6	7	80	0.0875000
NODE_202284_length_281_cov_7.895604	183	263	8	7	80	0.0875000
NODE_202284_length_281_cov_7.895604	183	263	10	6	80	0.0750000
NODE_202284_length_281_cov_7.895604	183	263	13	1	80	0.0125000
NODE_202284_length_281_cov_7.895604	183	263	14	45	80	0.5625000
NODE_202294_length_281_cov_6.379121	151	231	0	80	80	1.0000000
NODE_202333_length_281_cov_4.565934	71	127	0	56	56	1.0000000
NODE_202337_length_281_cov_4.494505	211	261	0	50	50	1.0000000
NODE_202356_length_281_cov_4.219780	85	135	0	50	50	1.0000000
NODE_202356_length_281_cov_4.219780	145	188	0	43	43	1.0000000
NODE_202401_length_281_cov_3.620879	245	281	0	36	36	1.0000000
NODE_202421_length_281_cov_3.324176	104	161	0	2	57	0.0350877
NODE_202421_length_281_cov_3.324176	104	161	2	36	57	0.6315789
NODE_202421_length_281_cov_3.324176	104	161	4	19	57	0.3333333
NODE_202421_length_281_cov_3.324176	112	192	2	30	80	0.3750000
NODE_202421_length_281_cov_3.324176	112	192	4	50	80	0.6250000
NODE_202436_length_281_cov_3.197802	6	80	0	74	74	1.0000000
NODE_202473_length_281_cov_2.923077	92	150	0	58	58	1.0000000
NODE_202650_length_281_cov_2.241758	5	58	0	53	53	1.0000000
NODE_202712_length_281_cov_2.120879	56	136	0	80	80	1.0000000
NODE_202788_length_281_cov_1.961538	199	270	2	6	71	0.0845070
NODE_202788_length_281_cov_1.961538	199	270	4	10	71	0.1408451
NODE_202788_length_281_cov_1.961538	199	270	6	22	71	0.3098592
NODE_202788_length_281_cov_1.961538	199	270	8	33	71	0.4647887
NODE_203008_length_281_cov_1.675824	147	199	2	52	52	1.0000000
NODE_203008_length_281_cov_1.675824	178	198	2	20	20	1.0000000
NODE_203008_length_281_cov_1.675824	200	241	0	18	41	0.4390244
NODE_203008_length_281_cov_1.675824	200	241	2	23	41	0.5609756
NODE_203065_length_281_cov_1.653846	29	65	0	36	36	1.0000000
NODE_203168_length_281_cov_1.483516	85	135	0	50	50	1.0000000
NODE_203168_length_281_cov_1.483516	86	166	0	80	80	1.0000000
NODE_203168_length_281_cov_1.483516	139	184	0	45	45	1.0000000
NODE_203183_length_281_cov_1.461538	223	276	0	53	53	1.0000000
NODE_203262_length_281_cov_1.401099	237	281	0	44	44	1.0000000
NODE_203281_length_281_cov_1.401099	150	214	0	16	64	0.2500000
NODE_203281_length_281_cov_1.401099	150	214	2	6	64	0.0937500
NODE_203281_length_281_cov_1.401099	150	214	4	1	64	0.0156250
NODE_203281_length_281_cov_1.401099	150	214	10	3	64	0.0468750
NODE_203281_length_281_cov_1.401099	150	214	12	1	64	0.0156250
NODE_203281_length_281_cov_1.401099	150	214	14	37	64	0.5781250
NODE_203281_length_281_cov_1.401099	187	267	0	69	80	0.8625000
NODE_203281_length_281_cov_1.401099	187	267	2	6	80	0.0750000
NODE_203281_length_281_cov_1.401099	187	267	4	1	80	0.0125000
NODE_203281_length_281_cov_1.401099	187	267	10	3	80	0.0375000
NODE_203281_length_281_cov_1.401099	187	267	12	1	80	0.0125000
NODE_203292_length_281_cov_1.401099	31	111	0	80	80	1.0000000
NODE_203440_length_281_cov_1.186813	0	79	1	11	79	0.1392405
NODE_203440_length_281_cov_1.186813	0	79	2	35	79	0.4430380
NODE_203440_length_281_cov_1.186813	0	79	4	3	79	0.0379747
NODE_203440_length_281_cov_1.186813	0	79	6	3	79	0.0379747
NODE_203440_length_281_cov_1.186813	0	79	7	1	79	0.0126582
NODE_203440_length_281_cov_1.186813	0	79	9	1	79	0.0126582
NODE_203440_length_281_cov_1.186813	0	79	11	1	79	0.0126582
NODE_203440_length_281_cov_1.186813	0	79	13	21	79	0.2658228
NODE_203440_length_281_cov_1.186813	0	79	14	3	79	0.0379747
NODE_203440_length_281_cov_1.186813	52	132	7	1	80	0.0125000
NODE_203440_length_281_cov_1.186813	52	132	9	1	80	0.0125000
NODE_203440_length_281_cov_1.186813	52	132	11	1	80	0.0125000
NODE_203440_length_281_cov_1.186813	52	132	12	7	80	0.0875000
NODE_203440_length_281_cov_1.186813	52	132	13	21	80	0.2625000
NODE_203440_length_281_cov_1.186813	52	132	14	8	80	0.1000000
NODE_203440_length_281_cov_1.186813	52	132	16	41	80	0.5125000
NODE_203516_length_281_cov_1.120879	47	82	0	1	35	0.0285714
NODE_203516_length_281_cov_1.120879	47	82	4	34	35	0.9714286
NODE_203534_length_281_cov_1.120879	243	276	0	3	33	0.0909091
NODE_203534_length_281_cov_1.120879	243	276	2	30	33	0.9090909
NODE_203544_length_281_cov_1.120879	216	281	4	2	65	0.0307692
NODE_203544_length_281_cov_1.120879	216	281	7	21	65	0.3230769
NODE_203544_length_281_cov_1.120879	216	281	10	42	65	0.6461539
NODE_203785_length_281_cov_1.060440	139	179	6	1	40	0.0250000
NODE_203785_length_281_cov_1.060440	139	179	8	3	40	0.0750000
NODE_203785_length_281_cov_1.060440	139	179	10	11	40	0.2750000
NODE_203785_length_281_cov_1.060440	139	179	12	6	40	0.1500000
NODE_203785_length_281_cov_1.060440	139	179	14	3	40	0.0750000
NODE_203785_length_281_cov_1.060440	139	179	16	7	40	0.1750000
NODE_203785_length_281_cov_1.060440	139	179	20	9	40	0.2250000
NODE_204094_length_281_cov_0.840659	72	138	1	35	66	0.5303030
NODE_204094_length_281_cov_0.840659	72	138	2	31	66	0.4696970
NODE_204094_length_281_cov_0.840659	111	191	0	52	80	0.6500000
NODE_204094_length_281_cov_0.840659	111	191	1	28	80	0.3500000
NODE_204467_length_280_cov_39.320442	118	198	0	20	80	0.2500000
NODE_204467_length_280_cov_39.320442	118	198	2	1	80	0.0125000
NODE_204467_length_280_cov_39.320442	118	198	5	1	80	0.0125000
NODE_204467_length_280_cov_39.320442	118	198	6	58	80	0.7250000
NODE_204467_length_280_cov_39.320442	181	251	0	70	70	1.0000000
NODE_204468_length_280_cov_34.259669	97	137	2	1	40	0.0250000
NODE_204468_length_280_cov_34.259669	97	137	4	1	40	0.0250000
NODE_204468_length_280_cov_34.259669	97	137	14	2	40	0.0500000
NODE_204468_length_280_cov_34.259669	97	137	18	1	40	0.0250000
NODE_204468_length_280_cov_34.259669	97	137	24	1	40	0.0250000
NODE_204468_length_280_cov_34.259669	97	137	25	1	40	0.0250000
NODE_204468_length_280_cov_34.259669	97	137	26	2	40	0.0500000
NODE_204468_length_280_cov_34.259669	97	137	32	1	40	0.0250000
NODE_204468_length_280_cov_34.259669	97	137	34	1	40	0.0250000
NODE_204468_length_280_cov_34.259669	97	137	40	6	40	0.1500000
NODE_204468_length_280_cov_34.259669	97	137	42	1	40	0.0250000
NODE_204468_length_280_cov_34.259669	97	137	44	2	40	0.0500000
NODE_204468_length_280_cov_34.259669	97	137	45	1	40	0.0250000
NODE_204468_length_280_cov_34.259669	97	137	47	2	40	0.0500000
NODE_204468_length_280_cov_34.259669	97	137	49	3	40	0.0750000
NODE_204468_length_280_cov_34.259669	97	137	51	2	40	0.0500000
NODE_204468_length_280_cov_34.259669	97	137	53	3	40	0.0750000
NODE_204468_length_280_cov_34.259669	97	137	57	1	40	0.0250000
NODE_204468_length_280_cov_34.259669	97	137	59	2	40	0.0500000
NODE_204468_length_280_cov_34.259669	97	137	63	1	40	0.0250000
NODE_204468_length_280_cov_34.259669	97	137	65	4	40	0.1000000
NODE_204468_length_280_cov_34.259669	97	137	68	1	40	0.0250000
NODE_204532_length_280_cov_4.287293	53	100	2	37	47	0.7872341
NODE_204532_length_280_cov_4.287293	53	100	3	10	47	0.2127660
NODE_204532_length_280_cov_4.287293	129	186	2	46	57	0.8070176
NODE_204532_length_280_cov_4.287293	129	186	4	11	57	0.1929825
NODE_204596_length_280_cov_3.436464	34	103	51	1	69	0.0144928
NODE_204596_length_280_cov_3.436464	34	103	53	2	69	0.0289855
NODE_204596_length_280_cov_3.436464	34	103	55	1	69	0.0144928
NODE_204596_length_280_cov_3.436464	34	103	59	1	69	0.0144928
NODE_204596_length_280_cov_3.436464	34	103	61	1	69	0.0144928
NODE_204596_length_280_cov_3.436464	34	103	71	2	69	0.0289855
NODE_204596_length_280_cov_3.436464	34	103	73	2	69	0.0289855
NODE_204596_length_280_cov_3.436464	34	103	77	2	69	0.0289855
NODE_204596_length_280_cov_3.436464	34	103	78	3	69	0.0434783
NODE_204596_length_280_cov_3.436464	34	103	84	1	69	0.0144928
NODE_204596_length_280_cov_3.436464	34	103	87	1	69	0.0144928
NODE_204596_length_280_cov_3.436464	34	103	89	3	69	0.0434783
NODE_204596_length_280_cov_3.436464	34	103	93	1	69	0.0144928
NODE_204596_length_280_cov_3.436464	34	103	95	2	69	0.0289855
NODE_204596_length_280_cov_3.436464	34	103	97	7	69	0.1014493
NODE_204596_length_280_cov_3.436464	34	103	103	6	69	0.0869565
NODE_204596_length_280_cov_3.436464	34	103	105	1	69	0.0144928
NODE_204596_length_280_cov_3.436464	34	103	109	6	69	0.0869565
NODE_204596_length_280_cov_3.436464	34	103	112	11	69	0.1594203
NODE_204596_length_280_cov_3.436464	34	103	114	4	69	0.0579710
NODE_204596_length_280_cov_3.436464	34	103	115	11	69	0.1594203
NODE_204597_length_280_cov_3.430939	17	97	2	2	80	0.0250000
NODE_204597_length_280_cov_3.430939	17	97	4	15	80	0.1875000
NODE_204597_length_280_cov_3.430939	17	97	8	63	80	0.7875000
NODE_204597_length_280_cov_3.430939	27	97	4	7	70	0.1000000
NODE_204597_length_280_cov_3.430939	27	97	8	63	70	0.9000000
NODE_204674_length_280_cov_2.988950	118	164	0	18	46	0.3913043
NODE_204674_length_280_cov_2.988950	118	164	2	28	46	0.6086956
NODE_204938_length_280_cov_2.165746	2	48	0	46	46	1.0000000
NODE_204938_length_280_cov_2.165746	6	48	0	42	42	1.0000000
NODE_204938_length_280_cov_2.165746	21	101	0	80	80	1.0000000
NODE_204938_length_280_cov_2.165746	22	101	0	79	79	1.0000000
NODE_204938_length_280_cov_2.165746	32	101	0	69	69	1.0000000
NODE_204976_length_280_cov_2.022099	105	148	0	43	43	1.0000000
NODE_204976_length_280_cov_2.022099	121	148	0	27	27	1.0000000
NODE_205044_length_280_cov_1.889503	50	132	2	33	82	0.4024390
NODE_205044_length_280_cov_1.889503	50	132	4	49	82	0.5975610
NODE_205062_length_280_cov_1.828729	45	75	12	6	30	0.2000000
NODE_205062_length_280_cov_1.828729	45	75	14	14	30	0.4666667
NODE_205062_length_280_cov_1.828729	45	75	16	4	30	0.1333333
NODE_205062_length_280_cov_1.828729	45	75	18	6	30	0.2000000
NODE_205410_length_280_cov_1.425414	17	50	0	10	33	0.3030303
NODE_205410_length_280_cov_1.425414	17	50	2	23	33	0.6969697
NODE_205410_length_280_cov_1.425414	70	112	6	42	42	1.0000000
NODE_205416_length_280_cov_1.414365	37	97	0	60	60	1.0000000
NODE_205633_length_280_cov_1.187845	56	136	0	16	80	0.2000000
NODE_205633_length_280_cov_1.187845	56	136	2	64	80	0.8000000
NODE_205635_length_280_cov_1.182320	154	234	7	4	80	0.0500000
NODE_205635_length_280_cov_1.182320	154	234	10	1	80	0.0125000
NODE_205635_length_280_cov_1.182320	154	234	17	5	80	0.0625000
NODE_205635_length_280_cov_1.182320	154	234	21	4	80	0.0500000
NODE_205635_length_280_cov_1.182320	154	234	23	6	80	0.0750000
NODE_205635_length_280_cov_1.182320	154	234	25	2	80	0.0250000
NODE_205635_length_280_cov_1.182320	154	234	26	23	80	0.2875000
NODE_205635_length_280_cov_1.182320	154	234	30	35	80	0.4375000
NODE_205635_length_280_cov_1.182320	207	280	0	4	73	0.0547945
NODE_205635_length_280_cov_1.182320	207	280	2	21	73	0.2876712
NODE_205635_length_280_cov_1.182320	207	280	3	8	73	0.1095890
NODE_205635_length_280_cov_1.182320	207	280	7	17	73	0.2328767
NODE_205635_length_280_cov_1.182320	207	280	10	1	73	0.0136986
NODE_205635_length_280_cov_1.182320	207	280	17	5	73	0.0684932
NODE_205635_length_280_cov_1.182320	207	280	21	4	73	0.0547945
NODE_205635_length_280_cov_1.182320	207	280	23	6	73	0.0821918
NODE_205635_length_280_cov_1.182320	207	280	25	2	73	0.0273973
NODE_205635_length_280_cov_1.182320	207	280	26	5	73	0.0684932
NODE_205701_length_280_cov_1.127072	204	265	2	3	61	0.0491803
NODE_205701_length_280_cov_1.127072	204	265	4	4	61	0.0655738
NODE_205701_length_280_cov_1.127072	204	265	6	54	61	0.8852459
NODE_205794_length_280_cov_1.127072	0	39	0	39	39	1.0000000
NODE_205801_length_280_cov_1.127072	218	253	0	35	35	1.0000000
NODE_205894_length_280_cov_1.127072	0	59	0	59	59	1.0000000
NODE_206211_length_280_cov_0.911602	176	256	0	80	80	1.0000000
NODE_206211_length_280_cov_0.911602	229	280	0	51	51	1.0000000
NODE_206319_length_280_cov_0.845304	211	268	0	57	57	1.0000000
NODE_206531_length_280_cov_0.779006	129	203	22	74	74	1.0000000
NODE_206721_length_279_cov_50.005556	51	130	46	13	79	0.1645570
NODE_206721_length_279_cov_50.005556	51	130	48	1	79	0.0126582
NODE_206721_length_279_cov_50.005556	51	130	50	8	79	0.1012658
NODE_206721_length_279_cov_50.005556	51	130	54	9	79	0.1139240
NODE_206721_length_279_cov_50.005556	51	130	56	5	79	0.0632911
NODE_206721_length_279_cov_50.005556	51	130	60	7	79	0.0886076
NODE_206721_length_279_cov_50.005556	51	130	62	9	79	0.1139240
NODE_206721_length_279_cov_50.005556	51	130	64	9	79	0.1139240
NODE_206721_length_279_cov_50.005556	51	130	66	18	79	0.2278481
NODE_206721_length_279_cov_50.005556	103	179	12	3	76	0.0394737
NODE_206721_length_279_cov_50.005556	103	179	15	1	76	0.0131579
NODE_206721_length_279_cov_50.005556	103	179	16	5	76	0.0657895
NODE_206721_length_279_cov_50.005556	103	179	18	2	76	0.0263158
NODE_206721_length_279_cov_50.005556	103	179	20	9	76	0.1184211
NODE_206721_length_279_cov_50.005556	103	179	22	1	76	0.0131579
NODE_206721_length_279_cov_50.005556	103	179	26	1	76	0.0131579
NODE_206721_length_279_cov_50.005556	103	179	27	5	76	0.0657895
NODE_206721_length_279_cov_50.005556	103	179	28	5	76	0.0657895
NODE_206721_length_279_cov_50.005556	103	179	30	3	76	0.0394737
NODE_206721_length_279_cov_50.005556	103	179	32	1	76	0.0131579
NODE_206721_length_279_cov_50.005556	103	179	35	7	76	0.0921053
NODE_206721_length_279_cov_50.005556	103	179	43	1	76	0.0131579
NODE_206721_length_279_cov_50.005556	103	179	45	5	76	0.0657895
NODE_206721_length_279_cov_50.005556	103	179	46	4	76	0.0526316
NODE_206721_length_279_cov_50.005556	103	179	50	1	76	0.0131579
NODE_206721_length_279_cov_50.005556	103	179	56	2	76	0.0263158
NODE_206721_length_279_cov_50.005556	103	179	64	9	76	0.1184211
NODE_206721_length_279_cov_50.005556	103	179	66	11	76	0.1447368
NODE_206744_length_279_cov_6.055556	196	228	0	32	32	1.0000000
NODE_206762_length_279_cov_5.166667	197	277	0	80	80	1.0000000
NODE_206788_length_279_cov_4.427778	107	187	5	20	80	0.2500000
NODE_206788_length_279_cov_4.427778	107	187	8	1	80	0.0125000
NODE_206788_length_279_cov_4.427778	107	187	9	12	80	0.1500000
NODE_206788_length_279_cov_4.427778	107	187	10	5	80	0.0625000
NODE_206788_length_279_cov_4.427778	107	187	11	42	80	0.5250000
NODE_206879_length_279_cov_3.200000	205	225	0	20	20	1.0000000
NODE_206886_length_279_cov_3.116667	115	195	0	80	80	1.0000000
NODE_206886_length_279_cov_3.116667	168	248	0	80	80	1.0000000
NODE_206972_length_279_cov_2.600000	67	147	6	48	80	0.6000000
NODE_206972_length_279_cov_2.600000	67	147	8	32	80	0.4000000
NODE_206972_length_279_cov_2.600000	120	199	0	39	79	0.4936709
NODE_206972_length_279_cov_2.600000	120	199	2	4	79	0.0506329
NODE_206972_length_279_cov_2.600000	120	199	6	36	79	0.4556962
NODE_207023_length_279_cov_2.427778	155	199	0	44	44	1.0000000
NODE_207052_length_279_cov_2.283333	168	240	0	72	72	1.0000000
NODE_207054_length_279_cov_2.277778	190	265	0	75	75	1.0000000
NODE_207086_length_279_cov_2.266667	66	109	0	43	43	1.0000000
NODE_207115_length_279_cov_2.255556	115	176	0	14	61	0.2295082
NODE_207115_length_279_cov_2.255556	115	176	2	47	61	0.7704918
NODE_207115_length_279_cov_2.255556	168	222	0	26	54	0.4814815
NODE_207115_length_279_cov_2.255556	168	222	2	28	54	0.5185185
NODE_207155_length_279_cov_2.200000	57	104	4	13	47	0.2765957
NODE_207155_length_279_cov_2.200000	57	104	6	12	47	0.2553191
NODE_207155_length_279_cov_2.200000	57	104	8	22	47	0.4680851
NODE_207269_length_279_cov_1.977778	0	62	0	62	62	1.0000000
NODE_207293_length_279_cov_1.944444	63	105	0	42	42	1.0000000
NODE_207306_length_279_cov_1.916667	182	262	0	80	80	1.0000000
NODE_207318_length_279_cov_1.866667	63	143	4	80	80	1.0000000
NODE_207387_length_279_cov_1.700000	8	37	0	29	29	1.0000000
NODE_207389_length_279_cov_1.700000	10	42	0	32	32	1.0000000
NODE_207534_length_279_cov_1.672222	103	183	0	27	80	0.3375000
NODE_207534_length_279_cov_1.672222	103	183	2	3	80	0.0375000
NODE_207534_length_279_cov_1.672222	103	183	6	50	80	0.6250000
NODE_207641_length_279_cov_1.433333	51	110	2	12	59	0.2033898
NODE_207641_length_279_cov_1.433333	51	110	4	11	59	0.1864407
NODE_207641_length_279_cov_1.433333	51	110	6	36	59	0.6101695
NODE_207641_length_279_cov_1.433333	83	119	2	21	36	0.5833333
NODE_207641_length_279_cov_1.433333	83	119	4	6	36	0.1666667
NODE_207641_length_279_cov_1.433333	83	119	6	9	36	0.2500000
NODE_207929_length_279_cov_1.144444	146	211	0	65	65	1.0000000
NODE_207929_length_279_cov_1.144444	184	266	0	82	82	1.0000000
NODE_207931_length_279_cov_1.138889	125	188	36	1	63	0.0158730
NODE_207931_length_279_cov_1.138889	125	188	38	1	63	0.0158730
NODE_207931_length_279_cov_1.138889	125	188	40	1	63	0.0158730
NODE_207931_length_279_cov_1.138889	125	188	41	8	63	0.1269841
NODE_207931_length_279_cov_1.138889	125	188	42	5	63	0.0793651
NODE_207931_length_279_cov_1.138889	125	188	45	7	63	0.1111111
NODE_207931_length_279_cov_1.138889	125	188	46	3	63	0.0476190
NODE_207931_length_279_cov_1.138889	125	188	47	4	63	0.0634921
NODE_207931_length_279_cov_1.138889	125	188	48	3	63	0.0476190
NODE_207931_length_279_cov_1.138889	125	188	49	2	63	0.0317460
NODE_207931_length_279_cov_1.138889	125	188	50	4	63	0.0634921
NODE_207931_length_279_cov_1.138889	125	188	51	23	63	0.3650794
NODE_207931_length_279_cov_1.138889	125	188	52	1	63	0.0158730
NODE_207932_length_279_cov_1.138889	111	191	2	80	80	1.0000000
NODE_207948_length_279_cov_1.133333	231	271	0	40	40	1.0000000
NODE_208183_length_279_cov_1.116667	15	92	0	77	77	1.0000000
NODE_208334_length_279_cov_0.988889	181	261	0	20	80	0.2500000
NODE_208334_length_279_cov_0.988889	181	261	2	12	80	0.1500000
NODE_208334_length_279_cov_0.988889	181	261	4	48	80	0.6000000
NODE_208410_length_279_cov_0.927778	50	69	0	19	19	1.0000000
NODE_208410_length_279_cov_0.927778	50	69	0	19	19	1.0000000
NODE_208664_length_279_cov_0.844444	35	70	0	35	35	1.0000000
NODE_209293_length_278_cov_44.882682	158	210	11	26	52	0.5000000
NODE_209293_length_278_cov_44.882682	158	210	12	1	52	0.0192308
NODE_209293_length_278_cov_44.882682	158	210	13	14	52	0.2692308
NODE_209293_length_278_cov_44.882682	158	210	17	5	52	0.0961538
NODE_209293_length_278_cov_44.882682	158	210	18	2	52	0.0384615
NODE_209293_length_278_cov_44.882682	158	210	20	2	52	0.0384615
NODE_209293_length_278_cov_44.882682	158	210	21	2	52	0.0384615
NODE_209293_length_278_cov_44.882682	206	232	6	5	26	0.1923077
NODE_209293_length_278_cov_44.882682	206	232	8	3	26	0.1153846
NODE_209293_length_278_cov_44.882682	206	232	9	4	26	0.1538462
NODE_209293_length_278_cov_44.882682	206	232	11	14	26	0.5384616
NODE_209293_length_278_cov_44.882682	206	265	6	38	59	0.6440678
NODE_209293_length_278_cov_44.882682	206	265	8	3	59	0.0508475
NODE_209293_length_278_cov_44.882682	206	265	9	4	59	0.0677966
NODE_209293_length_278_cov_44.882682	206	265	11	14	59	0.2372881
NODE_209294_length_278_cov_37.474860	0	52	0	52	52	1.0000000
NODE_209294_length_278_cov_37.474860	48	128	0	7	80	0.0875000
NODE_209294_length_278_cov_37.474860	48	128	6	1	80	0.0125000
NODE_209294_length_278_cov_37.474860	48	128	7	1	80	0.0125000
NODE_209294_length_278_cov_37.474860	48	128	8	4	80	0.0500000
NODE_209294_length_278_cov_37.474860	48	128	16	20	80	0.2500000
NODE_209294_length_278_cov_37.474860	48	128	18	47	80	0.5875000
NODE_209294_length_278_cov_37.474860	101	181	15	11	80	0.1375000
NODE_209294_length_278_cov_37.474860	101	181	16	38	80	0.4750000
NODE_209294_length_278_cov_37.474860	101	181	18	31	80	0.3875000
NODE_209295_length_278_cov_21.340782	84	164	0	80	80	1.0000000
NODE_209295_length_278_cov_21.340782	137	217	0	80	80	1.0000000
NODE_209360_length_278_cov_4.156425	132	210	0	23	78	0.2948718
NODE_209360_length_278_cov_4.156425	132	210	2	8	78	0.1025641
NODE_209360_length_278_cov_4.156425	132	210	3	6	78	0.0769231
NODE_209360_length_278_cov_4.156425	132	210	5	19	78	0.2435897
NODE_209360_length_278_cov_4.156425	132	210	7	1	78	0.0128205
NODE_209360_length_278_cov_4.156425	132	210	8	21	78	0.2692308
NODE_209360_length_278_cov_4.156425	193	263	0	9	70	0.1285714
NODE_209360_length_278_cov_4.156425	193	263	2	61	70	0.8714285
NODE_209372_length_278_cov_3.977654	142	221	2	21	79	0.2658228
NODE_209372_length_278_cov_3.977654	142	221	4	58	79	0.7341772
NODE_209378_length_278_cov_3.865922	168	210	0	42	42	1.0000000
NODE_209552_length_278_cov_2.558659	93	123	0	30	30	1.0000000
NODE_209565_length_278_cov_2.513966	54	106	0	52	52	1.0000000
NODE_209565_length_278_cov_2.513966	79	158	0	79	79	1.0000000
NODE_209605_length_278_cov_2.296089	127	207	10	26	80	0.3250000
NODE_209605_length_278_cov_2.296089	127	207	12	54	80	0.6750000
NODE_209883_length_278_cov_1.731844	145	194	13	3	49	0.0612245
NODE_209883_length_278_cov_1.731844	145	194	14	4	49	0.0816327
NODE_209883_length_278_cov_1.731844	145	194	16	2	49	0.0408163
NODE_209883_length_278_cov_1.731844	145	194	18	3	49	0.0612245
NODE_209883_length_278_cov_1.731844	145	194	19	6	49	0.1224490
NODE_209883_length_278_cov_1.731844	145	194	21	1	49	0.0204082
NODE_209883_length_278_cov_1.731844	145	194	23	1	49	0.0204082
NODE_209883_length_278_cov_1.731844	145	194	27	12	49	0.2448980
NODE_209883_length_278_cov_1.731844	145	194	29	5	49	0.1020408
NODE_209883_length_278_cov_1.731844	145	194	31	3	49	0.0612245
NODE_209883_length_278_cov_1.731844	145	194	35	1	49	0.0204082
NODE_209883_length_278_cov_1.731844	145	194	37	8	49	0.1632653
NODE_210038_length_278_cov_1.681564	129	184	0	29	55	0.5272727
NODE_210038_length_278_cov_1.681564	129	184	2	13	55	0.2363636
NODE_210038_length_278_cov_1.681564	129	184	4	13	55	0.2363636
NODE_210068_length_278_cov_1.636872	13	41	7	2	28	0.0714286
NODE_210068_length_278_cov_1.636872	13	41	15	17	28	0.6071429
NODE_210068_length_278_cov_1.636872	13	41	21	9	28	0.3214286
NODE_210373_length_278_cov_1.290503	3	67	11	1	64	0.0156250
NODE_210373_length_278_cov_1.290503	3	67	14	4	64	0.0625000
NODE_210373_length_278_cov_1.290503	3	67	15	1	64	0.0156250
NODE_210373_length_278_cov_1.290503	3	67	21	2	64	0.0312500
NODE_210373_length_278_cov_1.290503	3	67	26	1	64	0.0156250
NODE_210373_length_278_cov_1.290503	3	67	32	1	64	0.0156250
NODE_210373_length_278_cov_1.290503	3	67	37	1	64	0.0156250
NODE_210373_length_278_cov_1.290503	3	67	39	1	64	0.0156250
NODE_210373_length_278_cov_1.290503	3	67	49	1	64	0.0156250
NODE_210373_length_278_cov_1.290503	3	67	54	1	64	0.0156250
NODE_210373_length_278_cov_1.290503	3	67	57	1	64	0.0156250
NODE_210373_length_278_cov_1.290503	3	67	59	1	64	0.0156250
NODE_210373_length_278_cov_1.290503	3	67	67	1	64	0.0156250
NODE_210373_length_278_cov_1.290503	3	67	68	1	64	0.0156250
NODE_210373_length_278_cov_1.290503	3	67	69	1	64	0.0156250
NODE_210373_length_278_cov_1.290503	3	67	75	1	64	0.0156250
NODE_210373_length_278_cov_1.290503	3	67	76	7	64	0.1093750
NODE_210373_length_278_cov_1.290503	3	67	81	1	64	0.0156250
NODE_210373_length_278_cov_1.290503	3	67	84	3	64	0.0468750
NODE_210373_length_278_cov_1.290503	3	67	85	1	64	0.0156250
NODE_210373_length_278_cov_1.290503	3	67	86	1	64	0.0156250
NODE_210373_length_278_cov_1.290503	3	67	87	1	64	0.0156250
NODE_210373_length_278_cov_1.290503	3	67	89	1	64	0.0156250
NODE_210373_length_278_cov_1.290503	3	67	91	2	64	0.0312500
NODE_210373_length_278_cov_1.290503	3	67	92	1	64	0.0156250
NODE_210373_length_278_cov_1.290503	3	67	94	5	64	0.0781250
NODE_210373_length_278_cov_1.290503	3	67	96	10	64	0.1562500
NODE_210373_length_278_cov_1.290503	3	67	98	11	64	0.1718750
NODE_210373_length_278_cov_1.290503	3	67	11	1	64	0.0156250
NODE_210373_length_278_cov_1.290503	3	67	14	4	64	0.0625000
NODE_210373_length_278_cov_1.290503	3	67	15	1	64	0.0156250
NODE_210373_length_278_cov_1.290503	3	67	21	2	64	0.0312500
NODE_210373_length_278_cov_1.290503	3	67	26	1	64	0.0156250
NODE_210373_length_278_cov_1.290503	3	67	32	1	64	0.0156250
NODE_210373_length_278_cov_1.290503	3	67	37	1	64	0.0156250
NODE_210373_length_278_cov_1.290503	3	67	39	1	64	0.0156250
NODE_210373_length_278_cov_1.290503	3	67	49	1	64	0.0156250
NODE_210373_length_278_cov_1.290503	3	67	54	1	64	0.0156250
NODE_210373_length_278_cov_1.290503	3	67	57	1	64	0.0156250
NODE_210373_length_278_cov_1.290503	3	67	59	1	64	0.0156250
NODE_210373_length_278_cov_1.290503	3	67	67	1	64	0.0156250
NODE_210373_length_278_cov_1.290503	3	67	68	1	64	0.0156250
NODE_210373_length_278_cov_1.290503	3	67	69	1	64	0.0156250
NODE_210373_length_278_cov_1.290503	3	67	75	1	64	0.0156250
NODE_210373_length_278_cov_1.290503	3	67	76	7	64	0.1093750
NODE_210373_length_278_cov_1.290503	3	67	81	1	64	0.0156250
NODE_210373_length_278_cov_1.290503	3	67	84	3	64	0.0468750
NODE_210373_length_278_cov_1.290503	3	67	85	1	64	0.0156250
NODE_210373_length_278_cov_1.290503	3	67	86	1	64	0.0156250
NODE_210373_length_278_cov_1.290503	3	67	87	1	64	0.0156250
NODE_210373_length_278_cov_1.290503	3	67	89	1	64	0.0156250
NODE_210373_length_278_cov_1.290503	3	67	91	2	64	0.0312500
NODE_210373_length_278_cov_1.290503	3	67	92	1	64	0.0156250
NODE_210373_length_278_cov_1.290503	3	67	94	5	64	0.0781250
NODE_210373_length_278_cov_1.290503	3	67	96	10	64	0.1562500
NODE_210373_length_278_cov_1.290503	3	67	98	11	64	0.1718750
NODE_210373_length_278_cov_1.290503	3	67	11	1	64	0.0156250
NODE_210373_length_278_cov_1.290503	3	67	14	4	64	0.0625000
NODE_210373_length_278_cov_1.290503	3	67	15	1	64	0.0156250
NODE_210373_length_278_cov_1.290503	3	67	21	2	64	0.0312500
NODE_210373_length_278_cov_1.290503	3	67	26	1	64	0.0156250
NODE_210373_length_278_cov_1.290503	3	67	32	1	64	0.0156250
NODE_210373_length_278_cov_1.290503	3	67	37	1	64	0.0156250
NODE_210373_length_278_cov_1.290503	3	67	39	1	64	0.0156250
NODE_210373_length_278_cov_1.290503	3	67	49	1	64	0.0156250
NODE_210373_length_278_cov_1.290503	3	67	54	1	64	0.0156250
NODE_210373_length_278_cov_1.290503	3	67	57	1	64	0.0156250
NODE_210373_length_278_cov_1.290503	3	67	59	1	64	0.0156250
NODE_210373_length_278_cov_1.290503	3	67	67	1	64	0.0156250
NODE_210373_length_278_cov_1.290503	3	67	68	1	64	0.0156250
NODE_210373_length_278_cov_1.290503	3	67	69	1	64	0.0156250
NODE_210373_length_278_cov_1.290503	3	67	75	1	64	0.0156250
NODE_210373_length_278_cov_1.290503	3	67	76	7	64	0.1093750
NODE_210373_length_278_cov_1.290503	3	67	81	1	64	0.0156250
NODE_210373_length_278_cov_1.290503	3	67	84	3	64	0.0468750
NODE_210373_length_278_cov_1.290503	3	67	85	1	64	0.0156250
NODE_210373_length_278_cov_1.290503	3	67	86	1	64	0.0156250
NODE_210373_length_278_cov_1.290503	3	67	87	1	64	0.0156250
NODE_210373_length_278_cov_1.290503	3	67	89	1	64	0.0156250
NODE_210373_length_278_cov_1.290503	3	67	91	2	64	0.0312500
NODE_210373_length_278_cov_1.290503	3	67	92	1	64	0.0156250
NODE_210373_length_278_cov_1.290503	3	67	94	5	64	0.0781250
NODE_210373_length_278_cov_1.290503	3	67	96	10	64	0.1562500
NODE_210373_length_278_cov_1.290503	3	67	98	11	64	0.1718750
NODE_210463_length_278_cov_1.150838	52	76	6	24	24	1.0000000
NODE_210463_length_278_cov_1.150838	58	84	4	7	26	0.2692308
NODE_210463_length_278_cov_1.150838	58	84	6	19	26	0.7307692
NODE_210559_length_278_cov_1.139665	108	187	0	79	79	1.0000000
NODE_210612_length_278_cov_1.139665	232	278	0	46	46	1.0000000
NODE_210691_length_278_cov_1.139665	210	278	0	28	68	0.4117647
NODE_210691_length_278_cov_1.139665	210	278	2	29	68	0.4264706
NODE_210691_length_278_cov_1.139665	210	278	4	11	68	0.1617647
NODE_212166_length_277_cov_2.691011	0	60	0	60	60	1.0000000
NODE_212166_length_277_cov_2.691011	33	113	0	80	80	1.0000000
NODE_212175_length_277_cov_2.617978	85	127	2	26	42	0.6190476
NODE_212175_length_277_cov_2.617978	85	127	4	16	42	0.3809524
NODE_212233_length_277_cov_2.438202	137	218	0	5	81	0.0617284
NODE_212233_length_277_cov_2.438202	137	218	2	53	81	0.6543210
NODE_212233_length_277_cov_2.438202	137	218	6	23	81	0.2839506
NODE_212357_length_277_cov_2.140449	234	276	0	1	42	0.0238095
NODE_212357_length_277_cov_2.140449	234	276	4	41	42	0.9761904
NODE_212377_length_277_cov_2.095506	41	114	0	73	73	1.0000000
NODE_212377_length_277_cov_2.095506	41	114	0	73	73	1.0000000
NODE_212377_length_277_cov_2.095506	94	161	0	39	67	0.5820895
NODE_212377_length_277_cov_2.095506	94	161	2	28	67	0.4179105
NODE_212525_length_277_cov_1.837079	92	172	2	80	80	1.0000000
NODE_212558_length_277_cov_1.764045	115	155	2	9	40	0.2250000
NODE_212558_length_277_cov_1.764045	115	155	4	12	40	0.3000000
NODE_212558_length_277_cov_1.764045	115	155	6	4	40	0.1000000
NODE_212558_length_277_cov_1.764045	115	155	8	1	40	0.0250000
NODE_212558_length_277_cov_1.764045	115	155	10	2	40	0.0500000
NODE_212558_length_277_cov_1.764045	115	155	14	12	40	0.3000000
NODE_212605_length_277_cov_1.719101	150	215	2	65	65	1.0000000
NODE_212845_length_277_cov_1.505618	0	47	0	2	47	0.0425532
NODE_212845_length_277_cov_1.505618	0	47	2	45	47	0.9574468
NODE_212845_length_277_cov_1.505618	20	100	0	14	80	0.1750000
NODE_212845_length_277_cov_1.505618	20	100	2	66	80	0.8250000
NODE_212970_length_277_cov_1.426966	113	191	0	54	78	0.6923077
NODE_212970_length_277_cov_1.426966	113	191	2	24	78	0.3076923
NODE_213057_length_277_cov_1.314607	127	176	0	49	49	1.0000000
NODE_213091_length_277_cov_1.258427	141	222	0	81	81	1.0000000
NODE_213223_length_277_cov_1.146067	19	95	0	46	76	0.6052632
NODE_213223_length_277_cov_1.146067	19	95	1	13	76	0.1710526
NODE_213223_length_277_cov_1.146067	19	95	3	3	76	0.0394737
NODE_213223_length_277_cov_1.146067	19	95	5	7	76	0.0921053
NODE_213223_length_277_cov_1.146067	19	95	7	3	76	0.0394737
NODE_213223_length_277_cov_1.146067	19	95	9	4	76	0.0526316
NODE_213490_length_277_cov_1.061798	67	105	0	38	38	1.0000000
NODE_213505_length_277_cov_1.044944	19	77	0	58	58	1.0000000
NODE_214572_length_276_cov_31.774011	91	153	56	1	62	0.0161290
NODE_214572_length_276_cov_31.774011	91	153	58	1	62	0.0161290
NODE_214572_length_276_cov_31.774011	91	153	59	1	62	0.0161290
NODE_214572_length_276_cov_31.774011	91	153	67	2	62	0.0322581
NODE_214572_length_276_cov_31.774011	91	153	69	1	62	0.0161290
NODE_214572_length_276_cov_31.774011	91	153	72	1	62	0.0161290
NODE_214572_length_276_cov_31.774011	91	153	76	1	62	0.0161290
NODE_214572_length_276_cov_31.774011	91	153	81	1	62	0.0161290
NODE_214572_length_276_cov_31.774011	91	153	84	1	62	0.0161290
NODE_214572_length_276_cov_31.774011	91	153	87	2	62	0.0322581
NODE_214572_length_276_cov_31.774011	91	153	90	1	62	0.0161290
NODE_214572_length_276_cov_31.774011	91	153	91	1	62	0.0161290
NODE_214572_length_276_cov_31.774011	91	153	99	1	62	0.0161290
NODE_214572_length_276_cov_31.774011	91	153	103	1	62	0.0161290
NODE_214572_length_276_cov_31.774011	91	153	111	3	62	0.0483871
NODE_214572_length_276_cov_31.774011	91	153	117	1	62	0.0161290
NODE_214572_length_276_cov_31.774011	91	153	118	1	62	0.0161290
NODE_214572_length_276_cov_31.774011	91	153	120	1	62	0.0161290
NODE_214572_length_276_cov_31.774011	91	153	122	1	62	0.0161290
NODE_214572_length_276_cov_31.774011	91	153	132	1	62	0.0161290
NODE_214572_length_276_cov_31.774011	91	153	144	1	62	0.0161290
NODE_214572_length_276_cov_31.774011	91	153	147	1	62	0.0161290
NODE_214572_length_276_cov_31.774011	91	153	153	1	62	0.0161290
NODE_214572_length_276_cov_31.774011	91	153	160	2	62	0.0322581
NODE_214572_length_276_cov_31.774011	91	153	174	1	62	0.0161290
NODE_214572_length_276_cov_31.774011	91	153	178	1	62	0.0161290
NODE_214572_length_276_cov_31.774011	91	153	180	1	62	0.0161290
NODE_214572_length_276_cov_31.774011	91	153	197	1	62	0.0161290
NODE_214572_length_276_cov_31.774011	91	153	207	1	62	0.0161290
NODE_214572_length_276_cov_31.774011	91	153	217	1	62	0.0161290
NODE_214572_length_276_cov_31.774011	91	153	220	1	62	0.0161290
NODE_214572_length_276_cov_31.774011	91	153	231	1	62	0.0161290
NODE_214572_length_276_cov_31.774011	91	153	238	1	62	0.0161290
NODE_214572_length_276_cov_31.774011	91	153	243	1	62	0.0161290
NODE_214572_length_276_cov_31.774011	91	153	246	1	62	0.0161290
NODE_214572_length_276_cov_31.774011	91	153	266	1	62	0.0161290
NODE_214572_length_276_cov_31.774011	91	153	270	2	62	0.0322581
NODE_214572_length_276_cov_31.774011	91	153	278	1	62	0.0161290
NODE_214572_length_276_cov_31.774011	91	153	282	1	62	0.0161290
NODE_214572_length_276_cov_31.774011	91	153	285	1	62	0.0161290
NODE_214572_length_276_cov_31.774011	91	153	290	2	62	0.0322581
NODE_214572_length_276_cov_31.774011	91	153	298	1	62	0.0161290
NODE_214572_length_276_cov_31.774011	91	153	300	1	62	0.0161290
NODE_214572_length_276_cov_31.774011	91	153	306	1	62	0.0161290
NODE_214572_length_276_cov_31.774011	91	153	308	3	62	0.0483871
NODE_214572_length_276_cov_31.774011	91	153	312	4	62	0.0645161
NODE_214572_length_276_cov_31.774011	91	153	314	1	62	0.0161290
NODE_214572_length_276_cov_31.774011	91	153	316	2	62	0.0322581
NODE_214572_length_276_cov_31.774011	91	153	321	1	62	0.0161290
NODE_214576_length_276_cov_10.056497	66	146	4	29	80	0.3625000
NODE_214576_length_276_cov_10.056497	66	146	6	38	80	0.4750000
NODE_214576_length_276_cov_10.056497	66	146	8	13	80	0.1625000
NODE_214698_length_276_cov_3.564972	176	256	0	57	80	0.7125000
NODE_214698_length_276_cov_3.564972	176	256	1	16	80	0.2000000
NODE_214698_length_276_cov_3.564972	176	256	2	3	80	0.0375000
NODE_214698_length_276_cov_3.564972	176	256	3	4	80	0.0500000
NODE_214785_length_276_cov_2.920904	203	260	0	57	57	1.0000000
NODE_214785_length_276_cov_2.920904	233	276	0	43	43	1.0000000
NODE_214883_length_276_cov_2.542373	164	204	22	4	40	0.1000000
NODE_214883_length_276_cov_2.542373	164	204	24	11	40	0.2750000
NODE_214883_length_276_cov_2.542373	164	204	26	1	40	0.0250000
NODE_214883_length_276_cov_2.542373	164	204	27	1	40	0.0250000
NODE_214883_length_276_cov_2.542373	164	204	28	23	40	0.5750000
NODE_215016_length_276_cov_2.197740	64	144	2	6	80	0.0750000
NODE_215016_length_276_cov_2.197740	64	144	4	72	80	0.9000000
NODE_215016_length_276_cov_2.197740	64	144	6	2	80	0.0250000
NODE_215086_length_276_cov_2.022599	136	193	2	6	57	0.1052632
NODE_215086_length_276_cov_2.022599	136	193	4	24	57	0.4210526
NODE_215086_length_276_cov_2.022599	136	193	5	25	57	0.4385965
NODE_215086_length_276_cov_2.022599	136	193	7	2	57	0.0350877
NODE_215105_length_276_cov_2.016949	97	138	0	8	41	0.1951219
NODE_215105_length_276_cov_2.016949	97	138	2	27	41	0.6585366
NODE_215105_length_276_cov_2.016949	97	138	4	1	41	0.0243902
NODE_215105_length_276_cov_2.016949	97	138	6	5	41	0.1219512
NODE_215139_length_276_cov_2.005650	82	153	0	71	71	1.0000000
NODE_215234_length_276_cov_1.734463	102	182	6	1	80	0.0125000
NODE_215234_length_276_cov_1.734463	102	182	8	2	80	0.0250000
NODE_215234_length_276_cov_1.734463	102	182	12	2	80	0.0250000
NODE_215234_length_276_cov_1.734463	102	182	16	6	80	0.0750000
NODE_215234_length_276_cov_1.734463	102	182	18	2	80	0.0250000
NODE_215234_length_276_cov_1.734463	102	182	24	2	80	0.0250000
NODE_215234_length_276_cov_1.734463	102	182	26	1	80	0.0125000
NODE_215234_length_276_cov_1.734463	102	182	28	2	80	0.0250000
NODE_215234_length_276_cov_1.734463	102	182	32	10	80	0.1250000
NODE_215234_length_276_cov_1.734463	102	182	34	1	80	0.0125000
NODE_215234_length_276_cov_1.734463	102	182	36	4	80	0.0500000
NODE_215234_length_276_cov_1.734463	102	182	38	2	80	0.0250000
NODE_215234_length_276_cov_1.734463	102	182	42	7	80	0.0875000
NODE_215234_length_276_cov_1.734463	102	182	44	12	80	0.1500000
NODE_215234_length_276_cov_1.734463	102	182	46	3	80	0.0375000
NODE_215234_length_276_cov_1.734463	102	182	48	2	80	0.0250000
NODE_215234_length_276_cov_1.734463	102	182	52	8	80	0.1000000
NODE_215234_length_276_cov_1.734463	102	182	54	13	80	0.1625000
NODE_215516_length_276_cov_1.525424	70	116	0	46	46	1.0000000
NODE_215516_length_276_cov_1.525424	123	169	0	46	46	1.0000000
NODE_215519_length_276_cov_1.514124	115	155	20	26	40	0.6500000
NODE_215519_length_276_cov_1.514124	115	155	22	14	40	0.3500000
NODE_215748_length_276_cov_1.288136	114	154	16	14	40	0.3500000
NODE_215748_length_276_cov_1.288136	114	154	18	11	40	0.2750000
NODE_215748_length_276_cov_1.288136	114	154	20	15	40	0.3750000
NODE_216141_length_276_cov_1.124294	122	170	4	33	48	0.6875000
NODE_216141_length_276_cov_1.124294	122	170	6	15	48	0.3125000
NODE_216141_length_276_cov_1.124294	132	163	4	23	31	0.7419355
NODE_216141_length_276_cov_1.124294	132	163	6	8	31	0.2580645
NODE_216220_length_276_cov_1.039548	7	68	0	10	61	0.1639344
NODE_216220_length_276_cov_1.039548	7	68	4	11	61	0.1803279
NODE_216220_length_276_cov_1.039548	7	68	8	30	61	0.4918033
NODE_216220_length_276_cov_1.039548	7	68	11	2	61	0.0327869
NODE_216220_length_276_cov_1.039548	7	68	12	8	61	0.1311475
NODE_216220_length_276_cov_1.039548	7	70	0	10	63	0.1587302
NODE_216220_length_276_cov_1.039548	7	70	4	11	63	0.1746032
NODE_216220_length_276_cov_1.039548	7	70	8	30	63	0.4761905
NODE_216220_length_276_cov_1.039548	7	70	11	2	63	0.0317460
NODE_216220_length_276_cov_1.039548	7	70	12	10	63	0.1587302
NODE_216220_length_276_cov_1.039548	7	70	0	10	63	0.1587302
NODE_216220_length_276_cov_1.039548	7	70	4	11	63	0.1746032
NODE_216220_length_276_cov_1.039548	7	70	8	30	63	0.4761905
NODE_216220_length_276_cov_1.039548	7	70	11	2	63	0.0317460
NODE_216220_length_276_cov_1.039548	7	70	12	10	63	0.1587302
NODE_216220_length_276_cov_1.039548	7	70	0	10	63	0.1587302
NODE_216220_length_276_cov_1.039548	7	70	4	11	63	0.1746032
NODE_216220_length_276_cov_1.039548	7	70	8	30	63	0.4761905
NODE_216220_length_276_cov_1.039548	7	70	11	2	63	0.0317460
NODE_216220_length_276_cov_1.039548	7	70	12	10	63	0.1587302
NODE_216269_length_276_cov_1.000000	48	89	0	41	41	1.0000000
NODE_216269_length_276_cov_1.000000	62	106	0	44	44	1.0000000
NODE_216414_length_276_cov_0.898305	54	105	0	51	51	1.0000000
NODE_217265_length_275_cov_85.085227	94	174	0	3	80	0.0375000
NODE_217265_length_275_cov_85.085227	94	174	3	23	80	0.2875000
NODE_217265_length_275_cov_85.085227	94	174	4	54	80	0.6750000
NODE_217265_length_275_cov_85.085227	147	227	0	56	80	0.7000000
NODE_217265_length_275_cov_85.085227	147	227	4	24	80	0.3000000
NODE_217287_length_275_cov_5.818182	0	44	0	15	44	0.3409091
NODE_217287_length_275_cov_5.818182	0	44	2	29	44	0.6590909
NODE_217355_length_275_cov_3.857955	0	67	0	4	67	0.0597015
NODE_217355_length_275_cov_3.857955	0	67	2	63	67	0.9402985
NODE_217396_length_275_cov_3.306818	199	275	0	76	76	1.0000000
NODE_217402_length_275_cov_3.284091	127	175	0	48	48	1.0000000
NODE_217433_length_275_cov_2.977273	95	145	8	50	50	1.0000000
NODE_217531_length_275_cov_2.585227	85	122	60	1	37	0.0270270
NODE_217531_length_275_cov_2.585227	85	122	62	12	37	0.3243243
NODE_217531_length_275_cov_2.585227	85	122	64	5	37	0.1351351
NODE_217531_length_275_cov_2.585227	85	122	66	5	37	0.1351351
NODE_217531_length_275_cov_2.585227	85	122	68	2	37	0.0540541
NODE_217531_length_275_cov_2.585227	85	122	70	12	37	0.3243243
NODE_217714_length_275_cov_2.090909	0	47	0	37	47	0.7872341
NODE_217714_length_275_cov_2.090909	0	47	2	10	47	0.2127660
NODE_217714_length_275_cov_2.090909	20	91	0	17	71	0.2394366
NODE_217714_length_275_cov_2.090909	20	91	2	36	71	0.5070422
NODE_217714_length_275_cov_2.090909	20	91	4	18	71	0.2535211
NODE_217801_length_275_cov_1.960227	198	251	0	53	53	1.0000000
NODE_217835_length_275_cov_1.875000	190	247	0	57	57	1.0000000
NODE_217839_length_275_cov_1.857955	52	119	0	21	67	0.3134328
NODE_217839_length_275_cov_1.857955	52	119	2	46	67	0.6865672
NODE_217839_length_275_cov_1.857955	136	182	4	46	46	1.0000000
NODE_217885_length_275_cov_1.755682	21	76	0	55	55	1.0000000
NODE_217912_length_275_cov_1.738636	225	256	0	31	31	1.0000000
NODE_217967_length_275_cov_1.738636	161	241	0	80	80	1.0000000
NODE_218257_length_275_cov_1.448864	123	155	38	9	32	0.2812500
NODE_218257_length_275_cov_1.448864	123	155	40	6	32	0.1875000
NODE_218257_length_275_cov_1.448864	123	155	42	1	32	0.0312500
NODE_218257_length_275_cov_1.448864	123	155	44	6	32	0.1875000
NODE_218257_length_275_cov_1.448864	123	155	46	10	32	0.3125000
NODE_218402_length_275_cov_1.301136	132	196	2	64	64	1.0000000
NODE_218706_length_275_cov_1.159091	13	93	0	19	80	0.2375000
NODE_218706_length_275_cov_1.159091	13	93	2	61	80	0.7625000
NODE_218734_length_275_cov_1.153409	11	91	2	80	80	1.0000000
NODE_219031_length_275_cov_0.937500	13	49	27	2	36	0.0555556
NODE_219031_length_275_cov_0.937500	13	49	30	1	36	0.0277778
NODE_219031_length_275_cov_0.937500	13	49	34	1	36	0.0277778
NODE_219031_length_275_cov_0.937500	13	49	38	4	36	0.1111111
NODE_219031_length_275_cov_0.937500	13	49	45	5	36	0.1388889
NODE_219031_length_275_cov_0.937500	13	49	47	1	36	0.0277778
NODE_219031_length_275_cov_0.937500	13	49	49	1	36	0.0277778
NODE_219031_length_275_cov_0.937500	13	49	51	2	36	0.0555556
NODE_219031_length_275_cov_0.937500	13	49	54	3	36	0.0833333
NODE_219031_length_275_cov_0.937500	13	49	61	1	36	0.0277778
NODE_219031_length_275_cov_0.937500	13	49	63	5	36	0.1388889
NODE_219031_length_275_cov_0.937500	13	49	67	1	36	0.0277778
NODE_219031_length_275_cov_0.937500	13	49	68	2	36	0.0555556
NODE_219031_length_275_cov_0.937500	13	49	70	1	36	0.0277778
NODE_219031_length_275_cov_0.937500	13	49	73	2	36	0.0555556
NODE_219031_length_275_cov_0.937500	13	49	74	1	36	0.0277778
NODE_219031_length_275_cov_0.937500	13	49	76	1	36	0.0277778
NODE_219031_length_275_cov_0.937500	13	49	77	1	36	0.0277778
NODE_219031_length_275_cov_0.937500	13	49	79	1	36	0.0277778
NODE_219031_length_275_cov_0.937500	22	86	45	4	64	0.0625000
NODE_219031_length_275_cov_0.937500	22	86	47	1	64	0.0156250
NODE_219031_length_275_cov_0.937500	22	86	49	1	64	0.0156250
NODE_219031_length_275_cov_0.937500	22	86	51	2	64	0.0312500
NODE_219031_length_275_cov_0.937500	22	86	54	3	64	0.0468750
NODE_219031_length_275_cov_0.937500	22	86	61	1	64	0.0156250
NODE_219031_length_275_cov_0.937500	22	86	63	5	64	0.0781250
NODE_219031_length_275_cov_0.937500	22	86	67	1	64	0.0156250
NODE_219031_length_275_cov_0.937500	22	86	68	2	64	0.0312500
NODE_219031_length_275_cov_0.937500	22	86	70	1	64	0.0156250
NODE_219031_length_275_cov_0.937500	22	86	73	2	64	0.0312500
NODE_219031_length_275_cov_0.937500	22	86	74	1	64	0.0156250
NODE_219031_length_275_cov_0.937500	22	86	76	1	64	0.0156250
NODE_219031_length_275_cov_0.937500	22	86	77	1	64	0.0156250
NODE_219031_length_275_cov_0.937500	22	86	79	3	64	0.0468750
NODE_219031_length_275_cov_0.937500	22	86	83	1	64	0.0156250
NODE_219031_length_275_cov_0.937500	22	86	84	5	64	0.0781250
NODE_219031_length_275_cov_0.937500	22	86	88	8	64	0.1250000
NODE_219031_length_275_cov_0.937500	22	86	89	3	64	0.0468750
NODE_219031_length_275_cov_0.937500	22	86	92	2	64	0.0312500
NODE_219031_length_275_cov_0.937500	22	86	94	2	64	0.0312500
NODE_219031_length_275_cov_0.937500	22	86	96	1	64	0.0156250
NODE_219031_length_275_cov_0.937500	22	86	97	3	64	0.0468750
NODE_219031_length_275_cov_0.937500	22	86	103	2	64	0.0312500
NODE_219031_length_275_cov_0.937500	22	86	109	1	64	0.0156250
NODE_219031_length_275_cov_0.937500	22	86	111	1	64	0.0156250
NODE_219031_length_275_cov_0.937500	22	86	118	1	64	0.0156250
NODE_219031_length_275_cov_0.937500	22	86	120	1	64	0.0156250
NODE_219031_length_275_cov_0.937500	22	86	122	1	64	0.0156250
NODE_219031_length_275_cov_0.937500	22	86	126	1	64	0.0156250
NODE_219031_length_275_cov_0.937500	22	86	133	1	64	0.0156250
NODE_219031_length_275_cov_0.937500	22	86	136	1	64	0.0156250
NODE_219220_length_275_cov_0.869318	67	126	0	59	59	1.0000000
NODE_219655_length_275_cov_0.579545	40	70	0	30	30	1.0000000
NODE_220021_length_274_cov_6.074286	141	175	0	31	34	0.9117647
NODE_220021_length_274_cov_6.074286	141	175	4	3	34	0.0882353
NODE_220047_length_274_cov_4.845714	48	105	0	57	57	1.0000000
NODE_220047_length_274_cov_4.845714	113	175	0	32	62	0.5161290
NODE_220047_length_274_cov_4.845714	113	175	5	17	62	0.2741936
NODE_220047_length_274_cov_4.845714	113	175	6	13	62	0.2096774
NODE_220078_length_274_cov_4.080000	210	274	0	64	64	1.0000000
NODE_220215_length_274_cov_2.988571	104	161	0	57	57	1.0000000
NODE_220221_length_274_cov_2.937143	199	234	0	35	35	1.0000000
NODE_220293_length_274_cov_2.622857	29	76	4	6	47	0.1276596
NODE_220293_length_274_cov_2.622857	29	76	6	4	47	0.0851064
NODE_220293_length_274_cov_2.622857	29	76	10	6	47	0.1276596
NODE_220293_length_274_cov_2.622857	29	76	12	31	47	0.6595744
NODE_220293_length_274_cov_2.622857	82	157	4	27	75	0.3600000
NODE_220293_length_274_cov_2.622857	82	157	6	12	75	0.1600000
NODE_220293_length_274_cov_2.622857	82	157	8	3	75	0.0400000
NODE_220293_length_274_cov_2.622857	82	157	10	3	75	0.0400000
NODE_220293_length_274_cov_2.622857	82	157	12	30	75	0.4000000
NODE_220413_length_274_cov_2.308571	51	130	4	1	79	0.0126582
NODE_220413_length_274_cov_2.308571	51	130	5	4	79	0.0506329
NODE_220413_length_274_cov_2.308571	51	130	7	3	79	0.0379747
NODE_220413_length_274_cov_2.308571	51	130	9	5	79	0.0632911
NODE_220413_length_274_cov_2.308571	51	130	13	1	79	0.0126582
NODE_220413_length_274_cov_2.308571	51	130	17	1	79	0.0126582
NODE_220413_length_274_cov_2.308571	51	130	19	1	79	0.0126582
NODE_220413_length_274_cov_2.308571	51	130	25	1	79	0.0126582
NODE_220413_length_274_cov_2.308571	51	130	27	1	79	0.0126582
NODE_220413_length_274_cov_2.308571	51	130	28	1	79	0.0126582
NODE_220413_length_274_cov_2.308571	51	130	30	1	79	0.0126582
NODE_220413_length_274_cov_2.308571	51	130	32	2	79	0.0253165
NODE_220413_length_274_cov_2.308571	51	130	33	1	79	0.0126582
NODE_220413_length_274_cov_2.308571	51	130	36	1	79	0.0126582
NODE_220413_length_274_cov_2.308571	51	130	38	2	79	0.0253165
NODE_220413_length_274_cov_2.308571	51	130	42	1	79	0.0126582
NODE_220413_length_274_cov_2.308571	51	130	44	2	79	0.0253165
NODE_220413_length_274_cov_2.308571	51	130	46	2	79	0.0253165
NODE_220413_length_274_cov_2.308571	51	130	48	1	79	0.0126582
NODE_220413_length_274_cov_2.308571	51	130	50	3	79	0.0379747
NODE_220413_length_274_cov_2.308571	51	130	54	2	79	0.0253165
NODE_220413_length_274_cov_2.308571	51	130	55	1	79	0.0126582
NODE_220413_length_274_cov_2.308571	51	130	62	1	79	0.0126582
NODE_220413_length_274_cov_2.308571	51	130	63	5	79	0.0632911
NODE_220413_length_274_cov_2.308571	51	130	64	4	79	0.0506329
NODE_220413_length_274_cov_2.308571	51	130	65	2	79	0.0253165
NODE_220413_length_274_cov_2.308571	51	130	69	1	79	0.0126582
NODE_220413_length_274_cov_2.308571	51	130	71	2	79	0.0253165
NODE_220413_length_274_cov_2.308571	51	130	73	3	79	0.0379747
NODE_220413_length_274_cov_2.308571	51	130	75	2	79	0.0253165
NODE_220413_length_274_cov_2.308571	51	130	79	1	79	0.0126582
NODE_220413_length_274_cov_2.308571	51	130	83	1	79	0.0126582
NODE_220413_length_274_cov_2.308571	51	130	86	1	79	0.0126582
NODE_220413_length_274_cov_2.308571	51	130	88	1	79	0.0126582
NODE_220413_length_274_cov_2.308571	51	130	90	3	79	0.0379747
NODE_220413_length_274_cov_2.308571	51	130	91	1	79	0.0126582
NODE_220413_length_274_cov_2.308571	51	130	93	3	79	0.0379747
NODE_220413_length_274_cov_2.308571	51	130	94	3	79	0.0379747
NODE_220413_length_274_cov_2.308571	51	130	95	7	79	0.0886076
NODE_220504_length_274_cov_2.062857	172	242	0	70	70	1.0000000
NODE_220504_length_274_cov_2.062857	215	256	0	41	41	1.0000000
NODE_220662_length_274_cov_1.754286	219	259	0	39	40	0.9750000
NODE_220662_length_274_cov_1.754286	219	259	1	1	40	0.0250000
NODE_220681_length_274_cov_1.748571	168	231	0	3	63	0.0476190
NODE_220681_length_274_cov_1.748571	168	231	4	26	63	0.4126984
NODE_220681_length_274_cov_1.748571	168	231	6	34	63	0.5396826
NODE_220806_length_274_cov_1.737143	134	172	0	38	38	1.0000000
NODE_220847_length_274_cov_1.685714	132	189	6	2	57	0.0350877
NODE_220847_length_274_cov_1.685714	132	189	8	55	57	0.9649123
NODE_220847_length_274_cov_1.685714	141	199	6	12	58	0.2068966
NODE_220847_length_274_cov_1.685714	141	199	8	46	58	0.7931035
NODE_220966_length_274_cov_1.502857	170	232	0	62	62	1.0000000
NODE_220966_length_274_cov_1.502857	223	274	0	51	51	1.0000000
NODE_221005_length_274_cov_1.457143	118	147	0	29	29	1.0000000
NODE_221101_length_274_cov_1.434286	25	69	0	32	44	0.7272727
NODE_221101_length_274_cov_1.434286	25	69	2	12	44	0.2727273
NODE_221211_length_274_cov_1.285714	84	156	0	72	72	1.0000000
NODE_221612_length_274_cov_1.131429	205	251	4	44	46	0.9565217
NODE_221612_length_274_cov_1.131429	205	251	6	2	46	0.0434783
NODE_221764_length_274_cov_0.994286	219	260	0	41	41	1.0000000
NODE_222849_length_273_cov_4.948276	204	262	0	25	58	0.4310345
NODE_222849_length_273_cov_4.948276	204	262	2	33	58	0.5689655
NODE_222849_length_273_cov_4.948276	204	258	0	21	54	0.3888889
NODE_222849_length_273_cov_4.948276	204	258	2	33	54	0.6111111
NODE_222914_length_273_cov_3.712644	103	183	4	2	80	0.0250000
NODE_222914_length_273_cov_3.712644	103	183	6	1	80	0.0125000
NODE_222914_length_273_cov_3.712644	103	183	8	4	80	0.0500000
NODE_222914_length_273_cov_3.712644	103	183	11	3	80	0.0375000
NODE_222914_length_273_cov_3.712644	103	183	13	9	80	0.1125000
NODE_222914_length_273_cov_3.712644	103	183	17	1	80	0.0125000
NODE_222914_length_273_cov_3.712644	103	183	19	2	80	0.0250000
NODE_222914_length_273_cov_3.712644	103	183	21	20	80	0.2500000
NODE_222914_length_273_cov_3.712644	103	183	23	8	80	0.1000000
NODE_222914_length_273_cov_3.712644	103	183	25	30	80	0.3750000
NODE_222955_length_273_cov_3.298851	69	100	0	31	31	1.0000000
NODE_222955_length_273_cov_3.298851	73	153	0	80	80	1.0000000
NODE_222974_length_273_cov_3.195402	122	189	0	67	67	1.0000000
NODE_222991_length_273_cov_3.063218	76	151	36	5	75	0.0666667
NODE_222991_length_273_cov_3.063218	76	151	38	5	75	0.0666667
NODE_222991_length_273_cov_3.063218	76	151	40	2	75	0.0266667
NODE_222991_length_273_cov_3.063218	76	151	44	4	75	0.0533333
NODE_222991_length_273_cov_3.063218	76	151	46	1	75	0.0133333
NODE_222991_length_273_cov_3.063218	76	151	48	5	75	0.0666667
NODE_222991_length_273_cov_3.063218	76	151	50	6	75	0.0800000
NODE_222991_length_273_cov_3.063218	76	151	51	2	75	0.0266667
NODE_222991_length_273_cov_3.063218	76	151	52	9	75	0.1200000
NODE_222991_length_273_cov_3.063218	76	151	53	1	75	0.0133333
NODE_222991_length_273_cov_3.063218	76	151	58	8	75	0.1066667
NODE_222991_length_273_cov_3.063218	76	151	60	15	75	0.2000000
NODE_222991_length_273_cov_3.063218	76	151	62	7	75	0.0933333
NODE_222991_length_273_cov_3.063218	76	151	66	5	75	0.0666667
NODE_222991_length_273_cov_3.063218	135	191	14	3	56	0.0535714
NODE_222991_length_273_cov_3.063218	135	191	16	7	56	0.1250000
NODE_222991_length_273_cov_3.063218	135	191	20	10	56	0.1785714
NODE_222991_length_273_cov_3.063218	135	191	21	1	56	0.0178571
NODE_222991_length_273_cov_3.063218	135	191	25	3	56	0.0535714
NODE_222991_length_273_cov_3.063218	135	191	27	1	56	0.0178571
NODE_222991_length_273_cov_3.063218	135	191	31	4	56	0.0714286
NODE_222991_length_273_cov_3.063218	135	191	33	7	56	0.1250000
NODE_222991_length_273_cov_3.063218	135	191	35	2	56	0.0357143
NODE_222991_length_273_cov_3.063218	135	191	36	5	56	0.0892857
NODE_222991_length_273_cov_3.063218	135	191	38	6	56	0.1071429
NODE_222991_length_273_cov_3.063218	135	191	39	1	56	0.0178571
NODE_222991_length_273_cov_3.063218	135	191	40	2	56	0.0357143
NODE_222991_length_273_cov_3.063218	135	191	44	4	56	0.0714286
NODE_223066_length_273_cov_2.706897	11	45	2	33	34	0.9705882
NODE_223066_length_273_cov_2.706897	11	45	4	1	34	0.0294118
NODE_223203_length_273_cov_2.339080	69	145	13	11	76	0.1447368
NODE_223203_length_273_cov_2.339080	69	145	14	1	76	0.0131579
NODE_223203_length_273_cov_2.339080	69	145	15	1	76	0.0131579
NODE_223203_length_273_cov_2.339080	69	145	19	12	76	0.1578947
NODE_223203_length_273_cov_2.339080	69	145	21	5	76	0.0657895
NODE_223203_length_273_cov_2.339080	69	145	23	1	76	0.0131579
NODE_223203_length_273_cov_2.339080	69	145	27	5	76	0.0657895
NODE_223203_length_273_cov_2.339080	69	145	29	2	76	0.0263158
NODE_223203_length_273_cov_2.339080	69	145	33	6	76	0.0789474
NODE_223203_length_273_cov_2.339080	69	145	35	10	76	0.1315790
NODE_223203_length_273_cov_2.339080	69	145	37	22	76	0.2894737
NODE_223353_length_273_cov_2.051724	31	74	0	43	43	1.0000000
NODE_223377_length_273_cov_2.034483	81	161	6	16	80	0.2000000
NODE_223377_length_273_cov_2.034483	81	161	8	64	80	0.8000000
NODE_223377_length_273_cov_2.034483	213	263	0	25	50	0.5000000
NODE_223377_length_273_cov_2.034483	213	263	2	1	50	0.0200000
NODE_223377_length_273_cov_2.034483	213	263	4	8	50	0.1600000
NODE_223377_length_273_cov_2.034483	213	263	6	16	50	0.3200000
NODE_223680_length_273_cov_1.706897	181	238	0	57	57	1.0000000
NODE_223913_length_273_cov_1.442529	5	47	0	42	42	1.0000000
NODE_224023_length_273_cov_1.281609	167	247	0	80	80	1.0000000
NODE_224082_length_273_cov_1.189655	120	156	0	36	36	1.0000000
NODE_224082_length_273_cov_1.189655	129	160	0	31	31	1.0000000
NODE_224165_length_273_cov_1.172414	94	130	0	11	36	0.3055556
NODE_224165_length_273_cov_1.172414	94	130	2	25	36	0.6944444
NODE_224254_length_273_cov_1.172414	8	58	4	2	50	0.0400000
NODE_224254_length_273_cov_1.172414	8	58	6	7	50	0.1400000
NODE_224254_length_273_cov_1.172414	8	58	8	41	50	0.8200000
NODE_224367_length_273_cov_1.166667	74	93	0	19	19	1.0000000
NODE_224441_length_273_cov_1.091954	6	42	2	4	36	0.1111111
NODE_224441_length_273_cov_1.091954	6	42	4	32	36	0.8888889
NODE_224441_length_273_cov_1.091954	43	95	2	40	52	0.7692308
NODE_224441_length_273_cov_1.091954	43	95	4	12	52	0.2307692
NODE_224587_length_273_cov_0.971264	188	235	0	47	47	1.0000000
NODE_225303_length_273_cov_0.586207	27	88	0	61	61	1.0000000
NODE_225344_length_273_cov_0.586207	24	79	0	55	55	1.0000000
NODE_225344_length_273_cov_0.586207	81	113	0	32	32	1.0000000
NODE_225592_length_272_cov_6.190751	172	236	2	3	64	0.0468750
NODE_225592_length_272_cov_6.190751	172	236	4	11	64	0.1718750
NODE_225592_length_272_cov_6.190751	172	236	6	50	64	0.7812500
NODE_225607_length_272_cov_5.335260	193	272	0	79	79	1.0000000
NODE_225633_length_272_cov_4.716763	228	257	0	29	29	1.0000000
NODE_225656_length_272_cov_4.219653	93	166	0	17	73	0.2328767
NODE_225656_length_272_cov_4.219653	93	166	2	47	73	0.6438356
NODE_225656_length_272_cov_4.219653	93	166	4	9	73	0.1232877
NODE_225656_length_272_cov_4.219653	146	219	2	49	73	0.6712329
NODE_225656_length_272_cov_4.219653	146	219	4	24	73	0.3287671
NODE_225658_length_272_cov_4.184971	75	128	0	53	53	1.0000000
NODE_225739_length_272_cov_3.352601	154	199	0	45	45	1.0000000
NODE_225872_length_272_cov_2.664740	106	186	2	80	80	1.0000000
NODE_226010_length_272_cov_2.335260	33	103	0	70	70	1.0000000
NODE_226029_length_272_cov_2.277457	219	256	0	37	37	1.0000000
NODE_226045_length_272_cov_2.236994	104	184	11	1	80	0.0125000
NODE_226045_length_272_cov_2.236994	104	184	13	5	80	0.0625000
NODE_226045_length_272_cov_2.236994	104	184	17	15	80	0.1875000
NODE_226045_length_272_cov_2.236994	104	184	19	4	80	0.0500000
NODE_226045_length_272_cov_2.236994	104	184	21	9	80	0.1125000
NODE_226045_length_272_cov_2.236994	104	184	25	2	80	0.0250000
NODE_226045_length_272_cov_2.236994	104	184	27	2	80	0.0250000
NODE_226045_length_272_cov_2.236994	104	184	29	9	80	0.1125000
NODE_226045_length_272_cov_2.236994	104	184	31	2	80	0.0250000
NODE_226045_length_272_cov_2.236994	104	184	33	31	80	0.3875000
NODE_226169_length_272_cov_1.982659	172	252	0	80	80	1.0000000
NODE_226245_length_272_cov_1.780347	37	99	2	26	62	0.4193548
NODE_226245_length_272_cov_1.780347	37	99	6	36	62	0.5806451
NODE_226245_length_272_cov_1.780347	90	152	4	6	62	0.0967742
NODE_226245_length_272_cov_1.780347	90	152	6	56	62	0.9032258
NODE_226248_length_272_cov_1.768786	12	45	0	33	33	1.0000000
NODE_226461_length_272_cov_1.618497	97	160	10	1	63	0.0158730
NODE_226461_length_272_cov_1.618497	97	160	12	1	63	0.0158730
NODE_226461_length_272_cov_1.618497	97	160	14	1	63	0.0158730
NODE_226461_length_272_cov_1.618497	97	160	16	3	63	0.0476190
NODE_226461_length_272_cov_1.618497	97	160	22	4	63	0.0634921
NODE_226461_length_272_cov_1.618497	97	160	23	1	63	0.0158730
NODE_226461_length_272_cov_1.618497	97	160	24	1	63	0.0158730
NODE_226461_length_272_cov_1.618497	97	160	26	2	63	0.0317460
NODE_226461_length_272_cov_1.618497	97	160	28	2	63	0.0317460
NODE_226461_length_272_cov_1.618497	97	160	31	1	63	0.0158730
NODE_226461_length_272_cov_1.618497	97	160	36	2	63	0.0317460
NODE_226461_length_272_cov_1.618497	97	160	38	2	63	0.0317460
NODE_226461_length_272_cov_1.618497	97	160	42	1	63	0.0158730
NODE_226461_length_272_cov_1.618497	97	160	44	1	63	0.0158730
NODE_226461_length_272_cov_1.618497	97	160	46	5	63	0.0793651
NODE_226461_length_272_cov_1.618497	97	160	48	1	63	0.0158730
NODE_226461_length_272_cov_1.618497	97	160	50	1	63	0.0158730
NODE_226461_length_272_cov_1.618497	97	160	52	25	63	0.3968254
NODE_226461_length_272_cov_1.618497	97	160	54	8	63	0.1269841
NODE_226508_length_272_cov_1.543353	69	137	2	3	68	0.0441176
NODE_226508_length_272_cov_1.543353	69	137	4	11	68	0.1617647
NODE_226508_length_272_cov_1.543353	69	137	6	54	68	0.7941176
NODE_227037_length_272_cov_1.173410	147	203	4	36	56	0.6428571
NODE_227037_length_272_cov_1.173410	147	203	6	20	56	0.3571429
NODE_227265_length_272_cov_0.988439	169	215	0	46	46	1.0000000
NODE_227444_length_272_cov_0.884393	126	163	0	31	37	0.8378378
NODE_227444_length_272_cov_0.884393	126	163	2	6	37	0.1621622
NODE_228332_length_271_cov_5.238372	103	183	0	80	80	1.0000000
NODE_228423_length_271_cov_3.546512	102	165	0	63	63	1.0000000
NODE_228429_length_271_cov_3.476744	62	93	3	31	31	1.0000000
NODE_228494_length_271_cov_2.959302	96	176	0	80	80	1.0000000
NODE_228494_length_271_cov_2.959302	149	229	0	80	80	1.0000000
NODE_228554_length_271_cov_2.715116	160	241	0	81	81	1.0000000
NODE_228593_length_271_cov_2.622093	180	253	0	73	73	1.0000000
NODE_228623_length_271_cov_2.465116	45	75	0	30	30	1.0000000
NODE_228731_length_271_cov_2.284884	95	158	6	3	63	0.0476190
NODE_228731_length_271_cov_2.284884	95	158	8	60	63	0.9523810
NODE_228731_length_271_cov_2.284884	131	211	1	38	80	0.4750000
NODE_228731_length_271_cov_2.284884	131	211	2	8	80	0.1000000
NODE_228731_length_271_cov_2.284884	131	211	4	6	80	0.0750000
NODE_228731_length_271_cov_2.284884	131	211	6	4	80	0.0500000
NODE_228731_length_271_cov_2.284884	131	211	8	24	80	0.3000000
NODE_228737_length_271_cov_2.273256	163	219	0	56	56	1.0000000
NODE_228830_length_271_cov_2.069767	130	212	2	82	82	1.0000000
NODE_228932_length_271_cov_1.784884	135	183	0	17	48	0.3541667
NODE_228932_length_271_cov_1.784884	135	183	2	31	48	0.6458333
NODE_228937_length_271_cov_1.779070	204	268	0	1	64	0.0156250
NODE_228937_length_271_cov_1.779070	204	268	2	63	64	0.9843750
NODE_229085_length_271_cov_1.755814	119	199	0	2	80	0.0250000
NODE_229085_length_271_cov_1.755814	119	199	4	78	80	0.9750000
NODE_229242_length_271_cov_1.523256	122	183	2	61	61	1.0000000
NODE_229254_length_271_cov_1.511628	106	186	35	2	80	0.0250000
NODE_229254_length_271_cov_1.511628	106	186	37	1	80	0.0125000
NODE_229254_length_271_cov_1.511628	106	186	39	1	80	0.0125000
NODE_229254_length_271_cov_1.511628	106	186	41	1	80	0.0125000
NODE_229254_length_271_cov_1.511628	106	186	43	16	80	0.2000000
NODE_229254_length_271_cov_1.511628	106	186	45	4	80	0.0500000
NODE_229254_length_271_cov_1.511628	106	186	47	9	80	0.1125000
NODE_229254_length_271_cov_1.511628	106	186	53	10	80	0.1250000
NODE_229254_length_271_cov_1.511628	106	186	57	6	80	0.0750000
NODE_229254_length_271_cov_1.511628	106	186	58	1	80	0.0125000
NODE_229254_length_271_cov_1.511628	106	186	61	9	80	0.1125000
NODE_229254_length_271_cov_1.511628	106	186	63	14	80	0.1750000
NODE_229254_length_271_cov_1.511628	106	186	65	4	80	0.0500000
NODE_229254_length_271_cov_1.511628	106	186	67	2	80	0.0250000
NODE_229525_length_271_cov_1.226744	119	184	0	38	65	0.5846154
NODE_229525_length_271_cov_1.226744	119	184	2	27	65	0.4153846
NODE_229541_length_271_cov_1.197674	88	145	6	57	57	1.0000000
NODE_229541_length_271_cov_1.197674	118	192	0	17	74	0.2297297
NODE_229541_length_271_cov_1.197674	118	192	1	6	74	0.0810811
NODE_229541_length_271_cov_1.197674	118	192	3	7	74	0.0945946
NODE_229541_length_271_cov_1.197674	118	192	5	17	74	0.2297297
NODE_229541_length_271_cov_1.197674	118	192	6	27	74	0.3648649
NODE_230154_length_271_cov_0.918605	155	227	0	72	72	1.0000000
NODE_230255_length_271_cov_0.889535	101	148	0	47	47	1.0000000
NODE_230318_length_271_cov_0.889535	127	188	0	1	61	0.0163934
NODE_230318_length_271_cov_0.889535	127	188	1	60	61	0.9836066
NODE_231165_length_270_cov_4.818713	72	118	2	46	46	1.0000000
NODE_231187_length_270_cov_4.327485	5	82	0	57	77	0.7402598
NODE_231187_length_270_cov_4.327485	5	82	2	20	77	0.2597403
NODE_231240_length_270_cov_3.666667	87	154	0	15	67	0.2238806
NODE_231240_length_270_cov_3.666667	87	154	2	52	67	0.7761194
NODE_231240_length_270_cov_3.666667	140	207	2	67	67	1.0000000
NODE_231263_length_270_cov_3.491228	186	270	0	84	84	1.0000000
NODE_231310_length_270_cov_3.105263	43	90	0	47	47	1.0000000
NODE_231316_length_270_cov_3.046784	64	135	0	71	71	1.0000000
NODE_231439_length_270_cov_2.649123	210	270	0	7	60	0.1166667
NODE_231439_length_270_cov_2.649123	210	270	2	53	60	0.8833333
NODE_231655_length_270_cov_2.087719	16	55	0	39	39	1.0000000
NODE_231655_length_270_cov_2.087719	78	108	0	30	30	1.0000000
NODE_231714_length_270_cov_2.040936	103	159	2	1	56	0.0178571
NODE_231714_length_270_cov_2.040936	103	159	14	3	56	0.0535714
NODE_231714_length_270_cov_2.040936	103	159	16	1	56	0.0178571
NODE_231714_length_270_cov_2.040936	103	159	20	1	56	0.0178571
NODE_231714_length_270_cov_2.040936	103	159	22	2	56	0.0357143
NODE_231714_length_270_cov_2.040936	103	159	28	5	56	0.0892857
NODE_231714_length_270_cov_2.040936	103	159	32	4	56	0.0714286
NODE_231714_length_270_cov_2.040936	103	159	38	1	56	0.0178571
NODE_231714_length_270_cov_2.040936	103	159	40	1	56	0.0178571
NODE_231714_length_270_cov_2.040936	103	159	44	2	56	0.0357143
NODE_231714_length_270_cov_2.040936	103	159	46	3	56	0.0535714
NODE_231714_length_270_cov_2.040936	103	159	48	2	56	0.0357143
NODE_231714_length_270_cov_2.040936	103	159	49	5	56	0.0892857
NODE_231714_length_270_cov_2.040936	103	159	50	1	56	0.0178571
NODE_231714_length_270_cov_2.040936	103	159	52	24	56	0.4285714
NODE_231726_length_270_cov_2.017544	1	48	0	47	47	1.0000000
NODE_231820_length_270_cov_1.789474	146	228	4	82	82	1.0000000
NODE_232008_length_270_cov_1.678363	178	246	0	68	68	1.0000000
NODE_232021_length_270_cov_1.666667	127	191	33	1	64	0.0156250
NODE_232021_length_270_cov_1.666667	127	191	35	13	64	0.2031250
NODE_232021_length_270_cov_1.666667	127	191	37	2	64	0.0312500
NODE_232021_length_270_cov_1.666667	127	191	38	4	64	0.0625000
NODE_232021_length_270_cov_1.666667	127	191	40	1	64	0.0156250
NODE_232021_length_270_cov_1.666667	127	191	44	3	64	0.0468750
NODE_232021_length_270_cov_1.666667	127	191	46	7	64	0.1093750
NODE_232021_length_270_cov_1.666667	127	191	48	5	64	0.0781250
NODE_232021_length_270_cov_1.666667	127	191	54	11	64	0.1718750
NODE_232021_length_270_cov_1.666667	127	191	56	5	64	0.0781250
NODE_232021_length_270_cov_1.666667	127	191	60	3	64	0.0468750
NODE_232021_length_270_cov_1.666667	127	191	62	1	64	0.0156250
NODE_232021_length_270_cov_1.666667	127	191	64	2	64	0.0312500
NODE_232021_length_270_cov_1.666667	127	191	66	6	64	0.0937500
NODE_232021_length_270_cov_1.666667	180	227	13	4	47	0.0851064
NODE_232021_length_270_cov_1.666667	180	227	15	4	47	0.0851064
NODE_232021_length_270_cov_1.666667	180	227	17	3	47	0.0638298
NODE_232021_length_270_cov_1.666667	180	227	21	2	47	0.0425532
NODE_232021_length_270_cov_1.666667	180	227	25	1	47	0.0212766
NODE_232021_length_270_cov_1.666667	180	227	27	13	47	0.2765957
NODE_232021_length_270_cov_1.666667	180	227	31	8	47	0.1702128
NODE_232021_length_270_cov_1.666667	180	227	33	2	47	0.0425532
NODE_232021_length_270_cov_1.666667	180	227	35	10	47	0.2127660
NODE_232087_length_270_cov_1.555556	138	218	2	37	80	0.4625000
NODE_232087_length_270_cov_1.555556	138	218	4	14	80	0.1750000
NODE_232087_length_270_cov_1.555556	138	218	8	29	80	0.3625000
NODE_232331_length_270_cov_1.280702	4	75	0	26	71	0.3661972
NODE_232331_length_270_cov_1.280702	4	75	2	45	71	0.6338028
NODE_232331_length_270_cov_1.280702	57	137	2	80	80	1.0000000
NODE_232331_length_270_cov_1.280702	65	120	2	55	55	1.0000000
NODE_232331_length_270_cov_1.280702	125	198	0	50	73	0.6849315
NODE_232331_length_270_cov_1.280702	125	198	2	23	73	0.3150685
NODE_232440_length_270_cov_1.192982	146	194	0	48	48	1.0000000
NODE_232583_length_270_cov_1.192982	61	141	0	80	80	1.0000000
NODE_233290_length_270_cov_0.847953	53	128	2	2	75	0.0266667
NODE_233290_length_270_cov_0.847953	53	128	10	5	75	0.0666667
NODE_233290_length_270_cov_0.847953	53	128	12	51	75	0.6800000
NODE_233290_length_270_cov_0.847953	53	128	14	17	75	0.2266667
NODE_234072_length_269_cov_3.894118	30	110	0	13	80	0.1625000
NODE_234072_length_269_cov_3.894118	30	110	2	46	80	0.5750000
NODE_234072_length_269_cov_3.894118	30	110	4	21	80	0.2625000
NODE_234072_length_269_cov_3.894118	83	163	0	66	80	0.8250000
NODE_234072_length_269_cov_3.894118	83	163	2	14	80	0.1750000
NODE_234100_length_269_cov_3.605882	175	205	2	30	30	1.0000000
NODE_234116_length_269_cov_3.523529	192	233	2	21	41	0.5121951
NODE_234116_length_269_cov_3.523529	192	233	3	20	41	0.4878049
NODE_234116_length_269_cov_3.523529	206	268	0	11	62	0.1774193
NODE_234116_length_269_cov_3.523529	206	268	2	45	62	0.7258065
NODE_234116_length_269_cov_3.523529	206	268	3	6	62	0.0967742
NODE_234118_length_269_cov_3.505882	13	93	0	80	80	1.0000000
NODE_234118_length_269_cov_3.505882	66	145	0	79	79	1.0000000
NODE_234162_length_269_cov_3.147059	134	174	4	40	40	1.0000000
NODE_234167_length_269_cov_3.111765	39	119	0	68	80	0.8500000
NODE_234167_length_269_cov_3.111765	39	119	2	12	80	0.1500000
NODE_234167_length_269_cov_3.111765	92	169	0	15	77	0.1948052
NODE_234167_length_269_cov_3.111765	92	169	2	62	77	0.8051948
NODE_234178_length_269_cov_3.000000	166	233	0	16	67	0.2388060
NODE_234178_length_269_cov_3.000000	166	233	2	51	67	0.7611941
NODE_234205_length_269_cov_2.947059	55	123	0	68	68	1.0000000
NODE_234224_length_269_cov_2.858824	9	89	0	78	80	0.9750000
NODE_234224_length_269_cov_2.858824	9	89	2	2	80	0.0250000
NODE_234224_length_269_cov_2.858824	62	91	0	25	29	0.8620690
NODE_234224_length_269_cov_2.858824	62	91	2	4	29	0.1379310
NODE_234228_length_269_cov_2.823529	0	73	3	2	73	0.0273973
NODE_234228_length_269_cov_2.823529	0	73	4	1	73	0.0136986
NODE_234228_length_269_cov_2.823529	0	73	6	2	73	0.0273973
NODE_234228_length_269_cov_2.823529	0	73	9	1	73	0.0136986
NODE_234228_length_269_cov_2.823529	0	73	10	1	73	0.0136986
NODE_234228_length_269_cov_2.823529	0	73	12	4	73	0.0547945
NODE_234228_length_269_cov_2.823529	0	73	14	1	73	0.0136986
NODE_234228_length_269_cov_2.823529	0	73	16	8	73	0.1095890
NODE_234228_length_269_cov_2.823529	0	73	20	4	73	0.0547945
NODE_234228_length_269_cov_2.823529	0	73	22	5	73	0.0684932
NODE_234228_length_269_cov_2.823529	0	73	24	5	73	0.0684932
NODE_234228_length_269_cov_2.823529	0	73	26	12	73	0.1643836
NODE_234228_length_269_cov_2.823529	0	73	28	10	73	0.1369863
NODE_234228_length_269_cov_2.823529	0	73	30	6	73	0.0821918
NODE_234228_length_269_cov_2.823529	0	73	32	11	73	0.1506849
NODE_234228_length_269_cov_2.823529	46	77	28	10	31	0.3225806
NODE_234228_length_269_cov_2.823529	46	77	30	6	31	0.1935484
NODE_234228_length_269_cov_2.823529	46	77	32	15	31	0.4838710
NODE_234431_length_269_cov_2.311765	111	157	0	46	46	1.0000000
NODE_234431_length_269_cov_2.311765	130	209	0	79	79	1.0000000
NODE_234606_length_269_cov_1.958824	176	248	0	72	72	1.0000000
NODE_234647_length_269_cov_1.847059	72	99	0	27	27	1.0000000
NODE_234657_length_269_cov_1.823529	30	81	2	16	51	0.3137255
NODE_234657_length_269_cov_1.823529	30	81	4	23	51	0.4509804
NODE_234657_length_269_cov_1.823529	30	81	6	1	51	0.0196078
NODE_234657_length_269_cov_1.823529	30	81	8	2	51	0.0392157
NODE_234657_length_269_cov_1.823529	30	81	12	9	51	0.1764706
NODE_234758_length_269_cov_1.800000	0	42	0	42	42	1.0000000
NODE_234978_length_269_cov_1.552941	90	170	0	80	80	1.0000000
NODE_235157_length_269_cov_1.400000	139	219	10	7	80	0.0875000
NODE_235157_length_269_cov_1.400000	139	219	12	2	80	0.0250000
NODE_235157_length_269_cov_1.400000	139	219	14	4	80	0.0500000
NODE_235157_length_269_cov_1.400000	139	219	16	11	80	0.1375000
NODE_235157_length_269_cov_1.400000	139	219	18	19	80	0.2375000
NODE_235157_length_269_cov_1.400000	139	219	20	37	80	0.4625000
NODE_235168_length_269_cov_1.388235	185	252	0	22	67	0.3283582
NODE_235168_length_269_cov_1.388235	185	252	2	45	67	0.6716418
NODE_235239_length_269_cov_1.288235	150	179	2	10	29	0.3448276
NODE_235239_length_269_cov_1.288235	150	179	8	2	29	0.0689655
NODE_235239_length_269_cov_1.288235	150	179	12	13	29	0.4482759
NODE_235239_length_269_cov_1.288235	150	179	16	3	29	0.1034483
NODE_235239_length_269_cov_1.288235	150	179	18	1	29	0.0344828
NODE_235292_length_269_cov_1.217647	141	221	0	17	80	0.2125000
NODE_235292_length_269_cov_1.217647	141	221	2	63	80	0.7875000
NODE_235561_length_269_cov_1.194118	107	170	0	16	63	0.2539683
NODE_235561_length_269_cov_1.194118	107	170	2	47	63	0.7460318
NODE_235561_length_269_cov_1.194118	143	221	2	78	78	1.0000000
NODE_235714_length_269_cov_1.094118	38	72	0	34	34	1.0000000
NODE_235780_length_269_cov_1.035294	6	36	0	30	30	1.0000000
NODE_235780_length_269_cov_1.035294	96	150	0	54	54	1.0000000
NODE_235930_length_269_cov_0.917647	4	79	0	75	75	1.0000000
NODE_235930_length_269_cov_0.917647	57	93	0	33	36	0.9166667
NODE_235930_length_269_cov_0.917647	57	93	1	3	36	0.0833333
NODE_236243_length_269_cov_0.782353	2	52	8	3	50	0.0600000
NODE_236243_length_269_cov_0.782353	2	52	10	5	50	0.1000000
NODE_236243_length_269_cov_0.782353	2	52	12	14	50	0.2800000
NODE_236243_length_269_cov_0.782353	2	52	16	4	50	0.0800000
NODE_236243_length_269_cov_0.782353	2	52	18	6	50	0.1200000
NODE_236243_length_269_cov_0.782353	2	52	19	1	50	0.0200000
NODE_236243_length_269_cov_0.782353	2	52	21	2	50	0.0400000
NODE_236243_length_269_cov_0.782353	2	52	22	1	50	0.0200000
NODE_236243_length_269_cov_0.782353	2	52	24	1	50	0.0200000
NODE_236243_length_269_cov_0.782353	2	52	26	7	50	0.1400000
NODE_236243_length_269_cov_0.782353	2	52	32	3	50	0.0600000
NODE_236243_length_269_cov_0.782353	2	52	34	3	50	0.0600000
NODE_236243_length_269_cov_0.782353	76	132	32	2	56	0.0357143
NODE_236243_length_269_cov_0.782353	76	132	36	4	56	0.0714286
NODE_236243_length_269_cov_0.782353	76	132	38	11	56	0.1964286
NODE_236243_length_269_cov_0.782353	76	132	40	31	56	0.5535714
NODE_236243_length_269_cov_0.782353	76	132	42	6	56	0.1071429
NODE_236243_length_269_cov_0.782353	76	132	44	2	56	0.0357143
NODE_236856_length_268_cov_223.165680	161	188	0	1	27	0.0370370
NODE_236856_length_268_cov_223.165680	161	188	2	3	27	0.1111111
NODE_236856_length_268_cov_223.165680	161	188	4	23	27	0.8518519
NODE_236856_length_268_cov_223.165680	161	241	0	1	80	0.0125000
NODE_236856_length_268_cov_223.165680	161	241	2	49	80	0.6125000
NODE_236856_length_268_cov_223.165680	161	241	4	30	80	0.3750000
NODE_236878_length_268_cov_6.266272	29	111	0	3	82	0.0365854
NODE_236878_length_268_cov_6.266272	29	111	4	79	82	0.9634146
NODE_236909_length_268_cov_5.053254	137	217	0	80	80	1.0000000
NODE_236909_length_268_cov_5.053254	190	253	0	63	63	1.0000000
NODE_236911_length_268_cov_4.994083	92	168	6	1	76	0.0131579
NODE_236911_length_268_cov_4.994083	92	168	14	23	76	0.3026316
NODE_236911_length_268_cov_4.994083	92	168	16	52	76	0.6842105
NODE_236972_length_268_cov_3.905325	1	61	0	60	60	1.0000000
NODE_237107_length_268_cov_2.982249	95	175	14	18	80	0.2250000
NODE_237107_length_268_cov_2.982249	95	175	16	17	80	0.2125000
NODE_237107_length_268_cov_2.982249	95	175	18	6	80	0.0750000
NODE_237107_length_268_cov_2.982249	95	175	20	25	80	0.3125000
NODE_237107_length_268_cov_2.982249	95	175	22	14	80	0.1750000
NODE_237115_length_268_cov_2.940828	28	97	0	69	69	1.0000000
NODE_237185_length_268_cov_2.668639	57	110	0	53	53	1.0000000
NODE_237190_length_268_cov_2.621302	149	176	4	27	27	1.0000000
NODE_237325_length_268_cov_2.289941	87	127	18	3	40	0.0750000
NODE_237325_length_268_cov_2.289941	87	127	20	2	40	0.0500000
NODE_237325_length_268_cov_2.289941	87	127	22	4	40	0.1000000
NODE_237325_length_268_cov_2.289941	87	127	24	21	40	0.5250000
NODE_237325_length_268_cov_2.289941	87	127	26	6	40	0.1500000
NODE_237325_length_268_cov_2.289941	87	127	28	4	40	0.1000000
NODE_237345_length_268_cov_2.224852	96	176	6	80	80	1.0000000
NODE_237345_length_268_cov_2.224852	149	229	3	1	80	0.0125000
NODE_237345_length_268_cov_2.224852	149	229	6	79	80	0.9875000
NODE_237457_length_268_cov_2.005917	97	162	0	65	65	1.0000000
NODE_237502_length_268_cov_1.840237	80	155	4	60	75	0.8000000
NODE_237502_length_268_cov_1.840237	80	155	6	15	75	0.2000000
NODE_237572_length_268_cov_1.810651	8	84	0	76	76	1.0000000
NODE_237831_length_268_cov_1.532544	186	257	20	3	71	0.0422535
NODE_237831_length_268_cov_1.532544	186	257	25	8	71	0.1126761
NODE_237831_length_268_cov_1.532544	186	257	27	1	71	0.0140845
NODE_237831_length_268_cov_1.532544	186	257	28	2	71	0.0281690
NODE_237831_length_268_cov_1.532544	186	257	30	1	71	0.0140845
NODE_237831_length_268_cov_1.532544	186	257	34	4	71	0.0563380
NODE_237831_length_268_cov_1.532544	186	257	36	2	71	0.0281690
NODE_237831_length_268_cov_1.532544	186	257	38	1	71	0.0140845
NODE_237831_length_268_cov_1.532544	186	257	40	1	71	0.0140845
NODE_237831_length_268_cov_1.532544	186	257	42	3	71	0.0422535
NODE_237831_length_268_cov_1.532544	186	257	44	3	71	0.0422535
NODE_237831_length_268_cov_1.532544	186	257	48	2	71	0.0281690
NODE_237831_length_268_cov_1.532544	186	257	49	1	71	0.0140845
NODE_237831_length_268_cov_1.532544	186	257	51	1	71	0.0140845
NODE_237831_length_268_cov_1.532544	186	257	54	3	71	0.0422535
NODE_237831_length_268_cov_1.532544	186	257	56	3	71	0.0422535
NODE_237831_length_268_cov_1.532544	186	257	62	5	71	0.0704225
NODE_237831_length_268_cov_1.532544	186	257	66	8	71	0.1126761
NODE_237831_length_268_cov_1.532544	186	257	68	6	71	0.0845070
NODE_237831_length_268_cov_1.532544	186	257	69	4	71	0.0563380
NODE_237831_length_268_cov_1.532544	186	257	71	2	71	0.0281690
NODE_237831_length_268_cov_1.532544	186	257	73	4	71	0.0563380
NODE_237831_length_268_cov_1.532544	186	257	75	1	71	0.0140845
NODE_237831_length_268_cov_1.532544	186	257	80	1	71	0.0140845
NODE_237831_length_268_cov_1.532544	186	257	82	1	71	0.0140845
NODE_237906_length_268_cov_1.508876	52	131	2	79	79	1.0000000
NODE_238009_length_268_cov_1.384615	0	46	0	46	46	1.0000000
NODE_238070_length_268_cov_1.278107	100	175	2	75	75	1.0000000
NODE_238153_length_268_cov_1.207101	187	209	2	22	22	1.0000000
NODE_238478_length_268_cov_1.153846	135	195	0	60	60	1.0000000
NODE_239018_length_268_cov_0.852071	59	119	25	14	60	0.2333333
NODE_239018_length_268_cov_0.852071	59	119	28	13	60	0.2166667
NODE_239018_length_268_cov_0.852071	59	119	30	25	60	0.4166667
NODE_239018_length_268_cov_0.852071	59	119	31	3	60	0.0500000
NODE_239018_length_268_cov_0.852071	59	119	33	1	60	0.0166667
NODE_239018_length_268_cov_0.852071	59	119	35	3	60	0.0500000
NODE_239018_length_268_cov_0.852071	59	119	37	1	60	0.0166667
NODE_239805_length_267_cov_4.297619	0	52	0	1	52	0.0192308
NODE_239805_length_267_cov_4.297619	0	52	2	51	52	0.9807692
NODE_239817_length_267_cov_4.119048	41	87	0	8	46	0.1739130
NODE_239817_length_267_cov_4.119048	41	87	2	38	46	0.8260869
NODE_239845_length_267_cov_3.785714	96	163	6	6	67	0.0895522
NODE_239845_length_267_cov_3.785714	96	163	8	12	67	0.1791045
NODE_239845_length_267_cov_3.785714	96	163	13	5	67	0.0746269
NODE_239845_length_267_cov_3.785714	96	163	15	6	67	0.0895522
NODE_239845_length_267_cov_3.785714	96	163	16	38	67	0.5671642
NODE_239845_length_267_cov_3.785714	136	178	0	3	42	0.0714286
NODE_239845_length_267_cov_3.785714	136	178	2	7	42	0.1666667
NODE_239845_length_267_cov_3.785714	136	178	6	11	42	0.2619048
NODE_239845_length_267_cov_3.785714	136	178	8	12	42	0.2857143
NODE_239845_length_267_cov_3.785714	136	178	13	5	42	0.1190476
NODE_239845_length_267_cov_3.785714	136	178	15	4	42	0.0952381
NODE_239873_length_267_cov_3.535714	40	101	0	9	61	0.1475410
NODE_239873_length_267_cov_3.535714	40	101	2	52	61	0.8524590
NODE_239873_length_267_cov_3.535714	74	154	1	10	80	0.1250000
NODE_239873_length_267_cov_3.535714	74	154	2	70	80	0.8750000
NODE_239958_length_267_cov_3.005952	216	267	0	51	51	1.0000000
NODE_239959_length_267_cov_3.000000	87	144	0	2	57	0.0350877
NODE_239959_length_267_cov_3.000000	87	144	2	3	57	0.0526316
NODE_239959_length_267_cov_3.000000	87	144	8	1	57	0.0175439
NODE_239959_length_267_cov_3.000000	87	144	9	2	57	0.0350877
NODE_239959_length_267_cov_3.000000	87	144	11	3	57	0.0526316
NODE_239959_length_267_cov_3.000000	87	144	14	8	57	0.1403509
NODE_239959_length_267_cov_3.000000	87	144	16	1	57	0.0175439
NODE_239959_length_267_cov_3.000000	87	144	18	2	57	0.0350877
NODE_239959_length_267_cov_3.000000	87	144	20	1	57	0.0175439
NODE_239959_length_267_cov_3.000000	87	144	21	3	57	0.0526316
NODE_239959_length_267_cov_3.000000	87	144	23	2	57	0.0350877
NODE_239959_length_267_cov_3.000000	87	144	24	1	57	0.0175439
NODE_239959_length_267_cov_3.000000	87	144	26	6	57	0.1052632
NODE_239959_length_267_cov_3.000000	87	144	30	7	57	0.1228070
NODE_239959_length_267_cov_3.000000	87	144	32	15	57	0.2631579
NODE_240007_length_267_cov_2.726190	177	220	8	43	43	1.0000000
NODE_240024_length_267_cov_2.690476	117	170	25	21	53	0.3962264
NODE_240024_length_267_cov_2.690476	117	170	27	16	53	0.3018868
NODE_240024_length_267_cov_2.690476	117	170	29	16	53	0.3018868
NODE_240029_length_267_cov_2.666667	198	267	0	69	69	1.0000000
NODE_240114_length_267_cov_2.428571	189	254	0	6	65	0.0923077
NODE_240114_length_267_cov_2.428571	189	254	1	1	65	0.0153846
NODE_240114_length_267_cov_2.428571	189	254	2	56	65	0.8615385
NODE_240114_length_267_cov_2.428571	189	254	10	1	65	0.0153846
NODE_240114_length_267_cov_2.428571	189	254	15	1	65	0.0153846
NODE_240207_length_267_cov_2.208333	45	103	2	58	58	1.0000000
NODE_240246_length_267_cov_2.125000	124	175	7	1	51	0.0196078
NODE_240246_length_267_cov_2.125000	124	175	8	50	51	0.9803922
NODE_240303_length_267_cov_2.077381	65	146	2	36	81	0.4444444
NODE_240303_length_267_cov_2.077381	65	146	4	45	81	0.5555556
NODE_240303_length_267_cov_2.077381	229	264	0	35	35	1.0000000
NODE_240331_length_267_cov_2.005952	147	228	0	48	81	0.5925926
NODE_240331_length_267_cov_2.005952	147	228	2	13	81	0.1604938
NODE_240331_length_267_cov_2.005952	147	228	4	10	81	0.1234568
NODE_240331_length_267_cov_2.005952	147	228	6	3	81	0.0370370
NODE_240331_length_267_cov_2.005952	147	228	8	7	81	0.0864198
NODE_240331_length_267_cov_2.005952	201	267	0	66	66	1.0000000
NODE_240336_length_267_cov_1.988095	77	157	0	80	80	1.0000000
NODE_240336_length_267_cov_1.988095	130	210	0	80	80	1.0000000
NODE_240620_length_267_cov_1.755952	119	199	0	67	80	0.8375000
NODE_240620_length_267_cov_1.755952	119	199	1	13	80	0.1625000
NODE_240624_length_267_cov_1.750000	23	104	30	1	81	0.0123457
NODE_240624_length_267_cov_1.750000	23	104	35	1	81	0.0123457
NODE_240624_length_267_cov_1.750000	23	104	36	1	81	0.0123457
NODE_240624_length_267_cov_1.750000	23	104	39	1	81	0.0123457
NODE_240624_length_267_cov_1.750000	23	104	42	1	81	0.0123457
NODE_240624_length_267_cov_1.750000	23	104	43	3	81	0.0370370
NODE_240624_length_267_cov_1.750000	23	104	45	2	81	0.0246914
NODE_240624_length_267_cov_1.750000	23	104	49	2	81	0.0246914
NODE_240624_length_267_cov_1.750000	23	104	51	1	81	0.0123457
NODE_240624_length_267_cov_1.750000	23	104	53	1	81	0.0123457
NODE_240624_length_267_cov_1.750000	23	104	55	1	81	0.0123457
NODE_240624_length_267_cov_1.750000	23	104	59	2	81	0.0246914
NODE_240624_length_267_cov_1.750000	23	104	62	12	81	0.1481481
NODE_240624_length_267_cov_1.750000	23	104	63	9	81	0.1111111
NODE_240624_length_267_cov_1.750000	23	104	64	3	81	0.0370370
NODE_240624_length_267_cov_1.750000	23	104	66	21	81	0.2592593
NODE_240624_length_267_cov_1.750000	23	104	68	19	81	0.2345679
NODE_240624_length_267_cov_1.750000	179	208	1	13	29	0.4482759
NODE_240624_length_267_cov_1.750000	179	208	3	4	29	0.1379310
NODE_240624_length_267_cov_1.750000	179	208	4	7	29	0.2413793
NODE_240624_length_267_cov_1.750000	179	208	7	1	29	0.0344828
NODE_240624_length_267_cov_1.750000	179	208	8	1	29	0.0344828
NODE_240624_length_267_cov_1.750000	179	208	10	2	29	0.0689655
NODE_240624_length_267_cov_1.750000	179	208	12	1	29	0.0344828
NODE_240653_length_267_cov_1.690476	18	90	0	72	72	1.0000000
NODE_240790_length_267_cov_1.517857	6	43	0	37	37	1.0000000
NODE_241075_length_267_cov_1.214286	37	91	0	54	54	1.0000000
NODE_241240_length_267_cov_1.214286	89	126	0	37	37	1.0000000
NODE_241352_length_267_cov_1.208333	124	164	2	40	40	1.0000000
NODE_241484_length_267_cov_1.125000	57	103	0	46	46	1.0000000
NODE_241512_length_267_cov_1.089286	119	196	0	41	77	0.5324675
NODE_241512_length_267_cov_1.089286	119	196	2	36	77	0.4675325
NODE_241512_length_267_cov_1.089286	169	249	0	80	80	1.0000000
NODE_241517_length_267_cov_1.083333	133	152	38	4	19	0.2105263
NODE_241517_length_267_cov_1.083333	133	152	40	15	19	0.7894737
NODE_241517_length_267_cov_1.083333	183	264	5	2	81	0.0246914
NODE_241517_length_267_cov_1.083333	183	264	7	7	81	0.0864198
NODE_241517_length_267_cov_1.083333	183	264	8	10	81	0.1234568
NODE_241517_length_267_cov_1.083333	183	264	10	3	81	0.0370370
NODE_241517_length_267_cov_1.083333	183	264	12	12	81	0.1481481
NODE_241517_length_267_cov_1.083333	183	264	14	9	81	0.1111111
NODE_241517_length_267_cov_1.083333	183	264	16	2	81	0.0246914
NODE_241517_length_267_cov_1.083333	183	264	18	9	81	0.1111111
NODE_241517_length_267_cov_1.083333	183	264	20	1	81	0.0123457
NODE_241517_length_267_cov_1.083333	183	264	22	18	81	0.2222222
NODE_241517_length_267_cov_1.083333	183	264	24	2	81	0.0246914
NODE_241517_length_267_cov_1.083333	183	264	26	1	81	0.0123457
NODE_241517_length_267_cov_1.083333	183	264	30	5	81	0.0617284
NODE_241588_length_267_cov_1.017857	205	267	0	62	62	1.0000000
NODE_241633_length_267_cov_0.982143	4	75	4	71	71	1.0000000
NODE_242999_length_266_cov_5.706587	120	199	0	79	79	1.0000000
NODE_242999_length_266_cov_5.706587	172	239	0	67	67	1.0000000
NODE_243010_length_266_cov_5.107784	68	150	4	27	82	0.3292683
NODE_243010_length_266_cov_5.107784	68	150	7	2	82	0.0243902
NODE_243010_length_266_cov_5.107784	68	150	8	7	82	0.0853659
NODE_243010_length_266_cov_5.107784	68	150	10	46	82	0.5609756
NODE_243064_length_266_cov_4.125749	99	168	11	13	69	0.1884058
NODE_243064_length_266_cov_4.125749	99	168	13	2	69	0.0289855
NODE_243064_length_266_cov_4.125749	99	168	19	3	69	0.0434783
NODE_243064_length_266_cov_4.125749	99	168	21	2	69	0.0289855
NODE_243064_length_266_cov_4.125749	99	168	29	18	69	0.2608696
NODE_243064_length_266_cov_4.125749	99	168	31	26	69	0.3768116
NODE_243064_length_266_cov_4.125749	99	168	33	5	69	0.0724638
NODE_243079_length_266_cov_3.958084	40	120	0	80	80	1.0000000
NODE_243079_length_266_cov_3.958084	93	159	0	66	66	1.0000000
NODE_243136_length_266_cov_3.419162	68	130	0	49	62	0.7903226
NODE_243136_length_266_cov_3.419162	68	130	2	13	62	0.2096774
NODE_243136_length_266_cov_3.419162	116	183	0	1	67	0.0149254
NODE_243136_length_266_cov_3.419162	116	183	2	66	67	0.9850746
NODE_243168_length_266_cov_3.137725	6	86	0	80	80	1.0000000
NODE_243168_length_266_cov_3.137725	59	120	0	61	61	1.0000000
NODE_243174_length_266_cov_3.107784	166	232	34	4	66	0.0606061
NODE_243174_length_266_cov_3.107784	166	232	36	1	66	0.0151515
NODE_243174_length_266_cov_3.107784	166	232	40	3	66	0.0454545
NODE_243174_length_266_cov_3.107784	166	232	43	1	66	0.0151515
NODE_243174_length_266_cov_3.107784	166	232	44	2	66	0.0303030
NODE_243174_length_266_cov_3.107784	166	232	46	11	66	0.1666667
NODE_243174_length_266_cov_3.107784	166	232	48	11	66	0.1666667
NODE_243174_length_266_cov_3.107784	166	232	50	5	66	0.0757576
NODE_243174_length_266_cov_3.107784	166	232	52	5	66	0.0757576
NODE_243174_length_266_cov_3.107784	166	232	54	1	66	0.0151515
NODE_243174_length_266_cov_3.107784	166	232	56	7	66	0.1060606
NODE_243174_length_266_cov_3.107784	166	232	58	2	66	0.0303030
NODE_243174_length_266_cov_3.107784	166	232	59	3	66	0.0454545
NODE_243174_length_266_cov_3.107784	166	232	61	1	66	0.0151515
NODE_243174_length_266_cov_3.107784	166	232	63	5	66	0.0757576
NODE_243174_length_266_cov_3.107784	166	232	67	4	66	0.0606061
NODE_243475_length_266_cov_2.179641	110	191	15	2	81	0.0246914
NODE_243475_length_266_cov_2.179641	110	191	16	12	81	0.1481481
NODE_243475_length_266_cov_2.179641	110	191	18	10	81	0.1234568
NODE_243475_length_266_cov_2.179641	110	191	20	3	81	0.0370370
NODE_243475_length_266_cov_2.179641	110	191	22	3	81	0.0370370
NODE_243475_length_266_cov_2.179641	110	191	26	13	81	0.1604938
NODE_243475_length_266_cov_2.179641	110	191	30	11	81	0.1358025
NODE_243475_length_266_cov_2.179641	110	191	31	3	81	0.0370370
NODE_243475_length_266_cov_2.179641	110	191	33	3	81	0.0370370
NODE_243475_length_266_cov_2.179641	110	191	35	4	81	0.0493827
NODE_243475_length_266_cov_2.179641	110	191	37	17	81	0.2098765
NODE_243497_length_266_cov_2.137725	156	236	30	6	80	0.0750000
NODE_243497_length_266_cov_2.137725	156	236	31	10	80	0.1250000
NODE_243497_length_266_cov_2.137725	156	236	32	64	80	0.8000000
NODE_243570_length_266_cov_2.023952	47	123	0	75	76	0.9868421
NODE_243570_length_266_cov_2.023952	47	123	2	1	76	0.0131579
NODE_243972_length_266_cov_1.532934	155	235	4	27	80	0.3375000
NODE_243972_length_266_cov_1.532934	155	235	6	5	80	0.0625000
NODE_243972_length_266_cov_1.532934	155	235	8	14	80	0.1750000
NODE_243972_length_266_cov_1.532934	155	235	12	12	80	0.1500000
NODE_243972_length_266_cov_1.532934	155	235	14	22	80	0.2750000
NODE_244681_length_266_cov_1.113772	70	97	2	27	27	1.0000000
NODE_244760_length_266_cov_1.023952	144	201	6	57	57	1.0000000
NODE_244760_length_266_cov_1.023952	199	265	0	40	66	0.6060606
NODE_244760_length_266_cov_1.023952	199	265	3	2	66	0.0303030
NODE_244760_length_266_cov_1.023952	199	265	4	11	66	0.1666667
NODE_244760_length_266_cov_1.023952	199	265	6	13	66	0.1969697
NODE_245049_length_266_cov_0.916168	51	122	0	71	71	1.0000000
NODE_245280_length_266_cov_0.730539	132	158	0	26	26	1.0000000
NODE_245538_length_266_cov_0.610778	99	139	2	40	40	1.0000000
NODE_245538_length_266_cov_0.610778	112	156	2	44	44	1.0000000
NODE_246087_length_265_cov_7.843373	128	208	5	15	80	0.1875000
NODE_246087_length_265_cov_7.843373	128	208	6	3	80	0.0375000
NODE_246087_length_265_cov_7.843373	128	208	8	16	80	0.2000000
NODE_246087_length_265_cov_7.843373	128	208	9	14	80	0.1750000
NODE_246087_length_265_cov_7.843373	128	208	10	1	80	0.0125000
NODE_246087_length_265_cov_7.843373	128	208	17	2	80	0.0250000
NODE_246087_length_265_cov_7.843373	128	208	19	5	80	0.0625000
NODE_246087_length_265_cov_7.843373	128	208	23	7	80	0.0875000
NODE_246087_length_265_cov_7.843373	128	208	25	9	80	0.1125000
NODE_246087_length_265_cov_7.843373	128	208	26	6	80	0.0750000
NODE_246087_length_265_cov_7.843373	128	208	28	2	80	0.0250000
NODE_246192_length_265_cov_4.054217	65	145	0	80	80	1.0000000
NODE_246192_length_265_cov_4.054217	118	198	0	80	80	1.0000000
NODE_246198_length_265_cov_3.993976	195	231	0	36	36	1.0000000
NODE_246284_length_265_cov_3.150602	183	263	0	28	80	0.3500000
NODE_246284_length_265_cov_3.150602	183	263	2	1	80	0.0125000
NODE_246284_length_265_cov_3.150602	183	263	3	8	80	0.1000000
NODE_246284_length_265_cov_3.150602	183	263	4	43	80	0.5375000
NODE_246374_length_265_cov_2.789157	177	238	0	1	61	0.0163934
NODE_246374_length_265_cov_2.789157	177	238	2	60	61	0.9836066
NODE_246409_length_265_cov_2.734940	167	247	0	80	80	1.0000000
NODE_246432_length_265_cov_2.608434	188	259	0	71	71	1.0000000
NODE_246606_length_265_cov_2.156627	197	237	4	11	40	0.2750000
NODE_246606_length_265_cov_2.156627	197	237	6	1	40	0.0250000
NODE_246606_length_265_cov_2.156627	197	237	9	8	40	0.2000000
NODE_246606_length_265_cov_2.156627	197	237	10	7	40	0.1750000
NODE_246606_length_265_cov_2.156627	197	237	11	13	40	0.3250000
NODE_246624_length_265_cov_2.150602	169	218	0	49	49	1.0000000
NODE_246692_length_265_cov_1.975904	15	44	0	29	29	1.0000000
NODE_246811_length_265_cov_1.843373	195	265	1	1	70	0.0142857
NODE_246811_length_265_cov_1.843373	195	265	4	15	70	0.2142857
NODE_246811_length_265_cov_1.843373	195	265	6	21	70	0.3000000
NODE_246811_length_265_cov_1.843373	195	265	7	18	70	0.2571429
NODE_246811_length_265_cov_1.843373	195	265	8	15	70	0.2142857
NODE_247028_length_265_cov_1.620482	115	186	2	16	71	0.2253521
NODE_247028_length_265_cov_1.620482	115	186	4	55	71	0.7746479
NODE_247028_length_265_cov_1.620482	117	171	4	54	54	1.0000000
NODE_247031_length_265_cov_1.614458	53	113	2	7	60	0.1166667
NODE_247031_length_265_cov_1.614458	53	113	4	4	60	0.0666667
NODE_247031_length_265_cov_1.614458	53	113	8	6	60	0.1000000
NODE_247031_length_265_cov_1.614458	53	113	10	1	60	0.0166667
NODE_247031_length_265_cov_1.614458	53	113	14	2	60	0.0333333
NODE_247031_length_265_cov_1.614458	53	113	16	2	60	0.0333333
NODE_247031_length_265_cov_1.614458	53	113	17	1	60	0.0166667
NODE_247031_length_265_cov_1.614458	53	113	19	2	60	0.0333333
NODE_247031_length_265_cov_1.614458	53	113	23	2	60	0.0333333
NODE_247031_length_265_cov_1.614458	53	113	29	1	60	0.0166667
NODE_247031_length_265_cov_1.614458	53	113	30	4	60	0.0666667
NODE_247031_length_265_cov_1.614458	53	113	31	1	60	0.0166667
NODE_247031_length_265_cov_1.614458	53	113	34	1	60	0.0166667
NODE_247031_length_265_cov_1.614458	53	113	36	1	60	0.0166667
NODE_247031_length_265_cov_1.614458	53	113	38	1	60	0.0166667
NODE_247031_length_265_cov_1.614458	53	113	39	1	60	0.0166667
NODE_247031_length_265_cov_1.614458	53	113	41	1	60	0.0166667
NODE_247031_length_265_cov_1.614458	53	113	43	4	60	0.0666667
NODE_247031_length_265_cov_1.614458	53	113	45	4	60	0.0666667
NODE_247031_length_265_cov_1.614458	53	113	47	2	60	0.0333333
NODE_247031_length_265_cov_1.614458	53	113	49	1	60	0.0166667
NODE_247031_length_265_cov_1.614458	53	113	51	2	60	0.0333333
NODE_247031_length_265_cov_1.614458	53	113	52	4	60	0.0666667
NODE_247031_length_265_cov_1.614458	53	113	53	3	60	0.0500000
NODE_247031_length_265_cov_1.614458	53	113	59	2	60	0.0333333
NODE_247031_length_265_cov_1.614458	86	166	34	1	80	0.0125000
NODE_247031_length_265_cov_1.614458	86	166	36	1	80	0.0125000
NODE_247031_length_265_cov_1.614458	86	166	38	1	80	0.0125000
NODE_247031_length_265_cov_1.614458	86	166	39	1	80	0.0125000
NODE_247031_length_265_cov_1.614458	86	166	41	1	80	0.0125000
NODE_247031_length_265_cov_1.614458	86	166	43	4	80	0.0500000
NODE_247031_length_265_cov_1.614458	86	166	45	4	80	0.0500000
NODE_247031_length_265_cov_1.614458	86	166	47	2	80	0.0250000
NODE_247031_length_265_cov_1.614458	86	166	49	1	80	0.0125000
NODE_247031_length_265_cov_1.614458	86	166	51	2	80	0.0250000
NODE_247031_length_265_cov_1.614458	86	166	52	4	80	0.0500000
NODE_247031_length_265_cov_1.614458	86	166	53	3	80	0.0375000
NODE_247031_length_265_cov_1.614458	86	166	59	7	80	0.0875000
NODE_247031_length_265_cov_1.614458	86	166	60	12	80	0.1500000
NODE_247031_length_265_cov_1.614458	86	166	61	6	80	0.0750000
NODE_247031_length_265_cov_1.614458	86	166	62	1	80	0.0125000
NODE_247031_length_265_cov_1.614458	86	166	63	9	80	0.1125000
NODE_247031_length_265_cov_1.614458	86	166	64	6	80	0.0750000
NODE_247031_length_265_cov_1.614458	86	166	65	1	80	0.0125000
NODE_247031_length_265_cov_1.614458	86	166	66	3	80	0.0375000
NODE_247031_length_265_cov_1.614458	86	166	68	3	80	0.0375000
NODE_247031_length_265_cov_1.614458	86	166	70	7	80	0.0875000
NODE_247314_length_265_cov_1.337349	107	168	2	1	61	0.0163934
NODE_247314_length_265_cov_1.337349	107	168	6	5	61	0.0819672
NODE_247314_length_265_cov_1.337349	107	168	8	19	61	0.3114754
NODE_247314_length_265_cov_1.337349	107	168	10	16	61	0.2622951
NODE_247314_length_265_cov_1.337349	107	168	12	3	61	0.0491803
NODE_247314_length_265_cov_1.337349	107	168	14	17	61	0.2786885
NODE_247952_length_265_cov_1.000000	187	251	0	6	64	0.0937500
NODE_247952_length_265_cov_1.000000	187	251	4	11	64	0.1718750
NODE_247952_length_265_cov_1.000000	187	251	6	47	64	0.7343750
NODE_247972_length_265_cov_0.987952	44	63	0	7	19	0.3684210
NODE_247972_length_265_cov_0.987952	44	63	2	12	19	0.6315789
NODE_249395_length_264_cov_4.018182	141	178	2	37	37	1.0000000
NODE_249404_length_264_cov_3.957576	59	132	0	12	73	0.1643836
NODE_249404_length_264_cov_3.957576	59	132	6	61	73	0.8356164
NODE_249404_length_264_cov_3.957576	112	192	0	37	80	0.4625000
NODE_249404_length_264_cov_3.957576	112	192	6	43	80	0.5375000
NODE_249415_length_264_cov_3.824242	178	220	0	42	42	1.0000000
NODE_249452_length_264_cov_3.400000	73	125	0	52	52	1.0000000
NODE_249452_length_264_cov_3.400000	124	165	0	41	41	1.0000000
NODE_249485_length_264_cov_3.133333	119	186	0	11	67	0.1641791
NODE_249485_length_264_cov_3.133333	119	186	2	56	67	0.8358209
NODE_249530_length_264_cov_3.012121	122	198	0	1	76	0.0131579
NODE_249530_length_264_cov_3.012121	122	198	2	40	76	0.5263158
NODE_249530_length_264_cov_3.012121	122	198	8	35	76	0.4605263
NODE_249904_length_264_cov_2.048485	32	98	0	27	66	0.4090909
NODE_249904_length_264_cov_2.048485	32	98	2	27	66	0.4090909
NODE_249904_length_264_cov_2.048485	32	98	4	6	66	0.0909091
NODE_249904_length_264_cov_2.048485	32	98	6	1	66	0.0151515
NODE_249904_length_264_cov_2.048485	32	98	7	1	66	0.0151515
NODE_249904_length_264_cov_2.048485	32	98	13	3	66	0.0454545
NODE_249904_length_264_cov_2.048485	32	98	15	1	66	0.0151515
NODE_249905_length_264_cov_2.048485	133	176	0	43	43	1.0000000
NODE_249912_length_264_cov_2.012121	20	84	0	64	64	1.0000000
NODE_249931_length_264_cov_1.951515	178	211	2	33	33	1.0000000
NODE_249982_length_264_cov_1.854545	130	161	0	13	31	0.4193548
NODE_249982_length_264_cov_1.854545	130	161	2	18	31	0.5806451
NODE_250202_length_264_cov_1.745455	26	81	0	55	55	1.0000000
NODE_250202_length_264_cov_1.745455	86	153	0	67	67	1.0000000
NODE_250203_length_264_cov_1.745455	90	169	16	2	79	0.0253165
NODE_250203_length_264_cov_1.745455	90	169	18	5	79	0.0632911
NODE_250203_length_264_cov_1.745455	90	169	20	3	79	0.0379747
NODE_250203_length_264_cov_1.745455	90	169	22	2	79	0.0253165
NODE_250203_length_264_cov_1.745455	90	169	24	5	79	0.0632911
NODE_250203_length_264_cov_1.745455	90	169	26	8	79	0.1012658
NODE_250203_length_264_cov_1.745455	90	169	36	1	79	0.0126582
NODE_250203_length_264_cov_1.745455	90	169	38	3	79	0.0379747
NODE_250203_length_264_cov_1.745455	90	169	42	1	79	0.0126582
NODE_250203_length_264_cov_1.745455	90	169	44	1	79	0.0126582
NODE_250203_length_264_cov_1.745455	90	169	46	18	79	0.2278481
NODE_250203_length_264_cov_1.745455	90	169	48	7	79	0.0886076
NODE_250203_length_264_cov_1.745455	90	169	50	9	79	0.1139240
NODE_250203_length_264_cov_1.745455	90	169	52	1	79	0.0126582
NODE_250203_length_264_cov_1.745455	90	169	53	1	79	0.0126582
NODE_250203_length_264_cov_1.745455	90	169	55	11	79	0.1392405
NODE_250203_length_264_cov_1.745455	90	169	57	1	79	0.0126582
NODE_250203_length_264_cov_1.745455	143	207	44	7	64	0.1093750
NODE_250203_length_264_cov_1.745455	143	207	46	1	64	0.0156250
NODE_250203_length_264_cov_1.745455	143	207	48	11	64	0.1718750
NODE_250203_length_264_cov_1.745455	143	207	49	4	64	0.0625000
NODE_250203_length_264_cov_1.745455	143	207	50	13	64	0.2031250
NODE_250203_length_264_cov_1.745455	143	207	51	10	64	0.1562500
NODE_250203_length_264_cov_1.745455	143	207	52	1	64	0.0156250
NODE_250203_length_264_cov_1.745455	143	207	53	4	64	0.0625000
NODE_250203_length_264_cov_1.745455	143	207	55	12	64	0.1875000
NODE_250203_length_264_cov_1.745455	143	207	57	1	64	0.0156250
NODE_250297_length_264_cov_1.569697	173	236	0	63	63	1.0000000
NODE_250314_length_264_cov_1.545455	206	255	0	49	49	1.0000000
NODE_250381_length_264_cov_1.545455	35	66	0	31	31	1.0000000
NODE_250446_length_264_cov_1.503030	0	63	0	63	63	1.0000000
NODE_250513_length_264_cov_1.406061	149	230	0	81	81	1.0000000
NODE_250513_length_264_cov_1.406061	225	260	0	35	35	1.0000000
NODE_250635_length_264_cov_1.236364	2	63	0	61	61	1.0000000
NODE_251015_length_264_cov_1.151515	11	68	0	57	57	1.0000000
NODE_251529_length_264_cov_0.921212	49	85	0	36	36	1.0000000
NODE_251703_length_264_cov_0.721212	233	252	0	19	19	1.0000000
NODE_252559_length_263_cov_5.115854	132	219	43	2	87	0.0229885
NODE_252559_length_263_cov_5.115854	132	219	46	1	87	0.0114943
NODE_252559_length_263_cov_5.115854	132	219	48	1	87	0.0114943
NODE_252559_length_263_cov_5.115854	132	219	54	1	87	0.0114943
NODE_252559_length_263_cov_5.115854	132	219	59	10	87	0.1149425
NODE_252559_length_263_cov_5.115854	132	219	60	10	87	0.1149425
NODE_252559_length_263_cov_5.115854	132	219	61	2	87	0.0229885
NODE_252559_length_263_cov_5.115854	132	219	62	3	87	0.0344828
NODE_252559_length_263_cov_5.115854	132	219	63	2	87	0.0229885
NODE_252559_length_263_cov_5.115854	132	219	64	16	87	0.1839080
NODE_252559_length_263_cov_5.115854	132	219	65	9	87	0.1034483
NODE_252559_length_263_cov_5.115854	132	219	66	15	87	0.1724138
NODE_252559_length_263_cov_5.115854	132	219	67	1	87	0.0114943
NODE_252559_length_263_cov_5.115854	132	219	68	14	87	0.1609195
NODE_252563_length_263_cov_4.914634	45	117	2	10	72	0.1388889
NODE_252563_length_263_cov_4.914634	45	117	4	24	72	0.3333333
NODE_252563_length_263_cov_4.914634	45	117	6	11	72	0.1527778
NODE_252563_length_263_cov_4.914634	45	117	8	2	72	0.0277778
NODE_252563_length_263_cov_4.914634	45	117	10	25	72	0.3472222
NODE_252595_length_263_cov_4.225610	67	124	24	41	57	0.7192982
NODE_252595_length_263_cov_4.225610	67	124	26	16	57	0.2807018
NODE_252663_length_263_cov_3.518293	104	176	11	4	72	0.0555556
NODE_252663_length_263_cov_3.518293	104	176	12	27	72	0.3750000
NODE_252663_length_263_cov_3.518293	104	176	13	2	72	0.0277778
NODE_252663_length_263_cov_3.518293	104	176	14	39	72	0.5416667
NODE_252766_length_263_cov_2.908537	7	93	0	23	86	0.2674419
NODE_252766_length_263_cov_2.908537	7	93	1	27	86	0.3139535
NODE_252766_length_263_cov_2.908537	7	93	2	25	86	0.2906977
NODE_252766_length_263_cov_2.908537	7	93	4	1	86	0.0116279
NODE_252766_length_263_cov_2.908537	7	93	8	10	86	0.1162791
NODE_252778_length_263_cov_2.798780	67	146	6	18	79	0.2278481
NODE_252778_length_263_cov_2.798780	67	146	7	4	79	0.0506329
NODE_252778_length_263_cov_2.798780	67	146	9	1	79	0.0126582
NODE_252778_length_263_cov_2.798780	67	146	11	30	79	0.3797468
NODE_252778_length_263_cov_2.798780	67	146	13	26	79	0.3291139
NODE_252932_length_263_cov_2.396341	207	238	0	31	31	1.0000000
NODE_253261_length_263_cov_1.865854	51	81	7	6	30	0.2000000
NODE_253261_length_263_cov_1.865854	51	81	9	5	30	0.1666667
NODE_253261_length_263_cov_1.865854	51	81	11	3	30	0.1000000
NODE_253261_length_263_cov_1.865854	51	81	13	4	30	0.1333333
NODE_253261_length_263_cov_1.865854	51	81	15	12	30	0.4000000
NODE_253310_length_263_cov_1.847561	113	189	0	76	76	1.0000000
NODE_253379_length_263_cov_1.750000	151	231	0	10	80	0.1250000
NODE_253379_length_263_cov_1.750000	151	231	2	70	80	0.8750000
NODE_253468_length_263_cov_1.579268	32	95	14	2	63	0.0317460
NODE_253468_length_263_cov_1.579268	32	95	16	2	63	0.0317460
NODE_253468_length_263_cov_1.579268	32	95	20	4	63	0.0634921
NODE_253468_length_263_cov_1.579268	32	95	21	3	63	0.0476190
NODE_253468_length_263_cov_1.579268	32	95	23	12	63	0.1904762
NODE_253468_length_263_cov_1.579268	32	95	25	40	63	0.6349207
NODE_253477_length_263_cov_1.567073	98	155	0	57	57	1.0000000
NODE_253619_length_263_cov_1.506098	157	217	0	4	60	0.0666667
NODE_253619_length_263_cov_1.506098	157	217	2	56	60	0.9333333
NODE_253620_length_263_cov_1.506098	84	113	4	7	29	0.2413793
NODE_253620_length_263_cov_1.506098	84	113	6	9	29	0.3103448
NODE_253620_length_263_cov_1.506098	84	113	8	13	29	0.4482759
NODE_253753_length_263_cov_1.286585	143	223	0	3	80	0.0375000
NODE_253753_length_263_cov_1.286585	143	223	4	5	80	0.0625000
NODE_253753_length_263_cov_1.286585	143	223	8	2	80	0.0250000
NODE_253753_length_263_cov_1.286585	143	223	10	3	80	0.0375000
NODE_253753_length_263_cov_1.286585	143	223	12	23	80	0.2875000
NODE_253753_length_263_cov_1.286585	143	223	14	2	80	0.0250000
NODE_253753_length_263_cov_1.286585	143	223	18	8	80	0.1000000
NODE_253753_length_263_cov_1.286585	143	223	20	2	80	0.0250000
NODE_253753_length_263_cov_1.286585	143	223	22	3	80	0.0375000
NODE_253753_length_263_cov_1.286585	143	223	23	1	80	0.0125000
NODE_253753_length_263_cov_1.286585	143	223	24	2	80	0.0250000
NODE_253753_length_263_cov_1.286585	143	223	26	6	80	0.0750000
NODE_253753_length_263_cov_1.286585	143	223	28	16	80	0.2000000
NODE_253753_length_263_cov_1.286585	143	223	33	2	80	0.0250000
NODE_253753_length_263_cov_1.286585	143	223	37	2	80	0.0250000
NODE_253788_length_263_cov_1.243902	206	263	0	57	57	1.0000000
NODE_254174_length_263_cov_1.170732	12	66	0	54	54	1.0000000
NODE_254174_length_263_cov_1.170732	39	119	0	80	80	1.0000000
NODE_254301_length_263_cov_1.067073	137	202	0	16	65	0.2461538
NODE_254301_length_263_cov_1.067073	137	202	2	49	65	0.7538462
NODE_254301_length_263_cov_1.067073	175	255	2	80	80	1.0000000
NODE_254783_length_263_cov_0.810976	163	245	84	1	82	0.0121951
NODE_254783_length_263_cov_0.810976	163	245	85	1	82	0.0121951
NODE_254783_length_263_cov_0.810976	163	245	96	1	82	0.0121951
NODE_254783_length_263_cov_0.810976	163	245	97	1	82	0.0121951
NODE_254783_length_263_cov_0.810976	163	245	98	1	82	0.0121951
NODE_254783_length_263_cov_0.810976	163	245	101	1	82	0.0121951
NODE_254783_length_263_cov_0.810976	163	245	102	1	82	0.0121951
NODE_254783_length_263_cov_0.810976	163	245	107	1	82	0.0121951
NODE_254783_length_263_cov_0.810976	163	245	109	1	82	0.0121951
NODE_254783_length_263_cov_0.810976	163	245	111	1	82	0.0121951
NODE_254783_length_263_cov_0.810976	163	245	116	3	82	0.0365854
NODE_254783_length_263_cov_0.810976	163	245	118	1	82	0.0121951
NODE_254783_length_263_cov_0.810976	163	245	135	1	82	0.0121951
NODE_254783_length_263_cov_0.810976	163	245	137	1	82	0.0121951
NODE_254783_length_263_cov_0.810976	163	245	140	1	82	0.0121951
NODE_254783_length_263_cov_0.810976	163	245	154	1	82	0.0121951
NODE_254783_length_263_cov_0.810976	163	245	157	1	82	0.0121951
NODE_254783_length_263_cov_0.810976	163	245	158	1	82	0.0121951
NODE_254783_length_263_cov_0.810976	163	245	165	1	82	0.0121951
NODE_254783_length_263_cov_0.810976	163	245	167	1	82	0.0121951
NODE_254783_length_263_cov_0.810976	163	245	170	1	82	0.0121951
NODE_254783_length_263_cov_0.810976	163	245	173	1	82	0.0121951
NODE_254783_length_263_cov_0.810976	163	245	175	4	82	0.0487805
NODE_254783_length_263_cov_0.810976	163	245	177	2	82	0.0243902
NODE_254783_length_263_cov_0.810976	163	245	179	1	82	0.0121951
NODE_254783_length_263_cov_0.810976	163	245	182	1	82	0.0121951
NODE_254783_length_263_cov_0.810976	163	245	188	1	82	0.0121951
NODE_254783_length_263_cov_0.810976	163	245	191	1	82	0.0121951
NODE_254783_length_263_cov_0.810976	163	245	192	1	82	0.0121951
NODE_254783_length_263_cov_0.810976	163	245	199	1	82	0.0121951
NODE_254783_length_263_cov_0.810976	163	245	205	1	82	0.0121951
NODE_254783_length_263_cov_0.810976	163	245	228	1	82	0.0121951
NODE_254783_length_263_cov_0.810976	163	245	232	1	82	0.0121951
NODE_254783_length_263_cov_0.810976	163	245	246	1	82	0.0121951
NODE_254783_length_263_cov_0.810976	163	245	255	1	82	0.0121951
NODE_254783_length_263_cov_0.810976	163	245	273	1	82	0.0121951
NODE_254783_length_263_cov_0.810976	163	245	280	1	82	0.0121951
NODE_254783_length_263_cov_0.810976	163	245	283	1	82	0.0121951
NODE_254783_length_263_cov_0.810976	163	245	285	1	82	0.0121951
NODE_254783_length_263_cov_0.810976	163	245	289	1	82	0.0121951
NODE_254783_length_263_cov_0.810976	163	245	295	1	82	0.0121951
NODE_254783_length_263_cov_0.810976	163	245	300	3	82	0.0365854
NODE_254783_length_263_cov_0.810976	163	245	302	1	82	0.0121951
NODE_254783_length_263_cov_0.810976	163	245	304	1	82	0.0121951
NODE_254783_length_263_cov_0.810976	163	245	305	1	82	0.0121951
NODE_254783_length_263_cov_0.810976	163	245	308	3	82	0.0365854
NODE_254783_length_263_cov_0.810976	163	245	311	1	82	0.0121951
NODE_254783_length_263_cov_0.810976	163	245	317	2	82	0.0243902
NODE_254783_length_263_cov_0.810976	163	245	324	2	82	0.0243902
NODE_254783_length_263_cov_0.810976	163	245	327	1	82	0.0121951
NODE_254783_length_263_cov_0.810976	163	245	330	1	82	0.0121951
NODE_254783_length_263_cov_0.810976	163	245	333	1	82	0.0121951
NODE_254783_length_263_cov_0.810976	163	245	340	1	82	0.0121951
NODE_254783_length_263_cov_0.810976	163	245	344	2	82	0.0243902
NODE_254783_length_263_cov_0.810976	163	245	346	1	82	0.0121951
NODE_254783_length_263_cov_0.810976	163	245	360	1	82	0.0121951
NODE_254783_length_263_cov_0.810976	163	245	369	1	82	0.0121951
NODE_254783_length_263_cov_0.810976	163	245	372	1	82	0.0121951
NODE_254783_length_263_cov_0.810976	163	245	373	1	82	0.0121951
NODE_254783_length_263_cov_0.810976	163	245	374	4	82	0.0487805
NODE_254783_length_263_cov_0.810976	163	245	375	2	82	0.0243902
NODE_254783_length_263_cov_0.810976	163	245	376	2	82	0.0243902
NODE_254783_length_263_cov_0.810976	163	245	380	2	82	0.0243902
NODE_255446_length_263_cov_0.621951	212	258	0	46	46	1.0000000
NODE_255524_length_263_cov_0.621951	131	151	0	20	20	1.0000000
NODE_255559_length_263_cov_0.621951	67	86	0	14	19	0.7368421
NODE_255559_length_263_cov_0.621951	67	86	1	5	19	0.2631579
NODE_255727_length_262_cov_5.312883	20	82	2	62	62	1.0000000
NODE_255769_length_262_cov_4.447853	102	155	0	3	53	0.0566038
NODE_255769_length_262_cov_4.447853	102	155	2	38	53	0.7169811
NODE_255769_length_262_cov_4.447853	102	155	4	12	53	0.2264151
NODE_255821_length_262_cov_3.766871	48	89	0	41	41	1.0000000
NODE_255860_length_262_cov_3.435583	158	235	0	77	77	1.0000000
NODE_255945_length_262_cov_2.938650	142	222	0	80	80	1.0000000
NODE_256009_length_262_cov_2.723926	103	183	0	80	80	1.0000000
NODE_256049_length_262_cov_2.509202	88	148	0	17	60	0.2833333
NODE_256049_length_262_cov_2.509202	88	148	2	43	60	0.7166666
NODE_256050_length_262_cov_2.509202	0	61	0	61	61	1.0000000
NODE_256050_length_262_cov_2.509202	107	171	0	64	64	1.0000000
NODE_256050_length_262_cov_2.509202	144	224	0	80	80	1.0000000
NODE_256129_length_262_cov_2.429448	14	87	0	18	73	0.2465753
NODE_256129_length_262_cov_2.429448	14	87	2	55	73	0.7534246
NODE_256129_length_262_cov_2.429448	62	149	0	19	87	0.2183908
NODE_256129_length_262_cov_2.429448	62	149	1	1	87	0.0114943
NODE_256129_length_262_cov_2.429448	62	149	2	7	87	0.0804598
NODE_256129_length_262_cov_2.429448	62	149	3	13	87	0.1494253
NODE_256129_length_262_cov_2.429448	62	149	4	47	87	0.5402299
NODE_256176_length_262_cov_2.226994	2	79	0	1	77	0.0129870
NODE_256176_length_262_cov_2.226994	2	79	2	76	77	0.9870130
NODE_256187_length_262_cov_2.202454	61	81	0	20	20	1.0000000
NODE_256199_length_262_cov_2.190184	172	235	29	6	63	0.0952381
NODE_256199_length_262_cov_2.190184	172	235	30	7	63	0.1111111
NODE_256199_length_262_cov_2.190184	172	235	32	1	63	0.0158730
NODE_256199_length_262_cov_2.190184	172	235	34	5	63	0.0793651
NODE_256199_length_262_cov_2.190184	172	235	35	19	63	0.3015873
NODE_256199_length_262_cov_2.190184	172	235	36	25	63	0.3968254
NODE_256239_length_262_cov_2.177914	133	189	0	56	56	1.0000000
NODE_256265_length_262_cov_2.122699	96	157	2	36	61	0.5901639
NODE_256265_length_262_cov_2.122699	96	157	4	25	61	0.4098361
NODE_256386_length_262_cov_1.877301	0	77	0	54	77	0.7012987
NODE_256386_length_262_cov_1.877301	0	77	2	23	77	0.2987013
NODE_256390_length_262_cov_1.877301	77	124	25	2	47	0.0425532
NODE_256390_length_262_cov_1.877301	77	124	27	1	47	0.0212766
NODE_256390_length_262_cov_1.877301	77	124	28	6	47	0.1276596
NODE_256390_length_262_cov_1.877301	77	124	29	38	47	0.8085107
NODE_256481_length_262_cov_1.871166	192	252	0	60	60	1.0000000
NODE_256596_length_262_cov_1.736196	149	208	0	59	59	1.0000000
NODE_256630_length_262_cov_1.680982	2	82	0	80	80	1.0000000
NODE_256650_length_262_cov_1.656442	135	166	0	31	31	1.0000000
NODE_256659_length_262_cov_1.638037	111	142	8	31	31	1.0000000
NODE_256704_length_262_cov_1.576687	102	182	9	2	80	0.0250000
NODE_256704_length_262_cov_1.576687	102	182	10	3	80	0.0375000
NODE_256704_length_262_cov_1.576687	102	182	12	28	80	0.3500000
NODE_256704_length_262_cov_1.576687	102	182	14	47	80	0.5875000
NODE_256704_length_262_cov_1.576687	155	221	2	1	66	0.0151515
NODE_256704_length_262_cov_1.576687	155	221	4	10	66	0.1515152
NODE_256704_length_262_cov_1.576687	155	221	8	5	66	0.0757576
NODE_256704_length_262_cov_1.576687	155	221	10	3	66	0.0454545
NODE_256704_length_262_cov_1.576687	155	221	12	28	66	0.4242424
NODE_256704_length_262_cov_1.576687	155	221	14	19	66	0.2878788
NODE_256742_length_262_cov_1.564417	69	124	2	15	55	0.2727273
NODE_256742_length_262_cov_1.564417	69	124	4	34	55	0.6181818
NODE_256742_length_262_cov_1.564417	69	124	6	3	55	0.0545455
NODE_256742_length_262_cov_1.564417	69	124	8	3	55	0.0545455
NODE_256742_length_262_cov_1.564417	106	177	2	11	71	0.1549296
NODE_256742_length_262_cov_1.564417	106	177	4	1	71	0.0140845
NODE_256742_length_262_cov_1.564417	106	177	6	9	71	0.1267606
NODE_256742_length_262_cov_1.564417	106	177	8	50	71	0.7042254
NODE_256933_length_262_cov_1.349693	52	102	0	50	50	1.0000000
NODE_256933_length_262_cov_1.349693	83	149	0	66	66	1.0000000
NODE_257199_length_262_cov_1.251534	44	124	0	10	80	0.1250000
NODE_257199_length_262_cov_1.251534	44	124	2	7	80	0.0875000
NODE_257199_length_262_cov_1.251534	44	124	3	18	80	0.2250000
NODE_257199_length_262_cov_1.251534	44	124	4	9	80	0.1125000
NODE_257199_length_262_cov_1.251534	44	124	6	28	80	0.3500000
NODE_257199_length_262_cov_1.251534	44	124	8	8	80	0.1000000
NODE_257199_length_262_cov_1.251534	97	171	4	2	74	0.0270270
NODE_257199_length_262_cov_1.251534	97	171	6	25	74	0.3378378
NODE_257199_length_262_cov_1.251534	97	171	8	47	74	0.6351351
NODE_258876_length_261_cov_31.913580	32	112	14	30	80	0.3750000
NODE_258876_length_261_cov_31.913580	32	112	16	50	80	0.6250000
NODE_258876_length_261_cov_31.913580	85	171	2	23	86	0.2674419
NODE_258876_length_261_cov_31.913580	85	171	14	40	86	0.4651163
NODE_258876_length_261_cov_31.913580	85	171	15	1	86	0.0116279
NODE_258876_length_261_cov_31.913580	85	171	16	22	86	0.2558140
NODE_258901_length_261_cov_6.376543	126	201	0	75	75	1.0000000
NODE_258901_length_261_cov_6.376543	179	254	0	75	75	1.0000000
NODE_258929_length_261_cov_5.469136	56	132	0	76	76	1.0000000
NODE_259329_length_261_cov_2.425926	53	134	0	37	81	0.4567901
NODE_259329_length_261_cov_2.425926	53	134	2	44	81	0.5432099
NODE_259361_length_261_cov_2.333333	41	136	2	52	95	0.5473684
NODE_259361_length_261_cov_2.333333	41	136	4	43	95	0.4526316
NODE_259435_length_261_cov_2.191358	86	122	2	25	36	0.6944444
NODE_259435_length_261_cov_2.191358	86	122	4	11	36	0.3055556
NODE_259495_length_261_cov_1.993827	134	214	10	11	80	0.1375000
NODE_259495_length_261_cov_1.993827	134	214	11	1	80	0.0125000
NODE_259495_length_261_cov_1.993827	134	214	12	2	80	0.0250000
NODE_259495_length_261_cov_1.993827	134	214	17	12	80	0.1500000
NODE_259495_length_261_cov_1.993827	134	214	18	54	80	0.6750000
NODE_259672_length_261_cov_1.882716	51	105	19	2	54	0.0370370
NODE_259672_length_261_cov_1.882716	51	105	21	19	54	0.3518519
NODE_259672_length_261_cov_1.882716	51	105	23	1	54	0.0185185
NODE_259672_length_261_cov_1.882716	51	105	25	2	54	0.0370370
NODE_259672_length_261_cov_1.882716	51	105	27	2	54	0.0370370
NODE_259672_length_261_cov_1.882716	51	105	29	12	54	0.2222222
NODE_259672_length_261_cov_1.882716	51	105	31	16	54	0.2962963
NODE_259740_length_261_cov_1.839506	118	197	0	62	79	0.7848101
NODE_259740_length_261_cov_1.839506	118	197	2	3	79	0.0379747
NODE_259740_length_261_cov_1.839506	118	197	4	2	79	0.0253165
NODE_259740_length_261_cov_1.839506	118	197	8	12	79	0.1518987
NODE_259769_length_261_cov_1.783951	69	141	2	28	72	0.3888889
NODE_259769_length_261_cov_1.783951	69	141	4	44	72	0.6111111
NODE_260089_length_261_cov_1.388889	202	247	0	45	45	1.0000000
NODE_260090_length_261_cov_1.382716	14	61	2	47	47	1.0000000
NODE_260428_length_261_cov_1.253086	100	138	8	38	38	1.0000000
NODE_260738_length_261_cov_1.030864	122	205	0	29	83	0.3493976
NODE_260738_length_261_cov_1.030864	122	205	2	54	83	0.6506024
NODE_260738_length_261_cov_1.030864	129	210	0	22	81	0.2716049
NODE_260738_length_261_cov_1.030864	129	210	2	59	81	0.7283950
NODE_260738_length_261_cov_1.030864	129	184	0	22	55	0.4000000
NODE_260738_length_261_cov_1.030864	129	184	2	33	55	0.6000000
NODE_260738_length_261_cov_1.030864	187	248	2	61	61	1.0000000
NODE_260767_length_261_cov_1.006173	3	45	0	42	42	1.0000000
NODE_260767_length_261_cov_1.006173	46	98	0	52	52	1.0000000
NODE_262062_length_261_cov_0.580247	11	31	0	20	20	1.0000000
NODE_262121_length_260_cov_8.844720	74	138	2	64	64	1.0000000
NODE_262123_length_260_cov_8.447205	30	110	0	16	80	0.2000000
NODE_262123_length_260_cov_8.447205	30	110	1	1	80	0.0125000
NODE_262123_length_260_cov_8.447205	30	110	2	63	80	0.7875000
NODE_262123_length_260_cov_8.447205	83	167	0	40	84	0.4761905
NODE_262123_length_260_cov_8.447205	83	167	2	44	84	0.5238096
NODE_262123_length_260_cov_8.447205	163	243	0	80	80	1.0000000
NODE_262149_length_260_cov_5.807453	38	118	0	6	80	0.0750000
NODE_262149_length_260_cov_5.807453	38	118	2	74	80	0.9250000
NODE_262149_length_260_cov_5.807453	91	171	0	59	80	0.7375000
NODE_262149_length_260_cov_5.807453	91	171	2	21	80	0.2625000
NODE_262264_length_260_cov_3.645963	5	57	0	52	52	1.0000000
NODE_262329_length_260_cov_3.167702	91	163	2	40	72	0.5555556
NODE_262329_length_260_cov_3.167702	91	163	4	32	72	0.4444444
NODE_262378_length_260_cov_2.981366	58	127	0	64	69	0.9275362
NODE_262378_length_260_cov_2.981366	58	127	2	5	69	0.0724638
NODE_262384_length_260_cov_2.913043	10	90	0	7	80	0.0875000
NODE_262384_length_260_cov_2.913043	10	90	2	73	80	0.9125000
NODE_262708_length_260_cov_2.161491	174	251	0	77	77	1.0000000
NODE_262733_length_260_cov_2.080745	188	258	0	70	70	1.0000000
NODE_262788_length_260_cov_1.950311	27	85	2	49	58	0.8448276
NODE_262788_length_260_cov_1.950311	27	85	4	9	58	0.1551724
NODE_262930_length_260_cov_1.900621	14	50	0	36	36	1.0000000
NODE_263117_length_260_cov_1.683230	50	130	0	80	80	1.0000000
NODE_263428_length_260_cov_1.347826	38	118	4	80	80	1.0000000
NODE_263533_length_260_cov_1.267081	114	199	0	85	85	1.0000000
NODE_263556_length_260_cov_1.267081	198	244	0	46	46	1.0000000
NODE_263568_length_260_cov_1.267081	145	189	5	1	44	0.0227273
NODE_263568_length_260_cov_1.267081	145	189	7	3	44	0.0681818
NODE_263568_length_260_cov_1.267081	145	189	8	39	44	0.8863636
NODE_263568_length_260_cov_1.267081	145	189	9	1	44	0.0227273
NODE_265483_length_259_cov_4.800000	35	95	0	19	60	0.3166667
NODE_265483_length_259_cov_4.800000	35	95	2	41	60	0.6833333
NODE_265584_length_259_cov_3.675000	119	161	0	42	42	1.0000000
NODE_265584_length_259_cov_3.675000	134	214	0	80	80	1.0000000
NODE_265592_length_259_cov_3.593750	100	143	0	43	43	1.0000000
NODE_265611_length_259_cov_3.475000	198	259	0	61	61	1.0000000
NODE_265625_length_259_cov_3.331250	72	118	0	1	46	0.0217391
NODE_265625_length_259_cov_3.331250	72	118	2	4	46	0.0869565
NODE_265625_length_259_cov_3.331250	72	118	4	20	46	0.4347826
NODE_265625_length_259_cov_3.331250	72	118	6	21	46	0.4565217
NODE_265636_length_259_cov_3.237500	103	160	0	57	57	1.0000000
NODE_265704_length_259_cov_2.937500	209	233	0	1	24	0.0416667
NODE_265704_length_259_cov_2.937500	209	233	2	23	24	0.9583333
NODE_265735_length_259_cov_2.850000	0	41	0	41	41	1.0000000
NODE_265735_length_259_cov_2.850000	14	94	0	80	80	1.0000000
NODE_265818_length_259_cov_2.550000	9	82	2	5	73	0.0684932
NODE_265818_length_259_cov_2.550000	9	82	4	68	73	0.9315069
NODE_265942_length_259_cov_2.287500	147	225	6	28	78	0.3589744
NODE_265942_length_259_cov_2.287500	147	225	8	50	78	0.6410257
NODE_265942_length_259_cov_2.287500	198	241	6	42	43	0.9767442
NODE_265942_length_259_cov_2.287500	198	241	8	1	43	0.0232558
NODE_266032_length_259_cov_2.156250	0	72	0	72	72	1.0000000
NODE_266080_length_259_cov_2.012500	8	73	0	65	65	1.0000000
NODE_266080_length_259_cov_2.012500	53	126	0	73	73	1.0000000
NODE_266101_length_259_cov_1.962500	108	189	8	3	81	0.0370370
NODE_266101_length_259_cov_1.962500	108	189	10	1	81	0.0123457
NODE_266101_length_259_cov_1.962500	108	189	11	1	81	0.0123457
NODE_266101_length_259_cov_1.962500	108	189	12	76	81	0.9382716
NODE_266117_length_259_cov_1.918750	49	120	0	44	71	0.6197183
NODE_266117_length_259_cov_1.918750	49	120	2	27	71	0.3802817
NODE_266183_length_259_cov_1.912500	114	177	0	58	63	0.9206349
NODE_266183_length_259_cov_1.912500	114	177	4	4	63	0.0634921
NODE_266183_length_259_cov_1.912500	114	177	8	1	63	0.0158730
NODE_266365_length_259_cov_1.837500	180	252	2	16	72	0.2222222
NODE_266365_length_259_cov_1.837500	180	252	4	41	72	0.5694444
NODE_266365_length_259_cov_1.837500	180	252	5	15	72	0.2083333
NODE_266609_length_259_cov_1.593750	27	67	0	1	40	0.0250000
NODE_266609_length_259_cov_1.593750	27	67	2	39	40	0.9750000
NODE_266746_length_259_cov_1.400000	117	164	0	47	47	1.0000000
NODE_266746_length_259_cov_1.400000	137	217	0	80	80	1.0000000
NODE_268816_length_258_cov_6.415094	129	209	0	80	80	1.0000000
NODE_268816_length_258_cov_6.415094	182	258	0	76	76	1.0000000
NODE_268823_length_258_cov_6.157233	1	81	0	80	80	1.0000000
NODE_268823_length_258_cov_6.157233	9	64	0	55	55	1.0000000
NODE_268852_length_258_cov_4.798742	83	163	2	28	80	0.3500000
NODE_268852_length_258_cov_4.798742	83	163	6	48	80	0.6000000
NODE_268852_length_258_cov_4.798742	83	163	8	4	80	0.0500000
NODE_268870_length_258_cov_4.396226	0	44	0	44	44	1.0000000
NODE_268870_length_258_cov_4.396226	24	97	0	73	73	1.0000000
NODE_268880_length_258_cov_4.301887	0	54	0	54	54	1.0000000
NODE_268942_length_258_cov_3.616352	29	58	0	29	29	1.0000000
NODE_268982_length_258_cov_3.352201	47	127	4	2	80	0.0250000
NODE_268982_length_258_cov_3.352201	47	127	6	2	80	0.0250000
NODE_268982_length_258_cov_3.352201	47	127	8	6	80	0.0750000
NODE_268982_length_258_cov_3.352201	47	127	10	25	80	0.3125000
NODE_268982_length_258_cov_3.352201	47	127	12	37	80	0.4625000
NODE_268982_length_258_cov_3.352201	47	127	14	8	80	0.1000000
NODE_269086_length_258_cov_2.886792	102	121	2	19	19	1.0000000
NODE_269091_length_258_cov_2.880503	92	172	0	80	80	1.0000000
NODE_269102_length_258_cov_2.855346	96	138	34	17	42	0.4047619
NODE_269102_length_258_cov_2.855346	96	138	36	21	42	0.5000000
NODE_269102_length_258_cov_2.855346	96	138	38	3	42	0.0714286
NODE_269102_length_258_cov_2.855346	96	138	40	1	42	0.0238095
NODE_269102_length_258_cov_2.855346	148	191	4	1	43	0.0232558
NODE_269102_length_258_cov_2.855346	148	191	5	4	43	0.0930233
NODE_269102_length_258_cov_2.855346	148	191	9	1	43	0.0232558
NODE_269102_length_258_cov_2.855346	148	191	10	6	43	0.1395349
NODE_269102_length_258_cov_2.855346	148	191	11	7	43	0.1627907
NODE_269102_length_258_cov_2.855346	148	191	15	6	43	0.1395349
NODE_269102_length_258_cov_2.855346	148	191	16	1	43	0.0232558
NODE_269102_length_258_cov_2.855346	148	191	20	1	43	0.0232558
NODE_269102_length_258_cov_2.855346	148	191	21	16	43	0.3720930
NODE_269113_length_258_cov_2.817610	10	58	0	48	48	1.0000000
NODE_269264_length_258_cov_2.383648	48	128	0	6	80	0.0750000
NODE_269264_length_258_cov_2.383648	48	128	2	31	80	0.3875000
NODE_269264_length_258_cov_2.383648	48	128	4	10	80	0.1250000
NODE_269264_length_258_cov_2.383648	48	128	6	33	80	0.4125000
NODE_269264_length_258_cov_2.383648	101	182	4	2	81	0.0246914
NODE_269264_length_258_cov_2.383648	101	182	6	79	81	0.9753087
NODE_269338_length_258_cov_2.238994	61	141	0	80	80	1.0000000
NODE_269615_length_258_cov_1.918239	0	51	0	51	51	1.0000000
NODE_269682_length_258_cov_1.855346	26	47	0	11	21	0.5238096
NODE_269682_length_258_cov_1.855346	26	47	2	10	21	0.4761905
NODE_269682_length_258_cov_1.855346	71	104	5	3	33	0.0909091
NODE_269682_length_258_cov_1.855346	71	104	6	30	33	0.9090909
NODE_269682_length_258_cov_1.855346	81	156	6	55	75	0.7333333
NODE_269682_length_258_cov_1.855346	81	156	8	20	75	0.2666667
NODE_269749_length_258_cov_1.735849	105	176	3	2	71	0.0281690
NODE_269749_length_258_cov_1.735849	105	176	4	4	71	0.0563380
NODE_269749_length_258_cov_1.735849	105	176	6	26	71	0.3661972
NODE_269749_length_258_cov_1.735849	105	176	8	25	71	0.3521127
NODE_269749_length_258_cov_1.735849	105	176	10	14	71	0.1971831
NODE_269767_length_258_cov_1.710692	8	49	0	1	41	0.0243902
NODE_269767_length_258_cov_1.710692	8	49	2	4	41	0.0975610
NODE_269767_length_258_cov_1.710692	8	49	4	13	41	0.3170732
NODE_269767_length_258_cov_1.710692	8	49	11	1	41	0.0243902
NODE_269767_length_258_cov_1.710692	8	49	12	22	41	0.5365854
NODE_270191_length_258_cov_1.283019	127	191	0	16	64	0.2500000
NODE_270191_length_258_cov_1.283019	127	191	2	38	64	0.5937500
NODE_270191_length_258_cov_1.283019	127	191	6	10	64	0.1562500
NODE_270191_length_258_cov_1.283019	164	227	0	52	63	0.8253968
NODE_270191_length_258_cov_1.283019	164	227	2	11	63	0.1746032
NODE_270465_length_258_cov_1.270440	4	55	0	42	51	0.8235294
NODE_270465_length_258_cov_1.270440	4	55	2	9	51	0.1764706
NODE_270504_length_258_cov_1.232704	90	166	6	1	76	0.0131579
NODE_270504_length_258_cov_1.232704	90	166	8	4	76	0.0526316
NODE_270504_length_258_cov_1.232704	90	166	10	13	76	0.1710526
NODE_270504_length_258_cov_1.232704	90	166	12	14	76	0.1842105
NODE_270504_length_258_cov_1.232704	90	166	14	30	76	0.3947369
NODE_270504_length_258_cov_1.232704	90	166	16	14	76	0.1842105
NODE_270547_length_258_cov_1.201258	49	98	0	49	49	1.0000000
NODE_270876_length_258_cov_0.962264	186	258	0	72	72	1.0000000
NODE_270970_length_258_cov_0.962264	69	124	0	6	55	0.1090909
NODE_270970_length_258_cov_0.962264	69	124	2	24	55	0.4363636
NODE_270970_length_258_cov_0.962264	69	124	4	25	55	0.4545455
NODE_272169_length_257_cov_71.158228	81	165	131	2	84	0.0238095
NODE_272169_length_257_cov_71.158228	81	165	137	8	84	0.0952381
NODE_272169_length_257_cov_71.158228	81	165	139	2	84	0.0238095
NODE_272169_length_257_cov_71.158228	81	165	141	2	84	0.0238095
NODE_272169_length_257_cov_71.158228	81	165	143	1	84	0.0119048
NODE_272169_length_257_cov_71.158228	81	165	146	1	84	0.0119048
NODE_272169_length_257_cov_71.158228	81	165	147	1	84	0.0119048
NODE_272169_length_257_cov_71.158228	81	165	152	1	84	0.0119048
NODE_272169_length_257_cov_71.158228	81	165	153	2	84	0.0238095
NODE_272169_length_257_cov_71.158228	81	165	155	1	84	0.0119048
NODE_272169_length_257_cov_71.158228	81	165	159	1	84	0.0119048
NODE_272169_length_257_cov_71.158228	81	165	163	2	84	0.0238095
NODE_272169_length_257_cov_71.158228	81	165	168	4	84	0.0476190
NODE_272169_length_257_cov_71.158228	81	165	169	1	84	0.0119048
NODE_272169_length_257_cov_71.158228	81	165	170	4	84	0.0476190
NODE_272169_length_257_cov_71.158228	81	165	172	6	84	0.0714286
NODE_272169_length_257_cov_71.158228	81	165	173	1	84	0.0119048
NODE_272169_length_257_cov_71.158228	81	165	175	2	84	0.0238095
NODE_272169_length_257_cov_71.158228	81	165	176	4	84	0.0476190
NODE_272169_length_257_cov_71.158228	81	165	180	4	84	0.0476190
NODE_272169_length_257_cov_71.158228	81	165	181	2	84	0.0238095
NODE_272169_length_257_cov_71.158228	81	165	183	1	84	0.0119048
NODE_272169_length_257_cov_71.158228	81	165	184	2	84	0.0238095
NODE_272169_length_257_cov_71.158228	81	165	185	4	84	0.0476190
NODE_272169_length_257_cov_71.158228	81	165	186	2	84	0.0238095
NODE_272169_length_257_cov_71.158228	81	165	187	3	84	0.0357143
NODE_272169_length_257_cov_71.158228	81	165	188	1	84	0.0119048
NODE_272169_length_257_cov_71.158228	81	165	189	1	84	0.0119048
NODE_272169_length_257_cov_71.158228	81	165	190	1	84	0.0119048
NODE_272169_length_257_cov_71.158228	81	165	193	2	84	0.0238095
NODE_272169_length_257_cov_71.158228	81	165	194	1	84	0.0119048
NODE_272169_length_257_cov_71.158228	81	165	195	2	84	0.0238095
NODE_272169_length_257_cov_71.158228	81	165	197	7	84	0.0833333
NODE_272169_length_257_cov_71.158228	81	165	199	5	84	0.0595238
NODE_272169_length_257_cov_71.158228	145	218	59	1	73	0.0136986
NODE_272169_length_257_cov_71.158228	145	218	61	2	73	0.0273973
NODE_272169_length_257_cov_71.158228	145	218	63	3	73	0.0410959
NODE_272169_length_257_cov_71.158228	145	218	64	2	73	0.0273973
NODE_272169_length_257_cov_71.158228	145	218	66	6	73	0.0821918
NODE_272169_length_257_cov_71.158228	145	218	68	2	73	0.0273973
NODE_272169_length_257_cov_71.158228	145	218	70	2	73	0.0273973
NODE_272169_length_257_cov_71.158228	145	218	72	1	73	0.0136986
NODE_272169_length_257_cov_71.158228	145	218	76	1	73	0.0136986
NODE_272169_length_257_cov_71.158228	145	218	79	3	73	0.0410959
NODE_272169_length_257_cov_71.158228	145	218	81	2	73	0.0273973
NODE_272169_length_257_cov_71.158228	145	218	83	4	73	0.0547945
NODE_272169_length_257_cov_71.158228	145	218	85	1	73	0.0136986
NODE_272169_length_257_cov_71.158228	145	218	95	3	73	0.0410959
NODE_272169_length_257_cov_71.158228	145	218	96	1	73	0.0136986
NODE_272169_length_257_cov_71.158228	145	218	98	4	73	0.0547945
NODE_272169_length_257_cov_71.158228	145	218	99	1	73	0.0136986
NODE_272169_length_257_cov_71.158228	145	218	103	1	73	0.0136986
NODE_272169_length_257_cov_71.158228	145	218	106	1	73	0.0136986
NODE_272169_length_257_cov_71.158228	145	218	111	1	73	0.0136986
NODE_272169_length_257_cov_71.158228	145	218	113	2	73	0.0273973
NODE_272169_length_257_cov_71.158228	145	218	114	1	73	0.0136986
NODE_272169_length_257_cov_71.158228	145	218	116	2	73	0.0273973
NODE_272169_length_257_cov_71.158228	145	218	118	1	73	0.0136986
NODE_272169_length_257_cov_71.158228	145	218	123	1	73	0.0136986
NODE_272169_length_257_cov_71.158228	145	218	127	1	73	0.0136986
NODE_272169_length_257_cov_71.158228	145	218	130	2	73	0.0273973
NODE_272169_length_257_cov_71.158228	145	218	131	3	73	0.0410959
NODE_272169_length_257_cov_71.158228	145	218	137	6	73	0.0821918
NODE_272169_length_257_cov_71.158228	145	218	141	1	73	0.0136986
NODE_272169_length_257_cov_71.158228	145	218	143	1	73	0.0136986
NODE_272169_length_257_cov_71.158228	145	218	147	1	73	0.0136986
NODE_272169_length_257_cov_71.158228	145	218	153	2	73	0.0273973
NODE_272169_length_257_cov_71.158228	145	218	155	1	73	0.0136986
NODE_272169_length_257_cov_71.158228	145	218	163	2	73	0.0273973
NODE_272169_length_257_cov_71.158228	145	218	168	2	73	0.0273973
NODE_272169_length_257_cov_71.158228	145	218	170	2	73	0.0273973
NODE_272194_length_257_cov_6.329114	15	93	2	78	78	1.0000000
NODE_272275_length_257_cov_4.177215	25	86	0	61	61	1.0000000
NODE_272291_length_257_cov_3.987342	55	107	0	52	52	1.0000000
NODE_272304_length_257_cov_3.873418	145	225	0	80	80	1.0000000
NODE_272304_length_257_cov_3.873418	198	254	0	56	56	1.0000000
NODE_272322_length_257_cov_3.740506	133	199	4	7	66	0.1060606
NODE_272322_length_257_cov_3.740506	133	199	5	2	66	0.0303030
NODE_272322_length_257_cov_3.740506	133	199	7	6	66	0.0909091
NODE_272322_length_257_cov_3.740506	133	199	9	1	66	0.0151515
NODE_272322_length_257_cov_3.740506	133	199	10	8	66	0.1212121
NODE_272322_length_257_cov_3.740506	133	199	12	4	66	0.0606061
NODE_272322_length_257_cov_3.740506	133	199	16	8	66	0.1212121
NODE_272322_length_257_cov_3.740506	133	199	18	1	66	0.0151515
NODE_272322_length_257_cov_3.740506	133	199	22	8	66	0.1212121
NODE_272322_length_257_cov_3.740506	133	199	24	2	66	0.0303030
NODE_272322_length_257_cov_3.740506	133	199	26	2	66	0.0303030
NODE_272322_length_257_cov_3.740506	133	199	28	12	66	0.1818182
NODE_272322_length_257_cov_3.740506	133	199	30	5	66	0.0757576
NODE_272322_length_257_cov_3.740506	177	256	0	49	79	0.6202531
NODE_272322_length_257_cov_3.740506	177	256	1	5	79	0.0632911
NODE_272322_length_257_cov_3.740506	177	256	2	3	79	0.0379747
NODE_272322_length_257_cov_3.740506	177	256	4	7	79	0.0886076
NODE_272322_length_257_cov_3.740506	177	256	5	2	79	0.0253165
NODE_272322_length_257_cov_3.740506	177	256	7	6	79	0.0759494
NODE_272322_length_257_cov_3.740506	177	256	9	1	79	0.0126582
NODE_272322_length_257_cov_3.740506	177	256	10	6	79	0.0759494
NODE_272486_length_257_cov_2.734177	1	65	0	64	64	1.0000000
NODE_272491_length_257_cov_2.677215	170	250	0	41	80	0.5125000
NODE_272491_length_257_cov_2.677215	170	250	5	7	80	0.0875000
NODE_272491_length_257_cov_2.677215	170	250	7	12	80	0.1500000
NODE_272491_length_257_cov_2.677215	170	250	8	1	80	0.0125000
NODE_272491_length_257_cov_2.677215	170	250	9	7	80	0.0875000
NODE_272491_length_257_cov_2.677215	170	250	10	1	80	0.0125000
NODE_272491_length_257_cov_2.677215	170	250	13	1	80	0.0125000
NODE_272491_length_257_cov_2.677215	170	250	15	2	80	0.0250000
NODE_272491_length_257_cov_2.677215	170	250	16	1	80	0.0125000
NODE_272491_length_257_cov_2.677215	170	250	20	3	80	0.0375000
NODE_272491_length_257_cov_2.677215	170	250	22	4	80	0.0500000
NODE_272580_length_257_cov_2.537975	60	137	0	10	77	0.1298701
NODE_272580_length_257_cov_2.537975	60	137	4	2	77	0.0259740
NODE_272580_length_257_cov_2.537975	60	137	5	1	77	0.0129870
NODE_272580_length_257_cov_2.537975	60	137	6	64	77	0.8311688
NODE_272596_length_257_cov_2.487342	95	172	2	38	77	0.4935065
NODE_272596_length_257_cov_2.487342	95	172	4	39	77	0.5064935
NODE_272625_length_257_cov_2.379747	106	186	7	2	80	0.0250000
NODE_272625_length_257_cov_2.379747	106	186	8	36	80	0.4500000
NODE_272625_length_257_cov_2.379747	106	186	10	6	80	0.0750000
NODE_272625_length_257_cov_2.379747	106	186	12	11	80	0.1375000
NODE_272625_length_257_cov_2.379747	106	186	14	25	80	0.3125000
NODE_272625_length_257_cov_2.379747	159	207	4	19	48	0.3958333
NODE_272625_length_257_cov_2.379747	159	207	7	4	48	0.0833333
NODE_272625_length_257_cov_2.379747	159	207	8	17	48	0.3541667
NODE_272625_length_257_cov_2.379747	159	207	10	6	48	0.1250000
NODE_272625_length_257_cov_2.379747	159	207	12	2	48	0.0416667
NODE_272724_length_257_cov_2.221519	163	240	2	22	77	0.2857143
NODE_272724_length_257_cov_2.221519	163	240	4	39	77	0.5064935
NODE_272724_length_257_cov_2.221519	163	240	6	16	77	0.2077922
NODE_272729_length_257_cov_2.202532	16	97	2	15	81	0.1851852
NODE_272729_length_257_cov_2.202532	16	97	4	45	81	0.5555556
NODE_272729_length_257_cov_2.202532	16	97	8	21	81	0.2592593
NODE_273151_length_257_cov_1.664557	220	239	0	19	19	1.0000000
NODE_273357_length_257_cov_1.500000	85	166	0	62	81	0.7654321
NODE_273357_length_257_cov_1.500000	85	166	2	19	81	0.2345679
NODE_273462_length_257_cov_1.329114	120	186	10	11	66	0.1666667
NODE_273462_length_257_cov_1.329114	120	186	11	17	66	0.2575758
NODE_273462_length_257_cov_1.329114	120	186	12	38	66	0.5757576
NODE_273533_length_257_cov_1.291139	13	53	2	40	40	1.0000000
NODE_273697_length_257_cov_1.291139	205	257	2	52	52	1.0000000
NODE_273894_length_257_cov_1.221519	10	74	0	64	64	1.0000000
NODE_273917_length_257_cov_1.196203	70	150	0	80	80	1.0000000
NODE_273917_length_257_cov_1.196203	123	204	0	81	81	1.0000000
NODE_275399_length_257_cov_0.645570	138	158	0	20	20	1.0000000
NODE_275419_length_257_cov_0.645570	181	241	2	60	60	1.0000000
NODE_275598_length_256_cov_5.235669	30	77	0	47	47	1.0000000
NODE_275624_length_256_cov_4.598726	100	180	0	80	80	1.0000000
NODE_275624_length_256_cov_4.598726	160	211	0	51	51	1.0000000
NODE_275682_length_256_cov_3.866242	112	166	0	33	54	0.6111111
NODE_275682_length_256_cov_3.866242	112	166	4	21	54	0.3888889
NODE_275840_length_256_cov_2.878981	79	159	0	80	80	1.0000000
NODE_275840_length_256_cov_2.878981	132	212	0	80	80	1.0000000
NODE_275909_length_256_cov_2.598726	157	222	0	65	65	1.0000000
NODE_275909_length_256_cov_2.598726	195	249	0	54	54	1.0000000
NODE_275981_length_256_cov_2.445860	104	183	0	79	79	1.0000000
NODE_276082_length_256_cov_2.229299	0	58	0	25	58	0.4310345
NODE_276082_length_256_cov_2.229299	0	58	2	13	58	0.2241379
NODE_276082_length_256_cov_2.229299	0	58	6	1	58	0.0172414
NODE_276082_length_256_cov_2.229299	0	58	10	13	58	0.2241379
NODE_276082_length_256_cov_2.229299	0	58	12	6	58	0.1034483
NODE_276082_length_256_cov_2.229299	17	68	0	8	51	0.1568628
NODE_276082_length_256_cov_2.229299	17	68	2	13	51	0.2549020
NODE_276082_length_256_cov_2.229299	17	68	6	1	51	0.0196078
NODE_276082_length_256_cov_2.229299	17	68	10	13	51	0.2549020
NODE_276082_length_256_cov_2.229299	17	68	12	16	51	0.3137255
NODE_276082_length_256_cov_2.229299	41	88	10	11	47	0.2340426
NODE_276082_length_256_cov_2.229299	41	88	12	36	47	0.7659575
NODE_276082_length_256_cov_2.229299	42	122	6	4	80	0.0500000
NODE_276082_length_256_cov_2.229299	42	122	8	11	80	0.1375000
NODE_276082_length_256_cov_2.229299	42	122	10	10	80	0.1250000
NODE_276082_length_256_cov_2.229299	42	122	12	55	80	0.6875000
NODE_276098_length_256_cov_2.184713	192	246	0	54	54	1.0000000
NODE_276119_length_256_cov_2.121019	150	236	0	12	86	0.1395349
NODE_276119_length_256_cov_2.121019	150	236	2	37	86	0.4302326
NODE_276119_length_256_cov_2.121019	150	236	4	28	86	0.3255814
NODE_276119_length_256_cov_2.121019	150	236	8	9	86	0.1046512
NODE_276174_length_256_cov_1.974522	130	174	0	44	44	1.0000000
NODE_276471_length_256_cov_1.707006	39	92	0	1	53	0.0188679
NODE_276471_length_256_cov_1.707006	39	92	1	16	53	0.3018868
NODE_276471_length_256_cov_1.707006	39	92	2	1	53	0.0188679
NODE_276471_length_256_cov_1.707006	39	92	4	5	53	0.0943396
NODE_276471_length_256_cov_1.707006	39	92	5	1	53	0.0188679
NODE_276471_length_256_cov_1.707006	39	92	10	5	53	0.0943396
NODE_276471_length_256_cov_1.707006	39	92	11	1	53	0.0188679
NODE_276471_length_256_cov_1.707006	39	92	13	9	53	0.1698113
NODE_276471_length_256_cov_1.707006	39	92	14	1	53	0.0188679
NODE_276471_length_256_cov_1.707006	39	92	15	3	53	0.0566038
NODE_276471_length_256_cov_1.707006	39	92	16	3	53	0.0566038
NODE_276471_length_256_cov_1.707006	39	92	17	2	53	0.0377358
NODE_276471_length_256_cov_1.707006	39	92	20	3	53	0.0566038
NODE_276471_length_256_cov_1.707006	39	92	21	1	53	0.0188679
NODE_276471_length_256_cov_1.707006	39	92	22	1	53	0.0188679
NODE_276471_length_256_cov_1.707006	93	135	22	2	42	0.0476190
NODE_276471_length_256_cov_1.707006	93	135	23	1	42	0.0238095
NODE_276471_length_256_cov_1.707006	93	135	25	3	42	0.0714286
NODE_276471_length_256_cov_1.707006	93	135	26	1	42	0.0238095
NODE_276471_length_256_cov_1.707006	93	135	27	5	42	0.1190476
NODE_276471_length_256_cov_1.707006	93	135	29	5	42	0.1190476
NODE_276471_length_256_cov_1.707006	93	135	31	23	42	0.5476190
NODE_276471_length_256_cov_1.707006	93	135	33	2	42	0.0476190
NODE_276484_length_256_cov_1.700637	107	129	0	22	22	1.0000000
NODE_276495_length_256_cov_1.675159	52	98	0	46	46	1.0000000
NODE_276654_length_256_cov_1.598726	125	202	0	18	77	0.2337662
NODE_276654_length_256_cov_1.598726	125	202	2	59	77	0.7662337
NODE_276654_length_256_cov_1.598726	178	256	0	27	78	0.3461539
NODE_276654_length_256_cov_1.598726	178	256	2	51	78	0.6538461
NODE_276672_length_256_cov_1.579618	110	172	10	2	62	0.0322581
NODE_276672_length_256_cov_1.579618	110	172	12	30	62	0.4838710
NODE_276672_length_256_cov_1.579618	110	172	14	14	62	0.2258064
NODE_276672_length_256_cov_1.579618	110	172	16	16	62	0.2580645
NODE_276672_length_256_cov_1.579618	194	239	0	25	45	0.5555556
NODE_276672_length_256_cov_1.579618	194	239	2	20	45	0.4444444
NODE_276742_length_256_cov_1.464968	112	135	2	23	23	1.0000000
NODE_276826_length_256_cov_1.331210	138	209	0	6	71	0.0845070
NODE_276826_length_256_cov_1.331210	138	209	2	65	71	0.9154930
NODE_276826_length_256_cov_1.331210	182	240	0	21	58	0.3620690
NODE_276826_length_256_cov_1.331210	182	240	2	37	58	0.6379310
NODE_277113_length_256_cov_1.299363	88	160	3	9	72	0.1250000
NODE_277113_length_256_cov_1.299363	88	160	6	17	72	0.2361111
NODE_277113_length_256_cov_1.299363	88	160	9	46	72	0.6388889
NODE_277305_length_256_cov_1.203822	3	43	4	5	40	0.1250000
NODE_277305_length_256_cov_1.203822	3	43	8	10	40	0.2500000
NODE_277305_length_256_cov_1.203822	3	43	10	3	40	0.0750000
NODE_277305_length_256_cov_1.203822	3	43	12	2	40	0.0500000
NODE_277305_length_256_cov_1.203822	3	43	16	5	40	0.1250000
NODE_277305_length_256_cov_1.203822	3	43	18	2	40	0.0500000
NODE_277305_length_256_cov_1.203822	3	43	20	1	40	0.0250000
NODE_277305_length_256_cov_1.203822	3	43	22	5	40	0.1250000
NODE_277305_length_256_cov_1.203822	3	43	24	7	40	0.1750000
NODE_277305_length_256_cov_1.203822	16	96	8	2	80	0.0250000
NODE_277305_length_256_cov_1.203822	16	96	10	3	80	0.0375000
NODE_277305_length_256_cov_1.203822	16	96	12	2	80	0.0250000
NODE_277305_length_256_cov_1.203822	16	96	16	5	80	0.0625000
NODE_277305_length_256_cov_1.203822	16	96	18	4	80	0.0500000
NODE_277305_length_256_cov_1.203822	16	96	20	7	80	0.0875000
NODE_277305_length_256_cov_1.203822	16	96	22	8	80	0.1000000
NODE_277305_length_256_cov_1.203822	16	96	24	49	80	0.6125000
NODE_278934_length_255_cov_73.756410	52	99	2	47	47	1.0000000
NODE_278934_length_255_cov_73.756410	133	184	0	51	51	1.0000000
NODE_278934_length_255_cov_73.756410	157	237	0	80	80	1.0000000
NODE_278937_length_255_cov_15.538462	219	255	0	36	36	1.0000000
NODE_279003_length_255_cov_4.884615	157	230	0	73	73	1.0000000
NODE_279003_length_255_cov_4.884615	203	248	0	45	45	1.0000000
NODE_279058_length_255_cov_4.012821	68	148	2	52	80	0.6500000
NODE_279058_length_255_cov_4.012821	68	148	4	7	80	0.0875000
NODE_279058_length_255_cov_4.012821	68	148	6	21	80	0.2625000
NODE_279075_length_255_cov_3.826923	16	80	8	10	64	0.1562500
NODE_279075_length_255_cov_3.826923	16	80	10	6	64	0.0937500
NODE_279075_length_255_cov_3.826923	16	80	12	18	64	0.2812500
NODE_279075_length_255_cov_3.826923	16	80	14	11	64	0.1718750
NODE_279075_length_255_cov_3.826923	16	80	16	2	64	0.0312500
NODE_279075_length_255_cov_3.826923	16	80	18	17	64	0.2656250
NODE_279102_length_255_cov_3.596154	30	60	0	20	30	0.6666667
NODE_279102_length_255_cov_3.596154	30	60	2	9	30	0.3000000
NODE_279102_length_255_cov_3.596154	30	60	4	1	30	0.0333333
NODE_279134_length_255_cov_3.423077	64	109	4	22	45	0.4888889
NODE_279134_length_255_cov_3.423077	64	109	6	23	45	0.5111111
NODE_279166_length_255_cov_3.262821	0	48	2	5	48	0.1041667
NODE_279166_length_255_cov_3.262821	0	48	4	5	48	0.1041667
NODE_279166_length_255_cov_3.262821	0	48	8	2	48	0.0416667
NODE_279166_length_255_cov_3.262821	0	48	10	36	48	0.7500000
NODE_279166_length_255_cov_3.262821	66	113	2	10	47	0.2127660
NODE_279166_length_255_cov_3.262821	66	113	8	4	47	0.0851064
NODE_279166_length_255_cov_3.262821	66	113	10	33	47	0.7021276
NODE_279241_length_255_cov_2.942308	157	176	0	19	19	1.0000000
NODE_279320_length_255_cov_2.621795	227	254	0	27	27	1.0000000
NODE_279379_length_255_cov_2.602564	131	185	2	16	54	0.2962963
NODE_279379_length_255_cov_2.602564	131	185	3	12	54	0.2222222
NODE_279379_length_255_cov_2.602564	131	185	4	26	54	0.4814815
NODE_279427_length_255_cov_2.487179	43	119	4	36	76	0.4736842
NODE_279427_length_255_cov_2.487179	43	119	6	40	76	0.5263158
NODE_279447_length_255_cov_2.435897	0	58	4	58	58	1.0000000
NODE_279462_length_255_cov_2.391026	189	255	0	66	66	1.0000000
NODE_279507_length_255_cov_2.288462	0	60	0	60	60	1.0000000
NODE_279510_length_255_cov_2.288462	0	74	0	38	74	0.5135135
NODE_279510_length_255_cov_2.288462	0	74	2	5	74	0.0675676
NODE_279510_length_255_cov_2.288462	0	74	4	31	74	0.4189189
NODE_279620_length_255_cov_2.089744	105	145	0	40	40	1.0000000
NODE_279649_length_255_cov_1.987179	0	72	3	2	72	0.0277778
NODE_279649_length_255_cov_1.987179	0	72	4	1	72	0.0138889
NODE_279649_length_255_cov_1.987179	0	72	6	2	72	0.0277778
NODE_279649_length_255_cov_1.987179	0	72	8	67	72	0.9305556
NODE_279842_length_255_cov_1.910256	198	255	0	57	57	1.0000000
NODE_279871_length_255_cov_1.871795	16	68	0	52	52	1.0000000
NODE_279892_length_255_cov_1.826923	146	218	0	72	72	1.0000000
NODE_279956_length_255_cov_1.705128	0	45	0	45	45	1.0000000
NODE_279956_length_255_cov_1.705128	41	121	0	80	80	1.0000000
NODE_279956_length_255_cov_1.705128	94	174	0	80	80	1.0000000
NODE_280153_length_255_cov_1.576923	43	117	8	1	74	0.0135135
NODE_280153_length_255_cov_1.576923	43	117	10	4	74	0.0540541
NODE_280153_length_255_cov_1.576923	43	117	12	1	74	0.0135135
NODE_280153_length_255_cov_1.576923	43	117	14	4	74	0.0540541
NODE_280153_length_255_cov_1.576923	43	117	16	2	74	0.0270270
NODE_280153_length_255_cov_1.576923	43	117	20	3	74	0.0405405
NODE_280153_length_255_cov_1.576923	43	117	21	9	74	0.1216216
NODE_280153_length_255_cov_1.576923	43	117	22	1	74	0.0135135
NODE_280153_length_255_cov_1.576923	43	117	24	25	74	0.3378378
NODE_280153_length_255_cov_1.576923	43	117	30	2	74	0.0270270
NODE_280153_length_255_cov_1.576923	43	117	32	1	74	0.0135135
NODE_280153_length_255_cov_1.576923	43	117	34	10	74	0.1351351
NODE_280153_length_255_cov_1.576923	43	117	36	11	74	0.1486486
NODE_280153_length_255_cov_1.576923	90	175	16	1	85	0.0117647
NODE_280153_length_255_cov_1.576923	90	175	20	1	85	0.0117647
NODE_280153_length_255_cov_1.576923	90	175	22	1	85	0.0117647
NODE_280153_length_255_cov_1.576923	90	175	30	2	85	0.0235294
NODE_280153_length_255_cov_1.576923	90	175	32	1	85	0.0117647
NODE_280153_length_255_cov_1.576923	90	175	34	10	85	0.1176471
NODE_280153_length_255_cov_1.576923	90	175	36	16	85	0.1882353
NODE_280153_length_255_cov_1.576923	90	175	37	1	85	0.0117647
NODE_280153_length_255_cov_1.576923	90	175	38	8	85	0.0941176
NODE_280153_length_255_cov_1.576923	90	175	39	14	85	0.1647059
NODE_280153_length_255_cov_1.576923	90	175	40	30	85	0.3529412
NODE_280168_length_255_cov_1.557692	62	125	0	63	63	1.0000000
NODE_280297_length_255_cov_1.358974	178	246	0	68	68	1.0000000
NODE_280904_length_255_cov_1.128205	183	219	0	36	36	1.0000000
NODE_281094_length_255_cov_0.987179	220	241	0	21	21	1.0000000
NODE_281380_length_255_cov_0.955128	119	171	2	52	52	1.0000000
NODE_281384_length_255_cov_0.955128	12	92	4	1	80	0.0125000
NODE_281384_length_255_cov_0.955128	12	92	6	41	80	0.5125000
NODE_281384_length_255_cov_0.955128	12	92	8	38	80	0.4750000
NODE_282137_length_255_cov_0.653846	87	106	0	19	19	1.0000000
NODE_282534_length_254_cov_4.935484	144	189	2	45	45	1.0000000
NODE_282534_length_254_cov_4.935484	164	242	0	30	78	0.3846154
NODE_282534_length_254_cov_4.935484	164	242	2	48	78	0.6153846
NODE_282548_length_254_cov_4.722581	44	85	4	41	41	1.0000000
NODE_282576_length_254_cov_4.296774	149	174	4	25	25	1.0000000
NODE_282576_length_254_cov_4.296774	149	223	0	2	74	0.0270270
NODE_282576_length_254_cov_4.296774	149	223	2	14	74	0.1891892
NODE_282576_length_254_cov_4.296774	149	223	4	58	74	0.7837838
NODE_282590_length_254_cov_4.206452	57	86	17	7	29	0.2413793
NODE_282590_length_254_cov_4.206452	57	86	19	6	29	0.2068966
NODE_282590_length_254_cov_4.206452	57	86	21	12	29	0.4137931
NODE_282590_length_254_cov_4.206452	57	86	23	4	29	0.1379310
NODE_282626_length_254_cov_3.677419	7	64	8	3	57	0.0526316
NODE_282626_length_254_cov_3.677419	7	64	10	2	57	0.0350877
NODE_282626_length_254_cov_3.677419	7	64	16	4	57	0.0701754
NODE_282626_length_254_cov_3.677419	7	64	20	1	57	0.0175439
NODE_282626_length_254_cov_3.677419	7	64	24	1	57	0.0175439
NODE_282626_length_254_cov_3.677419	7	64	28	4	57	0.0701754
NODE_282626_length_254_cov_3.677419	7	64	30	3	57	0.0526316
NODE_282626_length_254_cov_3.677419	7	64	32	3	57	0.0526316
NODE_282626_length_254_cov_3.677419	7	64	34	2	57	0.0350877
NODE_282626_length_254_cov_3.677419	7	64	36	1	57	0.0175439
NODE_282626_length_254_cov_3.677419	7	64	38	2	57	0.0350877
NODE_282626_length_254_cov_3.677419	7	64	40	31	57	0.5438597
NODE_282626_length_254_cov_3.677419	60	117	16	1	57	0.0175439
NODE_282626_length_254_cov_3.677419	60	117	18	12	57	0.2105263
NODE_282626_length_254_cov_3.677419	60	117	20	5	57	0.0877193
NODE_282626_length_254_cov_3.677419	60	117	23	1	57	0.0175439
NODE_282626_length_254_cov_3.677419	60	117	24	5	57	0.0877193
NODE_282626_length_254_cov_3.677419	60	117	26	4	57	0.0701754
NODE_282626_length_254_cov_3.677419	60	117	28	1	57	0.0175439
NODE_282626_length_254_cov_3.677419	60	117	31	1	57	0.0175439
NODE_282626_length_254_cov_3.677419	60	117	32	1	57	0.0175439
NODE_282626_length_254_cov_3.677419	60	117	34	1	57	0.0175439
NODE_282626_length_254_cov_3.677419	60	117	36	4	57	0.0701754
NODE_282626_length_254_cov_3.677419	60	117	38	6	57	0.1052632
NODE_282626_length_254_cov_3.677419	60	117	40	15	57	0.2631579
NODE_282642_length_254_cov_3.593548	154	197	0	43	43	1.0000000
NODE_282659_length_254_cov_3.438710	82	129	2	41	47	0.8723404
NODE_282659_length_254_cov_3.438710	82	129	6	6	47	0.1276596
NODE_282659_length_254_cov_3.438710	102	182	2	80	80	1.0000000
NODE_282736_length_254_cov_2.961290	5	79	0	35	74	0.4729730
NODE_282736_length_254_cov_2.961290	5	79	2	33	74	0.4459459
NODE_282736_length_254_cov_2.961290	5	79	6	6	74	0.0810811
NODE_282736_length_254_cov_2.961290	52	118	2	21	66	0.3181818
NODE_282736_length_254_cov_2.961290	52	118	6	11	66	0.1666667
NODE_282736_length_254_cov_2.961290	52	118	8	34	66	0.5151515
NODE_282771_length_254_cov_2.780645	169	252	4	3	83	0.0361446
NODE_282771_length_254_cov_2.780645	169	252	5	2	83	0.0240964
NODE_282771_length_254_cov_2.780645	169	252	6	10	83	0.1204819
NODE_282771_length_254_cov_2.780645	169	252	12	20	83	0.2409639
NODE_282771_length_254_cov_2.780645	169	252	14	5	83	0.0602410
NODE_282771_length_254_cov_2.780645	169	252	16	11	83	0.1325301
NODE_282771_length_254_cov_2.780645	169	252	18	5	83	0.0602410
NODE_282771_length_254_cov_2.780645	169	252	20	1	83	0.0120482
NODE_282771_length_254_cov_2.780645	169	252	22	5	83	0.0602410
NODE_282771_length_254_cov_2.780645	169	252	24	4	83	0.0481928
NODE_282771_length_254_cov_2.780645	169	252	26	11	83	0.1325301
NODE_282771_length_254_cov_2.780645	169	252	30	1	83	0.0120482
NODE_282771_length_254_cov_2.780645	169	252	34	5	83	0.0602410
NODE_282947_length_254_cov_2.341935	167	201	8	34	34	1.0000000
NODE_283082_length_254_cov_2.161290	14	74	0	60	60	1.0000000
NODE_283244_length_254_cov_1.974194	156	204	1	19	48	0.3958333
NODE_283244_length_254_cov_1.974194	156	204	2	29	48	0.6041667
NODE_283440_length_254_cov_1.780645	79	126	6	1	47	0.0212766
NODE_283440_length_254_cov_1.780645	79	126	8	2	47	0.0425532
NODE_283440_length_254_cov_1.780645	79	126	10	3	47	0.0638298
NODE_283440_length_254_cov_1.780645	79	126	12	9	47	0.1914894
NODE_283440_length_254_cov_1.780645	79	126	14	7	47	0.1489362
NODE_283440_length_254_cov_1.780645	79	126	16	1	47	0.0212766
NODE_283440_length_254_cov_1.780645	79	126	18	9	47	0.1914894
NODE_283440_length_254_cov_1.780645	79	126	19	9	47	0.1914894
NODE_283440_length_254_cov_1.780645	79	126	20	6	47	0.1276596
NODE_283952_length_254_cov_1.316129	23	87	0	7	64	0.1093750
NODE_283952_length_254_cov_1.316129	23	87	2	57	64	0.8906250
NODE_284013_length_254_cov_1.316129	193	215	0	22	22	1.0000000
NODE_284256_length_254_cov_1.258065	181	249	2	68	68	1.0000000
NODE_284275_length_254_cov_1.238710	9	82	1	1	73	0.0136986
NODE_284275_length_254_cov_1.238710	9	82	2	68	73	0.9315069
NODE_284275_length_254_cov_1.238710	9	82	3	4	73	0.0547945
NODE_284275_length_254_cov_1.238710	62	82	1	1	20	0.0500000
NODE_284275_length_254_cov_1.238710	62	82	2	15	20	0.7500000
NODE_284275_length_254_cov_1.238710	62	82	3	4	20	0.2000000
NODE_284277_length_254_cov_1.238710	54	73	0	19	19	1.0000000
NODE_284301_length_254_cov_1.219355	98	157	0	56	59	0.9491525
NODE_284301_length_254_cov_1.219355	98	157	3	3	59	0.0508475
NODE_284638_length_254_cov_0.987097	139	193	0	54	54	1.0000000
NODE_284638_length_254_cov_0.987097	205	254	0	49	49	1.0000000
NODE_284796_length_254_cov_0.987097	121	152	0	31	31	1.0000000
NODE_285963_length_253_cov_60.311688	137	202	20	1	65	0.0153846
NODE_285963_length_253_cov_60.311688	137	202	46	2	65	0.0307692
NODE_285963_length_253_cov_60.311688	137	202	48	1	65	0.0153846
NODE_285963_length_253_cov_60.311688	137	202	52	4	65	0.0615385
NODE_285963_length_253_cov_60.311688	137	202	56	1	65	0.0153846
NODE_285963_length_253_cov_60.311688	137	202	64	1	65	0.0153846
NODE_285963_length_253_cov_60.311688	137	202	66	1	65	0.0153846
NODE_285963_length_253_cov_60.311688	137	202	70	54	65	0.8307692
NODE_285963_length_253_cov_60.311688	175	253	4	2	78	0.0256410
NODE_285963_length_253_cov_60.311688	175	253	6	1	78	0.0128205
NODE_285963_length_253_cov_60.311688	175	253	8	1	78	0.0128205
NODE_285963_length_253_cov_60.311688	175	253	12	1	78	0.0128205
NODE_285963_length_253_cov_60.311688	175	253	17	1	78	0.0128205
NODE_285963_length_253_cov_60.311688	175	253	19	1	78	0.0128205
NODE_285963_length_253_cov_60.311688	175	253	25	1	78	0.0128205
NODE_285963_length_253_cov_60.311688	175	253	29	1	78	0.0128205
NODE_285963_length_253_cov_60.311688	175	253	31	1	78	0.0128205
NODE_285963_length_253_cov_60.311688	175	253	33	1	78	0.0128205
NODE_285963_length_253_cov_60.311688	175	253	39	1	78	0.0128205
NODE_285963_length_253_cov_60.311688	175	253	41	1	78	0.0128205
NODE_285963_length_253_cov_60.311688	175	253	43	1	78	0.0128205
NODE_285963_length_253_cov_60.311688	175	253	56	1	78	0.0128205
NODE_285963_length_253_cov_60.311688	175	253	57	1	78	0.0128205
NODE_285963_length_253_cov_60.311688	175	253	59	1	78	0.0128205
NODE_285963_length_253_cov_60.311688	175	253	63	1	78	0.0128205
NODE_285963_length_253_cov_60.311688	175	253	65	1	78	0.0128205
NODE_285963_length_253_cov_60.311688	175	253	67	1	78	0.0128205
NODE_285963_length_253_cov_60.311688	175	253	69	5	78	0.0641026
NODE_285963_length_253_cov_60.311688	175	253	70	53	78	0.6794872
NODE_285965_length_253_cov_41.519481	0	68	4	1	68	0.0147059
NODE_285965_length_253_cov_41.519481	0	68	6	3	68	0.0441176
NODE_285965_length_253_cov_41.519481	0	68	10	10	68	0.1470588
NODE_285965_length_253_cov_41.519481	0	68	18	4	68	0.0588235
NODE_285965_length_253_cov_41.519481	0	68	20	3	68	0.0441176
NODE_285965_length_253_cov_41.519481	0	68	22	8	68	0.1176471
NODE_285965_length_253_cov_41.519481	0	68	29	1	68	0.0147059
NODE_285965_length_253_cov_41.519481	0	68	37	6	68	0.0882353
NODE_285965_length_253_cov_41.519481	0	68	41	5	68	0.0735294
NODE_285965_length_253_cov_41.519481	0	68	47	13	68	0.1911765
NODE_285965_length_253_cov_41.519481	0	68	49	2	68	0.0294118
NODE_285965_length_253_cov_41.519481	0	68	55	7	68	0.1029412
NODE_285965_length_253_cov_41.519481	0	68	59	2	68	0.0294118
NODE_285965_length_253_cov_41.519481	0	68	61	3	68	0.0441176
NODE_285965_length_253_cov_41.519481	0	70	4	1	70	0.0142857
NODE_285965_length_253_cov_41.519481	0	70	6	3	70	0.0428571
NODE_285965_length_253_cov_41.519481	0	70	10	10	70	0.1428571
NODE_285965_length_253_cov_41.519481	0	70	18	4	70	0.0571429
NODE_285965_length_253_cov_41.519481	0	70	20	3	70	0.0428571
NODE_285965_length_253_cov_41.519481	0	70	22	8	70	0.1142857
NODE_285965_length_253_cov_41.519481	0	70	29	1	70	0.0142857
NODE_285965_length_253_cov_41.519481	0	70	37	6	70	0.0857143
NODE_285965_length_253_cov_41.519481	0	70	41	5	70	0.0714286
NODE_285965_length_253_cov_41.519481	0	70	47	13	70	0.1857143
NODE_285965_length_253_cov_41.519481	0	70	49	2	70	0.0285714
NODE_285965_length_253_cov_41.519481	0	70	55	7	70	0.1000000
NODE_285965_length_253_cov_41.519481	0	70	59	2	70	0.0285714
NODE_285965_length_253_cov_41.519481	0	70	61	5	70	0.0714286
NODE_285965_length_253_cov_41.519481	2	73	6	2	71	0.0281690
NODE_285965_length_253_cov_41.519481	2	73	10	10	71	0.1408451
NODE_285965_length_253_cov_41.519481	2	73	18	4	71	0.0563380
NODE_285965_length_253_cov_41.519481	2	73	20	3	71	0.0422535
NODE_285965_length_253_cov_41.519481	2	73	22	8	71	0.1126761
NODE_285965_length_253_cov_41.519481	2	73	29	1	71	0.0140845
NODE_285965_length_253_cov_41.519481	2	73	37	6	71	0.0845070
NODE_285965_length_253_cov_41.519481	2	73	41	5	71	0.0704225
NODE_285965_length_253_cov_41.519481	2	73	47	13	71	0.1830986
NODE_285965_length_253_cov_41.519481	2	73	49	2	71	0.0281690
NODE_285965_length_253_cov_41.519481	2	73	55	7	71	0.0985916
NODE_285965_length_253_cov_41.519481	2	73	59	2	71	0.0281690
NODE_285965_length_253_cov_41.519481	2	73	61	8	71	0.1126761
NODE_285965_length_253_cov_41.519481	7	73	10	7	66	0.1060606
NODE_285965_length_253_cov_41.519481	7	73	18	4	66	0.0606061
NODE_285965_length_253_cov_41.519481	7	73	20	3	66	0.0454545
NODE_285965_length_253_cov_41.519481	7	73	22	8	66	0.1212121
NODE_285965_length_253_cov_41.519481	7	73	29	1	66	0.0151515
NODE_285965_length_253_cov_41.519481	7	73	37	6	66	0.0909091
NODE_285965_length_253_cov_41.519481	7	73	41	5	66	0.0757576
NODE_285965_length_253_cov_41.519481	7	73	47	13	66	0.1969697
NODE_285965_length_253_cov_41.519481	7	73	49	2	66	0.0303030
NODE_285965_length_253_cov_41.519481	7	73	55	7	66	0.1060606
NODE_285965_length_253_cov_41.519481	7	73	59	2	66	0.0303030
NODE_285965_length_253_cov_41.519481	7	73	61	8	66	0.1212121
NODE_285965_length_253_cov_41.519481	46	123	47	8	77	0.1038961
NODE_285965_length_253_cov_41.519481	46	123	49	2	77	0.0259740
NODE_285965_length_253_cov_41.519481	46	123	53	7	77	0.0909091
NODE_285965_length_253_cov_41.519481	46	123	55	13	77	0.1688312
NODE_285965_length_253_cov_41.519481	46	123	59	2	77	0.0259740
NODE_285965_length_253_cov_41.519481	46	123	61	14	77	0.1818182
NODE_285965_length_253_cov_41.519481	46	123	62	5	77	0.0649351
NODE_285965_length_253_cov_41.519481	46	123	63	26	77	0.3376623
NODE_285965_length_253_cov_41.519481	46	123	47	8	77	0.1038961
NODE_285965_length_253_cov_41.519481	46	123	49	2	77	0.0259740
NODE_285965_length_253_cov_41.519481	46	123	53	7	77	0.0909091
NODE_285965_length_253_cov_41.519481	46	123	55	13	77	0.1688312
NODE_285965_length_253_cov_41.519481	46	123	59	2	77	0.0259740
NODE_285965_length_253_cov_41.519481	46	123	61	14	77	0.1818182
NODE_285965_length_253_cov_41.519481	46	123	62	5	77	0.0649351
NODE_285965_length_253_cov_41.519481	46	123	63	26	77	0.3376623
NODE_285965_length_253_cov_41.519481	46	123	47	8	77	0.1038961
NODE_285965_length_253_cov_41.519481	46	123	49	2	77	0.0259740
NODE_285965_length_253_cov_41.519481	46	123	53	7	77	0.0909091
NODE_285965_length_253_cov_41.519481	46	123	55	13	77	0.1688312
NODE_285965_length_253_cov_41.519481	46	123	59	2	77	0.0259740
NODE_285965_length_253_cov_41.519481	46	123	61	14	77	0.1818182
NODE_285965_length_253_cov_41.519481	46	123	62	5	77	0.0649351
NODE_285965_length_253_cov_41.519481	46	123	63	26	77	0.3376623
NODE_285967_length_253_cov_13.967532	25	105	0	78	80	0.9750000
NODE_285967_length_253_cov_13.967532	25	105	2	2	80	0.0250000
NODE_285967_length_253_cov_13.967532	78	158	0	25	80	0.3125000
NODE_285967_length_253_cov_13.967532	78	158	2	55	80	0.6875000
NODE_285969_length_253_cov_12.259740	0	54	0	54	54	1.0000000
NODE_285969_length_253_cov_12.259740	27	62	0	35	35	1.0000000
NODE_285969_length_253_cov_12.259740	51	131	0	80	80	1.0000000
NODE_285969_length_253_cov_12.259740	104	139	0	35	35	1.0000000
NODE_285969_length_253_cov_12.259740	128	208	0	80	80	1.0000000
NODE_285969_length_253_cov_12.259740	181	216	0	35	35	1.0000000
NODE_285987_length_253_cov_7.279221	184	250	6	2	66	0.0303030
NODE_285987_length_253_cov_7.279221	184	250	7	3	66	0.0454545
NODE_285987_length_253_cov_7.279221	184	250	8	9	66	0.1363636
NODE_285987_length_253_cov_7.279221	184	250	14	6	66	0.0909091
NODE_285987_length_253_cov_7.279221	184	250	16	14	66	0.2121212
NODE_285987_length_253_cov_7.279221	184	250	18	6	66	0.0909091
NODE_285987_length_253_cov_7.279221	184	250	20	10	66	0.1515152
NODE_285987_length_253_cov_7.279221	184	250	22	14	66	0.2121212
NODE_285987_length_253_cov_7.279221	184	250	24	2	66	0.0303030
NODE_286022_length_253_cov_5.376623	66	147	0	12	81	0.1481481
NODE_286022_length_253_cov_5.376623	66	147	4	14	81	0.1728395
NODE_286022_length_253_cov_5.376623	66	147	6	27	81	0.3333333
NODE_286022_length_253_cov_5.376623	66	147	8	28	81	0.3456790
NODE_286022_length_253_cov_5.376623	120	185	8	65	65	1.0000000
NODE_286042_length_253_cov_4.896104	102	182	40	1	80	0.0125000
NODE_286042_length_253_cov_4.896104	102	182	42	2	80	0.0250000
NODE_286042_length_253_cov_4.896104	102	182	43	1	80	0.0125000
NODE_286042_length_253_cov_4.896104	102	182	47	1	80	0.0125000
NODE_286042_length_253_cov_4.896104	102	182	48	1	80	0.0125000
NODE_286042_length_253_cov_4.896104	102	182	50	3	80	0.0375000
NODE_286042_length_253_cov_4.896104	102	182	58	1	80	0.0125000
NODE_286042_length_253_cov_4.896104	102	182	62	1	80	0.0125000
NODE_286042_length_253_cov_4.896104	102	182	63	1	80	0.0125000
NODE_286042_length_253_cov_4.896104	102	182	64	2	80	0.0250000
NODE_286042_length_253_cov_4.896104	102	182	71	1	80	0.0125000
NODE_286042_length_253_cov_4.896104	102	182	72	2	80	0.0250000
NODE_286042_length_253_cov_4.896104	102	182	74	1	80	0.0125000
NODE_286042_length_253_cov_4.896104	102	182	76	1	80	0.0125000
NODE_286042_length_253_cov_4.896104	102	182	81	1	80	0.0125000
NODE_286042_length_253_cov_4.896104	102	182	85	1	80	0.0125000
NODE_286042_length_253_cov_4.896104	102	182	86	3	80	0.0375000
NODE_286042_length_253_cov_4.896104	102	182	88	2	80	0.0250000
NODE_286042_length_253_cov_4.896104	102	182	90	1	80	0.0125000
NODE_286042_length_253_cov_4.896104	102	182	91	1	80	0.0125000
NODE_286042_length_253_cov_4.896104	102	182	96	4	80	0.0500000
NODE_286042_length_253_cov_4.896104	102	182	97	2	80	0.0250000
NODE_286042_length_253_cov_4.896104	102	182	101	3	80	0.0375000
NODE_286042_length_253_cov_4.896104	102	182	104	1	80	0.0125000
NODE_286042_length_253_cov_4.896104	102	182	105	1	80	0.0125000
NODE_286042_length_253_cov_4.896104	102	182	106	1	80	0.0125000
NODE_286042_length_253_cov_4.896104	102	182	110	1	80	0.0125000
NODE_286042_length_253_cov_4.896104	102	182	118	3	80	0.0375000
NODE_286042_length_253_cov_4.896104	102	182	122	5	80	0.0625000
NODE_286042_length_253_cov_4.896104	102	182	123	1	80	0.0125000
NODE_286042_length_253_cov_4.896104	102	182	124	4	80	0.0500000
NODE_286042_length_253_cov_4.896104	102	182	125	2	80	0.0250000
NODE_286042_length_253_cov_4.896104	102	182	126	1	80	0.0125000
NODE_286042_length_253_cov_4.896104	102	182	129	2	80	0.0250000
NODE_286042_length_253_cov_4.896104	102	182	131	2	80	0.0250000
NODE_286042_length_253_cov_4.896104	102	182	132	12	80	0.1500000
NODE_286042_length_253_cov_4.896104	102	182	133	1	80	0.0125000
NODE_286042_length_253_cov_4.896104	102	182	136	5	80	0.0625000
NODE_286042_length_253_cov_4.896104	102	182	137	1	80	0.0125000
NODE_286046_length_253_cov_4.798701	199	253	0	54	54	1.0000000
NODE_286069_length_253_cov_4.487013	85	126	2	8	41	0.1951219
NODE_286069_length_253_cov_4.487013	85	126	4	33	41	0.8048781
NODE_286151_length_253_cov_3.500000	44	105	11	2	61	0.0327869
NODE_286151_length_253_cov_3.500000	44	105	12	48	61	0.7868853
NODE_286151_length_253_cov_3.500000	44	105	14	11	61	0.1803279
NODE_286151_length_253_cov_3.500000	90	158	2	21	68	0.3088235
NODE_286151_length_253_cov_3.500000	90	158	4	3	68	0.0441176
NODE_286151_length_253_cov_3.500000	90	158	6	1	68	0.0147059
NODE_286151_length_253_cov_3.500000	90	158	10	15	68	0.2205882
NODE_286151_length_253_cov_3.500000	90	158	12	23	68	0.3382353
NODE_286151_length_253_cov_3.500000	90	158	14	5	68	0.0735294
NODE_286259_length_253_cov_2.987013	85	165	0	80	80	1.0000000
NODE_286259_length_253_cov_2.987013	138	169	0	31	31	1.0000000
NODE_286275_length_253_cov_2.954545	100	148	0	48	48	1.0000000
NODE_286281_length_253_cov_2.909091	34	99	12	3	65	0.0461538
NODE_286281_length_253_cov_2.909091	34	99	14	17	65	0.2615385
NODE_286281_length_253_cov_2.909091	34	99	18	14	65	0.2153846
NODE_286281_length_253_cov_2.909091	34	99	20	19	65	0.2923077
NODE_286281_length_253_cov_2.909091	34	99	22	12	65	0.1846154
NODE_286288_length_253_cov_2.889610	129	200	20	9	71	0.1267606
NODE_286288_length_253_cov_2.889610	129	200	24	6	71	0.0845070
NODE_286288_length_253_cov_2.889610	129	200	26	2	71	0.0281690
NODE_286288_length_253_cov_2.889610	129	200	28	15	71	0.2112676
NODE_286288_length_253_cov_2.889610	129	200	30	8	71	0.1126761
NODE_286288_length_253_cov_2.889610	129	200	32	9	71	0.1267606
NODE_286288_length_253_cov_2.889610	129	200	34	4	71	0.0563380
NODE_286288_length_253_cov_2.889610	129	200	36	12	71	0.1690141
NODE_286288_length_253_cov_2.889610	129	200	38	4	71	0.0563380
NODE_286288_length_253_cov_2.889610	129	200	40	2	71	0.0281690
NODE_286288_length_253_cov_2.889610	173	253	7	3	80	0.0375000
NODE_286288_length_253_cov_2.889610	173	253	9	2	80	0.0250000
NODE_286288_length_253_cov_2.889610	173	253	13	3	80	0.0375000
NODE_286288_length_253_cov_2.889610	173	253	15	6	80	0.0750000
NODE_286288_length_253_cov_2.889610	173	253	16	4	80	0.0500000
NODE_286288_length_253_cov_2.889610	173	253	17	1	80	0.0125000
NODE_286288_length_253_cov_2.889610	173	253	18	2	80	0.0250000
NODE_286288_length_253_cov_2.889610	173	253	22	4	80	0.0500000
NODE_286288_length_253_cov_2.889610	173	253	24	1	80	0.0125000
NODE_286288_length_253_cov_2.889610	173	253	25	2	80	0.0250000
NODE_286288_length_253_cov_2.889610	173	253	26	1	80	0.0125000
NODE_286288_length_253_cov_2.889610	173	253	27	4	80	0.0500000
NODE_286288_length_253_cov_2.889610	173	253	28	14	80	0.1750000
NODE_286288_length_253_cov_2.889610	173	253	30	26	80	0.3250000
NODE_286288_length_253_cov_2.889610	173	253	32	7	80	0.0875000
NODE_286289_length_253_cov_2.889610	21	76	0	55	55	1.0000000
NODE_286289_length_253_cov_2.889610	149	229	0	5	80	0.0625000
NODE_286289_length_253_cov_2.889610	149	229	2	27	80	0.3375000
NODE_286289_length_253_cov_2.889610	149	229	4	48	80	0.6000000
NODE_286379_length_253_cov_2.610390	113	193	0	80	80	1.0000000
NODE_286386_length_253_cov_2.584416	97	154	4	6	57	0.1052632
NODE_286386_length_253_cov_2.584416	97	154	6	51	57	0.8947368
NODE_286545_length_253_cov_2.240260	185	250	0	65	65	1.0000000
NODE_286667_length_253_cov_1.987013	157	237	0	13	80	0.1625000
NODE_286667_length_253_cov_1.987013	157	237	2	67	80	0.8375000
NODE_286667_length_253_cov_1.987013	210	253	0	29	43	0.6744186
NODE_286667_length_253_cov_1.987013	210	253	2	14	43	0.3255814
NODE_286685_length_253_cov_1.987013	18	60	0	42	42	1.0000000
NODE_286829_length_253_cov_1.961039	186	232	2	46	46	1.0000000
NODE_286837_length_253_cov_1.948052	68	120	0	52	52	1.0000000
NODE_286838_length_253_cov_1.948052	63	114	0	51	51	1.0000000
NODE_286947_length_253_cov_1.746753	164	193	0	29	29	1.0000000
NODE_287031_length_253_cov_1.655844	40	120	2	1	80	0.0125000
NODE_287031_length_253_cov_1.655844	40	120	8	25	80	0.3125000
NODE_287031_length_253_cov_1.655844	40	120	12	10	80	0.1250000
NODE_287031_length_253_cov_1.655844	40	120	18	44	80	0.5500000
NODE_287031_length_253_cov_1.655844	93	152	8	3	59	0.0508475
NODE_287031_length_253_cov_1.655844	93	152	10	1	59	0.0169492
NODE_287031_length_253_cov_1.655844	93	152	16	6	59	0.1016949
NODE_287031_length_253_cov_1.655844	93	152	18	49	59	0.8305085
NODE_287133_length_253_cov_1.590909	102	148	4	46	46	1.0000000
NODE_287156_length_253_cov_1.558442	67	149	10	4	82	0.0487805
NODE_287156_length_253_cov_1.558442	67	149	12	29	82	0.3536585
NODE_287156_length_253_cov_1.558442	67	149	14	49	82	0.5975610
NODE_287230_length_253_cov_1.441558	49	113	0	64	64	1.0000000
NODE_287230_length_253_cov_1.441558	102	166	0	64	64	1.0000000
NODE_287232_length_253_cov_1.441558	121	185	0	64	64	1.0000000
NODE_287234_length_253_cov_1.435065	50	81	2	31	31	1.0000000
NODE_287584_length_253_cov_1.324675	193	239	0	38	46	0.8260869
NODE_287584_length_253_cov_1.324675	193	239	2	8	46	0.1739130
NODE_287599_length_253_cov_1.324675	90	132	48	6	42	0.1428571
NODE_287599_length_253_cov_1.324675	90	132	50	7	42	0.1666667
NODE_287599_length_253_cov_1.324675	90	132	52	17	42	0.4047619
NODE_287599_length_253_cov_1.324675	90	132	54	12	42	0.2857143
NODE_287599_length_253_cov_1.324675	133	185	9	1	52	0.0192308
NODE_287599_length_253_cov_1.324675	133	185	10	2	52	0.0384615
NODE_287599_length_253_cov_1.324675	133	185	16	1	52	0.0192308
NODE_287599_length_253_cov_1.324675	133	185	17	1	52	0.0192308
NODE_287599_length_253_cov_1.324675	133	185	18	1	52	0.0192308
NODE_287599_length_253_cov_1.324675	133	185	19	2	52	0.0384615
NODE_287599_length_253_cov_1.324675	133	185	23	6	52	0.1153846
NODE_287599_length_253_cov_1.324675	133	185	25	1	52	0.0192308
NODE_287599_length_253_cov_1.324675	133	185	27	4	52	0.0769231
NODE_287599_length_253_cov_1.324675	133	185	29	2	52	0.0384615
NODE_287599_length_253_cov_1.324675	133	185	33	2	52	0.0384615
NODE_287599_length_253_cov_1.324675	133	185	36	3	52	0.0576923
NODE_287599_length_253_cov_1.324675	133	185	44	20	52	0.3846154
NODE_287599_length_253_cov_1.324675	133	185	46	1	52	0.0192308
NODE_287599_length_253_cov_1.324675	133	185	48	5	52	0.0961538
NODE_287721_length_253_cov_1.285714	87	125	0	38	38	1.0000000
NODE_287794_length_253_cov_1.214286	99	148	0	49	49	1.0000000
NODE_287845_length_253_cov_1.181818	185	247	0	62	62	1.0000000
NODE_287845_length_253_cov_1.181818	185	247	0	62	62	1.0000000
NODE_287989_length_253_cov_1.064935	83	159	6	2	76	0.0263158
NODE_287989_length_253_cov_1.064935	83	159	7	1	76	0.0131579
NODE_287989_length_253_cov_1.064935	83	159	9	1	76	0.0131579
NODE_287989_length_253_cov_1.064935	83	159	11	2	76	0.0263158
NODE_287989_length_253_cov_1.064935	83	159	17	1	76	0.0131579
NODE_287989_length_253_cov_1.064935	83	159	19	6	76	0.0789474
NODE_287989_length_253_cov_1.064935	83	159	25	2	76	0.0263158
NODE_287989_length_253_cov_1.064935	83	159	27	3	76	0.0394737
NODE_287989_length_253_cov_1.064935	83	159	28	3	76	0.0394737
NODE_287989_length_253_cov_1.064935	83	159	29	2	76	0.0263158
NODE_287989_length_253_cov_1.064935	83	159	30	3	76	0.0394737
NODE_287989_length_253_cov_1.064935	83	159	32	3	76	0.0394737
NODE_287989_length_253_cov_1.064935	83	159	34	5	76	0.0657895
NODE_287989_length_253_cov_1.064935	83	159	38	6	76	0.0789474
NODE_287989_length_253_cov_1.064935	83	159	40	6	76	0.0789474
NODE_287989_length_253_cov_1.064935	83	159	42	9	76	0.1184211
NODE_287989_length_253_cov_1.064935	83	159	43	14	76	0.1842105
NODE_287989_length_253_cov_1.064935	83	159	44	7	76	0.0921053
NODE_288099_length_253_cov_0.993506	0	44	2	44	44	1.0000000
NODE_288465_length_253_cov_0.870130	17	46	2	16	29	0.5517241
NODE_288465_length_253_cov_0.870130	17	46	4	9	29	0.3103448
NODE_288465_length_253_cov_0.870130	17	46	6	4	29	0.1379310
NODE_288478_length_253_cov_0.850649	0	89	0	89	89	1.0000000
NODE_289563_length_252_cov_4.771242	94	148	0	25	54	0.4629630
NODE_289563_length_252_cov_4.771242	94	148	2	29	54	0.5370370
NODE_289574_length_252_cov_4.614379	16	37	0	5	21	0.2380952
NODE_289574_length_252_cov_4.614379	16	37	2	16	21	0.7619048
NODE_289624_length_252_cov_3.960784	7	85	0	19	78	0.2435897
NODE_289624_length_252_cov_3.960784	7	85	2	59	78	0.7564102
NODE_289624_length_252_cov_3.960784	63	136	0	70	73	0.9589041
NODE_289624_length_252_cov_3.960784	63	136	2	3	73	0.0410959
NODE_289663_length_252_cov_3.549020	89	157	0	68	68	1.0000000
NODE_289672_length_252_cov_3.405229	26	107	3	3	81	0.0370370
NODE_289672_length_252_cov_3.405229	26	107	5	3	81	0.0370370
NODE_289672_length_252_cov_3.405229	26	107	9	7	81	0.0864198
NODE_289672_length_252_cov_3.405229	26	107	10	35	81	0.4320988
NODE_289672_length_252_cov_3.405229	26	107	14	27	81	0.3333333
NODE_289672_length_252_cov_3.405229	26	107	18	6	81	0.0740741
NODE_289705_length_252_cov_3.307190	91	141	0	50	50	1.0000000
NODE_289742_length_252_cov_3.032680	135	212	0	77	77	1.0000000
NODE_289775_length_252_cov_2.928105	0	57	0	57	57	1.0000000
NODE_289799_length_252_cov_2.803922	41	121	0	80	80	1.0000000
NODE_290032_length_252_cov_2.320261	0	64	0	64	64	1.0000000
NODE_290046_length_252_cov_2.281046	120	170	0	50	50	1.0000000
NODE_290066_length_252_cov_2.215686	137	175	72	3	38	0.0789474
NODE_290066_length_252_cov_2.215686	137	175	78	1	38	0.0263158
NODE_290066_length_252_cov_2.215686	137	175	80	25	38	0.6578947
NODE_290066_length_252_cov_2.215686	137	175	82	8	38	0.2105263
NODE_290066_length_252_cov_2.215686	137	175	84	1	38	0.0263158
NODE_290103_length_252_cov_2.052288	18	39	0	21	21	1.0000000
NODE_290238_length_252_cov_1.993464	80	139	4	8	59	0.1355932
NODE_290238_length_252_cov_1.993464	80	139	6	14	59	0.2372881
NODE_290238_length_252_cov_1.993464	80	139	8	37	59	0.6271186
NODE_290385_length_252_cov_1.810458	3	49	0	46	46	1.0000000
NODE_290623_length_252_cov_1.594771	103	156	0	53	53	1.0000000
NODE_290623_length_252_cov_1.594771	152	192	0	40	40	1.0000000
NODE_290638_length_252_cov_1.568627	1	68	0	28	67	0.4179105
NODE_290638_length_252_cov_1.568627	1	68	2	39	67	0.5820895
NODE_290767_length_252_cov_1.359477	26	93	0	67	67	1.0000000
NODE_290790_length_252_cov_1.333333	179	232	0	53	53	1.0000000
NODE_290850_length_252_cov_1.333333	187	222	0	35	35	1.0000000
NODE_291072_length_252_cov_1.333333	31	111	0	80	80	1.0000000
NODE_291076_length_252_cov_1.333333	90	140	10	14	50	0.2800000
NODE_291076_length_252_cov_1.333333	90	140	12	36	50	0.7200000
NODE_291118_length_252_cov_1.326797	112	143	0	31	31	1.0000000
NODE_291351_length_252_cov_1.156863	1	32	0	31	31	1.0000000
NODE_291650_length_252_cov_1.000000	49	79	0	30	30	1.0000000
NODE_291911_length_252_cov_0.836601	125	172	0	13	47	0.2765957
NODE_291911_length_252_cov_0.836601	125	172	2	34	47	0.7234042
NODE_293004_length_251_cov_5.032895	0	62	0	62	62	1.0000000
NODE_293005_length_251_cov_5.026316	84	164	0	26	80	0.3250000
NODE_293005_length_251_cov_5.026316	84	164	2	54	80	0.6750000
NODE_293165_length_251_cov_3.302632	187	249	0	19	62	0.3064516
NODE_293165_length_251_cov_3.302632	187	249	2	43	62	0.6935484
NODE_293195_length_251_cov_3.131579	96	148	0	2	52	0.0384615
NODE_293195_length_251_cov_3.131579	96	148	2	50	52	0.9615384
NODE_293238_length_251_cov_2.980263	11	38	23	1	27	0.0370370
NODE_293238_length_251_cov_2.980263	11	38	28	2	27	0.0740741
NODE_293238_length_251_cov_2.980263	11	38	29	1	27	0.0370370
NODE_293238_length_251_cov_2.980263	11	38	31	1	27	0.0370370
NODE_293238_length_251_cov_2.980263	11	38	33	1	27	0.0370370
NODE_293238_length_251_cov_2.980263	11	38	44	2	27	0.0740741
NODE_293238_length_251_cov_2.980263	11	38	45	19	27	0.7037037
NODE_293238_length_251_cov_2.980263	11	91	23	1	80	0.0125000
NODE_293238_length_251_cov_2.980263	11	91	28	2	80	0.0250000
NODE_293238_length_251_cov_2.980263	11	91	29	1	80	0.0125000
NODE_293238_length_251_cov_2.980263	11	91	31	1	80	0.0125000
NODE_293238_length_251_cov_2.980263	11	91	33	1	80	0.0125000
NODE_293238_length_251_cov_2.980263	11	91	44	2	80	0.0250000
NODE_293238_length_251_cov_2.980263	11	91	45	29	80	0.3625000
NODE_293238_length_251_cov_2.980263	11	91	46	3	80	0.0375000
NODE_293238_length_251_cov_2.980263	11	91	53	1	80	0.0125000
NODE_293238_length_251_cov_2.980263	11	91	54	5	80	0.0625000
NODE_293238_length_251_cov_2.980263	11	91	56	34	80	0.4250000
NODE_293259_length_251_cov_2.842105	170	198	2	1	28	0.0357143
NODE_293259_length_251_cov_2.842105	170	198	4	23	28	0.8214286
NODE_293259_length_251_cov_2.842105	170	198	8	4	28	0.1428571
NODE_293279_length_251_cov_2.743421	181	232	0	51	51	1.0000000
NODE_293335_length_251_cov_2.677632	35	54	0	3	19	0.1578947
NODE_293335_length_251_cov_2.677632	35	54	2	16	19	0.8421053
NODE_293454_length_251_cov_2.348684	196	251	0	55	55	1.0000000
NODE_293502_length_251_cov_2.328947	86	149	0	32	63	0.5079365
NODE_293502_length_251_cov_2.328947	86	149	2	26	63	0.4126984
NODE_293502_length_251_cov_2.328947	86	149	6	5	63	0.0793651
NODE_293516_length_251_cov_2.296053	91	171	0	16	80	0.2000000
NODE_293516_length_251_cov_2.296053	91	171	4	64	80	0.8000000
NODE_293516_length_251_cov_2.296053	144	224	0	69	80	0.8625000
NODE_293516_length_251_cov_2.296053	144	224	4	11	80	0.1375000
NODE_293591_length_251_cov_2.065789	7	52	0	45	45	1.0000000
NODE_293698_length_251_cov_2.013158	96	179	4	19	83	0.2289157
NODE_293698_length_251_cov_2.013158	96	179	6	64	83	0.7710843
NODE_293698_length_251_cov_2.013158	96	179	4	19	83	0.2289157
NODE_293698_length_251_cov_2.013158	96	179	6	64	83	0.7710843
NODE_293698_length_251_cov_2.013158	152	203	0	3	51	0.0588235
NODE_293698_length_251_cov_2.013158	152	203	3	1	51	0.0196078
NODE_293698_length_251_cov_2.013158	152	203	4	8	51	0.1568628
NODE_293698_length_251_cov_2.013158	152	203	6	39	51	0.7647059
NODE_293698_length_251_cov_2.013158	152	201	0	1	49	0.0204082
NODE_293698_length_251_cov_2.013158	152	201	3	1	49	0.0204082
NODE_293698_length_251_cov_2.013158	152	201	4	8	49	0.1632653
NODE_293698_length_251_cov_2.013158	152	201	6	39	49	0.7959183
NODE_293919_length_251_cov_1.710526	135	194	2	17	59	0.2881356
NODE_293919_length_251_cov_1.710526	135	194	4	42	59	0.7118644
NODE_294028_length_251_cov_1.671053	94	127	0	33	33	1.0000000
NODE_294063_length_251_cov_1.644737	135	164	10	12	29	0.4137931
NODE_294063_length_251_cov_1.644737	135	164	12	10	29	0.3448276
NODE_294063_length_251_cov_1.644737	135	164	16	7	29	0.2413793
NODE_294147_length_251_cov_1.473684	137	202	0	65	65	1.0000000
NODE_294153_length_251_cov_1.460526	17	78	0	61	61	1.0000000
NODE_294190_length_251_cov_1.407895	182	246	2	64	64	1.0000000
NODE_294393_length_251_cov_1.342105	9	89	0	80	80	1.0000000
NODE_294393_length_251_cov_1.342105	62	91	0	29	29	1.0000000
NODE_294624_length_251_cov_1.296053	7	47	0	40	40	1.0000000
NODE_294624_length_251_cov_1.296053	24	47	0	23	23	1.0000000
NODE_295165_length_251_cov_1.006579	4	50	0	46	46	1.0000000
NODE_296033_length_251_cov_0.671053	184	204	0	20	20	1.0000000
NODE_296386_length_251_cov_0.572368	54	74	0	20	20	1.0000000
NODE_296437_length_250_cov_35.662252	33	99	0	66	66	1.0000000
NODE_296437_length_250_cov_35.662252	143	223	0	80	80	1.0000000
NODE_296456_length_250_cov_6.503311	186	250	0	64	64	1.0000000
NODE_296467_length_250_cov_5.867550	99	120	0	21	21	1.0000000
NODE_296520_length_250_cov_4.662252	143	187	0	44	44	1.0000000
NODE_296520_length_250_cov_4.662252	160	227	0	67	67	1.0000000
NODE_296598_length_250_cov_3.715232	37	90	0	53	53	1.0000000
NODE_296633_length_250_cov_3.417219	113	193	2	45	80	0.5625000
NODE_296633_length_250_cov_3.417219	113	193	4	35	80	0.4375000
NODE_296633_length_250_cov_3.417219	166	246	0	34	80	0.4250000
NODE_296633_length_250_cov_3.417219	166	246	2	46	80	0.5750000
NODE_296653_length_250_cov_3.364238	0	61	0	1	61	0.0163934
NODE_296653_length_250_cov_3.364238	0	61	4	3	61	0.0491803
NODE_296653_length_250_cov_3.364238	0	61	6	57	61	0.9344262
NODE_296653_length_250_cov_3.364238	34	94	6	60	60	1.0000000
NODE_296680_length_250_cov_3.225166	157	209	0	52	52	1.0000000
NODE_296680_length_250_cov_3.225166	182	250	0	68	68	1.0000000
NODE_296699_length_250_cov_3.086093	33	67	2	34	34	1.0000000
NODE_296703_length_250_cov_3.052980	29	94	4	3	65	0.0461538
NODE_296703_length_250_cov_3.052980	29	94	6	8	65	0.1230769
NODE_296703_length_250_cov_3.052980	29	94	8	2	65	0.0307692
NODE_296703_length_250_cov_3.052980	29	94	10	52	65	0.8000000
NODE_296707_length_250_cov_3.039735	51	106	0	21	55	0.3818182
NODE_296707_length_250_cov_3.039735	51	106	2	16	55	0.2909091
NODE_296707_length_250_cov_3.039735	51	106	4	18	55	0.3272727
NODE_296737_length_250_cov_2.986755	124	185	8	55	61	0.9016393
NODE_296737_length_250_cov_2.986755	124	185	10	6	61	0.0983607
NODE_296737_length_250_cov_2.986755	172	243	0	17	71	0.2394366
NODE_296737_length_250_cov_2.986755	172	243	4	3	71	0.0422535
NODE_296737_length_250_cov_2.986755	172	243	6	10	71	0.1408451
NODE_296737_length_250_cov_2.986755	172	243	8	41	71	0.5774648
NODE_296885_length_250_cov_2.516556	0	49	0	49	49	1.0000000
NODE_296893_length_250_cov_2.476821	94	174	0	80	80	1.0000000
NODE_296893_length_250_cov_2.476821	147	227	0	80	80	1.0000000
NODE_296897_length_250_cov_2.470199	166	212	0	46	46	1.0000000
NODE_297070_length_250_cov_2.059603	150	207	0	57	57	1.0000000
NODE_297211_length_250_cov_2.019868	74	141	16	16	67	0.2388060
NODE_297211_length_250_cov_2.019868	74	141	18	8	67	0.1194030
NODE_297211_length_250_cov_2.019868	74	141	20	5	67	0.0746269
NODE_297211_length_250_cov_2.019868	74	141	22	31	67	0.4626866
NODE_297211_length_250_cov_2.019868	74	141	24	3	67	0.0447761
NODE_297211_length_250_cov_2.019868	74	141	26	4	67	0.0597015
NODE_297211_length_250_cov_2.019868	158	204	11	1	46	0.0217391
NODE_297211_length_250_cov_2.019868	158	204	12	3	46	0.0652174
NODE_297211_length_250_cov_2.019868	158	204	14	7	46	0.1521739
NODE_297211_length_250_cov_2.019868	158	204	16	4	46	0.0869565
NODE_297211_length_250_cov_2.019868	158	204	18	12	46	0.2608696
NODE_297211_length_250_cov_2.019868	158	204	20	7	46	0.1521739
NODE_297211_length_250_cov_2.019868	158	204	22	12	46	0.2608696
NODE_297550_length_250_cov_1.688742	6	42	0	36	36	1.0000000
NODE_297624_length_250_cov_1.635762	150	191	2	41	41	1.0000000
NODE_297679_length_250_cov_1.529801	59	108	0	49	49	1.0000000
NODE_297679_length_250_cov_1.529801	81	161	0	80	80	1.0000000
NODE_297693_length_250_cov_1.516556	124	184	0	60	60	1.0000000
NODE_297693_length_250_cov_1.516556	166	237	0	71	71	1.0000000
NODE_297762_length_250_cov_1.377483	0	80	0	80	80	1.0000000
NODE_297963_length_250_cov_1.350993	40	98	0	58	58	1.0000000
NODE_298213_length_250_cov_1.291391	116	196	6	66	80	0.8250000
NODE_298213_length_250_cov_1.291391	116	196	7	13	80	0.1625000
NODE_298213_length_250_cov_1.291391	116	196	8	1	80	0.0125000
NODE_298719_length_250_cov_1.013245	126	163	0	37	37	1.0000000
NODE_298794_length_250_cov_1.006623	129	148	0	19	19	1.0000000
NODE_298900_length_250_cov_0.920530	126	178	20	7	52	0.1346154
NODE_298900_length_250_cov_0.920530	126	178	22	2	52	0.0384615
NODE_298900_length_250_cov_0.920530	126	178	24	17	52	0.3269231
NODE_298900_length_250_cov_0.920530	126	178	26	26	52	0.5000000
NODE_299979_length_249_cov_55.413333	97	172	0	75	75	1.0000000
NODE_299979_length_249_cov_55.413333	150	225	0	75	75	1.0000000
NODE_300012_length_247_cov_51.243243	172	247	0	75	75	1.0000000
NODE_300014_length_247_cov_37.614865	156	239	0	83	83	1.0000000
NODE_300056_length_245_cov_40.876712	138	202	80	4	64	0.0625000
NODE_300056_length_245_cov_40.876712	138	202	84	2	64	0.0312500
NODE_300056_length_245_cov_40.876712	138	202	90	1	64	0.0156250
NODE_300056_length_245_cov_40.876712	138	202	93	1	64	0.0156250
NODE_300056_length_245_cov_40.876712	138	202	106	2	64	0.0312500
NODE_300056_length_245_cov_40.876712	138	202	108	2	64	0.0312500
NODE_300056_length_245_cov_40.876712	138	202	112	2	64	0.0312500
NODE_300056_length_245_cov_40.876712	138	202	113	2	64	0.0312500
NODE_300056_length_245_cov_40.876712	138	202	114	1	64	0.0156250
NODE_300056_length_245_cov_40.876712	138	202	115	2	64	0.0312500
NODE_300056_length_245_cov_40.876712	138	202	127	1	64	0.0156250
NODE_300056_length_245_cov_40.876712	138	202	130	2	64	0.0312500
NODE_300056_length_245_cov_40.876712	138	202	133	3	64	0.0468750
NODE_300056_length_245_cov_40.876712	138	202	135	1	64	0.0156250
NODE_300056_length_245_cov_40.876712	138	202	138	1	64	0.0156250
NODE_300056_length_245_cov_40.876712	138	202	139	1	64	0.0156250
NODE_300056_length_245_cov_40.876712	138	202	143	2	64	0.0312500
NODE_300056_length_245_cov_40.876712	138	202	144	1	64	0.0156250
NODE_300056_length_245_cov_40.876712	138	202	145	8	64	0.1250000
NODE_300056_length_245_cov_40.876712	138	202	146	1	64	0.0156250
NODE_300056_length_245_cov_40.876712	138	202	148	1	64	0.0156250
NODE_300056_length_245_cov_40.876712	138	202	149	1	64	0.0156250
NODE_300056_length_245_cov_40.876712	138	202	150	1	64	0.0156250
NODE_300056_length_245_cov_40.876712	138	202	152	1	64	0.0156250
NODE_300056_length_245_cov_40.876712	138	202	153	1	64	0.0156250
NODE_300056_length_245_cov_40.876712	138	202	157	1	64	0.0156250
NODE_300056_length_245_cov_40.876712	138	202	158	2	64	0.0312500
NODE_300056_length_245_cov_40.876712	138	202	170	1	64	0.0156250
NODE_300056_length_245_cov_40.876712	138	202	171	1	64	0.0156250
NODE_300056_length_245_cov_40.876712	138	202	173	1	64	0.0156250
NODE_300056_length_245_cov_40.876712	138	202	175	1	64	0.0156250
NODE_300056_length_245_cov_40.876712	138	202	176	2	64	0.0312500
NODE_300056_length_245_cov_40.876712	138	202	177	1	64	0.0156250
NODE_300056_length_245_cov_40.876712	138	202	179	1	64	0.0156250
NODE_300056_length_245_cov_40.876712	138	202	180	4	64	0.0625000
NODE_300056_length_245_cov_40.876712	138	202	182	1	64	0.0156250
NODE_300056_length_245_cov_40.876712	138	202	184	1	64	0.0156250
NODE_300056_length_245_cov_40.876712	138	202	187	2	64	0.0312500
NODE_300056_length_245_cov_40.876712	138	202	80	4	64	0.0625000
NODE_300056_length_245_cov_40.876712	138	202	84	2	64	0.0312500
NODE_300056_length_245_cov_40.876712	138	202	90	1	64	0.0156250
NODE_300056_length_245_cov_40.876712	138	202	93	1	64	0.0156250
NODE_300056_length_245_cov_40.876712	138	202	106	2	64	0.0312500
NODE_300056_length_245_cov_40.876712	138	202	108	2	64	0.0312500
NODE_300056_length_245_cov_40.876712	138	202	112	2	64	0.0312500
NODE_300056_length_245_cov_40.876712	138	202	113	2	64	0.0312500
NODE_300056_length_245_cov_40.876712	138	202	114	1	64	0.0156250
NODE_300056_length_245_cov_40.876712	138	202	115	2	64	0.0312500
NODE_300056_length_245_cov_40.876712	138	202	127	1	64	0.0156250
NODE_300056_length_245_cov_40.876712	138	202	130	2	64	0.0312500
NODE_300056_length_245_cov_40.876712	138	202	133	3	64	0.0468750
NODE_300056_length_245_cov_40.876712	138	202	135	1	64	0.0156250
NODE_300056_length_245_cov_40.876712	138	202	138	1	64	0.0156250
NODE_300056_length_245_cov_40.876712	138	202	139	1	64	0.0156250
NODE_300056_length_245_cov_40.876712	138	202	143	2	64	0.0312500
NODE_300056_length_245_cov_40.876712	138	202	144	1	64	0.0156250
NODE_300056_length_245_cov_40.876712	138	202	145	8	64	0.1250000
NODE_300056_length_245_cov_40.876712	138	202	146	1	64	0.0156250
NODE_300056_length_245_cov_40.876712	138	202	148	1	64	0.0156250
NODE_300056_length_245_cov_40.876712	138	202	149	1	64	0.0156250
NODE_300056_length_245_cov_40.876712	138	202	150	1	64	0.0156250
NODE_300056_length_245_cov_40.876712	138	202	152	1	64	0.0156250
NODE_300056_length_245_cov_40.876712	138	202	153	1	64	0.0156250
NODE_300056_length_245_cov_40.876712	138	202	157	1	64	0.0156250
NODE_300056_length_245_cov_40.876712	138	202	158	2	64	0.0312500
NODE_300056_length_245_cov_40.876712	138	202	170	1	64	0.0156250
NODE_300056_length_245_cov_40.876712	138	202	171	1	64	0.0156250
NODE_300056_length_245_cov_40.876712	138	202	173	1	64	0.0156250
NODE_300056_length_245_cov_40.876712	138	202	175	1	64	0.0156250
NODE_300056_length_245_cov_40.876712	138	202	176	2	64	0.0312500
NODE_300056_length_245_cov_40.876712	138	202	177	1	64	0.0156250
NODE_300056_length_245_cov_40.876712	138	202	179	1	64	0.0156250
NODE_300056_length_245_cov_40.876712	138	202	180	4	64	0.0625000
NODE_300056_length_245_cov_40.876712	138	202	182	1	64	0.0156250
NODE_300056_length_245_cov_40.876712	138	202	184	1	64	0.0156250
NODE_300056_length_245_cov_40.876712	138	202	187	2	64	0.0312500
NODE_300056_length_245_cov_40.876712	138	202	80	4	64	0.0625000
NODE_300056_length_245_cov_40.876712	138	202	84	2	64	0.0312500
NODE_300056_length_245_cov_40.876712	138	202	90	1	64	0.0156250
NODE_300056_length_245_cov_40.876712	138	202	93	1	64	0.0156250
NODE_300056_length_245_cov_40.876712	138	202	106	2	64	0.0312500
NODE_300056_length_245_cov_40.876712	138	202	108	2	64	0.0312500
NODE_300056_length_245_cov_40.876712	138	202	112	2	64	0.0312500
NODE_300056_length_245_cov_40.876712	138	202	113	2	64	0.0312500
NODE_300056_length_245_cov_40.876712	138	202	114	1	64	0.0156250
NODE_300056_length_245_cov_40.876712	138	202	115	2	64	0.0312500
NODE_300056_length_245_cov_40.876712	138	202	127	1	64	0.0156250
NODE_300056_length_245_cov_40.876712	138	202	130	2	64	0.0312500
NODE_300056_length_245_cov_40.876712	138	202	133	3	64	0.0468750
NODE_300056_length_245_cov_40.876712	138	202	135	1	64	0.0156250
NODE_300056_length_245_cov_40.876712	138	202	138	1	64	0.0156250
NODE_300056_length_245_cov_40.876712	138	202	139	1	64	0.0156250
NODE_300056_length_245_cov_40.876712	138	202	143	2	64	0.0312500
NODE_300056_length_245_cov_40.876712	138	202	144	1	64	0.0156250
NODE_300056_length_245_cov_40.876712	138	202	145	8	64	0.1250000
NODE_300056_length_245_cov_40.876712	138	202	146	1	64	0.0156250
NODE_300056_length_245_cov_40.876712	138	202	148	1	64	0.0156250
NODE_300056_length_245_cov_40.876712	138	202	149	1	64	0.0156250
NODE_300056_length_245_cov_40.876712	138	202	150	1	64	0.0156250
NODE_300056_length_245_cov_40.876712	138	202	152	1	64	0.0156250
NODE_300056_length_245_cov_40.876712	138	202	153	1	64	0.0156250
NODE_300056_length_245_cov_40.876712	138	202	157	1	64	0.0156250
NODE_300056_length_245_cov_40.876712	138	202	158	2	64	0.0312500
NODE_300056_length_245_cov_40.876712	138	202	170	1	64	0.0156250
NODE_300056_length_245_cov_40.876712	138	202	171	1	64	0.0156250
NODE_300056_length_245_cov_40.876712	138	202	173	1	64	0.0156250
NODE_300056_length_245_cov_40.876712	138	202	175	1	64	0.0156250
NODE_300056_length_245_cov_40.876712	138	202	176	2	64	0.0312500
NODE_300056_length_245_cov_40.876712	138	202	177	1	64	0.0156250
NODE_300056_length_245_cov_40.876712	138	202	179	1	64	0.0156250
NODE_300056_length_245_cov_40.876712	138	202	180	4	64	0.0625000
NODE_300056_length_245_cov_40.876712	138	202	182	1	64	0.0156250
NODE_300056_length_245_cov_40.876712	138	202	184	1	64	0.0156250
NODE_300056_length_245_cov_40.876712	138	202	187	2	64	0.0312500
NODE_300056_length_245_cov_40.876712	175	241	17	1	66	0.0151515
NODE_300056_length_245_cov_40.876712	175	241	21	1	66	0.0151515
NODE_300056_length_245_cov_40.876712	175	241	25	1	66	0.0151515
NODE_300056_length_245_cov_40.876712	175	241	27	3	66	0.0454545
NODE_300056_length_245_cov_40.876712	175	241	28	1	66	0.0151515
NODE_300056_length_245_cov_40.876712	175	241	30	1	66	0.0151515
NODE_300056_length_245_cov_40.876712	175	241	40	1	66	0.0151515
NODE_300056_length_245_cov_40.876712	175	241	44	1	66	0.0151515
NODE_300056_length_245_cov_40.876712	175	241	45	2	66	0.0303030
NODE_300056_length_245_cov_40.876712	175	241	48	1	66	0.0151515
NODE_300056_length_245_cov_40.876712	175	241	50	5	66	0.0757576
NODE_300056_length_245_cov_40.876712	175	241	52	1	66	0.0151515
NODE_300056_length_245_cov_40.876712	175	241	53	1	66	0.0151515
NODE_300056_length_245_cov_40.876712	175	241	55	1	66	0.0151515
NODE_300056_length_245_cov_40.876712	175	241	56	1	66	0.0151515
NODE_300056_length_245_cov_40.876712	175	241	59	1	66	0.0151515
NODE_300056_length_245_cov_40.876712	175	241	62	1	66	0.0151515
NODE_300056_length_245_cov_40.876712	175	241	63	1	66	0.0151515
NODE_300056_length_245_cov_40.876712	175	241	65	4	66	0.0606061
NODE_300056_length_245_cov_40.876712	175	241	66	1	66	0.0151515
NODE_300056_length_245_cov_40.876712	175	241	71	5	66	0.0757576
NODE_300056_length_245_cov_40.876712	175	241	74	1	66	0.0151515
NODE_300056_length_245_cov_40.876712	175	241	79	1	66	0.0151515
NODE_300056_length_245_cov_40.876712	175	241	80	6	66	0.0909091
NODE_300056_length_245_cov_40.876712	175	241	84	2	66	0.0303030
NODE_300056_length_245_cov_40.876712	175	241	90	1	66	0.0151515
NODE_300056_length_245_cov_40.876712	175	241	93	1	66	0.0151515
NODE_300056_length_245_cov_40.876712	175	241	106	2	66	0.0303030
NODE_300056_length_245_cov_40.876712	175	241	108	2	66	0.0303030
NODE_300056_length_245_cov_40.876712	175	241	112	2	66	0.0303030
NODE_300056_length_245_cov_40.876712	175	241	113	2	66	0.0303030
NODE_300056_length_245_cov_40.876712	175	241	114	1	66	0.0151515
NODE_300056_length_245_cov_40.876712	175	241	115	2	66	0.0303030
NODE_300056_length_245_cov_40.876712	175	241	127	1	66	0.0151515
NODE_300056_length_245_cov_40.876712	175	241	130	2	66	0.0303030
NODE_300056_length_245_cov_40.876712	175	241	133	3	66	0.0454545
NODE_300056_length_245_cov_40.876712	175	241	135	1	66	0.0151515
NODE_300056_length_245_cov_40.876712	175	241	138	1	66	0.0151515
NODE_300147_length_240_cov_80.744681	167	238	0	2	71	0.0281690
NODE_300147_length_240_cov_80.744681	167	238	2	1	71	0.0140845
NODE_300147_length_240_cov_80.744681	167	238	3	51	71	0.7183099
NODE_300147_length_240_cov_80.744681	167	238	11	6	71	0.0845070
NODE_300147_length_240_cov_80.744681	167	238	15	7	71	0.0985916
NODE_300147_length_240_cov_80.744681	167	238	16	4	71	0.0563380
NODE_300148_length_240_cov_38.035461	31	82	2	8	51	0.1568628
NODE_300148_length_240_cov_38.035461	31	82	7	1	51	0.0196078
NODE_300148_length_240_cov_38.035461	31	82	8	7	51	0.1372549
NODE_300148_length_240_cov_38.035461	31	82	10	20	51	0.3921569
NODE_300148_length_240_cov_38.035461	31	82	12	15	51	0.2941177
NODE_300165_length_239_cov_72.878571	0	48	0	48	48	1.0000000
NODE_300165_length_239_cov_72.878571	21	101	0	66	80	0.8250000
NODE_300165_length_239_cov_72.878571	21	101	2	8	80	0.1000000
NODE_300165_length_239_cov_72.878571	21	101	4	1	80	0.0125000
NODE_300165_length_239_cov_72.878571	21	101	5	5	80	0.0625000
NODE_300165_length_239_cov_72.878571	150	230	0	18	80	0.2250000
NODE_300165_length_239_cov_72.878571	150	230	4	5	80	0.0625000
NODE_300165_length_239_cov_72.878571	150	230	7	9	80	0.1125000
NODE_300165_length_239_cov_72.878571	150	230	11	25	80	0.3125000
NODE_300165_length_239_cov_72.878571	150	230	13	23	80	0.2875000
NODE_300165_length_239_cov_72.878571	150	230	0	18	80	0.2250000
NODE_300165_length_239_cov_72.878571	150	230	4	5	80	0.0625000
NODE_300165_length_239_cov_72.878571	150	230	7	9	80	0.1125000
NODE_300165_length_239_cov_72.878571	150	230	11	25	80	0.3125000
NODE_300165_length_239_cov_72.878571	150	230	13	23	80	0.2875000
NODE_300165_length_239_cov_72.878571	150	212	4	5	62	0.0806452
NODE_300165_length_239_cov_72.878571	150	212	7	9	62	0.1451613
NODE_300165_length_239_cov_72.878571	150	212	11	25	62	0.4032258
NODE_300165_length_239_cov_72.878571	150	212	13	23	62	0.3709677
NODE_300165_length_239_cov_72.878571	150	221	0	9	71	0.1267606
NODE_300165_length_239_cov_72.878571	150	221	4	5	71	0.0704225
NODE_300165_length_239_cov_72.878571	150	221	7	9	71	0.1267606
NODE_300165_length_239_cov_72.878571	150	221	11	25	71	0.3521127
NODE_300165_length_239_cov_72.878571	150	221	13	23	71	0.3239437
NODE_300208_length_238_cov_385.683453	35	104	64	2	69	0.0289855
NODE_300208_length_238_cov_385.683453	35	104	68	3	69	0.0434783
NODE_300208_length_238_cov_385.683453	35	104	74	1	69	0.0144928
NODE_300208_length_238_cov_385.683453	35	104	78	2	69	0.0289855
NODE_300208_length_238_cov_385.683453	35	104	81	1	69	0.0144928
NODE_300208_length_238_cov_385.683453	35	104	82	3	69	0.0434783
NODE_300208_length_238_cov_385.683453	35	104	84	1	69	0.0144928
NODE_300208_length_238_cov_385.683453	35	104	85	1	69	0.0144928
NODE_300208_length_238_cov_385.683453	35	104	91	4	69	0.0579710
NODE_300208_length_238_cov_385.683453	35	104	93	3	69	0.0434783
NODE_300208_length_238_cov_385.683453	35	104	94	1	69	0.0144928
NODE_300208_length_238_cov_385.683453	35	104	102	1	69	0.0144928
NODE_300208_length_238_cov_385.683453	35	104	105	1	69	0.0144928
NODE_300208_length_238_cov_385.683453	35	104	111	1	69	0.0144928
NODE_300208_length_238_cov_385.683453	35	104	113	1	69	0.0144928
NODE_300208_length_238_cov_385.683453	35	104	117	1	69	0.0144928
NODE_300208_length_238_cov_385.683453	35	104	118	2	69	0.0289855
NODE_300208_length_238_cov_385.683453	35	104	119	1	69	0.0144928
NODE_300208_length_238_cov_385.683453	35	104	123	1	69	0.0144928
NODE_300208_length_238_cov_385.683453	35	104	124	1	69	0.0144928
NODE_300208_length_238_cov_385.683453	35	104	126	3	69	0.0434783
NODE_300208_length_238_cov_385.683453	35	104	128	1	69	0.0144928
NODE_300208_length_238_cov_385.683453	35	104	132	1	69	0.0144928
NODE_300208_length_238_cov_385.683453	35	104	133	1	69	0.0144928
NODE_300208_length_238_cov_385.683453	35	104	134	3	69	0.0434783
NODE_300208_length_238_cov_385.683453	35	104	135	1	69	0.0144928
NODE_300208_length_238_cov_385.683453	35	104	136	3	69	0.0434783
NODE_300208_length_238_cov_385.683453	35	104	138	2	69	0.0289855
NODE_300208_length_238_cov_385.683453	35	104	142	11	69	0.1594203
NODE_300208_length_238_cov_385.683453	35	104	143	4	69	0.0579710
NODE_300208_length_238_cov_385.683453	35	104	145	2	69	0.0289855
NODE_300208_length_238_cov_385.683453	35	104	147	4	69	0.0579710
NODE_300208_length_238_cov_385.683453	35	104	148	1	69	0.0144928
NODE_300225_length_237_cov_101.543478	83	163	10	35	80	0.4375000
NODE_300225_length_237_cov_101.543478	83	163	12	45	80	0.5625000
NODE_300225_length_237_cov_101.543478	83	163	10	35	80	0.4375000
NODE_300225_length_237_cov_101.543478	83	163	12	45	80	0.5625000
NODE_300225_length_237_cov_101.543478	83	163	10	35	80	0.4375000
NODE_300225_length_237_cov_101.543478	83	163	12	45	80	0.5625000
NODE_300225_length_237_cov_101.543478	83	163	10	35	80	0.4375000
NODE_300225_length_237_cov_101.543478	83	163	12	45	80	0.5625000
NODE_300225_length_237_cov_101.543478	136	216	10	80	80	1.0000000
NODE_300225_length_237_cov_101.543478	136	216	10	80	80	1.0000000
NODE_300225_length_237_cov_101.543478	136	216	10	80	80	1.0000000
NODE_300225_length_237_cov_101.543478	138	216	10	78	78	1.0000000
NODE_300225_length_237_cov_101.543478	138	216	10	78	78	1.0000000
NODE_300227_length_237_cov_49.623188	13	88	0	75	75	1.0000000
NODE_300227_length_237_cov_49.623188	73	153	0	80	80	1.0000000
NODE_300227_length_237_cov_49.623188	126	206	0	80	80	1.0000000
NODE_300289_length_235_cov_67.904412	0	62	0	62	62	1.0000000
NODE_300289_length_235_cov_67.904412	25	111	0	79	86	0.9186047
NODE_300289_length_235_cov_67.904412	25	111	2	7	86	0.0813954
NODE_300289_length_235_cov_67.904412	69	150	0	35	81	0.4320988
NODE_300289_length_235_cov_67.904412	69	150	2	46	81	0.5679013
NODE_300289_length_235_cov_67.904412	113	194	2	81	81	1.0000000
NODE_300289_length_235_cov_67.904412	157	235	0	20	78	0.2564103
NODE_300289_length_235_cov_67.904412	157	235	2	58	78	0.7435898
NODE_300322_length_234_cov_76.496296	0	76	0	69	76	0.9078947
NODE_300322_length_234_cov_76.496296	0	76	2	7	76	0.0921053
NODE_300322_length_234_cov_76.496296	0	76	0	69	76	0.9078947
NODE_300322_length_234_cov_76.496296	0	76	2	7	76	0.0921053
NODE_300322_length_234_cov_76.496296	0	76	0	69	76	0.9078947
NODE_300322_length_234_cov_76.496296	0	76	2	7	76	0.0921053
NODE_300322_length_234_cov_76.496296	0	76	0	69	76	0.9078947
NODE_300322_length_234_cov_76.496296	0	76	2	7	76	0.0921053
NODE_300322_length_234_cov_76.496296	49	128	0	20	79	0.2531646
NODE_300322_length_234_cov_76.496296	49	128	2	48	79	0.6075949
NODE_300322_length_234_cov_76.496296	49	128	4	6	79	0.0759494
NODE_300322_length_234_cov_76.496296	49	128	18	5	79	0.0632911
NODE_300322_length_234_cov_76.496296	49	128	0	20	79	0.2531646
NODE_300322_length_234_cov_76.496296	49	128	2	48	79	0.6075949
NODE_300322_length_234_cov_76.496296	49	128	4	6	79	0.0759494
NODE_300322_length_234_cov_76.496296	49	128	18	5	79	0.0632911
NODE_300322_length_234_cov_76.496296	124	204	13	10	80	0.1250000
NODE_300322_length_234_cov_76.496296	124	204	15	10	80	0.1250000
NODE_300322_length_234_cov_76.496296	124	204	17	2	80	0.0250000
NODE_300322_length_234_cov_76.496296	124	204	18	37	80	0.4625000
NODE_300322_length_234_cov_76.496296	124	204	20	21	80	0.2625000
NODE_300322_length_234_cov_76.496296	124	204	13	10	80	0.1250000
NODE_300322_length_234_cov_76.496296	124	204	15	10	80	0.1250000
NODE_300322_length_234_cov_76.496296	124	204	17	2	80	0.0250000
NODE_300322_length_234_cov_76.496296	124	204	18	37	80	0.4625000
NODE_300322_length_234_cov_76.496296	124	204	20	21	80	0.2625000
NODE_300322_length_234_cov_76.496296	124	204	13	10	80	0.1250000
NODE_300322_length_234_cov_76.496296	124	204	15	10	80	0.1250000
NODE_300322_length_234_cov_76.496296	124	204	17	2	80	0.0250000
NODE_300322_length_234_cov_76.496296	124	204	18	37	80	0.4625000
NODE_300322_length_234_cov_76.496296	124	204	20	21	80	0.2625000
NODE_300322_length_234_cov_76.496296	177	226	0	6	49	0.1224490
NODE_300322_length_234_cov_76.496296	177	226	12	11	49	0.2244898
NODE_300322_length_234_cov_76.496296	177	226	13	15	49	0.3061225
NODE_300322_length_234_cov_76.496296	177	226	15	10	49	0.2040816
NODE_300322_length_234_cov_76.496296	177	226	17	2	49	0.0408163
NODE_300322_length_234_cov_76.496296	177	226	18	5	49	0.1020408
NODE_300322_length_234_cov_76.496296	177	234	0	14	57	0.2456140
NODE_300322_length_234_cov_76.496296	177	234	12	11	57	0.1929825
NODE_300322_length_234_cov_76.496296	177	234	13	15	57	0.2631579
NODE_300322_length_234_cov_76.496296	177	234	15	10	57	0.1754386
NODE_300322_length_234_cov_76.496296	177	234	17	2	57	0.0350877
NODE_300322_length_234_cov_76.496296	177	234	18	5	57	0.0877193
NODE_300322_length_234_cov_76.496296	182	234	0	14	52	0.2692308
NODE_300322_length_234_cov_76.496296	182	234	12	11	52	0.2115385
NODE_300322_length_234_cov_76.496296	182	234	13	15	52	0.2884615
NODE_300322_length_234_cov_76.496296	182	234	15	10	52	0.1923077
NODE_300322_length_234_cov_76.496296	182	234	17	2	52	0.0384615
NODE_300323_length_234_cov_71.548148	90	162	4	30	72	0.4166667
NODE_300323_length_234_cov_71.548148	90	162	6	12	72	0.1666667
NODE_300323_length_234_cov_71.548148	90	162	10	30	72	0.4166667
NODE_300323_length_234_cov_71.548148	90	162	4	30	72	0.4166667
NODE_300323_length_234_cov_71.548148	90	162	6	12	72	0.1666667
NODE_300323_length_234_cov_71.548148	90	162	10	30	72	0.4166667
NODE_300323_length_234_cov_71.548148	135	215	2	2	80	0.0250000
NODE_300323_length_234_cov_71.548148	135	215	6	21	80	0.2625000
NODE_300323_length_234_cov_71.548148	135	215	10	57	80	0.7125000
NODE_300323_length_234_cov_71.548148	135	215	2	2	80	0.0250000
NODE_300323_length_234_cov_71.548148	135	215	6	21	80	0.2625000
NODE_300323_length_234_cov_71.548148	135	215	10	57	80	0.7125000
NODE_300357_length_233_cov_180.701493	0	65	0	6	65	0.0923077
NODE_300357_length_233_cov_180.701493	0	65	1	1	65	0.0153846
NODE_300357_length_233_cov_180.701493	0	65	2	58	65	0.8923077
NODE_300357_length_233_cov_180.701493	38	118	2	80	80	1.0000000
NODE_300392_length_232_cov_132.045113	53	133	2	7	80	0.0875000
NODE_300392_length_232_cov_132.045113	53	133	4	23	80	0.2875000
NODE_300392_length_232_cov_132.045113	53	133	12	1	80	0.0125000
NODE_300392_length_232_cov_132.045113	53	133	13	10	80	0.1250000
NODE_300392_length_232_cov_132.045113	53	133	14	18	80	0.2250000
NODE_300392_length_232_cov_132.045113	53	133	15	6	80	0.0750000
NODE_300392_length_232_cov_132.045113	53	133	16	15	80	0.1875000
NODE_300392_length_232_cov_132.045113	106	186	11	8	80	0.1000000
NODE_300392_length_232_cov_132.045113	106	186	12	2	80	0.0250000
NODE_300392_length_232_cov_132.045113	106	186	14	15	80	0.1875000
NODE_300392_length_232_cov_132.045113	106	186	16	55	80	0.6875000
NODE_300471_length_230_cov_34.427481	0	59	0	59	59	1.0000000
NODE_300471_length_230_cov_34.427481	0	59	0	59	59	1.0000000
NODE_300471_length_230_cov_34.427481	10	59	0	49	49	1.0000000
NODE_300487_length_229_cov_76.907692	94	176	50	7	82	0.0853659
NODE_300487_length_229_cov_76.907692	94	176	52	1	82	0.0121951
NODE_300487_length_229_cov_76.907692	94	176	54	5	82	0.0609756
NODE_300487_length_229_cov_76.907692	94	176	55	1	82	0.0121951
NODE_300487_length_229_cov_76.907692	94	176	57	5	82	0.0609756
NODE_300487_length_229_cov_76.907692	94	176	59	1	82	0.0121951
NODE_300487_length_229_cov_76.907692	94	176	61	1	82	0.0121951
NODE_300487_length_229_cov_76.907692	94	176	63	6	82	0.0731707
NODE_300487_length_229_cov_76.907692	94	176	67	2	82	0.0243902
NODE_300487_length_229_cov_76.907692	94	176	69	8	82	0.0975610
NODE_300487_length_229_cov_76.907692	94	176	77	2	82	0.0243902
NODE_300487_length_229_cov_76.907692	94	176	79	19	82	0.2317073
NODE_300487_length_229_cov_76.907692	94	176	81	9	82	0.1097561
NODE_300487_length_229_cov_76.907692	94	176	83	6	82	0.0731707
NODE_300487_length_229_cov_76.907692	94	176	85	9	82	0.1097561
NODE_300523_length_228_cov_127.131783	0	76	5	4	76	0.0526316
NODE_300523_length_228_cov_127.131783	0	76	6	7	76	0.0921053
NODE_300523_length_228_cov_127.131783	0	76	7	42	76	0.5526316
NODE_300523_length_228_cov_127.131783	0	76	9	2	76	0.0263158
NODE_300523_length_228_cov_127.131783	0	76	10	20	76	0.2631579
NODE_300523_length_228_cov_127.131783	0	76	12	1	76	0.0131579
NODE_300523_length_228_cov_127.131783	5	76	6	6	71	0.0845070
NODE_300523_length_228_cov_127.131783	5	76	7	42	71	0.5915493
NODE_300523_length_228_cov_127.131783	5	76	9	2	71	0.0281690
NODE_300523_length_228_cov_127.131783	5	76	10	20	71	0.2816902
NODE_300523_length_228_cov_127.131783	5	76	12	1	71	0.0140845
NODE_300523_length_228_cov_127.131783	10	76	6	1	66	0.0151515
NODE_300523_length_228_cov_127.131783	10	76	7	42	66	0.6363636
NODE_300523_length_228_cov_127.131783	10	76	9	2	66	0.0303030
NODE_300523_length_228_cov_127.131783	10	76	10	20	66	0.3030303
NODE_300523_length_228_cov_127.131783	10	76	12	1	66	0.0151515
NODE_300523_length_228_cov_127.131783	49	129	2	17	80	0.2125000
NODE_300523_length_228_cov_127.131783	49	129	4	1	80	0.0125000
NODE_300523_length_228_cov_127.131783	49	129	7	4	80	0.0500000
NODE_300523_length_228_cov_127.131783	49	129	9	2	80	0.0250000
NODE_300523_length_228_cov_127.131783	49	129	10	27	80	0.3375000
NODE_300523_length_228_cov_127.131783	49	129	12	29	80	0.3625000
NODE_300523_length_228_cov_127.131783	49	129	2	17	80	0.2125000
NODE_300523_length_228_cov_127.131783	49	129	4	1	80	0.0125000
NODE_300523_length_228_cov_127.131783	49	129	7	4	80	0.0500000
NODE_300523_length_228_cov_127.131783	49	129	9	2	80	0.0250000
NODE_300523_length_228_cov_127.131783	49	129	10	27	80	0.3375000
NODE_300523_length_228_cov_127.131783	49	129	12	29	80	0.3625000
NODE_300523_length_228_cov_127.131783	49	129	2	17	80	0.2125000
NODE_300523_length_228_cov_127.131783	49	129	4	1	80	0.0125000
NODE_300523_length_228_cov_127.131783	49	129	7	4	80	0.0500000
NODE_300523_length_228_cov_127.131783	49	129	9	2	80	0.0250000
NODE_300523_length_228_cov_127.131783	49	129	10	27	80	0.3375000
NODE_300523_length_228_cov_127.131783	49	129	12	29	80	0.3625000
NODE_300523_length_228_cov_127.131783	125	205	2	80	80	1.0000000
NODE_300523_length_228_cov_127.131783	125	205	2	80	80	1.0000000
NODE_300523_length_228_cov_127.131783	125	205	2	80	80	1.0000000
NODE_300523_length_228_cov_127.131783	178	228	0	2	50	0.0400000
NODE_300523_length_228_cov_127.131783	178	228	2	48	50	0.9600000
NODE_300523_length_228_cov_127.131783	178	228	0	2	50	0.0400000
NODE_300523_length_228_cov_127.131783	178	228	2	48	50	0.9600000
NODE_300523_length_228_cov_127.131783	178	228	0	2	50	0.0400000
NODE_300523_length_228_cov_127.131783	178	228	2	48	50	0.9600000
NODE_300524_length_228_cov_94.255814	34	99	5	4	65	0.0615385
NODE_300524_length_228_cov_94.255814	34	99	6	40	65	0.6153846
NODE_300524_length_228_cov_94.255814	34	99	7	6	65	0.0923077
NODE_300524_length_228_cov_94.255814	34	99	10	15	65	0.2307692
NODE_300524_length_228_cov_94.255814	34	114	5	4	80	0.0500000
NODE_300524_length_228_cov_94.255814	34	114	6	40	80	0.5000000
NODE_300524_length_228_cov_94.255814	34	114	7	6	80	0.0750000
NODE_300524_length_228_cov_94.255814	34	114	8	3	80	0.0375000
NODE_300524_length_228_cov_94.255814	34	114	10	27	80	0.3375000
NODE_300524_length_228_cov_94.255814	41	111	6	37	70	0.5285714
NODE_300524_length_228_cov_94.255814	41	111	7	6	70	0.0857143
NODE_300524_length_228_cov_94.255814	41	111	10	27	70	0.3857143
NODE_300524_length_228_cov_94.255814	43	114	6	35	71	0.4929577
NODE_300524_length_228_cov_94.255814	43	114	7	6	71	0.0845070
NODE_300524_length_228_cov_94.255814	43	114	8	3	71	0.0422535
NODE_300524_length_228_cov_94.255814	43	114	10	27	71	0.3802817
NODE_300524_length_228_cov_94.255814	87	167	6	25	80	0.3125000
NODE_300524_length_228_cov_94.255814	87	167	8	31	80	0.3875000
NODE_300524_length_228_cov_94.255814	87	167	10	24	80	0.3000000
NODE_300524_length_228_cov_94.255814	87	167	6	25	80	0.3125000
NODE_300524_length_228_cov_94.255814	87	167	8	31	80	0.3875000
NODE_300524_length_228_cov_94.255814	87	167	10	24	80	0.3000000
NODE_300524_length_228_cov_94.255814	87	167	6	25	80	0.3125000
NODE_300524_length_228_cov_94.255814	87	167	8	31	80	0.3875000
NODE_300524_length_228_cov_94.255814	87	167	10	24	80	0.3000000
NODE_300524_length_228_cov_94.255814	87	167	6	25	80	0.3125000
NODE_300524_length_228_cov_94.255814	87	167	8	31	80	0.3875000
NODE_300524_length_228_cov_94.255814	87	167	10	24	80	0.3000000
NODE_300547_length_228_cov_0.395349	27	107	0	80	80	1.0000000
NODE_300547_length_228_cov_0.395349	70	150	0	80	80	1.0000000
NODE_300556_length_227_cov_37.429688	40	111	0	71	71	1.0000000
NODE_300556_length_227_cov_37.429688	49	112	0	63	63	1.0000000
NODE_300556_length_227_cov_37.429688	93	172	0	79	79	1.0000000
NODE_300556_length_227_cov_37.429688	168	227	0	59	59	1.0000000
NODE_300556_length_227_cov_37.429688	168	227	0	59	59	1.0000000
NODE_300595_length_226_cov_547.629921	82	162	1067	1	80	0.0125000
NODE_300595_length_226_cov_547.629921	82	162	1070	1	80	0.0125000
NODE_300595_length_226_cov_547.629921	82	162	1087	1	80	0.0125000
NODE_300595_length_226_cov_547.629921	82	162	1092	1	80	0.0125000
NODE_300595_length_226_cov_547.629921	82	162	1101	1	80	0.0125000
NODE_300595_length_226_cov_547.629921	82	162	1102	1	80	0.0125000
NODE_300595_length_226_cov_547.629921	82	162	1128	1	80	0.0125000
NODE_300595_length_226_cov_547.629921	82	162	1135	1	80	0.0125000
NODE_300595_length_226_cov_547.629921	82	162	1141	1	80	0.0125000
NODE_300595_length_226_cov_547.629921	82	162	1142	1	80	0.0125000
NODE_300595_length_226_cov_547.629921	82	162	1143	1	80	0.0125000
NODE_300595_length_226_cov_547.629921	82	162	1164	1	80	0.0125000
NODE_300595_length_226_cov_547.629921	82	162	1165	1	80	0.0125000
NODE_300595_length_226_cov_547.629921	82	162	1168	1	80	0.0125000
NODE_300595_length_226_cov_547.629921	82	162	1181	1	80	0.0125000
NODE_300595_length_226_cov_547.629921	82	162	1191	1	80	0.0125000
NODE_300595_length_226_cov_547.629921	82	162	1193	1	80	0.0125000
NODE_300595_length_226_cov_547.629921	82	162	1195	1	80	0.0125000
NODE_300595_length_226_cov_547.629921	82	162	1199	1	80	0.0125000
NODE_300595_length_226_cov_547.629921	82	162	1203	1	80	0.0125000
NODE_300595_length_226_cov_547.629921	82	162	1206	1	80	0.0125000
NODE_300595_length_226_cov_547.629921	82	162	1213	1	80	0.0125000
NODE_300595_length_226_cov_547.629921	82	162	1218	1	80	0.0125000
NODE_300595_length_226_cov_547.629921	82	162	1219	1	80	0.0125000
NODE_300595_length_226_cov_547.629921	82	162	1220	1	80	0.0125000
NODE_300595_length_226_cov_547.629921	82	162	1236	1	80	0.0125000
NODE_300595_length_226_cov_547.629921	82	162	1237	1	80	0.0125000
NODE_300595_length_226_cov_547.629921	82	162	1240	1	80	0.0125000
NODE_300595_length_226_cov_547.629921	82	162	1242	1	80	0.0125000
NODE_300595_length_226_cov_547.629921	82	162	1266	1	80	0.0125000
NODE_300595_length_226_cov_547.629921	82	162	1268	1	80	0.0125000
NODE_300595_length_226_cov_547.629921	82	162	1289	1	80	0.0125000
NODE_300595_length_226_cov_547.629921	82	162	1294	1	80	0.0125000
NODE_300595_length_226_cov_547.629921	82	162	1295	1	80	0.0125000
NODE_300595_length_226_cov_547.629921	82	162	1299	1	80	0.0125000
NODE_300595_length_226_cov_547.629921	82	162	1309	1	80	0.0125000
NODE_300595_length_226_cov_547.629921	82	162	1311	1	80	0.0125000
NODE_300595_length_226_cov_547.629921	82	162	1316	1	80	0.0125000
NODE_300595_length_226_cov_547.629921	82	162	1322	1	80	0.0125000
NODE_300595_length_226_cov_547.629921	82	162	1323	2	80	0.0250000
NODE_300595_length_226_cov_547.629921	82	162	1328	1	80	0.0125000
NODE_300595_length_226_cov_547.629921	82	162	1331	2	80	0.0250000
NODE_300595_length_226_cov_547.629921	82	162	1337	1	80	0.0125000
NODE_300595_length_226_cov_547.629921	82	162	1341	2	80	0.0250000
NODE_300595_length_226_cov_547.629921	82	162	1343	1	80	0.0125000
NODE_300595_length_226_cov_547.629921	82	162	1344	1	80	0.0125000
NODE_300595_length_226_cov_547.629921	82	162	1345	1	80	0.0125000
NODE_300595_length_226_cov_547.629921	82	162	1350	1	80	0.0125000
NODE_300595_length_226_cov_547.629921	82	162	1351	1	80	0.0125000
NODE_300595_length_226_cov_547.629921	82	162	1353	1	80	0.0125000
NODE_300595_length_226_cov_547.629921	82	162	1363	1	80	0.0125000
NODE_300595_length_226_cov_547.629921	82	162	1364	1	80	0.0125000
NODE_300595_length_226_cov_547.629921	82	162	1367	1	80	0.0125000
NODE_300595_length_226_cov_547.629921	82	162	1371	1	80	0.0125000
NODE_300595_length_226_cov_547.629921	82	162	1372	1	80	0.0125000
NODE_300595_length_226_cov_547.629921	82	162	1373	1	80	0.0125000
NODE_300595_length_226_cov_547.629921	82	162	1374	1	80	0.0125000
NODE_300595_length_226_cov_547.629921	82	162	1375	1	80	0.0125000
NODE_300595_length_226_cov_547.629921	82	162	1376	1	80	0.0125000
NODE_300595_length_226_cov_547.629921	82	162	1379	1	80	0.0125000
NODE_300595_length_226_cov_547.629921	82	162	1385	2	80	0.0250000
NODE_300595_length_226_cov_547.629921	82	162	1387	1	80	0.0125000
NODE_300595_length_226_cov_547.629921	82	162	1391	2	80	0.0250000
NODE_300595_length_226_cov_547.629921	82	162	1397	1	80	0.0125000
NODE_300595_length_226_cov_547.629921	82	162	1398	1	80	0.0125000
NODE_300595_length_226_cov_547.629921	82	162	1399	1	80	0.0125000
NODE_300595_length_226_cov_547.629921	82	162	1402	1	80	0.0125000
NODE_300595_length_226_cov_547.629921	82	162	1404	3	80	0.0375000
NODE_300595_length_226_cov_547.629921	82	162	1406	1	80	0.0125000
NODE_300595_length_226_cov_547.629921	82	162	1407	2	80	0.0250000
NODE_300595_length_226_cov_547.629921	82	162	1408	2	80	0.0250000
NODE_300617_length_225_cov_41.269841	81	165	14	1	84	0.0119048
NODE_300617_length_225_cov_41.269841	81	165	16	5	84	0.0595238
NODE_300617_length_225_cov_41.269841	81	165	18	4	84	0.0476190
NODE_300617_length_225_cov_41.269841	81	165	21	2	84	0.0238095
NODE_300617_length_225_cov_41.269841	81	165	26	2	84	0.0238095
NODE_300617_length_225_cov_41.269841	81	165	28	5	84	0.0595238
NODE_300617_length_225_cov_41.269841	81	165	30	2	84	0.0238095
NODE_300617_length_225_cov_41.269841	81	165	34	1	84	0.0119048
NODE_300617_length_225_cov_41.269841	81	165	36	4	84	0.0476190
NODE_300617_length_225_cov_41.269841	81	165	38	1	84	0.0119048
NODE_300617_length_225_cov_41.269841	81	165	42	1	84	0.0119048
NODE_300617_length_225_cov_41.269841	81	165	48	2	84	0.0238095
NODE_300617_length_225_cov_41.269841	81	165	52	2	84	0.0238095
NODE_300617_length_225_cov_41.269841	81	165	54	1	84	0.0119048
NODE_300617_length_225_cov_41.269841	81	165	58	6	84	0.0714286
NODE_300617_length_225_cov_41.269841	81	165	60	6	84	0.0714286
NODE_300617_length_225_cov_41.269841	81	165	62	5	84	0.0595238
NODE_300617_length_225_cov_41.269841	81	165	64	9	84	0.1071429
NODE_300617_length_225_cov_41.269841	81	165	66	23	84	0.2738095
NODE_300617_length_225_cov_41.269841	81	165	68	2	84	0.0238095
NODE_300617_length_225_cov_41.269841	134	218	2	21	84	0.2500000
NODE_300617_length_225_cov_41.269841	134	218	4	4	84	0.0476190
NODE_300617_length_225_cov_41.269841	134	218	7	3	84	0.0357143
NODE_300617_length_225_cov_41.269841	134	218	8	16	84	0.1904762
NODE_300617_length_225_cov_41.269841	134	218	10	1	84	0.0119048
NODE_300617_length_225_cov_41.269841	134	218	12	8	84	0.0952381
NODE_300617_length_225_cov_41.269841	134	218	14	1	84	0.0119048
NODE_300617_length_225_cov_41.269841	134	218	16	5	84	0.0595238
NODE_300617_length_225_cov_41.269841	134	218	18	4	84	0.0476190
NODE_300617_length_225_cov_41.269841	134	218	21	2	84	0.0238095
NODE_300617_length_225_cov_41.269841	134	218	26	2	84	0.0238095
NODE_300617_length_225_cov_41.269841	134	218	28	5	84	0.0595238
NODE_300617_length_225_cov_41.269841	134	218	30	2	84	0.0238095
NODE_300617_length_225_cov_41.269841	134	218	34	1	84	0.0119048
NODE_300617_length_225_cov_41.269841	134	218	36	4	84	0.0476190
NODE_300617_length_225_cov_41.269841	134	218	38	1	84	0.0119048
NODE_300617_length_225_cov_41.269841	134	218	42	1	84	0.0119048
NODE_300617_length_225_cov_41.269841	134	218	48	2	84	0.0238095
NODE_300617_length_225_cov_41.269841	134	218	52	1	84	0.0119048
NODE_300661_length_224_cov_209.528000	12	84	12	6	72	0.0833333
NODE_300661_length_224_cov_209.528000	12	84	18	4	72	0.0555556
NODE_300661_length_224_cov_209.528000	12	84	20	7	72	0.0972222
NODE_300661_length_224_cov_209.528000	12	84	21	3	72	0.0416667
NODE_300661_length_224_cov_209.528000	12	84	22	1	72	0.0138889
NODE_300661_length_224_cov_209.528000	12	84	24	1	72	0.0138889
NODE_300661_length_224_cov_209.528000	12	84	28	4	72	0.0555556
NODE_300661_length_224_cov_209.528000	12	84	30	5	72	0.0694444
NODE_300661_length_224_cov_209.528000	12	84	31	1	72	0.0138889
NODE_300661_length_224_cov_209.528000	12	84	32	1	72	0.0138889
NODE_300661_length_224_cov_209.528000	12	84	33	4	72	0.0555556
NODE_300661_length_224_cov_209.528000	12	84	37	13	72	0.1805556
NODE_300661_length_224_cov_209.528000	12	84	39	19	72	0.2638889
NODE_300661_length_224_cov_209.528000	12	84	40	3	72	0.0416667
NODE_300663_length_224_cov_146.568000	13	72	4	2	59	0.0338983
NODE_300663_length_224_cov_146.568000	13	72	6	6	59	0.1016949
NODE_300663_length_224_cov_146.568000	13	72	10	2	59	0.0338983
NODE_300663_length_224_cov_146.568000	13	72	11	12	59	0.2033898
NODE_300663_length_224_cov_146.568000	13	72	13	1	59	0.0169492
NODE_300663_length_224_cov_146.568000	13	72	15	1	59	0.0169492
NODE_300663_length_224_cov_146.568000	13	72	19	1	59	0.0169492
NODE_300663_length_224_cov_146.568000	13	72	23	2	59	0.0338983
NODE_300663_length_224_cov_146.568000	13	72	24	10	59	0.1694915
NODE_300663_length_224_cov_146.568000	13	72	26	1	59	0.0169492
NODE_300663_length_224_cov_146.568000	13	72	27	2	59	0.0338983
NODE_300663_length_224_cov_146.568000	13	72	32	5	59	0.0847458
NODE_300663_length_224_cov_146.568000	13	72	34	1	59	0.0169492
NODE_300663_length_224_cov_146.568000	13	72	35	1	59	0.0169492
NODE_300663_length_224_cov_146.568000	13	72	42	5	59	0.0847458
NODE_300663_length_224_cov_146.568000	13	72	44	1	59	0.0169492
NODE_300663_length_224_cov_146.568000	13	72	48	1	59	0.0169492
NODE_300663_length_224_cov_146.568000	13	72	50	5	59	0.0847458
NODE_300663_length_224_cov_146.568000	46	72	24	4	26	0.1538462
NODE_300663_length_224_cov_146.568000	46	72	26	1	26	0.0384615
NODE_300663_length_224_cov_146.568000	46	72	27	2	26	0.0769231
NODE_300663_length_224_cov_146.568000	46	72	32	5	26	0.1923077
NODE_300663_length_224_cov_146.568000	46	72	34	1	26	0.0384615
NODE_300663_length_224_cov_146.568000	46	72	35	1	26	0.0384615
NODE_300663_length_224_cov_146.568000	46	72	42	5	26	0.1923077
NODE_300663_length_224_cov_146.568000	46	72	44	1	26	0.0384615
NODE_300663_length_224_cov_146.568000	46	72	48	1	26	0.0384615
NODE_300663_length_224_cov_146.568000	46	72	50	5	26	0.1923077
NODE_300663_length_224_cov_146.568000	68	120	50	4	52	0.0769231
NODE_300663_length_224_cov_146.568000	68	120	52	2	52	0.0384615
NODE_300663_length_224_cov_146.568000	68	120	54	1	52	0.0192308
NODE_300663_length_224_cov_146.568000	68	120	56	1	52	0.0192308
NODE_300663_length_224_cov_146.568000	68	120	58	3	52	0.0576923
NODE_300663_length_224_cov_146.568000	68	120	60	2	52	0.0384615
NODE_300663_length_224_cov_146.568000	68	120	62	3	52	0.0576923
NODE_300663_length_224_cov_146.568000	68	120	64	1	52	0.0192308
NODE_300663_length_224_cov_146.568000	68	120	68	1	52	0.0192308
NODE_300663_length_224_cov_146.568000	68	120	70	1	52	0.0192308
NODE_300663_length_224_cov_146.568000	68	120	72	1	52	0.0192308
NODE_300663_length_224_cov_146.568000	68	120	76	2	52	0.0384615
NODE_300663_length_224_cov_146.568000	68	120	78	2	52	0.0384615
NODE_300663_length_224_cov_146.568000	68	120	82	1	52	0.0192308
NODE_300663_length_224_cov_146.568000	68	120	87	5	52	0.0961538
NODE_300663_length_224_cov_146.568000	68	120	91	3	52	0.0576923
NODE_300663_length_224_cov_146.568000	68	120	93	7	52	0.1346154
NODE_300663_length_224_cov_146.568000	68	120	96	1	52	0.0192308
NODE_300663_length_224_cov_146.568000	68	120	98	11	52	0.2115385
NODE_300665_length_224_cov_59.088000	98	178	16	5	80	0.0625000
NODE_300665_length_224_cov_59.088000	98	178	18	13	80	0.1625000
NODE_300665_length_224_cov_59.088000	98	178	22	3	80	0.0375000
NODE_300665_length_224_cov_59.088000	98	178	24	15	80	0.1875000
NODE_300665_length_224_cov_59.088000	98	178	26	44	80	0.5500000
NODE_300665_length_224_cov_59.088000	98	178	16	5	80	0.0625000
NODE_300665_length_224_cov_59.088000	98	178	18	13	80	0.1625000
NODE_300665_length_224_cov_59.088000	98	178	22	3	80	0.0375000
NODE_300665_length_224_cov_59.088000	98	178	24	15	80	0.1875000
NODE_300665_length_224_cov_59.088000	98	178	26	44	80	0.5500000
NODE_300665_length_224_cov_59.088000	98	178	16	5	80	0.0625000
NODE_300665_length_224_cov_59.088000	98	178	18	13	80	0.1625000
NODE_300665_length_224_cov_59.088000	98	178	22	3	80	0.0375000
NODE_300665_length_224_cov_59.088000	98	178	24	15	80	0.1875000
NODE_300665_length_224_cov_59.088000	98	178	26	44	80	0.5500000
NODE_300665_length_224_cov_59.088000	151	217	0	3	66	0.0454545
NODE_300665_length_224_cov_59.088000	151	217	2	1	66	0.0151515
NODE_300665_length_224_cov_59.088000	151	217	3	1	66	0.0151515
NODE_300665_length_224_cov_59.088000	151	217	4	6	66	0.0909091
NODE_300665_length_224_cov_59.088000	151	217	6	14	66	0.2121212
NODE_300665_length_224_cov_59.088000	151	217	14	2	66	0.0303030
NODE_300665_length_224_cov_59.088000	151	217	16	16	66	0.2424242
NODE_300665_length_224_cov_59.088000	151	217	18	3	66	0.0454545
NODE_300665_length_224_cov_59.088000	151	217	22	3	66	0.0454545
NODE_300665_length_224_cov_59.088000	151	217	24	15	66	0.2272727
NODE_300665_length_224_cov_59.088000	151	217	26	2	66	0.0303030
NODE_300665_length_224_cov_59.088000	151	224	0	10	73	0.1369863
NODE_300665_length_224_cov_59.088000	151	224	2	1	73	0.0136986
NODE_300665_length_224_cov_59.088000	151	224	3	1	73	0.0136986
NODE_300665_length_224_cov_59.088000	151	224	4	6	73	0.0821918
NODE_300665_length_224_cov_59.088000	151	224	6	14	73	0.1917808
NODE_300665_length_224_cov_59.088000	151	224	14	2	73	0.0273973
NODE_300665_length_224_cov_59.088000	151	224	16	16	73	0.2191781
NODE_300665_length_224_cov_59.088000	151	224	18	3	73	0.0410959
NODE_300665_length_224_cov_59.088000	151	224	22	3	73	0.0410959
NODE_300665_length_224_cov_59.088000	151	224	24	15	73	0.2054795
NODE_300665_length_224_cov_59.088000	151	224	26	2	73	0.0273973
NODE_300667_length_224_cov_43.640000	98	157	0	59	59	1.0000000
NODE_300667_length_224_cov_43.640000	98	157	0	59	59	1.0000000
NODE_300667_length_224_cov_43.640000	106	157	0	51	51	1.0000000
NODE_300669_length_224_cov_36.224000	100	171	24	71	71	1.0000000
NODE_300669_length_224_cov_36.224000	151	224	0	3	73	0.0410959
NODE_300669_length_224_cov_36.224000	151	224	6	2	73	0.0273973
NODE_300669_length_224_cov_36.224000	151	224	8	1	73	0.0136986
NODE_300669_length_224_cov_36.224000	151	224	14	2	73	0.0273973
NODE_300669_length_224_cov_36.224000	151	224	18	13	73	0.1780822
NODE_300669_length_224_cov_36.224000	151	224	20	2	73	0.0273973
NODE_300669_length_224_cov_36.224000	151	224	22	24	73	0.3287671
NODE_300669_length_224_cov_36.224000	151	224	24	26	73	0.3561644
NODE_300696_length_223_cov_35.814516	0	54	2	54	54	1.0000000
NODE_300696_length_223_cov_35.814516	30	107	2	38	77	0.4935065
NODE_300696_length_223_cov_35.814516	30	107	6	18	77	0.2337662
NODE_300696_length_223_cov_35.814516	30	107	10	21	77	0.2727273
NODE_300768_length_221_cov_71.319672	14	94	72	1	80	0.0125000
NODE_300768_length_221_cov_71.319672	14	94	76	6	80	0.0750000
NODE_300768_length_221_cov_71.319672	14	94	80	2	80	0.0250000
NODE_300768_length_221_cov_71.319672	14	94	87	2	80	0.0250000
NODE_300768_length_221_cov_71.319672	14	94	92	1	80	0.0125000
NODE_300768_length_221_cov_71.319672	14	94	95	1	80	0.0125000
NODE_300768_length_221_cov_71.319672	14	94	97	1	80	0.0125000
NODE_300768_length_221_cov_71.319672	14	94	98	1	80	0.0125000
NODE_300768_length_221_cov_71.319672	14	94	99	1	80	0.0125000
NODE_300768_length_221_cov_71.319672	14	94	100	5	80	0.0625000
NODE_300768_length_221_cov_71.319672	14	94	103	2	80	0.0250000
NODE_300768_length_221_cov_71.319672	14	94	104	1	80	0.0125000
NODE_300768_length_221_cov_71.319672	14	94	105	2	80	0.0250000
NODE_300768_length_221_cov_71.319672	14	94	107	2	80	0.0250000
NODE_300768_length_221_cov_71.319672	14	94	119	1	80	0.0125000
NODE_300768_length_221_cov_71.319672	14	94	123	7	80	0.0875000
NODE_300768_length_221_cov_71.319672	14	94	125	2	80	0.0250000
NODE_300768_length_221_cov_71.319672	14	94	126	3	80	0.0375000
NODE_300768_length_221_cov_71.319672	14	94	132	1	80	0.0125000
NODE_300768_length_221_cov_71.319672	14	94	134	3	80	0.0375000
NODE_300768_length_221_cov_71.319672	14	94	135	3	80	0.0375000
NODE_300768_length_221_cov_71.319672	14	94	136	5	80	0.0625000
NODE_300768_length_221_cov_71.319672	14	94	137	27	80	0.3375000
NODE_300800_length_220_cov_42.206612	3	74	24	1	71	0.0140845
NODE_300800_length_220_cov_42.206612	3	74	25	5	71	0.0704225
NODE_300800_length_220_cov_42.206612	3	74	28	3	71	0.0422535
NODE_300800_length_220_cov_42.206612	3	74	29	1	71	0.0140845
NODE_300800_length_220_cov_42.206612	3	74	31	1	71	0.0140845
NODE_300800_length_220_cov_42.206612	3	74	32	2	71	0.0281690
NODE_300800_length_220_cov_42.206612	3	74	33	1	71	0.0140845
NODE_300800_length_220_cov_42.206612	3	74	35	9	71	0.1267606
NODE_300800_length_220_cov_42.206612	3	74	38	2	71	0.0281690
NODE_300800_length_220_cov_42.206612	3	74	42	3	71	0.0422535
NODE_300800_length_220_cov_42.206612	3	74	49	2	71	0.0281690
NODE_300800_length_220_cov_42.206612	3	74	50	5	71	0.0704225
NODE_300800_length_220_cov_42.206612	3	74	54	4	71	0.0563380
NODE_300800_length_220_cov_42.206612	3	74	59	1	71	0.0140845
NODE_300800_length_220_cov_42.206612	3	74	61	1	71	0.0140845
NODE_300800_length_220_cov_42.206612	3	74	64	2	71	0.0281690
NODE_300800_length_220_cov_42.206612	3	74	70	2	71	0.0281690
NODE_300800_length_220_cov_42.206612	3	74	71	5	71	0.0704225
NODE_300800_length_220_cov_42.206612	3	74	74	3	71	0.0422535
NODE_300800_length_220_cov_42.206612	3	74	79	1	71	0.0140845
NODE_300800_length_220_cov_42.206612	3	74	84	1	71	0.0140845
NODE_300800_length_220_cov_42.206612	3	74	91	2	71	0.0281690
NODE_300800_length_220_cov_42.206612	3	74	94	1	71	0.0140845
NODE_300800_length_220_cov_42.206612	3	74	95	13	71	0.1830986
NODE_300800_length_220_cov_42.206612	8	74	25	1	66	0.0151515
NODE_300800_length_220_cov_42.206612	8	74	28	3	66	0.0454545
NODE_300800_length_220_cov_42.206612	8	74	29	1	66	0.0151515
NODE_300800_length_220_cov_42.206612	8	74	31	1	66	0.0151515
NODE_300800_length_220_cov_42.206612	8	74	32	2	66	0.0303030
NODE_300800_length_220_cov_42.206612	8	74	33	1	66	0.0151515
NODE_300800_length_220_cov_42.206612	8	74	35	9	66	0.1363636
NODE_300800_length_220_cov_42.206612	8	74	38	2	66	0.0303030
NODE_300800_length_220_cov_42.206612	8	74	42	3	66	0.0454545
NODE_300800_length_220_cov_42.206612	8	74	49	2	66	0.0303030
NODE_300800_length_220_cov_42.206612	8	74	50	5	66	0.0757576
NODE_300800_length_220_cov_42.206612	8	74	54	4	66	0.0606061
NODE_300800_length_220_cov_42.206612	8	74	59	1	66	0.0151515
NODE_300800_length_220_cov_42.206612	8	74	61	1	66	0.0151515
NODE_300800_length_220_cov_42.206612	8	74	64	2	66	0.0303030
NODE_300800_length_220_cov_42.206612	8	74	70	2	66	0.0303030
NODE_300800_length_220_cov_42.206612	8	74	71	5	66	0.0757576
NODE_300800_length_220_cov_42.206612	8	74	74	3	66	0.0454545
NODE_300800_length_220_cov_42.206612	8	74	79	1	66	0.0151515
NODE_300800_length_220_cov_42.206612	8	74	84	1	66	0.0151515
NODE_300800_length_220_cov_42.206612	8	74	91	2	66	0.0303030
NODE_300800_length_220_cov_42.206612	8	74	94	1	66	0.0151515
NODE_300800_length_220_cov_42.206612	8	74	95	13	66	0.1969697
NODE_300800_length_220_cov_42.206612	47	98	70	1	51	0.0196078
NODE_300800_length_220_cov_42.206612	47	98	71	5	51	0.0980392
NODE_300800_length_220_cov_42.206612	47	98	74	3	51	0.0588235
NODE_300800_length_220_cov_42.206612	47	98	79	1	51	0.0196078
NODE_300800_length_220_cov_42.206612	47	98	84	1	51	0.0196078
NODE_300800_length_220_cov_42.206612	47	98	91	2	51	0.0392157
NODE_300800_length_220_cov_42.206612	47	98	94	1	51	0.0196078
NODE_300800_length_220_cov_42.206612	47	98	95	37	51	0.7254902
NODE_300800_length_220_cov_42.206612	47	98	70	1	51	0.0196078
NODE_300800_length_220_cov_42.206612	47	98	71	5	51	0.0980392
NODE_300800_length_220_cov_42.206612	47	98	74	3	51	0.0588235
NODE_300800_length_220_cov_42.206612	47	98	79	1	51	0.0196078
NODE_300800_length_220_cov_42.206612	47	98	84	1	51	0.0196078
NODE_300800_length_220_cov_42.206612	47	98	91	2	51	0.0392157
NODE_300800_length_220_cov_42.206612	47	98	94	1	51	0.0196078
NODE_300800_length_220_cov_42.206612	47	98	95	37	51	0.7254902
NODE_300800_length_220_cov_42.206612	47	98	70	1	51	0.0196078
NODE_300800_length_220_cov_42.206612	47	98	71	5	51	0.0980392
NODE_300800_length_220_cov_42.206612	47	98	74	3	51	0.0588235
NODE_300800_length_220_cov_42.206612	47	98	79	1	51	0.0196078
NODE_300800_length_220_cov_42.206612	47	98	84	1	51	0.0196078
NODE_300800_length_220_cov_42.206612	47	98	91	2	51	0.0392157
NODE_300800_length_220_cov_42.206612	47	98	94	1	51	0.0196078
NODE_300800_length_220_cov_42.206612	47	98	95	37	51	0.7254902
NODE_300874_length_218_cov_244.773109	128	203	17	1	75	0.0133333
NODE_300874_length_218_cov_244.773109	128	203	23	2	75	0.0266667
NODE_300874_length_218_cov_244.773109	128	203	25	6	75	0.0800000
NODE_300874_length_218_cov_244.773109	128	203	26	2	75	0.0266667
NODE_300874_length_218_cov_244.773109	128	203	27	1	75	0.0133333
NODE_300874_length_218_cov_244.773109	128	203	35	2	75	0.0266667
NODE_300874_length_218_cov_244.773109	128	203	37	2	75	0.0266667
NODE_300874_length_218_cov_244.773109	128	203	41	11	75	0.1466667
NODE_300874_length_218_cov_244.773109	128	203	43	2	75	0.0266667
NODE_300874_length_218_cov_244.773109	128	203	45	2	75	0.0266667
NODE_300874_length_218_cov_244.773109	128	203	47	2	75	0.0266667
NODE_300874_length_218_cov_244.773109	128	203	53	1	75	0.0133333
NODE_300874_length_218_cov_244.773109	128	203	56	1	75	0.0133333
NODE_300874_length_218_cov_244.773109	128	203	60	2	75	0.0266667
NODE_300874_length_218_cov_244.773109	128	203	64	1	75	0.0133333
NODE_300874_length_218_cov_244.773109	128	203	70	1	75	0.0133333
NODE_300874_length_218_cov_244.773109	128	203	80	1	75	0.0133333
NODE_300874_length_218_cov_244.773109	128	203	82	3	75	0.0400000
NODE_300874_length_218_cov_244.773109	128	203	84	2	75	0.0266667
NODE_300874_length_218_cov_244.773109	128	203	86	3	75	0.0400000
NODE_300874_length_218_cov_244.773109	128	203	88	1	75	0.0133333
NODE_300874_length_218_cov_244.773109	128	203	89	1	75	0.0133333
NODE_300874_length_218_cov_244.773109	128	203	90	4	75	0.0533333
NODE_300874_length_218_cov_244.773109	128	203	92	2	75	0.0266667
NODE_300874_length_218_cov_244.773109	128	203	94	4	75	0.0533333
NODE_300874_length_218_cov_244.773109	128	203	96	1	75	0.0133333
NODE_300874_length_218_cov_244.773109	128	203	98	1	75	0.0133333
NODE_300874_length_218_cov_244.773109	128	203	102	3	75	0.0400000
NODE_300874_length_218_cov_244.773109	128	203	103	7	75	0.0933333
NODE_300874_length_218_cov_244.773109	128	203	105	3	75	0.0400000
NODE_300874_length_218_cov_244.773109	176	218	14	5	42	0.1190476
NODE_300874_length_218_cov_244.773109	176	218	16	1	42	0.0238095
NODE_300874_length_218_cov_244.773109	176	218	17	10	42	0.2380952
NODE_300874_length_218_cov_244.773109	176	218	23	2	42	0.0476190
NODE_300874_length_218_cov_244.773109	176	218	25	6	42	0.1428571
NODE_300874_length_218_cov_244.773109	176	218	26	2	42	0.0476190
NODE_300874_length_218_cov_244.773109	176	218	27	1	42	0.0238095
NODE_300874_length_218_cov_244.773109	176	218	35	2	42	0.0476190
NODE_300874_length_218_cov_244.773109	176	218	37	2	42	0.0476190
NODE_300874_length_218_cov_244.773109	176	218	41	11	42	0.2619048
NODE_300915_length_217_cov_2.144068	14	49	0	35	35	1.0000000
NODE_300915_length_217_cov_2.144068	132	167	0	35	35	1.0000000
NODE_300924_length_216_cov_215.410256	0	63	0	32	63	0.5079365
NODE_300924_length_216_cov_215.410256	0	63	2	31	63	0.4920635
NODE_300924_length_216_cov_215.410256	36	102	2	66	66	1.0000000
NODE_300925_length_216_cov_51.940171	164	216	0	52	52	1.0000000
NODE_300953_length_215_cov_14.784483	0	50	0	50	50	1.0000000
NODE_300953_length_215_cov_14.784483	23	103	0	80	80	1.0000000
NODE_300984_length_214_cov_144.165217	0	62	4	3	62	0.0483871
NODE_300984_length_214_cov_144.165217	0	62	6	9	62	0.1451613
NODE_300984_length_214_cov_144.165217	0	62	29	27	62	0.4354839
NODE_300984_length_214_cov_144.165217	0	62	31	10	62	0.1612903
NODE_300984_length_214_cov_144.165217	0	62	34	7	62	0.1129032
NODE_300984_length_214_cov_144.165217	0	62	36	6	62	0.0967742
NODE_300984_length_214_cov_144.165217	0	62	4	3	62	0.0483871
NODE_300984_length_214_cov_144.165217	0	62	6	9	62	0.1451613
NODE_300984_length_214_cov_144.165217	0	62	29	27	62	0.4354839
NODE_300984_length_214_cov_144.165217	0	62	31	10	62	0.1612903
NODE_300984_length_214_cov_144.165217	0	62	34	7	62	0.1129032
NODE_300984_length_214_cov_144.165217	0	62	36	6	62	0.0967742
NODE_300984_length_214_cov_144.165217	35	115	29	4	80	0.0500000
NODE_300984_length_214_cov_144.165217	35	115	31	22	80	0.2750000
NODE_300984_length_214_cov_144.165217	35	115	34	7	80	0.0875000
NODE_300984_length_214_cov_144.165217	35	115	36	47	80	0.5875000
NODE_300984_length_214_cov_144.165217	35	115	29	4	80	0.0500000
NODE_300984_length_214_cov_144.165217	35	115	31	22	80	0.2750000
NODE_300984_length_214_cov_144.165217	35	115	34	7	80	0.0875000
NODE_300984_length_214_cov_144.165217	35	115	36	47	80	0.5875000
NODE_300984_length_214_cov_144.165217	35	115	29	4	80	0.0500000
NODE_300984_length_214_cov_144.165217	35	115	31	22	80	0.2750000
NODE_300984_length_214_cov_144.165217	35	115	34	7	80	0.0875000
NODE_300984_length_214_cov_144.165217	35	115	36	47	80	0.5875000
NODE_300984_length_214_cov_144.165217	111	191	2	2	80	0.0250000
NODE_300984_length_214_cov_144.165217	111	191	4	27	80	0.3375000
NODE_300984_length_214_cov_144.165217	111	191	26	2	80	0.0250000
NODE_300984_length_214_cov_144.165217	111	191	27	31	80	0.3875000
NODE_300984_length_214_cov_144.165217	111	191	29	6	80	0.0750000
NODE_300984_length_214_cov_144.165217	111	191	31	12	80	0.1500000
NODE_300984_length_214_cov_144.165217	111	191	2	2	80	0.0250000
NODE_300984_length_214_cov_144.165217	111	191	4	27	80	0.3375000
NODE_300984_length_214_cov_144.165217	111	191	26	2	80	0.0250000
NODE_300984_length_214_cov_144.165217	111	191	27	31	80	0.3875000
NODE_300984_length_214_cov_144.165217	111	191	29	6	80	0.0750000
NODE_300984_length_214_cov_144.165217	111	191	31	12	80	0.1500000
NODE_300984_length_214_cov_144.165217	111	191	2	2	80	0.0250000
NODE_300984_length_214_cov_144.165217	111	191	4	27	80	0.3375000
NODE_300984_length_214_cov_144.165217	111	191	26	2	80	0.0250000
NODE_300984_length_214_cov_144.165217	111	191	27	31	80	0.3875000
NODE_300984_length_214_cov_144.165217	111	191	29	6	80	0.0750000
NODE_300984_length_214_cov_144.165217	111	191	31	12	80	0.1500000
NODE_300984_length_214_cov_144.165217	164	214	0	15	50	0.3000000
NODE_300984_length_214_cov_144.165217	164	214	2	10	50	0.2000000
NODE_300984_length_214_cov_144.165217	164	214	4	25	50	0.5000000
NODE_300984_length_214_cov_144.165217	164	214	0	15	50	0.3000000
NODE_300984_length_214_cov_144.165217	164	214	2	10	50	0.2000000
NODE_300984_length_214_cov_144.165217	164	214	4	25	50	0.5000000
NODE_300984_length_214_cov_144.165217	164	214	0	15	50	0.3000000
NODE_300984_length_214_cov_144.165217	164	214	2	10	50	0.2000000
NODE_300984_length_214_cov_144.165217	164	214	4	25	50	0.5000000
NODE_301068_length_211_cov_39.571429	4	84	0	80	80	1.0000000
NODE_301169_length_208_cov_45.238532	3	59	0	15	56	0.2678571
NODE_301169_length_208_cov_45.238532	3	59	2	19	56	0.3392857
NODE_301169_length_208_cov_45.238532	3	59	10	22	56	0.3928571
NODE_301169_length_208_cov_45.238532	35	112	2	2	77	0.0259740
NODE_301169_length_208_cov_45.238532	35	112	10	75	77	0.9740260
NODE_301170_length_208_cov_35.229358	76	156	2	80	80	1.0000000
NODE_301179_length_207_cov_341.324074	33	113	0	80	80	1.0000000
NODE_301179_length_207_cov_341.324074	86	166	0	80	80	1.0000000
NODE_301248_length_205_cov_64.179245	6	77	2	6	71	0.0845070
NODE_301248_length_205_cov_64.179245	6	77	3	2	71	0.0281690
NODE_301248_length_205_cov_64.179245	6	77	4	15	71	0.2112676
NODE_301248_length_205_cov_64.179245	6	77	6	10	71	0.1408451
NODE_301248_length_205_cov_64.179245	6	77	8	3	71	0.0422535
NODE_301248_length_205_cov_64.179245	6	77	15	1	71	0.0140845
NODE_301248_length_205_cov_64.179245	6	77	16	1	71	0.0140845
NODE_301248_length_205_cov_64.179245	6	77	22	1	71	0.0140845
NODE_301248_length_205_cov_64.179245	6	77	23	5	71	0.0704225
NODE_301248_length_205_cov_64.179245	6	77	25	1	71	0.0140845
NODE_301248_length_205_cov_64.179245	6	77	26	8	71	0.1126761
NODE_301248_length_205_cov_64.179245	6	77	27	1	71	0.0140845
NODE_301248_length_205_cov_64.179245	6	77	29	4	71	0.0563380
NODE_301248_length_205_cov_64.179245	6	77	31	3	71	0.0422535
NODE_301248_length_205_cov_64.179245	6	77	33	10	71	0.1408451
NODE_301248_length_205_cov_64.179245	11	77	2	1	66	0.0151515
NODE_301248_length_205_cov_64.179245	11	77	3	2	66	0.0303030
NODE_301248_length_205_cov_64.179245	11	77	4	15	66	0.2272727
NODE_301248_length_205_cov_64.179245	11	77	6	10	66	0.1515152
NODE_301248_length_205_cov_64.179245	11	77	8	3	66	0.0454545
NODE_301248_length_205_cov_64.179245	11	77	15	1	66	0.0151515
NODE_301248_length_205_cov_64.179245	11	77	16	1	66	0.0151515
NODE_301248_length_205_cov_64.179245	11	77	22	1	66	0.0151515
NODE_301248_length_205_cov_64.179245	11	77	23	5	66	0.0757576
NODE_301248_length_205_cov_64.179245	11	77	25	1	66	0.0151515
NODE_301248_length_205_cov_64.179245	11	77	26	8	66	0.1212121
NODE_301248_length_205_cov_64.179245	11	77	27	1	66	0.0151515
NODE_301248_length_205_cov_64.179245	11	77	29	4	66	0.0606061
NODE_301248_length_205_cov_64.179245	11	77	31	3	66	0.0454545
NODE_301248_length_205_cov_64.179245	11	77	33	10	66	0.1515152
NODE_301248_length_205_cov_64.179245	50	98	25	1	48	0.0208333
NODE_301248_length_205_cov_64.179245	50	98	26	8	48	0.1666667
NODE_301248_length_205_cov_64.179245	50	98	27	1	48	0.0208333
NODE_301248_length_205_cov_64.179245	50	98	29	4	48	0.0833333
NODE_301248_length_205_cov_64.179245	50	98	31	3	48	0.0625000
NODE_301248_length_205_cov_64.179245	50	98	33	27	48	0.5625000
NODE_301248_length_205_cov_64.179245	50	98	37	4	48	0.0833333
NODE_301248_length_205_cov_64.179245	50	98	25	1	48	0.0208333
NODE_301248_length_205_cov_64.179245	50	98	26	8	48	0.1666667
NODE_301248_length_205_cov_64.179245	50	98	27	1	48	0.0208333
NODE_301248_length_205_cov_64.179245	50	98	29	4	48	0.0833333
NODE_301248_length_205_cov_64.179245	50	98	31	3	48	0.0625000
NODE_301248_length_205_cov_64.179245	50	98	33	27	48	0.5625000
NODE_301248_length_205_cov_64.179245	50	98	37	4	48	0.0833333
NODE_301248_length_205_cov_64.179245	50	98	25	1	48	0.0208333
NODE_301248_length_205_cov_64.179245	50	98	26	8	48	0.1666667
NODE_301248_length_205_cov_64.179245	50	98	27	1	48	0.0208333
NODE_301248_length_205_cov_64.179245	50	98	29	4	48	0.0833333
NODE_301248_length_205_cov_64.179245	50	98	31	3	48	0.0625000
NODE_301248_length_205_cov_64.179245	50	98	33	27	48	0.5625000
NODE_301248_length_205_cov_64.179245	50	98	37	4	48	0.0833333
NODE_301281_length_204_cov_183.390476	119	199	16	2	80	0.0250000
NODE_301281_length_204_cov_183.390476	119	199	17	2	80	0.0250000
NODE_301281_length_204_cov_183.390476	119	199	18	2	80	0.0250000
NODE_301281_length_204_cov_183.390476	119	199	36	2	80	0.0250000
NODE_301281_length_204_cov_183.390476	119	199	38	5	80	0.0625000
NODE_301281_length_204_cov_183.390476	119	199	39	2	80	0.0250000
NODE_301281_length_204_cov_183.390476	119	199	40	9	80	0.1125000
NODE_301281_length_204_cov_183.390476	119	199	42	10	80	0.1250000
NODE_301281_length_204_cov_183.390476	119	199	46	10	80	0.1250000
NODE_301281_length_204_cov_183.390476	119	199	48	7	80	0.0875000
NODE_301281_length_204_cov_183.390476	119	199	49	3	80	0.0375000
NODE_301281_length_204_cov_183.390476	119	199	50	10	80	0.1250000
NODE_301281_length_204_cov_183.390476	119	199	52	1	80	0.0125000
NODE_301281_length_204_cov_183.390476	119	199	54	1	80	0.0125000
NODE_301281_length_204_cov_183.390476	119	199	58	6	80	0.0750000
NODE_301281_length_204_cov_183.390476	119	199	60	1	80	0.0125000
NODE_301281_length_204_cov_183.390476	119	199	62	5	80	0.0625000
NODE_301281_length_204_cov_183.390476	119	199	64	1	80	0.0125000
NODE_301281_length_204_cov_183.390476	119	199	66	1	80	0.0125000
NODE_301281_length_204_cov_183.390476	172	194	18	1	22	0.0454545
NODE_301281_length_204_cov_183.390476	172	194	36	2	22	0.0909091
NODE_301281_length_204_cov_183.390476	172	194	38	5	22	0.2272727
NODE_301281_length_204_cov_183.390476	172	194	39	2	22	0.0909091
NODE_301281_length_204_cov_183.390476	172	194	40	9	22	0.4090909
NODE_301281_length_204_cov_183.390476	172	194	42	3	22	0.1363636
NODE_301283_length_204_cov_80.095238	10	90	0	52	80	0.6500000
NODE_301283_length_204_cov_80.095238	10	90	4	18	80	0.2250000
NODE_301283_length_204_cov_80.095238	10	90	6	10	80	0.1250000
NODE_301283_length_204_cov_80.095238	63	143	2	2	80	0.0250000
NODE_301283_length_204_cov_80.095238	63	143	4	17	80	0.2125000
NODE_301283_length_204_cov_80.095238	63	143	6	61	80	0.7625000
NODE_301345_length_202_cov_123.184466	0	64	7	1	64	0.0156250
NODE_301345_length_202_cov_123.184466	0	64	14	2	64	0.0312500
NODE_301345_length_202_cov_123.184466	0	64	16	1	64	0.0156250
NODE_301345_length_202_cov_123.184466	0	64	19	1	64	0.0156250
NODE_301345_length_202_cov_123.184466	0	64	23	1	64	0.0156250
NODE_301345_length_202_cov_123.184466	0	64	25	1	64	0.0156250
NODE_301345_length_202_cov_123.184466	0	64	27	1	64	0.0156250
NODE_301345_length_202_cov_123.184466	0	64	28	1	64	0.0156250
NODE_301345_length_202_cov_123.184466	0	64	34	1	64	0.0156250
NODE_301345_length_202_cov_123.184466	0	64	38	2	64	0.0312500
NODE_301345_length_202_cov_123.184466	0	64	44	2	64	0.0312500
NODE_301345_length_202_cov_123.184466	0	64	45	1	64	0.0156250
NODE_301345_length_202_cov_123.184466	0	64	47	1	64	0.0156250
NODE_301345_length_202_cov_123.184466	0	64	48	2	64	0.0312500
NODE_301345_length_202_cov_123.184466	0	64	54	1	64	0.0156250
NODE_301345_length_202_cov_123.184466	0	64	56	3	64	0.0468750
NODE_301345_length_202_cov_123.184466	0	64	60	1	64	0.0156250
NODE_301345_length_202_cov_123.184466	0	64	64	1	64	0.0156250
NODE_301345_length_202_cov_123.184466	0	64	68	1	64	0.0156250
NODE_301345_length_202_cov_123.184466	0	64	74	1	64	0.0156250
NODE_301345_length_202_cov_123.184466	0	64	75	1	64	0.0156250
NODE_301345_length_202_cov_123.184466	0	64	76	1	64	0.0156250
NODE_301345_length_202_cov_123.184466	0	64	78	3	64	0.0468750
NODE_301345_length_202_cov_123.184466	0	64	79	5	64	0.0781250
NODE_301345_length_202_cov_123.184466	0	64	80	1	64	0.0156250
NODE_301345_length_202_cov_123.184466	0	64	84	1	64	0.0156250
NODE_301345_length_202_cov_123.184466	0	64	86	1	64	0.0156250
NODE_301345_length_202_cov_123.184466	0	64	89	1	64	0.0156250
NODE_301345_length_202_cov_123.184466	0	64	92	1	64	0.0156250
NODE_301345_length_202_cov_123.184466	0	64	94	3	64	0.0468750
NODE_301345_length_202_cov_123.184466	0	64	99	1	64	0.0156250
NODE_301345_length_202_cov_123.184466	0	64	103	2	64	0.0312500
NODE_301345_length_202_cov_123.184466	0	64	108	1	64	0.0156250
NODE_301345_length_202_cov_123.184466	0	64	114	1	64	0.0156250
NODE_301345_length_202_cov_123.184466	0	64	115	2	64	0.0312500
NODE_301345_length_202_cov_123.184466	0	64	119	1	64	0.0156250
NODE_301345_length_202_cov_123.184466	0	64	127	1	64	0.0156250
NODE_301345_length_202_cov_123.184466	0	64	132	2	64	0.0312500
NODE_301345_length_202_cov_123.184466	0	64	135	3	64	0.0468750
NODE_301345_length_202_cov_123.184466	0	64	137	1	64	0.0156250
NODE_301345_length_202_cov_123.184466	0	64	141	2	64	0.0312500
NODE_301345_length_202_cov_123.184466	0	64	147	2	64	0.0312500
NODE_301345_length_202_cov_123.184466	0	64	148	1	64	0.0156250
NODE_301345_length_202_cov_123.184466	31	72	79	5	41	0.1219512
NODE_301345_length_202_cov_123.184466	31	72	80	1	41	0.0243902
NODE_301345_length_202_cov_123.184466	31	72	84	1	41	0.0243902
NODE_301345_length_202_cov_123.184466	31	72	86	1	41	0.0243902
NODE_301345_length_202_cov_123.184466	31	72	89	1	41	0.0243902
NODE_301345_length_202_cov_123.184466	31	72	92	1	41	0.0243902
NODE_301345_length_202_cov_123.184466	31	72	94	3	41	0.0731707
NODE_301345_length_202_cov_123.184466	31	72	99	1	41	0.0243902
NODE_301345_length_202_cov_123.184466	31	72	103	2	41	0.0487805
NODE_301345_length_202_cov_123.184466	31	72	108	1	41	0.0243902
NODE_301345_length_202_cov_123.184466	31	72	114	1	41	0.0243902
NODE_301345_length_202_cov_123.184466	31	72	115	2	41	0.0487805
NODE_301345_length_202_cov_123.184466	31	72	119	1	41	0.0243902
NODE_301345_length_202_cov_123.184466	31	72	127	1	41	0.0243902
NODE_301345_length_202_cov_123.184466	31	72	132	2	41	0.0487805
NODE_301345_length_202_cov_123.184466	31	72	135	3	41	0.0731707
NODE_301345_length_202_cov_123.184466	31	72	137	1	41	0.0243902
NODE_301345_length_202_cov_123.184466	31	72	141	2	41	0.0487805
NODE_301345_length_202_cov_123.184466	31	72	147	2	41	0.0487805
NODE_301345_length_202_cov_123.184466	31	72	148	1	41	0.0243902
NODE_301345_length_202_cov_123.184466	31	72	150	1	41	0.0243902
NODE_301345_length_202_cov_123.184466	31	72	156	1	41	0.0243902
NODE_301345_length_202_cov_123.184466	31	72	162	1	41	0.0243902
NODE_301345_length_202_cov_123.184466	31	72	168	1	41	0.0243902
NODE_301345_length_202_cov_123.184466	31	72	174	1	41	0.0243902
NODE_301345_length_202_cov_123.184466	31	72	178	2	41	0.0487805
NODE_301345_length_202_cov_123.184466	31	72	184	1	41	0.0243902
NODE_301370_length_201_cov_56.323529	133	201	9	8	68	0.1176471
NODE_301370_length_201_cov_56.323529	133	201	10	19	68	0.2794118
NODE_301370_length_201_cov_56.323529	133	201	12	2	68	0.0294118
NODE_301370_length_201_cov_56.323529	133	201	14	9	68	0.1323529
NODE_301370_length_201_cov_56.323529	133	201	16	16	68	0.2352941
NODE_301370_length_201_cov_56.323529	133	201	21	10	68	0.1470588
NODE_301370_length_201_cov_56.323529	133	201	22	4	68	0.0588235
NODE_301371_length_201_cov_50.647059	44	99	26	1	55	0.0181818
NODE_301371_length_201_cov_50.647059	44	99	29	3	55	0.0545455
NODE_301371_length_201_cov_50.647059	44	99	31	2	55	0.0363636
NODE_301371_length_201_cov_50.647059	44	99	35	1	55	0.0181818
NODE_301371_length_201_cov_50.647059	44	99	37	1	55	0.0181818
NODE_301371_length_201_cov_50.647059	44	99	39	1	55	0.0181818
NODE_301371_length_201_cov_50.647059	44	99	41	1	55	0.0181818
NODE_301371_length_201_cov_50.647059	44	99	42	2	55	0.0363636
NODE_301371_length_201_cov_50.647059	44	99	44	2	55	0.0363636
NODE_301371_length_201_cov_50.647059	44	99	46	5	55	0.0909091
NODE_301371_length_201_cov_50.647059	44	99	50	7	55	0.1272727
NODE_301371_length_201_cov_50.647059	44	99	54	2	55	0.0363636
NODE_301371_length_201_cov_50.647059	44	99	68	10	55	0.1818182
NODE_301371_length_201_cov_50.647059	44	99	74	3	55	0.0545455
NODE_301371_length_201_cov_50.647059	44	99	76	2	55	0.0363636
NODE_301371_length_201_cov_50.647059	44	99	78	5	55	0.0909091
NODE_301371_length_201_cov_50.647059	44	99	82	7	55	0.1272727
NODE_301371_length_201_cov_50.647059	136	201	11	1	65	0.0153846
NODE_301371_length_201_cov_50.647059	136	201	13	1	65	0.0153846
NODE_301371_length_201_cov_50.647059	136	201	17	3	65	0.0461538
NODE_301371_length_201_cov_50.647059	136	201	31	1	65	0.0153846
NODE_301371_length_201_cov_50.647059	136	201	34	1	65	0.0153846
NODE_301371_length_201_cov_50.647059	136	201	36	3	65	0.0461538
NODE_301371_length_201_cov_50.647059	136	201	40	1	65	0.0153846
NODE_301371_length_201_cov_50.647059	136	201	44	2	65	0.0307692
NODE_301371_length_201_cov_50.647059	136	201	46	6	65	0.0923077
NODE_301371_length_201_cov_50.647059	136	201	48	3	65	0.0461538
NODE_301371_length_201_cov_50.647059	136	201	50	7	65	0.1076923
NODE_301371_length_201_cov_50.647059	136	201	54	1	65	0.0153846
NODE_301371_length_201_cov_50.647059	136	201	55	1	65	0.0153846
NODE_301371_length_201_cov_50.647059	136	201	58	5	65	0.0769231
NODE_301371_length_201_cov_50.647059	136	201	60	16	65	0.2461538
NODE_301371_length_201_cov_50.647059	136	201	64	5	65	0.0769231
NODE_301371_length_201_cov_50.647059	136	201	66	6	65	0.0923077
NODE_301371_length_201_cov_50.647059	136	201	68	2	65	0.0307692
NODE_301371_length_201_cov_50.647059	136	201	11	1	65	0.0153846
NODE_301371_length_201_cov_50.647059	136	201	13	1	65	0.0153846
NODE_301371_length_201_cov_50.647059	136	201	17	3	65	0.0461538
NODE_301371_length_201_cov_50.647059	136	201	31	1	65	0.0153846
NODE_301371_length_201_cov_50.647059	136	201	34	1	65	0.0153846
NODE_301371_length_201_cov_50.647059	136	201	36	3	65	0.0461538
NODE_301371_length_201_cov_50.647059	136	201	40	1	65	0.0153846
NODE_301371_length_201_cov_50.647059	136	201	44	2	65	0.0307692
NODE_301371_length_201_cov_50.647059	136	201	46	6	65	0.0923077
NODE_301371_length_201_cov_50.647059	136	201	48	3	65	0.0461538
NODE_301371_length_201_cov_50.647059	136	201	50	7	65	0.1076923
NODE_301371_length_201_cov_50.647059	136	201	54	1	65	0.0153846
NODE_301371_length_201_cov_50.647059	136	201	55	1	65	0.0153846
NODE_301371_length_201_cov_50.647059	136	201	58	5	65	0.0769231
NODE_301371_length_201_cov_50.647059	136	201	60	16	65	0.2461538
NODE_301371_length_201_cov_50.647059	136	201	64	5	65	0.0769231
NODE_301371_length_201_cov_50.647059	136	201	66	6	65	0.0923077
NODE_301371_length_201_cov_50.647059	136	201	68	2	65	0.0307692
NODE_301371_length_201_cov_50.647059	136	201	11	1	65	0.0153846
NODE_301371_length_201_cov_50.647059	136	201	13	1	65	0.0153846
NODE_301371_length_201_cov_50.647059	136	201	17	3	65	0.0461538
NODE_301371_length_201_cov_50.647059	136	201	31	1	65	0.0153846
NODE_301371_length_201_cov_50.647059	136	201	34	1	65	0.0153846
NODE_301371_length_201_cov_50.647059	136	201	36	3	65	0.0461538
NODE_301371_length_201_cov_50.647059	136	201	40	1	65	0.0153846
NODE_301371_length_201_cov_50.647059	136	201	44	2	65	0.0307692
NODE_301371_length_201_cov_50.647059	136	201	46	6	65	0.0923077
NODE_301371_length_201_cov_50.647059	136	201	48	3	65	0.0461538
NODE_301371_length_201_cov_50.647059	136	201	50	7	65	0.1076923
NODE_301371_length_201_cov_50.647059	136	201	54	1	65	0.0153846
NODE_301371_length_201_cov_50.647059	136	201	55	1	65	0.0153846
NODE_301371_length_201_cov_50.647059	136	201	58	5	65	0.0769231
NODE_301371_length_201_cov_50.647059	136	201	60	16	65	0.2461538
NODE_301371_length_201_cov_50.647059	136	201	64	5	65	0.0769231
NODE_301371_length_201_cov_50.647059	136	201	66	6	65	0.0923077
NODE_301371_length_201_cov_50.647059	136	201	68	2	65	0.0307692
NODE_301371_length_201_cov_50.647059	136	201	11	1	65	0.0153846
NODE_301371_length_201_cov_50.647059	136	201	13	1	65	0.0153846
NODE_301371_length_201_cov_50.647059	136	201	17	3	65	0.0461538
NODE_301371_length_201_cov_50.647059	136	201	31	1	65	0.0153846
NODE_301371_length_201_cov_50.647059	136	201	34	1	65	0.0153846
NODE_301371_length_201_cov_50.647059	136	201	36	3	65	0.0461538
NODE_301371_length_201_cov_50.647059	136	201	40	1	65	0.0153846
NODE_301371_length_201_cov_50.647059	136	201	44	2	65	0.0307692
NODE_301371_length_201_cov_50.647059	136	201	46	6	65	0.0923077
NODE_301371_length_201_cov_50.647059	136	201	48	3	65	0.0461538
NODE_301371_length_201_cov_50.647059	136	201	50	7	65	0.1076923
NODE_301371_length_201_cov_50.647059	136	201	54	1	65	0.0153846
NODE_301371_length_201_cov_50.647059	136	201	55	1	65	0.0153846
NODE_301371_length_201_cov_50.647059	136	201	58	5	65	0.0769231
NODE_301371_length_201_cov_50.647059	136	201	60	16	65	0.2461538
NODE_301371_length_201_cov_50.647059	136	201	64	5	65	0.0769231
NODE_301371_length_201_cov_50.647059	136	201	66	6	65	0.0923077
NODE_301371_length_201_cov_50.647059	136	201	68	2	65	0.0307692
NODE_301405_length_200_cov_29.118812	0	73	23	1	73	0.0136986
NODE_301405_length_200_cov_29.118812	0	73	25	1	73	0.0136986
NODE_301405_length_200_cov_29.118812	0	73	29	1	73	0.0136986
NODE_301405_length_200_cov_29.118812	0	73	41	2	73	0.0273973
NODE_301405_length_200_cov_29.118812	0	73	45	2	73	0.0273973
NODE_301405_length_200_cov_29.118812	0	73	49	1	73	0.0136986
NODE_301405_length_200_cov_29.118812	0	73	53	1	73	0.0136986
NODE_301405_length_200_cov_29.118812	0	73	54	1	73	0.0136986
NODE_301405_length_200_cov_29.118812	0	73	61	1	73	0.0136986
NODE_301405_length_200_cov_29.118812	0	73	62	1	73	0.0136986
NODE_301405_length_200_cov_29.118812	0	73	65	1	73	0.0136986
NODE_301405_length_200_cov_29.118812	0	73	66	2	73	0.0273973
NODE_301405_length_200_cov_29.118812	0	73	72	1	73	0.0136986
NODE_301405_length_200_cov_29.118812	0	73	75	1	73	0.0136986
NODE_301405_length_200_cov_29.118812	0	73	82	4	73	0.0547945
NODE_301405_length_200_cov_29.118812	0	73	86	1	73	0.0136986
NODE_301405_length_200_cov_29.118812	0	73	88	4	73	0.0547945
NODE_301405_length_200_cov_29.118812	0	73	90	3	73	0.0410959
NODE_301405_length_200_cov_29.118812	0	73	92	1	73	0.0136986
NODE_301405_length_200_cov_29.118812	0	73	94	3	73	0.0410959
NODE_301405_length_200_cov_29.118812	0	73	98	1	73	0.0136986
NODE_301405_length_200_cov_29.118812	0	73	102	1	73	0.0136986
NODE_301405_length_200_cov_29.118812	0	73	110	3	73	0.0410959
NODE_301405_length_200_cov_29.118812	0	73	117	5	73	0.0684932
NODE_301405_length_200_cov_29.118812	0	73	119	2	73	0.0273973
NODE_301405_length_200_cov_29.118812	0	73	122	8	73	0.1095890
NODE_301405_length_200_cov_29.118812	0	73	128	6	73	0.0821918
NODE_301405_length_200_cov_29.118812	0	73	130	1	73	0.0136986
NODE_301405_length_200_cov_29.118812	0	73	132	1	73	0.0136986
NODE_301405_length_200_cov_29.118812	0	73	133	7	73	0.0958904
NODE_301405_length_200_cov_29.118812	0	73	135	4	73	0.0547945
NODE_301405_length_200_cov_29.118812	0	73	136	1	73	0.0136986
NODE_301419_length_199_cov_768.700000	94	142	352	3	48	0.0625000
NODE_301419_length_199_cov_768.700000	94	142	357	1	48	0.0208333
NODE_301419_length_199_cov_768.700000	94	142	361	3	48	0.0625000
NODE_301419_length_199_cov_768.700000	94	142	362	1	48	0.0208333
NODE_301419_length_199_cov_768.700000	94	142	366	1	48	0.0208333
NODE_301419_length_199_cov_768.700000	94	142	372	4	48	0.0833333
NODE_301419_length_199_cov_768.700000	94	142	374	4	48	0.0833333
NODE_301419_length_199_cov_768.700000	94	142	375	1	48	0.0208333
NODE_301419_length_199_cov_768.700000	94	142	378	8	48	0.1666667
NODE_301419_length_199_cov_768.700000	94	142	380	1	48	0.0208333
NODE_301419_length_199_cov_768.700000	94	142	382	7	48	0.1458333
NODE_301419_length_199_cov_768.700000	94	142	383	1	48	0.0208333
NODE_301419_length_199_cov_768.700000	94	142	384	4	48	0.0833333
NODE_301419_length_199_cov_768.700000	94	142	388	9	48	0.1875000
NODE_301419_length_199_cov_768.700000	115	186	87	1	71	0.0140845
NODE_301419_length_199_cov_768.700000	115	186	110	1	71	0.0140845
NODE_301419_length_199_cov_768.700000	115	186	113	1	71	0.0140845
NODE_301419_length_199_cov_768.700000	115	186	120	2	71	0.0281690
NODE_301419_length_199_cov_768.700000	115	186	141	1	71	0.0140845
NODE_301419_length_199_cov_768.700000	115	186	149	1	71	0.0140845
NODE_301419_length_199_cov_768.700000	115	186	160	1	71	0.0140845
NODE_301419_length_199_cov_768.700000	115	186	173	1	71	0.0140845
NODE_301419_length_199_cov_768.700000	115	186	181	1	71	0.0140845
NODE_301419_length_199_cov_768.700000	115	186	187	2	71	0.0281690
NODE_301419_length_199_cov_768.700000	115	186	193	1	71	0.0140845
NODE_301419_length_199_cov_768.700000	115	186	197	1	71	0.0140845
NODE_301419_length_199_cov_768.700000	115	186	206	1	71	0.0140845
NODE_301419_length_199_cov_768.700000	115	186	208	1	71	0.0140845
NODE_301419_length_199_cov_768.700000	115	186	215	1	71	0.0140845
NODE_301419_length_199_cov_768.700000	115	186	225	1	71	0.0140845
NODE_301419_length_199_cov_768.700000	115	186	232	1	71	0.0140845
NODE_301419_length_199_cov_768.700000	115	186	243	2	71	0.0281690
NODE_301419_length_199_cov_768.700000	115	186	247	1	71	0.0140845
NODE_301419_length_199_cov_768.700000	115	186	251	1	71	0.0140845
NODE_301419_length_199_cov_768.700000	115	186	262	2	71	0.0281690
NODE_301419_length_199_cov_768.700000	115	186	278	1	71	0.0140845
NODE_301419_length_199_cov_768.700000	115	186	285	1	71	0.0140845
NODE_301419_length_199_cov_768.700000	115	186	291	1	71	0.0140845
NODE_301419_length_199_cov_768.700000	115	186	301	1	71	0.0140845
NODE_301419_length_199_cov_768.700000	115	186	304	1	71	0.0140845
NODE_301419_length_199_cov_768.700000	115	186	308	1	71	0.0140845
NODE_301419_length_199_cov_768.700000	115	186	319	1	71	0.0140845
NODE_301419_length_199_cov_768.700000	115	186	321	2	71	0.0281690
NODE_301419_length_199_cov_768.700000	115	186	330	1	71	0.0140845
NODE_301419_length_199_cov_768.700000	115	186	331	1	71	0.0140845
NODE_301419_length_199_cov_768.700000	115	186	336	1	71	0.0140845
NODE_301419_length_199_cov_768.700000	115	186	337	1	71	0.0140845
NODE_301419_length_199_cov_768.700000	115	186	342	1	71	0.0140845
NODE_301419_length_199_cov_768.700000	115	186	346	1	71	0.0140845
NODE_301419_length_199_cov_768.700000	115	186	348	2	71	0.0281690
NODE_301419_length_199_cov_768.700000	115	186	352	5	71	0.0704225
NODE_301419_length_199_cov_768.700000	115	186	357	1	71	0.0140845
NODE_301419_length_199_cov_768.700000	115	186	361	3	71	0.0422535
NODE_301419_length_199_cov_768.700000	115	186	362	1	71	0.0140845
NODE_301419_length_199_cov_768.700000	115	186	366	1	71	0.0140845
NODE_301419_length_199_cov_768.700000	115	186	372	4	71	0.0563380
NODE_301419_length_199_cov_768.700000	115	186	374	4	71	0.0563380
NODE_301419_length_199_cov_768.700000	115	186	375	1	71	0.0140845
NODE_301419_length_199_cov_768.700000	115	186	378	8	71	0.1126761
NODE_301419_length_199_cov_768.700000	115	186	382	1	71	0.0140845
NODE_301420_length_199_cov_702.860000	3	78	68	1	75	0.0133333
NODE_301420_length_199_cov_702.860000	3	78	146	1	75	0.0133333
NODE_301420_length_199_cov_702.860000	3	78	147	1	75	0.0133333
NODE_301420_length_199_cov_702.860000	3	78	164	1	75	0.0133333
NODE_301420_length_199_cov_702.860000	3	78	168	2	75	0.0266667
NODE_301420_length_199_cov_702.860000	3	78	171	1	75	0.0133333
NODE_301420_length_199_cov_702.860000	3	78	184	1	75	0.0133333
NODE_301420_length_199_cov_702.860000	3	78	195	1	75	0.0133333
NODE_301420_length_199_cov_702.860000	3	78	217	1	75	0.0133333
NODE_301420_length_199_cov_702.860000	3	78	232	1	75	0.0133333
NODE_301420_length_199_cov_702.860000	3	78	254	1	75	0.0133333
NODE_301420_length_199_cov_702.860000	3	78	262	1	75	0.0133333
NODE_301420_length_199_cov_702.860000	3	78	284	1	75	0.0133333
NODE_301420_length_199_cov_702.860000	3	78	330	1	75	0.0133333
NODE_301420_length_199_cov_702.860000	3	78	338	1	75	0.0133333
NODE_301420_length_199_cov_702.860000	3	78	343	1	75	0.0133333
NODE_301420_length_199_cov_702.860000	3	78	349	1	75	0.0133333
NODE_301420_length_199_cov_702.860000	3	78	372	1	75	0.0133333
NODE_301420_length_199_cov_702.860000	3	78	390	1	75	0.0133333
NODE_301420_length_199_cov_702.860000	3	78	403	1	75	0.0133333
NODE_301420_length_199_cov_702.860000	3	78	409	1	75	0.0133333
NODE_301420_length_199_cov_702.860000	3	78	444	1	75	0.0133333
NODE_301420_length_199_cov_702.860000	3	78	477	1	75	0.0133333
NODE_301420_length_199_cov_702.860000	3	78	499	1	75	0.0133333
NODE_301420_length_199_cov_702.860000	3	78	537	1	75	0.0133333
NODE_301420_length_199_cov_702.860000	3	78	550	1	75	0.0133333
NODE_301420_length_199_cov_702.860000	3	78	576	1	75	0.0133333
NODE_301420_length_199_cov_702.860000	3	78	586	1	75	0.0133333
NODE_301420_length_199_cov_702.860000	3	78	595	1	75	0.0133333
NODE_301420_length_199_cov_702.860000	3	78	612	1	75	0.0133333
NODE_301420_length_199_cov_702.860000	3	78	616	1	75	0.0133333
NODE_301420_length_199_cov_702.860000	3	78	623	1	75	0.0133333
NODE_301420_length_199_cov_702.860000	3	78	652	1	75	0.0133333
NODE_301420_length_199_cov_702.860000	3	78	679	1	75	0.0133333
NODE_301420_length_199_cov_702.860000	3	78	722	1	75	0.0133333
NODE_301420_length_199_cov_702.860000	3	78	725	1	75	0.0133333
NODE_301420_length_199_cov_702.860000	3	78	731	1	75	0.0133333
NODE_301420_length_199_cov_702.860000	3	78	747	1	75	0.0133333
NODE_301420_length_199_cov_702.860000	3	78	760	1	75	0.0133333
NODE_301420_length_199_cov_702.860000	3	78	779	1	75	0.0133333
NODE_301420_length_199_cov_702.860000	3	78	786	1	75	0.0133333
NODE_301420_length_199_cov_702.860000	3	78	801	1	75	0.0133333
NODE_301420_length_199_cov_702.860000	3	78	807	1	75	0.0133333
NODE_301420_length_199_cov_702.860000	3	78	834	1	75	0.0133333
NODE_301420_length_199_cov_702.860000	3	78	848	1	75	0.0133333
NODE_301420_length_199_cov_702.860000	3	78	921	1	75	0.0133333
NODE_301420_length_199_cov_702.860000	3	78	926	1	75	0.0133333
NODE_301420_length_199_cov_702.860000	3	78	931	1	75	0.0133333
NODE_301420_length_199_cov_702.860000	3	78	963	1	75	0.0133333
NODE_301420_length_199_cov_702.860000	3	78	971	1	75	0.0133333
NODE_301420_length_199_cov_702.860000	3	78	980	1	75	0.0133333
NODE_301420_length_199_cov_702.860000	3	78	994	1	75	0.0133333
NODE_301420_length_199_cov_702.860000	3	78	1019	1	75	0.0133333
NODE_301420_length_199_cov_702.860000	3	78	1033	1	75	0.0133333
NODE_301420_length_199_cov_702.860000	3	78	1049	1	75	0.0133333
NODE_301420_length_199_cov_702.860000	3	78	1078	1	75	0.0133333
NODE_301420_length_199_cov_702.860000	3	78	1098	1	75	0.0133333
NODE_301420_length_199_cov_702.860000	3	78	1099	1	75	0.0133333
NODE_301420_length_199_cov_702.860000	3	78	1117	2	75	0.0266667
NODE_301420_length_199_cov_702.860000	3	78	1119	1	75	0.0133333
NODE_301420_length_199_cov_702.860000	3	78	1121	1	75	0.0133333
NODE_301420_length_199_cov_702.860000	3	78	1144	1	75	0.0133333
NODE_301420_length_199_cov_702.860000	3	78	1164	1	75	0.0133333
NODE_301420_length_199_cov_702.860000	3	78	1179	1	75	0.0133333
NODE_301420_length_199_cov_702.860000	3	78	1189	2	75	0.0266667
NODE_301420_length_199_cov_702.860000	3	78	1191	1	75	0.0133333
NODE_301420_length_199_cov_702.860000	3	78	1201	1	75	0.0133333
NODE_301420_length_199_cov_702.860000	3	78	1233	1	75	0.0133333
NODE_301420_length_199_cov_702.860000	3	78	1239	2	75	0.0266667
NODE_301420_length_199_cov_702.860000	3	78	1255	1	75	0.0133333
NODE_301420_length_199_cov_702.860000	3	78	1257	1	75	0.0133333
NODE_301420_length_199_cov_702.860000	51	131	931	1	80	0.0125000
NODE_301420_length_199_cov_702.860000	51	131	963	1	80	0.0125000
NODE_301420_length_199_cov_702.860000	51	131	971	1	80	0.0125000
NODE_301420_length_199_cov_702.860000	51	131	980	1	80	0.0125000
NODE_301420_length_199_cov_702.860000	51	131	994	1	80	0.0125000
NODE_301420_length_199_cov_702.860000	51	131	1019	1	80	0.0125000
NODE_301420_length_199_cov_702.860000	51	131	1033	1	80	0.0125000
NODE_301420_length_199_cov_702.860000	51	131	1049	1	80	0.0125000
NODE_301420_length_199_cov_702.860000	51	131	1078	1	80	0.0125000
NODE_301420_length_199_cov_702.860000	51	131	1098	1	80	0.0125000
NODE_301420_length_199_cov_702.860000	51	131	1099	1	80	0.0125000
NODE_301420_length_199_cov_702.860000	51	131	1110	1	80	0.0125000
NODE_301420_length_199_cov_702.860000	51	131	1117	2	80	0.0250000
NODE_301420_length_199_cov_702.860000	51	131	1118	1	80	0.0125000
NODE_301420_length_199_cov_702.860000	51	131	1119	1	80	0.0125000
NODE_301420_length_199_cov_702.860000	51	131	1121	1	80	0.0125000
NODE_301420_length_199_cov_702.860000	51	131	1144	1	80	0.0125000
NODE_301420_length_199_cov_702.860000	51	131	1159	2	80	0.0250000
NODE_301420_length_199_cov_702.860000	51	131	1164	1	80	0.0125000
NODE_301420_length_199_cov_702.860000	51	131	1167	1	80	0.0125000
NODE_301420_length_199_cov_702.860000	51	131	1169	1	80	0.0125000
NODE_301420_length_199_cov_702.860000	51	131	1172	1	80	0.0125000
NODE_301420_length_199_cov_702.860000	51	131	1179	1	80	0.0125000
NODE_301420_length_199_cov_702.860000	51	131	1184	1	80	0.0125000
NODE_301420_length_199_cov_702.860000	51	131	1189	2	80	0.0250000
NODE_301420_length_199_cov_702.860000	51	131	1191	1	80	0.0125000
NODE_301420_length_199_cov_702.860000	51	131	1195	1	80	0.0125000
NODE_301420_length_199_cov_702.860000	51	131	1201	1	80	0.0125000
NODE_301420_length_199_cov_702.860000	51	131	1221	1	80	0.0125000
NODE_301420_length_199_cov_702.860000	51	131	1232	1	80	0.0125000
NODE_301420_length_199_cov_702.860000	51	131	1233	1	80	0.0125000
NODE_301420_length_199_cov_702.860000	51	131	1239	2	80	0.0250000
NODE_301420_length_199_cov_702.860000	51	131	1249	1	80	0.0125000
NODE_301420_length_199_cov_702.860000	51	131	1255	1	80	0.0125000
NODE_301420_length_199_cov_702.860000	51	131	1257	1	80	0.0125000
NODE_301420_length_199_cov_702.860000	51	131	1276	1	80	0.0125000
NODE_301420_length_199_cov_702.860000	51	131	1279	2	80	0.0250000
NODE_301420_length_199_cov_702.860000	51	131	1281	1	80	0.0125000
NODE_301420_length_199_cov_702.860000	51	131	1283	1	80	0.0125000
NODE_301420_length_199_cov_702.860000	51	131	1285	1	80	0.0125000
NODE_301420_length_199_cov_702.860000	51	131	1295	1	80	0.0125000
NODE_301420_length_199_cov_702.860000	51	131	1299	1	80	0.0125000
NODE_301420_length_199_cov_702.860000	51	131	1315	1	80	0.0125000
NODE_301420_length_199_cov_702.860000	51	131	1331	1	80	0.0125000
NODE_301420_length_199_cov_702.860000	51	131	1333	1	80	0.0125000
NODE_301420_length_199_cov_702.860000	51	131	1340	1	80	0.0125000
NODE_301420_length_199_cov_702.860000	51	131	1341	1	80	0.0125000
NODE_301420_length_199_cov_702.860000	51	131	1355	1	80	0.0125000
NODE_301420_length_199_cov_702.860000	51	131	1357	1	80	0.0125000
NODE_301420_length_199_cov_702.860000	51	131	1360	1	80	0.0125000
NODE_301420_length_199_cov_702.860000	51	131	1365	2	80	0.0250000
NODE_301420_length_199_cov_702.860000	51	131	1367	1	80	0.0125000
NODE_301420_length_199_cov_702.860000	51	131	1370	1	80	0.0125000
NODE_301420_length_199_cov_702.860000	51	131	1378	3	80	0.0375000
NODE_301420_length_199_cov_702.860000	51	131	1380	1	80	0.0125000
NODE_301420_length_199_cov_702.860000	51	131	1381	1	80	0.0125000
NODE_301420_length_199_cov_702.860000	51	131	1382	2	80	0.0250000
NODE_301420_length_199_cov_702.860000	51	131	1384	1	80	0.0125000
NODE_301420_length_199_cov_702.860000	51	131	1385	1	80	0.0125000
NODE_301420_length_199_cov_702.860000	51	131	1386	1	80	0.0125000
NODE_301420_length_199_cov_702.860000	51	131	1388	1	80	0.0125000
NODE_301420_length_199_cov_702.860000	51	131	1390	1	80	0.0125000
NODE_301420_length_199_cov_702.860000	51	131	1396	2	80	0.0250000
NODE_301420_length_199_cov_702.860000	51	131	1402	7	80	0.0875000
NODE_301421_length_199_cov_670.570000	22	52	330	1	30	0.0333333
NODE_301421_length_199_cov_670.570000	22	52	341	1	30	0.0333333
NODE_301421_length_199_cov_670.570000	22	52	352	1	30	0.0333333
NODE_301421_length_199_cov_670.570000	22	52	359	1	30	0.0333333
NODE_301421_length_199_cov_670.570000	22	52	391	1	30	0.0333333
NODE_301421_length_199_cov_670.570000	22	52	400	1	30	0.0333333
NODE_301421_length_199_cov_670.570000	22	52	424	1	30	0.0333333
NODE_301421_length_199_cov_670.570000	22	52	428	1	30	0.0333333
NODE_301421_length_199_cov_670.570000	22	52	433	1	30	0.0333333
NODE_301421_length_199_cov_670.570000	22	52	443	1	30	0.0333333
NODE_301421_length_199_cov_670.570000	22	52	447	1	30	0.0333333
NODE_301421_length_199_cov_670.570000	22	52	457	1	30	0.0333333
NODE_301421_length_199_cov_670.570000	22	52	464	1	30	0.0333333
NODE_301421_length_199_cov_670.570000	22	52	492	1	30	0.0333333
NODE_301421_length_199_cov_670.570000	22	52	502	1	30	0.0333333
NODE_301421_length_199_cov_670.570000	22	52	504	1	30	0.0333333
NODE_301421_length_199_cov_670.570000	22	52	514	1	30	0.0333333
NODE_301421_length_199_cov_670.570000	22	52	519	1	30	0.0333333
NODE_301421_length_199_cov_670.570000	22	52	523	1	30	0.0333333
NODE_301421_length_199_cov_670.570000	22	52	526	2	30	0.0666667
NODE_301421_length_199_cov_670.570000	22	52	528	1	30	0.0333333
NODE_301421_length_199_cov_670.570000	22	52	530	1	30	0.0333333
NODE_301421_length_199_cov_670.570000	22	52	535	1	30	0.0333333
NODE_301421_length_199_cov_670.570000	22	52	538	1	30	0.0333333
NODE_301421_length_199_cov_670.570000	22	52	547	1	30	0.0333333
NODE_301421_length_199_cov_670.570000	22	52	551	1	30	0.0333333
NODE_301421_length_199_cov_670.570000	22	52	559	1	30	0.0333333
NODE_301421_length_199_cov_670.570000	22	52	568	1	30	0.0333333
NODE_301421_length_199_cov_670.570000	22	52	572	1	30	0.0333333
NODE_301421_length_199_cov_670.570000	25	105	359	1	80	0.0125000
NODE_301421_length_199_cov_670.570000	25	105	391	1	80	0.0125000
NODE_301421_length_199_cov_670.570000	25	105	400	1	80	0.0125000
NODE_301421_length_199_cov_670.570000	25	105	424	1	80	0.0125000
NODE_301421_length_199_cov_670.570000	25	105	428	1	80	0.0125000
NODE_301421_length_199_cov_670.570000	25	105	433	1	80	0.0125000
NODE_301421_length_199_cov_670.570000	25	105	443	1	80	0.0125000
NODE_301421_length_199_cov_670.570000	25	105	447	1	80	0.0125000
NODE_301421_length_199_cov_670.570000	25	105	457	1	80	0.0125000
NODE_301421_length_199_cov_670.570000	25	105	464	1	80	0.0125000
NODE_301421_length_199_cov_670.570000	25	105	492	1	80	0.0125000
NODE_301421_length_199_cov_670.570000	25	105	502	1	80	0.0125000
NODE_301421_length_199_cov_670.570000	25	105	504	1	80	0.0125000
NODE_301421_length_199_cov_670.570000	25	105	514	1	80	0.0125000
NODE_301421_length_199_cov_670.570000	25	105	519	1	80	0.0125000
NODE_301421_length_199_cov_670.570000	25	105	523	1	80	0.0125000
NODE_301421_length_199_cov_670.570000	25	105	526	2	80	0.0250000
NODE_301421_length_199_cov_670.570000	25	105	528	1	80	0.0125000
NODE_301421_length_199_cov_670.570000	25	105	530	1	80	0.0125000
NODE_301421_length_199_cov_670.570000	25	105	535	1	80	0.0125000
NODE_301421_length_199_cov_670.570000	25	105	538	1	80	0.0125000
NODE_301421_length_199_cov_670.570000	25	105	547	1	80	0.0125000
NODE_301421_length_199_cov_670.570000	25	105	551	1	80	0.0125000
NODE_301421_length_199_cov_670.570000	25	105	559	1	80	0.0125000
NODE_301421_length_199_cov_670.570000	25	105	568	1	80	0.0125000
NODE_301421_length_199_cov_670.570000	25	105	572	1	80	0.0125000
NODE_301421_length_199_cov_670.570000	25	105	576	1	80	0.0125000
NODE_301421_length_199_cov_670.570000	25	105	581	1	80	0.0125000
NODE_301421_length_199_cov_670.570000	25	105	596	1	80	0.0125000
NODE_301421_length_199_cov_670.570000	25	105	607	1	80	0.0125000
NODE_301421_length_199_cov_670.570000	25	105	609	2	80	0.0250000
NODE_301421_length_199_cov_670.570000	25	105	613	1	80	0.0125000
NODE_301421_length_199_cov_670.570000	25	105	615	1	80	0.0125000
NODE_301421_length_199_cov_670.570000	25	105	619	1	80	0.0125000
NODE_301421_length_199_cov_670.570000	25	105	622	1	80	0.0125000
NODE_301421_length_199_cov_670.570000	25	105	629	2	80	0.0250000
NODE_301421_length_199_cov_670.570000	25	105	632	2	80	0.0250000
NODE_301421_length_199_cov_670.570000	25	105	636	2	80	0.0250000
NODE_301421_length_199_cov_670.570000	25	105	642	2	80	0.0250000
NODE_301421_length_199_cov_670.570000	25	105	646	1	80	0.0125000
NODE_301421_length_199_cov_670.570000	25	105	649	1	80	0.0125000
NODE_301421_length_199_cov_670.570000	25	105	651	2	80	0.0250000
NODE_301421_length_199_cov_670.570000	25	105	661	1	80	0.0125000
NODE_301421_length_199_cov_670.570000	25	105	667	1	80	0.0125000
NODE_301421_length_199_cov_670.570000	25	105	675	3	80	0.0375000
NODE_301421_length_199_cov_670.570000	25	105	677	2	80	0.0250000
NODE_301421_length_199_cov_670.570000	25	105	681	1	80	0.0125000
NODE_301421_length_199_cov_670.570000	25	105	683	2	80	0.0250000
NODE_301421_length_199_cov_670.570000	25	105	687	1	80	0.0125000
NODE_301421_length_199_cov_670.570000	25	105	697	2	80	0.0250000
NODE_301421_length_199_cov_670.570000	25	105	699	3	80	0.0375000
NODE_301421_length_199_cov_670.570000	25	105	701	3	80	0.0375000
NODE_301421_length_199_cov_670.570000	25	105	703	1	80	0.0125000
NODE_301421_length_199_cov_670.570000	25	105	705	2	80	0.0250000
NODE_301421_length_199_cov_670.570000	25	105	709	3	80	0.0375000
NODE_301421_length_199_cov_670.570000	25	105	711	6	80	0.0750000
NODE_301430_length_199_cov_215.860000	3	75	6	7	72	0.0972222
NODE_301430_length_199_cov_215.860000	3	75	12	5	72	0.0694444
NODE_301430_length_199_cov_215.860000	3	75	16	2	72	0.0277778
NODE_301430_length_199_cov_215.860000	3	75	18	5	72	0.0694444
NODE_301430_length_199_cov_215.860000	3	75	25	5	72	0.0694444
NODE_301430_length_199_cov_215.860000	3	75	29	1	72	0.0138889
NODE_301430_length_199_cov_215.860000	3	75	31	1	72	0.0138889
NODE_301430_length_199_cov_215.860000	3	75	32	4	72	0.0555556
NODE_301430_length_199_cov_215.860000	3	75	33	1	72	0.0138889
NODE_301430_length_199_cov_215.860000	3	75	35	3	72	0.0416667
NODE_301430_length_199_cov_215.860000	3	75	41	2	72	0.0277778
NODE_301430_length_199_cov_215.860000	3	75	49	1	72	0.0138889
NODE_301430_length_199_cov_215.860000	3	75	51	1	72	0.0138889
NODE_301430_length_199_cov_215.860000	3	75	53	3	72	0.0416667
NODE_301430_length_199_cov_215.860000	3	75	54	1	72	0.0138889
NODE_301430_length_199_cov_215.860000	3	75	56	2	72	0.0277778
NODE_301430_length_199_cov_215.860000	3	75	59	2	72	0.0277778
NODE_301430_length_199_cov_215.860000	3	75	62	1	72	0.0138889
NODE_301430_length_199_cov_215.860000	3	75	64	2	72	0.0277778
NODE_301430_length_199_cov_215.860000	3	75	68	1	72	0.0138889
NODE_301430_length_199_cov_215.860000	3	75	70	6	72	0.0833333
NODE_301430_length_199_cov_215.860000	3	75	72	3	72	0.0416667
NODE_301430_length_199_cov_215.860000	3	75	74	2	72	0.0277778
NODE_301430_length_199_cov_215.860000	3	75	76	1	72	0.0138889
NODE_301430_length_199_cov_215.860000	3	75	78	10	72	0.1388889
NODE_301430_length_199_cov_215.860000	48	128	59	1	80	0.0125000
NODE_301430_length_199_cov_215.860000	48	128	62	1	80	0.0125000
NODE_301430_length_199_cov_215.860000	48	128	64	2	80	0.0250000
NODE_301430_length_199_cov_215.860000	48	128	68	1	80	0.0125000
NODE_301430_length_199_cov_215.860000	48	128	70	6	80	0.0750000
NODE_301430_length_199_cov_215.860000	48	128	72	3	80	0.0375000
NODE_301430_length_199_cov_215.860000	48	128	73	6	80	0.0750000
NODE_301430_length_199_cov_215.860000	48	128	74	2	80	0.0250000
NODE_301430_length_199_cov_215.860000	48	128	76	1	80	0.0125000
NODE_301430_length_199_cov_215.860000	48	128	77	7	80	0.0875000
NODE_301430_length_199_cov_215.860000	48	128	78	19	80	0.2375000
NODE_301430_length_199_cov_215.860000	48	128	80	1	80	0.0125000
NODE_301430_length_199_cov_215.860000	48	128	82	4	80	0.0500000
NODE_301430_length_199_cov_215.860000	48	128	84	10	80	0.1250000
NODE_301430_length_199_cov_215.860000	48	128	86	16	80	0.2000000
NODE_301432_length_199_cov_206.800000	120	199	0	79	79	1.0000000
NODE_301441_length_199_cov_131.120000	97	177	0	80	80	1.0000000
NODE_301448_length_199_cov_97.490000	4	77	10	2	73	0.0273973
NODE_301448_length_199_cov_97.490000	4	77	12	2	73	0.0273973
NODE_301448_length_199_cov_97.490000	4	77	14	3	73	0.0410959
NODE_301448_length_199_cov_97.490000	4	77	16	2	73	0.0273973
NODE_301448_length_199_cov_97.490000	4	77	22	2	73	0.0273973
NODE_301448_length_199_cov_97.490000	4	77	23	2	73	0.0273973
NODE_301448_length_199_cov_97.490000	4	77	25	1	73	0.0136986
NODE_301448_length_199_cov_97.490000	4	77	27	2	73	0.0273973
NODE_301448_length_199_cov_97.490000	4	77	29	2	73	0.0273973
NODE_301448_length_199_cov_97.490000	4	77	33	3	73	0.0410959
NODE_301448_length_199_cov_97.490000	4	77	35	1	73	0.0136986
NODE_301448_length_199_cov_97.490000	4	77	37	6	73	0.0821918
NODE_301448_length_199_cov_97.490000	4	77	41	3	73	0.0410959
NODE_301448_length_199_cov_97.490000	4	77	43	1	73	0.0136986
NODE_301448_length_199_cov_97.490000	4	77	45	1	73	0.0136986
NODE_301448_length_199_cov_97.490000	4	77	49	1	73	0.0136986
NODE_301448_length_199_cov_97.490000	4	77	53	1	73	0.0136986
NODE_301448_length_199_cov_97.490000	4	77	57	2	73	0.0273973
NODE_301448_length_199_cov_97.490000	4	77	60	1	73	0.0136986
NODE_301448_length_199_cov_97.490000	4	77	63	1	73	0.0136986
NODE_301448_length_199_cov_97.490000	4	77	65	3	73	0.0410959
NODE_301448_length_199_cov_97.490000	4	77	67	1	73	0.0136986
NODE_301448_length_199_cov_97.490000	4	77	69	1	73	0.0136986
NODE_301448_length_199_cov_97.490000	4	77	70	1	73	0.0136986
NODE_301448_length_199_cov_97.490000	4	77	72	1	73	0.0136986
NODE_301448_length_199_cov_97.490000	4	77	74	3	73	0.0410959
NODE_301448_length_199_cov_97.490000	4	77	75	1	73	0.0136986
NODE_301448_length_199_cov_97.490000	4	77	80	1	73	0.0136986
NODE_301448_length_199_cov_97.490000	4	77	82	3	73	0.0410959
NODE_301448_length_199_cov_97.490000	4	77	83	3	73	0.0410959
NODE_301448_length_199_cov_97.490000	4	77	96	1	73	0.0136986
NODE_301448_length_199_cov_97.490000	4	77	97	15	73	0.2054795
NODE_301449_length_199_cov_96.090000	91	171	2	6	80	0.0750000
NODE_301449_length_199_cov_96.090000	91	171	6	1	80	0.0125000
NODE_301449_length_199_cov_96.090000	91	171	8	2	80	0.0250000
NODE_301449_length_199_cov_96.090000	91	171	12	14	80	0.1750000
NODE_301449_length_199_cov_96.090000	91	171	16	2	80	0.0250000
NODE_301449_length_199_cov_96.090000	91	171	18	4	80	0.0500000
NODE_301449_length_199_cov_96.090000	91	171	20	7	80	0.0875000
NODE_301449_length_199_cov_96.090000	91	171	22	27	80	0.3375000
NODE_301449_length_199_cov_96.090000	91	171	24	17	80	0.2125000
NODE_301455_length_199_cov_84.060000	44	75	21	4	31	0.1290323
NODE_301455_length_199_cov_84.060000	44	75	23	3	31	0.0967742
NODE_301455_length_199_cov_84.060000	44	75	26	1	31	0.0322581
NODE_301455_length_199_cov_84.060000	44	75	27	10	31	0.3225806
NODE_301455_length_199_cov_84.060000	44	75	28	13	31	0.4193548
NODE_301456_length_199_cov_83.220000	0	64	0	64	64	1.0000000
NODE_301459_length_199_cov_80.390000	15	98	4	1	83	0.0120482
NODE_301459_length_199_cov_80.390000	15	98	6	2	83	0.0240964
NODE_301459_length_199_cov_80.390000	15	98	8	1	83	0.0120482
NODE_301459_length_199_cov_80.390000	15	98	14	10	83	0.1204819
NODE_301459_length_199_cov_80.390000	15	98	24	5	83	0.0602410
NODE_301459_length_199_cov_80.390000	15	98	26	5	83	0.0602410
NODE_301459_length_199_cov_80.390000	15	98	30	2	83	0.0240964
NODE_301459_length_199_cov_80.390000	15	98	34	2	83	0.0240964
NODE_301459_length_199_cov_80.390000	15	98	36	34	83	0.4096386
NODE_301459_length_199_cov_80.390000	15	98	38	15	83	0.1807229
NODE_301459_length_199_cov_80.390000	15	98	40	6	83	0.0722892
NODE_301469_length_199_cov_63.420000	128	194	10	2	66	0.0303030
NODE_301469_length_199_cov_63.420000	128	194	14	2	66	0.0303030
NODE_301469_length_199_cov_63.420000	128	194	17	2	66	0.0303030
NODE_301469_length_199_cov_63.420000	128	194	19	1	66	0.0151515
NODE_301469_length_199_cov_63.420000	128	194	24	1	66	0.0151515
NODE_301469_length_199_cov_63.420000	128	194	26	1	66	0.0151515
NODE_301469_length_199_cov_63.420000	128	194	30	1	66	0.0151515
NODE_301469_length_199_cov_63.420000	128	194	34	1	66	0.0151515
NODE_301469_length_199_cov_63.420000	128	194	35	1	66	0.0151515
NODE_301469_length_199_cov_63.420000	128	194	36	1	66	0.0151515
NODE_301469_length_199_cov_63.420000	128	194	40	1	66	0.0151515
NODE_301469_length_199_cov_63.420000	128	194	45	1	66	0.0151515
NODE_301469_length_199_cov_63.420000	128	194	46	1	66	0.0151515
NODE_301469_length_199_cov_63.420000	128	194	53	2	66	0.0303030
NODE_301469_length_199_cov_63.420000	128	194	55	3	66	0.0454545
NODE_301469_length_199_cov_63.420000	128	194	56	1	66	0.0151515
NODE_301469_length_199_cov_63.420000	128	194	58	3	66	0.0454545
NODE_301469_length_199_cov_63.420000	128	194	60	1	66	0.0151515
NODE_301469_length_199_cov_63.420000	128	194	61	1	66	0.0151515
NODE_301469_length_199_cov_63.420000	128	194	64	1	66	0.0151515
NODE_301469_length_199_cov_63.420000	128	194	72	1	66	0.0151515
NODE_301469_length_199_cov_63.420000	128	194	73	1	66	0.0151515
NODE_301469_length_199_cov_63.420000	128	194	74	1	66	0.0151515
NODE_301469_length_199_cov_63.420000	128	194	79	1	66	0.0151515
NODE_301469_length_199_cov_63.420000	128	194	85	1	66	0.0151515
NODE_301469_length_199_cov_63.420000	128	194	87	1	66	0.0151515
NODE_301469_length_199_cov_63.420000	128	194	90	2	66	0.0303030
NODE_301469_length_199_cov_63.420000	128	194	92	1	66	0.0151515
NODE_301469_length_199_cov_63.420000	128	194	98	1	66	0.0151515
NODE_301469_length_199_cov_63.420000	128	194	101	2	66	0.0303030
NODE_301469_length_199_cov_63.420000	128	194	105	2	66	0.0303030
NODE_301469_length_199_cov_63.420000	128	194	108	3	66	0.0454545
NODE_301469_length_199_cov_63.420000	128	194	116	1	66	0.0151515
NODE_301469_length_199_cov_63.420000	128	194	120	1	66	0.0151515
NODE_301469_length_199_cov_63.420000	128	194	123	2	66	0.0303030
NODE_301469_length_199_cov_63.420000	128	194	125	1	66	0.0151515
NODE_301469_length_199_cov_63.420000	128	194	126	1	66	0.0151515
NODE_301469_length_199_cov_63.420000	128	194	127	1	66	0.0151515
NODE_301469_length_199_cov_63.420000	128	194	128	2	66	0.0303030
NODE_301469_length_199_cov_63.420000	128	194	129	1	66	0.0151515
NODE_301469_length_199_cov_63.420000	128	194	131	2	66	0.0303030
NODE_301469_length_199_cov_63.420000	128	194	137	4	66	0.0606061
NODE_301469_length_199_cov_63.420000	128	194	143	1	66	0.0151515
NODE_301469_length_199_cov_63.420000	128	194	144	1	66	0.0151515
NODE_301469_length_199_cov_63.420000	128	194	151	2	66	0.0303030
NODE_301469_length_199_cov_63.420000	128	194	157	1	66	0.0151515
NODE_301477_length_199_cov_58.660000	18	85	0	67	67	1.0000000
NODE_301484_length_199_cov_50.350000	102	183	0	81	81	1.0000000
NODE_301485_length_199_cov_49.630000	5	47	2	35	42	0.8333333
NODE_301485_length_199_cov_49.630000	5	47	8	7	42	0.1666667
NODE_301485_length_199_cov_49.630000	100	163	8	17	63	0.2698413
NODE_301485_length_199_cov_49.630000	100	163	13	2	63	0.0317460
NODE_301485_length_199_cov_49.630000	100	163	14	20	63	0.3174603
NODE_301485_length_199_cov_49.630000	100	163	16	24	63	0.3809524
NODE_301485_length_199_cov_49.630000	100	163	8	17	63	0.2698413
NODE_301485_length_199_cov_49.630000	100	163	13	2	63	0.0317460
NODE_301485_length_199_cov_49.630000	100	163	14	20	63	0.3174603
NODE_301485_length_199_cov_49.630000	100	163	16	24	63	0.3809524
NODE_301485_length_199_cov_49.630000	100	163	8	17	63	0.2698413
NODE_301485_length_199_cov_49.630000	100	163	13	2	63	0.0317460
NODE_301485_length_199_cov_49.630000	100	163	14	20	63	0.3174603
NODE_301485_length_199_cov_49.630000	100	163	16	24	63	0.3809524
NODE_301485_length_199_cov_49.630000	136	185	4	17	49	0.3469388
NODE_301485_length_199_cov_49.630000	136	185	8	22	49	0.4489796
NODE_301485_length_199_cov_49.630000	136	185	13	2	49	0.0408163
NODE_301485_length_199_cov_49.630000	136	185	14	8	49	0.1632653
NODE_301485_length_199_cov_49.630000	153	199	0	1	46	0.0217391
NODE_301485_length_199_cov_49.630000	153	199	2	13	46	0.2826087
NODE_301485_length_199_cov_49.630000	153	199	4	17	46	0.3695652
NODE_301485_length_199_cov_49.630000	153	199	8	15	46	0.3260870
NODE_301491_length_199_cov_40.000000	0	66	0	2	66	0.0303030
NODE_301491_length_199_cov_40.000000	0	66	2	3	66	0.0454545
NODE_301491_length_199_cov_40.000000	0	66	10	1	66	0.0151515
NODE_301491_length_199_cov_40.000000	0	66	11	10	66	0.1515152
NODE_301491_length_199_cov_40.000000	0	66	12	11	66	0.1666667
NODE_301491_length_199_cov_40.000000	0	66	14	3	66	0.0454545
NODE_301491_length_199_cov_40.000000	0	66	18	2	66	0.0303030
NODE_301491_length_199_cov_40.000000	0	66	20	7	66	0.1060606
NODE_301491_length_199_cov_40.000000	0	66	22	18	66	0.2727273
NODE_301491_length_199_cov_40.000000	0	66	28	1	66	0.0151515
NODE_301491_length_199_cov_40.000000	0	66	30	4	66	0.0606061
NODE_301491_length_199_cov_40.000000	0	66	31	4	66	0.0606061
NODE_301491_length_199_cov_40.000000	34	114	20	5	80	0.0625000
NODE_301491_length_199_cov_40.000000	34	114	22	18	80	0.2250000
NODE_301491_length_199_cov_40.000000	34	114	28	1	80	0.0125000
NODE_301491_length_199_cov_40.000000	34	114	30	4	80	0.0500000
NODE_301491_length_199_cov_40.000000	34	114	31	9	80	0.1125000
NODE_301491_length_199_cov_40.000000	34	114	32	21	80	0.2625000
NODE_301491_length_199_cov_40.000000	34	114	34	22	80	0.2750000
NODE_301491_length_199_cov_40.000000	39	61	22	18	22	0.8181818
NODE_301491_length_199_cov_40.000000	39	61	28	1	22	0.0454545
NODE_301491_length_199_cov_40.000000	39	61	30	3	22	0.1363636
NODE_301498_length_199_cov_31.400000	3	77	0	1	74	0.0135135
NODE_301498_length_199_cov_31.400000	3	77	1	1	74	0.0135135
NODE_301498_length_199_cov_31.400000	3	77	2	8	74	0.1081081
NODE_301498_length_199_cov_31.400000	3	77	4	3	74	0.0405405
NODE_301498_length_199_cov_31.400000	3	77	6	61	74	0.8243243
NODE_301498_length_199_cov_31.400000	76	153	6	11	77	0.1428571
NODE_301498_length_199_cov_31.400000	76	153	8	2	77	0.0259740
NODE_301498_length_199_cov_31.400000	76	153	11	2	77	0.0259740
NODE_301498_length_199_cov_31.400000	76	153	14	2	77	0.0259740
NODE_301498_length_199_cov_31.400000	76	153	15	2	77	0.0259740
NODE_301498_length_199_cov_31.400000	76	153	16	58	77	0.7532467
NODE_301498_length_199_cov_31.400000	76	153	6	11	77	0.1428571
NODE_301498_length_199_cov_31.400000	76	153	8	2	77	0.0259740
NODE_301498_length_199_cov_31.400000	76	153	11	2	77	0.0259740
NODE_301498_length_199_cov_31.400000	76	153	14	2	77	0.0259740
NODE_301498_length_199_cov_31.400000	76	153	15	2	77	0.0259740
NODE_301498_length_199_cov_31.400000	76	153	16	58	77	0.7532467
NODE_301498_length_199_cov_31.400000	76	153	6	11	77	0.1428571
NODE_301498_length_199_cov_31.400000	76	153	8	2	77	0.0259740
NODE_301498_length_199_cov_31.400000	76	153	11	2	77	0.0259740
NODE_301498_length_199_cov_31.400000	76	153	14	2	77	0.0259740
NODE_301498_length_199_cov_31.400000	76	153	15	2	77	0.0259740
NODE_301498_length_199_cov_31.400000	76	153	16	58	77	0.7532467
NODE_301498_length_199_cov_31.400000	126	192	0	17	66	0.2575758
NODE_301498_length_199_cov_31.400000	126	192	2	9	66	0.1363636
NODE_301498_length_199_cov_31.400000	126	192	4	3	66	0.0454545
NODE_301498_length_199_cov_31.400000	126	192	10	10	66	0.1515152
NODE_301498_length_199_cov_31.400000	126	192	11	2	66	0.0303030
NODE_301498_length_199_cov_31.400000	126	192	15	2	66	0.0303030
NODE_301498_length_199_cov_31.400000	126	192	16	23	66	0.3484848
NODE_301498_length_199_cov_31.400000	129	199	0	24	70	0.3428572
NODE_301498_length_199_cov_31.400000	129	199	2	9	70	0.1285714
NODE_301498_length_199_cov_31.400000	129	199	4	3	70	0.0428571
NODE_301498_length_199_cov_31.400000	129	199	10	10	70	0.1428571
NODE_301498_length_199_cov_31.400000	129	199	11	2	70	0.0285714
NODE_301498_length_199_cov_31.400000	129	199	15	2	70	0.0285714
NODE_301498_length_199_cov_31.400000	129	199	16	20	70	0.2857143
NODE_301498_length_199_cov_31.400000	131	199	0	24	68	0.3529412
NODE_301498_length_199_cov_31.400000	131	199	2	9	68	0.1323529
NODE_301498_length_199_cov_31.400000	131	199	4	3	68	0.0441176
NODE_301498_length_199_cov_31.400000	131	199	10	10	68	0.1470588
NODE_301498_length_199_cov_31.400000	131	199	11	2	68	0.0294118
NODE_301498_length_199_cov_31.400000	131	199	15	2	68	0.0294118
NODE_301498_length_199_cov_31.400000	131	199	16	18	68	0.2647059
NODE_301500_length_199_cov_30.140000	118	198	0	3	80	0.0375000
NODE_301500_length_199_cov_30.140000	118	198	1	48	80	0.6000000
NODE_301500_length_199_cov_30.140000	118	198	2	29	80	0.3625000
NODE_301500_length_199_cov_30.140000	118	198	0	3	80	0.0375000
NODE_301500_length_199_cov_30.140000	118	198	1	48	80	0.6000000
NODE_301500_length_199_cov_30.140000	118	198	2	29	80	0.3625000
NODE_301500_length_199_cov_30.140000	118	198	0	3	80	0.0375000
NODE_301500_length_199_cov_30.140000	118	198	1	48	80	0.6000000
NODE_301500_length_199_cov_30.140000	118	198	2	29	80	0.3625000
NODE_301500_length_199_cov_30.140000	118	198	0	3	80	0.0375000
NODE_301500_length_199_cov_30.140000	118	198	1	48	80	0.6000000
NODE_301500_length_199_cov_30.140000	118	198	2	29	80	0.3625000
NODE_301500_length_199_cov_30.140000	118	198	0	3	80	0.0375000
NODE_301500_length_199_cov_30.140000	118	198	1	48	80	0.6000000
NODE_301500_length_199_cov_30.140000	118	198	2	29	80	0.3625000
NODE_301500_length_199_cov_30.140000	127	198	0	3	71	0.0422535
NODE_301500_length_199_cov_30.140000	127	198	1	48	71	0.6760563
NODE_301500_length_199_cov_30.140000	127	198	2	20	71	0.2816902
NODE_301581_length_197_cov_41.265306	0	70	0	70	70	1.0000000
NODE_301611_length_196_cov_101.855670	72	136	200	2	64	0.0312500
NODE_301611_length_196_cov_101.855670	72	136	202	2	64	0.0312500
NODE_301611_length_196_cov_101.855670	72	136	206	1	64	0.0156250
NODE_301611_length_196_cov_101.855670	72	136	208	1	64	0.0156250
NODE_301611_length_196_cov_101.855670	72	136	217	1	64	0.0156250
NODE_301611_length_196_cov_101.855670	72	136	218	1	64	0.0156250
NODE_301611_length_196_cov_101.855670	72	136	224	1	64	0.0156250
NODE_301611_length_196_cov_101.855670	72	136	226	1	64	0.0156250
NODE_301611_length_196_cov_101.855670	72	136	230	1	64	0.0156250
NODE_301611_length_196_cov_101.855670	72	136	233	2	64	0.0312500
NODE_301611_length_196_cov_101.855670	72	136	235	1	64	0.0156250
NODE_301611_length_196_cov_101.855670	72	136	239	1	64	0.0156250
NODE_301611_length_196_cov_101.855670	72	136	244	2	64	0.0312500
NODE_301611_length_196_cov_101.855670	72	136	248	1	64	0.0156250
NODE_301611_length_196_cov_101.855670	72	136	251	1	64	0.0156250
NODE_301611_length_196_cov_101.855670	72	136	252	3	64	0.0468750
NODE_301611_length_196_cov_101.855670	72	136	254	5	64	0.0781250
NODE_301611_length_196_cov_101.855670	72	136	256	4	64	0.0625000
NODE_301611_length_196_cov_101.855670	72	136	258	7	64	0.1093750
NODE_301611_length_196_cov_101.855670	72	136	260	4	64	0.0625000
NODE_301611_length_196_cov_101.855670	72	136	262	1	64	0.0156250
NODE_301611_length_196_cov_101.855670	72	136	264	6	64	0.0937500
NODE_301611_length_196_cov_101.855670	72	136	266	15	64	0.2343750
NODE_301611_length_196_cov_101.855670	72	136	200	2	64	0.0312500
NODE_301611_length_196_cov_101.855670	72	136	202	2	64	0.0312500
NODE_301611_length_196_cov_101.855670	72	136	206	1	64	0.0156250
NODE_301611_length_196_cov_101.855670	72	136	208	1	64	0.0156250
NODE_301611_length_196_cov_101.855670	72	136	217	1	64	0.0156250
NODE_301611_length_196_cov_101.855670	72	136	218	1	64	0.0156250
NODE_301611_length_196_cov_101.855670	72	136	224	1	64	0.0156250
NODE_301611_length_196_cov_101.855670	72	136	226	1	64	0.0156250
NODE_301611_length_196_cov_101.855670	72	136	230	1	64	0.0156250
NODE_301611_length_196_cov_101.855670	72	136	233	2	64	0.0312500
NODE_301611_length_196_cov_101.855670	72	136	235	1	64	0.0156250
NODE_301611_length_196_cov_101.855670	72	136	239	1	64	0.0156250
NODE_301611_length_196_cov_101.855670	72	136	244	2	64	0.0312500
NODE_301611_length_196_cov_101.855670	72	136	248	1	64	0.0156250
NODE_301611_length_196_cov_101.855670	72	136	251	1	64	0.0156250
NODE_301611_length_196_cov_101.855670	72	136	252	3	64	0.0468750
NODE_301611_length_196_cov_101.855670	72	136	254	5	64	0.0781250
NODE_301611_length_196_cov_101.855670	72	136	256	4	64	0.0625000
NODE_301611_length_196_cov_101.855670	72	136	258	7	64	0.1093750
NODE_301611_length_196_cov_101.855670	72	136	260	4	64	0.0625000
NODE_301611_length_196_cov_101.855670	72	136	262	1	64	0.0156250
NODE_301611_length_196_cov_101.855670	72	136	264	6	64	0.0937500
NODE_301611_length_196_cov_101.855670	72	136	266	15	64	0.2343750
NODE_301611_length_196_cov_101.855670	109	169	56	1	60	0.0166667
NODE_301611_length_196_cov_101.855670	109	169	59	1	60	0.0166667
NODE_301611_length_196_cov_101.855670	109	169	61	2	60	0.0333333
NODE_301611_length_196_cov_101.855670	109	169	63	1	60	0.0166667
NODE_301611_length_196_cov_101.855670	109	169	69	2	60	0.0333333
NODE_301611_length_196_cov_101.855670	109	169	71	2	60	0.0333333
NODE_301611_length_196_cov_101.855670	109	169	73	1	60	0.0166667
NODE_301611_length_196_cov_101.855670	109	169	74	1	60	0.0166667
NODE_301611_length_196_cov_101.855670	109	169	75	1	60	0.0166667
NODE_301611_length_196_cov_101.855670	109	169	84	3	60	0.0500000
NODE_301611_length_196_cov_101.855670	109	169	90	2	60	0.0333333
NODE_301611_length_196_cov_101.855670	109	169	97	1	60	0.0166667
NODE_301611_length_196_cov_101.855670	109	169	105	1	60	0.0166667
NODE_301611_length_196_cov_101.855670	109	169	116	1	60	0.0166667
NODE_301611_length_196_cov_101.855670	109	169	117	1	60	0.0166667
NODE_301611_length_196_cov_101.855670	109	169	126	1	60	0.0166667
NODE_301611_length_196_cov_101.855670	109	169	133	1	60	0.0166667
NODE_301611_length_196_cov_101.855670	109	169	134	1	60	0.0166667
NODE_301611_length_196_cov_101.855670	109	169	151	1	60	0.0166667
NODE_301611_length_196_cov_101.855670	109	169	156	1	60	0.0166667
NODE_301611_length_196_cov_101.855670	109	169	161	2	60	0.0333333
NODE_301611_length_196_cov_101.855670	109	169	169	1	60	0.0166667
NODE_301611_length_196_cov_101.855670	109	169	171	2	60	0.0333333
NODE_301611_length_196_cov_101.855670	109	169	181	1	60	0.0166667
NODE_301611_length_196_cov_101.855670	109	169	192	1	60	0.0166667
NODE_301611_length_196_cov_101.855670	109	169	200	2	60	0.0333333
NODE_301611_length_196_cov_101.855670	109	169	202	2	60	0.0333333
NODE_301611_length_196_cov_101.855670	109	169	206	1	60	0.0166667
NODE_301611_length_196_cov_101.855670	109	169	208	1	60	0.0166667
NODE_301611_length_196_cov_101.855670	109	169	217	1	60	0.0166667
NODE_301611_length_196_cov_101.855670	109	169	218	1	60	0.0166667
NODE_301611_length_196_cov_101.855670	109	169	224	1	60	0.0166667
NODE_301611_length_196_cov_101.855670	109	169	226	1	60	0.0166667
NODE_301611_length_196_cov_101.855670	109	169	230	1	60	0.0166667
NODE_301611_length_196_cov_101.855670	109	169	233	2	60	0.0333333
NODE_301611_length_196_cov_101.855670	109	169	235	1	60	0.0166667
NODE_301611_length_196_cov_101.855670	109	169	239	1	60	0.0166667
NODE_301611_length_196_cov_101.855670	109	169	244	2	60	0.0333333
NODE_301611_length_196_cov_101.855670	109	169	251	1	60	0.0166667
NODE_301611_length_196_cov_101.855670	109	169	252	2	60	0.0333333
NODE_301611_length_196_cov_101.855670	109	169	260	1	60	0.0166667
NODE_301611_length_196_cov_101.855670	109	169	262	1	60	0.0166667
NODE_301611_length_196_cov_101.855670	109	169	264	5	60	0.0833333
NODE_301613_length_196_cov_100.618557	129	196	1	1	67	0.0149254
NODE_301613_length_196_cov_100.618557	129	196	4	1	67	0.0149254
NODE_301613_length_196_cov_100.618557	129	196	5	5	67	0.0746269
NODE_301613_length_196_cov_100.618557	129	196	7	4	67	0.0597015
NODE_301613_length_196_cov_100.618557	129	196	9	3	67	0.0447761
NODE_301613_length_196_cov_100.618557	129	196	10	2	67	0.0298507
NODE_301613_length_196_cov_100.618557	129	196	12	2	67	0.0298507
NODE_301613_length_196_cov_100.618557	129	196	13	1	67	0.0149254
NODE_301613_length_196_cov_100.618557	129	196	15	2	67	0.0298507
NODE_301613_length_196_cov_100.618557	129	196	17	2	67	0.0298507
NODE_301613_length_196_cov_100.618557	129	196	18	1	67	0.0149254
NODE_301613_length_196_cov_100.618557	129	196	20	2	67	0.0298507
NODE_301613_length_196_cov_100.618557	129	196	22	1	67	0.0149254
NODE_301613_length_196_cov_100.618557	129	196	24	4	67	0.0597015
NODE_301613_length_196_cov_100.618557	129	196	25	4	67	0.0597015
NODE_301613_length_196_cov_100.618557	129	196	27	1	67	0.0149254
NODE_301613_length_196_cov_100.618557	129	196	29	2	67	0.0298507
NODE_301613_length_196_cov_100.618557	129	196	31	3	67	0.0447761
NODE_301613_length_196_cov_100.618557	129	196	37	2	67	0.0298507
NODE_301613_length_196_cov_100.618557	129	196	40	1	67	0.0149254
NODE_301613_length_196_cov_100.618557	129	196	44	1	67	0.0149254
NODE_301613_length_196_cov_100.618557	129	196	46	5	67	0.0746269
NODE_301613_length_196_cov_100.618557	129	196	48	7	67	0.1044776
NODE_301613_length_196_cov_100.618557	129	196	50	3	67	0.0447761
NODE_301613_length_196_cov_100.618557	129	196	52	1	67	0.0149254
NODE_301613_length_196_cov_100.618557	129	196	54	6	67	0.0895522
NODE_301618_length_196_cov_67.268041	8	88	3	3	80	0.0375000
NODE_301618_length_196_cov_67.268041	8	88	7	1	80	0.0125000
NODE_301618_length_196_cov_67.268041	8	88	8	7	80	0.0875000
NODE_301618_length_196_cov_67.268041	8	88	9	4	80	0.0500000
NODE_301618_length_196_cov_67.268041	8	88	10	17	80	0.2125000
NODE_301618_length_196_cov_67.268041	8	88	12	2	80	0.0250000
NODE_301618_length_196_cov_67.268041	8	88	14	3	80	0.0375000
NODE_301618_length_196_cov_67.268041	8	88	15	1	80	0.0125000
NODE_301618_length_196_cov_67.268041	8	88	23	3	80	0.0375000
NODE_301618_length_196_cov_67.268041	8	88	25	3	80	0.0375000
NODE_301618_length_196_cov_67.268041	8	88	30	1	80	0.0125000
NODE_301618_length_196_cov_67.268041	8	88	31	1	80	0.0125000
NODE_301618_length_196_cov_67.268041	8	88	33	4	80	0.0500000
NODE_301618_length_196_cov_67.268041	8	88	38	30	80	0.3750000
NODE_301618_length_196_cov_67.268041	61	124	37	28	63	0.4444444
NODE_301618_length_196_cov_67.268041	61	124	38	35	63	0.5555556
NODE_301629_length_196_cov_40.195876	101	184	0	15	83	0.1807229
NODE_301629_length_196_cov_40.195876	101	184	2	10	83	0.1204819
NODE_301629_length_196_cov_40.195876	101	184	4	1	83	0.0120482
NODE_301629_length_196_cov_40.195876	101	184	9	1	83	0.0120482
NODE_301629_length_196_cov_40.195876	101	184	12	1	83	0.0120482
NODE_301629_length_196_cov_40.195876	101	184	18	1	83	0.0120482
NODE_301629_length_196_cov_40.195876	101	184	20	3	83	0.0361446
NODE_301629_length_196_cov_40.195876	101	184	22	3	83	0.0361446
NODE_301629_length_196_cov_40.195876	101	184	25	3	83	0.0361446
NODE_301629_length_196_cov_40.195876	101	184	27	5	83	0.0602410
NODE_301629_length_196_cov_40.195876	101	184	30	7	83	0.0843373
NODE_301629_length_196_cov_40.195876	101	184	32	4	83	0.0481928
NODE_301629_length_196_cov_40.195876	101	184	34	29	83	0.3493976
NODE_301704_length_194_cov_63.252632	12	78	0	5	66	0.0757576
NODE_301704_length_194_cov_63.252632	12	78	2	2	66	0.0303030
NODE_301704_length_194_cov_63.252632	12	78	6	1	66	0.0151515
NODE_301704_length_194_cov_63.252632	12	78	7	1	66	0.0151515
NODE_301704_length_194_cov_63.252632	12	78	9	1	66	0.0151515
NODE_301704_length_194_cov_63.252632	12	78	13	2	66	0.0303030
NODE_301704_length_194_cov_63.252632	12	78	15	1	66	0.0151515
NODE_301704_length_194_cov_63.252632	12	78	20	3	66	0.0454545
NODE_301704_length_194_cov_63.252632	12	78	21	1	66	0.0151515
NODE_301704_length_194_cov_63.252632	12	78	22	2	66	0.0303030
NODE_301704_length_194_cov_63.252632	12	78	26	3	66	0.0454545
NODE_301704_length_194_cov_63.252632	12	78	30	2	66	0.0303030
NODE_301704_length_194_cov_63.252632	12	78	31	4	66	0.0606061
NODE_301704_length_194_cov_63.252632	12	78	32	1	66	0.0151515
NODE_301704_length_194_cov_63.252632	12	78	34	6	66	0.0909091
NODE_301704_length_194_cov_63.252632	12	78	42	3	66	0.0454545
NODE_301704_length_194_cov_63.252632	12	78	44	1	66	0.0151515
NODE_301704_length_194_cov_63.252632	12	78	58	1	66	0.0151515
NODE_301704_length_194_cov_63.252632	12	78	59	1	66	0.0151515
NODE_301704_length_194_cov_63.252632	12	78	63	2	66	0.0303030
NODE_301704_length_194_cov_63.252632	12	78	68	4	66	0.0606061
NODE_301704_length_194_cov_63.252632	12	78	73	2	66	0.0303030
NODE_301704_length_194_cov_63.252632	12	78	79	2	66	0.0303030
NODE_301704_length_194_cov_63.252632	12	78	83	2	66	0.0303030
NODE_301704_length_194_cov_63.252632	12	78	85	2	66	0.0303030
NODE_301704_length_194_cov_63.252632	12	78	87	1	66	0.0151515
NODE_301704_length_194_cov_63.252632	12	78	95	4	66	0.0606061
NODE_301704_length_194_cov_63.252632	12	78	102	1	66	0.0151515
NODE_301704_length_194_cov_63.252632	12	78	105	5	66	0.0757576
NODE_301704_length_194_cov_63.252632	51	112	58	1	61	0.0163934
NODE_301704_length_194_cov_63.252632	51	112	59	1	61	0.0163934
NODE_301704_length_194_cov_63.252632	51	112	63	2	61	0.0327869
NODE_301704_length_194_cov_63.252632	51	112	68	4	61	0.0655738
NODE_301704_length_194_cov_63.252632	51	112	73	2	61	0.0327869
NODE_301704_length_194_cov_63.252632	51	112	79	2	61	0.0327869
NODE_301704_length_194_cov_63.252632	51	112	83	2	61	0.0327869
NODE_301704_length_194_cov_63.252632	51	112	85	2	61	0.0327869
NODE_301704_length_194_cov_63.252632	51	112	87	1	61	0.0163934
NODE_301704_length_194_cov_63.252632	51	112	95	4	61	0.0655738
NODE_301704_length_194_cov_63.252632	51	112	102	1	61	0.0163934
NODE_301704_length_194_cov_63.252632	51	112	105	8	61	0.1311475
NODE_301704_length_194_cov_63.252632	51	112	107	7	61	0.1147541
NODE_301704_length_194_cov_63.252632	51	112	109	24	61	0.3934426
NODE_301704_length_194_cov_63.252632	51	99	58	1	48	0.0208333
NODE_301704_length_194_cov_63.252632	51	99	59	1	48	0.0208333
NODE_301704_length_194_cov_63.252632	51	99	63	2	48	0.0416667
NODE_301704_length_194_cov_63.252632	51	99	68	4	48	0.0833333
NODE_301704_length_194_cov_63.252632	51	99	73	2	48	0.0416667
NODE_301704_length_194_cov_63.252632	51	99	79	2	48	0.0416667
NODE_301704_length_194_cov_63.252632	51	99	83	2	48	0.0416667
NODE_301704_length_194_cov_63.252632	51	99	85	2	48	0.0416667
NODE_301704_length_194_cov_63.252632	51	99	87	1	48	0.0208333
NODE_301704_length_194_cov_63.252632	51	99	95	4	48	0.0833333
NODE_301704_length_194_cov_63.252632	51	99	102	1	48	0.0208333
NODE_301704_length_194_cov_63.252632	51	99	105	8	48	0.1666667
NODE_301704_length_194_cov_63.252632	51	99	107	6	48	0.1250000
NODE_301704_length_194_cov_63.252632	51	99	109	12	48	0.2500000
NODE_301704_length_194_cov_63.252632	51	112	58	1	61	0.0163934
NODE_301704_length_194_cov_63.252632	51	112	59	1	61	0.0163934
NODE_301704_length_194_cov_63.252632	51	112	63	2	61	0.0327869
NODE_301704_length_194_cov_63.252632	51	112	68	4	61	0.0655738
NODE_301704_length_194_cov_63.252632	51	112	73	2	61	0.0327869
NODE_301704_length_194_cov_63.252632	51	112	79	2	61	0.0327869
NODE_301704_length_194_cov_63.252632	51	112	83	2	61	0.0327869
NODE_301704_length_194_cov_63.252632	51	112	85	2	61	0.0327869
NODE_301704_length_194_cov_63.252632	51	112	87	1	61	0.0163934
NODE_301704_length_194_cov_63.252632	51	112	95	4	61	0.0655738
NODE_301704_length_194_cov_63.252632	51	112	102	1	61	0.0163934
NODE_301704_length_194_cov_63.252632	51	112	105	8	61	0.1311475
NODE_301704_length_194_cov_63.252632	51	112	107	7	61	0.1147541
NODE_301704_length_194_cov_63.252632	51	112	109	24	61	0.3934426
NODE_301708_length_194_cov_35.010526	95	162	8	8	67	0.1194030
NODE_301708_length_194_cov_35.010526	95	162	12	7	67	0.1044776
NODE_301708_length_194_cov_35.010526	95	162	18	1	67	0.0149254
NODE_301708_length_194_cov_35.010526	95	162	23	51	67	0.7611941
NODE_301708_length_194_cov_35.010526	95	162	8	8	67	0.1194030
NODE_301708_length_194_cov_35.010526	95	162	12	7	67	0.1044776
NODE_301708_length_194_cov_35.010526	95	162	18	1	67	0.0149254
NODE_301708_length_194_cov_35.010526	95	162	23	51	67	0.7611941
NODE_301708_length_194_cov_35.010526	135	184	2	4	49	0.0816327
NODE_301708_length_194_cov_35.010526	135	184	6	13	49	0.2653061
NODE_301708_length_194_cov_35.010526	135	184	8	13	49	0.2653061
NODE_301708_length_194_cov_35.010526	135	184	12	7	49	0.1428571
NODE_301708_length_194_cov_35.010526	135	184	18	1	49	0.0204082
NODE_301708_length_194_cov_35.010526	135	184	23	11	49	0.2244898
NODE_301714_length_194_cov_9.978947	153	194	0	41	41	1.0000000
NODE_301727_length_193_cov_117.170213	21	93	39	6	72	0.0833333
NODE_301727_length_193_cov_117.170213	21	93	45	1	72	0.0138889
NODE_301727_length_193_cov_117.170213	21	93	47	1	72	0.0138889
NODE_301727_length_193_cov_117.170213	21	93	53	2	72	0.0277778
NODE_301727_length_193_cov_117.170213	21	93	55	1	72	0.0138889
NODE_301727_length_193_cov_117.170213	21	93	66	1	72	0.0138889
NODE_301727_length_193_cov_117.170213	21	93	68	1	72	0.0138889
NODE_301727_length_193_cov_117.170213	21	93	70	3	72	0.0416667
NODE_301727_length_193_cov_117.170213	21	93	72	1	72	0.0138889
NODE_301727_length_193_cov_117.170213	21	93	78	3	72	0.0416667
NODE_301727_length_193_cov_117.170213	21	93	81	3	72	0.0416667
NODE_301727_length_193_cov_117.170213	21	93	88	1	72	0.0138889
NODE_301727_length_193_cov_117.170213	21	93	92	1	72	0.0138889
NODE_301727_length_193_cov_117.170213	21	93	96	3	72	0.0416667
NODE_301727_length_193_cov_117.170213	21	93	101	1	72	0.0138889
NODE_301727_length_193_cov_117.170213	21	93	112	2	72	0.0277778
NODE_301727_length_193_cov_117.170213	21	93	116	6	72	0.0833333
NODE_301727_length_193_cov_117.170213	21	93	120	2	72	0.0277778
NODE_301727_length_193_cov_117.170213	21	93	124	1	72	0.0138889
NODE_301727_length_193_cov_117.170213	21	93	128	1	72	0.0138889
NODE_301727_length_193_cov_117.170213	21	93	132	9	72	0.1250000
NODE_301727_length_193_cov_117.170213	21	93	134	6	72	0.0833333
NODE_301727_length_193_cov_117.170213	21	93	136	3	72	0.0416667
NODE_301727_length_193_cov_117.170213	21	93	138	13	72	0.1805556
NODE_301727_length_193_cov_117.170213	41	121	81	3	80	0.0375000
NODE_301727_length_193_cov_117.170213	41	121	88	1	80	0.0125000
NODE_301727_length_193_cov_117.170213	41	121	92	1	80	0.0125000
NODE_301727_length_193_cov_117.170213	41	121	96	3	80	0.0375000
NODE_301727_length_193_cov_117.170213	41	121	101	1	80	0.0125000
NODE_301727_length_193_cov_117.170213	41	121	112	2	80	0.0250000
NODE_301727_length_193_cov_117.170213	41	121	116	6	80	0.0750000
NODE_301727_length_193_cov_117.170213	41	121	120	2	80	0.0250000
NODE_301727_length_193_cov_117.170213	41	121	124	1	80	0.0125000
NODE_301727_length_193_cov_117.170213	41	121	128	1	80	0.0125000
NODE_301727_length_193_cov_117.170213	41	121	132	9	80	0.1125000
NODE_301727_length_193_cov_117.170213	41	121	134	6	80	0.0750000
NODE_301727_length_193_cov_117.170213	41	121	136	3	80	0.0375000
NODE_301727_length_193_cov_117.170213	41	121	138	41	80	0.5125000
NODE_301729_length_193_cov_54.734043	108	188	33	5	80	0.0625000
NODE_301729_length_193_cov_54.734043	108	188	36	5	80	0.0625000
NODE_301729_length_193_cov_54.734043	108	188	37	1	80	0.0125000
NODE_301729_length_193_cov_54.734043	108	188	45	1	80	0.0125000
NODE_301729_length_193_cov_54.734043	108	188	48	1	80	0.0125000
NODE_301729_length_193_cov_54.734043	108	188	49	1	80	0.0125000
NODE_301729_length_193_cov_54.734043	108	188	60	1	80	0.0125000
NODE_301729_length_193_cov_54.734043	108	188	63	7	80	0.0875000
NODE_301729_length_193_cov_54.734043	108	188	65	3	80	0.0375000
NODE_301729_length_193_cov_54.734043	108	188	68	1	80	0.0125000
NODE_301729_length_193_cov_54.734043	108	188	69	6	80	0.0750000
NODE_301729_length_193_cov_54.734043	108	188	70	4	80	0.0500000
NODE_301729_length_193_cov_54.734043	108	188	71	6	80	0.0750000
NODE_301729_length_193_cov_54.734043	108	188	72	2	80	0.0250000
NODE_301729_length_193_cov_54.734043	108	188	74	2	80	0.0250000
NODE_301729_length_193_cov_54.734043	108	188	77	7	80	0.0875000
NODE_301729_length_193_cov_54.734043	108	188	78	2	80	0.0250000
NODE_301729_length_193_cov_54.734043	108	188	79	9	80	0.1125000
NODE_301729_length_193_cov_54.734043	108	188	80	16	80	0.2000000
NODE_301729_length_193_cov_54.734043	161	183	36	5	22	0.2272727
NODE_301729_length_193_cov_54.734043	161	183	37	1	22	0.0454545
NODE_301729_length_193_cov_54.734043	161	183	45	1	22	0.0454545
NODE_301729_length_193_cov_54.734043	161	183	48	1	22	0.0454545
NODE_301729_length_193_cov_54.734043	161	183	49	1	22	0.0454545
NODE_301729_length_193_cov_54.734043	161	183	60	1	22	0.0454545
NODE_301729_length_193_cov_54.734043	161	183	63	7	22	0.3181818
NODE_301729_length_193_cov_54.734043	161	183	65	3	22	0.1363636
NODE_301729_length_193_cov_54.734043	161	183	68	1	22	0.0454545
NODE_301729_length_193_cov_54.734043	161	183	69	1	22	0.0454545
NODE_301735_length_193_cov_30.638298	108	188	61	1	80	0.0125000
NODE_301735_length_193_cov_30.638298	108	188	66	2	80	0.0250000
NODE_301735_length_193_cov_30.638298	108	188	74	2	80	0.0250000
NODE_301735_length_193_cov_30.638298	108	188	80	1	80	0.0125000
NODE_301735_length_193_cov_30.638298	108	188	82	2	80	0.0250000
NODE_301735_length_193_cov_30.638298	108	188	84	1	80	0.0125000
NODE_301735_length_193_cov_30.638298	108	188	86	2	80	0.0250000
NODE_301735_length_193_cov_30.638298	108	188	91	3	80	0.0375000
NODE_301735_length_193_cov_30.638298	108	188	95	1	80	0.0125000
NODE_301735_length_193_cov_30.638298	108	188	96	1	80	0.0125000
NODE_301735_length_193_cov_30.638298	108	188	98	2	80	0.0250000
NODE_301735_length_193_cov_30.638298	108	188	99	4	80	0.0500000
NODE_301735_length_193_cov_30.638298	108	188	106	2	80	0.0250000
NODE_301735_length_193_cov_30.638298	108	188	110	2	80	0.0250000
NODE_301735_length_193_cov_30.638298	108	188	112	1	80	0.0125000
NODE_301735_length_193_cov_30.638298	108	188	116	9	80	0.1125000
NODE_301735_length_193_cov_30.638298	108	188	118	3	80	0.0375000
NODE_301735_length_193_cov_30.638298	108	188	119	2	80	0.0250000
NODE_301735_length_193_cov_30.638298	108	188	123	1	80	0.0125000
NODE_301735_length_193_cov_30.638298	108	188	125	10	80	0.1250000
NODE_301735_length_193_cov_30.638298	108	188	126	3	80	0.0375000
NODE_301735_length_193_cov_30.638298	108	188	128	3	80	0.0375000
NODE_301735_length_193_cov_30.638298	108	188	130	8	80	0.1000000
NODE_301735_length_193_cov_30.638298	108	188	132	2	80	0.0250000
NODE_301735_length_193_cov_30.638298	108	188	134	2	80	0.0250000
NODE_301735_length_193_cov_30.638298	108	188	136	9	80	0.1125000
NODE_301735_length_193_cov_30.638298	108	188	138	1	80	0.0125000
NODE_301735_length_193_cov_30.638298	161	183	80	1	22	0.0454545
NODE_301735_length_193_cov_30.638298	161	183	82	2	22	0.0909091
NODE_301735_length_193_cov_30.638298	161	183	84	1	22	0.0454545
NODE_301735_length_193_cov_30.638298	161	183	86	2	22	0.0909091
NODE_301735_length_193_cov_30.638298	161	183	91	3	22	0.1363636
NODE_301735_length_193_cov_30.638298	161	183	95	1	22	0.0454545
NODE_301735_length_193_cov_30.638298	161	183	96	1	22	0.0454545
NODE_301735_length_193_cov_30.638298	161	183	98	2	22	0.0909091
NODE_301735_length_193_cov_30.638298	161	183	99	4	22	0.1818182
NODE_301735_length_193_cov_30.638298	161	183	106	2	22	0.0909091
NODE_301735_length_193_cov_30.638298	161	183	110	2	22	0.0909091
NODE_301735_length_193_cov_30.638298	161	183	112	1	22	0.0454545
NODE_301737_length_193_cov_29.968085	0	45	16	9	45	0.2000000
NODE_301737_length_193_cov_29.968085	0	45	24	5	45	0.1111111
NODE_301737_length_193_cov_29.968085	0	45	37	1	45	0.0222222
NODE_301737_length_193_cov_29.968085	0	45	43	6	45	0.1333333
NODE_301737_length_193_cov_29.968085	0	45	52	2	45	0.0444444
NODE_301737_length_193_cov_29.968085	0	45	54	4	45	0.0888889
NODE_301737_length_193_cov_29.968085	0	45	66	1	45	0.0222222
NODE_301737_length_193_cov_29.968085	0	45	70	8	45	0.1777778
NODE_301737_length_193_cov_29.968085	0	45	78	1	45	0.0222222
NODE_301737_length_193_cov_29.968085	0	45	79	4	45	0.0888889
NODE_301737_length_193_cov_29.968085	0	45	85	1	45	0.0222222
NODE_301737_length_193_cov_29.968085	0	45	91	1	45	0.0222222
NODE_301737_length_193_cov_29.968085	0	45	92	1	45	0.0222222
NODE_301737_length_193_cov_29.968085	0	45	96	1	45	0.0222222
NODE_301737_length_193_cov_29.968085	8	57	16	1	49	0.0204082
NODE_301737_length_193_cov_29.968085	8	57	24	5	49	0.1020408
NODE_301737_length_193_cov_29.968085	8	57	37	1	49	0.0204082
NODE_301737_length_193_cov_29.968085	8	57	43	6	49	0.1224490
NODE_301737_length_193_cov_29.968085	8	57	52	2	49	0.0408163
NODE_301737_length_193_cov_29.968085	8	57	54	4	49	0.0816327
NODE_301737_length_193_cov_29.968085	8	57	66	1	49	0.0204082
NODE_301737_length_193_cov_29.968085	8	57	70	8	49	0.1632653
NODE_301737_length_193_cov_29.968085	8	57	78	1	49	0.0204082
NODE_301737_length_193_cov_29.968085	8	57	79	4	49	0.0816327
NODE_301737_length_193_cov_29.968085	8	57	85	1	49	0.0204082
NODE_301737_length_193_cov_29.968085	8	57	91	1	49	0.0204082
NODE_301737_length_193_cov_29.968085	8	57	92	1	49	0.0204082
NODE_301737_length_193_cov_29.968085	8	57	96	1	49	0.0204082
NODE_301737_length_193_cov_29.968085	8	57	98	3	49	0.0612245
NODE_301737_length_193_cov_29.968085	8	57	100	1	49	0.0204082
NODE_301737_length_193_cov_29.968085	8	57	101	1	49	0.0204082
NODE_301737_length_193_cov_29.968085	8	57	109	7	49	0.1428571
NODE_301737_length_193_cov_29.968085	30	98	70	6	68	0.0882353
NODE_301737_length_193_cov_29.968085	30	98	78	1	68	0.0147059
NODE_301737_length_193_cov_29.968085	30	98	79	4	68	0.0588235
NODE_301737_length_193_cov_29.968085	30	98	85	1	68	0.0147059
NODE_301737_length_193_cov_29.968085	30	98	91	1	68	0.0147059
NODE_301737_length_193_cov_29.968085	30	98	92	1	68	0.0147059
NODE_301737_length_193_cov_29.968085	30	98	96	1	68	0.0147059
NODE_301737_length_193_cov_29.968085	30	98	98	3	68	0.0441176
NODE_301737_length_193_cov_29.968085	30	98	100	1	68	0.0147059
NODE_301737_length_193_cov_29.968085	30	98	101	1	68	0.0147059
NODE_301737_length_193_cov_29.968085	30	98	109	11	68	0.1617647
NODE_301737_length_193_cov_29.968085	30	98	111	11	68	0.1617647
NODE_301737_length_193_cov_29.968085	30	98	115	26	68	0.3823529
NODE_301737_length_193_cov_29.968085	30	98	70	6	68	0.0882353
NODE_301737_length_193_cov_29.968085	30	98	78	1	68	0.0147059
NODE_301737_length_193_cov_29.968085	30	98	79	4	68	0.0588235
NODE_301737_length_193_cov_29.968085	30	98	85	1	68	0.0147059
NODE_301737_length_193_cov_29.968085	30	98	91	1	68	0.0147059
NODE_301737_length_193_cov_29.968085	30	98	92	1	68	0.0147059
NODE_301737_length_193_cov_29.968085	30	98	96	1	68	0.0147059
NODE_301737_length_193_cov_29.968085	30	98	98	3	68	0.0441176
NODE_301737_length_193_cov_29.968085	30	98	100	1	68	0.0147059
NODE_301737_length_193_cov_29.968085	30	98	101	1	68	0.0147059
NODE_301737_length_193_cov_29.968085	30	98	109	11	68	0.1617647
NODE_301737_length_193_cov_29.968085	30	98	111	11	68	0.1617647
NODE_301737_length_193_cov_29.968085	30	98	115	26	68	0.3823529
NODE_301737_length_193_cov_29.968085	30	98	70	6	68	0.0882353
NODE_301737_length_193_cov_29.968085	30	98	78	1	68	0.0147059
NODE_301737_length_193_cov_29.968085	30	98	79	4	68	0.0588235
NODE_301737_length_193_cov_29.968085	30	98	85	1	68	0.0147059
NODE_301737_length_193_cov_29.968085	30	98	91	1	68	0.0147059
NODE_301737_length_193_cov_29.968085	30	98	92	1	68	0.0147059
NODE_301737_length_193_cov_29.968085	30	98	96	1	68	0.0147059
NODE_301737_length_193_cov_29.968085	30	98	98	3	68	0.0441176
NODE_301737_length_193_cov_29.968085	30	98	100	1	68	0.0147059
NODE_301737_length_193_cov_29.968085	30	98	101	1	68	0.0147059
NODE_301737_length_193_cov_29.968085	30	98	109	11	68	0.1617647
NODE_301737_length_193_cov_29.968085	30	98	111	11	68	0.1617647
NODE_301737_length_193_cov_29.968085	30	98	115	26	68	0.3823529
NODE_301737_length_193_cov_29.968085	146	188	1	17	42	0.4047619
NODE_301737_length_193_cov_29.968085	146	188	2	5	42	0.1190476
NODE_301737_length_193_cov_29.968085	146	188	14	3	42	0.0714286
NODE_301737_length_193_cov_29.968085	146	188	20	2	42	0.0476190
NODE_301737_length_193_cov_29.968085	146	188	24	3	42	0.0714286
NODE_301737_length_193_cov_29.968085	146	188	26	2	42	0.0476190
NODE_301737_length_193_cov_29.968085	146	188	28	1	42	0.0238095
NODE_301737_length_193_cov_29.968085	146	188	34	6	42	0.1428571
NODE_301737_length_193_cov_29.968085	146	188	39	1	42	0.0238095
NODE_301737_length_193_cov_29.968085	146	188	40	2	42	0.0476190
NODE_301776_length_192_cov_160.258065	0	76	24	1	76	0.0131579
NODE_301776_length_192_cov_160.258065	0	76	32	1	76	0.0131579
NODE_301776_length_192_cov_160.258065	0	76	34	1	76	0.0131579
NODE_301776_length_192_cov_160.258065	0	76	38	1	76	0.0131579
NODE_301776_length_192_cov_160.258065	0	76	39	1	76	0.0131579
NODE_301776_length_192_cov_160.258065	0	76	41	1	76	0.0131579
NODE_301776_length_192_cov_160.258065	0	76	49	1	76	0.0131579
NODE_301776_length_192_cov_160.258065	0	76	55	1	76	0.0131579
NODE_301776_length_192_cov_160.258065	0	76	60	2	76	0.0263158
NODE_301776_length_192_cov_160.258065	0	76	64	1	76	0.0131579
NODE_301776_length_192_cov_160.258065	0	76	75	1	76	0.0131579
NODE_301776_length_192_cov_160.258065	0	76	81	5	76	0.0657895
NODE_301776_length_192_cov_160.258065	0	76	82	1	76	0.0131579
NODE_301776_length_192_cov_160.258065	0	76	86	1	76	0.0131579
NODE_301776_length_192_cov_160.258065	0	76	88	1	76	0.0131579
NODE_301776_length_192_cov_160.258065	0	76	90	1	76	0.0131579
NODE_301776_length_192_cov_160.258065	0	76	91	1	76	0.0131579
NODE_301776_length_192_cov_160.258065	0	76	95	1	76	0.0131579
NODE_301776_length_192_cov_160.258065	0	76	98	2	76	0.0263158
NODE_301776_length_192_cov_160.258065	0	76	103	1	76	0.0131579
NODE_301776_length_192_cov_160.258065	0	76	105	2	76	0.0263158
NODE_301776_length_192_cov_160.258065	0	76	108	2	76	0.0263158
NODE_301776_length_192_cov_160.258065	0	76	110	1	76	0.0131579
NODE_301776_length_192_cov_160.258065	0	76	117	6	76	0.0789474
NODE_301776_length_192_cov_160.258065	0	76	120	1	76	0.0131579
NODE_301776_length_192_cov_160.258065	0	76	126	1	76	0.0131579
NODE_301776_length_192_cov_160.258065	0	76	132	1	76	0.0131579
NODE_301776_length_192_cov_160.258065	0	76	140	1	76	0.0131579
NODE_301776_length_192_cov_160.258065	0	76	144	2	76	0.0263158
NODE_301776_length_192_cov_160.258065	0	76	156	1	76	0.0131579
NODE_301776_length_192_cov_160.258065	0	76	161	2	76	0.0263158
NODE_301776_length_192_cov_160.258065	0	76	163	1	76	0.0131579
NODE_301776_length_192_cov_160.258065	0	76	165	2	76	0.0263158
NODE_301776_length_192_cov_160.258065	0	76	168	2	76	0.0263158
NODE_301776_length_192_cov_160.258065	0	76	169	1	76	0.0131579
NODE_301776_length_192_cov_160.258065	0	76	175	1	76	0.0131579
NODE_301776_length_192_cov_160.258065	0	76	177	1	76	0.0131579
NODE_301776_length_192_cov_160.258065	0	76	178	1	76	0.0131579
NODE_301776_length_192_cov_160.258065	0	76	184	2	76	0.0263158
NODE_301776_length_192_cov_160.258065	0	76	185	3	76	0.0394737
NODE_301776_length_192_cov_160.258065	0	76	189	2	76	0.0263158
NODE_301776_length_192_cov_160.258065	0	76	191	1	76	0.0131579
NODE_301776_length_192_cov_160.258065	0	76	207	2	76	0.0263158
NODE_301776_length_192_cov_160.258065	0	76	215	1	76	0.0131579
NODE_301776_length_192_cov_160.258065	0	76	223	1	76	0.0131579
NODE_301776_length_192_cov_160.258065	0	76	229	2	76	0.0263158
NODE_301776_length_192_cov_160.258065	0	76	231	1	76	0.0131579
NODE_301776_length_192_cov_160.258065	0	76	235	1	76	0.0131579
NODE_301776_length_192_cov_160.258065	0	76	237	1	76	0.0131579
NODE_301776_length_192_cov_160.258065	0	76	239	1	76	0.0131579
NODE_301776_length_192_cov_160.258065	0	76	253	2	76	0.0263158
NODE_301776_length_192_cov_160.258065	0	76	259	1	76	0.0131579
NODE_301825_length_191_cov_92.913043	81	144	5	19	63	0.3015873
NODE_301825_length_191_cov_92.913043	81	144	7	1	63	0.0158730
NODE_301825_length_191_cov_92.913043	81	144	9	43	63	0.6825397
NODE_301855_length_190_cov_112.285714	8	91	0	83	83	1.0000000
NODE_301859_length_190_cov_41.373626	92	172	15	3	80	0.0375000
NODE_301859_length_190_cov_41.373626	92	172	17	9	80	0.1125000
NODE_301859_length_190_cov_41.373626	92	172	18	2	80	0.0250000
NODE_301859_length_190_cov_41.373626	92	172	20	5	80	0.0625000
NODE_301859_length_190_cov_41.373626	92	172	22	6	80	0.0750000
NODE_301859_length_190_cov_41.373626	92	172	23	3	80	0.0375000
NODE_301859_length_190_cov_41.373626	92	172	24	1	80	0.0125000
NODE_301859_length_190_cov_41.373626	92	172	26	1	80	0.0125000
NODE_301859_length_190_cov_41.373626	92	172	28	10	80	0.1250000
NODE_301859_length_190_cov_41.373626	92	172	30	40	80	0.5000000
NODE_301859_length_190_cov_41.373626	145	190	0	4	45	0.0888889
NODE_301859_length_190_cov_41.373626	145	190	1	2	45	0.0444444
NODE_301859_length_190_cov_41.373626	145	190	3	6	45	0.1333333
NODE_301859_length_190_cov_41.373626	145	190	5	3	45	0.0666667
NODE_301859_length_190_cov_41.373626	145	190	6	1	45	0.0222222
NODE_301859_length_190_cov_41.373626	145	190	10	1	45	0.0222222
NODE_301859_length_190_cov_41.373626	145	190	14	1	45	0.0222222
NODE_301859_length_190_cov_41.373626	145	190	15	3	45	0.0666667
NODE_301859_length_190_cov_41.373626	145	190	17	9	45	0.2000000
NODE_301859_length_190_cov_41.373626	145	190	18	2	45	0.0444444
NODE_301859_length_190_cov_41.373626	145	190	20	5	45	0.1111111
NODE_301859_length_190_cov_41.373626	145	190	22	6	45	0.1333333
NODE_301859_length_190_cov_41.373626	145	190	23	2	45	0.0444444
NODE_301880_length_189_cov_234.500000	19	88	0	69	69	1.0000000
NODE_301882_length_189_cov_192.211111	134	186	4	1	52	0.0192308
NODE_301882_length_189_cov_192.211111	134	186	8	1	52	0.0192308
NODE_301882_length_189_cov_192.211111	134	186	12	1	52	0.0192308
NODE_301882_length_189_cov_192.211111	134	186	14	14	52	0.2692308
NODE_301882_length_189_cov_192.211111	134	186	16	4	52	0.0769231
NODE_301882_length_189_cov_192.211111	134	186	20	7	52	0.1346154
NODE_301882_length_189_cov_192.211111	134	186	22	1	52	0.0192308
NODE_301882_length_189_cov_192.211111	134	186	23	16	52	0.3076923
NODE_301882_length_189_cov_192.211111	134	186	24	1	52	0.0192308
NODE_301882_length_189_cov_192.211111	134	186	26	1	52	0.0192308
NODE_301882_length_189_cov_192.211111	134	186	30	2	52	0.0384615
NODE_301882_length_189_cov_192.211111	134	186	32	3	52	0.0576923
NODE_301885_length_189_cov_70.600000	19	88	0	69	69	1.0000000
NODE_301885_length_189_cov_70.600000	72	156	0	84	84	1.0000000
NODE_301886_length_189_cov_63.455556	70	150	104	1	80	0.0125000
NODE_301886_length_189_cov_63.455556	70	150	112	1	80	0.0125000
NODE_301886_length_189_cov_63.455556	70	150	114	1	80	0.0125000
NODE_301886_length_189_cov_63.455556	70	150	117	1	80	0.0125000
NODE_301886_length_189_cov_63.455556	70	150	125	2	80	0.0250000
NODE_301886_length_189_cov_63.455556	70	150	127	2	80	0.0250000
NODE_301886_length_189_cov_63.455556	70	150	135	1	80	0.0125000
NODE_301886_length_189_cov_63.455556	70	150	137	2	80	0.0250000
NODE_301886_length_189_cov_63.455556	70	150	139	2	80	0.0250000
NODE_301886_length_189_cov_63.455556	70	150	143	5	80	0.0625000
NODE_301886_length_189_cov_63.455556	70	150	145	2	80	0.0250000
NODE_301886_length_189_cov_63.455556	70	150	153	1	80	0.0125000
NODE_301886_length_189_cov_63.455556	70	150	159	1	80	0.0125000
NODE_301886_length_189_cov_63.455556	70	150	177	2	80	0.0250000
NODE_301886_length_189_cov_63.455556	70	150	181	1	80	0.0125000
NODE_301886_length_189_cov_63.455556	70	150	187	1	80	0.0125000
NODE_301886_length_189_cov_63.455556	70	150	189	2	80	0.0250000
NODE_301886_length_189_cov_63.455556	70	150	197	1	80	0.0125000
NODE_301886_length_189_cov_63.455556	70	150	203	1	80	0.0125000
NODE_301886_length_189_cov_63.455556	70	150	208	1	80	0.0125000
NODE_301886_length_189_cov_63.455556	70	150	217	1	80	0.0125000
NODE_301886_length_189_cov_63.455556	70	150	223	1	80	0.0125000
NODE_301886_length_189_cov_63.455556	70	150	225	1	80	0.0125000
NODE_301886_length_189_cov_63.455556	70	150	229	1	80	0.0125000
NODE_301886_length_189_cov_63.455556	70	150	237	1	80	0.0125000
NODE_301886_length_189_cov_63.455556	70	150	238	1	80	0.0125000
NODE_301886_length_189_cov_63.455556	70	150	239	1	80	0.0125000
NODE_301886_length_189_cov_63.455556	70	150	243	3	80	0.0375000
NODE_301886_length_189_cov_63.455556	70	150	247	2	80	0.0250000
NODE_301886_length_189_cov_63.455556	70	150	251	1	80	0.0125000
NODE_301886_length_189_cov_63.455556	70	150	255	3	80	0.0375000
NODE_301886_length_189_cov_63.455556	70	150	257	5	80	0.0625000
NODE_301886_length_189_cov_63.455556	70	150	262	1	80	0.0125000
NODE_301886_length_189_cov_63.455556	70	150	263	5	80	0.0625000
NODE_301886_length_189_cov_63.455556	70	150	265	1	80	0.0125000
NODE_301886_length_189_cov_63.455556	70	150	267	1	80	0.0125000
NODE_301886_length_189_cov_63.455556	70	150	269	2	80	0.0250000
NODE_301886_length_189_cov_63.455556	70	150	273	18	80	0.2250000
NODE_301886_length_189_cov_63.455556	70	141	137	2	71	0.0281690
NODE_301886_length_189_cov_63.455556	70	141	139	2	71	0.0281690
NODE_301886_length_189_cov_63.455556	70	141	143	5	71	0.0704225
NODE_301886_length_189_cov_63.455556	70	141	145	2	71	0.0281690
NODE_301886_length_189_cov_63.455556	70	141	153	1	71	0.0140845
NODE_301886_length_189_cov_63.455556	70	141	159	1	71	0.0140845
NODE_301886_length_189_cov_63.455556	70	141	177	2	71	0.0281690
NODE_301886_length_189_cov_63.455556	70	141	181	1	71	0.0140845
NODE_301886_length_189_cov_63.455556	70	141	187	1	71	0.0140845
NODE_301886_length_189_cov_63.455556	70	141	189	2	71	0.0281690
NODE_301886_length_189_cov_63.455556	70	141	197	1	71	0.0140845
NODE_301886_length_189_cov_63.455556	70	141	203	1	71	0.0140845
NODE_301886_length_189_cov_63.455556	70	141	208	1	71	0.0140845
NODE_301886_length_189_cov_63.455556	70	141	217	1	71	0.0140845
NODE_301886_length_189_cov_63.455556	70	141	223	1	71	0.0140845
NODE_301886_length_189_cov_63.455556	70	141	225	1	71	0.0140845
NODE_301886_length_189_cov_63.455556	70	141	229	1	71	0.0140845
NODE_301886_length_189_cov_63.455556	70	141	237	1	71	0.0140845
NODE_301886_length_189_cov_63.455556	70	141	238	1	71	0.0140845
NODE_301886_length_189_cov_63.455556	70	141	239	1	71	0.0140845
NODE_301886_length_189_cov_63.455556	70	141	243	3	71	0.0422535
NODE_301886_length_189_cov_63.455556	70	141	247	2	71	0.0281690
NODE_301886_length_189_cov_63.455556	70	141	251	1	71	0.0140845
NODE_301886_length_189_cov_63.455556	70	141	255	3	71	0.0422535
NODE_301886_length_189_cov_63.455556	70	141	257	5	71	0.0704225
NODE_301886_length_189_cov_63.455556	70	141	262	1	71	0.0140845
NODE_301886_length_189_cov_63.455556	70	141	263	5	71	0.0704225
NODE_301886_length_189_cov_63.455556	70	141	265	1	71	0.0140845
NODE_301886_length_189_cov_63.455556	70	141	267	1	71	0.0140845
NODE_301886_length_189_cov_63.455556	70	141	269	2	71	0.0281690
NODE_301886_length_189_cov_63.455556	70	141	273	18	71	0.2535211
NODE_301891_length_189_cov_43.600000	0	73	3	1	73	0.0136986
NODE_301891_length_189_cov_43.600000	0	73	4	1	73	0.0136986
NODE_301891_length_189_cov_43.600000	0	73	6	4	73	0.0547945
NODE_301891_length_189_cov_43.600000	0	73	8	1	73	0.0136986
NODE_301891_length_189_cov_43.600000	0	73	9	3	73	0.0410959
NODE_301891_length_189_cov_43.600000	0	73	11	1	73	0.0136986
NODE_301891_length_189_cov_43.600000	0	73	12	1	73	0.0136986
NODE_301891_length_189_cov_43.600000	0	73	14	2	73	0.0273973
NODE_301891_length_189_cov_43.600000	0	73	15	1	73	0.0136986
NODE_301891_length_189_cov_43.600000	0	73	28	1	73	0.0136986
NODE_301891_length_189_cov_43.600000	0	73	31	2	73	0.0273973
NODE_301891_length_189_cov_43.600000	0	73	34	2	73	0.0273973
NODE_301891_length_189_cov_43.600000	0	73	38	1	73	0.0136986
NODE_301891_length_189_cov_43.600000	0	73	41	2	73	0.0273973
NODE_301891_length_189_cov_43.600000	0	73	47	1	73	0.0136986
NODE_301891_length_189_cov_43.600000	0	73	49	1	73	0.0136986
NODE_301891_length_189_cov_43.600000	0	73	55	1	73	0.0136986
NODE_301891_length_189_cov_43.600000	0	73	59	1	73	0.0136986
NODE_301891_length_189_cov_43.600000	0	73	60	1	73	0.0136986
NODE_301891_length_189_cov_43.600000	0	73	63	1	73	0.0136986
NODE_301891_length_189_cov_43.600000	0	73	75	1	73	0.0136986
NODE_301891_length_189_cov_43.600000	0	73	79	1	73	0.0136986
NODE_301891_length_189_cov_43.600000	0	73	83	5	73	0.0684932
NODE_301891_length_189_cov_43.600000	0	73	85	2	73	0.0273973
NODE_301891_length_189_cov_43.600000	0	73	87	3	73	0.0410959
NODE_301891_length_189_cov_43.600000	0	73	89	5	73	0.0684932
NODE_301891_length_189_cov_43.600000	0	73	90	2	73	0.0273973
NODE_301891_length_189_cov_43.600000	0	73	91	2	73	0.0273973
NODE_301891_length_189_cov_43.600000	0	73	93	4	73	0.0547945
NODE_301891_length_189_cov_43.600000	0	73	95	3	73	0.0410959
NODE_301891_length_189_cov_43.600000	0	73	97	3	73	0.0410959
NODE_301891_length_189_cov_43.600000	0	73	98	1	73	0.0136986
NODE_301891_length_189_cov_43.600000	0	73	99	2	73	0.0273973
NODE_301891_length_189_cov_43.600000	0	73	100	7	73	0.0958904
NODE_301891_length_189_cov_43.600000	0	73	102	3	73	0.0410959
NODE_301940_length_188_cov_2021.561798	108	188	40	1	80	0.0125000
NODE_301940_length_188_cov_2021.561798	108	188	46	1	80	0.0125000
NODE_301940_length_188_cov_2021.561798	108	188	59	1	80	0.0125000
NODE_301940_length_188_cov_2021.561798	108	188	64	1	80	0.0125000
NODE_301940_length_188_cov_2021.561798	108	188	80	1	80	0.0125000
NODE_301940_length_188_cov_2021.561798	108	188	95	1	80	0.0125000
NODE_301940_length_188_cov_2021.561798	108	188	124	1	80	0.0125000
NODE_301940_length_188_cov_2021.561798	108	188	134	1	80	0.0125000
NODE_301940_length_188_cov_2021.561798	108	188	148	2	80	0.0250000
NODE_301940_length_188_cov_2021.561798	108	188	179	1	80	0.0125000
NODE_301940_length_188_cov_2021.561798	108	188	188	1	80	0.0125000
NODE_301940_length_188_cov_2021.561798	108	188	210	1	80	0.0125000
NODE_301940_length_188_cov_2021.561798	108	188	212	1	80	0.0125000
NODE_301940_length_188_cov_2021.561798	108	188	229	1	80	0.0125000
NODE_301940_length_188_cov_2021.561798	108	188	236	1	80	0.0125000
NODE_301940_length_188_cov_2021.561798	108	188	242	1	80	0.0125000
NODE_301940_length_188_cov_2021.561798	108	188	244	1	80	0.0125000
NODE_301940_length_188_cov_2021.561798	108	188	246	1	80	0.0125000
NODE_301940_length_188_cov_2021.561798	108	188	255	1	80	0.0125000
NODE_301940_length_188_cov_2021.561798	108	188	264	2	80	0.0250000
NODE_301940_length_188_cov_2021.561798	108	188	277	1	80	0.0125000
NODE_301940_length_188_cov_2021.561798	108	188	285	1	80	0.0125000
NODE_301940_length_188_cov_2021.561798	108	188	302	1	80	0.0125000
NODE_301940_length_188_cov_2021.561798	108	188	303	2	80	0.0250000
NODE_301940_length_188_cov_2021.561798	108	188	307	1	80	0.0125000
NODE_301940_length_188_cov_2021.561798	108	188	327	1	80	0.0125000
NODE_301940_length_188_cov_2021.561798	108	188	330	5	80	0.0625000
NODE_301940_length_188_cov_2021.561798	108	188	333	1	80	0.0125000
NODE_301940_length_188_cov_2021.561798	108	188	339	1	80	0.0125000
NODE_301940_length_188_cov_2021.561798	108	188	343	3	80	0.0375000
NODE_301940_length_188_cov_2021.561798	108	188	354	1	80	0.0125000
NODE_301940_length_188_cov_2021.561798	108	188	355	1	80	0.0125000
NODE_301940_length_188_cov_2021.561798	108	188	364	1	80	0.0125000
NODE_301940_length_188_cov_2021.561798	108	188	365	2	80	0.0250000
NODE_301940_length_188_cov_2021.561798	108	188	370	1	80	0.0125000
NODE_301940_length_188_cov_2021.561798	108	188	372	7	80	0.0875000
NODE_301940_length_188_cov_2021.561798	108	188	378	1	80	0.0125000
NODE_301940_length_188_cov_2021.561798	108	188	380	3	80	0.0375000
NODE_301940_length_188_cov_2021.561798	108	188	383	2	80	0.0250000
NODE_301940_length_188_cov_2021.561798	108	188	384	1	80	0.0125000
NODE_301940_length_188_cov_2021.561798	108	188	386	2	80	0.0250000
NODE_301940_length_188_cov_2021.561798	108	188	387	3	80	0.0375000
NODE_301940_length_188_cov_2021.561798	108	188	393	1	80	0.0125000
NODE_301940_length_188_cov_2021.561798	108	188	394	1	80	0.0125000
NODE_301940_length_188_cov_2021.561798	108	188	400	1	80	0.0125000
NODE_301940_length_188_cov_2021.561798	108	188	401	1	80	0.0125000
NODE_301940_length_188_cov_2021.561798	108	188	402	4	80	0.0500000
NODE_301940_length_188_cov_2021.561798	108	188	404	2	80	0.0250000
NODE_301940_length_188_cov_2021.561798	108	188	408	6	80	0.0750000
NODE_301940_length_188_cov_2021.561798	161	183	95	1	22	0.0454545
NODE_301940_length_188_cov_2021.561798	161	183	124	1	22	0.0454545
NODE_301940_length_188_cov_2021.561798	161	183	134	1	22	0.0454545
NODE_301940_length_188_cov_2021.561798	161	183	148	2	22	0.0909091
NODE_301940_length_188_cov_2021.561798	161	183	179	1	22	0.0454545
NODE_301940_length_188_cov_2021.561798	161	183	188	1	22	0.0454545
NODE_301940_length_188_cov_2021.561798	161	183	210	1	22	0.0454545
NODE_301940_length_188_cov_2021.561798	161	183	212	1	22	0.0454545
NODE_301940_length_188_cov_2021.561798	161	183	229	1	22	0.0454545
NODE_301940_length_188_cov_2021.561798	161	183	236	1	22	0.0454545
NODE_301940_length_188_cov_2021.561798	161	183	242	1	22	0.0454545
NODE_301940_length_188_cov_2021.561798	161	183	244	1	22	0.0454545
NODE_301940_length_188_cov_2021.561798	161	183	246	1	22	0.0454545
NODE_301940_length_188_cov_2021.561798	161	183	255	1	22	0.0454545
NODE_301940_length_188_cov_2021.561798	161	183	264	2	22	0.0909091
NODE_301940_length_188_cov_2021.561798	161	183	277	1	22	0.0454545
NODE_301940_length_188_cov_2021.561798	161	183	285	1	22	0.0454545
NODE_301940_length_188_cov_2021.561798	161	183	302	1	22	0.0454545
NODE_301940_length_188_cov_2021.561798	161	183	303	2	22	0.0909091
NODE_301952_length_188_cov_37.988764	0	50	1	19	50	0.3800000
NODE_301952_length_188_cov_37.988764	0	50	4	15	50	0.3000000
NODE_301952_length_188_cov_37.988764	0	50	8	11	50	0.2200000
NODE_301952_length_188_cov_37.988764	0	50	11	1	50	0.0200000
NODE_301952_length_188_cov_37.988764	0	50	12	4	50	0.0800000
NODE_301980_length_187_cov_71.170455	124	155	29	1	31	0.0322581
NODE_301980_length_187_cov_71.170455	124	155	32	4	31	0.1290323
NODE_301980_length_187_cov_71.170455	124	155	34	1	31	0.0322581
NODE_301980_length_187_cov_71.170455	124	155	36	25	31	0.8064516
NODE_301981_length_187_cov_56.000000	72	136	147	3	64	0.0468750
NODE_301981_length_187_cov_56.000000	72	136	148	3	64	0.0468750
NODE_301981_length_187_cov_56.000000	72	136	158	1	64	0.0156250
NODE_301981_length_187_cov_56.000000	72	136	166	1	64	0.0156250
NODE_301981_length_187_cov_56.000000	72	136	167	4	64	0.0625000
NODE_301981_length_187_cov_56.000000	72	136	170	1	64	0.0156250
NODE_301981_length_187_cov_56.000000	72	136	176	1	64	0.0156250
NODE_301981_length_187_cov_56.000000	72	136	184	3	64	0.0468750
NODE_301981_length_187_cov_56.000000	72	136	192	2	64	0.0312500
NODE_301981_length_187_cov_56.000000	72	136	194	1	64	0.0156250
NODE_301981_length_187_cov_56.000000	72	136	196	1	64	0.0156250
NODE_301981_length_187_cov_56.000000	72	136	198	6	64	0.0937500
NODE_301981_length_187_cov_56.000000	72	136	199	2	64	0.0312500
NODE_301981_length_187_cov_56.000000	72	136	200	4	64	0.0625000
NODE_301981_length_187_cov_56.000000	72	136	202	31	64	0.4843750
NODE_301981_length_187_cov_56.000000	72	136	147	3	64	0.0468750
NODE_301981_length_187_cov_56.000000	72	136	148	3	64	0.0468750
NODE_301981_length_187_cov_56.000000	72	136	158	1	64	0.0156250
NODE_301981_length_187_cov_56.000000	72	136	166	1	64	0.0156250
NODE_301981_length_187_cov_56.000000	72	136	167	4	64	0.0625000
NODE_301981_length_187_cov_56.000000	72	136	170	1	64	0.0156250
NODE_301981_length_187_cov_56.000000	72	136	176	1	64	0.0156250
NODE_301981_length_187_cov_56.000000	72	136	184	3	64	0.0468750
NODE_301981_length_187_cov_56.000000	72	136	192	2	64	0.0312500
NODE_301981_length_187_cov_56.000000	72	136	194	1	64	0.0156250
NODE_301981_length_187_cov_56.000000	72	136	196	1	64	0.0156250
NODE_301981_length_187_cov_56.000000	72	136	198	6	64	0.0937500
NODE_301981_length_187_cov_56.000000	72	136	199	2	64	0.0312500
NODE_301981_length_187_cov_56.000000	72	136	200	4	64	0.0625000
NODE_301981_length_187_cov_56.000000	72	136	202	31	64	0.4843750
NODE_301981_length_187_cov_56.000000	109	175	41	1	66	0.0151515
NODE_301981_length_187_cov_56.000000	109	175	45	1	66	0.0151515
NODE_301981_length_187_cov_56.000000	109	175	46	3	66	0.0454545
NODE_301981_length_187_cov_56.000000	109	175	61	1	66	0.0151515
NODE_301981_length_187_cov_56.000000	109	175	63	1	66	0.0151515
NODE_301981_length_187_cov_56.000000	109	175	69	1	66	0.0151515
NODE_301981_length_187_cov_56.000000	109	175	71	1	66	0.0151515
NODE_301981_length_187_cov_56.000000	109	175	72	1	66	0.0151515
NODE_301981_length_187_cov_56.000000	109	175	73	1	66	0.0151515
NODE_301981_length_187_cov_56.000000	109	175	76	2	66	0.0303030
NODE_301981_length_187_cov_56.000000	109	175	78	1	66	0.0151515
NODE_301981_length_187_cov_56.000000	109	175	82	1	66	0.0151515
NODE_301981_length_187_cov_56.000000	109	175	86	1	66	0.0151515
NODE_301981_length_187_cov_56.000000	109	175	87	1	66	0.0151515
NODE_301981_length_187_cov_56.000000	109	175	89	1	66	0.0151515
NODE_301981_length_187_cov_56.000000	109	175	92	1	66	0.0151515
NODE_301981_length_187_cov_56.000000	109	175	94	1	66	0.0151515
NODE_301981_length_187_cov_56.000000	109	175	96	3	66	0.0454545
NODE_301981_length_187_cov_56.000000	109	175	100	2	66	0.0303030
NODE_301981_length_187_cov_56.000000	109	175	105	3	66	0.0454545
NODE_301981_length_187_cov_56.000000	109	175	118	1	66	0.0151515
NODE_301981_length_187_cov_56.000000	109	175	120	1	66	0.0151515
NODE_301981_length_187_cov_56.000000	109	175	129	2	66	0.0303030
NODE_301981_length_187_cov_56.000000	109	175	131	2	66	0.0303030
NODE_301981_length_187_cov_56.000000	109	175	133	1	66	0.0151515
NODE_301981_length_187_cov_56.000000	109	175	135	1	66	0.0151515
NODE_301981_length_187_cov_56.000000	109	175	136	1	66	0.0151515
NODE_301981_length_187_cov_56.000000	109	175	142	1	66	0.0151515
NODE_301981_length_187_cov_56.000000	109	175	143	1	66	0.0151515
NODE_301981_length_187_cov_56.000000	109	175	147	3	66	0.0454545
NODE_301981_length_187_cov_56.000000	109	175	148	3	66	0.0454545
NODE_301981_length_187_cov_56.000000	109	175	158	1	66	0.0151515
NODE_301981_length_187_cov_56.000000	109	175	166	1	66	0.0151515
NODE_301981_length_187_cov_56.000000	109	175	167	4	66	0.0606061
NODE_301981_length_187_cov_56.000000	109	175	170	1	66	0.0151515
NODE_301981_length_187_cov_56.000000	109	175	176	1	66	0.0151515
NODE_301981_length_187_cov_56.000000	109	175	184	3	66	0.0454545
NODE_301981_length_187_cov_56.000000	109	175	192	2	66	0.0303030
NODE_301981_length_187_cov_56.000000	109	175	194	1	66	0.0151515
NODE_301981_length_187_cov_56.000000	109	175	196	1	66	0.0151515
NODE_301981_length_187_cov_56.000000	109	175	198	4	66	0.0606061
NODE_301981_length_187_cov_56.000000	109	175	199	2	66	0.0303030
NODE_301981_length_187_cov_56.000000	109	180	25	2	71	0.0281690
NODE_301981_length_187_cov_56.000000	109	180	28	2	71	0.0281690
NODE_301981_length_187_cov_56.000000	109	180	30	1	71	0.0140845
NODE_301981_length_187_cov_56.000000	109	180	41	1	71	0.0140845
NODE_301981_length_187_cov_56.000000	109	180	45	1	71	0.0140845
NODE_301981_length_187_cov_56.000000	109	180	46	3	71	0.0422535
NODE_301981_length_187_cov_56.000000	109	180	61	1	71	0.0140845
NODE_301981_length_187_cov_56.000000	109	180	63	1	71	0.0140845
NODE_301981_length_187_cov_56.000000	109	180	69	1	71	0.0140845
NODE_301981_length_187_cov_56.000000	109	180	71	1	71	0.0140845
NODE_301981_length_187_cov_56.000000	109	180	72	1	71	0.0140845
NODE_301981_length_187_cov_56.000000	109	180	73	1	71	0.0140845
NODE_301981_length_187_cov_56.000000	109	180	76	2	71	0.0281690
NODE_301981_length_187_cov_56.000000	109	180	78	1	71	0.0140845
NODE_301981_length_187_cov_56.000000	109	180	82	1	71	0.0140845
NODE_301981_length_187_cov_56.000000	109	180	86	1	71	0.0140845
NODE_301981_length_187_cov_56.000000	109	180	87	1	71	0.0140845
NODE_301981_length_187_cov_56.000000	109	180	89	1	71	0.0140845
NODE_301981_length_187_cov_56.000000	109	180	92	1	71	0.0140845
NODE_301981_length_187_cov_56.000000	109	180	94	1	71	0.0140845
NODE_301981_length_187_cov_56.000000	109	180	96	3	71	0.0422535
NODE_301981_length_187_cov_56.000000	109	180	100	2	71	0.0281690
NODE_301981_length_187_cov_56.000000	109	180	105	3	71	0.0422535
NODE_301981_length_187_cov_56.000000	109	180	118	1	71	0.0140845
NODE_301981_length_187_cov_56.000000	109	180	120	1	71	0.0140845
NODE_301981_length_187_cov_56.000000	109	180	129	2	71	0.0281690
NODE_301981_length_187_cov_56.000000	109	180	131	2	71	0.0281690
NODE_301981_length_187_cov_56.000000	109	180	133	1	71	0.0140845
NODE_301981_length_187_cov_56.000000	109	180	135	1	71	0.0140845
NODE_301981_length_187_cov_56.000000	109	180	136	1	71	0.0140845
NODE_301981_length_187_cov_56.000000	109	180	142	1	71	0.0140845
NODE_301981_length_187_cov_56.000000	109	180	143	1	71	0.0140845
NODE_301981_length_187_cov_56.000000	109	180	147	3	71	0.0422535
NODE_301981_length_187_cov_56.000000	109	180	148	3	71	0.0422535
NODE_301981_length_187_cov_56.000000	109	180	158	1	71	0.0140845
NODE_301981_length_187_cov_56.000000	109	180	166	1	71	0.0140845
NODE_301981_length_187_cov_56.000000	109	180	167	4	71	0.0563380
NODE_301981_length_187_cov_56.000000	109	180	170	1	71	0.0140845
NODE_301981_length_187_cov_56.000000	109	180	176	1	71	0.0140845
NODE_301981_length_187_cov_56.000000	109	180	184	3	71	0.0422535
NODE_301981_length_187_cov_56.000000	109	180	192	2	71	0.0281690
NODE_301981_length_187_cov_56.000000	109	180	194	1	71	0.0140845
NODE_301981_length_187_cov_56.000000	109	180	196	1	71	0.0140845
NODE_301981_length_187_cov_56.000000	109	180	198	4	71	0.0563380
NODE_301981_length_187_cov_56.000000	109	180	199	2	71	0.0281690
NODE_301986_length_187_cov_37.397727	4	57	20	7	53	0.1320755
NODE_301986_length_187_cov_37.397727	4	57	21	1	53	0.0188679
NODE_301986_length_187_cov_37.397727	4	57	22	5	53	0.0943396
NODE_301986_length_187_cov_37.397727	4	57	25	8	53	0.1509434
NODE_301986_length_187_cov_37.397727	4	57	27	2	53	0.0377358
NODE_301986_length_187_cov_37.397727	4	57	30	1	53	0.0188679
NODE_301986_length_187_cov_37.397727	4	57	36	2	53	0.0377358
NODE_301986_length_187_cov_37.397727	4	57	39	3	53	0.0566038
NODE_301986_length_187_cov_37.397727	4	57	40	1	53	0.0188679
NODE_301986_length_187_cov_37.397727	4	57	41	3	53	0.0566038
NODE_301986_length_187_cov_37.397727	4	57	47	3	53	0.0566038
NODE_301986_length_187_cov_37.397727	4	57	49	1	53	0.0188679
NODE_301986_length_187_cov_37.397727	4	57	53	2	53	0.0377358
NODE_301986_length_187_cov_37.397727	4	57	55	1	53	0.0188679
NODE_301986_length_187_cov_37.397727	4	57	56	1	53	0.0188679
NODE_301986_length_187_cov_37.397727	4	57	58	1	53	0.0188679
NODE_301986_length_187_cov_37.397727	4	57	70	1	53	0.0188679
NODE_301986_length_187_cov_37.397727	4	57	77	1	53	0.0188679
NODE_301986_length_187_cov_37.397727	4	57	79	2	53	0.0377358
NODE_301986_length_187_cov_37.397727	4	57	81	1	53	0.0188679
NODE_301986_length_187_cov_37.397727	4	57	83	1	53	0.0188679
NODE_301986_length_187_cov_37.397727	4	57	85	2	53	0.0377358
NODE_301986_length_187_cov_37.397727	4	57	89	1	53	0.0188679
NODE_301986_length_187_cov_37.397727	4	57	96	1	53	0.0188679
NODE_301986_length_187_cov_37.397727	4	57	110	1	53	0.0188679
NODE_301986_length_187_cov_37.397727	12	78	22	5	66	0.0757576
NODE_301986_length_187_cov_37.397727	12	78	25	8	66	0.1212121
NODE_301986_length_187_cov_37.397727	12	78	27	2	66	0.0303030
NODE_301986_length_187_cov_37.397727	12	78	30	1	66	0.0151515
NODE_301986_length_187_cov_37.397727	12	78	36	2	66	0.0303030
NODE_301986_length_187_cov_37.397727	12	78	39	3	66	0.0454545
NODE_301986_length_187_cov_37.397727	12	78	40	1	66	0.0151515
NODE_301986_length_187_cov_37.397727	12	78	41	3	66	0.0454545
NODE_301986_length_187_cov_37.397727	12	78	47	3	66	0.0454545
NODE_301986_length_187_cov_37.397727	12	78	49	1	66	0.0151515
NODE_301986_length_187_cov_37.397727	12	78	53	2	66	0.0303030
NODE_301986_length_187_cov_37.397727	12	78	55	1	66	0.0151515
NODE_301986_length_187_cov_37.397727	12	78	56	1	66	0.0151515
NODE_301986_length_187_cov_37.397727	12	78	58	1	66	0.0151515
NODE_301986_length_187_cov_37.397727	12	78	70	1	66	0.0151515
NODE_301986_length_187_cov_37.397727	12	78	77	1	66	0.0151515
NODE_301986_length_187_cov_37.397727	12	78	79	2	66	0.0303030
NODE_301986_length_187_cov_37.397727	12	78	81	1	66	0.0151515
NODE_301986_length_187_cov_37.397727	12	78	83	1	66	0.0151515
NODE_301986_length_187_cov_37.397727	12	78	85	2	66	0.0303030
NODE_301986_length_187_cov_37.397727	12	78	89	1	66	0.0151515
NODE_301986_length_187_cov_37.397727	12	78	96	1	66	0.0151515
NODE_301986_length_187_cov_37.397727	12	78	110	1	66	0.0151515
NODE_301986_length_187_cov_37.397727	12	78	116	2	66	0.0303030
NODE_301986_length_187_cov_37.397727	12	78	118	2	66	0.0303030
NODE_301986_length_187_cov_37.397727	12	78	133	2	66	0.0303030
NODE_301986_length_187_cov_37.397727	12	78	138	2	66	0.0303030
NODE_301986_length_187_cov_37.397727	12	78	142	2	66	0.0303030
NODE_301986_length_187_cov_37.397727	12	78	143	1	66	0.0151515
NODE_301986_length_187_cov_37.397727	12	78	147	1	66	0.0151515
NODE_301986_length_187_cov_37.397727	12	78	149	2	66	0.0303030
NODE_301986_length_187_cov_37.397727	12	78	152	1	66	0.0151515
NODE_301986_length_187_cov_37.397727	12	78	156	1	66	0.0151515
NODE_301986_length_187_cov_37.397727	12	78	158	4	66	0.0606061
NODE_301986_length_187_cov_37.397727	12	78	160	1	66	0.0151515
NODE_301986_length_187_cov_37.397727	51	112	83	1	61	0.0163934
NODE_301986_length_187_cov_37.397727	51	112	85	2	61	0.0327869
NODE_301986_length_187_cov_37.397727	51	112	89	1	61	0.0163934
NODE_301986_length_187_cov_37.397727	51	112	96	1	61	0.0163934
NODE_301986_length_187_cov_37.397727	51	112	110	1	61	0.0163934
NODE_301986_length_187_cov_37.397727	51	112	116	2	61	0.0327869
NODE_301986_length_187_cov_37.397727	51	112	118	2	61	0.0327869
NODE_301986_length_187_cov_37.397727	51	112	133	2	61	0.0327869
NODE_301986_length_187_cov_37.397727	51	112	138	2	61	0.0327869
NODE_301986_length_187_cov_37.397727	51	112	142	2	61	0.0327869
NODE_301986_length_187_cov_37.397727	51	112	143	1	61	0.0163934
NODE_301986_length_187_cov_37.397727	51	112	147	1	61	0.0163934
NODE_301986_length_187_cov_37.397727	51	112	149	2	61	0.0327869
NODE_301986_length_187_cov_37.397727	51	112	152	1	61	0.0163934
NODE_301986_length_187_cov_37.397727	51	112	156	1	61	0.0163934
NODE_301986_length_187_cov_37.397727	51	112	158	7	61	0.1147541
NODE_301986_length_187_cov_37.397727	51	112	160	32	61	0.5245901
NODE_301986_length_187_cov_37.397727	51	114	83	1	63	0.0158730
NODE_301986_length_187_cov_37.397727	51	114	85	2	63	0.0317460
NODE_301986_length_187_cov_37.397727	51	114	89	1	63	0.0158730
NODE_301986_length_187_cov_37.397727	51	114	96	1	63	0.0158730
NODE_301986_length_187_cov_37.397727	51	114	110	1	63	0.0158730
NODE_301986_length_187_cov_37.397727	51	114	116	2	63	0.0317460
NODE_301986_length_187_cov_37.397727	51	114	118	2	63	0.0317460
NODE_301986_length_187_cov_37.397727	51	114	133	2	63	0.0317460
NODE_301986_length_187_cov_37.397727	51	114	138	2	63	0.0317460
NODE_301986_length_187_cov_37.397727	51	114	142	2	63	0.0317460
NODE_301986_length_187_cov_37.397727	51	114	143	1	63	0.0158730
NODE_301986_length_187_cov_37.397727	51	114	147	1	63	0.0158730
NODE_301986_length_187_cov_37.397727	51	114	149	2	63	0.0317460
NODE_301986_length_187_cov_37.397727	51	114	152	1	63	0.0158730
NODE_301986_length_187_cov_37.397727	51	114	156	1	63	0.0158730
NODE_301986_length_187_cov_37.397727	51	114	158	9	63	0.1428571
NODE_301986_length_187_cov_37.397727	51	114	160	32	63	0.5079365
NODE_302020_length_186_cov_309.620690	20	104	0	19	84	0.2261905
NODE_302020_length_186_cov_309.620690	20	104	2	65	84	0.7738096
NODE_302021_length_186_cov_295.505747	57	115	123	2	58	0.0344828
NODE_302021_length_186_cov_295.505747	57	115	127	2	58	0.0344828
NODE_302021_length_186_cov_295.505747	57	115	135	1	58	0.0172414
NODE_302021_length_186_cov_295.505747	57	115	137	1	58	0.0172414
NODE_302021_length_186_cov_295.505747	57	115	145	13	58	0.2241379
NODE_302021_length_186_cov_295.505747	57	115	151	1	58	0.0172414
NODE_302021_length_186_cov_295.505747	57	115	154	2	58	0.0344828
NODE_302021_length_186_cov_295.505747	57	115	156	2	58	0.0344828
NODE_302021_length_186_cov_295.505747	57	115	157	1	58	0.0172414
NODE_302021_length_186_cov_295.505747	57	115	158	4	58	0.0689655
NODE_302021_length_186_cov_295.505747	57	115	159	3	58	0.0517241
NODE_302021_length_186_cov_295.505747	57	115	160	2	58	0.0344828
NODE_302021_length_186_cov_295.505747	57	115	161	24	58	0.4137931
NODE_302021_length_186_cov_295.505747	101	168	49	1	67	0.0149254
NODE_302021_length_186_cov_295.505747	101	168	54	5	67	0.0746269
NODE_302021_length_186_cov_295.505747	101	168	55	1	67	0.0149254
NODE_302021_length_186_cov_295.505747	101	168	65	1	67	0.0149254
NODE_302021_length_186_cov_295.505747	101	168	67	1	67	0.0149254
NODE_302021_length_186_cov_295.505747	101	168	68	1	67	0.0149254
NODE_302021_length_186_cov_295.505747	101	168	70	1	67	0.0149254
NODE_302021_length_186_cov_295.505747	101	168	74	1	67	0.0149254
NODE_302021_length_186_cov_295.505747	101	168	76	4	67	0.0597015
NODE_302021_length_186_cov_295.505747	101	168	88	4	67	0.0597015
NODE_302021_length_186_cov_295.505747	101	168	93	2	67	0.0298507
NODE_302021_length_186_cov_295.505747	101	168	100	1	67	0.0149254
NODE_302021_length_186_cov_295.505747	101	168	104	1	67	0.0149254
NODE_302021_length_186_cov_295.505747	101	168	106	2	67	0.0298507
NODE_302021_length_186_cov_295.505747	101	168	111	1	67	0.0149254
NODE_302021_length_186_cov_295.505747	101	168	112	2	67	0.0298507
NODE_302021_length_186_cov_295.505747	101	168	122	6	67	0.0895522
NODE_302021_length_186_cov_295.505747	101	168	127	1	67	0.0149254
NODE_302021_length_186_cov_295.505747	101	168	128	2	67	0.0298507
NODE_302021_length_186_cov_295.505747	101	168	132	1	67	0.0149254
NODE_302021_length_186_cov_295.505747	101	168	133	1	67	0.0149254
NODE_302021_length_186_cov_295.505747	101	168	137	6	67	0.0895522
NODE_302021_length_186_cov_295.505747	101	168	139	4	67	0.0597015
NODE_302021_length_186_cov_295.505747	101	168	147	1	67	0.0149254
NODE_302021_length_186_cov_295.505747	101	168	153	2	67	0.0298507
NODE_302021_length_186_cov_295.505747	101	168	154	2	67	0.0298507
NODE_302021_length_186_cov_295.505747	101	168	156	2	67	0.0298507
NODE_302021_length_186_cov_295.505747	101	168	158	4	67	0.0597015
NODE_302021_length_186_cov_295.505747	101	168	160	2	67	0.0298507
NODE_302021_length_186_cov_295.505747	101	168	161	4	67	0.0597015
NODE_302025_length_186_cov_61.344828	38	118	22	2	80	0.0250000
NODE_302025_length_186_cov_61.344828	38	118	27	6	80	0.0750000
NODE_302025_length_186_cov_61.344828	38	118	29	3	80	0.0375000
NODE_302025_length_186_cov_61.344828	38	118	33	1	80	0.0125000
NODE_302025_length_186_cov_61.344828	38	118	35	1	80	0.0125000
NODE_302025_length_186_cov_61.344828	38	118	39	4	80	0.0500000
NODE_302025_length_186_cov_61.344828	38	118	43	6	80	0.0750000
NODE_302025_length_186_cov_61.344828	38	118	45	9	80	0.1125000
NODE_302025_length_186_cov_61.344828	38	118	51	3	80	0.0375000
NODE_302025_length_186_cov_61.344828	38	118	59	2	80	0.0250000
NODE_302025_length_186_cov_61.344828	38	118	63	1	80	0.0125000
NODE_302025_length_186_cov_61.344828	38	118	66	32	80	0.4000000
NODE_302025_length_186_cov_61.344828	38	118	67	10	80	0.1250000
NODE_302025_length_186_cov_61.344828	91	171	38	7	80	0.0875000
NODE_302025_length_186_cov_61.344828	91	171	42	1	80	0.0125000
NODE_302025_length_186_cov_61.344828	91	171	46	7	80	0.0875000
NODE_302025_length_186_cov_61.344828	91	171	49	2	80	0.0250000
NODE_302025_length_186_cov_61.344828	91	171	50	3	80	0.0375000
NODE_302025_length_186_cov_61.344828	91	171	52	3	80	0.0375000
NODE_302025_length_186_cov_61.344828	91	171	54	4	80	0.0500000
NODE_302025_length_186_cov_61.344828	91	171	56	1	80	0.0125000
NODE_302025_length_186_cov_61.344828	91	171	62	5	80	0.0625000
NODE_302025_length_186_cov_61.344828	91	171	64	7	80	0.0875000
NODE_302025_length_186_cov_61.344828	91	171	66	40	80	0.5000000
NODE_302201_length_182_cov_127.759036	6	52	51	1	46	0.0217391
NODE_302201_length_182_cov_127.759036	6	52	52	2	46	0.0434783
NODE_302201_length_182_cov_127.759036	6	52	55	2	46	0.0434783
NODE_302201_length_182_cov_127.759036	6	52	57	1	46	0.0217391
NODE_302201_length_182_cov_127.759036	6	52	63	2	46	0.0434783
NODE_302201_length_182_cov_127.759036	6	52	66	1	46	0.0217391
NODE_302201_length_182_cov_127.759036	6	52	70	1	46	0.0217391
NODE_302201_length_182_cov_127.759036	6	52	72	1	46	0.0217391
NODE_302201_length_182_cov_127.759036	6	52	74	1	46	0.0217391
NODE_302201_length_182_cov_127.759036	6	52	77	1	46	0.0217391
NODE_302201_length_182_cov_127.759036	6	52	78	1	46	0.0217391
NODE_302201_length_182_cov_127.759036	6	52	80	1	46	0.0217391
NODE_302201_length_182_cov_127.759036	6	52	84	2	46	0.0434783
NODE_302201_length_182_cov_127.759036	6	52	85	1	46	0.0217391
NODE_302201_length_182_cov_127.759036	6	52	98	1	46	0.0217391
NODE_302201_length_182_cov_127.759036	6	52	99	1	46	0.0217391
NODE_302201_length_182_cov_127.759036	6	52	103	1	46	0.0217391
NODE_302201_length_182_cov_127.759036	6	52	110	1	46	0.0217391
NODE_302201_length_182_cov_127.759036	6	52	115	1	46	0.0217391
NODE_302201_length_182_cov_127.759036	6	52	117	1	46	0.0217391
NODE_302201_length_182_cov_127.759036	6	52	129	1	46	0.0217391
NODE_302201_length_182_cov_127.759036	6	52	133	1	46	0.0217391
NODE_302201_length_182_cov_127.759036	6	52	141	1	46	0.0217391
NODE_302201_length_182_cov_127.759036	6	52	143	1	46	0.0217391
NODE_302201_length_182_cov_127.759036	6	52	145	1	46	0.0217391
NODE_302201_length_182_cov_127.759036	6	52	147	4	46	0.0869565
NODE_302201_length_182_cov_127.759036	6	52	148	1	46	0.0217391
NODE_302201_length_182_cov_127.759036	6	52	149	1	46	0.0217391
NODE_302201_length_182_cov_127.759036	6	52	151	2	46	0.0434783
NODE_302201_length_182_cov_127.759036	6	52	153	1	46	0.0217391
NODE_302201_length_182_cov_127.759036	6	52	155	1	46	0.0217391
NODE_302201_length_182_cov_127.759036	6	52	157	1	46	0.0217391
NODE_302201_length_182_cov_127.759036	6	52	160	1	46	0.0217391
NODE_302201_length_182_cov_127.759036	6	52	162	2	46	0.0434783
NODE_302201_length_182_cov_127.759036	6	52	164	1	46	0.0217391
NODE_302201_length_182_cov_127.759036	6	52	168	1	46	0.0217391
NODE_302201_length_182_cov_127.759036	6	52	170	1	46	0.0217391
NODE_302201_length_182_cov_127.759036	59	105	200	1	46	0.0217391
NODE_302201_length_182_cov_127.759036	59	105	204	1	46	0.0217391
NODE_302201_length_182_cov_127.759036	59	105	205	1	46	0.0217391
NODE_302201_length_182_cov_127.759036	59	105	207	1	46	0.0217391
NODE_302201_length_182_cov_127.759036	59	105	216	1	46	0.0217391
NODE_302201_length_182_cov_127.759036	59	105	220	1	46	0.0217391
NODE_302201_length_182_cov_127.759036	59	105	221	1	46	0.0217391
NODE_302201_length_182_cov_127.759036	59	105	223	4	46	0.0869565
NODE_302201_length_182_cov_127.759036	59	105	225	4	46	0.0869565
NODE_302201_length_182_cov_127.759036	59	105	227	1	46	0.0217391
NODE_302201_length_182_cov_127.759036	59	105	228	2	46	0.0434783
NODE_302201_length_182_cov_127.759036	59	105	230	13	46	0.2826087
NODE_302201_length_182_cov_127.759036	59	105	231	15	46	0.3260870
NODE_302214_length_182_cov_29.421687	5	35	0	4	30	0.1333333
NODE_302214_length_182_cov_29.421687	5	35	4	16	30	0.5333334
NODE_302214_length_182_cov_29.421687	5	35	5	3	30	0.1000000
NODE_302214_length_182_cov_29.421687	5	35	6	7	30	0.2333333
NODE_302214_length_182_cov_29.421687	8	88	0	1	80	0.0125000
NODE_302214_length_182_cov_29.421687	8	88	4	16	80	0.2000000
NODE_302214_length_182_cov_29.421687	8	88	5	3	80	0.0375000
NODE_302214_length_182_cov_29.421687	8	88	6	10	80	0.1250000
NODE_302214_length_182_cov_29.421687	8	88	8	50	80	0.6250000
NODE_302236_length_181_cov_141.195122	1	60	0	14	59	0.2372881
NODE_302236_length_181_cov_141.195122	1	60	6	12	59	0.2033898
NODE_302236_length_181_cov_141.195122	1	60	8	33	59	0.5593221
NODE_302236_length_181_cov_141.195122	34	60	8	26	26	1.0000000
NODE_302236_length_181_cov_141.195122	114	145	6	31	31	1.0000000
NODE_302285_length_180_cov_102.567901	6	75	65	1	69	0.0144928
NODE_302285_length_180_cov_102.567901	6	75	70	1	69	0.0144928
NODE_302285_length_180_cov_102.567901	6	75	76	2	69	0.0289855
NODE_302285_length_180_cov_102.567901	6	75	78	2	69	0.0289855
NODE_302285_length_180_cov_102.567901	6	75	86	5	69	0.0724638
NODE_302285_length_180_cov_102.567901	6	75	100	1	69	0.0144928
NODE_302285_length_180_cov_102.567901	6	75	105	1	69	0.0144928
NODE_302285_length_180_cov_102.567901	6	75	108	2	69	0.0289855
NODE_302285_length_180_cov_102.567901	6	75	110	1	69	0.0144928
NODE_302285_length_180_cov_102.567901	6	75	114	2	69	0.0289855
NODE_302285_length_180_cov_102.567901	6	75	117	3	69	0.0434783
NODE_302285_length_180_cov_102.567901	6	75	123	1	69	0.0144928
NODE_302285_length_180_cov_102.567901	6	75	147	1	69	0.0144928
NODE_302285_length_180_cov_102.567901	6	75	156	1	69	0.0144928
NODE_302285_length_180_cov_102.567901	6	75	158	2	69	0.0289855
NODE_302285_length_180_cov_102.567901	6	75	162	1	69	0.0144928
NODE_302285_length_180_cov_102.567901	6	75	168	1	69	0.0144928
NODE_302285_length_180_cov_102.567901	6	75	177	1	69	0.0144928
NODE_302285_length_180_cov_102.567901	6	75	185	1	69	0.0144928
NODE_302285_length_180_cov_102.567901	6	75	217	1	69	0.0144928
NODE_302285_length_180_cov_102.567901	6	75	218	2	69	0.0289855
NODE_302285_length_180_cov_102.567901	6	75	228	1	69	0.0144928
NODE_302285_length_180_cov_102.567901	6	75	250	1	69	0.0144928
NODE_302285_length_180_cov_102.567901	6	75	260	1	69	0.0144928
NODE_302285_length_180_cov_102.567901	6	75	265	2	69	0.0289855
NODE_302285_length_180_cov_102.567901	6	75	273	1	69	0.0144928
NODE_302285_length_180_cov_102.567901	6	75	293	1	69	0.0144928
NODE_302285_length_180_cov_102.567901	6	75	295	1	69	0.0144928
NODE_302285_length_180_cov_102.567901	6	75	299	1	69	0.0144928
NODE_302285_length_180_cov_102.567901	6	75	303	1	69	0.0144928
NODE_302285_length_180_cov_102.567901	6	75	313	1	69	0.0144928
NODE_302285_length_180_cov_102.567901	6	75	316	1	69	0.0144928
NODE_302285_length_180_cov_102.567901	6	75	320	1	69	0.0144928
NODE_302285_length_180_cov_102.567901	6	75	332	2	69	0.0289855
NODE_302285_length_180_cov_102.567901	6	75	340	1	69	0.0144928
NODE_302285_length_180_cov_102.567901	6	75	342	1	69	0.0144928
NODE_302285_length_180_cov_102.567901	6	75	348	1	69	0.0144928
NODE_302285_length_180_cov_102.567901	6	75	350	1	69	0.0144928
NODE_302285_length_180_cov_102.567901	6	75	354	5	69	0.0724638
NODE_302285_length_180_cov_102.567901	6	75	358	1	69	0.0144928
NODE_302285_length_180_cov_102.567901	6	75	359	1	69	0.0144928
NODE_302285_length_180_cov_102.567901	6	75	361	3	69	0.0434783
NODE_302285_length_180_cov_102.567901	6	75	363	7	69	0.1014493
NODE_302363_length_178_cov_93.620253	81	112	22	7	31	0.2258064
NODE_302363_length_178_cov_93.620253	81	112	24	24	31	0.7741935
NODE_302365_length_178_cov_62.696203	0	78	0	3	78	0.0384615
NODE_302365_length_178_cov_62.696203	0	78	3	1	78	0.0128205
NODE_302365_length_178_cov_62.696203	0	78	10	1	78	0.0128205
NODE_302365_length_178_cov_62.696203	0	78	11	1	78	0.0128205
NODE_302365_length_178_cov_62.696203	0	78	13	1	78	0.0128205
NODE_302365_length_178_cov_62.696203	0	78	14	1	78	0.0128205
NODE_302365_length_178_cov_62.696203	0	78	15	8	78	0.1025641
NODE_302365_length_178_cov_62.696203	0	78	17	4	78	0.0512821
NODE_302365_length_178_cov_62.696203	0	78	19	14	78	0.1794872
NODE_302365_length_178_cov_62.696203	0	78	20	7	78	0.0897436
NODE_302365_length_178_cov_62.696203	0	78	22	7	78	0.0897436
NODE_302365_length_178_cov_62.696203	0	78	24	12	78	0.1538462
NODE_302365_length_178_cov_62.696203	0	78	26	18	78	0.2307692
NODE_302365_length_178_cov_62.696203	51	131	24	20	80	0.2500000
NODE_302365_length_178_cov_62.696203	51	131	26	60	80	0.7500000
NODE_302477_length_175_cov_116.684211	42	122	2	3	80	0.0375000
NODE_302477_length_175_cov_116.684211	42	122	12	14	80	0.1750000
NODE_302477_length_175_cov_116.684211	42	122	14	63	80	0.7875000
NODE_302477_length_175_cov_116.684211	95	175	0	3	80	0.0375000
NODE_302477_length_175_cov_116.684211	95	175	8	24	80	0.3000000
NODE_302477_length_175_cov_116.684211	95	175	10	2	80	0.0250000
NODE_302477_length_175_cov_116.684211	95	175	12	2	80	0.0250000
NODE_302477_length_175_cov_116.684211	95	175	14	49	80	0.6125000
NODE_302482_length_175_cov_61.000000	81	121	368	1	40	0.0250000
NODE_302482_length_175_cov_61.000000	81	121	372	1	40	0.0250000
NODE_302482_length_175_cov_61.000000	81	121	384	1	40	0.0250000
NODE_302482_length_175_cov_61.000000	81	121	388	4	40	0.1000000
NODE_302482_length_175_cov_61.000000	81	121	392	2	40	0.0500000
NODE_302482_length_175_cov_61.000000	81	121	398	1	40	0.0250000
NODE_302482_length_175_cov_61.000000	81	121	400	1	40	0.0250000
NODE_302482_length_175_cov_61.000000	81	121	402	1	40	0.0250000
NODE_302482_length_175_cov_61.000000	81	121	404	1	40	0.0250000
NODE_302482_length_175_cov_61.000000	81	121	410	3	40	0.0750000
NODE_302482_length_175_cov_61.000000	81	121	411	1	40	0.0250000
NODE_302482_length_175_cov_61.000000	81	121	419	2	40	0.0500000
NODE_302482_length_175_cov_61.000000	81	121	421	12	40	0.3000000
NODE_302482_length_175_cov_61.000000	81	121	422	9	40	0.2250000
NODE_302538_length_174_cov_173.893333	53	93	296	1	40	0.0250000
NODE_302538_length_174_cov_173.893333	53	93	297	1	40	0.0250000
NODE_302538_length_174_cov_173.893333	53	93	303	1	40	0.0250000
NODE_302538_length_174_cov_173.893333	53	93	307	1	40	0.0250000
NODE_302538_length_174_cov_173.893333	53	93	309	1	40	0.0250000
NODE_302538_length_174_cov_173.893333	53	93	315	1	40	0.0250000
NODE_302538_length_174_cov_173.893333	53	93	317	1	40	0.0250000
NODE_302538_length_174_cov_173.893333	53	93	321	2	40	0.0500000
NODE_302538_length_174_cov_173.893333	53	93	326	1	40	0.0250000
NODE_302538_length_174_cov_173.893333	53	93	327	1	40	0.0250000
NODE_302538_length_174_cov_173.893333	53	93	333	1	40	0.0250000
NODE_302538_length_174_cov_173.893333	53	93	338	1	40	0.0250000
NODE_302538_length_174_cov_173.893333	53	93	340	2	40	0.0500000
NODE_302538_length_174_cov_173.893333	53	93	344	2	40	0.0500000
NODE_302538_length_174_cov_173.893333	53	93	350	2	40	0.0500000
NODE_302538_length_174_cov_173.893333	53	93	351	11	40	0.2750000
NODE_302538_length_174_cov_173.893333	53	93	352	10	40	0.2500000
NODE_302543_length_174_cov_50.346667	91	161	31	2	70	0.0285714
NODE_302543_length_174_cov_50.346667	91	161	33	1	70	0.0142857
NODE_302543_length_174_cov_50.346667	91	161	36	1	70	0.0142857
NODE_302543_length_174_cov_50.346667	91	161	39	1	70	0.0142857
NODE_302543_length_174_cov_50.346667	91	161	40	2	70	0.0285714
NODE_302543_length_174_cov_50.346667	91	161	42	4	70	0.0571429
NODE_302543_length_174_cov_50.346667	91	161	44	2	70	0.0285714
NODE_302543_length_174_cov_50.346667	91	161	48	4	70	0.0571429
NODE_302543_length_174_cov_50.346667	91	161	50	5	70	0.0714286
NODE_302543_length_174_cov_50.346667	91	161	51	1	70	0.0142857
NODE_302543_length_174_cov_50.346667	91	161	56	2	70	0.0285714
NODE_302543_length_174_cov_50.346667	91	161	58	3	70	0.0428571
NODE_302543_length_174_cov_50.346667	91	161	62	1	70	0.0142857
NODE_302543_length_174_cov_50.346667	91	161	66	2	70	0.0285714
NODE_302543_length_174_cov_50.346667	91	161	68	4	70	0.0571429
NODE_302543_length_174_cov_50.346667	91	161	70	3	70	0.0428571
NODE_302543_length_174_cov_50.346667	91	161	72	5	70	0.0714286
NODE_302543_length_174_cov_50.346667	91	161	74	1	70	0.0142857
NODE_302543_length_174_cov_50.346667	91	161	82	1	70	0.0142857
NODE_302543_length_174_cov_50.346667	91	161	84	2	70	0.0285714
NODE_302543_length_174_cov_50.346667	91	161	86	2	70	0.0285714
NODE_302543_length_174_cov_50.346667	91	161	88	4	70	0.0571429
NODE_302543_length_174_cov_50.346667	91	161	89	1	70	0.0142857
NODE_302543_length_174_cov_50.346667	91	161	90	16	70	0.2285714
NODE_302590_length_173_cov_184.351351	62	126	360	1	64	0.0156250
NODE_302590_length_173_cov_184.351351	62	126	364	4	64	0.0625000
NODE_302590_length_173_cov_184.351351	62	126	372	1	64	0.0156250
NODE_302590_length_173_cov_184.351351	62	126	377	1	64	0.0156250
NODE_302590_length_173_cov_184.351351	62	126	378	1	64	0.0156250
NODE_302590_length_173_cov_184.351351	62	126	383	2	64	0.0312500
NODE_302590_length_173_cov_184.351351	62	126	405	1	64	0.0156250
NODE_302590_length_173_cov_184.351351	62	126	407	1	64	0.0156250
NODE_302590_length_173_cov_184.351351	62	126	420	1	64	0.0156250
NODE_302590_length_173_cov_184.351351	62	126	421	1	64	0.0156250
NODE_302590_length_173_cov_184.351351	62	126	423	2	64	0.0312500
NODE_302590_length_173_cov_184.351351	62	126	425	1	64	0.0156250
NODE_302590_length_173_cov_184.351351	62	126	431	1	64	0.0156250
NODE_302590_length_173_cov_184.351351	62	126	432	1	64	0.0156250
NODE_302590_length_173_cov_184.351351	62	126	441	3	64	0.0468750
NODE_302590_length_173_cov_184.351351	62	126	443	2	64	0.0312500
NODE_302590_length_173_cov_184.351351	62	126	444	1	64	0.0156250
NODE_302590_length_173_cov_184.351351	62	126	445	2	64	0.0312500
NODE_302590_length_173_cov_184.351351	62	126	446	23	64	0.3593750
NODE_302590_length_173_cov_184.351351	62	126	447	14	64	0.2187500
NODE_302590_length_173_cov_184.351351	62	126	360	1	64	0.0156250
NODE_302590_length_173_cov_184.351351	62	126	364	4	64	0.0625000
NODE_302590_length_173_cov_184.351351	62	126	372	1	64	0.0156250
NODE_302590_length_173_cov_184.351351	62	126	377	1	64	0.0156250
NODE_302590_length_173_cov_184.351351	62	126	378	1	64	0.0156250
NODE_302590_length_173_cov_184.351351	62	126	383	2	64	0.0312500
NODE_302590_length_173_cov_184.351351	62	126	405	1	64	0.0156250
NODE_302590_length_173_cov_184.351351	62	126	407	1	64	0.0156250
NODE_302590_length_173_cov_184.351351	62	126	420	1	64	0.0156250
NODE_302590_length_173_cov_184.351351	62	126	421	1	64	0.0156250
NODE_302590_length_173_cov_184.351351	62	126	423	2	64	0.0312500
NODE_302590_length_173_cov_184.351351	62	126	425	1	64	0.0156250
NODE_302590_length_173_cov_184.351351	62	126	431	1	64	0.0156250
NODE_302590_length_173_cov_184.351351	62	126	432	1	64	0.0156250
NODE_302590_length_173_cov_184.351351	62	126	441	3	64	0.0468750
NODE_302590_length_173_cov_184.351351	62	126	443	2	64	0.0312500
NODE_302590_length_173_cov_184.351351	62	126	444	1	64	0.0156250
NODE_302590_length_173_cov_184.351351	62	126	445	2	64	0.0312500
NODE_302590_length_173_cov_184.351351	62	126	446	23	64	0.3593750
NODE_302590_length_173_cov_184.351351	62	126	447	14	64	0.2187500
NODE_302590_length_173_cov_184.351351	62	126	360	1	64	0.0156250
NODE_302590_length_173_cov_184.351351	62	126	364	4	64	0.0625000
NODE_302590_length_173_cov_184.351351	62	126	372	1	64	0.0156250
NODE_302590_length_173_cov_184.351351	62	126	377	1	64	0.0156250
NODE_302590_length_173_cov_184.351351	62	126	378	1	64	0.0156250
NODE_302590_length_173_cov_184.351351	62	126	383	2	64	0.0312500
NODE_302590_length_173_cov_184.351351	62	126	405	1	64	0.0156250
NODE_302590_length_173_cov_184.351351	62	126	407	1	64	0.0156250
NODE_302590_length_173_cov_184.351351	62	126	420	1	64	0.0156250
NODE_302590_length_173_cov_184.351351	62	126	421	1	64	0.0156250
NODE_302590_length_173_cov_184.351351	62	126	423	2	64	0.0312500
NODE_302590_length_173_cov_184.351351	62	126	425	1	64	0.0156250
NODE_302590_length_173_cov_184.351351	62	126	431	1	64	0.0156250
NODE_302590_length_173_cov_184.351351	62	126	432	1	64	0.0156250
NODE_302590_length_173_cov_184.351351	62	126	441	3	64	0.0468750
NODE_302590_length_173_cov_184.351351	62	126	443	2	64	0.0312500
NODE_302590_length_173_cov_184.351351	62	126	444	1	64	0.0156250
NODE_302590_length_173_cov_184.351351	62	126	445	2	64	0.0312500
NODE_302590_length_173_cov_184.351351	62	126	446	23	64	0.3593750
NODE_302590_length_173_cov_184.351351	62	126	447	14	64	0.2187500
NODE_302590_length_173_cov_184.351351	62	126	360	1	64	0.0156250
NODE_302590_length_173_cov_184.351351	62	126	364	4	64	0.0625000
NODE_302590_length_173_cov_184.351351	62	126	372	1	64	0.0156250
NODE_302590_length_173_cov_184.351351	62	126	377	1	64	0.0156250
NODE_302590_length_173_cov_184.351351	62	126	378	1	64	0.0156250
NODE_302590_length_173_cov_184.351351	62	126	383	2	64	0.0312500
NODE_302590_length_173_cov_184.351351	62	126	405	1	64	0.0156250
NODE_302590_length_173_cov_184.351351	62	126	407	1	64	0.0156250
NODE_302590_length_173_cov_184.351351	62	126	420	1	64	0.0156250
NODE_302590_length_173_cov_184.351351	62	126	421	1	64	0.0156250
NODE_302590_length_173_cov_184.351351	62	126	423	2	64	0.0312500
NODE_302590_length_173_cov_184.351351	62	126	425	1	64	0.0156250
NODE_302590_length_173_cov_184.351351	62	126	431	1	64	0.0156250
NODE_302590_length_173_cov_184.351351	62	126	432	1	64	0.0156250
NODE_302590_length_173_cov_184.351351	62	126	441	3	64	0.0468750
NODE_302590_length_173_cov_184.351351	62	126	443	2	64	0.0312500
NODE_302590_length_173_cov_184.351351	62	126	444	1	64	0.0156250
NODE_302590_length_173_cov_184.351351	62	126	445	2	64	0.0312500
NODE_302590_length_173_cov_184.351351	62	126	446	23	64	0.3593750
NODE_302590_length_173_cov_184.351351	62	126	447	14	64	0.2187500
NODE_302590_length_173_cov_184.351351	99	165	92	2	66	0.0303030
NODE_302590_length_173_cov_184.351351	99	165	97	1	66	0.0151515
NODE_302590_length_173_cov_184.351351	99	165	106	1	66	0.0151515
NODE_302590_length_173_cov_184.351351	99	165	124	1	66	0.0151515
NODE_302590_length_173_cov_184.351351	99	165	128	1	66	0.0151515
NODE_302590_length_173_cov_184.351351	99	165	131	1	66	0.0151515
NODE_302590_length_173_cov_184.351351	99	165	133	1	66	0.0151515
NODE_302590_length_173_cov_184.351351	99	165	134	1	66	0.0151515
NODE_302590_length_173_cov_184.351351	99	165	138	1	66	0.0151515
NODE_302590_length_173_cov_184.351351	99	165	146	2	66	0.0303030
NODE_302590_length_173_cov_184.351351	99	165	148	1	66	0.0151515
NODE_302590_length_173_cov_184.351351	99	165	151	2	66	0.0303030
NODE_302590_length_173_cov_184.351351	99	165	154	1	66	0.0151515
NODE_302590_length_173_cov_184.351351	99	165	162	2	66	0.0303030
NODE_302590_length_173_cov_184.351351	99	165	173	1	66	0.0151515
NODE_302590_length_173_cov_184.351351	99	165	174	1	66	0.0151515
NODE_302590_length_173_cov_184.351351	99	165	189	1	66	0.0151515
NODE_302590_length_173_cov_184.351351	99	165	199	2	66	0.0303030
NODE_302590_length_173_cov_184.351351	99	165	209	1	66	0.0151515
NODE_302590_length_173_cov_184.351351	99	165	216	1	66	0.0151515
NODE_302590_length_173_cov_184.351351	99	165	239	1	66	0.0151515
NODE_302590_length_173_cov_184.351351	99	165	244	1	66	0.0151515
NODE_302590_length_173_cov_184.351351	99	165	252	1	66	0.0151515
NODE_302590_length_173_cov_184.351351	99	165	262	1	66	0.0151515
NODE_302590_length_173_cov_184.351351	99	165	271	1	66	0.0151515
NODE_302590_length_173_cov_184.351351	99	165	280	1	66	0.0151515
NODE_302590_length_173_cov_184.351351	99	165	281	1	66	0.0151515
NODE_302590_length_173_cov_184.351351	99	165	302	1	66	0.0151515
NODE_302590_length_173_cov_184.351351	99	165	303	1	66	0.0151515
NODE_302590_length_173_cov_184.351351	99	165	320	1	66	0.0151515
NODE_302590_length_173_cov_184.351351	99	165	329	1	66	0.0151515
NODE_302590_length_173_cov_184.351351	99	165	332	1	66	0.0151515
NODE_302590_length_173_cov_184.351351	99	165	342	1	66	0.0151515
NODE_302590_length_173_cov_184.351351	99	165	356	1	66	0.0151515
NODE_302590_length_173_cov_184.351351	99	165	360	1	66	0.0151515
NODE_302590_length_173_cov_184.351351	99	165	364	4	66	0.0606061
NODE_302590_length_173_cov_184.351351	99	165	372	1	66	0.0151515
NODE_302590_length_173_cov_184.351351	99	165	377	1	66	0.0151515
NODE_302590_length_173_cov_184.351351	99	165	378	1	66	0.0151515
NODE_302590_length_173_cov_184.351351	99	165	383	2	66	0.0303030
NODE_302590_length_173_cov_184.351351	99	165	405	1	66	0.0151515
NODE_302590_length_173_cov_184.351351	99	165	407	1	66	0.0151515
NODE_302590_length_173_cov_184.351351	99	165	420	1	66	0.0151515
NODE_302590_length_173_cov_184.351351	99	165	421	1	66	0.0151515
NODE_302590_length_173_cov_184.351351	99	165	423	2	66	0.0303030
NODE_302590_length_173_cov_184.351351	99	165	425	1	66	0.0151515
NODE_302590_length_173_cov_184.351351	99	165	431	1	66	0.0151515
NODE_302590_length_173_cov_184.351351	99	165	432	1	66	0.0151515
NODE_302590_length_173_cov_184.351351	99	165	441	3	66	0.0454545
NODE_302590_length_173_cov_184.351351	99	165	443	1	66	0.0151515
NODE_302590_length_173_cov_184.351351	99	165	444	1	66	0.0151515
NODE_302590_length_173_cov_184.351351	99	165	446	3	66	0.0454545
NODE_302590_length_173_cov_184.351351	99	170	57	1	71	0.0140845
NODE_302590_length_173_cov_184.351351	99	170	72	1	71	0.0140845
NODE_302590_length_173_cov_184.351351	99	170	87	1	71	0.0140845
NODE_302590_length_173_cov_184.351351	99	170	90	1	71	0.0140845
NODE_302590_length_173_cov_184.351351	99	170	91	1	71	0.0140845
NODE_302590_length_173_cov_184.351351	99	170	92	2	71	0.0281690
NODE_302590_length_173_cov_184.351351	99	170	97	1	71	0.0140845
NODE_302590_length_173_cov_184.351351	99	170	106	1	71	0.0140845
NODE_302590_length_173_cov_184.351351	99	170	124	1	71	0.0140845
NODE_302590_length_173_cov_184.351351	99	170	128	1	71	0.0140845
NODE_302590_length_173_cov_184.351351	99	170	131	1	71	0.0140845
NODE_302590_length_173_cov_184.351351	99	170	133	1	71	0.0140845
NODE_302590_length_173_cov_184.351351	99	170	134	1	71	0.0140845
NODE_302590_length_173_cov_184.351351	99	170	138	1	71	0.0140845
NODE_302590_length_173_cov_184.351351	99	170	146	2	71	0.0281690
NODE_302590_length_173_cov_184.351351	99	170	148	1	71	0.0140845
NODE_302590_length_173_cov_184.351351	99	170	151	2	71	0.0281690
NODE_302590_length_173_cov_184.351351	99	170	154	1	71	0.0140845
NODE_302590_length_173_cov_184.351351	99	170	162	2	71	0.0281690
NODE_302590_length_173_cov_184.351351	99	170	173	1	71	0.0140845
NODE_302590_length_173_cov_184.351351	99	170	174	1	71	0.0140845
NODE_302590_length_173_cov_184.351351	99	170	189	1	71	0.0140845
NODE_302590_length_173_cov_184.351351	99	170	199	2	71	0.0281690
NODE_302590_length_173_cov_184.351351	99	170	209	1	71	0.0140845
NODE_302590_length_173_cov_184.351351	99	170	216	1	71	0.0140845
NODE_302590_length_173_cov_184.351351	99	170	239	1	71	0.0140845
NODE_302590_length_173_cov_184.351351	99	170	244	1	71	0.0140845
NODE_302590_length_173_cov_184.351351	99	170	252	1	71	0.0140845
NODE_302590_length_173_cov_184.351351	99	170	262	1	71	0.0140845
NODE_302590_length_173_cov_184.351351	99	170	271	1	71	0.0140845
NODE_302590_length_173_cov_184.351351	99	170	280	1	71	0.0140845
NODE_302590_length_173_cov_184.351351	99	170	281	1	71	0.0140845
NODE_302590_length_173_cov_184.351351	99	170	302	1	71	0.0140845
NODE_302590_length_173_cov_184.351351	99	170	303	1	71	0.0140845
NODE_302590_length_173_cov_184.351351	99	170	320	1	71	0.0140845
NODE_302590_length_173_cov_184.351351	99	170	329	1	71	0.0140845
NODE_302590_length_173_cov_184.351351	99	170	332	1	71	0.0140845
NODE_302590_length_173_cov_184.351351	99	170	342	1	71	0.0140845
NODE_302590_length_173_cov_184.351351	99	170	356	1	71	0.0140845
NODE_302590_length_173_cov_184.351351	99	170	360	1	71	0.0140845
NODE_302590_length_173_cov_184.351351	99	170	364	4	71	0.0563380
NODE_302590_length_173_cov_184.351351	99	170	372	1	71	0.0140845
NODE_302590_length_173_cov_184.351351	99	170	377	1	71	0.0140845
NODE_302590_length_173_cov_184.351351	99	170	378	1	71	0.0140845
NODE_302590_length_173_cov_184.351351	99	170	383	2	71	0.0281690
NODE_302590_length_173_cov_184.351351	99	170	405	1	71	0.0140845
NODE_302590_length_173_cov_184.351351	99	170	407	1	71	0.0140845
NODE_302590_length_173_cov_184.351351	99	170	420	1	71	0.0140845
NODE_302590_length_173_cov_184.351351	99	170	421	1	71	0.0140845
NODE_302590_length_173_cov_184.351351	99	170	423	2	71	0.0281690
NODE_302590_length_173_cov_184.351351	99	170	425	1	71	0.0140845
NODE_302590_length_173_cov_184.351351	99	170	431	1	71	0.0140845
NODE_302590_length_173_cov_184.351351	99	170	432	1	71	0.0140845
NODE_302590_length_173_cov_184.351351	99	170	441	3	71	0.0422535
NODE_302590_length_173_cov_184.351351	99	170	443	1	71	0.0140845
NODE_302590_length_173_cov_184.351351	99	170	444	1	71	0.0140845
NODE_302590_length_173_cov_184.351351	99	170	446	3	71	0.0422535
NODE_302590_length_173_cov_184.351351	115	173	41	1	58	0.0172414
NODE_302590_length_173_cov_184.351351	115	173	46	1	58	0.0172414
NODE_302590_length_173_cov_184.351351	115	173	54	1	58	0.0172414
NODE_302590_length_173_cov_184.351351	115	173	57	1	58	0.0172414
NODE_302590_length_173_cov_184.351351	115	173	72	1	58	0.0172414
NODE_302590_length_173_cov_184.351351	115	173	87	1	58	0.0172414
NODE_302590_length_173_cov_184.351351	115	173	90	1	58	0.0172414
NODE_302590_length_173_cov_184.351351	115	173	91	1	58	0.0172414
NODE_302590_length_173_cov_184.351351	115	173	92	2	58	0.0344828
NODE_302590_length_173_cov_184.351351	115	173	97	1	58	0.0172414
NODE_302590_length_173_cov_184.351351	115	173	106	1	58	0.0172414
NODE_302590_length_173_cov_184.351351	115	173	124	1	58	0.0172414
NODE_302590_length_173_cov_184.351351	115	173	128	1	58	0.0172414
NODE_302590_length_173_cov_184.351351	115	173	131	1	58	0.0172414
NODE_302590_length_173_cov_184.351351	115	173	133	1	58	0.0172414
NODE_302590_length_173_cov_184.351351	115	173	134	1	58	0.0172414
NODE_302590_length_173_cov_184.351351	115	173	138	1	58	0.0172414
NODE_302590_length_173_cov_184.351351	115	173	146	2	58	0.0344828
NODE_302590_length_173_cov_184.351351	115	173	148	1	58	0.0172414
NODE_302590_length_173_cov_184.351351	115	173	151	2	58	0.0344828
NODE_302590_length_173_cov_184.351351	115	173	154	1	58	0.0172414
NODE_302590_length_173_cov_184.351351	115	173	162	2	58	0.0344828
NODE_302590_length_173_cov_184.351351	115	173	173	1	58	0.0172414
NODE_302590_length_173_cov_184.351351	115	173	174	1	58	0.0172414
NODE_302590_length_173_cov_184.351351	115	173	189	1	58	0.0172414
NODE_302590_length_173_cov_184.351351	115	173	199	2	58	0.0344828
NODE_302590_length_173_cov_184.351351	115	173	209	1	58	0.0172414
NODE_302590_length_173_cov_184.351351	115	173	216	1	58	0.0172414
NODE_302590_length_173_cov_184.351351	115	173	239	1	58	0.0172414
NODE_302590_length_173_cov_184.351351	115	173	244	1	58	0.0172414
NODE_302590_length_173_cov_184.351351	115	173	252	1	58	0.0172414
NODE_302590_length_173_cov_184.351351	115	173	262	1	58	0.0172414
NODE_302590_length_173_cov_184.351351	115	173	271	1	58	0.0172414
NODE_302590_length_173_cov_184.351351	115	173	280	1	58	0.0172414
NODE_302590_length_173_cov_184.351351	115	173	281	1	58	0.0172414
NODE_302590_length_173_cov_184.351351	115	173	302	1	58	0.0172414
NODE_302590_length_173_cov_184.351351	115	173	303	1	58	0.0172414
NODE_302590_length_173_cov_184.351351	115	173	320	1	58	0.0172414
NODE_302590_length_173_cov_184.351351	115	173	329	1	58	0.0172414
NODE_302590_length_173_cov_184.351351	115	173	332	1	58	0.0172414
NODE_302590_length_173_cov_184.351351	115	173	342	1	58	0.0172414
NODE_302590_length_173_cov_184.351351	115	173	356	1	58	0.0172414
NODE_302590_length_173_cov_184.351351	115	173	360	1	58	0.0172414
NODE_302590_length_173_cov_184.351351	115	173	364	4	58	0.0689655
NODE_302590_length_173_cov_184.351351	115	173	372	1	58	0.0172414
NODE_302590_length_173_cov_184.351351	115	173	377	1	58	0.0172414
NODE_302590_length_173_cov_184.351351	115	173	378	1	58	0.0172414
NODE_302590_length_173_cov_184.351351	115	173	383	2	58	0.0344828
NODE_302590_length_173_cov_184.351351	115	173	405	1	58	0.0172414
NODE_302596_length_173_cov_58.472973	0	78	3	3	78	0.0384615
NODE_302596_length_173_cov_58.472973	0	78	11	6	78	0.0769231
NODE_302596_length_173_cov_58.472973	0	78	15	2	78	0.0256410
NODE_302596_length_173_cov_58.472973	0	78	17	1	78	0.0128205
NODE_302596_length_173_cov_58.472973	0	78	18	3	78	0.0384615
NODE_302596_length_173_cov_58.472973	0	78	19	2	78	0.0256410
NODE_302596_length_173_cov_58.472973	0	78	22	1	78	0.0128205
NODE_302596_length_173_cov_58.472973	0	78	24	3	78	0.0384615
NODE_302596_length_173_cov_58.472973	0	78	26	1	78	0.0128205
NODE_302596_length_173_cov_58.472973	0	78	29	4	78	0.0512821
NODE_302596_length_173_cov_58.472973	0	78	31	1	78	0.0128205
NODE_302596_length_173_cov_58.472973	0	78	32	1	78	0.0128205
NODE_302596_length_173_cov_58.472973	0	78	34	1	78	0.0128205
NODE_302596_length_173_cov_58.472973	0	78	36	5	78	0.0641026
NODE_302596_length_173_cov_58.472973	0	78	38	2	78	0.0256410
NODE_302596_length_173_cov_58.472973	0	78	42	2	78	0.0256410
NODE_302596_length_173_cov_58.472973	0	78	44	1	78	0.0128205
NODE_302596_length_173_cov_58.472973	0	78	45	2	78	0.0256410
NODE_302596_length_173_cov_58.472973	0	78	53	2	78	0.0256410
NODE_302596_length_173_cov_58.472973	0	78	55	3	78	0.0384615
NODE_302596_length_173_cov_58.472973	0	78	58	2	78	0.0256410
NODE_302596_length_173_cov_58.472973	0	78	60	1	78	0.0128205
NODE_302596_length_173_cov_58.472973	0	78	62	1	78	0.0128205
NODE_302596_length_173_cov_58.472973	0	78	70	2	78	0.0256410
NODE_302596_length_173_cov_58.472973	0	78	74	10	78	0.1282051
NODE_302596_length_173_cov_58.472973	0	78	76	1	78	0.0128205
NODE_302596_length_173_cov_58.472973	0	78	80	1	78	0.0128205
NODE_302596_length_173_cov_58.472973	0	78	86	1	78	0.0128205
NODE_302596_length_173_cov_58.472973	0	78	88	2	78	0.0256410
NODE_302596_length_173_cov_58.472973	0	78	92	2	78	0.0256410
NODE_302596_length_173_cov_58.472973	0	78	94	9	78	0.1153846
NODE_302597_length_173_cov_57.148649	101	142	152	1	41	0.0243902
NODE_302597_length_173_cov_57.148649	101	142	153	3	41	0.0731707
NODE_302597_length_173_cov_57.148649	101	142	161	1	41	0.0243902
NODE_302597_length_173_cov_57.148649	101	142	166	1	41	0.0243902
NODE_302597_length_173_cov_57.148649	101	142	170	1	41	0.0243902
NODE_302597_length_173_cov_57.148649	101	142	174	3	41	0.0731707
NODE_302597_length_173_cov_57.148649	101	142	176	2	41	0.0487805
NODE_302597_length_173_cov_57.148649	101	142	178	1	41	0.0243902
NODE_302597_length_173_cov_57.148649	101	142	180	2	41	0.0487805
NODE_302597_length_173_cov_57.148649	101	142	185	2	41	0.0487805
NODE_302597_length_173_cov_57.148649	101	142	189	1	41	0.0243902
NODE_302597_length_173_cov_57.148649	101	142	192	3	41	0.0731707
NODE_302597_length_173_cov_57.148649	101	142	198	1	41	0.0243902
NODE_302597_length_173_cov_57.148649	101	142	200	4	41	0.0975610
NODE_302597_length_173_cov_57.148649	101	142	206	2	41	0.0487805
NODE_302597_length_173_cov_57.148649	101	142	210	4	41	0.0975610
NODE_302597_length_173_cov_57.148649	101	142	212	2	41	0.0487805
NODE_302597_length_173_cov_57.148649	101	142	218	3	41	0.0731707
NODE_302597_length_173_cov_57.148649	101	142	220	2	41	0.0487805
NODE_302597_length_173_cov_57.148649	101	142	222	1	41	0.0243902
NODE_302597_length_173_cov_57.148649	101	142	228	1	41	0.0243902
NODE_302597_length_173_cov_57.148649	109	173	45	1	64	0.0156250
NODE_302597_length_173_cov_57.148649	109	173	53	2	64	0.0312500
NODE_302597_length_173_cov_57.148649	109	173	55	1	64	0.0156250
NODE_302597_length_173_cov_57.148649	109	173	57	1	64	0.0156250
NODE_302597_length_173_cov_57.148649	109	173	59	1	64	0.0156250
NODE_302597_length_173_cov_57.148649	109	173	63	1	64	0.0156250
NODE_302597_length_173_cov_57.148649	109	173	67	1	64	0.0156250
NODE_302597_length_173_cov_57.148649	109	173	69	1	64	0.0156250
NODE_302597_length_173_cov_57.148649	109	173	75	1	64	0.0156250
NODE_302597_length_173_cov_57.148649	109	173	76	1	64	0.0156250
NODE_302597_length_173_cov_57.148649	109	173	82	1	64	0.0156250
NODE_302597_length_173_cov_57.148649	109	173	85	1	64	0.0156250
NODE_302597_length_173_cov_57.148649	109	173	88	1	64	0.0156250
NODE_302597_length_173_cov_57.148649	109	173	103	2	64	0.0312500
NODE_302597_length_173_cov_57.148649	109	173	106	1	64	0.0156250
NODE_302597_length_173_cov_57.148649	109	173	108	1	64	0.0156250
NODE_302597_length_173_cov_57.148649	109	173	116	1	64	0.0156250
NODE_302597_length_173_cov_57.148649	109	173	122	2	64	0.0312500
NODE_302597_length_173_cov_57.148649	109	173	124	1	64	0.0156250
NODE_302597_length_173_cov_57.148649	109	173	126	1	64	0.0156250
NODE_302597_length_173_cov_57.148649	109	173	134	1	64	0.0156250
NODE_302597_length_173_cov_57.148649	109	173	135	1	64	0.0156250
NODE_302597_length_173_cov_57.148649	109	173	139	2	64	0.0312500
NODE_302597_length_173_cov_57.148649	109	173	140	3	64	0.0468750
NODE_302597_length_173_cov_57.148649	109	173	142	1	64	0.0156250
NODE_302597_length_173_cov_57.148649	109	173	152	1	64	0.0156250
NODE_302597_length_173_cov_57.148649	109	173	153	3	64	0.0468750
NODE_302597_length_173_cov_57.148649	109	173	161	1	64	0.0156250
NODE_302597_length_173_cov_57.148649	109	173	166	1	64	0.0156250
NODE_302597_length_173_cov_57.148649	109	173	170	1	64	0.0156250
NODE_302597_length_173_cov_57.148649	109	173	174	3	64	0.0468750
NODE_302597_length_173_cov_57.148649	109	173	176	2	64	0.0312500
NODE_302597_length_173_cov_57.148649	109	173	178	1	64	0.0156250
NODE_302597_length_173_cov_57.148649	109	173	180	2	64	0.0312500
NODE_302597_length_173_cov_57.148649	109	173	185	2	64	0.0312500
NODE_302597_length_173_cov_57.148649	109	173	189	1	64	0.0156250
NODE_302597_length_173_cov_57.148649	109	173	192	3	64	0.0468750
NODE_302597_length_173_cov_57.148649	109	173	198	1	64	0.0156250
NODE_302597_length_173_cov_57.148649	109	173	200	4	64	0.0625000
NODE_302597_length_173_cov_57.148649	109	173	206	2	64	0.0312500
NODE_302597_length_173_cov_57.148649	109	173	210	4	64	0.0625000
NODE_302597_length_173_cov_57.148649	109	173	212	1	64	0.0156250
NODE_302686_length_171_cov_218.666667	12	90	10	3	78	0.0384615
NODE_302686_length_171_cov_218.666667	12	90	17	2	78	0.0256410
NODE_302686_length_171_cov_218.666667	12	90	19	1	78	0.0128205
NODE_302686_length_171_cov_218.666667	12	90	28	1	78	0.0128205
NODE_302686_length_171_cov_218.666667	12	90	30	1	78	0.0128205
NODE_302686_length_171_cov_218.666667	12	90	34	1	78	0.0128205
NODE_302686_length_171_cov_218.666667	12	90	39	1	78	0.0128205
NODE_302686_length_171_cov_218.666667	12	90	43	2	78	0.0256410
NODE_302686_length_171_cov_218.666667	12	90	45	3	78	0.0384615
NODE_302686_length_171_cov_218.666667	12	90	51	2	78	0.0256410
NODE_302686_length_171_cov_218.666667	12	90	53	2	78	0.0256410
NODE_302686_length_171_cov_218.666667	12	90	62	2	78	0.0256410
NODE_302686_length_171_cov_218.666667	12	90	101	1	78	0.0128205
NODE_302686_length_171_cov_218.666667	12	90	104	5	78	0.0641026
NODE_302686_length_171_cov_218.666667	12	90	106	2	78	0.0256410
NODE_302686_length_171_cov_218.666667	12	90	110	3	78	0.0384615
NODE_302686_length_171_cov_218.666667	12	90	119	1	78	0.0128205
NODE_302686_length_171_cov_218.666667	12	90	120	2	78	0.0256410
NODE_302686_length_171_cov_218.666667	12	90	121	1	78	0.0128205
NODE_302686_length_171_cov_218.666667	12	90	123	1	78	0.0128205
NODE_302686_length_171_cov_218.666667	12	90	125	1	78	0.0128205
NODE_302686_length_171_cov_218.666667	12	90	127	1	78	0.0128205
NODE_302686_length_171_cov_218.666667	12	90	133	5	78	0.0641026
NODE_302686_length_171_cov_218.666667	12	90	134	14	78	0.1794872
NODE_302686_length_171_cov_218.666667	12	90	135	2	78	0.0256410
NODE_302686_length_171_cov_218.666667	12	90	136	2	78	0.0256410
NODE_302686_length_171_cov_218.666667	12	90	137	5	78	0.0641026
NODE_302686_length_171_cov_218.666667	12	90	138	11	78	0.1410256
NODE_302686_length_171_cov_218.666667	12	90	10	3	78	0.0384615
NODE_302686_length_171_cov_218.666667	12	90	17	2	78	0.0256410
NODE_302686_length_171_cov_218.666667	12	90	19	1	78	0.0128205
NODE_302686_length_171_cov_218.666667	12	90	28	1	78	0.0128205
NODE_302686_length_171_cov_218.666667	12	90	30	1	78	0.0128205
NODE_302686_length_171_cov_218.666667	12	90	34	1	78	0.0128205
NODE_302686_length_171_cov_218.666667	12	90	39	1	78	0.0128205
NODE_302686_length_171_cov_218.666667	12	90	43	2	78	0.0256410
NODE_302686_length_171_cov_218.666667	12	90	45	3	78	0.0384615
NODE_302686_length_171_cov_218.666667	12	90	51	2	78	0.0256410
NODE_302686_length_171_cov_218.666667	12	90	53	2	78	0.0256410
NODE_302686_length_171_cov_218.666667	12	90	62	2	78	0.0256410
NODE_302686_length_171_cov_218.666667	12	90	101	1	78	0.0128205
NODE_302686_length_171_cov_218.666667	12	90	104	5	78	0.0641026
NODE_302686_length_171_cov_218.666667	12	90	106	2	78	0.0256410
NODE_302686_length_171_cov_218.666667	12	90	110	3	78	0.0384615
NODE_302686_length_171_cov_218.666667	12	90	119	1	78	0.0128205
NODE_302686_length_171_cov_218.666667	12	90	120	2	78	0.0256410
NODE_302686_length_171_cov_218.666667	12	90	121	1	78	0.0128205
NODE_302686_length_171_cov_218.666667	12	90	123	1	78	0.0128205
NODE_302686_length_171_cov_218.666667	12	90	125	1	78	0.0128205
NODE_302686_length_171_cov_218.666667	12	90	127	1	78	0.0128205
NODE_302686_length_171_cov_218.666667	12	90	133	5	78	0.0641026
NODE_302686_length_171_cov_218.666667	12	90	134	14	78	0.1794872
NODE_302686_length_171_cov_218.666667	12	90	135	2	78	0.0256410
NODE_302686_length_171_cov_218.666667	12	90	136	2	78	0.0256410
NODE_302686_length_171_cov_218.666667	12	90	137	5	78	0.0641026
NODE_302686_length_171_cov_218.666667	12	90	138	11	78	0.1410256
NODE_302686_length_171_cov_218.666667	21	90	39	1	69	0.0144928
NODE_302686_length_171_cov_218.666667	21	90	43	2	69	0.0289855
NODE_302686_length_171_cov_218.666667	21	90	45	3	69	0.0434783
NODE_302686_length_171_cov_218.666667	21	90	51	2	69	0.0289855
NODE_302686_length_171_cov_218.666667	21	90	53	2	69	0.0289855
NODE_302686_length_171_cov_218.666667	21	90	62	2	69	0.0289855
NODE_302686_length_171_cov_218.666667	21	90	101	1	69	0.0144928
NODE_302686_length_171_cov_218.666667	21	90	104	5	69	0.0724638
NODE_302686_length_171_cov_218.666667	21	90	106	2	69	0.0289855
NODE_302686_length_171_cov_218.666667	21	90	110	3	69	0.0434783
NODE_302686_length_171_cov_218.666667	21	90	119	1	69	0.0144928
NODE_302686_length_171_cov_218.666667	21	90	120	2	69	0.0289855
NODE_302686_length_171_cov_218.666667	21	90	121	1	69	0.0144928
NODE_302686_length_171_cov_218.666667	21	90	123	1	69	0.0144928
NODE_302686_length_171_cov_218.666667	21	90	125	1	69	0.0144928
NODE_302686_length_171_cov_218.666667	21	90	127	1	69	0.0144928
NODE_302686_length_171_cov_218.666667	21	90	133	5	69	0.0724638
NODE_302686_length_171_cov_218.666667	21	90	134	14	69	0.2028985
NODE_302686_length_171_cov_218.666667	21	90	135	2	69	0.0289855
NODE_302686_length_171_cov_218.666667	21	90	136	2	69	0.0289855
NODE_302686_length_171_cov_218.666667	21	90	137	5	69	0.0724638
NODE_302686_length_171_cov_218.666667	21	90	138	11	69	0.1594203
NODE_302689_length_171_cov_110.194444	81	161	9	7	80	0.0875000
NODE_302689_length_171_cov_110.194444	81	161	12	1	80	0.0125000
NODE_302689_length_171_cov_110.194444	81	161	16	2	80	0.0250000
NODE_302689_length_171_cov_110.194444	81	161	17	1	80	0.0125000
NODE_302689_length_171_cov_110.194444	81	161	23	9	80	0.1125000
NODE_302689_length_171_cov_110.194444	81	161	25	2	80	0.0250000
NODE_302689_length_171_cov_110.194444	81	161	30	10	80	0.1250000
NODE_302689_length_171_cov_110.194444	81	161	31	7	80	0.0875000
NODE_302689_length_171_cov_110.194444	81	161	32	41	80	0.5125000
NODE_302689_length_171_cov_110.194444	81	152	16	1	71	0.0140845
NODE_302689_length_171_cov_110.194444	81	152	17	1	71	0.0140845
NODE_302689_length_171_cov_110.194444	81	152	23	9	71	0.1267606
NODE_302689_length_171_cov_110.194444	81	152	25	2	71	0.0281690
NODE_302689_length_171_cov_110.194444	81	152	30	10	71	0.1408451
NODE_302689_length_171_cov_110.194444	81	152	31	7	71	0.0985916
NODE_302689_length_171_cov_110.194444	81	152	32	41	71	0.5774648
NODE_302691_length_171_cov_86.013889	106	171	0	13	65	0.2000000
NODE_302691_length_171_cov_86.013889	106	171	2	4	65	0.0615385
NODE_302691_length_171_cov_86.013889	106	171	4	7	65	0.1076923
NODE_302691_length_171_cov_86.013889	106	171	6	41	65	0.6307693
NODE_302697_length_171_cov_46.430556	0	59	10	1	59	0.0169492
NODE_302697_length_171_cov_46.430556	0	59	14	2	59	0.0338983
NODE_302697_length_171_cov_46.430556	0	59	22	1	59	0.0169492
NODE_302697_length_171_cov_46.430556	0	59	24	1	59	0.0169492
NODE_302697_length_171_cov_46.430556	0	59	26	1	59	0.0169492
NODE_302697_length_171_cov_46.430556	0	59	30	1	59	0.0169492
NODE_302697_length_171_cov_46.430556	0	59	36	3	59	0.0508475
NODE_302697_length_171_cov_46.430556	0	59	38	1	59	0.0169492
NODE_302697_length_171_cov_46.430556	0	59	44	1	59	0.0169492
NODE_302697_length_171_cov_46.430556	0	59	45	1	59	0.0169492
NODE_302697_length_171_cov_46.430556	0	59	49	2	59	0.0338983
NODE_302697_length_171_cov_46.430556	0	59	57	1	59	0.0169492
NODE_302697_length_171_cov_46.430556	0	59	59	1	59	0.0169492
NODE_302697_length_171_cov_46.430556	0	59	65	2	59	0.0338983
NODE_302697_length_171_cov_46.430556	0	59	67	2	59	0.0338983
NODE_302697_length_171_cov_46.430556	0	59	69	1	59	0.0169492
NODE_302697_length_171_cov_46.430556	0	59	73	1	59	0.0169492
NODE_302697_length_171_cov_46.430556	0	59	75	1	59	0.0169492
NODE_302697_length_171_cov_46.430556	0	59	76	1	59	0.0169492
NODE_302697_length_171_cov_46.430556	0	59	82	1	59	0.0169492
NODE_302697_length_171_cov_46.430556	0	59	90	2	59	0.0338983
NODE_302697_length_171_cov_46.430556	0	59	95	1	59	0.0169492
NODE_302697_length_171_cov_46.430556	0	59	102	1	59	0.0169492
NODE_302697_length_171_cov_46.430556	0	59	116	3	59	0.0508475
NODE_302697_length_171_cov_46.430556	0	59	128	1	59	0.0169492
NODE_302697_length_171_cov_46.430556	0	59	130	1	59	0.0169492
NODE_302697_length_171_cov_46.430556	0	59	138	2	59	0.0338983
NODE_302697_length_171_cov_46.430556	0	59	140	1	59	0.0169492
NODE_302697_length_171_cov_46.430556	0	59	146	2	59	0.0338983
NODE_302697_length_171_cov_46.430556	0	59	150	1	59	0.0169492
NODE_302697_length_171_cov_46.430556	0	59	154	4	59	0.0677966
NODE_302697_length_171_cov_46.430556	0	59	156	10	59	0.1694915
NODE_302697_length_171_cov_46.430556	0	59	160	1	59	0.0169492
NODE_302697_length_171_cov_46.430556	0	59	164	1	59	0.0169492
NODE_302697_length_171_cov_46.430556	0	59	168	1	59	0.0169492
NODE_302697_length_171_cov_46.430556	0	59	170	1	59	0.0169492
NODE_302697_length_171_cov_46.430556	32	98	116	1	66	0.0151515
NODE_302697_length_171_cov_46.430556	32	98	128	1	66	0.0151515
NODE_302697_length_171_cov_46.430556	32	98	130	1	66	0.0151515
NODE_302697_length_171_cov_46.430556	32	98	138	2	66	0.0303030
NODE_302697_length_171_cov_46.430556	32	98	140	1	66	0.0151515
NODE_302697_length_171_cov_46.430556	32	98	146	2	66	0.0303030
NODE_302697_length_171_cov_46.430556	32	98	150	1	66	0.0151515
NODE_302697_length_171_cov_46.430556	32	98	154	4	66	0.0606061
NODE_302697_length_171_cov_46.430556	32	98	156	10	66	0.1515152
NODE_302697_length_171_cov_46.430556	32	98	160	1	66	0.0151515
NODE_302697_length_171_cov_46.430556	32	98	164	1	66	0.0151515
NODE_302697_length_171_cov_46.430556	32	98	168	1	66	0.0151515
NODE_302697_length_171_cov_46.430556	32	98	170	1	66	0.0151515
NODE_302697_length_171_cov_46.430556	32	98	172	5	66	0.0757576
NODE_302697_length_171_cov_46.430556	32	98	176	34	66	0.5151515
NODE_302700_length_171_cov_40.069444	13	87	0	74	74	1.0000000
NODE_302702_length_171_cov_33.319444	84	158	16	21	74	0.2837838
NODE_302702_length_171_cov_33.319444	84	158	18	53	74	0.7162162
NODE_302764_length_170_cov_217.422535	10	90	52	1	80	0.0125000
NODE_302764_length_170_cov_217.422535	10	90	54	2	80	0.0250000
NODE_302764_length_170_cov_217.422535	10	90	63	1	80	0.0125000
NODE_302764_length_170_cov_217.422535	10	90	73	1	80	0.0125000
NODE_302764_length_170_cov_217.422535	10	90	76	1	80	0.0125000
NODE_302764_length_170_cov_217.422535	10	90	79	1	80	0.0125000
NODE_302764_length_170_cov_217.422535	10	90	97	1	80	0.0125000
NODE_302764_length_170_cov_217.422535	10	90	112	1	80	0.0125000
NODE_302764_length_170_cov_217.422535	10	90	118	1	80	0.0125000
NODE_302764_length_170_cov_217.422535	10	90	126	2	80	0.0250000
NODE_302764_length_170_cov_217.422535	10	90	128	1	80	0.0125000
NODE_302764_length_170_cov_217.422535	10	90	133	4	80	0.0500000
NODE_302764_length_170_cov_217.422535	10	90	140	1	80	0.0125000
NODE_302764_length_170_cov_217.422535	10	90	145	1	80	0.0125000
NODE_302764_length_170_cov_217.422535	10	90	148	1	80	0.0125000
NODE_302764_length_170_cov_217.422535	10	90	150	1	80	0.0125000
NODE_302764_length_170_cov_217.422535	10	90	160	1	80	0.0125000
NODE_302764_length_170_cov_217.422535	10	90	170	1	80	0.0125000
NODE_302764_length_170_cov_217.422535	10	90	174	1	80	0.0125000
NODE_302764_length_170_cov_217.422535	10	90	178	1	80	0.0125000
NODE_302764_length_170_cov_217.422535	10	90	189	1	80	0.0125000
NODE_302764_length_170_cov_217.422535	10	90	193	1	80	0.0125000
NODE_302764_length_170_cov_217.422535	10	90	197	1	80	0.0125000
NODE_302764_length_170_cov_217.422535	10	90	203	2	80	0.0250000
NODE_302764_length_170_cov_217.422535	10	90	206	1	80	0.0125000
NODE_302764_length_170_cov_217.422535	10	90	210	2	80	0.0250000
NODE_302764_length_170_cov_217.422535	10	90	213	1	80	0.0125000
NODE_302764_length_170_cov_217.422535	10	90	216	1	80	0.0125000
NODE_302764_length_170_cov_217.422535	10	90	218	1	80	0.0125000
NODE_302764_length_170_cov_217.422535	10	90	224	1	80	0.0125000
NODE_302764_length_170_cov_217.422535	10	90	234	1	80	0.0125000
NODE_302764_length_170_cov_217.422535	10	90	244	1	80	0.0125000
NODE_302764_length_170_cov_217.422535	10	90	253	1	80	0.0125000
NODE_302764_length_170_cov_217.422535	10	90	257	1	80	0.0125000
NODE_302764_length_170_cov_217.422535	10	90	263	1	80	0.0125000
NODE_302764_length_170_cov_217.422535	10	90	267	2	80	0.0250000
NODE_302764_length_170_cov_217.422535	10	90	274	2	80	0.0250000
NODE_302764_length_170_cov_217.422535	10	90	279	1	80	0.0125000
NODE_302764_length_170_cov_217.422535	10	90	289	1	80	0.0125000
NODE_302764_length_170_cov_217.422535	10	90	293	4	80	0.0500000
NODE_302764_length_170_cov_217.422535	10	90	295	1	80	0.0125000
NODE_302764_length_170_cov_217.422535	10	90	298	1	80	0.0125000
NODE_302764_length_170_cov_217.422535	10	90	299	1	80	0.0125000
NODE_302764_length_170_cov_217.422535	10	90	301	3	80	0.0375000
NODE_302764_length_170_cov_217.422535	10	90	303	22	80	0.2750000
NODE_302764_length_170_cov_217.422535	10	90	52	1	80	0.0125000
NODE_302764_length_170_cov_217.422535	10	90	54	2	80	0.0250000
NODE_302764_length_170_cov_217.422535	10	90	63	1	80	0.0125000
NODE_302764_length_170_cov_217.422535	10	90	73	1	80	0.0125000
NODE_302764_length_170_cov_217.422535	10	90	76	1	80	0.0125000
NODE_302764_length_170_cov_217.422535	10	90	79	1	80	0.0125000
NODE_302764_length_170_cov_217.422535	10	90	97	1	80	0.0125000
NODE_302764_length_170_cov_217.422535	10	90	112	1	80	0.0125000
NODE_302764_length_170_cov_217.422535	10	90	118	1	80	0.0125000
NODE_302764_length_170_cov_217.422535	10	90	126	2	80	0.0250000
NODE_302764_length_170_cov_217.422535	10	90	128	1	80	0.0125000
NODE_302764_length_170_cov_217.422535	10	90	133	4	80	0.0500000
NODE_302764_length_170_cov_217.422535	10	90	140	1	80	0.0125000
NODE_302764_length_170_cov_217.422535	10	90	145	1	80	0.0125000
NODE_302764_length_170_cov_217.422535	10	90	148	1	80	0.0125000
NODE_302764_length_170_cov_217.422535	10	90	150	1	80	0.0125000
NODE_302764_length_170_cov_217.422535	10	90	160	1	80	0.0125000
NODE_302764_length_170_cov_217.422535	10	90	170	1	80	0.0125000
NODE_302764_length_170_cov_217.422535	10	90	174	1	80	0.0125000
NODE_302764_length_170_cov_217.422535	10	90	178	1	80	0.0125000
NODE_302764_length_170_cov_217.422535	10	90	189	1	80	0.0125000
NODE_302764_length_170_cov_217.422535	10	90	193	1	80	0.0125000
NODE_302764_length_170_cov_217.422535	10	90	197	1	80	0.0125000
NODE_302764_length_170_cov_217.422535	10	90	203	2	80	0.0250000
NODE_302764_length_170_cov_217.422535	10	90	206	1	80	0.0125000
NODE_302764_length_170_cov_217.422535	10	90	210	2	80	0.0250000
NODE_302764_length_170_cov_217.422535	10	90	213	1	80	0.0125000
NODE_302764_length_170_cov_217.422535	10	90	216	1	80	0.0125000
NODE_302764_length_170_cov_217.422535	10	90	218	1	80	0.0125000
NODE_302764_length_170_cov_217.422535	10	90	224	1	80	0.0125000
NODE_302764_length_170_cov_217.422535	10	90	234	1	80	0.0125000
NODE_302764_length_170_cov_217.422535	10	90	244	1	80	0.0125000
NODE_302764_length_170_cov_217.422535	10	90	253	1	80	0.0125000
NODE_302764_length_170_cov_217.422535	10	90	257	1	80	0.0125000
NODE_302764_length_170_cov_217.422535	10	90	263	1	80	0.0125000
NODE_302764_length_170_cov_217.422535	10	90	267	2	80	0.0250000
NODE_302764_length_170_cov_217.422535	10	90	274	2	80	0.0250000
NODE_302764_length_170_cov_217.422535	10	90	279	1	80	0.0125000
NODE_302764_length_170_cov_217.422535	10	90	289	1	80	0.0125000
NODE_302764_length_170_cov_217.422535	10	90	293	4	80	0.0500000
NODE_302764_length_170_cov_217.422535	10	90	295	1	80	0.0125000
NODE_302764_length_170_cov_217.422535	10	90	298	1	80	0.0125000
NODE_302764_length_170_cov_217.422535	10	90	299	1	80	0.0125000
NODE_302764_length_170_cov_217.422535	10	90	301	3	80	0.0375000
NODE_302764_length_170_cov_217.422535	10	90	303	22	80	0.2750000
NODE_302764_length_170_cov_217.422535	10	90	52	1	80	0.0125000
NODE_302764_length_170_cov_217.422535	10	90	54	2	80	0.0250000
NODE_302764_length_170_cov_217.422535	10	90	63	1	80	0.0125000
NODE_302764_length_170_cov_217.422535	10	90	73	1	80	0.0125000
NODE_302764_length_170_cov_217.422535	10	90	76	1	80	0.0125000
NODE_302764_length_170_cov_217.422535	10	90	79	1	80	0.0125000
NODE_302764_length_170_cov_217.422535	10	90	97	1	80	0.0125000
NODE_302764_length_170_cov_217.422535	10	90	112	1	80	0.0125000
NODE_302764_length_170_cov_217.422535	10	90	118	1	80	0.0125000
NODE_302764_length_170_cov_217.422535	10	90	126	2	80	0.0250000
NODE_302764_length_170_cov_217.422535	10	90	128	1	80	0.0125000
NODE_302764_length_170_cov_217.422535	10	90	133	4	80	0.0500000
NODE_302764_length_170_cov_217.422535	10	90	140	1	80	0.0125000
NODE_302764_length_170_cov_217.422535	10	90	145	1	80	0.0125000
NODE_302764_length_170_cov_217.422535	10	90	148	1	80	0.0125000
NODE_302764_length_170_cov_217.422535	10	90	150	1	80	0.0125000
NODE_302764_length_170_cov_217.422535	10	90	160	1	80	0.0125000
NODE_302764_length_170_cov_217.422535	10	90	170	1	80	0.0125000
NODE_302764_length_170_cov_217.422535	10	90	174	1	80	0.0125000
NODE_302764_length_170_cov_217.422535	10	90	178	1	80	0.0125000
NODE_302764_length_170_cov_217.422535	10	90	189	1	80	0.0125000
NODE_302764_length_170_cov_217.422535	10	90	193	1	80	0.0125000
NODE_302764_length_170_cov_217.422535	10	90	197	1	80	0.0125000
NODE_302764_length_170_cov_217.422535	10	90	203	2	80	0.0250000
NODE_302764_length_170_cov_217.422535	10	90	206	1	80	0.0125000
NODE_302764_length_170_cov_217.422535	10	90	210	2	80	0.0250000
NODE_302764_length_170_cov_217.422535	10	90	213	1	80	0.0125000
NODE_302764_length_170_cov_217.422535	10	90	216	1	80	0.0125000
NODE_302764_length_170_cov_217.422535	10	90	218	1	80	0.0125000
NODE_302764_length_170_cov_217.422535	10	90	224	1	80	0.0125000
NODE_302764_length_170_cov_217.422535	10	90	234	1	80	0.0125000
NODE_302764_length_170_cov_217.422535	10	90	244	1	80	0.0125000
NODE_302764_length_170_cov_217.422535	10	90	253	1	80	0.0125000
NODE_302764_length_170_cov_217.422535	10	90	257	1	80	0.0125000
NODE_302764_length_170_cov_217.422535	10	90	263	1	80	0.0125000
NODE_302764_length_170_cov_217.422535	10	90	267	2	80	0.0250000
NODE_302764_length_170_cov_217.422535	10	90	274	2	80	0.0250000
NODE_302764_length_170_cov_217.422535	10	90	279	1	80	0.0125000
NODE_302764_length_170_cov_217.422535	10	90	289	1	80	0.0125000
NODE_302764_length_170_cov_217.422535	10	90	293	4	80	0.0500000
NODE_302764_length_170_cov_217.422535	10	90	295	1	80	0.0125000
NODE_302764_length_170_cov_217.422535	10	90	298	1	80	0.0125000
NODE_302764_length_170_cov_217.422535	10	90	299	1	80	0.0125000
NODE_302764_length_170_cov_217.422535	10	90	301	3	80	0.0375000
NODE_302764_length_170_cov_217.422535	10	90	303	22	80	0.2750000
NODE_302764_length_170_cov_217.422535	10	90	52	1	80	0.0125000
NODE_302764_length_170_cov_217.422535	10	90	54	2	80	0.0250000
NODE_302764_length_170_cov_217.422535	10	90	63	1	80	0.0125000
NODE_302764_length_170_cov_217.422535	10	90	73	1	80	0.0125000
NODE_302764_length_170_cov_217.422535	10	90	76	1	80	0.0125000
NODE_302764_length_170_cov_217.422535	10	90	79	1	80	0.0125000
NODE_302764_length_170_cov_217.422535	10	90	97	1	80	0.0125000
NODE_302764_length_170_cov_217.422535	10	90	112	1	80	0.0125000
NODE_302764_length_170_cov_217.422535	10	90	118	1	80	0.0125000
NODE_302764_length_170_cov_217.422535	10	90	126	2	80	0.0250000
NODE_302764_length_170_cov_217.422535	10	90	128	1	80	0.0125000
NODE_302764_length_170_cov_217.422535	10	90	133	4	80	0.0500000
NODE_302764_length_170_cov_217.422535	10	90	140	1	80	0.0125000
NODE_302764_length_170_cov_217.422535	10	90	145	1	80	0.0125000
NODE_302764_length_170_cov_217.422535	10	90	148	1	80	0.0125000
NODE_302764_length_170_cov_217.422535	10	90	150	1	80	0.0125000
NODE_302764_length_170_cov_217.422535	10	90	160	1	80	0.0125000
NODE_302764_length_170_cov_217.422535	10	90	170	1	80	0.0125000
NODE_302764_length_170_cov_217.422535	10	90	174	1	80	0.0125000
NODE_302764_length_170_cov_217.422535	10	90	178	1	80	0.0125000
NODE_302764_length_170_cov_217.422535	10	90	189	1	80	0.0125000
NODE_302764_length_170_cov_217.422535	10	90	193	1	80	0.0125000
NODE_302764_length_170_cov_217.422535	10	90	197	1	80	0.0125000
NODE_302764_length_170_cov_217.422535	10	90	203	2	80	0.0250000
NODE_302764_length_170_cov_217.422535	10	90	206	1	80	0.0125000
NODE_302764_length_170_cov_217.422535	10	90	210	2	80	0.0250000
NODE_302764_length_170_cov_217.422535	10	90	213	1	80	0.0125000
NODE_302764_length_170_cov_217.422535	10	90	216	1	80	0.0125000
NODE_302764_length_170_cov_217.422535	10	90	218	1	80	0.0125000
NODE_302764_length_170_cov_217.422535	10	90	224	1	80	0.0125000
NODE_302764_length_170_cov_217.422535	10	90	234	1	80	0.0125000
NODE_302764_length_170_cov_217.422535	10	90	244	1	80	0.0125000
NODE_302764_length_170_cov_217.422535	10	90	253	1	80	0.0125000
NODE_302764_length_170_cov_217.422535	10	90	257	1	80	0.0125000
NODE_302764_length_170_cov_217.422535	10	90	263	1	80	0.0125000
NODE_302764_length_170_cov_217.422535	10	90	267	2	80	0.0250000
NODE_302764_length_170_cov_217.422535	10	90	274	2	80	0.0250000
NODE_302764_length_170_cov_217.422535	10	90	279	1	80	0.0125000
NODE_302764_length_170_cov_217.422535	10	90	289	1	80	0.0125000
NODE_302764_length_170_cov_217.422535	10	90	293	4	80	0.0500000
NODE_302764_length_170_cov_217.422535	10	90	295	1	80	0.0125000
NODE_302764_length_170_cov_217.422535	10	90	298	1	80	0.0125000
NODE_302764_length_170_cov_217.422535	10	90	299	1	80	0.0125000
NODE_302764_length_170_cov_217.422535	10	90	301	3	80	0.0375000
NODE_302764_length_170_cov_217.422535	10	90	303	22	80	0.2750000
NODE_302764_length_170_cov_217.422535	10	90	52	1	80	0.0125000
NODE_302764_length_170_cov_217.422535	10	90	54	2	80	0.0250000
NODE_302764_length_170_cov_217.422535	10	90	63	1	80	0.0125000
NODE_302764_length_170_cov_217.422535	10	90	73	1	80	0.0125000
NODE_302764_length_170_cov_217.422535	10	90	76	1	80	0.0125000
NODE_302764_length_170_cov_217.422535	10	90	79	1	80	0.0125000
NODE_302764_length_170_cov_217.422535	10	90	97	1	80	0.0125000
NODE_302764_length_170_cov_217.422535	10	90	112	1	80	0.0125000
NODE_302764_length_170_cov_217.422535	10	90	118	1	80	0.0125000
NODE_302764_length_170_cov_217.422535	10	90	126	2	80	0.0250000
NODE_302764_length_170_cov_217.422535	10	90	128	1	80	0.0125000
NODE_302764_length_170_cov_217.422535	10	90	133	4	80	0.0500000
NODE_302764_length_170_cov_217.422535	10	90	140	1	80	0.0125000
NODE_302764_length_170_cov_217.422535	10	90	145	1	80	0.0125000
NODE_302764_length_170_cov_217.422535	10	90	148	1	80	0.0125000
NODE_302764_length_170_cov_217.422535	10	90	150	1	80	0.0125000
NODE_302764_length_170_cov_217.422535	10	90	160	1	80	0.0125000
NODE_302764_length_170_cov_217.422535	10	90	170	1	80	0.0125000
NODE_302764_length_170_cov_217.422535	10	90	174	1	80	0.0125000
NODE_302764_length_170_cov_217.422535	10	90	178	1	80	0.0125000
NODE_302764_length_170_cov_217.422535	10	90	189	1	80	0.0125000
NODE_302764_length_170_cov_217.422535	10	90	193	1	80	0.0125000
NODE_302764_length_170_cov_217.422535	10	90	197	1	80	0.0125000
NODE_302764_length_170_cov_217.422535	10	90	203	2	80	0.0250000
NODE_302764_length_170_cov_217.422535	10	90	206	1	80	0.0125000
NODE_302764_length_170_cov_217.422535	10	90	210	2	80	0.0250000
NODE_302764_length_170_cov_217.422535	10	90	213	1	80	0.0125000
NODE_302764_length_170_cov_217.422535	10	90	216	1	80	0.0125000
NODE_302764_length_170_cov_217.422535	10	90	218	1	80	0.0125000
NODE_302764_length_170_cov_217.422535	10	90	224	1	80	0.0125000
NODE_302764_length_170_cov_217.422535	10	90	234	1	80	0.0125000
NODE_302764_length_170_cov_217.422535	10	90	244	1	80	0.0125000
NODE_302764_length_170_cov_217.422535	10	90	253	1	80	0.0125000
NODE_302764_length_170_cov_217.422535	10	90	257	1	80	0.0125000
NODE_302764_length_170_cov_217.422535	10	90	263	1	80	0.0125000
NODE_302764_length_170_cov_217.422535	10	90	267	2	80	0.0250000
NODE_302764_length_170_cov_217.422535	10	90	274	2	80	0.0250000
NODE_302764_length_170_cov_217.422535	10	90	279	1	80	0.0125000
NODE_302764_length_170_cov_217.422535	10	90	289	1	80	0.0125000
NODE_302764_length_170_cov_217.422535	10	90	293	4	80	0.0500000
NODE_302764_length_170_cov_217.422535	10	90	295	1	80	0.0125000
NODE_302764_length_170_cov_217.422535	10	90	298	1	80	0.0125000
NODE_302764_length_170_cov_217.422535	10	90	299	1	80	0.0125000
NODE_302764_length_170_cov_217.422535	10	90	301	3	80	0.0375000
NODE_302764_length_170_cov_217.422535	10	90	303	22	80	0.2750000
NODE_302764_length_170_cov_217.422535	19	90	118	1	71	0.0140845
NODE_302764_length_170_cov_217.422535	19	90	126	2	71	0.0281690
NODE_302764_length_170_cov_217.422535	19	90	128	1	71	0.0140845
NODE_302764_length_170_cov_217.422535	19	90	133	4	71	0.0563380
NODE_302764_length_170_cov_217.422535	19	90	140	1	71	0.0140845
NODE_302764_length_170_cov_217.422535	19	90	145	1	71	0.0140845
NODE_302764_length_170_cov_217.422535	19	90	148	1	71	0.0140845
NODE_302764_length_170_cov_217.422535	19	90	150	1	71	0.0140845
NODE_302764_length_170_cov_217.422535	19	90	160	1	71	0.0140845
NODE_302764_length_170_cov_217.422535	19	90	170	1	71	0.0140845
NODE_302764_length_170_cov_217.422535	19	90	174	1	71	0.0140845
NODE_302764_length_170_cov_217.422535	19	90	178	1	71	0.0140845
NODE_302764_length_170_cov_217.422535	19	90	189	1	71	0.0140845
NODE_302764_length_170_cov_217.422535	19	90	193	1	71	0.0140845
NODE_302764_length_170_cov_217.422535	19	90	197	1	71	0.0140845
NODE_302764_length_170_cov_217.422535	19	90	203	2	71	0.0281690
NODE_302764_length_170_cov_217.422535	19	90	206	1	71	0.0140845
NODE_302764_length_170_cov_217.422535	19	90	210	2	71	0.0281690
NODE_302764_length_170_cov_217.422535	19	90	213	1	71	0.0140845
NODE_302764_length_170_cov_217.422535	19	90	216	1	71	0.0140845
NODE_302764_length_170_cov_217.422535	19	90	218	1	71	0.0140845
NODE_302764_length_170_cov_217.422535	19	90	224	1	71	0.0140845
NODE_302764_length_170_cov_217.422535	19	90	234	1	71	0.0140845
NODE_302764_length_170_cov_217.422535	19	90	244	1	71	0.0140845
NODE_302764_length_170_cov_217.422535	19	90	253	1	71	0.0140845
NODE_302764_length_170_cov_217.422535	19	90	257	1	71	0.0140845
NODE_302764_length_170_cov_217.422535	19	90	263	1	71	0.0140845
NODE_302764_length_170_cov_217.422535	19	90	267	2	71	0.0281690
NODE_302764_length_170_cov_217.422535	19	90	274	2	71	0.0281690
NODE_302764_length_170_cov_217.422535	19	90	279	1	71	0.0140845
NODE_302764_length_170_cov_217.422535	19	90	289	1	71	0.0140845
NODE_302764_length_170_cov_217.422535	19	90	293	4	71	0.0563380
NODE_302764_length_170_cov_217.422535	19	90	295	1	71	0.0140845
NODE_302764_length_170_cov_217.422535	19	90	298	1	71	0.0140845
NODE_302764_length_170_cov_217.422535	19	90	299	1	71	0.0140845
NODE_302764_length_170_cov_217.422535	19	90	301	3	71	0.0422535
NODE_302764_length_170_cov_217.422535	19	90	303	22	71	0.3098592
NODE_302764_length_170_cov_217.422535	63	126	281	1	63	0.0158730
NODE_302764_length_170_cov_217.422535	63	126	283	1	63	0.0158730
NODE_302764_length_170_cov_217.422535	63	126	284	4	63	0.0634921
NODE_302764_length_170_cov_217.422535	63	126	293	5	63	0.0793651
NODE_302764_length_170_cov_217.422535	63	126	295	3	63	0.0476190
NODE_302764_length_170_cov_217.422535	63	126	298	1	63	0.0158730
NODE_302764_length_170_cov_217.422535	63	126	299	8	63	0.1269841
NODE_302764_length_170_cov_217.422535	63	126	301	5	63	0.0793651
NODE_302764_length_170_cov_217.422535	63	126	303	35	63	0.5555556
NODE_302764_length_170_cov_217.422535	63	126	281	1	63	0.0158730
NODE_302764_length_170_cov_217.422535	63	126	283	1	63	0.0158730
NODE_302764_length_170_cov_217.422535	63	126	284	4	63	0.0634921
NODE_302764_length_170_cov_217.422535	63	126	293	5	63	0.0793651
NODE_302764_length_170_cov_217.422535	63	126	295	3	63	0.0476190
NODE_302764_length_170_cov_217.422535	63	126	298	1	63	0.0158730
NODE_302764_length_170_cov_217.422535	63	126	299	8	63	0.1269841
NODE_302764_length_170_cov_217.422535	63	126	301	5	63	0.0793651
NODE_302764_length_170_cov_217.422535	63	126	303	35	63	0.5555556
NODE_302768_length_170_cov_102.816901	23	86	83	1	63	0.0158730
NODE_302768_length_170_cov_102.816901	23	86	93	1	63	0.0158730
NODE_302768_length_170_cov_102.816901	23	86	97	1	63	0.0158730
NODE_302768_length_170_cov_102.816901	23	86	99	4	63	0.0634921
NODE_302768_length_170_cov_102.816901	23	86	103	1	63	0.0158730
NODE_302768_length_170_cov_102.816901	23	86	107	1	63	0.0158730
NODE_302768_length_170_cov_102.816901	23	86	109	2	63	0.0317460
NODE_302768_length_170_cov_102.816901	23	86	111	14	63	0.2222222
NODE_302768_length_170_cov_102.816901	23	86	117	5	63	0.0793651
NODE_302768_length_170_cov_102.816901	23	86	119	10	63	0.1587302
NODE_302768_length_170_cov_102.816901	23	86	121	3	63	0.0476190
NODE_302768_length_170_cov_102.816901	23	86	125	3	63	0.0476190
NODE_302768_length_170_cov_102.816901	23	86	126	17	63	0.2698413
NODE_302806_length_169_cov_47.757143	70	150	45	2	80	0.0250000
NODE_302806_length_169_cov_47.757143	70	150	55	1	80	0.0125000
NODE_302806_length_169_cov_47.757143	70	150	62	1	80	0.0125000
NODE_302806_length_169_cov_47.757143	70	150	64	7	80	0.0875000
NODE_302806_length_169_cov_47.757143	70	150	71	4	80	0.0500000
NODE_302806_length_169_cov_47.757143	70	150	73	8	80	0.1000000
NODE_302806_length_169_cov_47.757143	70	150	74	3	80	0.0375000
NODE_302806_length_169_cov_47.757143	70	150	78	54	80	0.6750000
NODE_302869_length_168_cov_10.391304	66	99	0	33	33	1.0000000
NODE_302869_length_168_cov_10.391304	135	168	0	33	33	1.0000000
NODE_302966_length_166_cov_401.149254	31	109	143	2	78	0.0256410
NODE_302966_length_166_cov_401.149254	31	109	147	1	78	0.0128205
NODE_302966_length_166_cov_401.149254	31	109	162	1	78	0.0128205
NODE_302966_length_166_cov_401.149254	31	109	164	1	78	0.0128205
NODE_302966_length_166_cov_401.149254	31	109	166	1	78	0.0128205
NODE_302966_length_166_cov_401.149254	31	109	176	1	78	0.0128205
NODE_302966_length_166_cov_401.149254	31	109	178	1	78	0.0128205
NODE_302966_length_166_cov_401.149254	31	109	184	2	78	0.0256410
NODE_302966_length_166_cov_401.149254	31	109	191	1	78	0.0128205
NODE_302966_length_166_cov_401.149254	31	109	194	1	78	0.0128205
NODE_302966_length_166_cov_401.149254	31	109	202	1	78	0.0128205
NODE_302966_length_166_cov_401.149254	31	109	208	1	78	0.0128205
NODE_302966_length_166_cov_401.149254	31	109	220	1	78	0.0128205
NODE_302966_length_166_cov_401.149254	31	109	230	2	78	0.0256410
NODE_302966_length_166_cov_401.149254	31	109	242	1	78	0.0128205
NODE_302966_length_166_cov_401.149254	31	109	252	1	78	0.0128205
NODE_302966_length_166_cov_401.149254	31	109	254	1	78	0.0128205
NODE_302966_length_166_cov_401.149254	31	109	260	2	78	0.0256410
NODE_302966_length_166_cov_401.149254	31	109	262	3	78	0.0384615
NODE_302966_length_166_cov_401.149254	31	109	268	1	78	0.0128205
NODE_302966_length_166_cov_401.149254	31	109	270	3	78	0.0384615
NODE_302966_length_166_cov_401.149254	31	109	272	2	78	0.0256410
NODE_302966_length_166_cov_401.149254	31	109	276	1	78	0.0128205
NODE_302966_length_166_cov_401.149254	31	109	277	1	78	0.0128205
NODE_302966_length_166_cov_401.149254	31	109	278	2	78	0.0256410
NODE_302966_length_166_cov_401.149254	31	109	282	2	78	0.0256410
NODE_302966_length_166_cov_401.149254	31	109	284	10	78	0.1282051
NODE_302966_length_166_cov_401.149254	31	109	285	31	78	0.3974359
NODE_302966_length_166_cov_401.149254	82	157	66	1	75	0.0133333
NODE_302966_length_166_cov_401.149254	82	157	73	1	75	0.0133333
NODE_302966_length_166_cov_401.149254	82	157	79	2	75	0.0266667
NODE_302966_length_166_cov_401.149254	82	157	81	3	75	0.0400000
NODE_302966_length_166_cov_401.149254	82	157	90	1	75	0.0133333
NODE_302966_length_166_cov_401.149254	82	157	93	1	75	0.0133333
NODE_302966_length_166_cov_401.149254	82	157	95	1	75	0.0133333
NODE_302966_length_166_cov_401.149254	82	157	114	1	75	0.0133333
NODE_302966_length_166_cov_401.149254	82	157	122	1	75	0.0133333
NODE_302966_length_166_cov_401.149254	82	157	128	1	75	0.0133333
NODE_302966_length_166_cov_401.149254	82	157	139	1	75	0.0133333
NODE_302966_length_166_cov_401.149254	82	157	143	1	75	0.0133333
NODE_302966_length_166_cov_401.149254	82	157	151	1	75	0.0133333
NODE_302966_length_166_cov_401.149254	82	157	159	1	75	0.0133333
NODE_302966_length_166_cov_401.149254	82	157	165	2	75	0.0266667
NODE_302966_length_166_cov_401.149254	82	157	171	1	75	0.0133333
NODE_302966_length_166_cov_401.149254	82	157	178	1	75	0.0133333
NODE_302966_length_166_cov_401.149254	82	157	182	1	75	0.0133333
NODE_302966_length_166_cov_401.149254	82	157	186	1	75	0.0133333
NODE_302966_length_166_cov_401.149254	82	157	187	2	75	0.0266667
NODE_302966_length_166_cov_401.149254	82	157	195	2	75	0.0266667
NODE_302966_length_166_cov_401.149254	82	157	199	4	75	0.0533333
NODE_302966_length_166_cov_401.149254	82	157	205	2	75	0.0266667
NODE_302966_length_166_cov_401.149254	82	157	206	1	75	0.0133333
NODE_302966_length_166_cov_401.149254	82	157	210	1	75	0.0133333
NODE_302966_length_166_cov_401.149254	82	157	214	1	75	0.0133333
NODE_302966_length_166_cov_401.149254	82	157	215	1	75	0.0133333
NODE_302966_length_166_cov_401.149254	82	157	219	1	75	0.0133333
NODE_302966_length_166_cov_401.149254	82	157	226	1	75	0.0133333
NODE_302966_length_166_cov_401.149254	82	157	228	1	75	0.0133333
NODE_302966_length_166_cov_401.149254	82	157	240	2	75	0.0266667
NODE_302966_length_166_cov_401.149254	82	157	244	1	75	0.0133333
NODE_302966_length_166_cov_401.149254	82	157	246	1	75	0.0133333
NODE_302966_length_166_cov_401.149254	82	157	250	1	75	0.0133333
NODE_302966_length_166_cov_401.149254	82	157	252	2	75	0.0266667
NODE_302966_length_166_cov_401.149254	82	157	266	1	75	0.0133333
NODE_302966_length_166_cov_401.149254	82	157	270	3	75	0.0400000
NODE_302966_length_166_cov_401.149254	82	157	278	2	75	0.0266667
NODE_302966_length_166_cov_401.149254	82	157	282	2	75	0.0266667
NODE_302966_length_166_cov_401.149254	82	157	284	10	75	0.1333333
NODE_302966_length_166_cov_401.149254	82	157	285	10	75	0.1333333
NODE_302974_length_166_cov_123.223881	46	97	14	3	51	0.0588235
NODE_302974_length_166_cov_123.223881	46	97	16	4	51	0.0784314
NODE_302974_length_166_cov_123.223881	46	97	18	9	51	0.1764706
NODE_302974_length_166_cov_123.223881	46	97	20	35	51	0.6862745
NODE_303071_length_164_cov_154.076923	0	75	0	57	75	0.7600000
NODE_303071_length_164_cov_154.076923	0	75	4	18	75	0.2400000
NODE_303071_length_164_cov_154.076923	48	128	0	9	80	0.1125000
NODE_303071_length_164_cov_154.076923	48	128	4	71	80	0.8875000
NODE_303074_length_164_cov_69.369231	0	64	2	6	64	0.0937500
NODE_303074_length_164_cov_69.369231	0	64	4	26	64	0.4062500
NODE_303074_length_164_cov_69.369231	0	64	6	32	64	0.5000000
NODE_303079_length_164_cov_43.923077	36	100	125	1	64	0.0156250
NODE_303079_length_164_cov_43.923077	36	100	129	11	64	0.1718750
NODE_303079_length_164_cov_43.923077	36	100	139	2	64	0.0312500
NODE_303079_length_164_cov_43.923077	36	100	141	4	64	0.0625000
NODE_303079_length_164_cov_43.923077	36	100	143	2	64	0.0312500
NODE_303079_length_164_cov_43.923077	36	100	145	2	64	0.0312500
NODE_303079_length_164_cov_43.923077	36	100	148	20	64	0.3125000
NODE_303079_length_164_cov_43.923077	36	100	149	22	64	0.3437500
NODE_303079_length_164_cov_43.923077	36	100	125	1	64	0.0156250
NODE_303079_length_164_cov_43.923077	36	100	129	11	64	0.1718750
NODE_303079_length_164_cov_43.923077	36	100	139	2	64	0.0312500
NODE_303079_length_164_cov_43.923077	36	100	141	4	64	0.0625000
NODE_303079_length_164_cov_43.923077	36	100	143	2	64	0.0312500
NODE_303079_length_164_cov_43.923077	36	100	145	2	64	0.0312500
NODE_303079_length_164_cov_43.923077	36	100	148	20	64	0.3125000
NODE_303079_length_164_cov_43.923077	36	100	149	22	64	0.3437500
NODE_303079_length_164_cov_43.923077	73	153	71	1	80	0.0125000
NODE_303079_length_164_cov_43.923077	73	153	80	3	80	0.0375000
NODE_303079_length_164_cov_43.923077	73	153	92	1	80	0.0125000
NODE_303079_length_164_cov_43.923077	73	153	93	1	80	0.0125000
NODE_303079_length_164_cov_43.923077	73	153	94	2	80	0.0250000
NODE_303079_length_164_cov_43.923077	73	153	102	3	80	0.0375000
NODE_303079_length_164_cov_43.923077	73	153	106	5	80	0.0625000
NODE_303079_length_164_cov_43.923077	73	153	114	5	80	0.0625000
NODE_303079_length_164_cov_43.923077	73	153	118	4	80	0.0500000
NODE_303079_length_164_cov_43.923077	73	153	120	3	80	0.0375000
NODE_303079_length_164_cov_43.923077	73	153	126	7	80	0.0875000
NODE_303079_length_164_cov_43.923077	73	153	132	2	80	0.0250000
NODE_303079_length_164_cov_43.923077	73	153	134	5	80	0.0625000
NODE_303079_length_164_cov_43.923077	73	153	138	2	80	0.0250000
NODE_303079_length_164_cov_43.923077	73	153	142	4	80	0.0500000
NODE_303079_length_164_cov_43.923077	73	153	148	25	80	0.3125000
NODE_303079_length_164_cov_43.923077	73	153	149	7	80	0.0875000
NODE_303079_length_164_cov_43.923077	73	153	71	1	80	0.0125000
NODE_303079_length_164_cov_43.923077	73	153	80	3	80	0.0375000
NODE_303079_length_164_cov_43.923077	73	153	92	1	80	0.0125000
NODE_303079_length_164_cov_43.923077	73	153	93	1	80	0.0125000
NODE_303079_length_164_cov_43.923077	73	153	94	2	80	0.0250000
NODE_303079_length_164_cov_43.923077	73	153	102	3	80	0.0375000
NODE_303079_length_164_cov_43.923077	73	153	106	5	80	0.0625000
NODE_303079_length_164_cov_43.923077	73	153	114	5	80	0.0625000
NODE_303079_length_164_cov_43.923077	73	153	118	4	80	0.0500000
NODE_303079_length_164_cov_43.923077	73	153	120	3	80	0.0375000
NODE_303079_length_164_cov_43.923077	73	153	126	7	80	0.0875000
NODE_303079_length_164_cov_43.923077	73	153	132	2	80	0.0250000
NODE_303079_length_164_cov_43.923077	73	153	134	5	80	0.0625000
NODE_303079_length_164_cov_43.923077	73	153	138	2	80	0.0250000
NODE_303079_length_164_cov_43.923077	73	153	142	4	80	0.0500000
NODE_303079_length_164_cov_43.923077	73	153	148	25	80	0.3125000
NODE_303079_length_164_cov_43.923077	73	153	149	7	80	0.0875000
NODE_303079_length_164_cov_43.923077	73	153	71	1	80	0.0125000
NODE_303079_length_164_cov_43.923077	73	153	80	3	80	0.0375000
NODE_303079_length_164_cov_43.923077	73	153	92	1	80	0.0125000
NODE_303079_length_164_cov_43.923077	73	153	93	1	80	0.0125000
NODE_303079_length_164_cov_43.923077	73	153	94	2	80	0.0250000
NODE_303079_length_164_cov_43.923077	73	153	102	3	80	0.0375000
NODE_303079_length_164_cov_43.923077	73	153	106	5	80	0.0625000
NODE_303079_length_164_cov_43.923077	73	153	114	5	80	0.0625000
NODE_303079_length_164_cov_43.923077	73	153	118	4	80	0.0500000
NODE_303079_length_164_cov_43.923077	73	153	120	3	80	0.0375000
NODE_303079_length_164_cov_43.923077	73	153	126	7	80	0.0875000
NODE_303079_length_164_cov_43.923077	73	153	132	2	80	0.0250000
NODE_303079_length_164_cov_43.923077	73	153	134	5	80	0.0625000
NODE_303079_length_164_cov_43.923077	73	153	138	2	80	0.0250000
NODE_303079_length_164_cov_43.923077	73	153	142	4	80	0.0500000
NODE_303079_length_164_cov_43.923077	73	153	148	25	80	0.3125000
NODE_303079_length_164_cov_43.923077	73	153	149	7	80	0.0875000
NODE_303079_length_164_cov_43.923077	73	153	71	1	80	0.0125000
NODE_303079_length_164_cov_43.923077	73	153	80	3	80	0.0375000
NODE_303079_length_164_cov_43.923077	73	153	92	1	80	0.0125000
NODE_303079_length_164_cov_43.923077	73	153	93	1	80	0.0125000
NODE_303079_length_164_cov_43.923077	73	153	94	2	80	0.0250000
NODE_303079_length_164_cov_43.923077	73	153	102	3	80	0.0375000
NODE_303079_length_164_cov_43.923077	73	153	106	5	80	0.0625000
NODE_303079_length_164_cov_43.923077	73	153	114	5	80	0.0625000
NODE_303079_length_164_cov_43.923077	73	153	118	4	80	0.0500000
NODE_303079_length_164_cov_43.923077	73	153	120	3	80	0.0375000
NODE_303079_length_164_cov_43.923077	73	153	126	7	80	0.0875000
NODE_303079_length_164_cov_43.923077	73	153	132	2	80	0.0250000
NODE_303079_length_164_cov_43.923077	73	153	134	5	80	0.0625000
NODE_303079_length_164_cov_43.923077	73	153	138	2	80	0.0250000
NODE_303079_length_164_cov_43.923077	73	153	142	4	80	0.0500000
NODE_303079_length_164_cov_43.923077	73	153	148	25	80	0.3125000
NODE_303079_length_164_cov_43.923077	73	153	149	7	80	0.0875000
NODE_303079_length_164_cov_43.923077	73	153	71	1	80	0.0125000
NODE_303079_length_164_cov_43.923077	73	153	80	3	80	0.0375000
NODE_303079_length_164_cov_43.923077	73	153	92	1	80	0.0125000
NODE_303079_length_164_cov_43.923077	73	153	93	1	80	0.0125000
NODE_303079_length_164_cov_43.923077	73	153	94	2	80	0.0250000
NODE_303079_length_164_cov_43.923077	73	153	102	3	80	0.0375000
NODE_303079_length_164_cov_43.923077	73	153	106	5	80	0.0625000
NODE_303079_length_164_cov_43.923077	73	153	114	5	80	0.0625000
NODE_303079_length_164_cov_43.923077	73	153	118	4	80	0.0500000
NODE_303079_length_164_cov_43.923077	73	153	120	3	80	0.0375000
NODE_303079_length_164_cov_43.923077	73	153	126	7	80	0.0875000
NODE_303079_length_164_cov_43.923077	73	153	132	2	80	0.0250000
NODE_303079_length_164_cov_43.923077	73	153	134	5	80	0.0625000
NODE_303079_length_164_cov_43.923077	73	153	138	2	80	0.0250000
NODE_303079_length_164_cov_43.923077	73	153	142	4	80	0.0500000
NODE_303079_length_164_cov_43.923077	73	153	148	25	80	0.3125000
NODE_303079_length_164_cov_43.923077	73	153	149	7	80	0.0875000
NODE_303079_length_164_cov_43.923077	73	144	102	2	71	0.0281690
NODE_303079_length_164_cov_43.923077	73	144	106	5	71	0.0704225
NODE_303079_length_164_cov_43.923077	73	144	114	5	71	0.0704225
NODE_303079_length_164_cov_43.923077	73	144	118	4	71	0.0563380
NODE_303079_length_164_cov_43.923077	73	144	120	3	71	0.0422535
NODE_303079_length_164_cov_43.923077	73	144	126	7	71	0.0985916
NODE_303079_length_164_cov_43.923077	73	144	132	2	71	0.0281690
NODE_303079_length_164_cov_43.923077	73	144	134	5	71	0.0704225
NODE_303079_length_164_cov_43.923077	73	144	138	2	71	0.0281690
NODE_303079_length_164_cov_43.923077	73	144	142	4	71	0.0563380
NODE_303079_length_164_cov_43.923077	73	144	148	25	71	0.3521127
NODE_303079_length_164_cov_43.923077	73	144	149	7	71	0.0985916
NODE_303135_length_163_cov_480.593750	0	40	13	1	40	0.0250000
NODE_303135_length_163_cov_480.593750	0	40	18	2	40	0.0500000
NODE_303135_length_163_cov_480.593750	0	40	28	4	40	0.1000000
NODE_303135_length_163_cov_480.593750	0	40	30	1	40	0.0250000
NODE_303135_length_163_cov_480.593750	0	40	36	3	40	0.0750000
NODE_303135_length_163_cov_480.593750	0	40	46	3	40	0.0750000
NODE_303135_length_163_cov_480.593750	0	40	50	1	40	0.0250000
NODE_303135_length_163_cov_480.593750	0	40	54	4	40	0.1000000
NODE_303135_length_163_cov_480.593750	0	40	58	3	40	0.0750000
NODE_303135_length_163_cov_480.593750	0	40	62	3	40	0.0750000
NODE_303135_length_163_cov_480.593750	0	40	64	1	40	0.0250000
NODE_303135_length_163_cov_480.593750	0	40	66	2	40	0.0500000
NODE_303135_length_163_cov_480.593750	0	40	68	4	40	0.1000000
NODE_303135_length_163_cov_480.593750	0	40	76	1	40	0.0250000
NODE_303135_length_163_cov_480.593750	0	40	82	1	40	0.0250000
NODE_303135_length_163_cov_480.593750	0	40	84	3	40	0.0750000
NODE_303135_length_163_cov_480.593750	0	40	88	3	40	0.0750000
NODE_303136_length_163_cov_368.000000	24	96	28	1	72	0.0138889
NODE_303136_length_163_cov_368.000000	24	96	34	2	72	0.0277778
NODE_303136_length_163_cov_368.000000	24	96	40	6	72	0.0833333
NODE_303136_length_163_cov_368.000000	24	96	42	9	72	0.1250000
NODE_303136_length_163_cov_368.000000	24	96	44	54	72	0.7500000
NODE_303138_length_163_cov_319.843750	0	68	6	1	68	0.0147059
NODE_303138_length_163_cov_319.843750	0	68	7	2	68	0.0294118
NODE_303138_length_163_cov_319.843750	0	68	12	2	68	0.0294118
NODE_303138_length_163_cov_319.843750	0	68	14	3	68	0.0441176
NODE_303138_length_163_cov_319.843750	0	68	17	1	68	0.0147059
NODE_303138_length_163_cov_319.843750	0	68	19	1	68	0.0147059
NODE_303138_length_163_cov_319.843750	0	68	25	2	68	0.0294118
NODE_303138_length_163_cov_319.843750	0	68	31	1	68	0.0147059
NODE_303138_length_163_cov_319.843750	0	68	35	5	68	0.0735294
NODE_303138_length_163_cov_319.843750	0	68	37	1	68	0.0147059
NODE_303138_length_163_cov_319.843750	0	68	39	7	68	0.1029412
NODE_303138_length_163_cov_319.843750	0	68	42	3	68	0.0441176
NODE_303138_length_163_cov_319.843750	0	68	44	4	68	0.0588235
NODE_303138_length_163_cov_319.843750	0	68	46	21	68	0.3088235
NODE_303138_length_163_cov_319.843750	0	68	48	1	68	0.0147059
NODE_303138_length_163_cov_319.843750	0	68	49	1	68	0.0147059
NODE_303138_length_163_cov_319.843750	0	68	50	12	68	0.1764706
NODE_303139_length_163_cov_198.078125	34	109	76	1	75	0.0133333
NODE_303139_length_163_cov_198.078125	34	109	80	1	75	0.0133333
NODE_303139_length_163_cov_198.078125	34	109	86	1	75	0.0133333
NODE_303139_length_163_cov_198.078125	34	109	108	1	75	0.0133333
NODE_303139_length_163_cov_198.078125	34	109	112	3	75	0.0400000
NODE_303139_length_163_cov_198.078125	34	109	125	4	75	0.0533333
NODE_303139_length_163_cov_198.078125	34	109	131	2	75	0.0266667
NODE_303139_length_163_cov_198.078125	34	109	133	7	75	0.0933333
NODE_303139_length_163_cov_198.078125	34	109	137	6	75	0.0800000
NODE_303139_length_163_cov_198.078125	34	109	141	1	75	0.0133333
NODE_303139_length_163_cov_198.078125	34	109	143	2	75	0.0266667
NODE_303139_length_163_cov_198.078125	34	109	145	3	75	0.0400000
NODE_303139_length_163_cov_198.078125	34	109	146	43	75	0.5733333
NODE_303139_length_163_cov_198.078125	34	114	76	1	80	0.0125000
NODE_303139_length_163_cov_198.078125	34	114	80	1	80	0.0125000
NODE_303139_length_163_cov_198.078125	34	114	86	1	80	0.0125000
NODE_303139_length_163_cov_198.078125	34	114	108	1	80	0.0125000
NODE_303139_length_163_cov_198.078125	34	114	112	3	80	0.0375000
NODE_303139_length_163_cov_198.078125	34	114	125	4	80	0.0500000
NODE_303139_length_163_cov_198.078125	34	114	131	2	80	0.0250000
NODE_303139_length_163_cov_198.078125	34	114	133	7	80	0.0875000
NODE_303139_length_163_cov_198.078125	34	114	137	6	80	0.0750000
NODE_303139_length_163_cov_198.078125	34	114	139	5	80	0.0625000
NODE_303139_length_163_cov_198.078125	34	114	141	1	80	0.0125000
NODE_303139_length_163_cov_198.078125	34	114	143	2	80	0.0250000
NODE_303139_length_163_cov_198.078125	34	114	145	3	80	0.0375000
NODE_303139_length_163_cov_198.078125	34	114	146	43	80	0.5375000
NODE_303139_length_163_cov_198.078125	35	110	80	1	75	0.0133333
NODE_303139_length_163_cov_198.078125	35	110	86	1	75	0.0133333
NODE_303139_length_163_cov_198.078125	35	110	108	1	75	0.0133333
NODE_303139_length_163_cov_198.078125	35	110	112	3	75	0.0400000
NODE_303139_length_163_cov_198.078125	35	110	125	4	75	0.0533333
NODE_303139_length_163_cov_198.078125	35	110	131	2	75	0.0266667
NODE_303139_length_163_cov_198.078125	35	110	133	7	75	0.0933333
NODE_303139_length_163_cov_198.078125	35	110	137	6	75	0.0800000
NODE_303139_length_163_cov_198.078125	35	110	139	1	75	0.0133333
NODE_303139_length_163_cov_198.078125	35	110	141	1	75	0.0133333
NODE_303139_length_163_cov_198.078125	35	110	143	2	75	0.0266667
NODE_303139_length_163_cov_198.078125	35	110	145	3	75	0.0400000
NODE_303139_length_163_cov_198.078125	35	110	146	43	75	0.5733333
NODE_303139_length_163_cov_198.078125	87	163	1	6	76	0.0789474
NODE_303139_length_163_cov_198.078125	87	163	9	2	76	0.0263158
NODE_303139_length_163_cov_198.078125	87	163	41	1	76	0.0131579
NODE_303139_length_163_cov_198.078125	87	163	50	1	76	0.0131579
NODE_303139_length_163_cov_198.078125	87	163	55	1	76	0.0131579
NODE_303139_length_163_cov_198.078125	87	163	57	1	76	0.0131579
NODE_303139_length_163_cov_198.078125	87	163	60	1	76	0.0131579
NODE_303139_length_163_cov_198.078125	87	163	87	1	76	0.0131579
NODE_303139_length_163_cov_198.078125	87	163	89	2	76	0.0263158
NODE_303139_length_163_cov_198.078125	87	163	94	3	76	0.0394737
NODE_303139_length_163_cov_198.078125	87	163	98	5	76	0.0657895
NODE_303139_length_163_cov_198.078125	87	163	102	5	76	0.0657895
NODE_303139_length_163_cov_198.078125	87	163	108	1	76	0.0131579
NODE_303139_length_163_cov_198.078125	87	163	116	1	76	0.0131579
NODE_303139_length_163_cov_198.078125	87	163	121	2	76	0.0263158
NODE_303139_length_163_cov_198.078125	87	163	122	4	76	0.0526316
NODE_303139_length_163_cov_198.078125	87	163	128	3	76	0.0394737
NODE_303139_length_163_cov_198.078125	87	163	135	1	76	0.0131579
NODE_303139_length_163_cov_198.078125	87	163	139	13	76	0.1710526
NODE_303139_length_163_cov_198.078125	87	163	141	1	76	0.0131579
NODE_303139_length_163_cov_198.078125	87	163	143	2	76	0.0263158
NODE_303139_length_163_cov_198.078125	87	163	145	2	76	0.0263158
NODE_303139_length_163_cov_198.078125	87	163	146	17	76	0.2236842
NODE_303139_length_163_cov_198.078125	87	163	1	6	76	0.0789474
NODE_303139_length_163_cov_198.078125	87	163	9	2	76	0.0263158
NODE_303139_length_163_cov_198.078125	87	163	41	1	76	0.0131579
NODE_303139_length_163_cov_198.078125	87	163	50	1	76	0.0131579
NODE_303139_length_163_cov_198.078125	87	163	55	1	76	0.0131579
NODE_303139_length_163_cov_198.078125	87	163	57	1	76	0.0131579
NODE_303139_length_163_cov_198.078125	87	163	60	1	76	0.0131579
NODE_303139_length_163_cov_198.078125	87	163	87	1	76	0.0131579
NODE_303139_length_163_cov_198.078125	87	163	89	2	76	0.0263158
NODE_303139_length_163_cov_198.078125	87	163	94	3	76	0.0394737
NODE_303139_length_163_cov_198.078125	87	163	98	5	76	0.0657895
NODE_303139_length_163_cov_198.078125	87	163	102	5	76	0.0657895
NODE_303139_length_163_cov_198.078125	87	163	108	1	76	0.0131579
NODE_303139_length_163_cov_198.078125	87	163	116	1	76	0.0131579
NODE_303139_length_163_cov_198.078125	87	163	121	2	76	0.0263158
NODE_303139_length_163_cov_198.078125	87	163	122	4	76	0.0526316
NODE_303139_length_163_cov_198.078125	87	163	128	3	76	0.0394737
NODE_303139_length_163_cov_198.078125	87	163	135	1	76	0.0131579
NODE_303139_length_163_cov_198.078125	87	163	139	13	76	0.1710526
NODE_303139_length_163_cov_198.078125	87	163	141	1	76	0.0131579
NODE_303139_length_163_cov_198.078125	87	163	143	2	76	0.0263158
NODE_303139_length_163_cov_198.078125	87	163	145	2	76	0.0263158
NODE_303139_length_163_cov_198.078125	87	163	146	17	76	0.2236842
NODE_303139_length_163_cov_198.078125	87	163	1	6	76	0.0789474
NODE_303139_length_163_cov_198.078125	87	163	9	2	76	0.0263158
NODE_303139_length_163_cov_198.078125	87	163	41	1	76	0.0131579
NODE_303139_length_163_cov_198.078125	87	163	50	1	76	0.0131579
NODE_303139_length_163_cov_198.078125	87	163	55	1	76	0.0131579
NODE_303139_length_163_cov_198.078125	87	163	57	1	76	0.0131579
NODE_303139_length_163_cov_198.078125	87	163	60	1	76	0.0131579
NODE_303139_length_163_cov_198.078125	87	163	87	1	76	0.0131579
NODE_303139_length_163_cov_198.078125	87	163	89	2	76	0.0263158
NODE_303139_length_163_cov_198.078125	87	163	94	3	76	0.0394737
NODE_303139_length_163_cov_198.078125	87	163	98	5	76	0.0657895
NODE_303139_length_163_cov_198.078125	87	163	102	5	76	0.0657895
NODE_303139_length_163_cov_198.078125	87	163	108	1	76	0.0131579
NODE_303139_length_163_cov_198.078125	87	163	116	1	76	0.0131579
NODE_303139_length_163_cov_198.078125	87	163	121	2	76	0.0263158
NODE_303139_length_163_cov_198.078125	87	163	122	4	76	0.0526316
NODE_303139_length_163_cov_198.078125	87	163	128	3	76	0.0394737
NODE_303139_length_163_cov_198.078125	87	163	135	1	76	0.0131579
NODE_303139_length_163_cov_198.078125	87	163	139	13	76	0.1710526
NODE_303139_length_163_cov_198.078125	87	163	141	1	76	0.0131579
NODE_303139_length_163_cov_198.078125	87	163	143	2	76	0.0263158
NODE_303139_length_163_cov_198.078125	87	163	145	2	76	0.0263158
NODE_303139_length_163_cov_198.078125	87	163	146	17	76	0.2236842
NODE_303231_length_162_cov_421.047619	7	56	96	1	49	0.0204082
NODE_303231_length_162_cov_421.047619	7	56	116	1	49	0.0204082
NODE_303231_length_162_cov_421.047619	7	56	117	1	49	0.0204082
NODE_303231_length_162_cov_421.047619	7	56	119	1	49	0.0204082
NODE_303231_length_162_cov_421.047619	7	56	128	1	49	0.0204082
NODE_303231_length_162_cov_421.047619	7	56	130	1	49	0.0204082
NODE_303231_length_162_cov_421.047619	7	56	148	1	49	0.0204082
NODE_303231_length_162_cov_421.047619	7	56	161	1	49	0.0204082
NODE_303231_length_162_cov_421.047619	7	56	175	1	49	0.0204082
NODE_303231_length_162_cov_421.047619	7	56	176	1	49	0.0204082
NODE_303231_length_162_cov_421.047619	7	56	182	1	49	0.0204082
NODE_303231_length_162_cov_421.047619	7	56	206	1	49	0.0204082
NODE_303231_length_162_cov_421.047619	7	56	218	1	49	0.0204082
NODE_303231_length_162_cov_421.047619	7	56	229	1	49	0.0204082
NODE_303231_length_162_cov_421.047619	7	56	232	1	49	0.0204082
NODE_303231_length_162_cov_421.047619	7	56	233	1	49	0.0204082
NODE_303231_length_162_cov_421.047619	7	56	235	1	49	0.0204082
NODE_303231_length_162_cov_421.047619	7	56	245	2	49	0.0408163
NODE_303231_length_162_cov_421.047619	7	56	257	1	49	0.0204082
NODE_303231_length_162_cov_421.047619	7	56	260	1	49	0.0204082
NODE_303231_length_162_cov_421.047619	7	56	282	1	49	0.0204082
NODE_303231_length_162_cov_421.047619	7	56	291	1	49	0.0204082
NODE_303231_length_162_cov_421.047619	7	56	292	1	49	0.0204082
NODE_303231_length_162_cov_421.047619	7	56	294	2	49	0.0408163
NODE_303231_length_162_cov_421.047619	7	56	304	2	49	0.0408163
NODE_303231_length_162_cov_421.047619	7	56	312	1	49	0.0204082
NODE_303231_length_162_cov_421.047619	7	56	318	1	49	0.0204082
NODE_303231_length_162_cov_421.047619	7	56	335	2	49	0.0408163
NODE_303231_length_162_cov_421.047619	7	56	350	1	49	0.0204082
NODE_303231_length_162_cov_421.047619	7	56	351	2	49	0.0408163
NODE_303231_length_162_cov_421.047619	7	56	354	1	49	0.0204082
NODE_303231_length_162_cov_421.047619	7	56	363	1	49	0.0204082
NODE_303231_length_162_cov_421.047619	7	56	368	1	49	0.0204082
NODE_303231_length_162_cov_421.047619	7	56	371	1	49	0.0204082
NODE_303231_length_162_cov_421.047619	7	56	383	3	49	0.0612245
NODE_303231_length_162_cov_421.047619	7	56	390	1	49	0.0204082
NODE_303231_length_162_cov_421.047619	7	56	397	1	49	0.0204082
NODE_303231_length_162_cov_421.047619	7	56	405	1	49	0.0204082
NODE_303231_length_162_cov_421.047619	7	56	407	1	49	0.0204082
NODE_303231_length_162_cov_421.047619	7	56	409	2	49	0.0408163
NODE_303231_length_162_cov_421.047619	7	56	413	1	49	0.0204082
NODE_303231_length_162_cov_421.047619	29	90	291	1	61	0.0163934
NODE_303231_length_162_cov_421.047619	29	90	292	1	61	0.0163934
NODE_303231_length_162_cov_421.047619	29	90	294	2	61	0.0327869
NODE_303231_length_162_cov_421.047619	29	90	304	2	61	0.0327869
NODE_303231_length_162_cov_421.047619	29	90	312	1	61	0.0163934
NODE_303231_length_162_cov_421.047619	29	90	318	1	61	0.0163934
NODE_303231_length_162_cov_421.047619	29	90	335	2	61	0.0327869
NODE_303231_length_162_cov_421.047619	29	90	350	1	61	0.0163934
NODE_303231_length_162_cov_421.047619	29	90	351	2	61	0.0327869
NODE_303231_length_162_cov_421.047619	29	90	354	1	61	0.0163934
NODE_303231_length_162_cov_421.047619	29	90	363	1	61	0.0163934
NODE_303231_length_162_cov_421.047619	29	90	368	1	61	0.0163934
NODE_303231_length_162_cov_421.047619	29	90	371	1	61	0.0163934
NODE_303231_length_162_cov_421.047619	29	90	383	3	61	0.0491803
NODE_303231_length_162_cov_421.047619	29	90	390	1	61	0.0163934
NODE_303231_length_162_cov_421.047619	29	90	397	1	61	0.0163934
NODE_303231_length_162_cov_421.047619	29	90	405	1	61	0.0163934
NODE_303231_length_162_cov_421.047619	29	90	407	1	61	0.0163934
NODE_303231_length_162_cov_421.047619	29	90	409	2	61	0.0327869
NODE_303231_length_162_cov_421.047619	29	90	413	35	61	0.5737705
NODE_303231_length_162_cov_421.047619	29	92	291	1	63	0.0158730
NODE_303231_length_162_cov_421.047619	29	92	292	1	63	0.0158730
NODE_303231_length_162_cov_421.047619	29	92	294	2	63	0.0317460
NODE_303231_length_162_cov_421.047619	29	92	304	2	63	0.0317460
NODE_303231_length_162_cov_421.047619	29	92	312	1	63	0.0158730
NODE_303231_length_162_cov_421.047619	29	92	318	1	63	0.0158730
NODE_303231_length_162_cov_421.047619	29	92	335	2	63	0.0317460
NODE_303231_length_162_cov_421.047619	29	92	350	1	63	0.0158730
NODE_303231_length_162_cov_421.047619	29	92	351	2	63	0.0317460
NODE_303231_length_162_cov_421.047619	29	92	354	1	63	0.0158730
NODE_303231_length_162_cov_421.047619	29	92	363	1	63	0.0158730
NODE_303231_length_162_cov_421.047619	29	92	368	1	63	0.0158730
NODE_303231_length_162_cov_421.047619	29	92	371	1	63	0.0158730
NODE_303231_length_162_cov_421.047619	29	92	383	3	63	0.0476190
NODE_303231_length_162_cov_421.047619	29	92	390	1	63	0.0158730
NODE_303231_length_162_cov_421.047619	29	92	397	1	63	0.0158730
NODE_303231_length_162_cov_421.047619	29	92	405	1	63	0.0158730
NODE_303231_length_162_cov_421.047619	29	92	407	1	63	0.0158730
NODE_303231_length_162_cov_421.047619	29	92	409	2	63	0.0317460
NODE_303231_length_162_cov_421.047619	29	92	413	37	63	0.5873016
NODE_303231_length_162_cov_421.047619	29	92	291	1	63	0.0158730
NODE_303231_length_162_cov_421.047619	29	92	292	1	63	0.0158730
NODE_303231_length_162_cov_421.047619	29	92	294	2	63	0.0317460
NODE_303231_length_162_cov_421.047619	29	92	304	2	63	0.0317460
NODE_303231_length_162_cov_421.047619	29	92	312	1	63	0.0158730
NODE_303231_length_162_cov_421.047619	29	92	318	1	63	0.0158730
NODE_303231_length_162_cov_421.047619	29	92	335	2	63	0.0317460
NODE_303231_length_162_cov_421.047619	29	92	350	1	63	0.0158730
NODE_303231_length_162_cov_421.047619	29	92	351	2	63	0.0317460
NODE_303231_length_162_cov_421.047619	29	92	354	1	63	0.0158730
NODE_303231_length_162_cov_421.047619	29	92	363	1	63	0.0158730
NODE_303231_length_162_cov_421.047619	29	92	368	1	63	0.0158730
NODE_303231_length_162_cov_421.047619	29	92	371	1	63	0.0158730
NODE_303231_length_162_cov_421.047619	29	92	383	3	63	0.0476190
NODE_303231_length_162_cov_421.047619	29	92	390	1	63	0.0158730
NODE_303231_length_162_cov_421.047619	29	92	397	1	63	0.0158730
NODE_303231_length_162_cov_421.047619	29	92	405	1	63	0.0158730
NODE_303231_length_162_cov_421.047619	29	92	407	1	63	0.0158730
NODE_303231_length_162_cov_421.047619	29	92	409	2	63	0.0317460
NODE_303231_length_162_cov_421.047619	29	92	413	37	63	0.5873016
NODE_303231_length_162_cov_421.047619	29	92	291	1	63	0.0158730
NODE_303231_length_162_cov_421.047619	29	92	292	1	63	0.0158730
NODE_303231_length_162_cov_421.047619	29	92	294	2	63	0.0317460
NODE_303231_length_162_cov_421.047619	29	92	304	2	63	0.0317460
NODE_303231_length_162_cov_421.047619	29	92	312	1	63	0.0158730
NODE_303231_length_162_cov_421.047619	29	92	318	1	63	0.0158730
NODE_303231_length_162_cov_421.047619	29	92	335	2	63	0.0317460
NODE_303231_length_162_cov_421.047619	29	92	350	1	63	0.0158730
NODE_303231_length_162_cov_421.047619	29	92	351	2	63	0.0317460
NODE_303231_length_162_cov_421.047619	29	92	354	1	63	0.0158730
NODE_303231_length_162_cov_421.047619	29	92	363	1	63	0.0158730
NODE_303231_length_162_cov_421.047619	29	92	368	1	63	0.0158730
NODE_303231_length_162_cov_421.047619	29	92	371	1	63	0.0158730
NODE_303231_length_162_cov_421.047619	29	92	383	3	63	0.0476190
NODE_303231_length_162_cov_421.047619	29	92	390	1	63	0.0158730
NODE_303231_length_162_cov_421.047619	29	92	397	1	63	0.0158730
NODE_303231_length_162_cov_421.047619	29	92	405	1	63	0.0158730
NODE_303231_length_162_cov_421.047619	29	92	407	1	63	0.0158730
NODE_303231_length_162_cov_421.047619	29	92	409	2	63	0.0317460
NODE_303231_length_162_cov_421.047619	29	92	413	37	63	0.5873016
NODE_303250_length_162_cov_45.380952	63	127	70	4	64	0.0625000
NODE_303250_length_162_cov_45.380952	63	127	72	1	64	0.0156250
NODE_303250_length_162_cov_45.380952	63	127	76	1	64	0.0156250
NODE_303250_length_162_cov_45.380952	63	127	86	1	64	0.0156250
NODE_303250_length_162_cov_45.380952	63	127	88	7	64	0.1093750
NODE_303250_length_162_cov_45.380952	63	127	92	1	64	0.0156250
NODE_303250_length_162_cov_45.380952	63	127	93	4	64	0.0625000
NODE_303250_length_162_cov_45.380952	63	127	95	1	64	0.0156250
NODE_303250_length_162_cov_45.380952	63	127	98	44	64	0.6875000
NODE_303250_length_162_cov_45.380952	63	127	70	4	64	0.0625000
NODE_303250_length_162_cov_45.380952	63	127	72	1	64	0.0156250
NODE_303250_length_162_cov_45.380952	63	127	76	1	64	0.0156250
NODE_303250_length_162_cov_45.380952	63	127	86	1	64	0.0156250
NODE_303250_length_162_cov_45.380952	63	127	88	7	64	0.1093750
NODE_303250_length_162_cov_45.380952	63	127	92	1	64	0.0156250
NODE_303250_length_162_cov_45.380952	63	127	93	4	64	0.0625000
NODE_303250_length_162_cov_45.380952	63	127	95	1	64	0.0156250
NODE_303250_length_162_cov_45.380952	63	127	98	44	64	0.6875000
NODE_303250_length_162_cov_45.380952	100	162	0	2	62	0.0322581
NODE_303250_length_162_cov_45.380952	100	162	2	1	62	0.0161290
NODE_303250_length_162_cov_45.380952	100	162	4	5	62	0.0806452
NODE_303250_length_162_cov_45.380952	100	162	12	2	62	0.0322581
NODE_303250_length_162_cov_45.380952	100	162	16	1	62	0.0161290
NODE_303250_length_162_cov_45.380952	100	162	18	3	62	0.0483871
NODE_303250_length_162_cov_45.380952	100	162	28	1	62	0.0161290
NODE_303250_length_162_cov_45.380952	100	162	33	3	62	0.0483871
NODE_303250_length_162_cov_45.380952	100	162	43	1	62	0.0161290
NODE_303250_length_162_cov_45.380952	100	162	44	5	62	0.0806452
NODE_303250_length_162_cov_45.380952	100	162	45	1	62	0.0161290
NODE_303250_length_162_cov_45.380952	100	162	47	1	62	0.0161290
NODE_303250_length_162_cov_45.380952	100	162	56	1	62	0.0161290
NODE_303250_length_162_cov_45.380952	100	162	62	1	62	0.0161290
NODE_303250_length_162_cov_45.380952	100	162	63	4	62	0.0645161
NODE_303250_length_162_cov_45.380952	100	162	66	1	62	0.0161290
NODE_303250_length_162_cov_45.380952	100	162	68	2	62	0.0322581
NODE_303250_length_162_cov_45.380952	100	162	70	4	62	0.0645161
NODE_303250_length_162_cov_45.380952	100	162	72	1	62	0.0161290
NODE_303250_length_162_cov_45.380952	100	162	76	1	62	0.0161290
NODE_303250_length_162_cov_45.380952	100	162	86	1	62	0.0161290
NODE_303250_length_162_cov_45.380952	100	162	88	7	62	0.1129032
NODE_303250_length_162_cov_45.380952	100	162	92	1	62	0.0161290
NODE_303250_length_162_cov_45.380952	100	162	93	4	62	0.0645161
NODE_303250_length_162_cov_45.380952	100	162	95	1	62	0.0161290
NODE_303250_length_162_cov_45.380952	100	162	98	7	62	0.1129032
NODE_303301_length_161_cov_1483.177419	51	131	119	6	80	0.0750000
NODE_303301_length_161_cov_1483.177419	51	131	121	4	80	0.0500000
NODE_303301_length_161_cov_1483.177419	51	131	122	4	80	0.0500000
NODE_303301_length_161_cov_1483.177419	51	131	124	2	80	0.0250000
NODE_303301_length_161_cov_1483.177419	51	131	128	1	80	0.0125000
NODE_303301_length_161_cov_1483.177419	51	131	132	2	80	0.0250000
NODE_303301_length_161_cov_1483.177419	51	131	134	1	80	0.0125000
NODE_303301_length_161_cov_1483.177419	51	131	136	3	80	0.0375000
NODE_303301_length_161_cov_1483.177419	51	131	140	1	80	0.0125000
NODE_303301_length_161_cov_1483.177419	51	131	142	1	80	0.0125000
NODE_303301_length_161_cov_1483.177419	51	131	144	1	80	0.0125000
NODE_303301_length_161_cov_1483.177419	51	131	146	1	80	0.0125000
NODE_303301_length_161_cov_1483.177419	51	131	148	3	80	0.0375000
NODE_303301_length_161_cov_1483.177419	51	131	150	2	80	0.0250000
NODE_303301_length_161_cov_1483.177419	51	131	152	3	80	0.0375000
NODE_303301_length_161_cov_1483.177419	51	131	154	45	80	0.5625000
NODE_303301_length_161_cov_1483.177419	104	161	24	1	57	0.0175439
NODE_303301_length_161_cov_1483.177419	104	161	26	2	57	0.0350877
NODE_303301_length_161_cov_1483.177419	104	161	28	3	57	0.0526316
NODE_303301_length_161_cov_1483.177419	104	161	32	1	57	0.0175439
NODE_303301_length_161_cov_1483.177419	104	161	37	1	57	0.0175439
NODE_303301_length_161_cov_1483.177419	104	161	38	1	57	0.0175439
NODE_303301_length_161_cov_1483.177419	104	161	39	1	57	0.0175439
NODE_303301_length_161_cov_1483.177419	104	161	49	1	57	0.0175439
NODE_303301_length_161_cov_1483.177419	104	161	53	1	57	0.0175439
NODE_303301_length_161_cov_1483.177419	104	161	57	1	57	0.0175439
NODE_303301_length_161_cov_1483.177419	104	161	58	1	57	0.0175439
NODE_303301_length_161_cov_1483.177419	104	161	72	1	57	0.0175439
NODE_303301_length_161_cov_1483.177419	104	161	75	2	57	0.0350877
NODE_303301_length_161_cov_1483.177419	104	161	81	1	57	0.0175439
NODE_303301_length_161_cov_1483.177419	104	161	85	1	57	0.0175439
NODE_303301_length_161_cov_1483.177419	104	161	88	1	57	0.0175439
NODE_303301_length_161_cov_1483.177419	104	161	89	1	57	0.0175439
NODE_303301_length_161_cov_1483.177419	104	161	91	1	57	0.0175439
NODE_303301_length_161_cov_1483.177419	104	161	95	1	57	0.0175439
NODE_303301_length_161_cov_1483.177419	104	161	99	1	57	0.0175439
NODE_303301_length_161_cov_1483.177419	104	161	103	1	57	0.0175439
NODE_303301_length_161_cov_1483.177419	104	161	105	2	57	0.0350877
NODE_303301_length_161_cov_1483.177419	104	161	111	1	57	0.0175439
NODE_303301_length_161_cov_1483.177419	104	161	114	1	57	0.0175439
NODE_303301_length_161_cov_1483.177419	104	161	119	7	57	0.1228070
NODE_303301_length_161_cov_1483.177419	104	161	121	4	57	0.0701754
NODE_303301_length_161_cov_1483.177419	104	161	122	4	57	0.0701754
NODE_303301_length_161_cov_1483.177419	104	161	128	1	57	0.0175439
NODE_303301_length_161_cov_1483.177419	104	161	132	1	57	0.0175439
NODE_303301_length_161_cov_1483.177419	104	161	134	1	57	0.0175439
NODE_303301_length_161_cov_1483.177419	104	161	136	2	57	0.0350877
NODE_303301_length_161_cov_1483.177419	104	161	146	1	57	0.0175439
NODE_303301_length_161_cov_1483.177419	104	161	148	3	57	0.0526316
NODE_303301_length_161_cov_1483.177419	104	161	150	1	57	0.0175439
NODE_303301_length_161_cov_1483.177419	104	161	152	3	57	0.0526316
NODE_303312_length_161_cov_71.500000	33	110	2	6	77	0.0779221
NODE_303312_length_161_cov_71.500000	33	110	4	71	77	0.9220779
NODE_303312_length_161_cov_71.500000	33	110	2	6	77	0.0779221
NODE_303312_length_161_cov_71.500000	33	110	4	71	77	0.9220779
NODE_303312_length_161_cov_71.500000	33	110	2	6	77	0.0779221
NODE_303312_length_161_cov_71.500000	33	110	4	71	77	0.9220779
NODE_303312_length_161_cov_71.500000	33	110	2	6	77	0.0779221
NODE_303312_length_161_cov_71.500000	33	110	4	71	77	0.9220779
NODE_303312_length_161_cov_71.500000	83	149	2	4	66	0.0606061
NODE_303312_length_161_cov_71.500000	83	149	4	62	66	0.9393939
NODE_303312_length_161_cov_71.500000	83	161	0	6	78	0.0769231
NODE_303312_length_161_cov_71.500000	83	161	2	10	78	0.1282051
NODE_303312_length_161_cov_71.500000	83	161	4	62	78	0.7948718
NODE_303312_length_161_cov_71.500000	86	161	0	6	75	0.0800000
NODE_303312_length_161_cov_71.500000	86	161	2	10	75	0.1333333
NODE_303312_length_161_cov_71.500000	86	161	4	59	75	0.7866667
NODE_303312_length_161_cov_71.500000	86	161	0	6	75	0.0800000
NODE_303312_length_161_cov_71.500000	86	161	2	10	75	0.1333333
NODE_303312_length_161_cov_71.500000	86	161	4	59	75	0.7866667
NODE_303312_length_161_cov_71.500000	88	161	0	6	73	0.0821918
NODE_303312_length_161_cov_71.500000	88	161	2	10	73	0.1369863
NODE_303312_length_161_cov_71.500000	88	161	4	57	73	0.7808219
NODE_303321_length_161_cov_29.758065	0	80	2	19	80	0.2375000
NODE_303321_length_161_cov_29.758065	0	80	4	7	80	0.0875000
NODE_303321_length_161_cov_29.758065	0	80	10	3	80	0.0375000
NODE_303321_length_161_cov_29.758065	0	80	20	1	80	0.0125000
NODE_303321_length_161_cov_29.758065	0	80	21	2	80	0.0250000
NODE_303321_length_161_cov_29.758065	0	80	22	1	80	0.0125000
NODE_303321_length_161_cov_29.758065	0	80	24	18	80	0.2250000
NODE_303321_length_161_cov_29.758065	0	80	26	2	80	0.0250000
NODE_303321_length_161_cov_29.758065	0	80	28	27	80	0.3375000
NODE_303381_length_160_cov_143.573770	45	125	18	1	80	0.0125000
NODE_303381_length_160_cov_143.573770	45	125	20	5	80	0.0625000
NODE_303381_length_160_cov_143.573770	45	125	22	74	80	0.9250000
NODE_303381_length_160_cov_143.573770	93	160	0	6	67	0.0895522
NODE_303381_length_160_cov_143.573770	93	160	2	16	67	0.2388060
NODE_303381_length_160_cov_143.573770	93	160	4	1	67	0.0149254
NODE_303381_length_160_cov_143.573770	93	160	6	1	67	0.0149254
NODE_303381_length_160_cov_143.573770	93	160	16	4	67	0.0597015
NODE_303381_length_160_cov_143.573770	93	160	18	8	67	0.1194030
NODE_303381_length_160_cov_143.573770	93	160	20	5	67	0.0746269
NODE_303381_length_160_cov_143.573770	93	160	22	26	67	0.3880597
NODE_303381_length_160_cov_143.573770	98	120	20	1	22	0.0454545
NODE_303381_length_160_cov_143.573770	98	120	22	21	22	0.9545454
NODE_303388_length_160_cov_58.245902	0	45	0	14	45	0.3111111
NODE_303388_length_160_cov_58.245902	0	45	2	13	45	0.2888889
NODE_303388_length_160_cov_58.245902	0	45	4	12	45	0.2666667
NODE_303388_length_160_cov_58.245902	0	45	6	6	45	0.1333333
NODE_303431_length_159_cov_182.016667	71	156	7	8	85	0.0941176
NODE_303431_length_159_cov_182.016667	71	156	17	4	85	0.0470588
NODE_303431_length_159_cov_182.016667	71	156	20	2	85	0.0235294
NODE_303431_length_159_cov_182.016667	71	156	28	3	85	0.0352941
NODE_303431_length_159_cov_182.016667	71	156	45	2	85	0.0235294
NODE_303431_length_159_cov_182.016667	71	156	46	1	85	0.0117647
NODE_303431_length_159_cov_182.016667	71	156	52	3	85	0.0352941
NODE_303431_length_159_cov_182.016667	71	156	57	1	85	0.0117647
NODE_303431_length_159_cov_182.016667	71	156	58	9	85	0.1058824
NODE_303431_length_159_cov_182.016667	71	156	62	52	85	0.6117647
NODE_303431_length_159_cov_182.016667	71	156	7	8	85	0.0941176
NODE_303431_length_159_cov_182.016667	71	156	17	4	85	0.0470588
NODE_303431_length_159_cov_182.016667	71	156	20	2	85	0.0235294
NODE_303431_length_159_cov_182.016667	71	156	28	3	85	0.0352941
NODE_303431_length_159_cov_182.016667	71	156	45	2	85	0.0235294
NODE_303431_length_159_cov_182.016667	71	156	46	1	85	0.0117647
NODE_303431_length_159_cov_182.016667	71	156	52	3	85	0.0352941
NODE_303431_length_159_cov_182.016667	71	156	57	1	85	0.0117647
NODE_303431_length_159_cov_182.016667	71	156	58	9	85	0.1058824
NODE_303431_length_159_cov_182.016667	71	156	62	52	85	0.6117647
NODE_303431_length_159_cov_182.016667	71	156	7	8	85	0.0941176
NODE_303431_length_159_cov_182.016667	71	156	17	4	85	0.0470588
NODE_303431_length_159_cov_182.016667	71	156	20	2	85	0.0235294
NODE_303431_length_159_cov_182.016667	71	156	28	3	85	0.0352941
NODE_303431_length_159_cov_182.016667	71	156	45	2	85	0.0235294
NODE_303431_length_159_cov_182.016667	71	156	46	1	85	0.0117647
NODE_303431_length_159_cov_182.016667	71	156	52	3	85	0.0352941
NODE_303431_length_159_cov_182.016667	71	156	57	1	85	0.0117647
NODE_303431_length_159_cov_182.016667	71	156	58	9	85	0.1058824
NODE_303431_length_159_cov_182.016667	71	156	62	52	85	0.6117647
NODE_303440_length_159_cov_85.750000	0	43	0	5	43	0.1162791
NODE_303440_length_159_cov_85.750000	0	43	2	3	43	0.0697674
NODE_303440_length_159_cov_85.750000	0	43	4	5	43	0.1162791
NODE_303440_length_159_cov_85.750000	0	43	6	1	43	0.0232558
NODE_303440_length_159_cov_85.750000	0	43	8	5	43	0.1162791
NODE_303440_length_159_cov_85.750000	0	43	14	3	43	0.0697674
NODE_303440_length_159_cov_85.750000	0	43	16	3	43	0.0697674
NODE_303440_length_159_cov_85.750000	0	43	18	3	43	0.0697674
NODE_303440_length_159_cov_85.750000	0	43	22	2	43	0.0465116
NODE_303440_length_159_cov_85.750000	0	43	30	1	43	0.0232558
NODE_303440_length_159_cov_85.750000	0	43	36	2	43	0.0465116
NODE_303440_length_159_cov_85.750000	0	43	42	4	43	0.0930233
NODE_303440_length_159_cov_85.750000	0	43	45	3	43	0.0697674
NODE_303440_length_159_cov_85.750000	0	43	47	3	43	0.0697674
NODE_303440_length_159_cov_85.750000	16	97	8	3	81	0.0370370
NODE_303440_length_159_cov_85.750000	16	97	14	3	81	0.0370370
NODE_303440_length_159_cov_85.750000	16	97	16	3	81	0.0370370
NODE_303440_length_159_cov_85.750000	16	97	18	3	81	0.0370370
NODE_303440_length_159_cov_85.750000	16	97	22	2	81	0.0246914
NODE_303440_length_159_cov_85.750000	16	97	30	1	81	0.0123457
NODE_303440_length_159_cov_85.750000	16	97	36	2	81	0.0246914
NODE_303440_length_159_cov_85.750000	16	97	42	4	81	0.0493827
NODE_303440_length_159_cov_85.750000	16	97	45	3	81	0.0370370
NODE_303440_length_159_cov_85.750000	16	97	47	5	81	0.0617284
NODE_303440_length_159_cov_85.750000	16	97	48	8	81	0.0987654
NODE_303440_length_159_cov_85.750000	16	97	50	44	81	0.5432099
NODE_303440_length_159_cov_85.750000	65	145	18	2	80	0.0250000
NODE_303440_length_159_cov_85.750000	65	145	24	5	80	0.0625000
NODE_303440_length_159_cov_85.750000	65	145	30	1	80	0.0125000
NODE_303440_length_159_cov_85.750000	65	145	32	1	80	0.0125000
NODE_303440_length_159_cov_85.750000	65	145	34	5	80	0.0625000
NODE_303440_length_159_cov_85.750000	65	145	36	1	80	0.0125000
NODE_303440_length_159_cov_85.750000	65	145	38	1	80	0.0125000
NODE_303440_length_159_cov_85.750000	65	145	40	7	80	0.0875000
NODE_303440_length_159_cov_85.750000	65	145	42	5	80	0.0625000
NODE_303440_length_159_cov_85.750000	65	145	44	6	80	0.0750000
NODE_303440_length_159_cov_85.750000	65	145	46	1	80	0.0125000
NODE_303440_length_159_cov_85.750000	65	145	48	5	80	0.0625000
NODE_303440_length_159_cov_85.750000	65	145	50	40	80	0.5000000
NODE_303440_length_159_cov_85.750000	70	92	50	22	22	1.0000000
NODE_303546_length_158_cov_119.813559	34	77	10	43	43	1.0000000
NODE_303546_length_158_cov_119.813559	78	113	7	10	35	0.2857143
NODE_303546_length_158_cov_119.813559	78	113	9	21	35	0.6000000
NODE_303546_length_158_cov_119.813559	78	113	10	4	35	0.1142857
NODE_303546_length_158_cov_119.813559	123	158	2	12	35	0.3428572
NODE_303546_length_158_cov_119.813559	123	158	3	21	35	0.6000000
NODE_303546_length_158_cov_119.813559	123	158	7	2	35	0.0571429
NODE_303552_length_158_cov_70.135593	5	82	14	41	77	0.5324675
NODE_303552_length_158_cov_70.135593	5	82	16	36	77	0.4675325
NODE_303552_length_158_cov_70.135593	5	82	14	41	77	0.5324675
NODE_303552_length_158_cov_70.135593	5	82	16	36	77	0.4675325
NODE_303552_length_158_cov_70.135593	81	155	0	10	74	0.1351351
NODE_303552_length_158_cov_70.135593	81	155	4	2	74	0.0270270
NODE_303552_length_158_cov_70.135593	81	155	14	31	74	0.4189189
NODE_303552_length_158_cov_70.135593	81	155	16	31	74	0.4189189
NODE_303555_length_158_cov_63.559322	80	151	7	1	71	0.0140845
NODE_303555_length_158_cov_63.559322	80	151	8	5	71	0.0704225
NODE_303555_length_158_cov_63.559322	80	151	10	3	71	0.0422535
NODE_303555_length_158_cov_63.559322	80	151	12	8	71	0.1126761
NODE_303555_length_158_cov_63.559322	80	151	14	2	71	0.0281690
NODE_303555_length_158_cov_63.559322	80	151	18	4	71	0.0563380
NODE_303555_length_158_cov_63.559322	80	151	22	11	71	0.1549296
NODE_303555_length_158_cov_63.559322	80	151	24	1	71	0.0140845
NODE_303555_length_158_cov_63.559322	80	151	28	2	71	0.0281690
NODE_303555_length_158_cov_63.559322	80	151	30	1	71	0.0140845
NODE_303555_length_158_cov_63.559322	80	151	34	33	71	0.4647887
NODE_303556_length_158_cov_61.203390	2	66	95	1	64	0.0156250
NODE_303556_length_158_cov_61.203390	2	66	106	2	64	0.0312500
NODE_303556_length_158_cov_61.203390	2	66	121	1	64	0.0156250
NODE_303556_length_158_cov_61.203390	2	66	130	1	64	0.0156250
NODE_303556_length_158_cov_61.203390	2	66	147	1	64	0.0156250
NODE_303556_length_158_cov_61.203390	2	66	161	1	64	0.0156250
NODE_303556_length_158_cov_61.203390	2	66	165	2	64	0.0312500
NODE_303556_length_158_cov_61.203390	2	66	169	3	64	0.0468750
NODE_303556_length_158_cov_61.203390	2	66	209	1	64	0.0156250
NODE_303556_length_158_cov_61.203390	2	66	215	1	64	0.0156250
NODE_303556_length_158_cov_61.203390	2	66	217	1	64	0.0156250
NODE_303556_length_158_cov_61.203390	2	66	218	1	64	0.0156250
NODE_303556_length_158_cov_61.203390	2	66	224	1	64	0.0156250
NODE_303556_length_158_cov_61.203390	2	66	225	1	64	0.0156250
NODE_303556_length_158_cov_61.203390	2	66	232	1	64	0.0156250
NODE_303556_length_158_cov_61.203390	2	66	251	1	64	0.0156250
NODE_303556_length_158_cov_61.203390	2	66	261	1	64	0.0156250
NODE_303556_length_158_cov_61.203390	2	66	265	2	64	0.0312500
NODE_303556_length_158_cov_61.203390	2	66	276	1	64	0.0156250
NODE_303556_length_158_cov_61.203390	2	66	280	1	64	0.0156250
NODE_303556_length_158_cov_61.203390	2	66	316	1	64	0.0156250
NODE_303556_length_158_cov_61.203390	2	66	318	1	64	0.0156250
NODE_303556_length_158_cov_61.203390	2	66	321	2	64	0.0312500
NODE_303556_length_158_cov_61.203390	2	66	328	1	64	0.0156250
NODE_303556_length_158_cov_61.203390	2	66	343	1	64	0.0156250
NODE_303556_length_158_cov_61.203390	2	66	347	1	64	0.0156250
NODE_303556_length_158_cov_61.203390	2	66	353	2	64	0.0312500
NODE_303556_length_158_cov_61.203390	2	66	361	2	64	0.0312500
NODE_303556_length_158_cov_61.203390	2	66	367	2	64	0.0312500
NODE_303556_length_158_cov_61.203390	2	66	371	1	64	0.0156250
NODE_303556_length_158_cov_61.203390	2	66	373	1	64	0.0156250
NODE_303556_length_158_cov_61.203390	2	66	375	1	64	0.0156250
NODE_303556_length_158_cov_61.203390	2	66	384	1	64	0.0156250
NODE_303556_length_158_cov_61.203390	2	66	394	1	64	0.0156250
NODE_303556_length_158_cov_61.203390	2	66	401	3	64	0.0468750
NODE_303556_length_158_cov_61.203390	2	66	402	1	64	0.0156250
NODE_303556_length_158_cov_61.203390	2	66	407	3	64	0.0468750
NODE_303556_length_158_cov_61.203390	2	66	414	1	64	0.0156250
NODE_303556_length_158_cov_61.203390	2	66	422	1	64	0.0156250
NODE_303556_length_158_cov_61.203390	2	66	425	6	64	0.0937500
NODE_303556_length_158_cov_61.203390	2	66	426	6	64	0.0937500
NODE_303556_length_158_cov_61.203390	2	66	95	1	64	0.0156250
NODE_303556_length_158_cov_61.203390	2	66	106	2	64	0.0312500
NODE_303556_length_158_cov_61.203390	2	66	121	1	64	0.0156250
NODE_303556_length_158_cov_61.203390	2	66	130	1	64	0.0156250
NODE_303556_length_158_cov_61.203390	2	66	147	1	64	0.0156250
NODE_303556_length_158_cov_61.203390	2	66	161	1	64	0.0156250
NODE_303556_length_158_cov_61.203390	2	66	165	2	64	0.0312500
NODE_303556_length_158_cov_61.203390	2	66	169	3	64	0.0468750
NODE_303556_length_158_cov_61.203390	2	66	209	1	64	0.0156250
NODE_303556_length_158_cov_61.203390	2	66	215	1	64	0.0156250
NODE_303556_length_158_cov_61.203390	2	66	217	1	64	0.0156250
NODE_303556_length_158_cov_61.203390	2	66	218	1	64	0.0156250
NODE_303556_length_158_cov_61.203390	2	66	224	1	64	0.0156250
NODE_303556_length_158_cov_61.203390	2	66	225	1	64	0.0156250
NODE_303556_length_158_cov_61.203390	2	66	232	1	64	0.0156250
NODE_303556_length_158_cov_61.203390	2	66	251	1	64	0.0156250
NODE_303556_length_158_cov_61.203390	2	66	261	1	64	0.0156250
NODE_303556_length_158_cov_61.203390	2	66	265	2	64	0.0312500
NODE_303556_length_158_cov_61.203390	2	66	276	1	64	0.0156250
NODE_303556_length_158_cov_61.203390	2	66	280	1	64	0.0156250
NODE_303556_length_158_cov_61.203390	2	66	316	1	64	0.0156250
NODE_303556_length_158_cov_61.203390	2	66	318	1	64	0.0156250
NODE_303556_length_158_cov_61.203390	2	66	321	2	64	0.0312500
NODE_303556_length_158_cov_61.203390	2	66	328	1	64	0.0156250
NODE_303556_length_158_cov_61.203390	2	66	343	1	64	0.0156250
NODE_303556_length_158_cov_61.203390	2	66	347	1	64	0.0156250
NODE_303556_length_158_cov_61.203390	2	66	353	2	64	0.0312500
NODE_303556_length_158_cov_61.203390	2	66	361	2	64	0.0312500
NODE_303556_length_158_cov_61.203390	2	66	367	2	64	0.0312500
NODE_303556_length_158_cov_61.203390	2	66	371	1	64	0.0156250
NODE_303556_length_158_cov_61.203390	2	66	373	1	64	0.0156250
NODE_303556_length_158_cov_61.203390	2	66	375	1	64	0.0156250
NODE_303556_length_158_cov_61.203390	2	66	384	1	64	0.0156250
NODE_303556_length_158_cov_61.203390	2	66	394	1	64	0.0156250
NODE_303556_length_158_cov_61.203390	2	66	401	3	64	0.0468750
NODE_303556_length_158_cov_61.203390	2	66	402	1	64	0.0156250
NODE_303556_length_158_cov_61.203390	2	66	407	3	64	0.0468750
NODE_303556_length_158_cov_61.203390	2	66	414	1	64	0.0156250
NODE_303556_length_158_cov_61.203390	2	66	422	1	64	0.0156250
NODE_303556_length_158_cov_61.203390	2	66	425	6	64	0.0937500
NODE_303556_length_158_cov_61.203390	2	66	426	6	64	0.0937500
NODE_303556_length_158_cov_61.203390	2	66	95	1	64	0.0156250
NODE_303556_length_158_cov_61.203390	2	66	106	2	64	0.0312500
NODE_303556_length_158_cov_61.203390	2	66	121	1	64	0.0156250
NODE_303556_length_158_cov_61.203390	2	66	130	1	64	0.0156250
NODE_303556_length_158_cov_61.203390	2	66	147	1	64	0.0156250
NODE_303556_length_158_cov_61.203390	2	66	161	1	64	0.0156250
NODE_303556_length_158_cov_61.203390	2	66	165	2	64	0.0312500
NODE_303556_length_158_cov_61.203390	2	66	169	3	64	0.0468750
NODE_303556_length_158_cov_61.203390	2	66	209	1	64	0.0156250
NODE_303556_length_158_cov_61.203390	2	66	215	1	64	0.0156250
NODE_303556_length_158_cov_61.203390	2	66	217	1	64	0.0156250
NODE_303556_length_158_cov_61.203390	2	66	218	1	64	0.0156250
NODE_303556_length_158_cov_61.203390	2	66	224	1	64	0.0156250
NODE_303556_length_158_cov_61.203390	2	66	225	1	64	0.0156250
NODE_303556_length_158_cov_61.203390	2	66	232	1	64	0.0156250
NODE_303556_length_158_cov_61.203390	2	66	251	1	64	0.0156250
NODE_303556_length_158_cov_61.203390	2	66	261	1	64	0.0156250
NODE_303556_length_158_cov_61.203390	2	66	265	2	64	0.0312500
NODE_303556_length_158_cov_61.203390	2	66	276	1	64	0.0156250
NODE_303556_length_158_cov_61.203390	2	66	280	1	64	0.0156250
NODE_303556_length_158_cov_61.203390	2	66	316	1	64	0.0156250
NODE_303556_length_158_cov_61.203390	2	66	318	1	64	0.0156250
NODE_303556_length_158_cov_61.203390	2	66	321	2	64	0.0312500
NODE_303556_length_158_cov_61.203390	2	66	328	1	64	0.0156250
NODE_303556_length_158_cov_61.203390	2	66	343	1	64	0.0156250
NODE_303556_length_158_cov_61.203390	2	66	347	1	64	0.0156250
NODE_303556_length_158_cov_61.203390	2	66	353	2	64	0.0312500
NODE_303556_length_158_cov_61.203390	2	66	361	2	64	0.0312500
NODE_303556_length_158_cov_61.203390	2	66	367	2	64	0.0312500
NODE_303556_length_158_cov_61.203390	2	66	371	1	64	0.0156250
NODE_303556_length_158_cov_61.203390	2	66	373	1	64	0.0156250
NODE_303556_length_158_cov_61.203390	2	66	375	1	64	0.0156250
NODE_303556_length_158_cov_61.203390	2	66	384	1	64	0.0156250
NODE_303556_length_158_cov_61.203390	2	66	394	1	64	0.0156250
NODE_303556_length_158_cov_61.203390	2	66	401	3	64	0.0468750
NODE_303556_length_158_cov_61.203390	2	66	402	1	64	0.0156250
NODE_303556_length_158_cov_61.203390	2	66	407	3	64	0.0468750
NODE_303556_length_158_cov_61.203390	2	66	414	1	64	0.0156250
NODE_303556_length_158_cov_61.203390	2	66	422	1	64	0.0156250
NODE_303556_length_158_cov_61.203390	2	66	425	6	64	0.0937500
NODE_303556_length_158_cov_61.203390	2	66	426	6	64	0.0937500
NODE_303556_length_158_cov_61.203390	39	119	350	1	80	0.0125000
NODE_303556_length_158_cov_61.203390	39	119	352	1	80	0.0125000
NODE_303556_length_158_cov_61.203390	39	119	367	1	80	0.0125000
NODE_303556_length_158_cov_61.203390	39	119	371	1	80	0.0125000
NODE_303556_length_158_cov_61.203390	39	119	373	1	80	0.0125000
NODE_303556_length_158_cov_61.203390	39	119	374	2	80	0.0250000
NODE_303556_length_158_cov_61.203390	39	119	375	1	80	0.0125000
NODE_303556_length_158_cov_61.203390	39	119	380	1	80	0.0125000
NODE_303556_length_158_cov_61.203390	39	119	384	1	80	0.0125000
NODE_303556_length_158_cov_61.203390	39	119	386	2	80	0.0250000
NODE_303556_length_158_cov_61.203390	39	119	390	1	80	0.0125000
NODE_303556_length_158_cov_61.203390	39	119	394	1	80	0.0125000
NODE_303556_length_158_cov_61.203390	39	119	398	1	80	0.0125000
NODE_303556_length_158_cov_61.203390	39	119	401	3	80	0.0375000
NODE_303556_length_158_cov_61.203390	39	119	402	2	80	0.0250000
NODE_303556_length_158_cov_61.203390	39	119	403	1	80	0.0125000
NODE_303556_length_158_cov_61.203390	39	119	407	3	80	0.0375000
NODE_303556_length_158_cov_61.203390	39	119	414	1	80	0.0125000
NODE_303556_length_158_cov_61.203390	39	119	419	3	80	0.0375000
NODE_303556_length_158_cov_61.203390	39	119	421	25	80	0.3125000
NODE_303556_length_158_cov_61.203390	39	119	422	1	80	0.0125000
NODE_303556_length_158_cov_61.203390	39	119	423	5	80	0.0625000
NODE_303556_length_158_cov_61.203390	39	119	425	15	80	0.1875000
NODE_303556_length_158_cov_61.203390	39	119	426	6	80	0.0750000
NODE_303563_length_158_cov_40.271186	43	107	112	1	64	0.0156250
NODE_303563_length_158_cov_40.271186	43	107	116	4	64	0.0625000
NODE_303563_length_158_cov_40.271186	43	107	120	1	64	0.0156250
NODE_303563_length_158_cov_40.271186	43	107	121	1	64	0.0156250
NODE_303563_length_158_cov_40.271186	43	107	122	5	64	0.0781250
NODE_303563_length_158_cov_40.271186	43	107	124	17	64	0.2656250
NODE_303563_length_158_cov_40.271186	43	107	125	35	64	0.5468750
NODE_303563_length_158_cov_40.271186	80	151	51	1	71	0.0140845
NODE_303563_length_158_cov_40.271186	80	151	52	1	71	0.0140845
NODE_303563_length_158_cov_40.271186	80	151	57	2	71	0.0281690
NODE_303563_length_158_cov_40.271186	80	151	59	2	71	0.0281690
NODE_303563_length_158_cov_40.271186	80	151	61	2	71	0.0281690
NODE_303563_length_158_cov_40.271186	80	151	63	2	71	0.0281690
NODE_303563_length_158_cov_40.271186	80	151	67	1	71	0.0140845
NODE_303563_length_158_cov_40.271186	80	151	71	2	71	0.0281690
NODE_303563_length_158_cov_40.271186	80	151	73	2	71	0.0281690
NODE_303563_length_158_cov_40.271186	80	151	75	5	71	0.0704225
NODE_303563_length_158_cov_40.271186	80	151	79	3	71	0.0422535
NODE_303563_length_158_cov_40.271186	80	151	91	2	71	0.0281690
NODE_303563_length_158_cov_40.271186	80	151	93	2	71	0.0281690
NODE_303563_length_158_cov_40.271186	80	151	97	1	71	0.0140845
NODE_303563_length_158_cov_40.271186	80	151	101	1	71	0.0140845
NODE_303563_length_158_cov_40.271186	80	151	103	1	71	0.0140845
NODE_303563_length_158_cov_40.271186	80	151	105	1	71	0.0140845
NODE_303563_length_158_cov_40.271186	80	151	107	4	71	0.0563380
NODE_303563_length_158_cov_40.271186	80	151	111	2	71	0.0281690
NODE_303563_length_158_cov_40.271186	80	151	113	2	71	0.0281690
NODE_303563_length_158_cov_40.271186	80	151	115	1	71	0.0140845
NODE_303563_length_158_cov_40.271186	80	151	117	1	71	0.0140845
NODE_303563_length_158_cov_40.271186	80	151	119	3	71	0.0422535
NODE_303563_length_158_cov_40.271186	80	151	121	1	71	0.0140845
NODE_303563_length_158_cov_40.271186	80	151	125	26	71	0.3661972
NODE_303566_length_158_cov_29.661017	0	61	0	61	61	1.0000000
NODE_303566_length_158_cov_29.661017	34	64	0	30	30	1.0000000
NODE_303605_length_157_cov_1488.586207	57	138	93	3	81	0.0370370
NODE_303605_length_157_cov_1488.586207	57	138	95	1	81	0.0123457
NODE_303605_length_157_cov_1488.586207	57	138	97	1	81	0.0123457
NODE_303605_length_157_cov_1488.586207	57	138	106	1	81	0.0123457
NODE_303605_length_157_cov_1488.586207	57	138	119	1	81	0.0123457
NODE_303605_length_157_cov_1488.586207	57	138	128	1	81	0.0123457
NODE_303605_length_157_cov_1488.586207	57	138	132	2	81	0.0246914
NODE_303605_length_157_cov_1488.586207	57	138	134	1	81	0.0123457
NODE_303605_length_157_cov_1488.586207	57	138	138	1	81	0.0123457
NODE_303605_length_157_cov_1488.586207	57	138	148	1	81	0.0123457
NODE_303605_length_157_cov_1488.586207	57	138	156	1	81	0.0123457
NODE_303605_length_157_cov_1488.586207	57	138	162	4	81	0.0493827
NODE_303605_length_157_cov_1488.586207	57	138	164	2	81	0.0246914
NODE_303605_length_157_cov_1488.586207	57	138	167	2	81	0.0246914
NODE_303605_length_157_cov_1488.586207	57	138	168	1	81	0.0123457
NODE_303605_length_157_cov_1488.586207	57	138	170	3	81	0.0370370
NODE_303605_length_157_cov_1488.586207	57	138	172	1	81	0.0123457
NODE_303605_length_157_cov_1488.586207	57	138	174	2	81	0.0246914
NODE_303605_length_157_cov_1488.586207	57	138	176	1	81	0.0123457
NODE_303605_length_157_cov_1488.586207	57	138	178	4	81	0.0493827
NODE_303605_length_157_cov_1488.586207	57	138	182	20	81	0.2469136
NODE_303605_length_157_cov_1488.586207	57	138	183	2	81	0.0246914
NODE_303605_length_157_cov_1488.586207	57	138	184	25	81	0.3086420
NODE_303605_length_157_cov_1488.586207	111	157	1	2	46	0.0434783
NODE_303605_length_157_cov_1488.586207	111	157	2	1	46	0.0217391
NODE_303605_length_157_cov_1488.586207	111	157	13	1	46	0.0217391
NODE_303605_length_157_cov_1488.586207	111	157	14	1	46	0.0217391
NODE_303605_length_157_cov_1488.586207	111	157	26	2	46	0.0434783
NODE_303605_length_157_cov_1488.586207	111	157	32	1	46	0.0217391
NODE_303605_length_157_cov_1488.586207	111	157	40	2	46	0.0434783
NODE_303605_length_157_cov_1488.586207	111	157	44	1	46	0.0217391
NODE_303605_length_157_cov_1488.586207	111	157	53	1	46	0.0217391
NODE_303605_length_157_cov_1488.586207	111	157	61	3	46	0.0652174
NODE_303605_length_157_cov_1488.586207	111	157	63	1	46	0.0217391
NODE_303605_length_157_cov_1488.586207	111	157	71	1	46	0.0217391
NODE_303605_length_157_cov_1488.586207	111	157	73	1	46	0.0217391
NODE_303605_length_157_cov_1488.586207	111	157	79	1	46	0.0217391
NODE_303605_length_157_cov_1488.586207	111	157	93	3	46	0.0652174
NODE_303605_length_157_cov_1488.586207	111	157	95	1	46	0.0217391
NODE_303605_length_157_cov_1488.586207	111	157	97	1	46	0.0217391
NODE_303605_length_157_cov_1488.586207	111	157	106	1	46	0.0217391
NODE_303605_length_157_cov_1488.586207	111	157	119	1	46	0.0217391
NODE_303605_length_157_cov_1488.586207	111	157	128	1	46	0.0217391
NODE_303605_length_157_cov_1488.586207	111	157	132	2	46	0.0434783
NODE_303605_length_157_cov_1488.586207	111	157	134	1	46	0.0217391
NODE_303605_length_157_cov_1488.586207	111	157	138	1	46	0.0217391
NODE_303605_length_157_cov_1488.586207	111	157	148	1	46	0.0217391
NODE_303605_length_157_cov_1488.586207	111	157	156	1	46	0.0217391
NODE_303605_length_157_cov_1488.586207	111	157	162	4	46	0.0869565
NODE_303605_length_157_cov_1488.586207	111	157	164	2	46	0.0434783
NODE_303605_length_157_cov_1488.586207	111	157	167	2	46	0.0434783
NODE_303605_length_157_cov_1488.586207	111	157	168	1	46	0.0217391
NODE_303605_length_157_cov_1488.586207	111	157	170	3	46	0.0652174
NODE_303605_length_157_cov_1488.586207	111	157	172	1	46	0.0217391
NODE_303606_length_157_cov_295.896552	32	78	57	1	46	0.0217391
NODE_303606_length_157_cov_295.896552	32	78	59	1	46	0.0217391
NODE_303606_length_157_cov_295.896552	32	78	63	1	46	0.0217391
NODE_303606_length_157_cov_295.896552	32	78	69	2	46	0.0434783
NODE_303606_length_157_cov_295.896552	32	78	79	5	46	0.1086956
NODE_303606_length_157_cov_295.896552	32	78	81	1	46	0.0217391
NODE_303606_length_157_cov_295.896552	32	78	83	2	46	0.0434783
NODE_303606_length_157_cov_295.896552	32	78	85	1	46	0.0217391
NODE_303606_length_157_cov_295.896552	32	78	87	4	46	0.0869565
NODE_303606_length_157_cov_295.896552	32	78	89	1	46	0.0217391
NODE_303606_length_157_cov_295.896552	32	78	93	1	46	0.0217391
NODE_303606_length_157_cov_295.896552	32	78	95	10	46	0.2173913
NODE_303606_length_157_cov_295.896552	32	78	96	16	46	0.3478261
NODE_303608_length_157_cov_161.689655	0	59	0	15	59	0.2542373
NODE_303608_length_157_cov_161.689655	0	59	14	11	59	0.1864407
NODE_303608_length_157_cov_161.689655	0	59	20	23	59	0.3898305
NODE_303608_length_157_cov_161.689655	0	59	22	4	59	0.0677966
NODE_303608_length_157_cov_161.689655	0	59	24	1	59	0.0169492
NODE_303608_length_157_cov_161.689655	0	59	26	5	59	0.0847458
NODE_303608_length_157_cov_161.689655	0	59	0	15	59	0.2542373
NODE_303608_length_157_cov_161.689655	0	59	14	11	59	0.1864407
NODE_303608_length_157_cov_161.689655	0	59	20	23	59	0.3898305
NODE_303608_length_157_cov_161.689655	0	59	22	4	59	0.0677966
NODE_303608_length_157_cov_161.689655	0	59	24	1	59	0.0169492
NODE_303608_length_157_cov_161.689655	0	59	26	5	59	0.0847458
NODE_303608_length_157_cov_161.689655	55	135	22	16	80	0.2000000
NODE_303608_length_157_cov_161.689655	55	135	24	5	80	0.0625000
NODE_303608_length_157_cov_161.689655	55	135	26	59	80	0.7375000
NODE_303608_length_157_cov_161.689655	55	135	22	16	80	0.2000000
NODE_303608_length_157_cov_161.689655	55	135	24	5	80	0.0625000
NODE_303608_length_157_cov_161.689655	55	135	26	59	80	0.7375000
NODE_303608_length_157_cov_161.689655	108	157	0	1	49	0.0204082
NODE_303608_length_157_cov_161.689655	108	157	6	10	49	0.2040816
NODE_303608_length_157_cov_161.689655	108	157	8	7	49	0.1428571
NODE_303608_length_157_cov_161.689655	108	157	22	20	49	0.4081633
NODE_303608_length_157_cov_161.689655	108	157	24	5	49	0.1020408
NODE_303608_length_157_cov_161.689655	108	157	26	6	49	0.1224490
NODE_303608_length_157_cov_161.689655	113	157	0	1	44	0.0227273
NODE_303608_length_157_cov_161.689655	113	157	6	10	44	0.2272727
NODE_303608_length_157_cov_161.689655	113	157	8	7	44	0.1590909
NODE_303608_length_157_cov_161.689655	113	157	22	20	44	0.4545455
NODE_303608_length_157_cov_161.689655	113	157	24	5	44	0.1136364
NODE_303608_length_157_cov_161.689655	113	157	26	1	44	0.0227273
NODE_303677_length_156_cov_100.491228	0	41	0	15	41	0.3658537
NODE_303677_length_156_cov_100.491228	0	41	4	6	41	0.1463415
NODE_303677_length_156_cov_100.491228	0	41	6	12	41	0.2926829
NODE_303677_length_156_cov_100.491228	0	41	8	8	41	0.1951219
NODE_303677_length_156_cov_100.491228	21	94	6	12	73	0.1643836
NODE_303677_length_156_cov_100.491228	21	94	8	61	73	0.8356164
NODE_303688_length_156_cov_37.368421	24	81	12	1	57	0.0175439
NODE_303688_length_156_cov_37.368421	24	81	14	1	57	0.0175439
NODE_303688_length_156_cov_37.368421	24	81	18	3	57	0.0526316
NODE_303688_length_156_cov_37.368421	24	81	26	2	57	0.0350877
NODE_303688_length_156_cov_37.368421	24	81	30	1	57	0.0175439
NODE_303688_length_156_cov_37.368421	24	81	32	2	57	0.0350877
NODE_303688_length_156_cov_37.368421	24	81	34	3	57	0.0526316
NODE_303688_length_156_cov_37.368421	24	81	36	2	57	0.0350877
NODE_303688_length_156_cov_37.368421	24	81	37	1	57	0.0175439
NODE_303688_length_156_cov_37.368421	24	81	38	2	57	0.0350877
NODE_303688_length_156_cov_37.368421	24	81	40	1	57	0.0175439
NODE_303688_length_156_cov_37.368421	24	81	44	6	57	0.1052632
NODE_303688_length_156_cov_37.368421	24	81	46	32	57	0.5614035
NODE_303688_length_156_cov_37.368421	54	134	28	11	80	0.1375000
NODE_303688_length_156_cov_37.368421	54	134	30	7	80	0.0875000
NODE_303688_length_156_cov_37.368421	54	134	34	4	80	0.0500000
NODE_303688_length_156_cov_37.368421	54	134	36	8	80	0.1000000
NODE_303688_length_156_cov_37.368421	54	134	46	50	80	0.6250000
NODE_303700_length_156_cov_9.543860	2	48	0	46	46	1.0000000
NODE_303700_length_156_cov_9.543860	59	105	0	46	46	1.0000000
NODE_303752_length_155_cov_56.750000	27	102	16	75	75	1.0000000
NODE_303752_length_155_cov_56.750000	80	155	0	2	75	0.0266667
NODE_303752_length_155_cov_56.750000	80	155	3	1	75	0.0133333
NODE_303752_length_155_cov_56.750000	80	155	6	6	75	0.0800000
NODE_303752_length_155_cov_56.750000	80	155	11	1	75	0.0133333
NODE_303752_length_155_cov_56.750000	80	155	12	36	75	0.4800000
NODE_303752_length_155_cov_56.750000	80	155	16	29	75	0.3866667
NODE_304022_length_153_cov_0.944444	5	48	0	43	43	1.0000000
NODE_304022_length_153_cov_0.944444	37	86	0	49	49	1.0000000
NODE_304022_length_153_cov_0.944444	59	102	0	43	43	1.0000000
NODE_304022_length_153_cov_0.944444	91	140	0	49	49	1.0000000
NODE_304022_length_153_cov_0.944444	113	153	0	40	40	1.0000000
NODE_304027_length_152_cov_195.396226	9	89	8	12	80	0.1500000
NODE_304027_length_152_cov_195.396226	9	89	16	20	80	0.2500000
NODE_304027_length_152_cov_195.396226	9	89	18	48	80	0.6000000
NODE_304027_length_152_cov_195.396226	9	89	8	12	80	0.1500000
NODE_304027_length_152_cov_195.396226	9	89	16	20	80	0.2500000
NODE_304027_length_152_cov_195.396226	9	89	18	48	80	0.6000000
NODE_304027_length_152_cov_195.396226	85	149	0	19	64	0.2968750
NODE_304027_length_152_cov_195.396226	85	149	2	2	64	0.0312500
NODE_304027_length_152_cov_195.396226	85	149	9	23	64	0.3593750
NODE_304027_length_152_cov_195.396226	85	149	18	20	64	0.3125000
NODE_304027_length_152_cov_195.396226	85	152	0	22	67	0.3283582
NODE_304027_length_152_cov_195.396226	85	152	2	2	67	0.0298507
NODE_304027_length_152_cov_195.396226	85	152	9	23	67	0.3432836
NODE_304027_length_152_cov_195.396226	85	152	18	20	67	0.2985075
NODE_304027_length_152_cov_195.396226	85	152	0	22	67	0.3283582
NODE_304027_length_152_cov_195.396226	85	152	2	2	67	0.0298507
NODE_304027_length_152_cov_195.396226	85	152	9	23	67	0.3432836
NODE_304027_length_152_cov_195.396226	85	152	18	20	67	0.2985075
NODE_304027_length_152_cov_195.396226	85	152	0	22	67	0.3283582
NODE_304027_length_152_cov_195.396226	85	152	2	2	67	0.0298507
NODE_304027_length_152_cov_195.396226	85	152	9	23	67	0.3432836
NODE_304027_length_152_cov_195.396226	85	152	18	20	67	0.2985075
NODE_304030_length_152_cov_68.094340	99	150	8	13	51	0.2549020
NODE_304030_length_152_cov_68.094340	99	150	10	17	51	0.3333333
NODE_304030_length_152_cov_68.094340	99	150	12	21	51	0.4117647
NODE_304112_length_151_cov_541.615385	19	88	21	8	69	0.1159420
NODE_304112_length_151_cov_541.615385	19	88	26	1	69	0.0144928
NODE_304112_length_151_cov_541.615385	19	88	28	4	69	0.0579710
NODE_304112_length_151_cov_541.615385	19	88	30	8	69	0.1159420
NODE_304112_length_151_cov_541.615385	19	88	32	1	69	0.0144928
NODE_304112_length_151_cov_541.615385	19	88	34	3	69	0.0434783
NODE_304112_length_151_cov_541.615385	19	88	38	44	69	0.6376812
NODE_304112_length_151_cov_541.615385	72	149	10	3	77	0.0389610
NODE_304112_length_151_cov_541.615385	72	149	12	9	77	0.1168831
NODE_304112_length_151_cov_541.615385	72	149	20	3	77	0.0389610
NODE_304112_length_151_cov_541.615385	72	149	22	5	77	0.0649351
NODE_304112_length_151_cov_541.615385	72	149	24	3	77	0.0389610
NODE_304112_length_151_cov_541.615385	72	149	27	1	77	0.0129870
NODE_304112_length_151_cov_541.615385	72	149	30	3	77	0.0389610
NODE_304112_length_151_cov_541.615385	72	149	32	7	77	0.0909091
NODE_304112_length_151_cov_541.615385	72	149	33	1	77	0.0129870
NODE_304112_length_151_cov_541.615385	72	149	34	1	77	0.0129870
NODE_304112_length_151_cov_541.615385	72	149	36	1	77	0.0129870
NODE_304112_length_151_cov_541.615385	72	149	38	40	77	0.5194805
NODE_304229_length_150_cov_88.647059	51	102	0	51	51	1.0000000
NODE_304472_length_148_cov_34.183673	23	99	33	2	76	0.0263158
NODE_304472_length_148_cov_34.183673	23	99	39	1	76	0.0131579
NODE_304472_length_148_cov_34.183673	23	99	45	1	76	0.0131579
NODE_304472_length_148_cov_34.183673	23	99	49	1	76	0.0131579
NODE_304472_length_148_cov_34.183673	23	99	55	1	76	0.0131579
NODE_304472_length_148_cov_34.183673	23	99	56	1	76	0.0131579
NODE_304472_length_148_cov_34.183673	23	99	58	2	76	0.0263158
NODE_304472_length_148_cov_34.183673	23	99	60	1	76	0.0131579
NODE_304472_length_148_cov_34.183673	23	99	62	3	76	0.0394737
NODE_304472_length_148_cov_34.183673	23	99	64	2	76	0.0263158
NODE_304472_length_148_cov_34.183673	23	99	66	3	76	0.0394737
NODE_304472_length_148_cov_34.183673	23	99	68	58	76	0.7631579
NODE_304570_length_147_cov_472.354167	0	55	6	2	55	0.0363636
NODE_304570_length_147_cov_472.354167	0	55	12	1	55	0.0181818
NODE_304570_length_147_cov_472.354167	0	55	16	1	55	0.0181818
NODE_304570_length_147_cov_472.354167	0	55	19	2	55	0.0363636
NODE_304570_length_147_cov_472.354167	0	55	25	1	55	0.0181818
NODE_304570_length_147_cov_472.354167	0	55	26	2	55	0.0363636
NODE_304570_length_147_cov_472.354167	0	55	34	2	55	0.0363636
NODE_304570_length_147_cov_472.354167	0	55	36	1	55	0.0181818
NODE_304570_length_147_cov_472.354167	0	55	38	1	55	0.0181818
NODE_304570_length_147_cov_472.354167	0	55	39	1	55	0.0181818
NODE_304570_length_147_cov_472.354167	0	55	41	2	55	0.0363636
NODE_304570_length_147_cov_472.354167	0	55	43	1	55	0.0181818
NODE_304570_length_147_cov_472.354167	0	55	45	1	55	0.0181818
NODE_304570_length_147_cov_472.354167	0	55	47	1	55	0.0181818
NODE_304570_length_147_cov_472.354167	0	55	49	1	55	0.0181818
NODE_304570_length_147_cov_472.354167	0	55	53	1	55	0.0181818
NODE_304570_length_147_cov_472.354167	0	55	57	1	55	0.0181818
NODE_304570_length_147_cov_472.354167	0	55	59	1	55	0.0181818
NODE_304570_length_147_cov_472.354167	0	55	61	1	55	0.0181818
NODE_304570_length_147_cov_472.354167	0	55	65	2	55	0.0363636
NODE_304570_length_147_cov_472.354167	0	55	67	2	55	0.0363636
NODE_304570_length_147_cov_472.354167	0	55	69	1	55	0.0181818
NODE_304570_length_147_cov_472.354167	0	55	71	3	55	0.0545455
NODE_304570_length_147_cov_472.354167	0	55	74	1	55	0.0181818
NODE_304570_length_147_cov_472.354167	0	55	75	4	55	0.0727273
NODE_304570_length_147_cov_472.354167	0	55	77	2	55	0.0363636
NODE_304570_length_147_cov_472.354167	0	55	78	1	55	0.0181818
NODE_304570_length_147_cov_472.354167	0	55	79	2	55	0.0363636
NODE_304570_length_147_cov_472.354167	0	55	80	13	55	0.2363636
NODE_304570_length_147_cov_472.354167	12	89	38	1	77	0.0129870
NODE_304570_length_147_cov_472.354167	12	89	39	1	77	0.0129870
NODE_304570_length_147_cov_472.354167	12	89	41	2	77	0.0259740
NODE_304570_length_147_cov_472.354167	12	89	43	1	77	0.0129870
NODE_304570_length_147_cov_472.354167	12	89	45	1	77	0.0129870
NODE_304570_length_147_cov_472.354167	12	89	47	1	77	0.0129870
NODE_304570_length_147_cov_472.354167	12	89	49	1	77	0.0129870
NODE_304570_length_147_cov_472.354167	12	89	53	1	77	0.0129870
NODE_304570_length_147_cov_472.354167	12	89	57	1	77	0.0129870
NODE_304570_length_147_cov_472.354167	12	89	59	1	77	0.0129870
NODE_304570_length_147_cov_472.354167	12	89	61	1	77	0.0129870
NODE_304570_length_147_cov_472.354167	12	89	65	2	77	0.0259740
NODE_304570_length_147_cov_472.354167	12	89	67	2	77	0.0259740
NODE_304570_length_147_cov_472.354167	12	89	69	1	77	0.0129870
NODE_304570_length_147_cov_472.354167	12	89	71	3	77	0.0389610
NODE_304570_length_147_cov_472.354167	12	89	74	1	77	0.0129870
NODE_304570_length_147_cov_472.354167	12	89	75	4	77	0.0519481
NODE_304570_length_147_cov_472.354167	12	89	77	2	77	0.0259740
NODE_304570_length_147_cov_472.354167	12	89	78	1	77	0.0129870
NODE_304570_length_147_cov_472.354167	12	89	79	2	77	0.0259740
NODE_304570_length_147_cov_472.354167	12	89	80	47	77	0.6103896
NODE_304570_length_147_cov_472.354167	65	137	28	3	72	0.0416667
NODE_304570_length_147_cov_472.354167	65	137	30	4	72	0.0555556
NODE_304570_length_147_cov_472.354167	65	137	32	2	72	0.0277778
NODE_304570_length_147_cov_472.354167	65	137	38	2	72	0.0277778
NODE_304570_length_147_cov_472.354167	65	137	42	1	72	0.0138889
NODE_304570_length_147_cov_472.354167	65	137	44	1	72	0.0138889
NODE_304570_length_147_cov_472.354167	65	137	46	1	72	0.0138889
NODE_304570_length_147_cov_472.354167	65	137	48	1	72	0.0138889
NODE_304570_length_147_cov_472.354167	65	137	52	1	72	0.0138889
NODE_304570_length_147_cov_472.354167	65	137	54	2	72	0.0277778
NODE_304570_length_147_cov_472.354167	65	137	56	3	72	0.0416667
NODE_304570_length_147_cov_472.354167	65	137	58	1	72	0.0138889
NODE_304570_length_147_cov_472.354167	65	137	60	3	72	0.0416667
NODE_304570_length_147_cov_472.354167	65	137	68	2	72	0.0277778
NODE_304570_length_147_cov_472.354167	65	137	74	5	72	0.0694444
NODE_304570_length_147_cov_472.354167	65	137	78	2	72	0.0277778
NODE_304570_length_147_cov_472.354167	65	137	80	38	72	0.5277778
NODE_304572_length_147_cov_229.729167	7	56	34	1	49	0.0204082
NODE_304572_length_147_cov_229.729167	7	56	39	1	49	0.0204082
NODE_304572_length_147_cov_229.729167	7	56	40	2	49	0.0408163
NODE_304572_length_147_cov_229.729167	7	56	44	3	49	0.0612245
NODE_304572_length_147_cov_229.729167	7	56	49	1	49	0.0204082
NODE_304572_length_147_cov_229.729167	7	56	52	1	49	0.0204082
NODE_304572_length_147_cov_229.729167	7	56	56	3	49	0.0612245
NODE_304572_length_147_cov_229.729167	7	56	62	1	49	0.0204082
NODE_304572_length_147_cov_229.729167	7	56	76	2	49	0.0408163
NODE_304572_length_147_cov_229.729167	7	56	84	1	49	0.0204082
NODE_304572_length_147_cov_229.729167	7	56	87	1	49	0.0204082
NODE_304572_length_147_cov_229.729167	7	56	91	1	49	0.0204082
NODE_304572_length_147_cov_229.729167	7	56	103	1	49	0.0204082
NODE_304572_length_147_cov_229.729167	7	56	105	3	49	0.0612245
NODE_304572_length_147_cov_229.729167	7	56	115	1	49	0.0204082
NODE_304572_length_147_cov_229.729167	7	56	116	1	49	0.0204082
NODE_304572_length_147_cov_229.729167	7	56	120	2	49	0.0408163
NODE_304572_length_147_cov_229.729167	7	56	124	1	49	0.0204082
NODE_304572_length_147_cov_229.729167	7	56	130	1	49	0.0204082
NODE_304572_length_147_cov_229.729167	7	56	142	1	49	0.0204082
NODE_304572_length_147_cov_229.729167	7	56	144	3	49	0.0612245
NODE_304572_length_147_cov_229.729167	7	56	150	4	49	0.0816327
NODE_304572_length_147_cov_229.729167	7	56	152	13	49	0.2653061
NODE_304572_length_147_cov_229.729167	29	93	115	1	64	0.0156250
NODE_304572_length_147_cov_229.729167	29	93	116	1	64	0.0156250
NODE_304572_length_147_cov_229.729167	29	93	120	2	64	0.0312500
NODE_304572_length_147_cov_229.729167	29	93	124	1	64	0.0156250
NODE_304572_length_147_cov_229.729167	29	93	130	1	64	0.0156250
NODE_304572_length_147_cov_229.729167	29	93	142	1	64	0.0156250
NODE_304572_length_147_cov_229.729167	29	93	144	3	64	0.0468750
NODE_304572_length_147_cov_229.729167	29	93	150	4	64	0.0625000
NODE_304572_length_147_cov_229.729167	29	93	152	50	64	0.7812500
NODE_304572_length_147_cov_229.729167	29	93	115	1	64	0.0156250
NODE_304572_length_147_cov_229.729167	29	93	116	1	64	0.0156250
NODE_304572_length_147_cov_229.729167	29	93	120	2	64	0.0312500
NODE_304572_length_147_cov_229.729167	29	93	124	1	64	0.0156250
NODE_304572_length_147_cov_229.729167	29	93	130	1	64	0.0156250
NODE_304572_length_147_cov_229.729167	29	93	142	1	64	0.0156250
NODE_304572_length_147_cov_229.729167	29	93	144	3	64	0.0468750
NODE_304572_length_147_cov_229.729167	29	93	150	4	64	0.0625000
NODE_304572_length_147_cov_229.729167	29	93	152	50	64	0.7812500
NODE_304572_length_147_cov_229.729167	29	93	115	1	64	0.0156250
NODE_304572_length_147_cov_229.729167	29	93	116	1	64	0.0156250
NODE_304572_length_147_cov_229.729167	29	93	120	2	64	0.0312500
NODE_304572_length_147_cov_229.729167	29	93	124	1	64	0.0156250
NODE_304572_length_147_cov_229.729167	29	93	130	1	64	0.0156250
NODE_304572_length_147_cov_229.729167	29	93	142	1	64	0.0156250
NODE_304572_length_147_cov_229.729167	29	93	144	3	64	0.0468750
NODE_304572_length_147_cov_229.729167	29	93	150	4	64	0.0625000
NODE_304572_length_147_cov_229.729167	29	93	152	50	64	0.7812500
NODE_304573_length_147_cov_213.770833	37	117	0	80	80	1.0000000
NODE_304573_length_147_cov_213.770833	90	146	0	56	56	1.0000000
NODE_304697_length_146_cov_182.893617	1	60	2	10	59	0.1694915
NODE_304697_length_146_cov_182.893617	1	60	6	49	59	0.8305085
NODE_304697_length_146_cov_182.893617	34	60	6	26	26	1.0000000
NODE_304697_length_146_cov_182.893617	113	144	0	5	31	0.1612903
NODE_304697_length_146_cov_182.893617	113	144	2	25	31	0.8064516
NODE_304697_length_146_cov_182.893617	113	144	4	1	31	0.0322581
NODE_304698_length_146_cov_152.808511	0	69	0	69	69	1.0000000
NODE_304698_length_146_cov_152.808511	42	122	0	80	80	1.0000000
NODE_304703_length_146_cov_89.808511	0	53	0	53	53	1.0000000
NODE_304703_length_146_cov_89.808511	26	106	0	80	80	1.0000000
NODE_304703_length_146_cov_89.808511	74	146	0	72	72	1.0000000
NODE_304703_length_146_cov_89.808511	79	101	0	22	22	1.0000000
NODE_304707_length_146_cov_57.446809	44	124	0	80	80	1.0000000
NODE_304708_length_146_cov_54.106383	0	69	0	69	69	1.0000000
NODE_304708_length_146_cov_54.106383	42	122	0	80	80	1.0000000
NODE_304710_length_146_cov_46.765957	3	83	0	10	80	0.1250000
NODE_304710_length_146_cov_46.765957	3	83	4	5	80	0.0625000
NODE_304710_length_146_cov_46.765957	3	83	10	14	80	0.1750000
NODE_304710_length_146_cov_46.765957	3	83	14	6	80	0.0750000
NODE_304710_length_146_cov_46.765957	3	83	18	45	80	0.5625000
NODE_304710_length_146_cov_46.765957	3	83	0	10	80	0.1250000
NODE_304710_length_146_cov_46.765957	3	83	4	5	80	0.0625000
NODE_304710_length_146_cov_46.765957	3	83	10	14	80	0.1750000
NODE_304710_length_146_cov_46.765957	3	83	14	6	80	0.0750000
NODE_304710_length_146_cov_46.765957	3	83	18	45	80	0.5625000
NODE_304710_length_146_cov_46.765957	3	83	0	10	80	0.1250000
NODE_304710_length_146_cov_46.765957	3	83	4	5	80	0.0625000
NODE_304710_length_146_cov_46.765957	3	83	10	14	80	0.1750000
NODE_304710_length_146_cov_46.765957	3	83	14	6	80	0.0750000
NODE_304710_length_146_cov_46.765957	3	83	18	45	80	0.5625000
NODE_304710_length_146_cov_46.765957	3	83	0	10	80	0.1250000
NODE_304710_length_146_cov_46.765957	3	83	4	5	80	0.0625000
NODE_304710_length_146_cov_46.765957	3	83	10	14	80	0.1750000
NODE_304710_length_146_cov_46.765957	3	83	14	6	80	0.0750000
NODE_304710_length_146_cov_46.765957	3	83	18	45	80	0.5625000
NODE_304710_length_146_cov_46.765957	3	83	0	10	80	0.1250000
NODE_304710_length_146_cov_46.765957	3	83	4	5	80	0.0625000
NODE_304710_length_146_cov_46.765957	3	83	10	14	80	0.1750000
NODE_304710_length_146_cov_46.765957	3	83	14	6	80	0.0750000
NODE_304710_length_146_cov_46.765957	3	83	18	45	80	0.5625000
NODE_304710_length_146_cov_46.765957	12	83	0	1	71	0.0140845
NODE_304710_length_146_cov_46.765957	12	83	4	5	71	0.0704225
NODE_304710_length_146_cov_46.765957	12	83	10	14	71	0.1971831
NODE_304710_length_146_cov_46.765957	12	83	14	6	71	0.0845070
NODE_304710_length_146_cov_46.765957	12	83	18	45	71	0.6338028
NODE_304710_length_146_cov_46.765957	56	136	4	4	80	0.0500000
NODE_304710_length_146_cov_46.765957	56	136	10	2	80	0.0250000
NODE_304710_length_146_cov_46.765957	56	136	14	8	80	0.1000000
NODE_304710_length_146_cov_46.765957	56	136	18	66	80	0.8250000
NODE_304710_length_146_cov_46.765957	56	136	4	4	80	0.0500000
NODE_304710_length_146_cov_46.765957	56	136	10	2	80	0.0250000
NODE_304710_length_146_cov_46.765957	56	136	14	8	80	0.1000000
NODE_304710_length_146_cov_46.765957	56	136	18	66	80	0.8250000
NODE_304711_length_146_cov_44.021277	0	69	0	69	69	1.0000000
NODE_304711_length_146_cov_44.021277	42	122	0	80	80	1.0000000
NODE_304798_length_145_cov_1385.413043	0	69	68	1	69	0.0144928
NODE_304798_length_145_cov_1385.413043	0	69	70	1	69	0.0144928
NODE_304798_length_145_cov_1385.413043	0	69	84	1	69	0.0144928
NODE_304798_length_145_cov_1385.413043	0	69	91	1	69	0.0144928
NODE_304798_length_145_cov_1385.413043	0	69	95	2	69	0.0289855
NODE_304798_length_145_cov_1385.413043	0	69	102	1	69	0.0144928
NODE_304798_length_145_cov_1385.413043	0	69	106	1	69	0.0144928
NODE_304798_length_145_cov_1385.413043	0	69	112	1	69	0.0144928
NODE_304798_length_145_cov_1385.413043	0	69	124	1	69	0.0144928
NODE_304798_length_145_cov_1385.413043	0	69	142	1	69	0.0144928
NODE_304798_length_145_cov_1385.413043	0	69	148	1	69	0.0144928
NODE_304798_length_145_cov_1385.413043	0	69	166	1	69	0.0144928
NODE_304798_length_145_cov_1385.413043	0	69	169	1	69	0.0144928
NODE_304798_length_145_cov_1385.413043	0	69	185	1	69	0.0144928
NODE_304798_length_145_cov_1385.413043	0	69	199	1	69	0.0144928
NODE_304798_length_145_cov_1385.413043	0	69	208	1	69	0.0144928
NODE_304798_length_145_cov_1385.413043	0	69	234	1	69	0.0144928
NODE_304798_length_145_cov_1385.413043	0	69	239	1	69	0.0144928
NODE_304798_length_145_cov_1385.413043	0	69	256	1	69	0.0144928
NODE_304798_length_145_cov_1385.413043	0	69	263	1	69	0.0144928
NODE_304798_length_145_cov_1385.413043	0	69	267	1	69	0.0144928
NODE_304798_length_145_cov_1385.413043	0	69	290	1	69	0.0144928
NODE_304798_length_145_cov_1385.413043	0	69	292	1	69	0.0144928
NODE_304798_length_145_cov_1385.413043	0	69	294	2	69	0.0289855
NODE_304798_length_145_cov_1385.413043	0	69	300	1	69	0.0144928
NODE_304798_length_145_cov_1385.413043	0	69	312	1	69	0.0144928
NODE_304798_length_145_cov_1385.413043	0	69	316	1	69	0.0144928
NODE_304798_length_145_cov_1385.413043	0	69	322	1	69	0.0144928
NODE_304798_length_145_cov_1385.413043	0	69	323	1	69	0.0144928
NODE_304798_length_145_cov_1385.413043	0	69	351	1	69	0.0144928
NODE_304798_length_145_cov_1385.413043	0	69	354	1	69	0.0144928
NODE_304798_length_145_cov_1385.413043	0	69	377	1	69	0.0144928
NODE_304798_length_145_cov_1385.413043	0	69	382	2	69	0.0289855
NODE_304798_length_145_cov_1385.413043	0	69	386	2	69	0.0289855
NODE_304798_length_145_cov_1385.413043	0	69	398	1	69	0.0144928
NODE_304798_length_145_cov_1385.413043	0	69	409	1	69	0.0144928
NODE_304798_length_145_cov_1385.413043	0	69	429	1	69	0.0144928
NODE_304798_length_145_cov_1385.413043	0	69	430	1	69	0.0144928
NODE_304798_length_145_cov_1385.413043	0	69	432	2	69	0.0289855
NODE_304798_length_145_cov_1385.413043	0	69	433	6	69	0.0869565
NODE_304798_length_145_cov_1385.413043	0	69	434	19	69	0.2753623
NODE_304798_length_145_cov_1385.413043	42	122	258	1	80	0.0125000
NODE_304798_length_145_cov_1385.413043	42	122	288	1	80	0.0125000
NODE_304798_length_145_cov_1385.413043	42	122	302	1	80	0.0125000
NODE_304798_length_145_cov_1385.413043	42	122	305	2	80	0.0250000
NODE_304798_length_145_cov_1385.413043	42	122	309	1	80	0.0125000
NODE_304798_length_145_cov_1385.413043	42	122	313	1	80	0.0125000
NODE_304798_length_145_cov_1385.413043	42	122	333	1	80	0.0125000
NODE_304798_length_145_cov_1385.413043	42	122	341	1	80	0.0125000
NODE_304798_length_145_cov_1385.413043	42	122	367	1	80	0.0125000
NODE_304798_length_145_cov_1385.413043	42	122	369	1	80	0.0125000
NODE_304798_length_145_cov_1385.413043	42	122	371	1	80	0.0125000
NODE_304798_length_145_cov_1385.413043	42	122	377	1	80	0.0125000
NODE_304798_length_145_cov_1385.413043	42	122	385	1	80	0.0125000
NODE_304798_length_145_cov_1385.413043	42	122	403	1	80	0.0125000
NODE_304798_length_145_cov_1385.413043	42	122	405	1	80	0.0125000
NODE_304798_length_145_cov_1385.413043	42	122	410	1	80	0.0125000
NODE_304798_length_145_cov_1385.413043	42	122	421	1	80	0.0125000
NODE_304798_length_145_cov_1385.413043	42	122	427	2	80	0.0250000
NODE_304798_length_145_cov_1385.413043	42	122	431	7	80	0.0875000
NODE_304798_length_145_cov_1385.413043	42	122	432	14	80	0.1750000
NODE_304798_length_145_cov_1385.413043	42	122	433	12	80	0.1500000
NODE_304798_length_145_cov_1385.413043	42	122	434	27	80	0.3375000
NODE_304799_length_145_cov_880.369565	56	120	326	1	64	0.0156250
NODE_304799_length_145_cov_880.369565	56	120	332	1	64	0.0156250
NODE_304799_length_145_cov_880.369565	56	120	334	1	64	0.0156250
NODE_304799_length_145_cov_880.369565	56	120	338	1	64	0.0156250
NODE_304799_length_145_cov_880.369565	56	120	352	1	64	0.0156250
NODE_304799_length_145_cov_880.369565	56	120	358	1	64	0.0156250
NODE_304799_length_145_cov_880.369565	56	120	376	1	64	0.0156250
NODE_304799_length_145_cov_880.369565	56	120	378	1	64	0.0156250
NODE_304799_length_145_cov_880.369565	56	120	396	1	64	0.0156250
NODE_304799_length_145_cov_880.369565	56	120	400	1	64	0.0156250
NODE_304799_length_145_cov_880.369565	56	120	410	1	64	0.0156250
NODE_304799_length_145_cov_880.369565	56	120	412	1	64	0.0156250
NODE_304799_length_145_cov_880.369565	56	120	420	1	64	0.0156250
NODE_304799_length_145_cov_880.369565	56	120	421	1	64	0.0156250
NODE_304799_length_145_cov_880.369565	56	120	429	2	64	0.0312500
NODE_304799_length_145_cov_880.369565	56	120	435	1	64	0.0156250
NODE_304799_length_145_cov_880.369565	56	120	438	1	64	0.0156250
NODE_304799_length_145_cov_880.369565	56	120	444	1	64	0.0156250
NODE_304799_length_145_cov_880.369565	56	120	447	45	64	0.7031250
NODE_304799_length_145_cov_880.369565	56	120	326	1	64	0.0156250
NODE_304799_length_145_cov_880.369565	56	120	332	1	64	0.0156250
NODE_304799_length_145_cov_880.369565	56	120	334	1	64	0.0156250
NODE_304799_length_145_cov_880.369565	56	120	338	1	64	0.0156250
NODE_304799_length_145_cov_880.369565	56	120	352	1	64	0.0156250
NODE_304799_length_145_cov_880.369565	56	120	358	1	64	0.0156250
NODE_304799_length_145_cov_880.369565	56	120	376	1	64	0.0156250
NODE_304799_length_145_cov_880.369565	56	120	378	1	64	0.0156250
NODE_304799_length_145_cov_880.369565	56	120	396	1	64	0.0156250
NODE_304799_length_145_cov_880.369565	56	120	400	1	64	0.0156250
NODE_304799_length_145_cov_880.369565	56	120	410	1	64	0.0156250
NODE_304799_length_145_cov_880.369565	56	120	412	1	64	0.0156250
NODE_304799_length_145_cov_880.369565	56	120	420	1	64	0.0156250
NODE_304799_length_145_cov_880.369565	56	120	421	1	64	0.0156250
NODE_304799_length_145_cov_880.369565	56	120	429	2	64	0.0312500
NODE_304799_length_145_cov_880.369565	56	120	435	1	64	0.0156250
NODE_304799_length_145_cov_880.369565	56	120	438	1	64	0.0156250
NODE_304799_length_145_cov_880.369565	56	120	444	1	64	0.0156250
NODE_304799_length_145_cov_880.369565	56	120	447	45	64	0.7031250
NODE_304799_length_145_cov_880.369565	56	120	326	1	64	0.0156250
NODE_304799_length_145_cov_880.369565	56	120	332	1	64	0.0156250
NODE_304799_length_145_cov_880.369565	56	120	334	1	64	0.0156250
NODE_304799_length_145_cov_880.369565	56	120	338	1	64	0.0156250
NODE_304799_length_145_cov_880.369565	56	120	352	1	64	0.0156250
NODE_304799_length_145_cov_880.369565	56	120	358	1	64	0.0156250
NODE_304799_length_145_cov_880.369565	56	120	376	1	64	0.0156250
NODE_304799_length_145_cov_880.369565	56	120	378	1	64	0.0156250
NODE_304799_length_145_cov_880.369565	56	120	396	1	64	0.0156250
NODE_304799_length_145_cov_880.369565	56	120	400	1	64	0.0156250
NODE_304799_length_145_cov_880.369565	56	120	410	1	64	0.0156250
NODE_304799_length_145_cov_880.369565	56	120	412	1	64	0.0156250
NODE_304799_length_145_cov_880.369565	56	120	420	1	64	0.0156250
NODE_304799_length_145_cov_880.369565	56	120	421	1	64	0.0156250
NODE_304799_length_145_cov_880.369565	56	120	429	2	64	0.0312500
NODE_304799_length_145_cov_880.369565	56	120	435	1	64	0.0156250
NODE_304799_length_145_cov_880.369565	56	120	438	1	64	0.0156250
NODE_304799_length_145_cov_880.369565	56	120	444	1	64	0.0156250
NODE_304799_length_145_cov_880.369565	56	120	447	45	64	0.7031250
NODE_304799_length_145_cov_880.369565	93	142	36	1	49	0.0204082
NODE_304799_length_145_cov_880.369565	93	142	58	1	49	0.0204082
NODE_304799_length_145_cov_880.369565	93	142	61	1	49	0.0204082
NODE_304799_length_145_cov_880.369565	93	142	67	1	49	0.0204082
NODE_304799_length_145_cov_880.369565	93	142	77	1	49	0.0204082
NODE_304799_length_145_cov_880.369565	93	142	83	1	49	0.0204082
NODE_304799_length_145_cov_880.369565	93	142	89	1	49	0.0204082
NODE_304799_length_145_cov_880.369565	93	142	126	1	49	0.0204082
NODE_304799_length_145_cov_880.369565	93	142	157	1	49	0.0204082
NODE_304799_length_145_cov_880.369565	93	142	159	1	49	0.0204082
NODE_304799_length_145_cov_880.369565	93	142	171	1	49	0.0204082
NODE_304799_length_145_cov_880.369565	93	142	179	1	49	0.0204082
NODE_304799_length_145_cov_880.369565	93	142	195	1	49	0.0204082
NODE_304799_length_145_cov_880.369565	93	142	204	1	49	0.0204082
NODE_304799_length_145_cov_880.369565	93	142	213	1	49	0.0204082
NODE_304799_length_145_cov_880.369565	93	142	219	1	49	0.0204082
NODE_304799_length_145_cov_880.369565	93	142	233	1	49	0.0204082
NODE_304799_length_145_cov_880.369565	93	142	259	1	49	0.0204082
NODE_304799_length_145_cov_880.369565	93	142	275	2	49	0.0408163
NODE_304799_length_145_cov_880.369565	93	142	283	1	49	0.0204082
NODE_304799_length_145_cov_880.369565	93	142	295	1	49	0.0204082
NODE_304799_length_145_cov_880.369565	93	142	326	1	49	0.0204082
NODE_304799_length_145_cov_880.369565	93	142	332	1	49	0.0204082
NODE_304799_length_145_cov_880.369565	93	142	334	1	49	0.0204082
NODE_304799_length_145_cov_880.369565	93	142	338	1	49	0.0204082
NODE_304799_length_145_cov_880.369565	93	142	352	1	49	0.0204082
NODE_304799_length_145_cov_880.369565	93	142	358	1	49	0.0204082
NODE_304799_length_145_cov_880.369565	93	142	376	1	49	0.0204082
NODE_304799_length_145_cov_880.369565	93	142	378	1	49	0.0204082
NODE_304799_length_145_cov_880.369565	93	142	396	1	49	0.0204082
NODE_304799_length_145_cov_880.369565	93	142	400	1	49	0.0204082
NODE_304799_length_145_cov_880.369565	93	142	410	1	49	0.0204082
NODE_304799_length_145_cov_880.369565	93	142	412	1	49	0.0204082
NODE_304799_length_145_cov_880.369565	93	142	420	1	49	0.0204082
NODE_304799_length_145_cov_880.369565	93	142	421	1	49	0.0204082
NODE_304799_length_145_cov_880.369565	93	142	429	2	49	0.0408163
NODE_304799_length_145_cov_880.369565	93	142	435	1	49	0.0204082
NODE_304799_length_145_cov_880.369565	93	142	438	1	49	0.0204082
NODE_304799_length_145_cov_880.369565	93	142	444	1	49	0.0204082
NODE_304799_length_145_cov_880.369565	93	142	447	8	49	0.1632653
NODE_304923_length_144_cov_46.155556	1	81	0	2	80	0.0250000
NODE_304923_length_144_cov_46.155556	1	81	1	2	80	0.0250000
NODE_304923_length_144_cov_46.155556	1	81	4	4	80	0.0500000
NODE_304923_length_144_cov_46.155556	1	81	5	1	80	0.0125000
NODE_304923_length_144_cov_46.155556	1	81	6	1	80	0.0125000
NODE_304923_length_144_cov_46.155556	1	81	8	4	80	0.0500000
NODE_304923_length_144_cov_46.155556	1	81	10	5	80	0.0625000
NODE_304923_length_144_cov_46.155556	1	81	14	5	80	0.0625000
NODE_304923_length_144_cov_46.155556	1	81	16	4	80	0.0500000
NODE_304923_length_144_cov_46.155556	1	81	18	1	80	0.0125000
NODE_304923_length_144_cov_46.155556	1	81	20	1	80	0.0125000
NODE_304923_length_144_cov_46.155556	1	81	22	10	80	0.1250000
NODE_304923_length_144_cov_46.155556	1	81	24	40	80	0.5000000
NODE_305208_length_142_cov_244.488372	0	52	0	3	52	0.0576923
NODE_305208_length_142_cov_244.488372	0	52	2	1	52	0.0192308
NODE_305208_length_142_cov_244.488372	0	52	4	5	52	0.0961538
NODE_305208_length_142_cov_244.488372	0	52	6	1	52	0.0192308
NODE_305208_length_142_cov_244.488372	0	52	12	4	52	0.0769231
NODE_305208_length_142_cov_244.488372	0	52	14	3	52	0.0576923
NODE_305208_length_142_cov_244.488372	0	52	16	1	52	0.0192308
NODE_305208_length_142_cov_244.488372	0	52	20	1	52	0.0192308
NODE_305208_length_142_cov_244.488372	0	52	22	1	52	0.0192308
NODE_305208_length_142_cov_244.488372	0	52	24	1	52	0.0192308
NODE_305208_length_142_cov_244.488372	0	52	26	10	52	0.1923077
NODE_305208_length_142_cov_244.488372	0	52	30	21	52	0.4038461
NODE_305229_length_142_cov_46.976744	1	65	11	2	64	0.0312500
NODE_305229_length_142_cov_46.976744	1	65	12	1	64	0.0156250
NODE_305229_length_142_cov_46.976744	1	65	14	1	64	0.0156250
NODE_305229_length_142_cov_46.976744	1	65	18	4	64	0.0625000
NODE_305229_length_142_cov_46.976744	1	65	24	2	64	0.0312500
NODE_305229_length_142_cov_46.976744	1	65	29	3	64	0.0468750
NODE_305229_length_142_cov_46.976744	1	65	34	3	64	0.0468750
NODE_305229_length_142_cov_46.976744	1	65	38	1	64	0.0156250
NODE_305229_length_142_cov_46.976744	1	65	40	1	64	0.0156250
NODE_305229_length_142_cov_46.976744	1	65	44	4	64	0.0625000
NODE_305229_length_142_cov_46.976744	1	65	46	2	64	0.0312500
NODE_305229_length_142_cov_46.976744	1	65	48	1	64	0.0156250
NODE_305229_length_142_cov_46.976744	1	65	50	39	64	0.6093750
NODE_305229_length_142_cov_46.976744	1	65	11	2	64	0.0312500
NODE_305229_length_142_cov_46.976744	1	65	12	1	64	0.0156250
NODE_305229_length_142_cov_46.976744	1	65	14	1	64	0.0156250
NODE_305229_length_142_cov_46.976744	1	65	18	4	64	0.0625000
NODE_305229_length_142_cov_46.976744	1	65	24	2	64	0.0312500
NODE_305229_length_142_cov_46.976744	1	65	29	3	64	0.0468750
NODE_305229_length_142_cov_46.976744	1	65	34	3	64	0.0468750
NODE_305229_length_142_cov_46.976744	1	65	38	1	64	0.0156250
NODE_305229_length_142_cov_46.976744	1	65	40	1	64	0.0156250
NODE_305229_length_142_cov_46.976744	1	65	44	4	64	0.0625000
NODE_305229_length_142_cov_46.976744	1	65	46	2	64	0.0312500
NODE_305229_length_142_cov_46.976744	1	65	48	1	64	0.0156250
NODE_305229_length_142_cov_46.976744	1	65	50	39	64	0.6093750
NODE_305229_length_142_cov_46.976744	1	65	11	2	64	0.0312500
NODE_305229_length_142_cov_46.976744	1	65	12	1	64	0.0156250
NODE_305229_length_142_cov_46.976744	1	65	14	1	64	0.0156250
NODE_305229_length_142_cov_46.976744	1	65	18	4	64	0.0625000
NODE_305229_length_142_cov_46.976744	1	65	24	2	64	0.0312500
NODE_305229_length_142_cov_46.976744	1	65	29	3	64	0.0468750
NODE_305229_length_142_cov_46.976744	1	65	34	3	64	0.0468750
NODE_305229_length_142_cov_46.976744	1	65	38	1	64	0.0156250
NODE_305229_length_142_cov_46.976744	1	65	40	1	64	0.0156250
NODE_305229_length_142_cov_46.976744	1	65	44	4	64	0.0625000
NODE_305229_length_142_cov_46.976744	1	65	46	2	64	0.0312500
NODE_305229_length_142_cov_46.976744	1	65	48	1	64	0.0156250
NODE_305229_length_142_cov_46.976744	1	65	50	39	64	0.6093750
NODE_305230_length_142_cov_45.000000	0	69	0	4	69	0.0579710
NODE_305230_length_142_cov_45.000000	0	69	4	26	69	0.3768116
NODE_305230_length_142_cov_45.000000	0	69	6	39	69	0.5652174
NODE_305385_length_141_cov_178.785714	58	118	166	2	60	0.0333333
NODE_305385_length_141_cov_178.785714	58	118	170	1	60	0.0166667
NODE_305385_length_141_cov_178.785714	58	118	174	1	60	0.0166667
NODE_305385_length_141_cov_178.785714	58	118	176	7	60	0.1166667
NODE_305385_length_141_cov_178.785714	58	118	178	3	60	0.0500000
NODE_305385_length_141_cov_178.785714	58	118	182	46	60	0.7666667
NODE_305398_length_141_cov_62.285714	26	106	0	80	80	1.0000000
NODE_305398_length_141_cov_62.285714	26	106	0	80	80	1.0000000
NODE_305398_length_141_cov_62.285714	26	97	0	71	71	1.0000000
NODE_305402_length_141_cov_41.142857	26	97	0	71	71	1.0000000
NODE_305600_length_140_cov_60.439024	8	88	2	4	80	0.0500000
NODE_305600_length_140_cov_60.439024	8	88	8	76	80	0.9500000
NODE_305600_length_140_cov_60.439024	8	88	2	4	80	0.0500000
NODE_305600_length_140_cov_60.439024	8	88	8	76	80	0.9500000
NODE_305600_length_140_cov_60.439024	8	88	2	4	80	0.0500000
NODE_305600_length_140_cov_60.439024	8	88	8	76	80	0.9500000
NODE_305600_length_140_cov_60.439024	8	88	2	4	80	0.0500000
NODE_305600_length_140_cov_60.439024	8	88	8	76	80	0.9500000
NODE_305600_length_140_cov_60.439024	8	88	2	4	80	0.0500000
NODE_305600_length_140_cov_60.439024	8	88	8	76	80	0.9500000
NODE_305616_length_140_cov_35.146341	22	102	0	10	80	0.1250000
NODE_305616_length_140_cov_35.146341	22	102	2	1	80	0.0125000
NODE_305616_length_140_cov_35.146341	22	102	6	69	80	0.8625000
NODE_305616_length_140_cov_35.146341	75	105	6	30	30	1.0000000
NODE_305618_length_140_cov_34.048780	0	77	0	32	77	0.4155844
NODE_305618_length_140_cov_34.048780	0	77	5	1	77	0.0129870
NODE_305618_length_140_cov_34.048780	0	77	6	44	77	0.5714286
NODE_305618_length_140_cov_34.048780	0	77	0	32	77	0.4155844
NODE_305618_length_140_cov_34.048780	0	77	5	1	77	0.0129870
NODE_305618_length_140_cov_34.048780	0	77	6	44	77	0.5714286
NODE_305618_length_140_cov_34.048780	50	130	0	12	80	0.1500000
NODE_305618_length_140_cov_34.048780	50	130	6	68	80	0.8500000
NODE_305618_length_140_cov_34.048780	50	130	0	12	80	0.1500000
NODE_305618_length_140_cov_34.048780	50	130	6	68	80	0.8500000
NODE_305618_length_140_cov_34.048780	55	130	0	12	75	0.1600000
NODE_305618_length_140_cov_34.048780	55	130	6	63	75	0.8400000
NODE_305619_length_140_cov_19.926829	44	118	0	74	74	1.0000000
NODE_305783_length_139_cov_29.700000	0	40	0	2	40	0.0500000
NODE_305783_length_139_cov_29.700000	0	40	2	6	40	0.1500000
NODE_305783_length_139_cov_29.700000	0	40	6	9	40	0.2250000
NODE_305783_length_139_cov_29.700000	0	40	12	6	40	0.1500000
NODE_305783_length_139_cov_29.700000	0	40	14	7	40	0.1750000
NODE_305783_length_139_cov_29.700000	0	40	16	4	40	0.1000000
NODE_305783_length_139_cov_29.700000	0	40	18	6	40	0.1500000
NODE_305783_length_139_cov_29.700000	0	40	0	2	40	0.0500000
NODE_305783_length_139_cov_29.700000	0	40	2	6	40	0.1500000
NODE_305783_length_139_cov_29.700000	0	40	6	9	40	0.2250000
NODE_305783_length_139_cov_29.700000	0	40	12	6	40	0.1500000
NODE_305783_length_139_cov_29.700000	0	40	14	7	40	0.1750000
NODE_305783_length_139_cov_29.700000	0	40	16	4	40	0.1000000
NODE_305783_length_139_cov_29.700000	0	40	18	6	40	0.1500000
NODE_305783_length_139_cov_29.700000	13	93	6	4	80	0.0500000
NODE_305783_length_139_cov_29.700000	13	93	12	6	80	0.0750000
NODE_305783_length_139_cov_29.700000	13	93	14	7	80	0.0875000
NODE_305783_length_139_cov_29.700000	13	93	16	4	80	0.0500000
NODE_305783_length_139_cov_29.700000	13	93	18	59	80	0.7375000
NODE_305783_length_139_cov_29.700000	13	93	6	4	80	0.0500000
NODE_305783_length_139_cov_29.700000	13	93	12	6	80	0.0750000
NODE_305783_length_139_cov_29.700000	13	93	14	7	80	0.0875000
NODE_305783_length_139_cov_29.700000	13	93	16	4	80	0.0500000
NODE_305783_length_139_cov_29.700000	13	93	18	59	80	0.7375000
NODE_305783_length_139_cov_29.700000	13	93	6	4	80	0.0500000
NODE_305783_length_139_cov_29.700000	13	93	12	6	80	0.0750000
NODE_305783_length_139_cov_29.700000	13	93	14	7	80	0.0875000
NODE_305783_length_139_cov_29.700000	13	93	16	4	80	0.0500000
NODE_305783_length_139_cov_29.700000	13	93	18	59	80	0.7375000
NODE_305783_length_139_cov_29.700000	13	93	6	4	80	0.0500000
NODE_305783_length_139_cov_29.700000	13	93	12	6	80	0.0750000
NODE_305783_length_139_cov_29.700000	13	93	14	7	80	0.0875000
NODE_305783_length_139_cov_29.700000	13	93	16	4	80	0.0500000
NODE_305783_length_139_cov_29.700000	13	93	18	59	80	0.7375000
NODE_305783_length_139_cov_29.700000	13	93	6	4	80	0.0500000
NODE_305783_length_139_cov_29.700000	13	93	12	6	80	0.0750000
NODE_305783_length_139_cov_29.700000	13	93	14	7	80	0.0875000
NODE_305783_length_139_cov_29.700000	13	93	16	4	80	0.0500000
NODE_305783_length_139_cov_29.700000	13	93	18	59	80	0.7375000
NODE_305783_length_139_cov_29.700000	13	84	6	4	71	0.0563380
NODE_305783_length_139_cov_29.700000	13	84	12	6	71	0.0845070
NODE_305783_length_139_cov_29.700000	13	84	14	7	71	0.0985916
NODE_305783_length_139_cov_29.700000	13	84	16	4	71	0.0563380
NODE_305783_length_139_cov_29.700000	13	84	18	50	71	0.7042254
NODE_305936_length_138_cov_1475.615385	30	97	110	1	67	0.0149254
NODE_305936_length_138_cov_1475.615385	30	97	114	3	67	0.0447761
NODE_305936_length_138_cov_1475.615385	30	97	116	1	67	0.0149254
NODE_305936_length_138_cov_1475.615385	30	97	117	1	67	0.0149254
NODE_305936_length_138_cov_1475.615385	30	97	120	52	67	0.7761194
NODE_305936_length_138_cov_1475.615385	30	97	121	9	67	0.1343284
NODE_305936_length_138_cov_1475.615385	70	138	74	1	68	0.0147059
NODE_305936_length_138_cov_1475.615385	70	138	75	1	68	0.0147059
NODE_305936_length_138_cov_1475.615385	70	138	79	1	68	0.0147059
NODE_305936_length_138_cov_1475.615385	70	138	89	2	68	0.0294118
NODE_305936_length_138_cov_1475.615385	70	138	93	1	68	0.0147059
NODE_305936_length_138_cov_1475.615385	70	138	97	10	68	0.1470588
NODE_305936_length_138_cov_1475.615385	70	138	99	1	68	0.0147059
NODE_305936_length_138_cov_1475.615385	70	138	103	2	68	0.0294118
NODE_305936_length_138_cov_1475.615385	70	138	105	3	68	0.0441176
NODE_305936_length_138_cov_1475.615385	70	138	107	2	68	0.0294118
NODE_305936_length_138_cov_1475.615385	70	138	109	1	68	0.0147059
NODE_305936_length_138_cov_1475.615385	70	138	115	9	68	0.1323529
NODE_305936_length_138_cov_1475.615385	70	138	117	1	68	0.0147059
NODE_305936_length_138_cov_1475.615385	70	138	119	1	68	0.0147059
NODE_305936_length_138_cov_1475.615385	70	138	120	23	68	0.3382353
NODE_305936_length_138_cov_1475.615385	70	138	121	9	68	0.1323529
NODE_305963_length_138_cov_29.564103	11	91	10	24	80	0.3000000
NODE_305963_length_138_cov_29.564103	11	91	22	56	80	0.7000000
NODE_305963_length_138_cov_29.564103	11	91	10	24	80	0.3000000
NODE_305963_length_138_cov_29.564103	11	91	22	56	80	0.7000000
NODE_305963_length_138_cov_29.564103	64	128	8	6	64	0.0937500
NODE_305963_length_138_cov_29.564103	64	128	12	2	64	0.0312500
NODE_305963_length_138_cov_29.564103	64	128	20	2	64	0.0312500
NODE_305963_length_138_cov_29.564103	64	128	22	54	64	0.8437500
NODE_305963_length_138_cov_29.564103	64	128	8	6	64	0.0937500
NODE_305963_length_138_cov_29.564103	64	128	12	2	64	0.0312500
NODE_305963_length_138_cov_29.564103	64	128	20	2	64	0.0312500
NODE_305963_length_138_cov_29.564103	64	128	22	54	64	0.8437500
NODE_306081_length_137_cov_185.684211	20	104	10	4	84	0.0476190
NODE_306081_length_137_cov_185.684211	20	104	13	2	84	0.0238095
NODE_306081_length_137_cov_185.684211	20	104	14	78	84	0.9285714
NODE_306092_length_137_cov_58.289474	76	106	30	1	30	0.0333333
NODE_306092_length_137_cov_58.289474	76	106	32	2	30	0.0666667
NODE_306092_length_137_cov_58.289474	76	106	36	3	30	0.1000000
NODE_306092_length_137_cov_58.289474	76	106	38	24	30	0.8000000
NODE_306099_length_137_cov_36.473684	31	111	18	2	80	0.0250000
NODE_306099_length_137_cov_36.473684	31	111	20	78	80	0.9750000
NODE_306208_length_136_cov_1257.621622	27	107	52	1	80	0.0125000
NODE_306208_length_136_cov_1257.621622	27	107	54	3	80	0.0375000
NODE_306208_length_136_cov_1257.621622	27	107	56	3	80	0.0375000
NODE_306208_length_136_cov_1257.621622	27	107	57	1	80	0.0125000
NODE_306208_length_136_cov_1257.621622	27	107	58	72	80	0.9000000
NODE_306209_length_136_cov_769.594595	0	69	4	1	69	0.0144928
NODE_306209_length_136_cov_769.594595	0	69	6	2	69	0.0289855
NODE_306209_length_136_cov_769.594595	0	69	8	1	69	0.0144928
NODE_306209_length_136_cov_769.594595	0	69	10	5	69	0.0724638
NODE_306209_length_136_cov_769.594595	0	69	16	21	69	0.3043478
NODE_306209_length_136_cov_769.594595	0	69	18	39	69	0.5652174
NODE_306222_length_136_cov_128.324324	39	119	16	3	80	0.0375000
NODE_306222_length_136_cov_128.324324	39	119	18	8	80	0.1000000
NODE_306222_length_136_cov_128.324324	39	119	20	69	80	0.8625000
NODE_306227_length_136_cov_90.783784	10	86	0	22	76	0.2894737
NODE_306227_length_136_cov_90.783784	10	86	2	54	76	0.7105263
NODE_306227_length_136_cov_90.783784	59	136	0	20	77	0.2597403
NODE_306227_length_136_cov_90.783784	59	136	2	57	77	0.7402598
NODE_306368_length_135_cov_2144.166667	0	73	32	1	73	0.0136986
NODE_306368_length_135_cov_2144.166667	0	73	44	2	73	0.0273973
NODE_306368_length_135_cov_2144.166667	0	73	56	1	73	0.0136986
NODE_306368_length_135_cov_2144.166667	0	73	60	1	73	0.0136986
NODE_306368_length_135_cov_2144.166667	0	73	66	1	73	0.0136986
NODE_306368_length_135_cov_2144.166667	0	73	86	1	73	0.0136986
NODE_306368_length_135_cov_2144.166667	0	73	92	1	73	0.0136986
NODE_306368_length_135_cov_2144.166667	0	73	96	1	73	0.0136986
NODE_306368_length_135_cov_2144.166667	0	73	102	1	73	0.0136986
NODE_306368_length_135_cov_2144.166667	0	73	104	1	73	0.0136986
NODE_306368_length_135_cov_2144.166667	0	73	110	1	73	0.0136986
NODE_306368_length_135_cov_2144.166667	0	73	112	1	73	0.0136986
NODE_306368_length_135_cov_2144.166667	0	73	120	1	73	0.0136986
NODE_306368_length_135_cov_2144.166667	0	73	142	2	73	0.0273973
NODE_306368_length_135_cov_2144.166667	0	73	144	2	73	0.0273973
NODE_306368_length_135_cov_2144.166667	0	73	148	1	73	0.0136986
NODE_306368_length_135_cov_2144.166667	0	73	159	3	73	0.0410959
NODE_306368_length_135_cov_2144.166667	0	73	169	1	73	0.0136986
NODE_306368_length_135_cov_2144.166667	0	73	173	1	73	0.0136986
NODE_306368_length_135_cov_2144.166667	0	73	180	1	73	0.0136986
NODE_306368_length_135_cov_2144.166667	0	73	184	1	73	0.0136986
NODE_306368_length_135_cov_2144.166667	0	73	186	2	73	0.0273973
NODE_306368_length_135_cov_2144.166667	0	73	204	2	73	0.0273973
NODE_306368_length_135_cov_2144.166667	0	73	206	1	73	0.0136986
NODE_306368_length_135_cov_2144.166667	0	73	212	42	73	0.5753425
NODE_306368_length_135_cov_2144.166667	46	126	40	2	80	0.0250000
NODE_306368_length_135_cov_2144.166667	46	126	51	1	80	0.0125000
NODE_306368_length_135_cov_2144.166667	46	126	56	1	80	0.0125000
NODE_306368_length_135_cov_2144.166667	46	126	62	1	80	0.0125000
NODE_306368_length_135_cov_2144.166667	46	126	82	1	80	0.0125000
NODE_306368_length_135_cov_2144.166667	46	126	98	1	80	0.0125000
NODE_306368_length_135_cov_2144.166667	46	126	106	1	80	0.0125000
NODE_306368_length_135_cov_2144.166667	46	126	134	1	80	0.0125000
NODE_306368_length_135_cov_2144.166667	46	126	142	1	80	0.0125000
NODE_306368_length_135_cov_2144.166667	46	126	146	1	80	0.0125000
NODE_306368_length_135_cov_2144.166667	46	126	150	1	80	0.0125000
NODE_306368_length_135_cov_2144.166667	46	126	154	1	80	0.0125000
NODE_306368_length_135_cov_2144.166667	46	126	170	1	80	0.0125000
NODE_306368_length_135_cov_2144.166667	46	126	178	1	80	0.0125000
NODE_306368_length_135_cov_2144.166667	46	126	180	1	80	0.0125000
NODE_306368_length_135_cov_2144.166667	46	126	184	1	80	0.0125000
NODE_306368_length_135_cov_2144.166667	46	126	190	1	80	0.0125000
NODE_306368_length_135_cov_2144.166667	46	126	200	2	80	0.0250000
NODE_306368_length_135_cov_2144.166667	46	126	202	2	80	0.0250000
NODE_306368_length_135_cov_2144.166667	46	126	204	1	80	0.0125000
NODE_306368_length_135_cov_2144.166667	46	126	211	1	80	0.0125000
NODE_306368_length_135_cov_2144.166667	46	126	212	56	80	0.7000000
NODE_306368_length_135_cov_2144.166667	83	135	4	2	52	0.0384615
NODE_306368_length_135_cov_2144.166667	83	135	24	1	52	0.0192308
NODE_306368_length_135_cov_2144.166667	83	135	26	2	52	0.0384615
NODE_306368_length_135_cov_2144.166667	83	135	34	1	52	0.0192308
NODE_306368_length_135_cov_2144.166667	83	135	36	1	52	0.0192308
NODE_306368_length_135_cov_2144.166667	83	135	38	1	52	0.0192308
NODE_306368_length_135_cov_2144.166667	83	135	40	3	52	0.0576923
NODE_306368_length_135_cov_2144.166667	83	135	51	1	52	0.0192308
NODE_306368_length_135_cov_2144.166667	83	135	56	1	52	0.0192308
NODE_306368_length_135_cov_2144.166667	83	135	62	1	52	0.0192308
NODE_306368_length_135_cov_2144.166667	83	135	82	1	52	0.0192308
NODE_306368_length_135_cov_2144.166667	83	135	98	1	52	0.0192308
NODE_306368_length_135_cov_2144.166667	83	135	106	1	52	0.0192308
NODE_306368_length_135_cov_2144.166667	83	135	134	1	52	0.0192308
NODE_306368_length_135_cov_2144.166667	83	135	142	1	52	0.0192308
NODE_306368_length_135_cov_2144.166667	83	135	146	1	52	0.0192308
NODE_306368_length_135_cov_2144.166667	83	135	150	1	52	0.0192308
NODE_306368_length_135_cov_2144.166667	83	135	154	1	52	0.0192308
NODE_306368_length_135_cov_2144.166667	83	135	170	1	52	0.0192308
NODE_306368_length_135_cov_2144.166667	83	135	178	1	52	0.0192308
NODE_306368_length_135_cov_2144.166667	83	135	180	1	52	0.0192308
NODE_306368_length_135_cov_2144.166667	83	135	184	1	52	0.0192308
NODE_306368_length_135_cov_2144.166667	83	135	190	1	52	0.0192308
NODE_306368_length_135_cov_2144.166667	83	135	200	2	52	0.0384615
NODE_306368_length_135_cov_2144.166667	83	135	202	2	52	0.0384615
NODE_306368_length_135_cov_2144.166667	83	135	204	1	52	0.0192308
NODE_306368_length_135_cov_2144.166667	83	135	211	1	52	0.0192308
NODE_306368_length_135_cov_2144.166667	83	135	212	19	52	0.3653846
NODE_306370_length_135_cov_630.194444	0	76	14	1	76	0.0131579
NODE_306370_length_135_cov_630.194444	0	76	18	3	76	0.0394737
NODE_306370_length_135_cov_630.194444	0	76	23	1	76	0.0131579
NODE_306370_length_135_cov_630.194444	0	76	25	1	76	0.0131579
NODE_306370_length_135_cov_630.194444	0	76	29	2	76	0.0263158
NODE_306370_length_135_cov_630.194444	0	76	30	3	76	0.0394737
NODE_306370_length_135_cov_630.194444	0	76	36	2	76	0.0263158
NODE_306370_length_135_cov_630.194444	0	76	48	1	76	0.0131579
NODE_306370_length_135_cov_630.194444	0	76	50	1	76	0.0131579
NODE_306370_length_135_cov_630.194444	0	76	52	1	76	0.0131579
NODE_306370_length_135_cov_630.194444	0	76	58	3	76	0.0394737
NODE_306370_length_135_cov_630.194444	0	76	64	2	76	0.0263158
NODE_306370_length_135_cov_630.194444	0	76	66	4	76	0.0526316
NODE_306370_length_135_cov_630.194444	0	76	68	8	76	0.1052632
NODE_306370_length_135_cov_630.194444	0	76	70	43	76	0.5657895
NODE_306371_length_135_cov_540.611111	0	76	18	2	76	0.0263158
NODE_306371_length_135_cov_540.611111	0	76	28	1	76	0.0131579
NODE_306371_length_135_cov_540.611111	0	76	32	1	76	0.0131579
NODE_306371_length_135_cov_540.611111	0	76	44	2	76	0.0263158
NODE_306371_length_135_cov_540.611111	0	76	52	1	76	0.0131579
NODE_306371_length_135_cov_540.611111	0	76	60	2	76	0.0263158
NODE_306371_length_135_cov_540.611111	0	76	68	2	76	0.0263158
NODE_306371_length_135_cov_540.611111	0	76	72	1	76	0.0131579
NODE_306371_length_135_cov_540.611111	0	76	74	1	76	0.0131579
NODE_306371_length_135_cov_540.611111	0	76	84	1	76	0.0131579
NODE_306371_length_135_cov_540.611111	0	76	86	1	76	0.0131579
NODE_306371_length_135_cov_540.611111	0	76	90	1	76	0.0131579
NODE_306371_length_135_cov_540.611111	0	76	98	1	76	0.0131579
NODE_306371_length_135_cov_540.611111	0	76	100	1	76	0.0131579
NODE_306371_length_135_cov_540.611111	0	76	102	3	76	0.0394737
NODE_306371_length_135_cov_540.611111	0	76	104	3	76	0.0394737
NODE_306371_length_135_cov_540.611111	0	76	106	1	76	0.0131579
NODE_306371_length_135_cov_540.611111	0	76	108	1	76	0.0131579
NODE_306371_length_135_cov_540.611111	0	76	112	3	76	0.0394737
NODE_306371_length_135_cov_540.611111	0	76	116	47	76	0.6184211
NODE_306373_length_135_cov_257.416667	36	88	16	52	52	1.0000000
NODE_306374_length_135_cov_239.638889	97	135	6	1	38	0.0263158
NODE_306374_length_135_cov_239.638889	97	135	10	1	38	0.0263158
NODE_306374_length_135_cov_239.638889	97	135	14	2	38	0.0526316
NODE_306374_length_135_cov_239.638889	97	135	22	2	38	0.0526316
NODE_306374_length_135_cov_239.638889	97	135	24	2	38	0.0526316
NODE_306374_length_135_cov_239.638889	97	135	26	1	38	0.0263158
NODE_306374_length_135_cov_239.638889	97	135	36	1	38	0.0263158
NODE_306374_length_135_cov_239.638889	97	135	39	1	38	0.0263158
NODE_306374_length_135_cov_239.638889	97	135	48	1	38	0.0263158
NODE_306374_length_135_cov_239.638889	97	135	50	1	38	0.0263158
NODE_306374_length_135_cov_239.638889	97	135	56	2	38	0.0526316
NODE_306374_length_135_cov_239.638889	97	135	62	3	38	0.0789474
NODE_306374_length_135_cov_239.638889	97	135	66	3	38	0.0789474
NODE_306374_length_135_cov_239.638889	97	135	68	1	38	0.0263158
NODE_306374_length_135_cov_239.638889	97	135	74	1	38	0.0263158
NODE_306374_length_135_cov_239.638889	97	135	82	4	38	0.1052632
NODE_306374_length_135_cov_239.638889	97	135	84	2	38	0.0526316
NODE_306374_length_135_cov_239.638889	97	135	89	4	38	0.1052632
NODE_306374_length_135_cov_239.638889	97	135	98	5	38	0.1315790
NODE_306400_length_135_cov_35.055556	8	88	10	2	80	0.0250000
NODE_306400_length_135_cov_35.055556	8	88	14	78	80	0.9750000
NODE_306400_length_135_cov_35.055556	61	125	2	16	64	0.2500000
NODE_306400_length_135_cov_35.055556	61	125	6	1	64	0.0156250
NODE_306400_length_135_cov_35.055556	61	125	14	47	64	0.7343750
NODE_306400_length_135_cov_35.055556	61	125	2	16	64	0.2500000
NODE_306400_length_135_cov_35.055556	61	125	6	1	64	0.0156250
NODE_306400_length_135_cov_35.055556	61	125	14	47	64	0.7343750
NODE_306402_length_135_cov_31.805556	0	76	0	11	76	0.1447368
NODE_306402_length_135_cov_31.805556	0	76	2	65	76	0.8552632
NODE_306658_length_133_cov_140.411765	8	43	0	35	35	1.0000000
NODE_306658_length_133_cov_140.411765	53	88	0	35	35	1.0000000
NODE_306658_length_133_cov_140.411765	98	133	0	35	35	1.0000000
NODE_306661_length_133_cov_109.441176	63	129	0	2	66	0.0303030
NODE_306661_length_133_cov_109.441176	63	129	2	8	66	0.1212121
NODE_306661_length_133_cov_109.441176	63	129	6	4	66	0.0606061
NODE_306661_length_133_cov_109.441176	63	129	8	2	66	0.0303030
NODE_306661_length_133_cov_109.441176	63	129	10	50	66	0.7575758
NODE_306812_length_132_cov_114.151515	2	44	0	6	42	0.1428571
NODE_306812_length_132_cov_114.151515	2	44	2	12	42	0.2857143
NODE_306812_length_132_cov_114.151515	2	44	6	24	42	0.5714286
NODE_306812_length_132_cov_114.151515	4	44	0	4	40	0.1000000
NODE_306812_length_132_cov_114.151515	4	44	2	12	40	0.3000000
NODE_306812_length_132_cov_114.151515	4	44	6	24	40	0.6000000
NODE_306812_length_132_cov_114.151515	17	83	2	3	66	0.0454545
NODE_306812_length_132_cov_114.151515	17	83	6	63	66	0.9545454
NODE_306812_length_132_cov_114.151515	17	88	2	3	71	0.0422535
NODE_306812_length_132_cov_114.151515	17	88	6	68	71	0.9577465
NODE_306824_length_132_cov_61.636364	3	76	2	1	73	0.0136986
NODE_306824_length_132_cov_61.636364	3	76	4	4	73	0.0547945
NODE_306824_length_132_cov_61.636364	3	76	6	1	73	0.0136986
NODE_306824_length_132_cov_61.636364	3	76	10	3	73	0.0410959
NODE_306824_length_132_cov_61.636364	3	76	12	1	73	0.0136986
NODE_306824_length_132_cov_61.636364	3	76	14	4	73	0.0547945
NODE_306824_length_132_cov_61.636364	3	76	16	4	73	0.0547945
NODE_306824_length_132_cov_61.636364	3	76	18	55	73	0.7534246
NODE_306824_length_132_cov_61.636364	49	130	0	5	81	0.0617284
NODE_306824_length_132_cov_61.636364	49	130	2	1	81	0.0123457
NODE_306824_length_132_cov_61.636364	49	130	4	2	81	0.0246914
NODE_306824_length_132_cov_61.636364	49	130	8	5	81	0.0617284
NODE_306824_length_132_cov_61.636364	49	130	10	2	81	0.0246914
NODE_306824_length_132_cov_61.636364	49	130	12	8	81	0.0987654
NODE_306824_length_132_cov_61.636364	49	130	14	3	81	0.0370370
NODE_306824_length_132_cov_61.636364	49	130	18	55	81	0.6790124
NODE_306824_length_132_cov_61.636364	103	125	2	1	22	0.0454545
NODE_306824_length_132_cov_61.636364	103	125	4	2	22	0.0909091
NODE_306824_length_132_cov_61.636364	103	125	8	5	22	0.2272727
NODE_306824_length_132_cov_61.636364	103	125	10	2	22	0.0909091
NODE_306824_length_132_cov_61.636364	103	125	12	8	22	0.3636364
NODE_306824_length_132_cov_61.636364	103	125	14	3	22	0.1363636
NODE_306824_length_132_cov_61.636364	103	125	18	1	22	0.0454545
NODE_306834_length_132_cov_33.393939	2	83	0	81	81	1.0000000
NODE_306834_length_132_cov_33.393939	7	29	0	22	22	1.0000000
NODE_306834_length_132_cov_33.393939	56	129	0	73	73	1.0000000
NODE_306965_length_131_cov_810.000000	0	60	50	1	60	0.0166667
NODE_306965_length_131_cov_810.000000	0	60	60	1	60	0.0166667
NODE_306965_length_131_cov_810.000000	0	60	73	1	60	0.0166667
NODE_306965_length_131_cov_810.000000	0	60	82	1	60	0.0166667
NODE_306965_length_131_cov_810.000000	0	60	102	1	60	0.0166667
NODE_306965_length_131_cov_810.000000	0	60	108	1	60	0.0166667
NODE_306965_length_131_cov_810.000000	0	60	110	1	60	0.0166667
NODE_306965_length_131_cov_810.000000	0	60	123	1	60	0.0166667
NODE_306965_length_131_cov_810.000000	0	60	130	1	60	0.0166667
NODE_306965_length_131_cov_810.000000	0	60	140	1	60	0.0166667
NODE_306965_length_131_cov_810.000000	0	60	142	1	60	0.0166667
NODE_306965_length_131_cov_810.000000	0	60	154	1	60	0.0166667
NODE_306965_length_131_cov_810.000000	0	60	178	1	60	0.0166667
NODE_306965_length_131_cov_810.000000	0	60	182	1	60	0.0166667
NODE_306965_length_131_cov_810.000000	0	60	194	1	60	0.0166667
NODE_306965_length_131_cov_810.000000	0	60	196	1	60	0.0166667
NODE_306965_length_131_cov_810.000000	0	60	208	1	60	0.0166667
NODE_306965_length_131_cov_810.000000	0	60	218	1	60	0.0166667
NODE_306965_length_131_cov_810.000000	0	60	225	1	60	0.0166667
NODE_306965_length_131_cov_810.000000	0	60	241	1	60	0.0166667
NODE_306965_length_131_cov_810.000000	0	60	245	1	60	0.0166667
NODE_306965_length_131_cov_810.000000	0	60	247	1	60	0.0166667
NODE_306965_length_131_cov_810.000000	0	60	249	1	60	0.0166667
NODE_306965_length_131_cov_810.000000	0	60	253	1	60	0.0166667
NODE_306965_length_131_cov_810.000000	0	60	261	1	60	0.0166667
NODE_306965_length_131_cov_810.000000	0	60	264	1	60	0.0166667
NODE_306965_length_131_cov_810.000000	0	60	269	2	60	0.0333333
NODE_306965_length_131_cov_810.000000	0	60	284	1	60	0.0166667
NODE_306965_length_131_cov_810.000000	0	60	286	31	60	0.5166667
NODE_306965_length_131_cov_810.000000	33	97	286	64	64	1.0000000
NODE_306965_length_131_cov_810.000000	33	97	286	64	64	1.0000000
NODE_306965_length_131_cov_810.000000	33	97	286	64	64	1.0000000
NODE_306985_length_131_cov_149.187500	25	105	94	2	80	0.0250000
NODE_306985_length_131_cov_149.187500	25	105	98	2	80	0.0250000
NODE_306985_length_131_cov_149.187500	25	105	102	76	80	0.9500000
NODE_306985_length_131_cov_149.187500	78	131	13	1	53	0.0188679
NODE_306985_length_131_cov_149.187500	78	131	16	3	53	0.0566038
NODE_306985_length_131_cov_149.187500	78	131	36	1	53	0.0188679
NODE_306985_length_131_cov_149.187500	78	131	38	2	53	0.0377358
NODE_306985_length_131_cov_149.187500	78	131	40	1	53	0.0188679
NODE_306985_length_131_cov_149.187500	78	131	41	1	53	0.0188679
NODE_306985_length_131_cov_149.187500	78	131	49	1	53	0.0188679
NODE_306985_length_131_cov_149.187500	78	131	67	1	53	0.0188679
NODE_306985_length_131_cov_149.187500	78	131	76	1	53	0.0188679
NODE_306985_length_131_cov_149.187500	78	131	77	1	53	0.0188679
NODE_306985_length_131_cov_149.187500	78	131	83	1	53	0.0188679
NODE_306985_length_131_cov_149.187500	78	131	87	1	53	0.0188679
NODE_306985_length_131_cov_149.187500	78	131	91	1	53	0.0188679
NODE_306985_length_131_cov_149.187500	78	131	93	1	53	0.0188679
NODE_306985_length_131_cov_149.187500	78	131	96	1	53	0.0188679
NODE_306985_length_131_cov_149.187500	78	131	98	2	53	0.0377358
NODE_306985_length_131_cov_149.187500	78	131	100	4	53	0.0754717
NODE_306985_length_131_cov_149.187500	78	131	102	29	53	0.5471698
NODE_307121_length_130_cov_319.806452	54	126	10	3	72	0.0416667
NODE_307121_length_130_cov_319.806452	54	126	20	2	72	0.0277778
NODE_307121_length_130_cov_319.806452	54	126	22	2	72	0.0277778
NODE_307121_length_130_cov_319.806452	54	126	24	1	72	0.0138889
NODE_307121_length_130_cov_319.806452	54	126	26	1	72	0.0138889
NODE_307121_length_130_cov_319.806452	54	126	34	1	72	0.0138889
NODE_307121_length_130_cov_319.806452	54	126	38	1	72	0.0138889
NODE_307121_length_130_cov_319.806452	54	126	40	2	72	0.0277778
NODE_307121_length_130_cov_319.806452	54	126	42	1	72	0.0138889
NODE_307121_length_130_cov_319.806452	54	126	44	2	72	0.0277778
NODE_307121_length_130_cov_319.806452	54	126	50	1	72	0.0138889
NODE_307121_length_130_cov_319.806452	54	126	52	55	72	0.7638889
NODE_307132_length_130_cov_153.516129	82	113	6	31	31	1.0000000
NODE_307140_length_130_cov_79.064516	0	53	0	1	53	0.0188679
NODE_307140_length_130_cov_79.064516	0	53	2	1	53	0.0188679
NODE_307140_length_130_cov_79.064516	0	53	4	8	53	0.1509434
NODE_307140_length_130_cov_79.064516	0	53	6	4	53	0.0754717
NODE_307140_length_130_cov_79.064516	0	53	8	1	53	0.0188679
NODE_307140_length_130_cov_79.064516	0	53	10	2	53	0.0377358
NODE_307140_length_130_cov_79.064516	0	53	14	7	53	0.1320755
NODE_307140_length_130_cov_79.064516	0	53	16	3	53	0.0566038
NODE_307140_length_130_cov_79.064516	0	53	18	26	53	0.4905660
NODE_307140_length_130_cov_79.064516	26	56	16	1	30	0.0333333
NODE_307140_length_130_cov_79.064516	26	56	18	29	30	0.9666666
NODE_307270_length_129_cov_1851.133333	0	45	0	1	45	0.0222222
NODE_307270_length_129_cov_1851.133333	0	45	4	1	45	0.0222222
NODE_307270_length_129_cov_1851.133333	0	45	10	1	45	0.0222222
NODE_307270_length_129_cov_1851.133333	0	45	12	4	45	0.0888889
NODE_307270_length_129_cov_1851.133333	0	45	20	5	45	0.1111111
NODE_307270_length_129_cov_1851.133333	0	45	22	2	45	0.0444444
NODE_307270_length_129_cov_1851.133333	0	45	24	1	45	0.0222222
NODE_307270_length_129_cov_1851.133333	0	45	30	2	45	0.0444444
NODE_307270_length_129_cov_1851.133333	0	45	32	1	45	0.0222222
NODE_307270_length_129_cov_1851.133333	0	45	34	3	45	0.0666667
NODE_307270_length_129_cov_1851.133333	0	45	36	1	45	0.0222222
NODE_307270_length_129_cov_1851.133333	0	45	38	23	45	0.5111111
NODE_307270_length_129_cov_1851.133333	18	98	34	3	80	0.0375000
NODE_307270_length_129_cov_1851.133333	18	98	36	1	80	0.0125000
NODE_307270_length_129_cov_1851.133333	18	98	38	76	80	0.9500000
NODE_307285_length_129_cov_186.500000	0	78	0	4	78	0.0512821
NODE_307285_length_129_cov_186.500000	0	78	4	1	78	0.0128205
NODE_307285_length_129_cov_186.500000	0	78	6	2	78	0.0256410
NODE_307285_length_129_cov_186.500000	0	78	10	4	78	0.0512821
NODE_307285_length_129_cov_186.500000	0	78	12	12	78	0.1538462
NODE_307285_length_129_cov_186.500000	0	78	16	3	78	0.0384615
NODE_307285_length_129_cov_186.500000	0	78	18	52	78	0.6666667
NODE_307285_length_129_cov_186.500000	53	129	0	1	76	0.0131579
NODE_307285_length_129_cov_186.500000	53	129	2	3	76	0.0394737
NODE_307285_length_129_cov_186.500000	53	129	5	1	76	0.0131579
NODE_307285_length_129_cov_186.500000	53	129	6	4	76	0.0526316
NODE_307285_length_129_cov_186.500000	53	129	10	6	76	0.0789474
NODE_307285_length_129_cov_186.500000	53	129	12	12	76	0.1578947
NODE_307285_length_129_cov_186.500000	53	129	18	49	76	0.6447368
NODE_307287_length_129_cov_165.466667	36	111	12	9	75	0.1200000
NODE_307287_length_129_cov_165.466667	36	111	14	66	75	0.8800000
NODE_307287_length_129_cov_165.466667	84	113	12	11	29	0.3793103
NODE_307287_length_129_cov_165.466667	84	113	14	18	29	0.6206896
NODE_307292_length_129_cov_90.366667	0	48	16	4	48	0.0833333
NODE_307292_length_129_cov_90.366667	0	48	18	44	48	0.9166667
NODE_307292_length_129_cov_90.366667	0	48	16	4	48	0.0833333
NODE_307292_length_129_cov_90.366667	0	48	18	44	48	0.9166667
NODE_307292_length_129_cov_90.366667	0	48	16	4	48	0.0833333
NODE_307292_length_129_cov_90.366667	0	48	18	44	48	0.9166667
NODE_307292_length_129_cov_90.366667	21	101	18	80	80	1.0000000
NODE_307442_length_128_cov_2621.517241	3	83	28	1	80	0.0125000
NODE_307442_length_128_cov_2621.517241	3	83	32	1	80	0.0125000
NODE_307442_length_128_cov_2621.517241	3	83	34	1	80	0.0125000
NODE_307442_length_128_cov_2621.517241	3	83	36	1	80	0.0125000
NODE_307442_length_128_cov_2621.517241	3	83	38	1	80	0.0125000
NODE_307442_length_128_cov_2621.517241	3	83	44	1	80	0.0125000
NODE_307442_length_128_cov_2621.517241	3	83	57	1	80	0.0125000
NODE_307442_length_128_cov_2621.517241	3	83	68	1	80	0.0125000
NODE_307442_length_128_cov_2621.517241	3	83	72	2	80	0.0250000
NODE_307442_length_128_cov_2621.517241	3	83	78	1	80	0.0125000
NODE_307442_length_128_cov_2621.517241	3	83	80	2	80	0.0250000
NODE_307442_length_128_cov_2621.517241	3	83	86	2	80	0.0250000
NODE_307442_length_128_cov_2621.517241	3	83	88	2	80	0.0250000
NODE_307442_length_128_cov_2621.517241	3	83	90	1	80	0.0125000
NODE_307442_length_128_cov_2621.517241	3	83	98	1	80	0.0125000
NODE_307442_length_128_cov_2621.517241	3	83	100	2	80	0.0250000
NODE_307442_length_128_cov_2621.517241	3	83	106	2	80	0.0250000
NODE_307442_length_128_cov_2621.517241	3	83	108	57	80	0.7125000
NODE_307442_length_128_cov_2621.517241	8	30	44	1	22	0.0454545
NODE_307442_length_128_cov_2621.517241	8	30	57	1	22	0.0454545
NODE_307442_length_128_cov_2621.517241	8	30	68	1	22	0.0454545
NODE_307442_length_128_cov_2621.517241	8	30	72	2	22	0.0909091
NODE_307442_length_128_cov_2621.517241	8	30	78	1	22	0.0454545
NODE_307442_length_128_cov_2621.517241	8	30	80	2	22	0.0909091
NODE_307442_length_128_cov_2621.517241	8	30	86	2	22	0.0909091
NODE_307442_length_128_cov_2621.517241	8	30	88	2	22	0.0909091
NODE_307442_length_128_cov_2621.517241	8	30	90	1	22	0.0454545
NODE_307442_length_128_cov_2621.517241	8	30	98	1	22	0.0454545
NODE_307442_length_128_cov_2621.517241	8	30	100	2	22	0.0909091
NODE_307442_length_128_cov_2621.517241	8	30	106	2	22	0.0909091
NODE_307442_length_128_cov_2621.517241	8	30	108	4	22	0.1818182
NODE_307442_length_128_cov_2621.517241	56	128	7	2	72	0.0277778
NODE_307442_length_128_cov_2621.517241	56	128	8	2	72	0.0277778
NODE_307442_length_128_cov_2621.517241	56	128	18	6	72	0.0833333
NODE_307442_length_128_cov_2621.517241	56	128	24	1	72	0.0138889
NODE_307442_length_128_cov_2621.517241	56	128	36	1	72	0.0138889
NODE_307442_length_128_cov_2621.517241	56	128	38	1	72	0.0138889
NODE_307442_length_128_cov_2621.517241	56	128	48	1	72	0.0138889
NODE_307442_length_128_cov_2621.517241	56	128	56	2	72	0.0277778
NODE_307442_length_128_cov_2621.517241	56	128	70	1	72	0.0138889
NODE_307442_length_128_cov_2621.517241	56	128	72	1	72	0.0138889
NODE_307442_length_128_cov_2621.517241	56	128	80	1	72	0.0138889
NODE_307442_length_128_cov_2621.517241	56	128	86	1	72	0.0138889
NODE_307442_length_128_cov_2621.517241	56	128	92	1	72	0.0138889
NODE_307442_length_128_cov_2621.517241	56	128	100	1	72	0.0138889
NODE_307442_length_128_cov_2621.517241	56	128	102	1	72	0.0138889
NODE_307442_length_128_cov_2621.517241	56	128	106	3	72	0.0416667
NODE_307442_length_128_cov_2621.517241	56	128	108	46	72	0.6388889
NODE_307443_length_128_cov_1604.275862	58	127	6	3	69	0.0434783
NODE_307443_length_128_cov_1604.275862	58	127	10	3	69	0.0434783
NODE_307443_length_128_cov_1604.275862	58	127	12	18	69	0.2608696
NODE_307443_length_128_cov_1604.275862	58	127	14	1	69	0.0144928
NODE_307443_length_128_cov_1604.275862	58	127	16	35	69	0.5072464
NODE_307443_length_128_cov_1604.275862	58	127	17	9	69	0.1304348
NODE_307458_length_128_cov_79.034483	43	123	12	8	80	0.1000000
NODE_307458_length_128_cov_79.034483	43	123	14	1	80	0.0125000
NODE_307458_length_128_cov_79.034483	43	123	16	5	80	0.0625000
NODE_307458_length_128_cov_79.034483	43	123	18	1	80	0.0125000
NODE_307458_length_128_cov_79.034483	43	123	20	65	80	0.8125000
NODE_307464_length_128_cov_61.793103	5	85	4	20	80	0.2500000
NODE_307464_length_128_cov_61.793103	5	85	8	60	80	0.7500000
NODE_307549_length_127_cov_1879.785714	21	101	105	2	80	0.0250000
NODE_307549_length_127_cov_1879.785714	21	101	125	1	80	0.0125000
NODE_307549_length_127_cov_1879.785714	21	101	130	1	80	0.0125000
NODE_307549_length_127_cov_1879.785714	21	101	132	76	80	0.9500000
NODE_307549_length_127_cov_1879.785714	74	127	10	2	53	0.0377358
NODE_307549_length_127_cov_1879.785714	74	127	12	1	53	0.0188679
NODE_307549_length_127_cov_1879.785714	74	127	15	1	53	0.0188679
NODE_307549_length_127_cov_1879.785714	74	127	25	1	53	0.0188679
NODE_307549_length_127_cov_1879.785714	74	127	26	1	53	0.0188679
NODE_307549_length_127_cov_1879.785714	74	127	28	1	53	0.0188679
NODE_307549_length_127_cov_1879.785714	74	127	30	2	53	0.0377358
NODE_307549_length_127_cov_1879.785714	74	127	34	1	53	0.0188679
NODE_307549_length_127_cov_1879.785714	74	127	38	1	53	0.0188679
NODE_307549_length_127_cov_1879.785714	74	127	44	1	53	0.0188679
NODE_307549_length_127_cov_1879.785714	74	127	56	1	53	0.0188679
NODE_307549_length_127_cov_1879.785714	74	127	72	2	53	0.0377358
NODE_307549_length_127_cov_1879.785714	74	127	74	1	53	0.0188679
NODE_307549_length_127_cov_1879.785714	74	127	76	1	53	0.0188679
NODE_307549_length_127_cov_1879.785714	74	127	80	1	53	0.0188679
NODE_307549_length_127_cov_1879.785714	74	127	90	1	53	0.0188679
NODE_307549_length_127_cov_1879.785714	74	127	111	1	53	0.0188679
NODE_307549_length_127_cov_1879.785714	74	127	117	1	53	0.0188679
NODE_307549_length_127_cov_1879.785714	74	127	118	1	53	0.0188679
NODE_307549_length_127_cov_1879.785714	74	127	120	1	53	0.0188679
NODE_307549_length_127_cov_1879.785714	74	127	122	1	53	0.0188679
NODE_307549_length_127_cov_1879.785714	74	127	132	29	53	0.5471698
NODE_307583_length_127_cov_66.142857	38	118	0	13	80	0.1625000
NODE_307583_length_127_cov_66.142857	38	118	2	67	80	0.8375000
NODE_307583_length_127_cov_66.142857	47	118	0	13	71	0.1830986
NODE_307583_length_127_cov_66.142857	47	118	2	58	71	0.8169014
NODE_307590_length_127_cov_38.285714	12	86	4	74	74	1.0000000
NODE_307596_length_127_cov_30.607143	21	93	0	72	72	1.0000000
NODE_307662_length_126_cov_936.777778	24	96	11	9	72	0.1250000
NODE_307662_length_126_cov_936.777778	24	96	12	63	72	0.8750000
NODE_307675_length_126_cov_147.185185	2	66	0	8	64	0.1250000
NODE_307675_length_126_cov_147.185185	2	66	6	2	64	0.0312500
NODE_307675_length_126_cov_147.185185	2	66	8	5	64	0.0781250
NODE_307675_length_126_cov_147.185185	2	66	14	4	64	0.0625000
NODE_307675_length_126_cov_147.185185	2	66	16	1	64	0.0156250
NODE_307675_length_126_cov_147.185185	2	66	18	1	64	0.0156250
NODE_307675_length_126_cov_147.185185	2	66	23	1	64	0.0156250
NODE_307675_length_126_cov_147.185185	2	66	24	42	64	0.6562500
NODE_307675_length_126_cov_147.185185	2	66	0	8	64	0.1250000
NODE_307675_length_126_cov_147.185185	2	66	6	2	64	0.0312500
NODE_307675_length_126_cov_147.185185	2	66	8	5	64	0.0781250
NODE_307675_length_126_cov_147.185185	2	66	14	4	64	0.0625000
NODE_307675_length_126_cov_147.185185	2	66	16	1	64	0.0156250
NODE_307675_length_126_cov_147.185185	2	66	18	1	64	0.0156250
NODE_307675_length_126_cov_147.185185	2	66	23	1	64	0.0156250
NODE_307675_length_126_cov_147.185185	2	66	24	42	64	0.6562500
NODE_307675_length_126_cov_147.185185	2	66	0	8	64	0.1250000
NODE_307675_length_126_cov_147.185185	2	66	6	2	64	0.0312500
NODE_307675_length_126_cov_147.185185	2	66	8	5	64	0.0781250
NODE_307675_length_126_cov_147.185185	2	66	14	4	64	0.0625000
NODE_307675_length_126_cov_147.185185	2	66	16	1	64	0.0156250
NODE_307675_length_126_cov_147.185185	2	66	18	1	64	0.0156250
NODE_307675_length_126_cov_147.185185	2	66	23	1	64	0.0156250
NODE_307675_length_126_cov_147.185185	2	66	24	42	64	0.6562500
NODE_307675_length_126_cov_147.185185	39	99	24	60	60	1.0000000
NODE_307675_length_126_cov_147.185185	55	99	24	44	44	1.0000000
NODE_307684_length_126_cov_82.518519	44	75	0	31	31	1.0000000
NODE_307793_length_125_cov_656.807692	19	99	47	1	80	0.0125000
NODE_307793_length_125_cov_656.807692	19	99	48	2	80	0.0250000
NODE_307793_length_125_cov_656.807692	19	99	50	77	80	0.9625000
NODE_307806_length_125_cov_143.615385	52	125	6	9	73	0.1232877
NODE_307806_length_125_cov_143.615385	52	125	7	1	73	0.0136986
NODE_307806_length_125_cov_143.615385	52	125	9	4	73	0.0547945
NODE_307806_length_125_cov_143.615385	52	125	11	4	73	0.0547945
NODE_307806_length_125_cov_143.615385	52	125	13	55	73	0.7534246
NODE_307810_length_125_cov_131.923077	3	52	0	7	49	0.1428571
NODE_307810_length_125_cov_131.923077	3	52	6	1	49	0.0204082
NODE_307810_length_125_cov_131.923077	3	52	12	3	49	0.0612245
NODE_307810_length_125_cov_131.923077	3	52	16	1	49	0.0204082
NODE_307810_length_125_cov_131.923077	3	52	18	4	49	0.0816327
NODE_307810_length_125_cov_131.923077	3	52	24	1	49	0.0204082
NODE_307810_length_125_cov_131.923077	3	52	28	3	49	0.0612245
NODE_307810_length_125_cov_131.923077	3	52	30	29	49	0.5918368
NODE_307810_length_125_cov_131.923077	25	89	30	64	64	1.0000000
NODE_307810_length_125_cov_131.923077	25	89	30	64	64	1.0000000
NODE_307816_length_125_cov_102.500000	0	56	3	3	56	0.0535714
NODE_307816_length_125_cov_102.500000	0	56	7	6	56	0.1071429
NODE_307816_length_125_cov_102.500000	0	56	11	5	56	0.0892857
NODE_307816_length_125_cov_102.500000	0	56	23	1	56	0.0178571
NODE_307816_length_125_cov_102.500000	0	56	24	3	56	0.0535714
NODE_307816_length_125_cov_102.500000	0	56	26	1	56	0.0178571
NODE_307816_length_125_cov_102.500000	0	56	32	32	56	0.5714286
NODE_307816_length_125_cov_102.500000	0	56	33	5	56	0.0892857
NODE_307816_length_125_cov_102.500000	7	56	7	2	49	0.0408163
NODE_307816_length_125_cov_102.500000	7	56	11	5	49	0.1020408
NODE_307816_length_125_cov_102.500000	7	56	23	1	49	0.0204082
NODE_307816_length_125_cov_102.500000	7	56	24	3	49	0.0612245
NODE_307816_length_125_cov_102.500000	7	56	26	1	49	0.0204082
NODE_307816_length_125_cov_102.500000	7	56	32	32	49	0.6530612
NODE_307816_length_125_cov_102.500000	7	56	33	5	49	0.1020408
NODE_307816_length_125_cov_102.500000	29	114	21	5	85	0.0588235
NODE_307816_length_125_cov_102.500000	29	114	29	5	85	0.0588235
NODE_307816_length_125_cov_102.500000	29	114	32	24	85	0.2823530
NODE_307816_length_125_cov_102.500000	29	114	33	51	85	0.6000000
NODE_307816_length_125_cov_102.500000	29	114	21	5	85	0.0588235
NODE_307816_length_125_cov_102.500000	29	114	29	5	85	0.0588235
NODE_307816_length_125_cov_102.500000	29	114	32	24	85	0.2823530
NODE_307816_length_125_cov_102.500000	29	114	33	51	85	0.6000000
NODE_307816_length_125_cov_102.500000	29	114	21	5	85	0.0588235
NODE_307816_length_125_cov_102.500000	29	114	29	5	85	0.0588235
NODE_307816_length_125_cov_102.500000	29	114	32	24	85	0.2823530
NODE_307816_length_125_cov_102.500000	29	114	33	51	85	0.6000000
NODE_307839_length_125_cov_28.115385	17	90	30	1	73	0.0136986
NODE_307839_length_125_cov_28.115385	17	90	36	1	73	0.0136986
NODE_307839_length_125_cov_28.115385	17	90	38	1	73	0.0136986
NODE_307839_length_125_cov_28.115385	17	90	40	3	73	0.0410959
NODE_307839_length_125_cov_28.115385	17	90	42	67	73	0.9178082
NODE_307839_length_125_cov_28.115385	57	98	42	41	41	1.0000000
NODE_307906_length_124_cov_945.680000	0	73	0	2	73	0.0273973
NODE_307906_length_124_cov_945.680000	0	73	8	1	73	0.0136986
NODE_307906_length_124_cov_945.680000	0	73	12	7	73	0.0958904
NODE_307906_length_124_cov_945.680000	0	73	14	6	73	0.0821918
NODE_307906_length_124_cov_945.680000	0	73	16	1	73	0.0136986
NODE_307906_length_124_cov_945.680000	0	73	20	56	73	0.7671233
NODE_307906_length_124_cov_945.680000	53	124	8	9	71	0.1267606
NODE_307906_length_124_cov_945.680000	53	124	10	3	71	0.0422535
NODE_307906_length_124_cov_945.680000	53	124	12	1	71	0.0140845
NODE_307906_length_124_cov_945.680000	53	124	18	7	71	0.0985916
NODE_307906_length_124_cov_945.680000	53	124	20	51	71	0.7183099
NODE_308023_length_123_cov_1186.083333	0	76	5	1	76	0.0131579
NODE_308023_length_123_cov_1186.083333	0	76	6	1	76	0.0131579
NODE_308023_length_123_cov_1186.083333	0	76	15	1	76	0.0131579
NODE_308023_length_123_cov_1186.083333	0	76	19	3	76	0.0394737
NODE_308023_length_123_cov_1186.083333	0	76	21	1	76	0.0131579
NODE_308023_length_123_cov_1186.083333	0	76	23	1	76	0.0131579
NODE_308023_length_123_cov_1186.083333	0	76	39	3	76	0.0394737
NODE_308023_length_123_cov_1186.083333	0	76	43	2	76	0.0263158
NODE_308023_length_123_cov_1186.083333	0	76	45	7	76	0.0921053
NODE_308023_length_123_cov_1186.083333	0	76	55	43	76	0.5657895
NODE_308023_length_123_cov_1186.083333	0	76	56	13	76	0.1710526
NODE_308023_length_123_cov_1186.083333	0	76	5	1	76	0.0131579
NODE_308023_length_123_cov_1186.083333	0	76	6	1	76	0.0131579
NODE_308023_length_123_cov_1186.083333	0	76	15	1	76	0.0131579
NODE_308023_length_123_cov_1186.083333	0	76	19	3	76	0.0394737
NODE_308023_length_123_cov_1186.083333	0	76	21	1	76	0.0131579
NODE_308023_length_123_cov_1186.083333	0	76	23	1	76	0.0131579
NODE_308023_length_123_cov_1186.083333	0	76	39	3	76	0.0394737
NODE_308023_length_123_cov_1186.083333	0	76	43	2	76	0.0263158
NODE_308023_length_123_cov_1186.083333	0	76	45	7	76	0.0921053
NODE_308023_length_123_cov_1186.083333	0	76	55	43	76	0.5657895
NODE_308023_length_123_cov_1186.083333	0	76	56	13	76	0.1710526
NODE_308023_length_123_cov_1186.083333	0	76	5	1	76	0.0131579
NODE_308023_length_123_cov_1186.083333	0	76	6	1	76	0.0131579
NODE_308023_length_123_cov_1186.083333	0	76	15	1	76	0.0131579
NODE_308023_length_123_cov_1186.083333	0	76	19	3	76	0.0394737
NODE_308023_length_123_cov_1186.083333	0	76	21	1	76	0.0131579
NODE_308023_length_123_cov_1186.083333	0	76	23	1	76	0.0131579
NODE_308023_length_123_cov_1186.083333	0	76	39	3	76	0.0394737
NODE_308023_length_123_cov_1186.083333	0	76	43	2	76	0.0263158
NODE_308023_length_123_cov_1186.083333	0	76	45	7	76	0.0921053
NODE_308023_length_123_cov_1186.083333	0	76	55	43	76	0.5657895
NODE_308023_length_123_cov_1186.083333	0	76	56	13	76	0.1710526
NODE_308023_length_123_cov_1186.083333	0	76	5	1	76	0.0131579
NODE_308023_length_123_cov_1186.083333	0	76	6	1	76	0.0131579
NODE_308023_length_123_cov_1186.083333	0	76	15	1	76	0.0131579
NODE_308023_length_123_cov_1186.083333	0	76	19	3	76	0.0394737
NODE_308023_length_123_cov_1186.083333	0	76	21	1	76	0.0131579
NODE_308023_length_123_cov_1186.083333	0	76	23	1	76	0.0131579
NODE_308023_length_123_cov_1186.083333	0	76	39	3	76	0.0394737
NODE_308023_length_123_cov_1186.083333	0	76	43	2	76	0.0263158
NODE_308023_length_123_cov_1186.083333	0	76	45	7	76	0.0921053
NODE_308023_length_123_cov_1186.083333	0	76	55	43	76	0.5657895
NODE_308023_length_123_cov_1186.083333	0	76	56	13	76	0.1710526
NODE_308023_length_123_cov_1186.083333	49	123	16	1	74	0.0135135
NODE_308023_length_123_cov_1186.083333	49	123	18	2	74	0.0270270
NODE_308023_length_123_cov_1186.083333	49	123	20	5	74	0.0675676
NODE_308023_length_123_cov_1186.083333	49	123	32	1	74	0.0135135
NODE_308023_length_123_cov_1186.083333	49	123	34	2	74	0.0270270
NODE_308023_length_123_cov_1186.083333	49	123	38	1	74	0.0135135
NODE_308023_length_123_cov_1186.083333	49	123	40	4	74	0.0540541
NODE_308023_length_123_cov_1186.083333	49	123	52	4	74	0.0540541
NODE_308023_length_123_cov_1186.083333	49	123	55	14	74	0.1891892
NODE_308023_length_123_cov_1186.083333	49	123	56	40	74	0.5405405
NODE_308023_length_123_cov_1186.083333	49	123	16	1	74	0.0135135
NODE_308023_length_123_cov_1186.083333	49	123	18	2	74	0.0270270
NODE_308023_length_123_cov_1186.083333	49	123	20	5	74	0.0675676
NODE_308023_length_123_cov_1186.083333	49	123	32	1	74	0.0135135
NODE_308023_length_123_cov_1186.083333	49	123	34	2	74	0.0270270
NODE_308023_length_123_cov_1186.083333	49	123	38	1	74	0.0135135
NODE_308023_length_123_cov_1186.083333	49	123	40	4	74	0.0540541
NODE_308023_length_123_cov_1186.083333	49	123	52	4	74	0.0540541
NODE_308023_length_123_cov_1186.083333	49	123	55	14	74	0.1891892
NODE_308023_length_123_cov_1186.083333	49	123	56	40	74	0.5405405
NODE_308023_length_123_cov_1186.083333	49	123	16	1	74	0.0135135
NODE_308023_length_123_cov_1186.083333	49	123	18	2	74	0.0270270
NODE_308023_length_123_cov_1186.083333	49	123	20	5	74	0.0675676
NODE_308023_length_123_cov_1186.083333	49	123	32	1	74	0.0135135
NODE_308023_length_123_cov_1186.083333	49	123	34	2	74	0.0270270
NODE_308023_length_123_cov_1186.083333	49	123	38	1	74	0.0135135
NODE_308023_length_123_cov_1186.083333	49	123	40	4	74	0.0540541
NODE_308023_length_123_cov_1186.083333	49	123	52	4	74	0.0540541
NODE_308023_length_123_cov_1186.083333	49	123	55	14	74	0.1891892
NODE_308023_length_123_cov_1186.083333	49	123	56	40	74	0.5405405
NODE_308024_length_123_cov_963.500000	19	88	16	2	69	0.0289855
NODE_308024_length_123_cov_963.500000	19	88	18	67	69	0.9710145
NODE_308037_length_123_cov_181.291667	0	47	0	47	47	1.0000000
NODE_308037_length_123_cov_181.291667	24	100	0	76	76	1.0000000
NODE_308057_length_123_cov_55.375000	52	123	4	1	71	0.0140845
NODE_308057_length_123_cov_55.375000	52	123	8	3	71	0.0422535
NODE_308057_length_123_cov_55.375000	52	123	16	4	71	0.0563380
NODE_308057_length_123_cov_55.375000	52	123	20	4	71	0.0563380
NODE_308057_length_123_cov_55.375000	52	123	32	59	71	0.8309859
NODE_308057_length_123_cov_55.375000	52	123	4	1	71	0.0140845
NODE_308057_length_123_cov_55.375000	52	123	8	3	71	0.0422535
NODE_308057_length_123_cov_55.375000	52	123	16	4	71	0.0563380
NODE_308057_length_123_cov_55.375000	52	123	20	4	71	0.0563380
NODE_308057_length_123_cov_55.375000	52	123	32	59	71	0.8309859
NODE_308057_length_123_cov_55.375000	61	123	4	1	62	0.0161290
NODE_308057_length_123_cov_55.375000	61	123	8	3	62	0.0483871
NODE_308057_length_123_cov_55.375000	61	123	16	4	62	0.0645161
NODE_308057_length_123_cov_55.375000	61	123	20	4	62	0.0645161
NODE_308057_length_123_cov_55.375000	61	123	32	50	62	0.8064516
NODE_308068_length_123_cov_40.958333	9	89	16	5	80	0.0625000
NODE_308068_length_123_cov_40.958333	9	89	18	75	80	0.9375000
NODE_308068_length_123_cov_40.958333	9	89	16	5	80	0.0625000
NODE_308068_length_123_cov_40.958333	9	89	18	75	80	0.9375000
NODE_308068_length_123_cov_40.958333	9	89	16	5	80	0.0625000
NODE_308068_length_123_cov_40.958333	9	89	18	75	80	0.9375000
NODE_308068_length_123_cov_40.958333	9	89	16	5	80	0.0625000
NODE_308068_length_123_cov_40.958333	9	89	18	75	80	0.9375000
NODE_308068_length_123_cov_40.958333	9	89	16	5	80	0.0625000
NODE_308068_length_123_cov_40.958333	9	89	18	75	80	0.9375000
NODE_308068_length_123_cov_40.958333	9	80	16	5	71	0.0704225
NODE_308068_length_123_cov_40.958333	9	80	18	66	71	0.9295775
NODE_308180_length_122_cov_111.043478	8	88	11	14	80	0.1750000
NODE_308180_length_122_cov_111.043478	8	88	12	66	80	0.8250000
NODE_308180_length_122_cov_111.043478	8	88	11	14	80	0.1750000
NODE_308180_length_122_cov_111.043478	8	88	12	66	80	0.8250000
NODE_308184_length_122_cov_67.565217	0	50	0	3	50	0.0600000
NODE_308184_length_122_cov_67.565217	0	50	2	2	50	0.0400000
NODE_308184_length_122_cov_67.565217	0	50	8	2	50	0.0400000
NODE_308184_length_122_cov_67.565217	0	50	10	4	50	0.0800000
NODE_308184_length_122_cov_67.565217	0	50	14	3	50	0.0600000
NODE_308184_length_122_cov_67.565217	0	50	16	36	50	0.7200000
NODE_308184_length_122_cov_67.565217	0	50	0	3	50	0.0600000
NODE_308184_length_122_cov_67.565217	0	50	2	2	50	0.0400000
NODE_308184_length_122_cov_67.565217	0	50	8	2	50	0.0400000
NODE_308184_length_122_cov_67.565217	0	50	10	4	50	0.0800000
NODE_308184_length_122_cov_67.565217	0	50	14	3	50	0.0600000
NODE_308184_length_122_cov_67.565217	0	50	16	36	50	0.7200000
NODE_308184_length_122_cov_67.565217	23	103	16	80	80	1.0000000
NODE_308184_length_122_cov_67.565217	23	103	16	80	80	1.0000000
NODE_308184_length_122_cov_67.565217	23	103	16	80	80	1.0000000
NODE_308184_length_122_cov_67.565217	23	103	16	80	80	1.0000000
NODE_308184_length_122_cov_67.565217	23	103	16	80	80	1.0000000
NODE_308184_length_122_cov_67.565217	23	94	16	71	71	1.0000000
NODE_308188_length_122_cov_58.826087	28	99	0	71	71	1.0000000
NODE_308188_length_122_cov_58.826087	33	99	0	66	66	1.0000000
NODE_308188_length_122_cov_58.826087	72	122	0	50	50	1.0000000
NODE_308188_length_122_cov_58.826087	72	122	0	50	50	1.0000000
NODE_308198_length_122_cov_38.173913	12	93	0	5	81	0.0617284
NODE_308198_length_122_cov_38.173913	12	93	2	76	81	0.9382716
NODE_308257_length_121_cov_159.318182	24	55	10	31	31	1.0000000
NODE_308260_length_121_cov_120.181818	20	100	2	80	80	1.0000000
NODE_308260_length_121_cov_120.181818	20	95	2	75	75	1.0000000
NODE_308260_length_121_cov_120.181818	20	100	2	80	80	1.0000000
NODE_308260_length_121_cov_120.181818	29	100	2	71	71	1.0000000
NODE_308273_length_121_cov_54.181818	7	70	0	63	63	1.0000000
NODE_308273_length_121_cov_54.181818	7	70	0	63	63	1.0000000
NODE_308273_length_121_cov_54.181818	7	70	0	63	63	1.0000000
NODE_308273_length_121_cov_54.181818	9	70	0	61	61	1.0000000
NODE_308273_length_121_cov_54.181818	43	109	0	66	66	1.0000000
NODE_308273_length_121_cov_54.181818	43	121	0	78	78	1.0000000
NODE_308273_length_121_cov_54.181818	64	117	0	53	53	1.0000000
NODE_308317_length_120_cov_1404.619048	0	64	12	1	64	0.0156250
NODE_308317_length_120_cov_1404.619048	0	64	16	1	64	0.0156250
NODE_308317_length_120_cov_1404.619048	0	64	18	1	64	0.0156250
NODE_308317_length_120_cov_1404.619048	0	64	22	1	64	0.0156250
NODE_308317_length_120_cov_1404.619048	0	64	26	2	64	0.0312500
NODE_308317_length_120_cov_1404.619048	0	64	36	1	64	0.0156250
NODE_308317_length_120_cov_1404.619048	0	64	44	2	64	0.0312500
NODE_308317_length_120_cov_1404.619048	0	64	48	2	64	0.0312500
NODE_308317_length_120_cov_1404.619048	0	64	52	2	64	0.0312500
NODE_308317_length_120_cov_1404.619048	0	64	56	4	64	0.0625000
NODE_308317_length_120_cov_1404.619048	0	64	58	47	64	0.7343750
NODE_308317_length_120_cov_1404.619048	45	117	38	2	72	0.0277778
NODE_308317_length_120_cov_1404.619048	45	117	44	2	72	0.0277778
NODE_308317_length_120_cov_1404.619048	45	117	48	2	72	0.0277778
NODE_308317_length_120_cov_1404.619048	45	117	50	3	72	0.0416667
NODE_308317_length_120_cov_1404.619048	45	117	54	4	72	0.0555556
NODE_308317_length_120_cov_1404.619048	45	117	55	1	72	0.0138889
NODE_308317_length_120_cov_1404.619048	45	117	56	1	72	0.0138889
NODE_308317_length_120_cov_1404.619048	45	117	58	57	72	0.7916667
NODE_308318_length_120_cov_1138.428571	19	99	12	80	80	1.0000000
NODE_308318_length_120_cov_1138.428571	72	120	0	5	48	0.1041667
NODE_308318_length_120_cov_1138.428571	72	120	4	2	48	0.0416667
NODE_308318_length_120_cov_1138.428571	72	120	6	8	48	0.1666667
NODE_308318_length_120_cov_1138.428571	72	120	8	2	48	0.0416667
NODE_308318_length_120_cov_1138.428571	72	120	10	1	48	0.0208333
NODE_308318_length_120_cov_1138.428571	72	120	12	30	48	0.6250000
NODE_308357_length_120_cov_54.666667	0	69	0	3	69	0.0434783
NODE_308357_length_120_cov_54.666667	0	69	2	8	69	0.1159420
NODE_308357_length_120_cov_54.666667	0	69	6	1	69	0.0144928
NODE_308357_length_120_cov_54.666667	0	69	8	1	69	0.0144928
NODE_308357_length_120_cov_54.666667	0	69	10	2	69	0.0289855
NODE_308357_length_120_cov_54.666667	0	69	12	54	69	0.7826087
NODE_308357_length_120_cov_54.666667	0	69	0	3	69	0.0434783
NODE_308357_length_120_cov_54.666667	0	69	2	8	69	0.1159420
NODE_308357_length_120_cov_54.666667	0	69	6	1	69	0.0144928
NODE_308357_length_120_cov_54.666667	0	69	8	1	69	0.0144928
NODE_308357_length_120_cov_54.666667	0	69	10	2	69	0.0289855
NODE_308357_length_120_cov_54.666667	0	69	12	54	69	0.7826087
NODE_308357_length_120_cov_54.666667	0	69	0	3	69	0.0434783
NODE_308357_length_120_cov_54.666667	0	69	2	8	69	0.1159420
NODE_308357_length_120_cov_54.666667	0	69	6	1	69	0.0144928
NODE_308357_length_120_cov_54.666667	0	69	8	1	69	0.0144928
NODE_308357_length_120_cov_54.666667	0	69	10	2	69	0.0289855
NODE_308357_length_120_cov_54.666667	0	69	12	54	69	0.7826087
NODE_308357_length_120_cov_54.666667	42	108	7	2	66	0.0303030
NODE_308357_length_120_cov_54.666667	42	108	8	1	66	0.0151515
NODE_308357_length_120_cov_54.666667	42	108	10	4	66	0.0606061
NODE_308357_length_120_cov_54.666667	42	108	12	59	66	0.8939394
NODE_308357_length_120_cov_54.666667	53	120	4	6	67	0.0895522
NODE_308357_length_120_cov_54.666667	53	120	5	2	67	0.0298507
NODE_308357_length_120_cov_54.666667	53	120	7	6	67	0.0895522
NODE_308357_length_120_cov_54.666667	53	120	8	1	67	0.0149254
NODE_308357_length_120_cov_54.666667	53	120	10	4	67	0.0597015
NODE_308357_length_120_cov_54.666667	53	120	12	48	67	0.7164179
NODE_308357_length_120_cov_54.666667	53	120	4	6	67	0.0895522
NODE_308357_length_120_cov_54.666667	53	120	5	2	67	0.0298507
NODE_308357_length_120_cov_54.666667	53	120	7	6	67	0.0895522
NODE_308357_length_120_cov_54.666667	53	120	8	1	67	0.0149254
NODE_308357_length_120_cov_54.666667	53	120	10	4	67	0.0597015
NODE_308357_length_120_cov_54.666667	53	120	12	48	67	0.7164179
NODE_308487_length_118_cov_1211.578947	49	116	4	1	67	0.0149254
NODE_308487_length_118_cov_1211.578947	49	116	6	11	67	0.1641791
NODE_308487_length_118_cov_1211.578947	49	116	10	55	67	0.8208955
NODE_308488_length_118_cov_1157.157895	4	70	8	1	66	0.0151515
NODE_308488_length_118_cov_1157.157895	4	70	10	5	66	0.0757576
NODE_308488_length_118_cov_1157.157895	4	70	14	60	66	0.9090909
NODE_308500_length_118_cov_218.210526	0	63	0	2	63	0.0317460
NODE_308500_length_118_cov_218.210526	0	63	4	10	63	0.1587302
NODE_308500_length_118_cov_218.210526	0	63	6	51	63	0.8095238
NODE_308500_length_118_cov_218.210526	35	115	0	2	80	0.0250000
NODE_308500_length_118_cov_218.210526	35	115	2	4	80	0.0500000
NODE_308500_length_118_cov_218.210526	35	115	3	5	80	0.0625000
NODE_308500_length_118_cov_218.210526	35	115	5	1	80	0.0125000
NODE_308500_length_118_cov_218.210526	35	115	6	68	80	0.8500000
NODE_308504_length_118_cov_161.052632	4	70	0	66	66	1.0000000
NODE_308572_length_117_cov_338.555556	7	70	24	1	63	0.0158730
NODE_308572_length_117_cov_338.555556	7	70	26	3	63	0.0476190
NODE_308572_length_117_cov_338.555556	7	70	28	2	63	0.0317460
NODE_308572_length_117_cov_338.555556	7	70	30	57	63	0.9047619
NODE_308572_length_117_cov_338.555556	7	70	24	1	63	0.0158730
NODE_308572_length_117_cov_338.555556	7	70	26	3	63	0.0476190
NODE_308572_length_117_cov_338.555556	7	70	28	2	63	0.0317460
NODE_308572_length_117_cov_338.555556	7	70	30	57	63	0.9047619
NODE_308572_length_117_cov_338.555556	7	70	24	1	63	0.0158730
NODE_308572_length_117_cov_338.555556	7	70	26	3	63	0.0476190
NODE_308572_length_117_cov_338.555556	7	70	28	2	63	0.0317460
NODE_308572_length_117_cov_338.555556	7	70	30	57	63	0.9047619
NODE_308572_length_117_cov_338.555556	9	70	26	2	61	0.0327869
NODE_308572_length_117_cov_338.555556	9	70	28	2	61	0.0327869
NODE_308572_length_117_cov_338.555556	9	70	30	57	61	0.9344262
NODE_308572_length_117_cov_338.555556	43	109	28	4	66	0.0606061
NODE_308572_length_117_cov_338.555556	43	109	30	62	66	0.9393939
NODE_308572_length_117_cov_338.555556	43	114	20	1	71	0.0140845
NODE_308572_length_117_cov_338.555556	43	114	22	1	71	0.0140845
NODE_308572_length_117_cov_338.555556	43	114	24	2	71	0.0281690
NODE_308572_length_117_cov_338.555556	43	114	28	5	71	0.0704225
NODE_308572_length_117_cov_338.555556	43	114	30	62	71	0.8732395
NODE_308572_length_117_cov_338.555556	64	117	12	1	53	0.0188679
NODE_308572_length_117_cov_338.555556	64	117	16	2	53	0.0377358
NODE_308572_length_117_cov_338.555556	64	117	20	1	53	0.0188679
NODE_308572_length_117_cov_338.555556	64	117	22	1	53	0.0188679
NODE_308572_length_117_cov_338.555556	64	117	24	2	53	0.0377358
NODE_308572_length_117_cov_338.555556	64	117	28	5	53	0.0943396
NODE_308572_length_117_cov_338.555556	64	117	30	41	53	0.7735849
NODE_308654_length_116_cov_1897.470588	0	77	4	1	77	0.0129870
NODE_308654_length_116_cov_1897.470588	0	77	10	2	77	0.0259740
NODE_308654_length_116_cov_1897.470588	0	77	12	1	77	0.0129870
NODE_308654_length_116_cov_1897.470588	0	77	16	1	77	0.0129870
NODE_308654_length_116_cov_1897.470588	0	77	20	3	77	0.0389610
NODE_308654_length_116_cov_1897.470588	0	77	24	69	77	0.8961039
NODE_308654_length_116_cov_1897.470588	34	111	10	2	77	0.0259740
NODE_308654_length_116_cov_1897.470588	34	111	15	1	77	0.0129870
NODE_308654_length_116_cov_1897.470588	34	111	16	1	77	0.0129870
NODE_308654_length_116_cov_1897.470588	34	111	22	2	77	0.0259740
NODE_308654_length_116_cov_1897.470588	34	111	24	71	77	0.9220779
NODE_308668_length_116_cov_438.529412	15	95	8	80	80	1.0000000
NODE_308668_length_116_cov_438.529412	68	116	2	5	48	0.1041667
NODE_308668_length_116_cov_438.529412	68	116	4	5	48	0.1041667
NODE_308668_length_116_cov_438.529412	68	116	8	38	48	0.7916667
NODE_308701_length_116_cov_93.235294	52	116	0	5	64	0.0781250
NODE_308701_length_116_cov_93.235294	52	116	2	4	64	0.0625000
NODE_308701_length_116_cov_93.235294	52	116	4	55	64	0.8593750
NODE_308722_length_116_cov_46.882353	6	66	27	1	60	0.0166667
NODE_308722_length_116_cov_46.882353	6	66	29	7	60	0.1166667
NODE_308722_length_116_cov_46.882353	6	66	30	1	60	0.0166667
NODE_308722_length_116_cov_46.882353	6	66	31	17	60	0.2833333
NODE_308722_length_116_cov_46.882353	6	66	32	34	60	0.5666667
NODE_308727_length_116_cov_38.352941	20	100	2	80	80	1.0000000
NODE_308746_length_115_cov_1012.625000	31	114	14	6	83	0.0722892
NODE_308746_length_115_cov_1012.625000	31	114	24	5	83	0.0602410
NODE_308746_length_115_cov_1012.625000	31	114	26	72	83	0.8674699
NODE_308750_length_115_cov_776.625000	9	92	2	2	83	0.0240964
NODE_308750_length_115_cov_776.625000	9	92	5	1	83	0.0120482
NODE_308750_length_115_cov_776.625000	9	92	6	80	83	0.9638554
NODE_308752_length_115_cov_623.937500	0	74	8	74	74	1.0000000
NODE_308782_length_115_cov_144.812500	4	73	0	69	69	1.0000000
NODE_308806_length_115_cov_65.187500	16	76	8	60	60	1.0000000
NODE_308846_length_114_cov_819.466667	40	114	0	1	74	0.0135135
NODE_308846_length_114_cov_819.466667	40	114	2	5	74	0.0675676
NODE_308846_length_114_cov_819.466667	40	114	4	3	74	0.0405405
NODE_308846_length_114_cov_819.466667	40	114	14	1	74	0.0135135
NODE_308846_length_114_cov_819.466667	40	114	18	1	74	0.0135135
NODE_308846_length_114_cov_819.466667	40	114	28	3	74	0.0405405
NODE_308846_length_114_cov_819.466667	40	114	30	60	74	0.8108108
NODE_308846_length_114_cov_819.466667	40	114	0	1	74	0.0135135
NODE_308846_length_114_cov_819.466667	40	114	2	5	74	0.0675676
NODE_308846_length_114_cov_819.466667	40	114	4	3	74	0.0405405
NODE_308846_length_114_cov_819.466667	40	114	14	1	74	0.0135135
NODE_308846_length_114_cov_819.466667	40	114	18	1	74	0.0135135
NODE_308846_length_114_cov_819.466667	40	114	28	3	74	0.0405405
NODE_308846_length_114_cov_819.466667	40	114	30	60	74	0.8108108
NODE_308846_length_114_cov_819.466667	49	114	0	1	65	0.0153846
NODE_308846_length_114_cov_819.466667	49	114	2	5	65	0.0769231
NODE_308846_length_114_cov_819.466667	49	114	4	3	65	0.0461538
NODE_308846_length_114_cov_819.466667	49	114	14	1	65	0.0153846
NODE_308846_length_114_cov_819.466667	49	114	18	1	65	0.0153846
NODE_308846_length_114_cov_819.466667	49	114	28	3	65	0.0461538
NODE_308846_length_114_cov_819.466667	49	114	30	51	65	0.7846154
NODE_308866_length_114_cov_285.666667	0	78	0	5	78	0.0641026
NODE_308866_length_114_cov_285.666667	0	78	2	3	78	0.0384615
NODE_308866_length_114_cov_285.666667	0	78	4	70	78	0.8974359
NODE_308866_length_114_cov_285.666667	51	114	0	1	63	0.0158730
NODE_308866_length_114_cov_285.666667	51	114	2	8	63	0.1269841
NODE_308866_length_114_cov_285.666667	51	114	4	54	63	0.8571429
NODE_308886_length_114_cov_83.600000	51	82	0	31	31	1.0000000
NODE_308891_length_114_cov_67.666667	40	90	0	50	50	1.0000000
NODE_308939_length_113_cov_446.214286	5	82	10	77	77	1.0000000
NODE_308939_length_113_cov_446.214286	5	82	10	77	77	1.0000000
NODE_308967_length_113_cov_160.071429	0	64	4	2	64	0.0312500
NODE_308967_length_113_cov_160.071429	0	64	6	1	64	0.0156250
NODE_308967_length_113_cov_160.071429	0	64	10	2	64	0.0312500
NODE_308967_length_113_cov_160.071429	0	64	14	4	64	0.0625000
NODE_308967_length_113_cov_160.071429	0	64	16	55	64	0.8593750
NODE_308967_length_113_cov_160.071429	0	64	4	2	64	0.0312500
NODE_308967_length_113_cov_160.071429	0	64	6	1	64	0.0156250
NODE_308967_length_113_cov_160.071429	0	64	10	2	64	0.0312500
NODE_308967_length_113_cov_160.071429	0	64	14	4	64	0.0625000
NODE_308967_length_113_cov_160.071429	0	64	16	55	64	0.8593750
NODE_308967_length_113_cov_160.071429	37	103	15	25	66	0.3787879
NODE_308967_length_113_cov_160.071429	37	103	16	41	66	0.6212121
NODE_308967_length_113_cov_160.071429	37	108	15	30	71	0.4225352
NODE_308967_length_113_cov_160.071429	37	108	16	41	71	0.5774648
NODE_309037_length_112_cov_963.384615	43	112	12	3	69	0.0434783
NODE_309037_length_112_cov_963.384615	43	112	14	2	69	0.0289855
NODE_309037_length_112_cov_963.384615	43	112	18	64	69	0.9275362
NODE_309044_length_112_cov_653.615385	7	78	4	71	71	1.0000000
NODE_309044_length_112_cov_653.615385	12	78	4	66	66	1.0000000
NODE_309044_length_112_cov_653.615385	51	112	0	2	61	0.0327869
NODE_309044_length_112_cov_653.615385	51	112	4	59	61	0.9672131
NODE_309044_length_112_cov_653.615385	51	112	0	2	61	0.0327869
NODE_309044_length_112_cov_653.615385	51	112	4	59	61	0.9672131
NODE_309067_length_112_cov_219.538462	0	62	0	6	62	0.0967742
NODE_309067_length_112_cov_219.538462	0	62	4	56	62	0.9032258
NODE_309067_length_112_cov_219.538462	0	57	0	6	57	0.1052632
NODE_309067_length_112_cov_219.538462	0	57	4	51	57	0.8947368
NODE_309067_length_112_cov_219.538462	0	62	0	6	62	0.0967742
NODE_309067_length_112_cov_219.538462	0	62	4	56	62	0.9032258
NODE_309067_length_112_cov_219.538462	0	59	0	6	59	0.1016949
NODE_309067_length_112_cov_219.538462	0	59	4	53	59	0.8983051
NODE_309067_length_112_cov_219.538462	35	112	0	5	77	0.0649351
NODE_309067_length_112_cov_219.538462	35	112	4	72	77	0.9350649
NODE_309067_length_112_cov_219.538462	35	112	0	5	77	0.0649351
NODE_309067_length_112_cov_219.538462	35	112	4	72	77	0.9350649
NODE_309067_length_112_cov_219.538462	35	112	0	5	77	0.0649351
NODE_309067_length_112_cov_219.538462	35	112	4	72	77	0.9350649
NODE_309078_length_112_cov_160.307692	0	69	0	69	69	1.0000000
NODE_309079_length_112_cov_134.846154	11	91	6	80	80	1.0000000
NODE_309079_length_112_cov_134.846154	11	91	6	80	80	1.0000000
NODE_309079_length_112_cov_134.846154	64	112	4	5	48	0.1041667
NODE_309079_length_112_cov_134.846154	64	112	6	43	48	0.8958333
NODE_309079_length_112_cov_134.846154	64	112	4	5	48	0.1041667
NODE_309079_length_112_cov_134.846154	64	112	6	43	48	0.8958333
NODE_309079_length_112_cov_134.846154	64	112	4	5	48	0.1041667
NODE_309079_length_112_cov_134.846154	64	112	6	43	48	0.8958333
NODE_309092_length_112_cov_84.384615	10	90	0	80	80	1.0000000
NODE_309097_length_112_cov_72.769231	36	100	6	64	64	1.0000000
NODE_309106_length_112_cov_35.307692	13	76	16	63	63	1.0000000
NODE_309123_length_111_cov_1107.833333	0	52	0	52	52	1.0000000
NODE_309123_length_111_cov_1107.833333	0	52	0	52	52	1.0000000
NODE_309123_length_111_cov_1107.833333	0	52	0	52	52	1.0000000
NODE_309123_length_111_cov_1107.833333	0	52	0	52	52	1.0000000
NODE_309123_length_111_cov_1107.833333	25	105	0	80	80	1.0000000
NODE_309123_length_111_cov_1107.833333	25	105	0	80	80	1.0000000
NODE_309123_length_111_cov_1107.833333	25	105	0	80	80	1.0000000
NODE_309123_length_111_cov_1107.833333	25	105	0	80	80	1.0000000
NODE_309123_length_111_cov_1107.833333	25	105	0	80	80	1.0000000
NODE_309123_length_111_cov_1107.833333	25	105	0	80	80	1.0000000
NODE_309126_length_111_cov_827.500000	3	74	21	1	71	0.0140845
NODE_309126_length_111_cov_827.500000	3	74	24	70	71	0.9859155
NODE_309126_length_111_cov_827.500000	8	74	24	66	66	1.0000000
NODE_309126_length_111_cov_827.500000	47	111	0	1	64	0.0156250
NODE_309126_length_111_cov_827.500000	47	111	10	3	64	0.0468750
NODE_309126_length_111_cov_827.500000	47	111	12	1	64	0.0156250
NODE_309126_length_111_cov_827.500000	47	111	16	1	64	0.0156250
NODE_309126_length_111_cov_827.500000	47	111	22	2	64	0.0312500
NODE_309126_length_111_cov_827.500000	47	111	24	56	64	0.8750000
NODE_309126_length_111_cov_827.500000	47	111	0	1	64	0.0156250
NODE_309126_length_111_cov_827.500000	47	111	10	3	64	0.0468750
NODE_309126_length_111_cov_827.500000	47	111	12	1	64	0.0156250
NODE_309126_length_111_cov_827.500000	47	111	16	1	64	0.0156250
NODE_309126_length_111_cov_827.500000	47	111	22	2	64	0.0312500
NODE_309126_length_111_cov_827.500000	47	111	24	56	64	0.8750000
NODE_309126_length_111_cov_827.500000	47	111	0	1	64	0.0156250
NODE_309126_length_111_cov_827.500000	47	111	10	3	64	0.0468750
NODE_309126_length_111_cov_827.500000	47	111	12	1	64	0.0156250
NODE_309126_length_111_cov_827.500000	47	111	16	1	64	0.0156250
NODE_309126_length_111_cov_827.500000	47	111	22	2	64	0.0312500
NODE_309126_length_111_cov_827.500000	47	111	24	56	64	0.8750000
NODE_309129_length_111_cov_726.833333	12	89	6	77	77	1.0000000
NODE_309129_length_111_cov_726.833333	12	89	6	77	77	1.0000000
NODE_309129_length_111_cov_726.833333	62	111	0	6	49	0.1224490
NODE_309129_length_111_cov_726.833333	62	111	6	43	49	0.8775510
NODE_309129_length_111_cov_726.833333	67	111	0	6	44	0.1363636
NODE_309129_length_111_cov_726.833333	67	111	6	38	44	0.8636364
NODE_309131_length_111_cov_692.416667	31	111	4	80	80	1.0000000
NODE_309149_length_111_cov_241.750000	30	97	0	67	67	1.0000000
NODE_309160_length_111_cov_169.416667	21	102	0	81	81	1.0000000
NODE_309200_length_110_cov_554.909091	1	28	16	1	27	0.0370370
NODE_309200_length_110_cov_554.909091	1	28	20	1	27	0.0370370
NODE_309200_length_110_cov_554.909091	1	28	24	2	27	0.0740741
NODE_309200_length_110_cov_554.909091	1	28	26	2	27	0.0740741
NODE_309200_length_110_cov_554.909091	1	28	28	21	27	0.7777778
NODE_309200_length_110_cov_554.909091	1	81	16	1	80	0.0125000
NODE_309200_length_110_cov_554.909091	1	81	20	1	80	0.0125000
NODE_309200_length_110_cov_554.909091	1	81	24	2	80	0.0250000
NODE_309200_length_110_cov_554.909091	1	81	26	2	80	0.0250000
NODE_309200_length_110_cov_554.909091	1	81	28	74	80	0.9250000
NODE_309202_length_110_cov_537.545455	0	75	0	75	75	1.0000000
NODE_309202_length_110_cov_537.545455	53	107	0	54	54	1.0000000
NODE_309235_length_110_cov_91.636364	19	54	0	35	35	1.0000000
NODE_309235_length_110_cov_91.636364	64	107	0	43	43	1.0000000
NODE_309239_length_110_cov_80.272727	19	54	0	35	35	1.0000000
NODE_309239_length_110_cov_80.272727	64	99	0	35	35	1.0000000
NODE_309241_length_110_cov_78.363636	19	54	0	35	35	1.0000000
NODE_309241_length_110_cov_78.363636	64	107	0	43	43	1.0000000
NODE_309245_length_110_cov_68.727273	11	46	0	35	35	1.0000000
NODE_309245_length_110_cov_68.727273	56	91	0	35	35	1.0000000
NODE_309252_length_110_cov_44.545455	5	57	0	52	52	1.0000000
NODE_309263_length_109_cov_1364.100000	29	98	0	69	69	1.0000000
NODE_309275_length_109_cov_689.800000	12	86	2	74	74	1.0000000
NODE_309309_length_109_cov_250.800000	4	66	0	62	62	1.0000000
NODE_309311_length_109_cov_242.000000	29	98	0	69	69	1.0000000
NODE_309326_length_109_cov_139.000000	26	106	3	60	80	0.7500000
NODE_309326_length_109_cov_139.000000	26	106	4	20	80	0.2500000
NODE_309345_length_109_cov_84.500000	33	93	0	60	60	1.0000000
NODE_309349_length_109_cov_75.300000	0	65	0	65	65	1.0000000
NODE_309384_length_108_cov_1542.666667	28	108	0	1	80	0.0125000
NODE_309384_length_108_cov_1542.666667	28	108	1	79	80	0.9875000
NODE_309391_length_108_cov_987.666667	5	85	0	80	80	1.0000000
NODE_309391_length_108_cov_987.666667	5	85	0	80	80	1.0000000
NODE_309391_length_108_cov_987.666667	5	85	0	80	80	1.0000000
NODE_309391_length_108_cov_987.666667	5	85	0	80	80	1.0000000
NODE_309391_length_108_cov_987.666667	5	85	0	80	80	1.0000000
NODE_309391_length_108_cov_987.666667	58	108	0	50	50	1.0000000
NODE_309391_length_108_cov_987.666667	58	108	0	50	50	1.0000000
NODE_309395_length_108_cov_841.666667	1	65	10	1	64	0.0156250
NODE_309395_length_108_cov_841.666667	1	65	12	3	64	0.0468750
NODE_309395_length_108_cov_841.666667	1	65	14	60	64	0.9375000
NODE_309395_length_108_cov_841.666667	1	65	10	1	64	0.0156250
NODE_309395_length_108_cov_841.666667	1	65	12	3	64	0.0468750
NODE_309395_length_108_cov_841.666667	1	65	14	60	64	0.9375000
NODE_309395_length_108_cov_841.666667	1	65	10	1	64	0.0156250
NODE_309395_length_108_cov_841.666667	1	65	12	3	64	0.0468750
NODE_309395_length_108_cov_841.666667	1	65	14	60	64	0.9375000
NODE_309433_length_108_cov_213.333333	22	81	2	59	59	1.0000000
NODE_309433_length_108_cov_213.333333	55	81	2	26	26	1.0000000
NODE_309464_length_108_cov_107.888889	11	82	0	71	71	1.0000000
NODE_309464_length_108_cov_107.888889	16	82	0	66	66	1.0000000
NODE_309464_length_108_cov_107.888889	55	108	0	53	53	1.0000000
NODE_309464_length_108_cov_107.888889	55	108	0	53	53	1.0000000
NODE_309464_length_108_cov_107.888889	55	108	0	53	53	1.0000000
NODE_309472_length_108_cov_76.444444	13	76	0	63	63	1.0000000
NODE_309479_length_108_cov_51.000000	0	53	0	53	53	1.0000000
NODE_309479_length_108_cov_51.000000	0	53	0	53	53	1.0000000
NODE_309479_length_108_cov_51.000000	0	53	0	53	53	1.0000000
NODE_309479_length_108_cov_51.000000	26	106	0	80	80	1.0000000
NODE_309479_length_108_cov_51.000000	26	106	0	80	80	1.0000000
NODE_309479_length_108_cov_51.000000	26	106	0	80	80	1.0000000
NODE_309479_length_108_cov_51.000000	26	106	0	80	80	1.0000000
NODE_309479_length_108_cov_51.000000	26	106	0	80	80	1.0000000
NODE_309479_length_108_cov_51.000000	26	97	0	71	71	1.0000000
NODE_309490_length_108_cov_31.111111	11	82	0	71	71	1.0000000
NODE_309490_length_108_cov_31.111111	16	82	0	66	66	1.0000000
NODE_309490_length_108_cov_31.111111	55	108	0	53	53	1.0000000
NODE_309490_length_108_cov_31.111111	55	108	0	53	53	1.0000000
NODE_309490_length_108_cov_31.111111	55	108	0	53	53	1.0000000
NODE_309530_length_107_cov_608.250000	0	64	0	64	64	1.0000000
NODE_309530_length_107_cov_608.250000	53	103	0	50	50	1.0000000
NODE_309551_length_107_cov_303.250000	0	56	0	56	56	1.0000000
NODE_309551_length_107_cov_303.250000	29	99	0	70	70	1.0000000
NODE_309657_length_106_cov_522.571429	10	90	0	80	80	1.0000000
NODE_309657_length_106_cov_522.571429	10	90	0	80	80	1.0000000
NODE_309657_length_106_cov_522.571429	10	90	0	80	80	1.0000000
NODE_309657_length_106_cov_522.571429	10	90	0	80	80	1.0000000
NODE_309657_length_106_cov_522.571429	10	90	0	80	80	1.0000000
NODE_309657_length_106_cov_522.571429	19	90	0	71	71	1.0000000
NODE_309696_length_106_cov_161.857143	7	78	0	71	71	1.0000000
NODE_309696_length_106_cov_161.857143	51	106	0	55	55	1.0000000
NODE_309707_length_106_cov_130.714286	0	76	0	76	76	1.0000000
NODE_309714_length_106_cov_108.000000	0	76	0	76	76	1.0000000
NODE_309717_length_106_cov_102.142857	0	62	0	62	62	1.0000000
NODE_309717_length_106_cov_102.142857	35	106	0	71	71	1.0000000
NODE_309717_length_106_cov_102.142857	35	106	0	71	71	1.0000000
NODE_309747_length_106_cov_39.428571	0	76	0	76	76	1.0000000
NODE_309761_length_106_cov_30.857143	0	70	0	70	70	1.0000000
NODE_309761_length_106_cov_30.857143	0	70	0	70	70	1.0000000
NODE_309761_length_106_cov_30.857143	0	70	0	70	70	1.0000000
NODE_309761_length_106_cov_30.857143	43	92	0	49	49	1.0000000
NODE_309761_length_106_cov_30.857143	53	106	0	53	53	1.0000000
NODE_309761_length_106_cov_30.857143	53	106	0	53	53	1.0000000
NODE_309775_length_105_cov_2054.666667	31	105	0	74	74	1.0000000
NODE_309775_length_105_cov_2054.666667	31	105	0	74	74	1.0000000
NODE_309775_length_105_cov_2054.666667	31	105	0	74	74	1.0000000
NODE_309775_length_105_cov_2054.666667	31	105	0	74	74	1.0000000
NODE_309788_length_105_cov_830.833333	30	105	0	75	75	1.0000000
NODE_309789_length_105_cov_825.500000	0	77	0	77	77	1.0000000
NODE_309789_length_105_cov_825.500000	0	77	0	77	77	1.0000000
NODE_309789_length_105_cov_825.500000	50	99	0	49	49	1.0000000
NODE_309789_length_105_cov_825.500000	55	105	0	50	50	1.0000000
NODE_309815_length_105_cov_231.333333	0	54	2	54	54	1.0000000
NODE_309815_length_105_cov_231.333333	27	99	2	72	72	1.0000000
NODE_309842_length_105_cov_85.333333	14	94	8	80	80	1.0000000
NODE_309842_length_105_cov_85.333333	67	89	8	22	22	1.0000000
NODE_309855_length_105_cov_61.833333	23	103	0	80	80	1.0000000
NODE_309867_length_105_cov_40.666667	6	66	0	60	60	1.0000000
NODE_309925_length_104_cov_1016.000000	0	78	0	78	78	1.0000000
NODE_309925_length_104_cov_1016.000000	53	99	0	46	46	1.0000000
NODE_309935_length_104_cov_791.200000	0	67	0	67	67	1.0000000
NODE_309935_length_104_cov_791.200000	0	67	0	67	67	1.0000000
NODE_309935_length_104_cov_791.200000	40	104	0	64	64	1.0000000
NODE_309938_length_104_cov_574.200000	21	101	0	80	80	1.0000000
NODE_309938_length_104_cov_574.200000	21	101	0	80	80	1.0000000
NODE_309938_length_104_cov_574.200000	21	101	0	80	80	1.0000000
NODE_309938_length_104_cov_574.200000	21	101	0	80	80	1.0000000
NODE_309938_length_104_cov_574.200000	21	101	0	80	80	1.0000000
NODE_309938_length_104_cov_574.200000	21	92	0	71	71	1.0000000
NODE_309940_length_104_cov_547.400000	10	87	0	77	77	1.0000000
NODE_309940_length_104_cov_547.400000	10	87	0	77	77	1.0000000
NODE_310020_length_104_cov_46.800000	42	104	0	62	62	1.0000000
NODE_310054_length_103_cov_2267.000000	0	54	0	54	54	1.0000000
NODE_310054_length_103_cov_2267.000000	27	100	0	73	73	1.0000000
NODE_310082_length_103_cov_890.000000	6	70	0	64	64	1.0000000
NODE_310082_length_103_cov_890.000000	6	70	0	64	64	1.0000000
NODE_310082_length_103_cov_890.000000	6	70	0	64	64	1.0000000
NODE_310082_length_103_cov_890.000000	43	103	0	60	60	1.0000000
NODE_310082_length_103_cov_890.000000	59	103	0	44	44	1.0000000
NODE_310090_length_103_cov_768.500000	7	78	0	71	71	1.0000000
NODE_310090_length_103_cov_768.500000	12	78	0	66	66	1.0000000
NODE_310090_length_103_cov_768.500000	51	99	0	48	48	1.0000000
NODE_310090_length_103_cov_768.500000	51	99	0	48	48	1.0000000
NODE_310090_length_103_cov_768.500000	51	99	0	48	48	1.0000000
NODE_310091_length_103_cov_751.000000	0	71	0	71	71	1.0000000
NODE_310091_length_103_cov_751.000000	0	71	0	71	71	1.0000000
NODE_310091_length_103_cov_751.000000	44	93	0	49	49	1.0000000
NODE_310094_length_103_cov_678.000000	10	74	0	64	64	1.0000000
NODE_310094_length_103_cov_678.000000	10	74	0	64	64	1.0000000
NODE_310094_length_103_cov_678.000000	10	74	0	64	64	1.0000000
NODE_310094_length_103_cov_678.000000	47	96	0	49	49	1.0000000
NODE_310103_length_103_cov_462.750000	19	99	0	80	80	1.0000000
NODE_310116_length_103_cov_300.250000	0	63	0	63	63	1.0000000
NODE_310147_length_103_cov_103.250000	4	47	0	43	43	1.0000000
NODE_310152_length_103_cov_80.250000	36	99	0	63	63	1.0000000
NODE_310153_length_103_cov_76.500000	4	63	0	59	59	1.0000000
NODE_310160_length_103_cov_42.000000	0	78	0	78	78	1.0000000
NODE_310160_length_103_cov_42.000000	7	78	0	71	71	1.0000000
NODE_310160_length_103_cov_42.000000	12	78	0	66	66	1.0000000
NODE_310160_length_103_cov_42.000000	51	99	0	48	48	1.0000000
NODE_310160_length_103_cov_42.000000	51	99	0	48	48	1.0000000
NODE_310160_length_103_cov_42.000000	51	99	0	48	48	1.0000000
NODE_310211_length_102_cov_2033.666667	0	48	0	48	48	1.0000000
NODE_310211_length_102_cov_2033.666667	21	101	0	80	80	1.0000000
NODE_310227_length_102_cov_1028.333333	52	102	0	50	50	1.0000000
NODE_310230_length_102_cov_987.666667	15	98	0	83	83	1.0000000
NODE_310231_length_102_cov_934.000000	12	95	0	83	83	1.0000000
NODE_310246_length_102_cov_685.666667	0	73	0	73	73	1.0000000
NODE_310247_length_102_cov_646.666667	15	89	0	74	74	1.0000000
NODE_310269_length_102_cov_250.000000	12	72	0	60	60	1.0000000
NODE_310273_length_102_cov_216.333333	4	70	0	66	66	1.0000000
NODE_310273_length_102_cov_216.333333	4	70	0	66	66	1.0000000
NODE_310273_length_102_cov_216.333333	4	70	0	66	66	1.0000000
NODE_310273_length_102_cov_216.333333	43	92	0	49	49	1.0000000
NODE_310273_length_102_cov_216.333333	57	102	0	45	45	1.0000000
NODE_310287_length_102_cov_152.333333	0	63	0	63	63	1.0000000
NODE_310295_length_102_cov_124.333333	0	70	0	70	70	1.0000000
NODE_310302_length_102_cov_106.333333	0	78	0	78	78	1.0000000
NODE_310302_length_102_cov_106.333333	7	78	0	71	71	1.0000000
NODE_310302_length_102_cov_106.333333	12	78	0	66	66	1.0000000
NODE_310302_length_102_cov_106.333333	51	102	0	51	51	1.0000000
NODE_310302_length_102_cov_106.333333	51	102	0	51	51	1.0000000
NODE_310302_length_102_cov_106.333333	51	102	0	51	51	1.0000000
NODE_310316_length_102_cov_74.333333	31	99	0	68	68	1.0000000
NODE_310321_length_102_cov_71.000000	11	91	0	80	80	1.0000000
NODE_310336_length_102_cov_32.666667	0	65	0	65	65	1.0000000
NODE_310336_length_102_cov_32.666667	38	99	0	61	61	1.0000000
NODE_310405_length_101_cov_2217.000000	0	43	0	43	43	1.0000000
NODE_310405_length_101_cov_2217.000000	23	96	0	73	73	1.0000000
NODE_310464_length_101_cov_740.500000	2	66	0	64	64	1.0000000
NODE_310464_length_101_cov_740.500000	2	66	0	64	64	1.0000000
NODE_310464_length_101_cov_740.500000	2	66	0	64	64	1.0000000
NODE_310464_length_101_cov_740.500000	39	101	0	62	62	1.0000000
NODE_310464_length_101_cov_740.500000	55	101	0	46	46	1.0000000
NODE_310469_length_101_cov_701.000000	0	62	0	62	62	1.0000000
NODE_310469_length_101_cov_701.000000	35	99	0	64	64	1.0000000
NODE_310469_length_101_cov_701.000000	35	99	0	64	64	1.0000000
NODE_310469_length_101_cov_701.000000	35	99	0	64	64	1.0000000
NODE_310471_length_101_cov_679.000000	2	76	0	74	74	1.0000000
NODE_310500_length_101_cov_374.500000	2	50	0	48	48	1.0000000
NODE_310500_length_101_cov_374.500000	2	50	0	48	48	1.0000000
NODE_310500_length_101_cov_374.500000	2	50	0	48	48	1.0000000
NODE_310500_length_101_cov_374.500000	23	89	0	66	66	1.0000000
NODE_310500_length_101_cov_374.500000	23	94	0	71	71	1.0000000
NODE_310516_length_101_cov_294.000000	4	52	0	48	48	1.0000000
NODE_310516_length_101_cov_294.000000	4	52	0	48	48	1.0000000
NODE_310516_length_101_cov_294.000000	4	52	0	48	48	1.0000000
NODE_310516_length_101_cov_294.000000	25	91	0	66	66	1.0000000
NODE_310516_length_101_cov_294.000000	25	96	0	71	71	1.0000000
NODE_310529_length_101_cov_230.500000	2	76	0	74	74	1.0000000
NODE_310529_length_101_cov_230.500000	2	76	0	74	74	1.0000000
NODE_310529_length_101_cov_230.500000	2	76	0	74	74	1.0000000
NODE_310529_length_101_cov_230.500000	49	101	0	52	52	1.0000000
NODE_310529_length_101_cov_230.500000	55	101	0	46	46	1.0000000
NODE_310550_length_101_cov_157.000000	13	72	0	59	59	1.0000000
NODE_310550_length_101_cov_157.000000	46	72	0	26	26	1.0000000
NODE_310565_length_101_cov_134.500000	2	37	0	35	35	1.0000000
NODE_310685_length_100_cov_1883.000000	32	100	0	68	68	1.0000000
NODE_310685_length_100_cov_1883.000000	32	100	0	68	68	1.0000000
NODE_310685_length_100_cov_1883.000000	32	99	0	67	67	1.0000000
NODE_310685_length_100_cov_1883.000000	32	100	0	68	68	1.0000000
NODE_310704_length_100_cov_1310.000000	0	42	0	42	42	1.0000000
NODE_310704_length_100_cov_1310.000000	1	42	0	41	41	1.0000000
NODE_310704_length_100_cov_1310.000000	38	100	0	62	62	1.0000000
NODE_310704_length_100_cov_1310.000000	38	95	0	57	57	1.0000000
NODE_310704_length_100_cov_1310.000000	38	100	0	62	62	1.0000000
NODE_310704_length_100_cov_1310.000000	38	100	0	62	62	1.0000000
NODE_310708_length_100_cov_1239.000000	1	48	0	47	47	1.0000000
NODE_310740_length_100_cov_694.000000	0	62	0	62	62	1.0000000
NODE_310740_length_100_cov_694.000000	0	62	0	62	62	1.0000000
NODE_310740_length_100_cov_694.000000	35	100	0	65	65	1.0000000
NODE_310748_length_100_cov_602.000000	0	57	0	57	57	1.0000000
NODE_310750_length_100_cov_590.000000	0	58	0	58	58	1.0000000
NODE_310798_length_100_cov_274.000000	1	67	0	66	66	1.0000000
NODE_310798_length_100_cov_274.000000	1	67	0	66	66	1.0000000
NODE_310798_length_100_cov_274.000000	1	67	0	66	66	1.0000000
NODE_310798_length_100_cov_274.000000	40	100	0	60	60	1.0000000
NODE_310798_length_100_cov_274.000000	54	100	0	46	46	1.0000000
NODE_310808_length_100_cov_217.000000	4	75	0	71	71	1.0000000
NODE_310808_length_100_cov_217.000000	9	75	0	66	66	1.0000000
NODE_310808_length_100_cov_217.000000	48	99	0	51	51	1.0000000
NODE_310808_length_100_cov_217.000000	48	99	0	51	51	1.0000000
NODE_310808_length_100_cov_217.000000	48	99	0	51	51	1.0000000
NODE_310810_length_100_cov_209.000000	1	44	0	43	43	1.0000000
NODE_310810_length_100_cov_209.000000	40	100	0	60	60	1.0000000
NODE_310810_length_100_cov_209.000000	40	100	0	60	60	1.0000000
NODE_310819_length_100_cov_185.000000	0	46	0	46	46	1.0000000
NODE_310819_length_100_cov_185.000000	9	58	0	49	49	1.0000000
NODE_310819_length_100_cov_185.000000	31	99	0	68	68	1.0000000
NODE_310819_length_100_cov_185.000000	31	99	0	68	68	1.0000000
NODE_310819_length_100_cov_185.000000	31	99	0	68	68	1.0000000
NODE_310828_length_100_cov_164.000000	9	92	0	83	83	1.0000000
NODE_310837_length_100_cov_152.000000	11	91	0	80	80	1.0000000
NODE_310837_length_100_cov_152.000000	11	91	0	80	80	1.0000000
NODE_310837_length_100_cov_152.000000	11	91	0	80	80	1.0000000
NODE_310837_length_100_cov_152.000000	11	91	0	80	80	1.0000000
NODE_310837_length_100_cov_152.000000	11	91	0	80	80	1.0000000
NODE_310839_length_100_cov_150.000000	0	54	0	54	54	1.0000000
NODE_310839_length_100_cov_150.000000	0	54	0	54	54	1.0000000
NODE_310839_length_100_cov_150.000000	27	100	0	73	73	1.0000000
NODE_310839_length_100_cov_150.000000	27	100	0	73	73	1.0000000
NODE_310840_length_100_cov_148.000000	2	82	0	80	80	1.0000000
NODE_310841_length_100_cov_148.000000	0	71	0	71	71	1.0000000
NODE_310841_length_100_cov_148.000000	0	71	0	71	71	1.0000000
NODE_310841_length_100_cov_148.000000	0	62	0	62	62	1.0000000
NODE_310876_length_100_cov_71.000000	0	75	0	75	75	1.0000000
NODE_310876_length_100_cov_71.000000	4	75	0	71	71	1.0000000
NODE_310876_length_100_cov_71.000000	9	75	0	66	66	1.0000000
NODE_310876_length_100_cov_71.000000	48	100	0	52	52	1.0000000
NODE_310876_length_100_cov_71.000000	48	100	0	52	52	1.0000000
NODE_310876_length_100_cov_71.000000	48	100	0	52	52	1.0000000
NODE_310896_length_100_cov_41.000000	0	75	0	75	75	1.0000000
NODE_310896_length_100_cov_41.000000	4	75	0	71	71	1.0000000
NODE_310896_length_100_cov_41.000000	9	75	0	66	66	1.0000000
NODE_310896_length_100_cov_41.000000	48	99	0	51	51	1.0000000
NODE_310896_length_100_cov_41.000000	48	99	0	51	51	1.0000000
NODE_310896_length_100_cov_41.000000	48	99	0	51	51	1.0000000
NODE_310904_length_100_cov_30.000000	1	42	0	41	41	1.0000000
